,Unnamed: 0,game_location,game_result,mp,fg,fga,fg_pct,fg2,fg2a,fg2_pct,fg3,fg3a,fg3_pct,ft,fta,ft_pct,pts,opp_fg,opp_fga,opp_fg_pct,opp_fg2,opp_fg2a,opp_fg2_pct,opp_fg3,opp_fg3a,opp_fg3_pct,opp_ft,opp_fta,opp_ft_pct,opp_pts,date_game,team_id,opp_id
0,0,Home,W 149-140 (2OT),290,60,113,0.531,50,86,0.581,10,27,0.37,19,20,0.95,149,49,100,0.49,35,64,0.547,14,36,0.389,28,36,0.778,140,2012-03-23,OKC,MIN
1,1,Home,W 149-106 ,240,53,86,0.616,34,50,0.68,19,36,0.528,24,35,0.686,149,40,93,0.43,32,73,0.438,8,20,0.4,18,22,0.818,106,2016-11-23,GSW,LAL
2,2,@,W 147-144 (4OT),340,56,124,0.452,48,95,0.505,8,29,0.276,27,46,0.587,147,50,120,0.417,45,98,0.459,5,22,0.227,39,44,0.886,144,2015-12-18,DET,CHI
3,3,@,W 145-130 ,240,56,97,0.577,45,71,0.634,11,26,0.423,22,28,0.786,145,44,95,0.463,30,63,0.476,14,32,0.438,28,35,0.8,130,2014-04-08,HOU,LAL
4,4,@,W 144-143 (2OT),290,57,109,0.523,46,80,0.575,11,29,0.379,19,24,0.792,144,53,125,0.424,38,82,0.463,15,43,0.349,22,25,0.88,143,2015-04-10,DAL,DEN
5,5,Home,L 144-147 (4OT),340,50,120,0.417,45,98,0.459,5,22,0.227,39,44,0.886,144,56,124,0.452,48,95,0.505,8,29,0.276,27,46,0.587,147,2015-12-18,CHI,DET
6,6,Home,W 144-109 ,240,56,86,0.651,43,58,0.741,13,28,0.464,19,23,0.826,144,40,92,0.435,29,62,0.468,11,30,0.367,18,22,0.818,109,2016-04-13,MIN,NOP
7,7,Home,W 144-98 ,240,57,92,0.62,40,58,0.69,17,34,0.5,13,16,0.813,144,36,82,0.439,24,54,0.444,12,28,0.429,14,22,0.636,98,2017-01-28,GSW,LAC
8,8,Home,W 143-107 ,240,51,76,0.671,43,58,0.741,8,18,0.444,33,40,0.825,143,44,102,0.431,37,77,0.481,7,25,0.28,12,15,0.8,107,2014-03-28,MIN,LAL
9,9,Home,L 143-144 (2OT),290,53,125,0.424,38,82,0.463,15,43,0.349,22,25,0.88,143,57,109,0.523,46,80,0.575,11,29,0.379,19,24,0.792,144,2015-04-10,DEN,DAL
10,10,@,W 143-114 ,240,48,83,0.578,33,53,0.623,15,30,0.5,32,35,0.914,143,43,105,0.41,32,71,0.451,11,34,0.324,17,23,0.739,114,2017-01-20,BRK,NOP
11,11,@,W 142-94 ,240,57,103,0.553,45,77,0.584,12,26,0.462,16,22,0.727,142,34,86,0.395,26,56,0.464,8,30,0.267,18,26,0.692,94,2014-03-06,LAC,LAL
12,12,Home,W 142-119 ,240,53,87,0.609,44,64,0.688,9,23,0.391,27,34,0.794,142,43,83,0.518,33,54,0.611,10,29,0.345,23,28,0.821,119,2016-01-02,SAC,PHO
13,13,Home,W 142-106 ,240,54,104,0.519,40,67,0.597,14,37,0.378,20,26,0.769,142,35,85,0.412,32,70,0.457,3,15,0.2,33,35,0.943,106,2016-12-05,GSW,IND
14,14,Home,W 142-139 (4OT),340,52,119,0.437,42,88,0.477,10,31,0.323,28,40,0.7,142,51,128,0.398,33,77,0.429,18,51,0.353,19,23,0.826,139,2017-01-29,ATL,NYK
15,15,Home,W 142-130 ,240,44,94,0.468,22,36,0.611,22,58,0.379,32,42,0.762,142,49,94,0.521,40,68,0.588,9,26,0.346,23,28,0.821,130,2017-02-25,HOU,MIN
16,16,Home,W 141-129 (2OT),290,56,101,0.554,46,78,0.59,10,23,0.435,19,24,0.792,141,48,93,0.516,34,66,0.515,14,27,0.519,19,26,0.731,129,2013-02-26,MIA,SAC
17,17,@,L 140-149 (2OT),290,49,100,0.49,35,64,0.547,14,36,0.389,28,36,0.778,140,60,113,0.531,50,86,0.581,10,27,0.37,19,20,0.95,149,2012-03-23,MIN,OKC
18,18,@,W 140-133 (3OT),315,46,93,0.495,32,67,0.478,14,26,0.538,34,43,0.791,140,51,108,0.472,43,84,0.512,8,24,0.333,23,30,0.767,133,2012-11-12,UTA,TOR
19,19,Home,W 140-109 ,240,46,91,0.505,23,51,0.451,23,40,0.575,25,35,0.714,140,41,86,0.477,38,71,0.535,3,15,0.2,24,30,0.8,109,2013-02-05,HOU,GSW
20,20,Home,W 140-106 ,240,51,82,0.622,33,47,0.702,18,35,0.514,20,28,0.714,140,44,85,0.518,39,72,0.542,5,13,0.385,13,21,0.619,106,2014-11-21,DAL,LAL
21,21,Home,W 140-132 (OT),265,47,91,0.516,25,54,0.463,22,37,0.595,24,33,0.727,140,44,88,0.5,33,56,0.589,11,32,0.344,33,52,0.635,132,2016-01-18,LAC,HOU
22,22,Home,W 140-116 ,240,45,81,0.556,31,41,0.756,14,40,0.35,36,43,0.837,140,45,96,0.469,32,63,0.508,13,33,0.394,13,16,0.813,116,2016-12-30,HOU,LAC
23,23,Home,W 140-112 ,240,52,91,0.571,37,59,0.627,15,32,0.469,21,23,0.913,140,44,94,0.468,32,65,0.492,12,29,0.414,12,13,0.923,112,2017-01-12,DEN,IND
24,24,@,W 140-135 (OT),265,49,92,0.533,30,54,0.556,19,38,0.5,23,28,0.821,140,50,99,0.505,38,70,0.543,12,29,0.414,23,26,0.885,135,2017-02-06,CLE,WAS
25,25,Home,W 139-133 (4OT),340,48,107,0.449,42,88,0.477,6,19,0.316,37,47,0.787,139,49,126,0.389,43,105,0.41,6,21,0.286,29,35,0.829,133,2012-03-25,ATL,UTA
26,26,@,W 139-105 ,240,52,93,0.559,31,56,0.554,21,37,0.568,14,20,0.7,139,39,87,0.448,30,72,0.417,9,15,0.6,18,26,0.692,105,2013-12-14,POR,PHI
27,27,Home,W 139-91 ,240,56,84,0.667,41,64,0.641,15,20,0.75,12,16,0.75,139,29,72,0.403,26,58,0.448,3,14,0.214,30,41,0.732,91,2014-11-14,NOP,MIN
28,28,@,W 139-136 (2OT),290,50,110,0.455,42,83,0.506,8,27,0.296,31,38,0.816,139,47,106,0.443,35,73,0.479,12,33,0.364,30,38,0.789,136,2015-10-30,OKC,ORL
29,29,Home,W 139-134 (OT),265,47,95,0.495,34,62,0.548,13,33,0.394,32,37,0.865,139,44,85,0.518,32,55,0.582,12,30,0.4,34,50,0.68,134,2016-02-10,BOS,LAC
30,30,Home,W 139-105 ,240,56,91,0.615,42,64,0.656,14,27,0.519,13,19,0.684,139,37,79,0.468,32,65,0.492,5,14,0.357,26,39,0.667,105,2016-03-29,ORL,BRK
31,31,@,L 139-142 (4OT),340,51,128,0.398,33,77,0.429,18,51,0.353,19,23,0.826,139,52,119,0.437,42,88,0.477,10,31,0.323,28,40,0.7,142,2017-01-29,NYK,ATL
32,32,@,W 138-113 ,240,52,95,0.547,40,67,0.597,12,28,0.429,22,31,0.71,138,39,84,0.464,33,65,0.508,6,19,0.316,29,35,0.829,113,2015-04-15,OKC,MIN
33,33,Home,W 138-109 ,240,49,78,0.628,35,57,0.614,14,21,0.667,26,34,0.765,138,41,91,0.451,30,59,0.508,11,32,0.344,16,21,0.762,109,2016-12-03,GSW,PHO
34,34,Home,W 137-97 ,240,51,86,0.593,36,58,0.621,15,28,0.536,20,24,0.833,137,32,84,0.381,24,64,0.375,8,20,0.4,25,32,0.781,97,2012-02-21,POR,SAS
35,35,Home,W 137-118 ,240,49,94,0.521,34,56,0.607,15,38,0.395,24,28,0.857,137,41,82,0.5,34,57,0.596,7,25,0.28,29,43,0.674,118,2013-11-04,LAC,HOU
36,36,@,W 137-115 ,240,53,99,0.535,41,70,0.586,12,29,0.414,19,24,0.792,137,42,89,0.472,39,68,0.574,3,21,0.143,28,36,0.778,115,2014-01-05,DEN,LAL
37,37,Home,W 137-107 ,240,52,92,0.565,37,65,0.569,15,27,0.556,18,25,0.72,137,35,74,0.473,33,65,0.508,2,9,0.222,35,45,0.778,107,2014-04-02,DEN,NOP
38,38,Home,W 137-134 (OT),265,41,99,0.414,30,64,0.469,11,35,0.314,44,49,0.898,137,46,90,0.511,33,63,0.524,13,27,0.481,29,35,0.829,134,2014-12-31,OKC,PHO
39,39,Home,W 137-105 ,240,52,97,0.536,35,67,0.522,17,30,0.567,16,23,0.696,137,36,92,0.391,24,58,0.414,12,34,0.353,21,28,0.75,105,2016-02-19,POR,GSW
40,40,Home,W 137-125 ,240,48,90,0.533,27,54,0.5,21,36,0.583,20,27,0.741,137,47,90,0.522,34,61,0.557,13,29,0.448,18,19,0.947,125,2016-11-23,CLE,POR
41,41,@,W 137-112 ,240,46,92,0.5,25,48,0.521,21,44,0.477,24,32,0.75,137,41,93,0.441,26,49,0.531,15,44,0.341,15,19,0.789,112,2017-01-15,HOU,BRK
42,42,@,W 137-112 ,240,52,82,0.634,45,65,0.692,7,17,0.412,26,35,0.743,137,38,91,0.418,27,63,0.429,11,28,0.393,25,30,0.833,112,2017-02-04,MIL,PHO
43,43,Home,W 137-101 ,240,49,88,0.557,39,64,0.609,10,24,0.417,29,34,0.853,137,35,93,0.376,26,67,0.388,9,26,0.346,22,28,0.786,101,2017-02-15,PHO,LAL
44,44,Home,W 136-103 ,240,46,80,0.575,32,46,0.696,14,34,0.412,30,40,0.75,136,38,80,0.475,26,53,0.491,12,27,0.444,15,24,0.625,103,2013-03-03,HOU,DAL
45,45,@,W 136-106 ,240,53,86,0.616,40,65,0.615,13,21,0.619,17,21,0.81,136,44,84,0.524,38,65,0.585,6,19,0.316,12,15,0.8,106,2013-03-08,POR,SAS
46,46,@,W 136-130 (2OT),290,53,108,0.491,47,84,0.56,6,24,0.25,24,29,0.828,136,40,97,0.412,32,72,0.444,8,25,0.32,42,54,0.778,130,2014-04-16,UTA,MIN
47,47,@,W 136-115 ,240,46,86,0.535,32,58,0.552,14,28,0.5,30,34,0.882,136,39,99,0.394,36,83,0.434,3,16,0.188,34,43,0.791,115,2014-11-16,GSW,LAL
48,48,Home,L 136-139 (2OT),290,47,106,0.443,35,73,0.479,12,33,0.364,30,38,0.789,136,50,110,0.455,42,83,0.506,8,27,0.296,31,38,0.816,139,2015-10-30,ORL,OKC
49,49,Home,W 136-111 ,240,50,88,0.568,32,58,0.552,18,30,0.6,18,22,0.818,136,38,85,0.447,29,61,0.475,9,24,0.375,26,33,0.788,111,2016-04-03,GSW,POR
50,50,@,W 136-130 (2OT),290,52,105,0.495,41,83,0.494,11,22,0.5,21,31,0.677,136,50,108,0.463,38,78,0.487,12,30,0.4,18,26,0.692,130,2016-12-20,ORL,MIA
51,51,@,W 136-106 ,240,54,95,0.568,44,72,0.611,10,23,0.435,18,21,0.857,136,43,88,0.489,29,54,0.537,14,34,0.412,6,7,0.857,106,2017-03-04,DET,PHI
52,52,Home,W 135-98 ,240,52,86,0.605,39,58,0.672,13,28,0.464,18,27,0.667,135,35,83,0.422,29,64,0.453,6,19,0.316,22,31,0.71,98,2013-11-16,NOP,PHI
53,53,Home,W 135-129 (OT),265,49,89,0.551,41,73,0.562,8,16,0.5,29,33,0.879,135,48,97,0.495,42,77,0.545,6,20,0.3,27,32,0.844,129,2014-12-27,SAC,NYK
54,54,@,W 135-131 ,240,56,91,0.615,52,76,0.684,4,15,0.267,19,24,0.792,135,45,93,0.484,31,62,0.5,14,31,0.452,27,33,0.818,131,2015-04-01,DAL,OKC
55,55,@,W 135-116 ,240,46,81,0.568,24,43,0.558,22,38,0.579,21,31,0.677,135,45,92,0.489,35,66,0.53,10,26,0.385,16,23,0.696,116,2015-11-27,GSW,PHO
56,56,Home,W 135-90 ,240,51,87,0.586,37,59,0.627,14,28,0.5,19,26,0.731,135,34,86,0.395,26,58,0.448,8,28,0.286,14,20,0.7,90,2016-12-17,GSW,POR
57,57,Home,L 135-140 (OT),265,50,99,0.505,38,70,0.543,12,29,0.414,23,26,0.885,135,49,92,0.533,30,54,0.556,19,38,0.5,23,28,0.821,140,2017-02-06,WAS,CLE
58,58,@,W 135-130 ,240,47,86,0.547,22,40,0.55,25,46,0.543,16,20,0.8,135,49,91,0.538,39,65,0.6,10,26,0.385,22,30,0.733,130,2017-03-03,CLE,ATL
59,59,@,W 134-126 (OT),265,48,92,0.522,34,62,0.548,14,30,0.467,24,26,0.923,134,41,97,0.423,25,67,0.373,16,30,0.533,28,36,0.778,126,2012-12-10,SAS,HOU
60,60,Home,W 134-104 ,240,54,93,0.581,33,60,0.55,21,33,0.636,5,7,0.714,134,34,79,0.43,27,63,0.429,7,16,0.438,29,36,0.806,104,2014-01-02,POR,CHA
61,61,@,W 134-108 ,240,52,104,0.5,34,69,0.493,18,35,0.514,12,25,0.48,134,41,84,0.488,27,57,0.474,14,27,0.519,12,15,0.8,108,2014-02-19,HOU,LAL
62,62,@,W 134-129 (3OT),315,51,108,0.472,46,86,0.535,5,22,0.227,27,37,0.73,134,45,100,0.45,33,70,0.471,12,30,0.4,27,36,0.75,129,2014-02-27,WAS,TOR
63,63,Home,W 134-126 ,240,54,99,0.545,40,75,0.533,14,24,0.583,12,21,0.571,134,45,97,0.464,33,70,0.471,12,27,0.444,24,30,0.8,126,2014-03-07,DEN,LAL
64,64,@,L 134-137 (OT),265,46,90,0.511,33,63,0.524,13,27,0.481,29,35,0.829,134,41,99,0.414,30,64,0.469,11,35,0.314,44,49,0.898,137,2014-12-31,PHO,OKC
65,65,@,W 134-120 ,240,46,84,0.548,29,54,0.537,17,30,0.567,25,35,0.714,134,46,100,0.46,38,78,0.487,8,22,0.364,20,23,0.87,120,2015-10-31,GSW,NOP
66,66,@,W 134-121 ,240,49,93,0.527,29,52,0.558,20,41,0.488,16,29,0.552,134,46,91,0.505,38,68,0.559,8,23,0.348,21,30,0.7,121,2016-02-03,GSW,WAS
67,67,@,L 134-139 (OT),265,44,85,0.518,32,55,0.582,12,30,0.4,34,50,0.68,134,47,95,0.495,34,62,0.548,13,33,0.394,32,37,0.865,139,2016-02-10,LAC,BOS
68,68,Home,W 134-95 ,240,51,94,0.543,36,58,0.621,15,36,0.417,17,21,0.81,134,34,87,0.391,29,67,0.433,5,20,0.25,22,27,0.815,95,2016-12-07,HOU,LAL
69,69,Home,W 134-94 ,240,49,81,0.605,39,60,0.65,10,21,0.476,26,29,0.897,134,35,85,0.412,29,65,0.446,6,20,0.3,18,25,0.72,94,2017-01-12,SAS,LAL
70,70,@,L 133-139 (4OT),340,49,126,0.389,43,105,0.41,6,21,0.286,29,35,0.829,133,48,107,0.449,42,88,0.477,6,19,0.316,37,47,0.787,139,2012-03-25,UTA,ATL
71,71,Home,L 133-140 (3OT),315,51,108,0.472,43,84,0.512,8,24,0.333,23,30,0.767,133,46,93,0.495,32,67,0.478,14,26,0.538,34,43,0.791,140,2012-11-12,TOR,UTA
72,72,@,W 133-102 ,240,55,98,0.561,42,74,0.568,13,24,0.542,10,14,0.714,133,35,87,0.402,29,64,0.453,6,23,0.261,26,35,0.743,102,2014-03-28,SAS,DEN
73,73,Home,W 133-132 (2OT),290,49,94,0.521,42,78,0.538,7,16,0.438,28,34,0.824,133,47,102,0.461,38,80,0.475,9,22,0.409,29,32,0.906,132,2014-12-08,WAS,BOS
74,74,Home,W 133-126 ,240,47,90,0.522,34,62,0.548,13,28,0.464,26,34,0.765,133,45,83,0.542,39,65,0.6,6,18,0.333,30,36,0.833,126,2015-04-15,GSW,DEN
75,75,Home,W 133-111 ,240,51,82,0.622,42,62,0.677,9,20,0.45,22,30,0.733,133,42,88,0.477,34,64,0.531,8,24,0.333,19,24,0.792,111,2016-03-27,SAC,DAL
76,76,Home,W 133-120 ,240,45,87,0.517,29,54,0.537,16,33,0.485,27,31,0.871,133,46,90,0.511,38,66,0.576,8,24,0.333,20,26,0.769,120,2016-11-13,GSW,PHO
77,77,Home,W 133-105 ,240,54,94,0.574,37,58,0.638,17,36,0.472,8,9,0.889,133,40,83,0.482,32,64,0.5,8,19,0.421,17,26,0.654,105,2016-12-10,LAC,NOP
78,78,@,W 133-120 ,240,52,99,0.525,38,65,0.585,14,34,0.412,15,18,0.833,133,40,80,0.5,30,55,0.545,10,25,0.4,30,39,0.769,120,2017-02-02,GSW,LAC
79,79,Home,W 133-102 ,240,42,85,0.494,24,49,0.49,18,36,0.5,31,39,0.795,133,37,94,0.394,29,72,0.403,8,22,0.364,20,26,0.769,102,2017-02-11,HOU,PHO
80,80,@,W 132-102 ,240,50,90,0.556,31,56,0.554,19,34,0.559,13,15,0.867,132,37,79,0.468,31,64,0.484,6,15,0.4,22,31,0.71,102,2012-12-08,SAS,CHA
81,81,Home,W 132-114 ,240,54,99,0.545,43,74,0.581,11,25,0.44,13,21,0.619,132,39,83,0.47,25,49,0.51,14,34,0.412,22,32,0.688,114,2013-04-06,DEN,HOU
82,82,@,W 132-128 ,240,38,80,0.475,34,64,0.531,4,16,0.25,52,64,0.813,132,50,95,0.526,38,62,0.613,12,33,0.364,16,25,0.64,128,2014-03-03,MIN,DEN
83,83,@,W 132-125 ,240,46,77,0.597,39,60,0.65,7,17,0.412,33,40,0.825,132,46,85,0.541,36,63,0.571,10,22,0.455,23,31,0.742,125,2014-03-04,NOP,LAL
84,84,@,W 132-129 (2OT),290,47,102,0.461,32,72,0.444,15,30,0.5,23,27,0.852,132,47,103,0.456,39,77,0.506,8,26,0.308,27,34,0.794,129,2014-12-02,DAL,CHI
85,85,@,L 132-133 (2OT),290,47,102,0.461,38,80,0.475,9,22,0.409,29,32,0.906,132,49,94,0.521,42,78,0.538,7,16,0.438,28,34,0.824,133,2014-12-08,BOS,WAS
86,86,Home,W 132-114 ,240,52,101,0.515,46,79,0.582,6,22,0.273,22,30,0.733,132,41,89,0.461,30,55,0.545,11,34,0.324,21,27,0.778,114,2015-10-30,SAC,LAL
87,87,@,W 132-98 ,240,46,85,0.541,27,45,0.6,19,40,0.475,21,27,0.778,132,37,77,0.481,30,58,0.517,7,19,0.368,17,25,0.68,98,2016-01-18,GSW,CLE
88,88,@,L 132-140 (OT),265,44,88,0.5,33,56,0.589,11,32,0.344,33,52,0.635,132,47,91,0.516,25,54,0.463,22,37,0.595,24,33,0.727,140,2016-01-18,HOU,LAC
89,89,Home,W 132-118 ,240,52,76,0.684,42,58,0.724,10,18,0.556,18,22,0.818,132,45,92,0.489,36,66,0.545,9,26,0.346,19,26,0.731,118,2016-03-05,MIN,BRK
90,90,Home,W 132-120 (OT),265,49,89,0.551,34,64,0.531,15,25,0.6,19,23,0.826,132,42,104,0.404,24,58,0.414,18,46,0.391,18,28,0.643,120,2016-03-20,DAL,POR
91,91,@,W 132-129 (2OT),290,51,96,0.531,43,70,0.614,8,26,0.308,22,22,1.0,132,50,100,0.5,37,71,0.521,13,29,0.448,16,23,0.696,129,2016-03-25,MIN,WAS
92,92,@,W 132-129 (OT),265,48,95,0.505,35,69,0.507,13,26,0.5,23,29,0.793,132,48,101,0.475,36,67,0.537,12,34,0.353,21,27,0.778,129,2016-11-25,OKC,DEN
93,93,@,W 132-127 (2OT),290,48,108,0.444,34,64,0.531,14,44,0.318,22,30,0.733,132,43,104,0.413,31,60,0.517,12,44,0.273,29,37,0.784,127,2016-12-01,HOU,GSW
94,94,Home,W 132-98 ,240,50,85,0.588,28,43,0.651,22,42,0.524,10,16,0.625,132,39,92,0.424,28,60,0.467,11,32,0.344,9,11,0.818,98,2016-12-14,HOU,SAC
95,95,Home,W 132-120 ,240,43,84,0.512,28,53,0.528,15,31,0.484,31,35,0.886,132,41,88,0.466,33,65,0.508,8,23,0.348,30,36,0.833,120,2016-12-15,DEN,POR
96,96,Home,W 132-113 ,240,52,97,0.536,41,69,0.594,11,28,0.393,17,21,0.81,132,40,86,0.465,23,50,0.46,17,36,0.472,16,20,0.8,113,2017-01-13,TOR,BRK
97,97,@,W 132-117 ,240,46,84,0.548,30,48,0.625,16,36,0.444,24,26,0.923,132,41,82,0.5,28,57,0.491,13,25,0.52,22,26,0.846,117,2017-02-08,CLE,IND
98,98,Home,W 132-110 ,240,48,88,0.545,24,47,0.511,24,41,0.585,12,16,0.75,132,45,92,0.489,37,60,0.617,8,32,0.25,12,13,0.923,110,2017-02-13,DEN,GSW
99,99,@,W 131-102 ,240,56,89,0.629,51,79,0.646,5,10,0.5,14,20,0.7,131,40,89,0.449,30,62,0.484,10,27,0.37,12,19,0.632,102,2012-04-26,DEN,MIN
100,0,Home,W 131-103 ,240,46,89,0.517,32,64,0.5,14,25,0.56,25,28,0.893,131,37,86,0.43,20,47,0.426,17,39,0.436,12,14,0.857,103,2012-11-23,HOU,NYK
101,1,Home,W 131-99 ,240,45,91,0.495,32,68,0.471,13,23,0.565,28,35,0.8,131,33,82,0.402,26,58,0.448,7,24,0.292,26,31,0.839,99,2012-12-07,UTA,TOR
102,2,Home,W 131-127 ,240,43,86,0.5,32,67,0.478,11,19,0.579,34,42,0.81,131,46,92,0.5,33,66,0.5,13,26,0.5,22,25,0.88,127,2012-12-19,SAC,GSW
103,3,Home,W 131-102 ,240,51,100,0.51,37,73,0.507,14,27,0.519,15,17,0.882,131,37,73,0.507,31,54,0.574,6,19,0.316,22,28,0.786,102,2013-04-01,MIL,CHA
104,4,@,W 131-128 (3OT),315,50,113,0.442,39,90,0.433,11,23,0.478,20,27,0.741,131,48,101,0.475,40,78,0.513,8,23,0.348,24,34,0.706,128,2013-12-02,NOP,CHI
105,5,Home,W 131-102 ,240,45,89,0.506,32,59,0.542,13,30,0.433,28,30,0.933,131,37,94,0.394,24,67,0.358,13,27,0.481,15,25,0.6,102,2014-03-13,OKC,LAL
106,6,Home,W 131-109 ,240,42,76,0.553,34,56,0.607,8,20,0.4,39,50,0.78,131,37,82,0.451,28,54,0.519,9,28,0.321,26,31,0.839,109,2014-11-05,SAC,DEN
107,7,Home,W 131-117 ,240,52,94,0.553,44,68,0.647,8,26,0.308,19,23,0.826,131,43,86,0.5,36,69,0.522,7,17,0.412,24,29,0.828,117,2014-11-15,DAL,MIN
108,8,@,W 131-106 ,240,50,91,0.549,41,69,0.594,9,22,0.409,22,33,0.667,131,37,88,0.42,30,65,0.462,7,23,0.304,25,34,0.735,106,2015-01-17,GSW,HOU
109,9,Home,W 131-108 ,240,46,88,0.523,38,68,0.559,8,20,0.4,31,38,0.816,131,42,90,0.467,30,58,0.517,12,32,0.375,12,17,0.706,108,2015-02-08,OKC,LAC
110,10,Home,L 131-135 ,240,45,93,0.484,31,62,0.5,14,31,0.452,27,33,0.818,131,56,91,0.615,52,76,0.684,4,15,0.267,19,24,0.792,135,2015-04-01,OKC,DAL
111,11,Home,W 131-99 ,240,49,82,0.598,32,49,0.653,17,33,0.515,16,19,0.842,131,39,80,0.488,29,57,0.509,10,23,0.435,11,17,0.647,99,2015-04-04,ATL,BRK
112,12,@,W 131-123 ,240,52,95,0.547,36,60,0.6,16,35,0.457,11,15,0.733,131,44,100,0.44,30,67,0.448,14,33,0.424,21,26,0.808,123,2015-12-08,GSW,IND
113,13,Home,W 131-123 ,240,43,86,0.5,35,64,0.547,8,22,0.364,37,40,0.925,131,49,100,0.49,39,84,0.464,10,16,0.625,15,22,0.682,123,2015-12-29,OKC,MIL
114,14,@,W 131-116 ,240,47,82,0.573,33,48,0.688,14,34,0.412,23,26,0.885,131,48,107,0.449,41,82,0.5,7,25,0.28,13,19,0.684,116,2016-02-29,OKC,SAC
115,15,Home,W 131-114 ,240,47,90,0.522,37,66,0.561,10,24,0.417,27,31,0.871,131,41,88,0.466,30,58,0.517,11,30,0.367,21,26,0.808,114,2016-03-15,BRK,PHI
116,16,Home,W 131-109 ,240,51,94,0.543,39,62,0.629,12,32,0.375,17,19,0.895,131,36,72,0.5,30,58,0.517,6,14,0.429,31,35,0.886,109,2016-11-30,POR,IND
117,17,@,W 131-120 ,240,51,87,0.586,36,53,0.679,15,34,0.441,14,20,0.7,131,45,89,0.506,34,61,0.557,11,28,0.393,19,21,0.905,120,2016-12-13,ORL,ATL
118,18,Home,W 131-115 ,240,46,92,0.5,31,49,0.633,15,43,0.349,24,30,0.8,131,43,101,0.426,36,71,0.507,7,30,0.233,22,27,0.815,115,2016-12-26,HOU,PHO
119,19,@,W 131-123 ,240,54,95,0.568,38,63,0.603,16,32,0.5,7,10,0.7,131,52,93,0.559,36,55,0.655,16,38,0.421,3,5,0.6,123,2017-02-10,DEN,NYK
120,20,@,W 131-127 ,240,41,90,0.456,34,72,0.472,7,18,0.389,42,53,0.792,131,44,88,0.5,31,61,0.508,13,27,0.481,26,33,0.788,127,2017-03-07,WAS,PHO
121,21,Home,W 130-102 ,240,51,84,0.607,42,64,0.656,9,20,0.45,19,23,0.826,130,39,85,0.459,32,64,0.5,7,21,0.333,17,19,0.895,102,2013-03-01,SAS,SAC
122,22,Home,W 130-98 ,240,46,83,0.554,29,60,0.483,17,23,0.739,21,24,0.875,130,39,93,0.419,35,82,0.427,4,11,0.364,16,19,0.842,98,2013-12-06,POR,UTA
123,23,Home,W 130-94 ,240,47,78,0.603,26,43,0.605,21,35,0.6,15,26,0.577,130,37,90,0.411,29,60,0.483,8,30,0.267,12,20,0.6,94,2013-12-16,BRK,PHI
124,24,@,W 130-110 ,240,48,84,0.571,36,64,0.563,12,20,0.6,22,29,0.759,130,43,88,0.489,35,64,0.547,8,24,0.333,16,23,0.696,110,2014-02-24,MIL,PHI
125,25,Home,W 130-102 ,240,52,90,0.578,35,57,0.614,17,33,0.515,9,9,1.0,130,39,86,0.453,35,73,0.479,4,13,0.308,20,28,0.714,102,2014-04-06,GSW,UTA
126,26,Home,W 130-125 (OT),265,45,98,0.459,32,62,0.516,13,36,0.361,27,40,0.675,130,51,107,0.477,37,76,0.487,14,31,0.452,9,13,0.692,125,2014-04-06,HOU,DEN
127,27,Home,L 130-145 ,240,44,95,0.463,30,63,0.476,14,32,0.438,28,35,0.8,130,56,97,0.577,45,71,0.634,11,26,0.423,22,28,0.786,145,2014-04-08,LAL,HOU
128,28,Home,W 130-120 ,240,49,101,0.485,34,64,0.531,15,37,0.405,17,19,0.895,130,43,81,0.531,35,66,0.53,8,15,0.533,26,33,0.788,120,2014-04-14,GSW,MIN
129,29,Home,L 130-136 (2OT),290,40,97,0.412,32,72,0.444,8,25,0.32,42,54,0.778,130,53,108,0.491,47,84,0.56,6,24,0.25,24,29,0.828,136,2014-04-16,MIN,UTA
130,30,@,W 130-113 ,240,45,88,0.511,29,55,0.527,16,33,0.485,24,29,0.828,130,39,90,0.433,31,67,0.463,8,23,0.348,27,33,0.818,113,2014-11-12,POR,DEN
131,31,Home,W 130-105 ,240,53,88,0.602,33,52,0.635,20,36,0.556,4,7,0.571,130,39,81,0.481,31,61,0.508,8,20,0.4,19,20,0.95,105,2015-03-09,ATL,SAC
132,32,Home,W 130-91 ,240,51,88,0.58,38,67,0.567,13,21,0.619,15,19,0.789,130,36,90,0.4,30,72,0.417,6,18,0.333,13,14,0.929,91,2015-03-25,SAS,OKC
133,33,Home,W 130-105 ,240,47,91,0.516,33,68,0.485,14,23,0.609,22,23,0.957,130,44,90,0.489,30,60,0.5,14,30,0.467,3,8,0.375,105,2015-11-03,CHA,CHI
134,34,@,W 130-125 ,240,44,78,0.564,33,54,0.611,11,24,0.458,31,39,0.795,130,45,96,0.469,28,61,0.459,17,35,0.486,18,22,0.818,125,2015-12-20,NOP,DEN
135,35,Home,W 130-99 ,240,49,81,0.605,37,58,0.638,12,23,0.522,20,25,0.8,130,41,89,0.461,32,66,0.485,9,23,0.391,8,17,0.471,99,2016-01-02,LAC,PHI
136,36,Home,W 130-99 ,240,50,90,0.556,38,67,0.567,12,23,0.522,18,21,0.857,130,28,73,0.384,20,43,0.465,8,30,0.267,35,52,0.673,99,2016-01-27,SAS,HOU
137,37,@,W 130-114 ,240,53,88,0.602,40,63,0.635,13,25,0.52,11,16,0.688,130,41,90,0.456,31,64,0.484,10,26,0.385,22,28,0.786,114,2016-02-25,GSW,ORL
138,38,Home,W 130-116 ,240,49,86,0.57,39,70,0.557,10,16,0.625,22,25,0.88,130,41,77,0.532,36,55,0.655,5,22,0.227,29,37,0.784,116,2016-02-28,ORL,PHI
139,39,Home,W 130-81 ,240,46,85,0.541,30,52,0.577,16,33,0.485,22,34,0.647,130,30,101,0.297,26,84,0.31,4,17,0.235,17,28,0.607,81,2016-03-14,HOU,MEM
140,40,@,W 130-109 ,240,47,96,0.49,35,67,0.522,12,29,0.414,24,30,0.8,130,40,93,0.43,35,74,0.473,5,19,0.263,24,27,0.889,109,2016-03-16,OKC,BOS
141,41,@,W 130-112 ,240,48,95,0.505,26,57,0.456,22,38,0.579,12,14,0.857,130,41,93,0.441,32,64,0.5,9,29,0.31,21,22,0.955,112,2016-03-18,GSW,DAL
142,42,Home,W 130-110 ,240,50,98,0.51,33,57,0.579,17,41,0.415,13,18,0.722,130,41,83,0.494,29,55,0.527,12,28,0.429,16,19,0.842,110,2016-04-10,HOU,LAL
143,43,Home,W 130-121 (OT),265,47,93,0.505,37,74,0.5,10,19,0.526,26,34,0.765,130,45,104,0.433,27,56,0.482,18,48,0.375,13,18,0.722,121,2016-10-26,IND,DAL
144,44,@,W 130-114 ,240,46,82,0.561,29,46,0.63,17,36,0.472,21,28,0.75,130,40,83,0.482,28,50,0.56,12,33,0.364,22,29,0.759,114,2016-11-27,HOU,POR
145,45,Home,W 130-101 ,240,50,94,0.532,36,68,0.529,14,26,0.538,16,18,0.889,130,36,87,0.414,29,60,0.483,7,27,0.259,22,25,0.88,101,2016-12-10,SAS,BRK
146,46,Home,L 130-136 (2OT),290,50,108,0.463,38,78,0.487,12,30,0.4,18,26,0.692,130,52,105,0.495,41,83,0.494,11,22,0.5,21,31,0.677,136,2016-12-20,MIA,ORL
147,47,@,W 130-114 ,240,46,87,0.529,33,56,0.589,13,31,0.419,25,35,0.714,130,40,83,0.482,34,59,0.576,6,24,0.25,28,36,0.778,114,2017-02-11,GSW,OKC
148,48,@,L 130-142 ,240,49,94,0.521,40,68,0.588,9,26,0.346,23,28,0.821,130,44,94,0.468,22,36,0.611,22,58,0.379,32,42,0.762,142,2017-02-25,MIN,HOU
149,49,Home,W 130-112 ,240,48,86,0.558,36,61,0.59,12,25,0.48,22,29,0.759,130,43,83,0.518,36,62,0.581,7,21,0.333,19,24,0.792,112,2017-02-28,MEM,PHO
150,50,Home,L 130-135 ,240,49,91,0.538,39,65,0.6,10,26,0.385,22,30,0.733,130,47,86,0.547,22,40,0.55,25,46,0.543,16,20,0.8,135,2017-03-03,ATL,CLE
151,51,Home,W 130-116 ,240,49,86,0.57,33,61,0.541,16,25,0.64,16,22,0.727,130,45,86,0.523,31,56,0.554,14,30,0.467,12,17,0.706,116,2017-03-04,POR,BRK
152,52,Home,W 129-90 ,240,48,80,0.6,41,69,0.594,7,11,0.636,26,31,0.839,129,35,92,0.38,29,74,0.392,6,18,0.333,14,21,0.667,90,2012-01-01,MIA,CHA
153,53,Home,W 129-91 ,240,47,84,0.56,27,54,0.5,20,30,0.667,15,19,0.789,129,34,74,0.459,29,60,0.483,5,14,0.357,18,29,0.621,91,2012-12-23,SAS,DAL
154,54,@,L 129-141 (2OT),290,48,93,0.516,34,66,0.515,14,27,0.519,19,26,0.731,129,56,101,0.554,46,78,0.59,10,23,0.435,19,24,0.792,141,2013-02-26,SAC,MIA
155,55,Home,W 129-97 ,240,50,80,0.625,36,52,0.692,14,28,0.5,15,25,0.6,129,30,64,0.469,19,41,0.463,11,23,0.478,26,42,0.619,97,2013-03-10,LAC,DET
156,56,Home,W 129-98 ,240,43,83,0.518,29,52,0.558,14,31,0.452,29,38,0.763,129,35,91,0.385,31,73,0.425,4,18,0.222,24,32,0.75,98,2014-01-07,DEN,BOS
157,57,Home,W 129-127 ,240,42,83,0.506,25,49,0.51,17,34,0.5,28,37,0.757,129,51,97,0.526,39,72,0.542,12,25,0.48,13,21,0.619,127,2014-01-15,LAC,DAL
158,58,Home,W 129-121 (2OT),290,49,99,0.495,40,83,0.482,9,16,0.563,22,26,0.846,129,45,95,0.474,30,61,0.492,15,34,0.441,16,23,0.696,121,2014-02-21,ORL,NYK
159,59,@,W 129-103 ,240,41,72,0.569,30,50,0.6,11,22,0.5,36,42,0.857,129,36,90,0.4,31,72,0.431,5,18,0.278,26,31,0.839,103,2014-02-25,HOU,SAC
160,60,Home,L 129-134 (3OT),315,45,100,0.45,33,70,0.471,12,30,0.4,27,36,0.75,129,51,108,0.472,46,86,0.535,5,22,0.227,27,37,0.73,134,2014-02-27,TOR,WAS
161,61,Home,W 129-120 ,240,44,80,0.55,29,56,0.518,15,24,0.625,26,30,0.867,129,44,84,0.524,30,53,0.566,14,31,0.452,18,26,0.692,120,2014-03-02,PHO,ATL
162,62,Home,W 129-106 ,240,49,85,0.576,33,47,0.702,16,38,0.421,15,19,0.789,129,38,87,0.437,26,59,0.441,12,28,0.429,18,23,0.783,106,2014-03-20,HOU,MIN
163,63,Home,W 129-122 (OT),265,47,96,0.49,37,72,0.514,10,24,0.417,25,34,0.735,129,45,104,0.433,36,70,0.514,9,34,0.265,23,31,0.742,122,2014-11-30,LAL,TOR
164,64,Home,L 129-132 (2OT),290,47,103,0.456,39,77,0.506,8,26,0.308,27,34,0.794,129,47,102,0.461,32,72,0.444,15,30,0.5,23,27,0.852,132,2014-12-02,CHI,DAL
165,65,@,W 129-119 (3OT),315,47,110,0.427,34,75,0.453,13,35,0.371,22,23,0.957,129,45,109,0.413,37,89,0.416,8,20,0.4,21,26,0.808,119,2014-12-19,POR,SAS
166,66,Home,W 129-120 ,240,40,74,0.541,34,62,0.548,6,12,0.5,43,47,0.915,129,44,100,0.44,35,70,0.5,9,30,0.3,23,32,0.719,120,2014-12-22,CHI,TOR
167,67,@,L 129-135 (OT),265,48,97,0.495,42,77,0.545,6,20,0.3,27,32,0.844,129,49,89,0.551,41,73,0.562,8,16,0.5,29,33,0.879,135,2014-12-27,NYK,SAC
168,68,Home,W 129-90 ,240,46,89,0.517,31,61,0.508,15,28,0.536,22,28,0.786,129,36,89,0.404,34,73,0.466,2,16,0.125,16,24,0.667,90,2015-01-23,CLE,CHO
169,69,Home,W 129-99 ,240,51,84,0.607,35,56,0.625,16,28,0.571,11,16,0.688,129,41,82,0.5,29,50,0.58,12,32,0.375,5,12,0.417,99,2015-03-13,DAL,LAC
170,70,Home,W 129-127 (3OT),315,46,107,0.43,35,82,0.427,11,25,0.44,26,34,0.765,129,49,129,0.38,41,113,0.363,8,16,0.5,21,29,0.724,127,2015-03-20,BRK,MIL
171,71,@,W 129-116 ,240,48,89,0.539,30,51,0.588,18,38,0.474,15,16,0.938,129,43,87,0.494,40,78,0.513,3,9,0.333,27,36,0.75,116,2015-11-12,GSW,MIN
172,72,@,W 129-118 ,240,44,77,0.571,34,54,0.63,10,23,0.435,31,37,0.838,129,42,88,0.477,29,57,0.509,13,31,0.419,21,27,0.778,118,2015-11-25,SAC,MIL
173,73,Home,W 129-126 ,240,46,91,0.505,36,65,0.554,10,26,0.385,27,38,0.711,129,48,82,0.585,39,62,0.629,9,20,0.45,21,30,0.7,126,2016-01-17,DEN,IND
174,74,@,W 129-128 (2OT),290,44,110,0.4,24,66,0.364,20,44,0.455,21,26,0.808,129,48,91,0.527,41,68,0.603,7,23,0.304,25,32,0.781,128,2016-01-25,CHA,SAC
175,75,Home,W 129-103 ,240,41,85,0.482,28,51,0.549,13,34,0.382,34,36,0.944,129,37,77,0.481,25,49,0.51,12,28,0.429,17,27,0.63,103,2016-02-21,DAL,PHI
176,76,Home,W 129-111 ,240,52,77,0.675,46,65,0.708,6,12,0.5,19,25,0.76,129,41,90,0.456,30,67,0.448,11,23,0.478,18,26,0.692,111,2016-03-01,MIA,CHI
177,77,Home,L 129-132 (2OT),290,50,100,0.5,37,71,0.521,13,29,0.448,16,23,0.696,129,51,96,0.531,43,70,0.614,8,26,0.308,22,22,1.0,132,2016-03-25,WAS,MIN
178,78,Home,W 129-105 ,240,48,86,0.558,37,59,0.627,11,27,0.407,22,27,0.815,129,35,91,0.385,21,54,0.389,14,37,0.378,21,26,0.808,105,2016-04-10,IND,BRK
179,79,@,W 129-105 ,240,48,86,0.558,33,56,0.589,15,30,0.5,18,26,0.692,129,38,83,0.458,33,62,0.532,5,21,0.238,24,33,0.727,105,2016-04-11,HOU,MIN
180,80,@,W 129-100 ,240,47,98,0.48,35,74,0.473,12,24,0.5,23,26,0.885,129,40,85,0.471,33,52,0.635,7,33,0.212,13,18,0.722,100,2016-10-25,SAS,GSW
181,81,@,W 129-109 ,240,49,85,0.576,34,49,0.694,15,36,0.417,16,21,0.762,129,37,93,0.398,27,58,0.466,10,35,0.286,25,31,0.806,109,2016-11-20,POR,BRK
182,82,Home,L 129-132 (OT),265,48,101,0.475,36,67,0.537,12,34,0.353,21,27,0.778,129,48,95,0.505,35,69,0.507,13,26,0.5,23,29,0.793,132,2016-11-25,DEN,OKC
183,83,Home,W 129-122 ,240,42,92,0.457,21,37,0.568,21,55,0.382,24,29,0.828,129,47,105,0.448,37,73,0.507,10,32,0.313,18,25,0.72,122,2016-12-31,HOU,NYK
184,84,@,W 129-122 ,240,46,89,0.517,35,51,0.686,11,38,0.289,26,31,0.839,129,42,78,0.538,31,53,0.585,11,25,0.44,27,30,0.9,122,2017-01-08,HOU,TOR
185,85,Home,W 129-109 ,240,47,92,0.511,38,72,0.528,9,20,0.45,26,32,0.813,129,41,85,0.482,34,64,0.531,7,21,0.333,20,25,0.8,109,2017-01-28,MIN,BRK
186,86,@,W 129-125 ,240,50,88,0.568,43,73,0.589,7,15,0.467,22,32,0.688,129,46,88,0.523,32,52,0.615,14,36,0.389,19,23,0.826,125,2017-02-15,MIL,BRK
187,87,@,W 129-99 ,240,45,91,0.495,25,40,0.625,20,51,0.392,19,24,0.792,129,36,86,0.419,30,55,0.545,6,31,0.194,21,26,0.808,99,2017-02-23,HOU,NOP
188,88,Home,W 129-109 ,240,49,97,0.505,35,66,0.53,14,31,0.452,17,24,0.708,129,41,83,0.494,31,53,0.585,10,30,0.333,17,31,0.548,109,2017-02-24,DEN,BRK
189,89,Home,W 128-95 ,240,50,92,0.543,42,76,0.553,8,16,0.5,20,27,0.741,128,36,87,0.414,30,68,0.441,6,19,0.316,17,22,0.773,95,2012-01-21,MEM,SAC
190,90,Home,W 128-103 ,240,51,84,0.607,42,66,0.636,9,18,0.5,17,21,0.81,128,36,77,0.468,31,65,0.477,5,12,0.417,26,35,0.743,103,2012-04-06,SAS,NOH
191,91,@,W 128-99 ,240,45,80,0.563,28,43,0.651,17,37,0.459,21,24,0.875,128,38,87,0.437,29,69,0.42,9,18,0.5,14,19,0.737,99,2013-01-12,MIA,SAC
192,92,Home,W 128-96 ,240,50,86,0.581,41,67,0.612,9,19,0.474,19,23,0.826,128,38,91,0.418,28,64,0.438,10,27,0.37,10,14,0.714,96,2013-02-07,DEN,CHI
193,93,Home,L 128-131 (3OT),315,48,101,0.475,40,78,0.513,8,23,0.348,24,34,0.706,128,50,113,0.442,39,90,0.433,11,23,0.478,20,27,0.741,131,2013-12-02,CHI,NOP
194,94,@,W 128-125 (3OT),315,48,113,0.425,36,80,0.45,12,33,0.364,20,23,0.87,128,53,104,0.51,47,78,0.603,6,26,0.231,13,16,0.813,125,2014-01-15,CHI,ORL
195,95,Home,L 128-132 ,240,50,95,0.526,38,62,0.613,12,33,0.364,16,25,0.64,128,38,80,0.475,34,64,0.531,4,16,0.25,52,64,0.813,132,2014-03-03,DEN,MIN
196,96,Home,W 128-122 ,240,42,80,0.525,27,53,0.509,15,27,0.556,29,39,0.744,128,45,90,0.5,32,57,0.561,13,33,0.394,19,19,1.0,122,2014-03-06,PHO,OKC
197,97,Home,W 128-119 (OT),265,45,90,0.5,30,52,0.577,15,38,0.395,23,28,0.821,128,46,93,0.495,34,60,0.567,12,33,0.364,15,19,0.789,119,2014-03-25,DAL,OKC
198,98,@,W 128-122 (OT),265,44,86,0.512,33,62,0.532,11,24,0.458,29,35,0.829,128,47,101,0.465,39,74,0.527,8,27,0.296,20,25,0.8,122,2014-12-14,GSW,NOP
199,99,Home,W 128-108 ,240,49,91,0.538,40,66,0.606,9,25,0.36,21,24,0.875,128,43,90,0.478,35,73,0.479,8,17,0.471,14,21,0.667,108,2014-12-22,GSW,SAC
200,0,Home,W 128-118 ,240,49,94,0.521,39,70,0.557,10,24,0.417,20,24,0.833,128,48,97,0.495,42,82,0.512,6,15,0.4,16,16,1.0,118,2015-01-21,DET,ORL
201,1,Home,W 128-114 ,240,45,86,0.523,26,48,0.542,19,38,0.5,19,25,0.76,128,41,98,0.418,31,68,0.456,10,30,0.333,22,28,0.786,114,2015-02-04,GSW,DAL
202,2,@,W 128-125 (OT),265,44,91,0.484,30,65,0.462,14,26,0.538,26,30,0.867,128,49,87,0.563,41,61,0.672,8,26,0.308,19,27,0.704,125,2015-03-12,CLE,SAS
203,3,Home,W 128-103 ,240,46,88,0.523,31,56,0.554,15,32,0.469,21,27,0.778,128,41,91,0.451,36,69,0.522,5,22,0.227,16,18,0.889,103,2015-12-16,GSW,PHO
204,4,@,W 128-108 ,240,46,87,0.529,28,55,0.509,18,32,0.563,18,21,0.857,128,38,96,0.396,26,63,0.413,12,33,0.364,20,28,0.714,108,2016-01-08,GSW,POR
205,5,@,W 128-116 ,240,49,87,0.563,30,50,0.6,19,37,0.514,11,15,0.733,128,43,92,0.467,35,69,0.507,8,23,0.348,22,29,0.759,116,2016-01-09,GSW,SAC
206,6,Home,L 128-129 (2OT),290,48,91,0.527,41,68,0.603,7,23,0.304,25,32,0.781,128,44,110,0.4,24,66,0.364,20,44,0.455,21,26,0.808,129,2016-01-25,SAC,CHO
207,7,@,W 128-122 (OT),265,46,99,0.465,35,79,0.443,11,20,0.55,25,29,0.862,128,44,95,0.463,33,72,0.458,11,23,0.478,23,30,0.767,122,2016-01-26,OKC,NYK
208,8,Home,W 128-119 ,240,48,86,0.558,30,58,0.517,18,28,0.643,14,15,0.933,128,45,89,0.506,37,63,0.587,8,26,0.308,21,22,0.955,119,2016-02-05,BRK,SAC
209,9,Home,W 128-119 ,240,51,91,0.56,38,67,0.567,13,24,0.542,13,15,0.867,128,47,95,0.495,37,69,0.536,10,26,0.385,15,19,0.789,119,2016-02-07,BOS,SAC
210,10,Home,W 128-119 ,240,48,85,0.565,35,58,0.603,13,27,0.481,19,29,0.655,128,39,88,0.443,22,49,0.449,17,39,0.436,24,33,0.727,119,2016-02-24,MEM,LAL
211,11,Home,W 128-101 ,240,47,89,0.528,34,53,0.642,13,36,0.361,21,21,1.0,128,34,90,0.378,27,67,0.403,7,23,0.304,26,37,0.703,101,2016-02-28,DAL,MIN
212,12,Home,W 128-121 ,240,48,81,0.593,40,66,0.606,8,15,0.533,24,33,0.727,128,41,87,0.471,26,51,0.51,15,36,0.417,24,35,0.686,121,2016-02-29,MIL,HOU
213,13,@,W 128-97 ,240,46,82,0.561,30,58,0.517,16,24,0.667,20,24,0.833,128,39,89,0.438,30,60,0.5,9,29,0.31,10,15,0.667,97,2016-03-09,NYK,PHO
214,14,Home,W 128-112 ,240,40,89,0.449,22,49,0.449,18,40,0.45,30,39,0.769,128,37,86,0.43,18,50,0.36,19,36,0.528,19,23,0.826,112,2016-03-11,GSW,POR
215,15,Home,W 128-94 ,240,49,83,0.59,40,66,0.606,9,17,0.529,21,26,0.808,128,31,91,0.341,24,64,0.375,7,27,0.259,25,27,0.926,94,2016-03-14,OKC,POR
216,16,Home,W 128-120 ,240,43,88,0.489,22,43,0.512,21,45,0.467,21,23,0.913,128,43,96,0.448,25,61,0.41,18,35,0.514,16,21,0.762,120,2016-03-25,GSW,DAL
217,17,Home,W 128-120 ,240,43,83,0.518,27,51,0.529,16,32,0.5,26,31,0.839,128,43,90,0.478,26,46,0.565,17,44,0.386,17,25,0.68,120,2016-11-01,CLE,HOU
218,18,Home,W 128-122 ,240,41,84,0.488,27,50,0.54,14,34,0.412,32,37,0.865,128,46,96,0.479,35,64,0.547,11,32,0.344,19,22,0.864,122,2016-11-03,CLE,BOS
219,19,Home,W 128-90 ,240,43,85,0.506,23,42,0.548,20,43,0.465,22,24,0.917,128,37,91,0.407,29,56,0.518,8,35,0.229,8,12,0.667,90,2016-11-25,CLE,DAL
220,20,@,W 128-110 ,240,45,88,0.511,28,51,0.549,17,37,0.459,21,25,0.84,128,46,104,0.442,37,73,0.507,9,31,0.29,9,16,0.563,110,2016-12-02,HOU,DEN
221,21,Home,W 128-84 ,240,53,92,0.576,40,68,0.588,13,24,0.542,9,11,0.818,128,35,88,0.398,28,60,0.467,7,28,0.25,7,14,0.5,84,2016-12-03,TOR,ATL
222,22,@,W 128-119 (OT),265,50,103,0.485,37,70,0.529,13,33,0.394,15,19,0.789,128,41,83,0.494,33,53,0.623,8,30,0.267,29,39,0.744,119,2017-01-06,MEM,GSW
223,23,Home,W 128-98 ,240,50,89,0.562,34,55,0.618,16,34,0.471,12,15,0.8,128,38,87,0.437,29,62,0.468,9,25,0.36,13,18,0.722,98,2017-01-27,BOS,ORL
224,24,@,W 128-100 ,240,49,81,0.605,43,66,0.652,6,15,0.4,24,30,0.8,128,38,100,0.38,28,63,0.444,10,37,0.27,14,17,0.824,100,2017-02-01,CHI,OKC
225,25,Home,W 128-104 ,240,44,89,0.494,28,51,0.549,16,38,0.421,24,36,0.667,128,42,88,0.477,36,63,0.571,6,25,0.24,14,20,0.7,104,2017-02-07,HOU,ORL
226,26,Home,W 128-121 (OT),265,46,98,0.469,34,72,0.472,12,26,0.462,24,31,0.774,128,49,93,0.527,41,69,0.594,8,24,0.333,15,25,0.6,121,2017-02-24,CHI,PHO
227,27,@,W 127-124 ,240,50,89,0.562,36,67,0.537,14,22,0.636,13,21,0.619,127,46,89,0.517,37,68,0.544,9,21,0.429,23,29,0.793,124,2012-03-12,MIN,PHO
228,28,@,W 127-102 ,240,47,80,0.588,39,59,0.661,8,21,0.381,25,31,0.806,127,41,92,0.446,35,71,0.493,6,21,0.286,14,20,0.7,102,2012-04-18,SAS,SAC
229,29,@,L 127-131 ,240,46,92,0.5,33,66,0.5,13,26,0.5,22,25,0.88,127,43,86,0.5,32,67,0.478,11,19,0.579,34,42,0.81,131,2012-12-19,GSW,SAC
230,30,Home,W 127-96 ,240,50,87,0.575,36,66,0.545,14,21,0.667,13,18,0.722,127,39,83,0.47,32,65,0.492,7,18,0.389,11,15,0.733,96,2013-02-08,OKC,PHO
231,31,Home,W 127-111 ,240,48,83,0.578,39,69,0.565,9,14,0.643,22,22,1.0,127,41,85,0.482,35,68,0.515,6,17,0.353,23,29,0.793,111,2013-02-22,OKC,MIN
232,32,Home,W 127-105 ,240,48,93,0.516,34,72,0.472,14,21,0.667,17,20,0.85,127,42,88,0.477,36,67,0.537,6,21,0.286,15,20,0.75,105,2013-03-16,WAS,PHO
233,33,@,W 127-113 ,240,51,89,0.573,38,67,0.567,13,22,0.591,12,14,0.857,127,42,75,0.56,34,54,0.63,8,21,0.381,21,29,0.724,113,2013-03-18,DAL,ATL
234,34,Home,W 127-125 (2OT),290,46,102,0.451,33,71,0.465,13,31,0.419,22,29,0.759,127,47,99,0.475,36,72,0.5,11,27,0.407,20,23,0.87,125,2013-11-09,CLE,PHI
235,35,@,W 127-125 (2OT),290,51,103,0.495,40,69,0.58,11,34,0.324,14,19,0.737,127,49,94,0.521,41,73,0.562,8,21,0.381,19,26,0.731,125,2013-12-26,ATL,CLE
236,36,@,L 127-129 ,240,51,97,0.526,39,72,0.542,12,25,0.48,13,21,0.619,127,42,83,0.506,25,49,0.51,17,34,0.5,28,37,0.757,129,2014-01-15,DAL,LAC
237,37,@,W 127-110 ,240,53,91,0.582,37,64,0.578,16,27,0.593,5,7,0.714,127,40,81,0.494,32,56,0.571,8,25,0.32,22,22,1.0,110,2014-01-16,BRK,ATL
238,38,Home,W 127-121 ,240,47,81,0.58,38,59,0.644,9,22,0.409,24,33,0.727,127,43,82,0.524,27,55,0.491,16,27,0.593,19,34,0.559,121,2014-01-17,OKC,GSW
239,39,@,W 127-111 ,240,46,90,0.511,37,64,0.578,9,26,0.346,26,28,0.929,127,42,90,0.467,35,72,0.486,7,18,0.389,20,25,0.8,111,2014-01-18,POR,DAL
240,40,@,W 127-120 ,240,46,80,0.575,34,53,0.642,12,27,0.444,23,29,0.793,127,40,91,0.44,32,68,0.471,8,23,0.348,32,37,0.865,120,2014-03-23,PHO,MIN
241,41,Home,W 127-96 ,240,48,83,0.578,30,55,0.545,18,28,0.643,13,15,0.867,127,36,74,0.486,32,59,0.542,4,15,0.267,20,27,0.741,96,2014-03-25,LAL,NYK
242,42,Home,W 127-104 ,240,46,83,0.554,35,60,0.583,11,23,0.478,24,28,0.857,127,41,88,0.466,37,74,0.5,4,14,0.286,18,25,0.72,104,2014-11-01,GSW,LAL
243,43,Home,W 127-94 ,240,49,90,0.544,30,59,0.508,19,31,0.613,10,13,0.769,127,40,90,0.444,37,68,0.544,3,22,0.136,11,13,0.846,94,2014-11-15,CLE,ATL
244,44,Home,W 127-101 ,240,41,80,0.513,26,46,0.565,15,34,0.441,30,36,0.833,127,35,82,0.427,33,70,0.471,2,12,0.167,29,40,0.725,101,2014-12-01,LAC,MIN
245,45,@,W 127-98 ,240,49,76,0.645,33,48,0.688,16,28,0.571,13,16,0.813,127,37,82,0.451,29,52,0.558,8,30,0.267,16,21,0.762,98,2014-12-17,ATL,CLE
246,46,Home,W 127-91 ,240,46,85,0.541,31,48,0.646,15,37,0.405,20,26,0.769,127,32,79,0.405,23,54,0.426,9,25,0.36,18,26,0.692,91,2015-01-03,LAC,PHI
247,47,Home,W 127-115 ,240,51,97,0.526,41,75,0.547,10,22,0.455,15,19,0.789,127,42,92,0.457,33,68,0.485,9,24,0.375,22,28,0.786,115,2015-01-16,OKC,GSW
248,48,@,W 127-99 ,240,48,83,0.578,39,58,0.672,9,25,0.36,22,32,0.688,127,35,88,0.398,27,65,0.415,8,23,0.348,21,27,0.778,99,2015-01-18,OKC,ORL
249,49,@,W 127-122 (OT),265,47,92,0.511,40,66,0.606,7,26,0.269,26,30,0.867,127,49,101,0.485,45,82,0.549,4,19,0.211,20,26,0.769,122,2015-01-30,TOR,BRK
250,50,@,W 127-118 ,240,48,95,0.505,33,58,0.569,15,37,0.405,16,23,0.696,127,41,87,0.471,29,61,0.475,12,26,0.462,24,30,0.8,118,2015-02-10,HOU,PHO
251,51,@,W 127-89 ,240,46,90,0.511,32,57,0.561,14,33,0.424,21,28,0.75,127,38,86,0.442,37,70,0.529,1,16,0.063,12,16,0.75,89,2015-02-20,CLE,WAS
252,52,@,W 127-94 ,240,44,87,0.506,29,55,0.527,15,32,0.469,24,29,0.828,127,33,81,0.407,28,61,0.459,5,20,0.25,23,33,0.697,94,2015-03-10,CLE,DAL
253,53,@,L 127-129 (3OT),315,49,129,0.38,41,113,0.363,8,16,0.5,21,29,0.724,127,46,107,0.43,35,82,0.427,11,25,0.44,26,34,0.765,129,2015-03-20,MIL,BRK
254,54,Home,W 127-117 ,240,48,86,0.558,37,65,0.569,11,21,0.524,20,23,0.87,127,44,85,0.518,35,66,0.53,9,19,0.474,20,27,0.741,117,2015-03-24,OKC,LAL
255,55,Home,W 127-122 (OT),265,49,98,0.5,40,69,0.58,9,29,0.31,20,26,0.769,127,52,104,0.5,44,73,0.603,8,31,0.258,10,16,0.625,122,2015-11-23,CHA,SAC
256,56,Home,W 127-122 (OT),265,44,87,0.506,32,60,0.533,12,27,0.444,27,44,0.614,127,47,97,0.485,33,64,0.516,14,33,0.424,14,15,0.933,122,2015-12-02,DET,PHO
257,57,Home,W 127-106 ,240,48,78,0.615,38,57,0.667,10,21,0.476,21,24,0.875,127,39,75,0.52,27,49,0.551,12,26,0.462,16,24,0.667,106,2015-12-16,ATL,PHI
258,58,Home,W 127-107 ,240,47,81,0.58,33,52,0.635,14,29,0.483,19,21,0.905,127,44,87,0.506,33,56,0.589,11,31,0.355,8,12,0.667,107,2016-01-27,GSW,DAL
259,59,@,W 127-104 ,240,50,89,0.562,40,63,0.635,10,26,0.385,17,23,0.739,127,37,86,0.43,23,47,0.489,14,39,0.359,16,21,0.762,104,2016-11-01,GSW,POR
260,60,Home,W 127-95 ,240,48,90,0.533,34,65,0.523,14,25,0.56,17,21,0.81,127,34,77,0.442,24,44,0.545,10,33,0.303,17,22,0.773,95,2016-11-14,LAC,BRK
261,61,@,W 127-121 ,240,44,87,0.506,31,51,0.608,13,36,0.361,26,28,0.929,127,37,82,0.451,27,57,0.474,10,25,0.4,37,41,0.902,121,2016-11-16,GSW,TOR
262,62,Home,W 127-122 (2OT),290,45,104,0.433,32,66,0.485,13,38,0.342,24,36,0.667,127,46,109,0.422,33,69,0.478,13,40,0.325,17,22,0.773,122,2016-11-29,BRK,LAC
263,63,Home,L 127-132 (2OT),290,43,104,0.413,31,60,0.517,12,44,0.273,29,37,0.784,127,48,108,0.444,34,64,0.531,14,44,0.318,22,30,0.733,132,2016-12-01,GSW,HOU
264,64,Home,W 127-114 ,240,50,90,0.556,40,63,0.635,10,27,0.37,17,29,0.586,127,35,80,0.438,27,57,0.474,8,23,0.348,36,39,0.923,114,2016-12-17,DEN,NYK
265,65,Home,W 127-119 ,240,50,95,0.526,39,70,0.557,11,25,0.44,16,21,0.762,127,48,101,0.475,39,66,0.591,9,35,0.257,14,18,0.778,119,2017-01-02,GSW,DEN
266,66,@,W 127-99 ,240,51,90,0.567,39,66,0.591,12,24,0.5,13,17,0.765,127,39,86,0.453,32,61,0.525,7,25,0.28,14,17,0.824,99,2017-01-05,SAS,DEN
267,67,Home,W 127-100 ,240,48,96,0.5,38,68,0.559,10,28,0.357,21,29,0.724,127,38,92,0.413,30,60,0.5,8,32,0.25,16,27,0.593,100,2017-01-06,LAL,MIA
268,68,Home,W 127-107 ,240,50,89,0.562,35,60,0.583,15,29,0.517,12,18,0.667,127,43,88,0.489,37,60,0.617,6,28,0.214,15,20,0.75,107,2017-01-12,GSW,DET
269,69,@,W 127-121 ,240,50,88,0.568,39,62,0.629,11,26,0.423,16,26,0.615,127,47,108,0.435,36,78,0.462,11,30,0.367,16,18,0.889,121,2017-01-17,DEN,LAL
270,70,@,W 127-123 (OT),265,43,92,0.467,33,67,0.493,10,25,0.4,31,36,0.861,127,42,92,0.457,29,57,0.509,13,35,0.371,26,31,0.839,123,2017-01-21,POR,BOS
271,71,Home,W 127-114 ,240,47,80,0.588,36,57,0.632,11,23,0.478,22,27,0.815,127,39,77,0.506,25,42,0.595,14,35,0.4,22,28,0.786,114,2017-01-23,MIL,HOU
272,72,Home,W 127-120 ,240,44,86,0.512,35,63,0.556,9,23,0.391,30,35,0.857,127,48,89,0.539,38,65,0.585,10,24,0.417,14,17,0.824,120,2017-01-26,DEN,PHO
273,73,@,W 127-94 ,240,48,88,0.545,34,56,0.607,14,32,0.438,17,21,0.81,127,35,77,0.455,30,53,0.566,5,24,0.208,19,25,0.76,94,2017-02-08,UTA,NOP
274,74,Home,L 127-131 ,240,44,88,0.5,31,61,0.508,13,27,0.481,26,33,0.788,127,41,90,0.456,34,72,0.472,7,18,0.389,42,53,0.792,131,2017-03-07,PHO,WAS
275,75,Home,W 126-99 ,240,49,80,0.613,33,55,0.6,16,25,0.64,12,15,0.8,126,39,91,0.429,36,74,0.486,3,17,0.176,18,24,0.75,99,2012-11-03,DAL,CHA
276,76,Home,W 126-100 ,240,47,88,0.534,31,61,0.508,16,27,0.593,16,20,0.8,126,39,78,0.5,35,67,0.522,4,11,0.364,18,26,0.692,100,2012-11-17,SAS,DEN
277,77,Home,L 126-134 (OT),265,41,97,0.423,25,67,0.373,16,30,0.533,28,36,0.778,126,48,92,0.522,34,62,0.548,14,30,0.467,24,26,0.923,134,2012-12-10,HOU,SAS
278,78,Home,W 126-119 (2OT),290,46,98,0.469,35,65,0.538,11,33,0.333,23,31,0.742,126,48,109,0.44,34,82,0.415,14,27,0.519,9,15,0.6,119,2012-12-26,ATL,DET
279,79,Home,W 126-114 ,240,45,94,0.479,33,72,0.458,12,22,0.545,24,32,0.75,126,41,83,0.494,30,54,0.556,11,29,0.379,21,30,0.7,114,2012-12-26,DEN,LAL
280,80,Home,W 126-101 ,240,52,93,0.559,43,72,0.597,9,21,0.429,13,18,0.722,126,35,77,0.455,28,60,0.467,7,17,0.412,24,25,0.96,101,2013-04-03,LAC,PHO
281,81,Home,W 126-115 ,240,42,85,0.494,33,57,0.579,9,28,0.321,33,50,0.66,126,40,76,0.526,28,55,0.509,12,21,0.571,23,33,0.697,115,2013-10-31,LAC,GSW
282,82,Home,W 126-96 ,240,46,80,0.575,30,56,0.536,16,24,0.667,18,23,0.783,126,39,83,0.47,35,70,0.5,4,13,0.308,14,20,0.7,96,2013-11-23,SAS,CLE
283,83,Home,W 126-125 (2OT),290,46,96,0.479,35,67,0.522,11,29,0.379,23,33,0.697,126,47,94,0.5,41,68,0.603,6,26,0.231,25,32,0.781,125,2013-12-03,PHI,ORL
284,84,@,W 126-95 ,240,46,100,0.46,30,74,0.405,16,26,0.615,18,23,0.783,126,38,80,0.475,30,62,0.484,8,18,0.444,11,16,0.688,95,2014-01-06,MIN,PHI
285,85,Home,W 126-113 ,240,45,86,0.523,29,53,0.547,16,33,0.485,20,24,0.833,126,44,97,0.454,36,72,0.5,8,25,0.32,17,22,0.773,113,2014-01-20,HOU,POR
286,86,@,W 126-118 ,240,46,84,0.548,34,62,0.548,12,22,0.545,22,25,0.88,126,36,74,0.486,22,45,0.489,14,29,0.483,32,38,0.842,118,2014-01-25,LAC,TOR
287,87,@,W 126-117 ,240,42,78,0.538,30,55,0.545,12,23,0.522,30,32,0.938,126,38,89,0.427,31,70,0.443,7,19,0.368,34,36,0.944,117,2014-01-29,PHO,MIL
288,88,Home,W 126-109 ,240,50,98,0.51,42,78,0.538,8,20,0.4,18,23,0.783,126,41,88,0.466,26,55,0.473,15,33,0.455,12,22,0.545,109,2014-02-08,DET,DEN
289,89,Home,W 126-122 ,240,48,80,0.6,29,53,0.547,19,27,0.704,11,16,0.688,126,47,93,0.505,42,78,0.538,5,15,0.333,23,32,0.719,122,2014-02-28,LAL,SAC
290,90,@,W 126-103 ,240,44,92,0.478,30,57,0.526,14,35,0.4,24,31,0.774,126,36,95,0.379,26,70,0.371,10,25,0.4,21,23,0.913,103,2014-02-28,GSW,NYK
291,91,@,L 126-134 ,240,45,97,0.464,33,70,0.471,12,27,0.444,24,30,0.8,126,54,99,0.545,40,75,0.533,14,24,0.583,12,21,0.571,134,2014-03-07,LAL,DEN
292,92,@,W 126-115 ,240,42,82,0.512,28,53,0.528,14,29,0.483,28,33,0.848,126,42,82,0.512,32,58,0.552,10,24,0.417,21,24,0.875,115,2014-11-26,TOR,ATL
293,93,Home,W 126-86 ,240,46,82,0.561,34,54,0.63,12,28,0.429,22,27,0.815,126,33,86,0.384,27,66,0.409,6,20,0.3,14,23,0.609,86,2014-12-30,GSW,PHI
294,94,Home,W 126-105 ,240,49,92,0.533,37,64,0.578,12,28,0.429,16,20,0.8,126,40,86,0.465,30,61,0.492,10,25,0.4,15,20,0.75,105,2015-01-02,GSW,TOR
295,95,@,W 126-121 ,240,46,83,0.554,36,60,0.6,10,23,0.435,24,31,0.774,126,43,91,0.473,33,62,0.532,10,29,0.345,25,36,0.694,121,2015-01-16,CLE,LAC
296,96,Home,W 126-113 ,240,49,98,0.5,36,69,0.522,13,29,0.448,15,18,0.833,126,37,87,0.425,24,55,0.436,13,32,0.406,26,31,0.839,113,2015-01-21,GSW,HOU
297,97,Home,W 126-101 ,240,45,94,0.479,28,54,0.519,17,40,0.425,19,22,0.864,126,34,82,0.415,30,65,0.462,4,17,0.235,29,34,0.853,101,2015-01-23,GSW,SAC
298,98,Home,W 126-99 ,240,46,95,0.484,32,60,0.533,14,35,0.4,20,28,0.714,126,30,88,0.341,26,72,0.361,4,16,0.25,35,46,0.761,99,2015-02-21,LAC,SAC
299,99,@,W 126-122 ,240,46,86,0.535,31,58,0.534,15,28,0.536,19,24,0.792,126,45,89,0.506,32,64,0.5,13,25,0.52,19,25,0.76,122,2015-04-01,LAC,POR
300,0,@,L 126-133 ,240,45,83,0.542,39,65,0.6,6,18,0.333,30,36,0.833,126,47,90,0.522,34,62,0.548,13,28,0.464,26,34,0.765,133,2015-04-15,DEN,GSW
301,1,Home,W 126-97 ,240,47,90,0.522,32,57,0.561,15,33,0.455,17,28,0.607,126,35,88,0.398,25,56,0.446,10,32,0.313,17,20,0.85,97,2015-12-12,HOU,LAL
302,2,@,W 126-98 ,240,49,92,0.533,36,60,0.6,13,32,0.406,15,19,0.789,126,39,86,0.453,34,68,0.5,5,18,0.278,15,25,0.6,98,2016-01-07,ATL,PHI
303,3,@,L 126-129 ,240,48,82,0.585,39,62,0.629,9,20,0.45,21,30,0.7,126,46,91,0.505,36,65,0.554,10,26,0.385,27,38,0.711,129,2016-01-17,IND,DEN
304,4,@,W 126-123 ,240,48,91,0.527,38,71,0.535,10,20,0.5,20,21,0.952,126,50,90,0.556,45,76,0.592,5,14,0.357,18,28,0.643,123,2016-01-27,OKC,MIN
305,5,Home,W 126-115 ,240,44,79,0.557,31,60,0.517,13,19,0.684,25,26,0.962,126,43,93,0.462,36,72,0.5,7,21,0.333,22,33,0.667,115,2016-02-21,CHI,LAL
306,6,Home,W 126-92 ,240,45,93,0.484,32,66,0.485,13,27,0.481,23,27,0.852,126,33,91,0.363,27,64,0.422,6,27,0.222,20,27,0.741,92,2016-03-01,CHA,PHO
307,7,@,W 126-99 ,240,52,94,0.553,36,64,0.563,16,30,0.533,6,7,0.857,126,39,90,0.433,33,70,0.471,6,20,0.3,15,19,0.789,99,2016-11-12,LAL,NOP
308,8,Home,W 126-109 ,240,46,95,0.484,32,63,0.508,14,32,0.438,20,25,0.8,126,41,90,0.456,31,62,0.5,10,28,0.357,17,21,0.81,109,2016-11-17,HOU,POR
309,9,Home,W 126-115 (OT),265,46,95,0.484,34,65,0.523,12,30,0.4,22,31,0.71,126,44,98,0.449,34,70,0.486,10,28,0.357,17,26,0.654,115,2016-11-30,OKC,WAS
310,10,@,W 126-94 ,240,39,80,0.488,17,40,0.425,22,40,0.55,26,31,0.839,126,35,87,0.402,24,56,0.429,11,31,0.355,13,15,0.867,94,2016-12-07,CLE,NYK
311,11,Home,W 126-121 ,240,40,72,0.556,30,49,0.612,10,23,0.435,36,43,0.837,126,44,86,0.512,40,59,0.678,4,27,0.148,29,40,0.725,121,2016-12-20,SAC,POR
312,12,Home,W 126-91 ,240,46,91,0.505,31,57,0.544,15,34,0.441,19,24,0.792,126,31,88,0.352,22,54,0.407,9,34,0.265,20,27,0.741,91,2017-01-16,GSW,CLE
313,13,Home,W 126-111 ,240,47,96,0.49,26,48,0.542,21,48,0.438,11,14,0.786,126,39,88,0.443,30,57,0.526,9,31,0.29,24,26,0.923,111,2017-02-01,GSW,CHO
314,14,@,W 126-121 ,240,47,85,0.553,36,62,0.581,11,23,0.478,21,27,0.778,126,44,85,0.518,34,60,0.567,10,25,0.4,23,30,0.767,121,2017-03-07,POR,OKC
315,15,@,W 125-104 ,240,43,84,0.512,36,72,0.5,7,12,0.583,32,39,0.821,125,40,91,0.44,30,70,0.429,10,21,0.476,14,18,0.778,104,2012-03-24,IND,MIL
316,16,@,W 125-90 ,240,48,81,0.593,37,58,0.638,11,23,0.478,18,21,0.857,125,34,82,0.415,25,58,0.431,9,24,0.375,13,15,0.867,90,2012-04-03,SAS,CLE
317,17,Home,W 125-105 ,240,47,94,0.5,33,65,0.508,14,29,0.483,17,21,0.81,125,47,97,0.485,46,88,0.523,1,9,0.111,10,18,0.556,105,2012-04-07,PHO,LAL
318,18,Home,W 125-107 ,240,51,85,0.6,44,70,0.629,7,15,0.467,16,19,0.842,125,41,89,0.461,33,68,0.485,8,21,0.381,17,23,0.739,107,2012-04-16,PHO,POR
319,19,Home,W 125-103 ,240,42,75,0.56,31,48,0.646,11,27,0.407,30,36,0.833,125,40,89,0.449,34,72,0.472,6,17,0.353,17,24,0.708,103,2012-12-19,HOU,PHI
320,20,Home,W 125-119 (OT),265,48,94,0.511,40,70,0.571,8,24,0.333,21,24,0.875,125,46,93,0.495,35,63,0.556,11,30,0.367,16,18,0.889,119,2013-01-07,POR,ORL
321,21,Home,W 125-112 ,240,48,87,0.552,37,62,0.597,11,25,0.44,18,23,0.783,125,43,91,0.473,29,60,0.483,14,31,0.452,12,13,0.923,112,2013-01-08,HOU,LAL
322,22,@,W 125-80 ,240,47,89,0.528,31,55,0.564,16,34,0.471,15,18,0.833,125,32,81,0.395,27,63,0.429,5,18,0.278,11,19,0.579,80,2013-01-28,HOU,UTA
323,23,@,W 125-101 ,240,46,89,0.517,30,59,0.508,16,30,0.533,17,22,0.773,125,38,75,0.507,32,55,0.582,6,20,0.3,19,27,0.704,101,2013-02-14,LAC,LAL
324,24,Home,W 125-91 ,240,42,79,0.532,31,55,0.564,11,24,0.458,30,39,0.769,125,29,86,0.337,24,58,0.414,5,28,0.179,28,36,0.778,91,2013-02-20,IND,NYK
325,25,@,W 125-101 ,240,46,84,0.548,36,62,0.581,10,22,0.455,23,29,0.793,125,37,83,0.446,31,64,0.484,6,19,0.316,21,25,0.84,101,2013-02-27,SAC,ORL
326,26,Home,W 125-118 ,240,47,82,0.573,39,65,0.6,8,17,0.471,23,28,0.821,125,41,94,0.436,32,68,0.471,9,26,0.346,27,35,0.771,118,2013-03-04,GSW,TOR
327,27,Home,W 125-98 ,240,47,87,0.54,38,67,0.567,9,20,0.45,22,27,0.815,125,33,86,0.384,25,63,0.397,8,23,0.348,24,29,0.828,98,2013-03-30,GSW,POR
328,28,@,W 125-120 ,240,46,93,0.495,31,59,0.525,15,34,0.441,18,24,0.75,125,45,78,0.577,36,61,0.59,9,17,0.529,21,25,0.84,120,2013-04-07,NYK,OKC
329,29,Home,W 125-94 ,240,46,86,0.535,31,59,0.525,15,27,0.556,18,23,0.783,125,35,89,0.393,27,71,0.38,8,18,0.444,16,21,0.762,94,2013-10-30,GSW,LAL
330,30,@,L 125-127 (2OT),290,47,99,0.475,36,72,0.5,11,27,0.407,20,23,0.87,125,46,102,0.451,33,71,0.465,13,31,0.419,22,29,0.759,127,2013-11-09,PHI,CLE
331,31,@,L 125-126 (2OT),290,47,94,0.5,41,68,0.603,6,26,0.231,25,32,0.781,125,46,96,0.479,35,67,0.522,11,29,0.379,23,33,0.697,126,2013-12-03,ORL,PHI
332,32,Home,L 125-127 (2OT),290,49,94,0.521,41,73,0.562,8,21,0.381,19,26,0.731,125,51,103,0.495,40,69,0.58,11,34,0.324,14,19,0.737,127,2013-12-26,CLE,ATL
333,33,Home,L 125-128 (3OT),315,53,104,0.51,47,78,0.603,6,26,0.231,13,16,0.813,125,48,113,0.425,36,80,0.45,12,33,0.364,20,23,0.87,128,2014-01-15,ORL,CHI
334,34,Home,W 125-96 ,240,50,90,0.556,36,63,0.571,14,27,0.519,11,11,1.0,125,37,76,0.487,27,52,0.519,10,24,0.417,12,14,0.857,96,2014-01-24,NYK,CHA
335,35,@,W 125-117 ,240,42,81,0.519,32,56,0.571,10,25,0.4,31,40,0.775,125,42,81,0.519,38,65,0.585,4,16,0.25,29,34,0.853,117,2014-01-26,DEN,SAC
336,36,@,W 125-99 ,240,45,89,0.506,37,73,0.507,8,16,0.5,27,34,0.794,125,32,87,0.368,26,65,0.4,6,22,0.273,29,37,0.784,99,2014-01-31,ATL,PHI
337,37,@,W 125-118 (2OT),290,48,98,0.49,39,70,0.557,9,28,0.321,20,25,0.8,125,44,101,0.436,39,85,0.459,5,16,0.313,25,32,0.781,118,2014-02-05,SAS,WAS
338,38,@,W 125-117 ,240,42,81,0.519,29,51,0.569,13,30,0.433,28,39,0.718,125,43,93,0.462,31,64,0.484,12,29,0.414,19,24,0.792,117,2014-02-23,LAC,OKC
339,39,Home,L 125-132 ,240,46,85,0.541,36,63,0.571,10,22,0.455,23,31,0.742,125,46,77,0.597,39,60,0.65,7,17,0.412,33,40,0.825,132,2014-03-04,LAL,NOP
340,40,Home,W 125-92 ,240,43,76,0.566,36,56,0.643,7,20,0.35,32,43,0.744,125,32,94,0.34,22,64,0.344,10,30,0.333,18,26,0.692,92,2014-03-04,OKC,PHI
341,41,@,W 125-109 ,240,50,95,0.526,38,68,0.559,12,27,0.444,13,16,0.813,125,39,91,0.429,30,65,0.462,9,26,0.346,22,29,0.759,109,2014-03-19,SAS,LAL
342,42,@,L 125-130 (OT),265,51,107,0.477,37,76,0.487,14,31,0.452,9,13,0.692,125,45,98,0.459,32,62,0.516,13,36,0.361,27,40,0.675,130,2014-04-06,DEN,HOU
343,43,Home,W 125-114 ,240,41,82,0.5,29,57,0.509,12,25,0.48,31,37,0.838,125,44,85,0.518,36,64,0.563,8,21,0.381,18,21,0.857,114,2014-04-09,TOR,PHI
344,44,Home,W 125-102 ,240,49,84,0.583,37,53,0.698,12,31,0.387,15,19,0.789,125,42,84,0.5,38,69,0.551,4,15,0.267,14,17,0.824,102,2014-12-07,DAL,MIL
345,45,Home,W 125-118 ,240,49,77,0.636,36,54,0.667,13,23,0.565,14,22,0.636,125,43,86,0.5,33,62,0.532,10,24,0.417,22,29,0.759,118,2014-12-22,SAS,LAC
346,46,Home,W 125-104 ,240,44,84,0.524,32,60,0.533,12,24,0.5,25,31,0.806,125,39,88,0.443,35,75,0.467,4,13,0.308,22,29,0.759,104,2014-12-23,CLE,MIN
347,47,Home,W 125-109 ,240,48,89,0.539,40,66,0.606,8,23,0.348,21,28,0.75,125,38,83,0.458,29,57,0.509,9,26,0.346,24,29,0.828,109,2015-01-04,PHO,TOR
348,48,Home,L 125-128 (OT),265,49,87,0.563,41,61,0.672,8,26,0.308,19,27,0.704,125,44,91,0.484,30,65,0.462,14,26,0.538,26,30,0.867,128,2015-03-12,SAS,CLE
349,49,Home,W 125-94 ,240,45,90,0.5,26,56,0.464,19,34,0.559,16,17,0.941,125,38,96,0.396,29,71,0.408,9,25,0.36,9,16,0.563,94,2015-03-14,GSW,NYK
350,50,@,W 125-101 ,240,44,86,0.512,29,63,0.46,15,23,0.652,22,29,0.759,125,38,97,0.392,33,73,0.452,5,24,0.208,20,26,0.769,101,2015-11-10,OKC,WAS
351,51,@,W 125-88 ,240,47,84,0.56,34,58,0.586,13,26,0.5,18,23,0.783,125,33,81,0.407,30,67,0.448,3,14,0.214,19,22,0.864,88,2015-12-08,OKC,MEM
352,52,Home,L 125-130 ,240,45,96,0.469,28,61,0.459,17,35,0.486,18,22,0.818,125,44,78,0.564,33,54,0.611,11,24,0.458,31,39,0.795,130,2015-12-20,DEN,NOP
353,53,@,W 125-99 ,240,43,81,0.531,30,54,0.556,13,27,0.481,26,29,0.897,125,36,79,0.456,29,63,0.46,7,16,0.438,20,26,0.769,99,2016-01-08,CLE,MIN
354,54,@,W 125-94 ,240,50,95,0.526,38,63,0.603,12,32,0.375,13,20,0.65,125,37,100,0.37,36,80,0.45,1,20,0.05,19,24,0.792,94,2016-01-20,GSW,CHI
355,55,Home,W 125-109 ,240,48,88,0.545,33,57,0.579,15,31,0.484,14,16,0.875,125,43,93,0.462,38,67,0.567,5,26,0.192,18,28,0.643,109,2016-03-12,CHA,HOU
356,56,@,W 125-111 ,240,49,91,0.538,40,73,0.548,9,18,0.5,18,22,0.818,125,39,84,0.464,29,59,0.492,10,25,0.4,23,27,0.852,111,2016-03-12,DET,PHI
357,57,Home,W 125-107 ,240,47,81,0.58,35,56,0.625,12,25,0.48,19,23,0.826,125,35,93,0.376,28,68,0.412,7,25,0.28,30,34,0.882,107,2016-03-14,GSW,NOP
358,58,Home,W 125-104 ,240,46,87,0.529,26,40,0.65,20,47,0.426,13,16,0.813,125,42,98,0.429,34,74,0.459,8,24,0.333,12,16,0.75,104,2016-04-13,GSW,MEM
359,59,Home,W 125-107 ,240,47,82,0.573,35,55,0.636,12,27,0.444,19,24,0.792,125,38,81,0.469,28,58,0.483,10,23,0.435,21,27,0.778,107,2016-11-03,MIL,IND
360,60,@,W 125-101 ,240,46,85,0.541,32,55,0.582,14,30,0.467,19,20,0.95,125,38,94,0.404,25,58,0.431,13,36,0.361,12,17,0.706,101,2016-11-10,GSW,DEN
361,61,Home,W 125-99 ,240,42,80,0.525,29,53,0.547,13,27,0.481,28,42,0.667,125,33,71,0.465,25,47,0.532,8,24,0.333,25,30,0.833,99,2016-11-13,MIN,LAL
362,62,Home,W 125-118 ,240,41,92,0.446,32,64,0.5,9,28,0.321,34,43,0.791,125,45,99,0.455,33,58,0.569,12,41,0.293,16,20,0.8,118,2016-11-15,LAL,BRK
363,63,@,L 125-137 ,240,47,90,0.522,34,61,0.557,13,29,0.448,18,19,0.947,125,48,90,0.533,27,54,0.5,21,36,0.583,20,27,0.741,137,2016-11-23,POR,CLE
364,64,@,W 125-120 (OT),265,48,106,0.453,38,79,0.481,10,27,0.37,19,22,0.864,125,44,101,0.436,30,65,0.462,14,36,0.389,18,26,0.692,120,2016-12-03,MIN,CHO
365,65,@,W 125-121 ,240,46,86,0.535,35,61,0.574,11,25,0.44,22,32,0.688,125,47,86,0.547,37,65,0.569,10,21,0.476,17,26,0.654,121,2016-12-16,ATL,TOR
366,66,@,W 125-111 ,240,46,86,0.535,28,48,0.583,18,38,0.474,15,26,0.577,125,44,93,0.473,35,68,0.515,9,25,0.36,14,20,0.7,111,2016-12-21,HOU,PHO
367,67,Home,W 125-117 ,240,44,87,0.506,31,51,0.608,13,36,0.361,24,29,0.828,125,40,89,0.449,28,63,0.444,12,26,0.462,25,28,0.893,117,2017-01-04,GSW,POR
368,68,@,W 125-124 (2OT),290,54,105,0.514,46,80,0.575,8,25,0.32,9,12,0.75,125,51,98,0.52,36,63,0.571,15,35,0.429,7,12,0.583,124,2017-01-08,DET,POR
369,69,Home,W 125-112 ,240,52,89,0.584,43,62,0.694,9,27,0.333,12,15,0.8,125,45,88,0.511,37,63,0.587,8,25,0.32,14,18,0.778,112,2017-01-16,DEN,ORL
370,70,@,W 125-108 ,240,47,89,0.528,32,51,0.627,15,38,0.395,16,21,0.762,125,43,96,0.448,36,61,0.59,7,35,0.2,15,18,0.833,108,2017-01-20,GSW,HOU
371,71,Home,W 125-97 ,240,48,89,0.539,33,52,0.635,15,37,0.405,14,22,0.636,125,41,94,0.436,34,73,0.466,7,21,0.333,8,10,0.8,97,2017-02-01,CLE,MIN
372,72,Home,W 125-102 ,240,48,82,0.585,36,60,0.6,12,22,0.545,17,23,0.739,125,35,84,0.417,29,61,0.475,6,23,0.261,26,31,0.839,102,2017-02-04,MIA,PHI
373,73,Home,W 125-109 ,240,46,84,0.548,31,54,0.574,15,30,0.5,18,22,0.818,125,39,97,0.402,27,60,0.45,12,37,0.324,19,22,0.864,109,2017-02-11,CLE,DEN
374,74,Home,L 125-129 ,240,46,88,0.523,32,52,0.615,14,36,0.389,19,23,0.826,125,50,88,0.568,43,73,0.589,7,15,0.467,22,32,0.688,129,2017-02-15,BRK,MIL
375,75,@,W 125-107 ,240,45,80,0.563,32,50,0.64,13,30,0.433,22,24,0.917,125,44,96,0.458,34,70,0.486,10,26,0.385,9,10,0.9,107,2017-02-28,DEN,CHI
376,76,Home,W 125-98 ,240,49,90,0.544,36,60,0.6,13,30,0.433,14,21,0.667,125,37,85,0.435,31,68,0.456,6,17,0.353,18,22,0.818,98,2017-03-01,MIA,PHI
377,77,@,W 124-109 ,240,48,80,0.6,39,63,0.619,9,17,0.529,19,23,0.826,124,40,85,0.471,33,62,0.532,7,23,0.304,22,27,0.815,109,2012-02-14,WAS,POR
378,78,Home,W 124-118 (OT),265,46,94,0.489,37,66,0.561,9,28,0.321,23,28,0.821,124,49,101,0.485,43,79,0.544,6,22,0.273,14,18,0.778,118,2012-02-19,OKC,DEN
379,79,Home,L 124-127 ,240,46,89,0.517,37,68,0.544,9,21,0.429,23,29,0.793,124,50,89,0.562,36,67,0.537,14,22,0.636,13,21,0.619,127,2012-03-12,PHO,MIN
380,80,@,W 124-112 ,240,50,86,0.581,42,73,0.575,8,13,0.615,16,20,0.8,124,45,87,0.517,40,68,0.588,5,19,0.263,17,24,0.708,112,2012-03-14,DET,SAC
381,81,Home,W 124-89 ,240,48,81,0.593,36,59,0.61,12,22,0.545,16,21,0.762,124,37,96,0.385,31,80,0.388,6,16,0.375,9,11,0.818,89,2012-04-23,SAS,POR
382,82,Home,W 124-99 ,240,47,86,0.547,32,60,0.533,15,26,0.577,15,19,0.789,124,35,88,0.398,28,67,0.418,7,21,0.333,22,29,0.759,99,2012-11-05,MIA,PHO
383,83,Home,W 124-116 ,240,46,83,0.554,35,61,0.574,11,22,0.5,21,26,0.808,124,48,94,0.511,37,74,0.5,11,20,0.55,9,11,0.818,116,2012-12-01,HOU,UTA
384,84,@,W 124-94 ,240,45,94,0.479,32,65,0.492,13,29,0.448,21,23,0.913,124,33,83,0.398,25,53,0.472,8,30,0.267,20,27,0.741,94,2012-12-29,OKC,HOU
385,85,Home,W 124-118 ,240,43,84,0.512,34,65,0.523,9,19,0.474,29,33,0.879,124,44,92,0.478,36,76,0.474,8,16,0.5,22,30,0.733,118,2013-01-14,SAC,CLE
386,86,@,W 124-101 ,240,49,91,0.538,41,69,0.594,8,22,0.364,18,19,0.947,124,37,88,0.42,30,67,0.448,7,21,0.333,20,22,0.909,101,2013-04-10,ATL,PHI
387,87,Home,W 124-95 ,240,45,82,0.549,34,60,0.567,11,22,0.5,23,26,0.885,124,36,87,0.414,31,71,0.437,5,16,0.313,18,21,0.857,95,2013-11-13,MIN,CLE
388,88,Home,W 124-107 ,240,47,81,0.58,32,56,0.571,15,25,0.6,15,18,0.833,124,40,84,0.476,34,69,0.493,6,15,0.4,21,25,0.84,107,2013-12-18,ATL,SAC
389,89,Home,W 124-112 ,240,44,79,0.557,36,57,0.632,8,22,0.364,28,35,0.8,124,45,87,0.517,39,67,0.582,6,20,0.3,16,22,0.727,112,2014-01-01,MIN,NOP
390,90,Home,W 124-80 ,240,42,81,0.519,27,51,0.529,15,30,0.5,25,30,0.833,124,31,80,0.388,24,59,0.407,7,21,0.333,11,23,0.478,80,2014-01-12,SAC,CLE
391,91,Home,W 124-100 ,240,45,83,0.542,34,67,0.507,11,16,0.688,23,32,0.719,124,38,75,0.507,33,60,0.55,5,15,0.333,19,28,0.679,100,2014-01-22,PHO,IND
392,92,@,W 124-113 ,240,43,80,0.538,34,60,0.567,9,20,0.45,29,35,0.829,124,40,87,0.46,32,67,0.478,8,20,0.4,25,26,0.962,113,2014-01-27,PHO,PHI
393,93,Home,W 124-107 ,240,44,80,0.55,32,54,0.593,12,26,0.462,24,26,0.923,124,37,80,0.463,29,56,0.518,8,24,0.333,25,33,0.758,107,2014-02-03,DAL,CLE
394,94,@,W 124-112 ,240,48,77,0.623,39,54,0.722,9,23,0.391,19,25,0.76,124,42,94,0.447,37,69,0.536,5,25,0.2,23,32,0.719,112,2014-02-21,DAL,PHI
395,95,Home,W 124-80 ,240,46,86,0.535,33,55,0.6,13,31,0.419,19,21,0.905,124,32,81,0.395,28,59,0.475,4,22,0.182,12,17,0.706,80,2014-02-26,POR,BRK
396,96,Home,W 124-107 ,240,46,83,0.554,30,55,0.545,16,28,0.571,16,20,0.8,124,42,82,0.512,33,59,0.559,9,23,0.391,14,21,0.667,107,2014-03-03,MIA,CHA
397,97,Home,W 124-86 ,240,46,79,0.582,33,54,0.611,13,25,0.52,19,26,0.731,124,34,83,0.41,30,65,0.462,4,18,0.222,14,18,0.778,86,2014-03-17,HOU,UTA
398,98,Home,W 124-94 ,240,49,94,0.521,41,75,0.547,8,19,0.421,18,19,0.947,124,34,84,0.405,25,57,0.439,9,27,0.333,17,22,0.773,94,2014-03-22,CHA,POR
399,99,Home,W 124-107 ,240,44,86,0.512,37,66,0.561,7,20,0.35,29,36,0.806,124,42,85,0.494,38,67,0.567,4,18,0.222,19,30,0.633,107,2014-03-23,SAC,MIL
400,0,@,W 124-112 ,240,46,99,0.465,33,70,0.471,13,29,0.448,19,21,0.905,124,41,92,0.446,30,67,0.448,11,25,0.44,19,22,0.864,112,2014-04-01,POR,LAL
401,1,Home,W 124-82 ,240,45,86,0.523,30,61,0.492,15,25,0.6,19,24,0.792,124,27,74,0.365,21,54,0.389,6,20,0.3,22,32,0.688,82,2014-11-21,TOR,MIL
402,2,Home,W 124-115 ,240,44,97,0.454,31,64,0.484,13,33,0.394,23,32,0.719,124,41,88,0.466,32,63,0.508,9,25,0.36,24,29,0.828,115,2014-12-23,PHO,DAL
403,3,Home,W 124-116 ,240,38,77,0.494,23,50,0.46,15,27,0.556,33,37,0.892,124,47,103,0.456,35,70,0.5,12,33,0.364,10,15,0.667,116,2015-02-06,ATL,GSW
404,4,@,W 124-114 ,240,43,80,0.538,31,56,0.554,12,24,0.5,26,35,0.743,124,42,87,0.483,33,59,0.559,9,28,0.321,21,29,0.724,114,2015-02-09,OKC,DEN
405,5,@,W 124-86 ,240,41,83,0.494,31,65,0.477,10,18,0.556,32,37,0.865,124,30,82,0.366,26,60,0.433,4,22,0.182,22,30,0.733,86,2015-03-03,SAC,NYK
406,6,Home,W 124-103 ,240,49,94,0.521,45,74,0.608,4,20,0.2,22,30,0.733,124,38,84,0.452,31,68,0.456,7,16,0.438,20,26,0.769,103,2015-11-08,OKC,PHO
407,7,@,W 124-117 ,240,38,73,0.521,21,43,0.488,17,30,0.567,31,36,0.861,124,44,88,0.5,31,59,0.525,13,29,0.448,16,24,0.667,117,2015-11-19,GSW,LAC
408,8,@,W 124-119 (2OT),290,42,107,0.393,33,76,0.434,9,31,0.29,31,39,0.795,124,49,114,0.43,37,81,0.457,12,33,0.364,9,16,0.563,119,2015-12-11,GSW,BOS
409,9,Home,W 124-119 (2OT),290,41,88,0.466,27,61,0.443,14,27,0.519,28,32,0.875,124,44,104,0.423,29,59,0.492,15,45,0.333,16,20,0.8,119,2016-01-18,CHA,UTA
410,10,@,W 124-86 ,240,48,92,0.522,38,72,0.528,10,20,0.5,18,25,0.72,124,35,84,0.417,29,57,0.509,6,27,0.222,10,14,0.714,86,2016-02-03,ATL,PHI
411,11,Home,W 124-84 ,240,44,80,0.55,31,56,0.554,13,24,0.542,23,35,0.657,124,31,88,0.352,24,64,0.375,7,24,0.292,15,20,0.75,84,2016-02-22,LAC,PHO
412,12,Home,W 124-122 ,240,43,83,0.518,35,68,0.515,8,15,0.533,30,40,0.75,124,49,101,0.485,39,73,0.534,10,28,0.357,14,17,0.824,122,2016-02-22,MIN,BOS
413,13,@,W 124-115 ,240,41,85,0.482,34,71,0.479,7,14,0.5,35,41,0.854,124,43,79,0.544,33,58,0.569,10,21,0.476,19,26,0.731,115,2016-02-23,ORL,PHI
414,14,Home,W 124-119 ,240,47,79,0.595,39,62,0.629,8,17,0.471,22,28,0.786,124,49,93,0.527,42,73,0.575,7,20,0.35,14,20,0.7,119,2016-03-14,MIA,DEN
415,15,Home,W 124-81 ,240,51,90,0.567,43,72,0.597,8,18,0.444,14,18,0.778,124,32,79,0.405,29,56,0.518,3,23,0.13,14,22,0.636,81,2016-03-14,WAS,DET
416,16,Home,W 124-91 ,240,48,86,0.558,33,55,0.6,15,31,0.484,13,17,0.765,124,32,81,0.395,24,59,0.407,8,22,0.364,19,25,0.76,91,2016-03-21,CLE,DEN
417,17,@,W 124-102 ,240,46,87,0.529,31,54,0.574,15,33,0.455,17,24,0.708,124,37,88,0.42,27,58,0.466,10,30,0.333,18,27,0.667,102,2016-04-05,OKC,DEN
418,18,@,W 124-117 (OT),265,44,86,0.512,36,69,0.522,8,17,0.471,28,36,0.778,124,49,98,0.5,37,63,0.587,12,35,0.343,7,8,0.875,117,2016-04-05,MIN,GSW
419,19,@,W 124-115 ,240,44,94,0.468,32,63,0.508,12,31,0.387,24,29,0.828,124,42,74,0.568,28,41,0.683,14,33,0.424,17,28,0.607,115,2016-04-07,PHO,HOU
420,20,Home,W 124-109 ,240,44,78,0.564,38,64,0.594,6,14,0.429,30,38,0.789,124,41,84,0.488,34,67,0.507,7,17,0.412,20,29,0.69,109,2016-04-08,BOS,MIL
421,21,Home,W 124-121 ,240,45,81,0.556,31,50,0.62,14,31,0.452,20,28,0.714,124,43,86,0.5,36,65,0.554,7,21,0.333,28,33,0.848,121,2016-11-08,POR,PHO
422,22,Home,W 124-105 ,240,49,89,0.551,42,63,0.667,7,26,0.269,19,24,0.792,124,35,83,0.422,24,54,0.444,11,29,0.379,24,30,0.8,105,2016-11-18,OKC,BRK
423,23,@,W 124-121 ,240,42,95,0.442,28,57,0.491,14,38,0.368,26,32,0.813,124,46,89,0.517,36,69,0.522,10,20,0.5,19,25,0.76,121,2016-11-19,GSW,MIL
424,24,@,W 124-104 ,240,43,85,0.506,28,53,0.528,15,32,0.469,23,31,0.742,124,38,84,0.452,27,60,0.45,11,24,0.458,17,18,0.944,104,2016-11-23,LAC,DAL
425,25,@,W 124-116 ,240,43,83,0.518,31,57,0.544,12,26,0.462,26,36,0.722,124,44,93,0.473,33,70,0.471,11,23,0.478,17,24,0.708,116,2016-12-06,ORL,WAS
426,26,Home,W 124-110 ,240,43,87,0.494,31,60,0.517,12,27,0.444,26,33,0.788,124,45,88,0.511,36,60,0.6,9,28,0.321,11,15,0.733,110,2016-12-08,TOR,MIN
427,27,Home,W 124-118 ,240,43,83,0.518,29,45,0.644,14,38,0.368,24,33,0.727,124,43,85,0.506,31,48,0.646,12,37,0.324,20,21,0.952,118,2016-12-29,CLE,BOS
428,28,@,W 124-122 ,240,38,87,0.437,22,54,0.407,16,33,0.485,32,40,0.8,124,39,84,0.464,28,57,0.491,11,27,0.407,33,41,0.805,122,2016-12-30,PHI,DEN
429,29,Home,L 124-125 (2OT),290,51,98,0.52,36,63,0.571,15,35,0.429,7,12,0.583,124,54,105,0.514,46,80,0.575,8,25,0.32,9,12,0.75,125,2017-01-08,POR,DET
430,30,Home,W 124-122 ,240,43,87,0.494,27,48,0.563,16,39,0.41,22,30,0.733,124,43,93,0.462,28,56,0.5,15,37,0.405,21,25,0.84,122,2017-01-23,NOP,CLE
431,31,Home,W 124-116 ,240,49,92,0.533,36,56,0.643,13,36,0.361,13,20,0.65,124,43,87,0.494,27,54,0.5,16,33,0.485,14,16,0.875,116,2017-01-27,CLE,BRK
432,32,@,W 124-114 ,240,44,84,0.524,39,65,0.6,5,19,0.263,31,38,0.816,124,39,96,0.406,32,76,0.421,7,20,0.35,29,35,0.829,114,2017-02-01,LAC,PHO
433,33,Home,W 124-121 (OT),265,45,97,0.464,35,65,0.538,10,32,0.313,24,34,0.706,124,38,80,0.475,20,40,0.5,18,40,0.45,27,30,0.9,121,2017-02-26,LAC,CHO
434,34,Home,W 123-115 ,240,44,74,0.595,33,56,0.589,11,18,0.611,24,30,0.8,123,43,83,0.518,23,48,0.479,20,35,0.571,9,12,0.75,115,2012-01-11,DEN,NJN
435,35,Home,W 123-84 ,240,48,88,0.545,39,70,0.557,9,18,0.5,18,24,0.75,123,31,84,0.369,19,59,0.322,12,25,0.48,10,14,0.714,84,2012-04-09,DEN,GSW
436,36,Home,W 123-121 (3OT),315,41,95,0.432,29,67,0.433,12,28,0.429,29,37,0.784,123,42,98,0.429,28,64,0.438,14,34,0.412,23,25,0.92,121,2012-04-16,UTA,DAL
437,37,@,W 123-88 ,240,46,82,0.561,31,55,0.564,15,27,0.556,16,21,0.762,123,36,81,0.444,31,63,0.492,5,18,0.278,11,22,0.5,88,2012-12-29,TOR,ORL
438,38,Home,W 123-104 ,240,45,84,0.536,29,55,0.527,16,29,0.552,17,22,0.773,123,43,90,0.478,31,67,0.463,12,23,0.522,6,7,0.857,104,2012-12-31,HOU,ATL
439,39,Home,W 123-116 (OT),265,45,82,0.549,36,60,0.6,9,22,0.409,24,38,0.632,123,44,88,0.5,30,57,0.526,14,31,0.452,14,18,0.778,116,2013-01-23,MIA,TOR
440,40,Home,W 123-111 (2OT),290,42,94,0.447,30,58,0.517,12,36,0.333,27,36,0.75,123,42,93,0.452,35,74,0.473,7,19,0.368,20,20,1.0,111,2013-01-25,ATL,BOS
441,41,Home,W 123-100 ,240,43,92,0.467,30,58,0.517,13,34,0.382,24,26,0.923,123,33,80,0.413,29,64,0.453,4,16,0.25,30,36,0.833,100,2013-02-13,DAL,SAC
442,42,Home,W 123-104 ,240,49,94,0.521,36,67,0.537,13,27,0.481,12,14,0.857,123,39,88,0.443,27,57,0.474,12,31,0.387,14,20,0.7,104,2013-11-05,DAL,LAL
443,43,Home,W 123-117 (OT),265,43,103,0.417,32,78,0.41,11,25,0.44,26,34,0.765,123,43,96,0.448,28,55,0.509,15,41,0.366,16,25,0.64,117,2013-11-13,PHI,HOU
444,44,Home,W 123-120 ,240,42,72,0.583,31,50,0.62,11,22,0.5,28,33,0.848,123,42,76,0.553,30,45,0.667,12,31,0.387,24,33,0.727,120,2013-11-20,DAL,HOU
445,45,Home,W 123-108 ,240,44,86,0.512,29,56,0.518,15,30,0.5,20,22,0.909,123,44,91,0.484,41,74,0.554,3,17,0.176,17,23,0.739,108,2013-12-21,PHO,DAL
446,46,@,W 123-94 ,240,45,84,0.536,32,60,0.533,13,24,0.542,20,26,0.769,123,38,90,0.422,32,67,0.478,6,23,0.261,12,19,0.632,94,2013-12-25,OKC,NYK
447,47,@,W 123-114 ,240,46,82,0.561,31,53,0.585,15,29,0.517,16,19,0.842,123,40,78,0.513,32,60,0.533,8,18,0.444,26,31,0.839,114,2014-01-02,GSW,MIA
448,48,Home,W 123-119 ,240,40,85,0.471,33,70,0.471,7,15,0.467,36,50,0.72,123,39,90,0.433,29,63,0.46,10,27,0.37,31,36,0.861,119,2014-01-07,SAC,POR
449,49,Home,W 123-87 ,240,45,92,0.489,38,69,0.551,7,23,0.304,26,35,0.743,123,29,84,0.345,25,68,0.368,4,16,0.25,25,28,0.893,87,2014-01-10,LAC,LAL
450,50,@,W 123-116 ,240,45,83,0.542,33,59,0.559,12,24,0.5,21,29,0.724,123,39,90,0.433,30,62,0.484,9,28,0.321,29,33,0.879,116,2014-01-15,DEN,GSW
451,51,Home,W 123-78 ,240,50,89,0.562,41,61,0.672,9,28,0.321,14,17,0.824,123,27,100,0.27,24,72,0.333,3,28,0.107,21,25,0.84,78,2014-02-09,LAC,PHI
452,52,Home,W 123-80 ,240,43,88,0.489,31,59,0.525,12,29,0.414,25,30,0.833,123,33,90,0.367,31,73,0.425,2,17,0.118,12,17,0.706,80,2014-02-10,GSW,PHI
453,53,@,W 123-110 ,240,43,83,0.518,27,55,0.491,16,28,0.571,21,26,0.808,123,37,87,0.425,30,69,0.435,7,18,0.389,29,35,0.829,110,2014-02-24,LAC,NOP
454,54,Home,W 123-110 ,240,44,81,0.543,31,49,0.633,13,32,0.406,22,34,0.647,123,43,84,0.512,37,64,0.578,6,20,0.3,18,25,0.72,110,2014-03-10,NYK,PHI
455,55,@,W 123-122 (OT),265,44,92,0.478,34,63,0.54,10,29,0.345,25,31,0.806,123,47,95,0.495,38,68,0.559,9,27,0.333,19,25,0.76,122,2014-03-19,MIN,DAL
456,56,Home,W 123-98 ,240,48,92,0.522,36,71,0.507,12,21,0.571,15,19,0.789,123,33,85,0.388,27,64,0.422,6,21,0.286,26,32,0.813,98,2014-03-29,PHI,DET
457,57,@,W 123-93 ,240,42,79,0.532,30,57,0.526,12,22,0.545,27,35,0.771,123,35,83,0.422,31,65,0.477,4,18,0.222,19,26,0.731,93,2014-04-02,CHA,PHI
458,58,Home,W 123-116 ,240,50,101,0.495,39,73,0.534,11,28,0.393,12,14,0.857,123,40,92,0.435,25,52,0.481,15,40,0.375,21,25,0.84,116,2014-04-09,DEN,HOU
459,59,Home,W 123-70 ,240,41,80,0.513,30,48,0.625,11,32,0.344,30,36,0.833,123,23,77,0.299,16,50,0.32,7,27,0.259,17,33,0.515,70,2014-11-13,DAL,PHI
460,60,@,W 123-104 ,240,45,79,0.57,33,58,0.569,12,21,0.571,21,24,0.875,123,42,87,0.483,34,59,0.576,8,28,0.286,12,15,0.8,104,2014-12-03,TOR,UTA
461,61,Home,W 123-101 ,240,47,82,0.573,40,64,0.625,7,18,0.389,22,25,0.88,123,35,83,0.422,29,67,0.433,6,16,0.375,25,32,0.781,101,2014-12-06,SAS,MIN
462,62,Home,W 123-84 ,240,49,83,0.59,38,58,0.655,11,25,0.44,14,21,0.667,123,33,88,0.375,29,67,0.433,4,21,0.19,14,25,0.56,84,2015-01-22,LAC,BRK
463,63,Home,W 123-118 (2OT),290,50,106,0.472,47,97,0.485,3,9,0.333,20,25,0.8,123,43,104,0.413,37,79,0.468,6,25,0.24,26,32,0.813,118,2015-01-29,LAL,CHI
464,64,Home,W 123-107 ,240,40,75,0.533,27,45,0.6,13,30,0.433,30,37,0.811,123,38,78,0.487,32,55,0.582,6,23,0.261,25,31,0.806,107,2015-02-06,TOR,LAC
465,65,Home,W 123-118 (OT),265,44,96,0.458,37,75,0.493,7,21,0.333,28,34,0.824,123,34,96,0.354,19,61,0.311,15,35,0.429,35,44,0.795,118,2015-03-04,OKC,PHI
466,66,@,W 123-108 ,240,45,76,0.592,27,41,0.659,18,35,0.514,15,19,0.789,123,42,88,0.477,33,69,0.478,9,19,0.474,15,27,0.556,108,2015-03-15,CLE,ORL
467,67,Home,W 123-97 ,240,49,84,0.583,37,62,0.597,12,22,0.545,13,15,0.867,123,38,86,0.442,31,71,0.437,7,15,0.467,14,18,0.778,97,2015-03-15,SAS,MIN
468,68,Home,W 123-115 ,240,43,84,0.512,30,54,0.556,13,30,0.433,24,26,0.923,123,41,82,0.5,28,53,0.528,13,29,0.448,20,25,0.8,115,2015-03-20,OKC,ATL
469,69,@,W 123-111 ,240,46,75,0.613,40,63,0.635,6,12,0.5,25,31,0.806,123,45,90,0.5,37,67,0.552,8,23,0.348,13,18,0.722,111,2015-03-21,BRK,IND
470,70,Home,W 123-93 ,240,47,85,0.553,33,51,0.647,14,34,0.412,15,17,0.882,123,40,87,0.46,34,70,0.486,6,17,0.353,7,11,0.636,93,2015-04-03,SAS,DEN
471,71,@,W 123-110 ,240,43,95,0.453,29,59,0.492,14,36,0.389,23,32,0.719,123,34,80,0.425,31,64,0.484,3,16,0.188,39,54,0.722,110,2015-04-04,GSW,DAL
472,72,Home,W 123-86 ,240,47,91,0.516,32,61,0.525,15,30,0.5,14,23,0.609,123,34,79,0.43,29,62,0.468,5,17,0.294,13,19,0.684,86,2015-11-21,IND,MIL
473,73,@,W 123-106 ,240,44,80,0.55,25,54,0.463,19,26,0.731,16,23,0.696,123,38,83,0.458,25,50,0.5,13,33,0.394,17,24,0.708,106,2015-11-24,IND,WAS
474,74,Home,W 123-111 ,240,44,85,0.518,26,49,0.531,18,36,0.5,17,20,0.85,123,38,88,0.432,25,58,0.431,13,30,0.433,22,24,0.917,111,2015-12-03,POR,IND
475,75,Home,L 123-131 ,240,44,100,0.44,30,67,0.448,14,33,0.424,21,26,0.808,123,52,95,0.547,36,60,0.6,16,35,0.457,11,15,0.733,131,2015-12-08,IND,GSW
476,76,Home,W 123-122 (OT),265,46,93,0.495,39,74,0.527,7,19,0.368,24,31,0.774,123,48,93,0.516,39,70,0.557,9,23,0.391,17,27,0.63,122,2015-12-09,MIN,LAL
477,77,@,W 123-99 ,240,39,78,0.5,21,41,0.512,18,37,0.486,27,30,0.9,123,32,80,0.4,25,60,0.417,7,20,0.35,28,37,0.757,99,2015-12-11,CHA,MEM
478,78,@,L 123-131 ,240,49,100,0.49,39,84,0.464,10,16,0.625,15,22,0.682,123,43,86,0.5,35,64,0.547,8,22,0.364,37,40,0.925,131,2015-12-29,MIL,OKC
479,79,@,W 123-98 ,240,49,90,0.544,40,70,0.571,9,20,0.45,16,20,0.8,123,37,77,0.481,34,65,0.523,3,12,0.25,21,30,0.7,98,2016-01-04,SAS,MIL
480,80,Home,W 123-98 ,240,52,86,0.605,43,65,0.662,9,21,0.429,10,13,0.769,123,37,79,0.468,30,61,0.492,7,18,0.389,17,18,0.944,98,2016-01-06,SAS,UTA
481,81,@,W 123-114 ,240,38,80,0.475,26,50,0.52,12,30,0.4,35,59,0.593,123,43,95,0.453,31,71,0.437,12,24,0.5,16,18,0.889,114,2016-01-20,DET,HOU
482,82,Home,L 123-126 ,240,50,90,0.556,45,76,0.592,5,14,0.357,18,28,0.643,123,48,91,0.527,38,71,0.535,10,20,0.5,20,21,0.952,126,2016-01-27,MIN,OKC
483,83,@,W 123-122 ,240,45,86,0.523,34,54,0.63,11,32,0.344,22,30,0.733,123,41,86,0.477,24,51,0.471,17,35,0.486,23,33,0.697,122,2016-01-30,WAS,HOU
484,84,Home,W 123-110 ,240,44,94,0.468,32,60,0.533,12,34,0.353,23,26,0.885,123,37,87,0.425,24,54,0.444,13,33,0.394,23,35,0.657,110,2016-02-09,GSW,HOU
485,85,Home,W 123-119 ,240,47,90,0.522,35,70,0.5,12,20,0.6,17,18,0.944,123,47,86,0.547,39,67,0.582,8,19,0.421,17,22,0.773,119,2016-02-25,NOP,OKC
486,86,Home,W 123-103 ,240,44,84,0.524,32,62,0.516,12,22,0.545,23,28,0.821,123,35,78,0.449,24,47,0.511,11,31,0.355,22,23,0.957,103,2016-03-06,DET,POR
487,87,Home,W 123-116 ,240,42,84,0.5,31,51,0.608,11,33,0.333,28,33,0.848,123,45,92,0.489,34,63,0.54,11,29,0.379,15,20,0.75,116,2016-03-12,GSW,PHO
488,88,@,W 123-108 ,240,49,90,0.544,37,69,0.536,12,21,0.571,13,16,0.813,123,42,90,0.467,33,72,0.458,9,18,0.5,15,17,0.882,108,2016-03-16,NOP,SAC
489,89,Home,W 123-75 ,240,46,89,0.517,29,57,0.509,17,32,0.531,14,19,0.737,123,26,85,0.306,19,65,0.292,7,20,0.35,16,22,0.727,75,2016-03-28,UTA,LAL
490,90,Home,W 123-109 ,240,45,80,0.563,29,49,0.592,16,31,0.516,17,22,0.773,123,35,74,0.473,27,45,0.6,8,29,0.276,31,34,0.912,109,2016-04-06,IND,CLE
491,91,@,W 123-116 ,240,48,90,0.533,39,68,0.574,9,22,0.409,18,20,0.9,123,41,85,0.482,30,53,0.566,11,32,0.344,23,29,0.793,116,2016-11-02,LAL,ATL
492,92,@,W 123-107 ,240,44,84,0.524,33,61,0.541,11,23,0.478,24,31,0.774,123,41,90,0.456,33,65,0.508,8,25,0.32,17,21,0.81,107,2016-11-06,DEN,BOS
493,93,@,W 123-107 ,240,45,87,0.517,32,64,0.5,13,23,0.565,20,26,0.769,123,38,85,0.447,30,61,0.492,8,24,0.333,23,30,0.767,107,2016-11-09,MIN,ORL
494,94,Home,W 123-115 ,240,39,74,0.527,29,49,0.592,10,25,0.4,35,42,0.833,123,40,80,0.5,32,61,0.525,8,19,0.421,27,32,0.844,115,2016-11-21,LAC,TOR
495,95,@,W 123-114 ,240,41,87,0.471,31,58,0.534,10,29,0.345,31,36,0.861,123,43,86,0.5,34,57,0.596,9,29,0.31,19,25,0.76,114,2016-12-14,TOR,PHI
496,96,Home,W 123-96 ,240,45,80,0.563,36,55,0.655,9,25,0.36,24,27,0.889,123,37,79,0.468,30,55,0.545,7,24,0.292,15,18,0.833,96,2016-12-23,MIL,WAS
497,97,Home,W 123-116 ,240,42,79,0.532,30,53,0.566,12,26,0.462,27,37,0.73,123,42,83,0.506,29,52,0.558,13,31,0.419,19,22,0.864,116,2016-12-23,PHO,PHI
498,98,@,W 123-107 ,240,41,78,0.526,24,46,0.522,17,32,0.531,24,28,0.857,123,36,87,0.414,21,49,0.429,15,38,0.395,20,25,0.8,107,2016-12-27,HOU,DAL
499,99,@,W 123-114 ,240,42,75,0.56,32,58,0.552,10,17,0.588,29,32,0.906,123,37,92,0.402,22,60,0.367,15,32,0.469,25,31,0.806,114,2017-01-01,TOR,LAL
500,0,Home,W 123-112 ,240,37,80,0.463,28,56,0.5,9,24,0.375,40,49,0.816,123,42,96,0.438,33,66,0.5,9,30,0.3,19,23,0.826,112,2017-01-04,CHA,OKC
501,1,Home,W 123-118 (OT),265,38,97,0.392,27,69,0.391,11,28,0.393,36,39,0.923,123,37,85,0.435,29,54,0.537,8,31,0.258,36,43,0.837,118,2017-01-07,CHI,TOR
502,2,Home,W 123-109 ,240,43,86,0.5,32,62,0.516,11,24,0.458,26,28,0.929,123,40,87,0.46,28,56,0.5,12,31,0.387,17,24,0.708,109,2017-01-07,IND,NYK
503,3,Home,L 123-127 (OT),265,42,92,0.457,29,57,0.509,13,35,0.371,26,31,0.839,123,43,92,0.467,33,67,0.493,10,25,0.4,31,36,0.861,127,2017-01-21,BOS,POR
504,4,Home,W 123-98 ,240,46,87,0.529,36,63,0.571,10,24,0.417,21,26,0.808,123,40,96,0.417,30,64,0.469,10,32,0.313,8,8,1.0,98,2017-01-21,DEN,LAC
505,5,Home,W 123-108 ,240,48,83,0.578,39,63,0.619,9,20,0.45,18,21,0.857,123,38,84,0.452,28,51,0.549,10,33,0.303,22,24,0.917,108,2017-01-24,WAS,BOS
506,6,@,W 123-118 ,240,42,81,0.519,30,50,0.6,12,31,0.387,27,28,0.964,123,42,78,0.538,32,53,0.604,10,25,0.4,24,32,0.75,118,2017-01-27,HOU,PHI
507,7,@,W 123-112 ,240,39,80,0.488,31,55,0.564,8,25,0.32,37,42,0.881,123,41,91,0.451,35,70,0.5,6,21,0.286,24,32,0.75,112,2017-01-28,DEN,PHO
508,8,Home,W 123-92 ,240,48,85,0.565,33,57,0.579,15,28,0.536,12,13,0.923,123,37,92,0.402,33,68,0.485,4,24,0.167,14,19,0.737,92,2017-02-08,GSW,CHI
509,9,Home,L 123-131 ,240,52,93,0.559,36,55,0.655,16,38,0.421,3,5,0.6,123,54,95,0.568,38,63,0.603,16,32,0.5,7,10,0.7,131,2017-02-10,NYK,DEN
510,10,Home,W 123-113 ,240,43,81,0.531,30,55,0.545,13,26,0.5,24,26,0.923,123,38,93,0.409,27,65,0.415,11,28,0.393,26,37,0.703,113,2017-02-23,GSW,LAC
511,11,Home,W 123-108 ,240,39,78,0.5,21,36,0.583,18,42,0.429,27,36,0.75,123,43,97,0.443,35,69,0.507,8,28,0.286,14,21,0.667,108,2017-03-04,HOU,MEM
512,12,@,W 123-113 ,240,50,88,0.568,39,62,0.629,11,26,0.423,12,19,0.632,123,46,87,0.529,33,59,0.559,13,28,0.464,8,17,0.471,113,2017-03-08,WAS,DEN
513,13,@,W 122-93 ,240,50,91,0.549,48,78,0.615,2,13,0.154,20,25,0.8,122,34,78,0.436,25,58,0.431,9,20,0.45,16,22,0.727,93,2012-01-25,DEN,SAC
514,14,@,W 122-99 ,240,48,87,0.552,34,60,0.567,14,27,0.519,12,18,0.667,122,35,80,0.438,23,59,0.39,12,21,0.571,17,20,0.85,99,2012-01-30,DAL,PHO
515,15,@,W 122-110 ,240,43,80,0.538,31,57,0.544,12,23,0.522,24,28,0.857,122,40,83,0.482,30,57,0.526,10,26,0.385,20,28,0.714,110,2012-03-03,MIN,POR
516,16,Home,W 122-95 ,240,46,73,0.63,36,50,0.72,10,23,0.435,20,26,0.769,122,36,88,0.409,29,74,0.392,7,14,0.5,16,19,0.842,95,2012-03-10,OKC,CHA
517,17,Home,W 122-111 ,240,43,83,0.518,30,57,0.526,13,26,0.5,23,27,0.852,122,45,86,0.523,34,59,0.576,11,27,0.407,10,16,0.625,111,2012-03-14,SAS,ORL
518,18,Home,W 122-117 (OT),265,44,98,0.449,36,72,0.5,8,26,0.308,26,32,0.813,122,43,96,0.448,31,72,0.431,12,24,0.5,19,25,0.76,117,2012-04-08,BRK,CLE
519,19,Home,W 122-103 ,240,47,87,0.54,30,54,0.556,17,33,0.515,11,17,0.647,122,40,86,0.465,32,62,0.516,8,24,0.333,15,22,0.682,103,2012-11-30,LAL,DEN
520,20,@,W 122-97 ,240,46,85,0.541,38,67,0.567,8,18,0.444,22,29,0.759,122,31,91,0.341,25,67,0.373,6,24,0.25,29,34,0.853,97,2012-12-16,DEN,SAC
521,21,Home,W 122-116 ,240,44,77,0.571,32,54,0.593,12,23,0.522,22,24,0.917,122,45,86,0.523,34,54,0.63,11,32,0.344,15,26,0.577,116,2012-12-28,SAS,HOU
522,22,Home,W 122-95 ,240,52,92,0.565,43,68,0.632,9,24,0.375,9,13,0.692,122,37,79,0.468,31,64,0.484,6,15,0.4,15,25,0.6,95,2013-02-06,CLE,CHA
523,23,Home,W 122-119 ,240,44,92,0.478,29,59,0.492,15,33,0.455,19,23,0.826,122,42,87,0.483,31,59,0.525,11,28,0.393,24,27,0.889,119,2013-02-20,HOU,OKC
524,24,Home,W 122-108 ,240,49,92,0.533,37,65,0.569,12,27,0.444,12,19,0.632,122,38,88,0.432,26,66,0.394,12,22,0.545,20,25,0.8,108,2013-02-22,ATL,SAC
525,25,Home,W 122-114 (OT),265,46,92,0.5,41,78,0.526,5,14,0.357,25,30,0.833,122,46,100,0.46,38,78,0.487,8,22,0.364,14,18,0.778,114,2013-03-02,MIL,TOR
526,26,Home,W 122-105 ,240,49,82,0.598,37,58,0.638,12,24,0.5,12,17,0.706,122,45,97,0.464,44,87,0.506,1,10,0.1,14,18,0.778,105,2013-03-04,POR,CHA
527,27,Home,W 122-105 ,240,46,96,0.479,38,73,0.521,8,23,0.348,22,24,0.917,122,31,77,0.403,19,48,0.396,12,29,0.414,31,40,0.775,105,2013-03-05,OKC,LAL
528,28,Home,W 122-111 ,240,41,81,0.506,32,60,0.533,9,21,0.429,31,44,0.705,122,45,99,0.455,37,75,0.493,8,24,0.333,13,18,0.722,111,2013-11-16,HOU,DEN
529,29,@,W 122-101 ,240,48,89,0.539,35,66,0.53,13,23,0.565,13,15,0.867,122,35,78,0.449,31,65,0.477,4,13,0.308,27,33,0.818,101,2013-12-11,UTA,SAC
530,30,Home,W 122-97 ,240,47,99,0.475,39,74,0.527,8,25,0.32,20,23,0.87,122,36,87,0.414,29,62,0.468,7,25,0.28,18,31,0.581,97,2013-12-13,OKC,LAL
531,31,Home,W 122-103 ,240,51,83,0.614,41,60,0.683,10,23,0.435,10,14,0.714,122,43,74,0.581,36,52,0.692,7,22,0.318,10,24,0.417,103,2013-12-20,MIA,SAC
532,32,Home,W 122-108 ,240,39,71,0.549,28,55,0.509,11,16,0.688,33,42,0.786,122,42,90,0.467,34,60,0.567,8,30,0.267,16,21,0.762,108,2014-02-05,HOU,PHO
533,33,Home,W 122-109 ,240,43,80,0.538,32,59,0.542,11,21,0.524,25,30,0.833,122,41,84,0.488,33,59,0.559,8,25,0.32,19,26,0.731,109,2014-02-08,PHO,GSW
534,34,Home,W 122-117 ,240,46,79,0.582,42,69,0.609,4,10,0.4,26,31,0.839,122,43,84,0.512,30,53,0.566,13,31,0.419,18,22,0.818,117,2014-02-12,LAC,POR
535,35,@,L 122-126 ,240,47,93,0.505,42,78,0.538,5,15,0.333,23,32,0.719,122,48,80,0.6,29,53,0.547,19,27,0.704,11,16,0.688,126,2014-02-28,SAC,LAL
536,36,@,W 122-103 ,240,45,89,0.506,33,63,0.524,12,26,0.462,20,28,0.714,122,38,84,0.452,33,62,0.532,5,22,0.227,22,32,0.688,103,2014-03-01,WAS,PHI
537,37,@,W 122-101 ,240,43,90,0.478,29,57,0.509,14,33,0.424,22,24,0.917,122,38,79,0.481,28,60,0.467,10,19,0.526,15,20,0.75,101,2014-03-04,SAS,CLE
538,38,@,L 122-128 ,240,45,90,0.5,32,57,0.561,13,33,0.394,19,19,1.0,122,42,80,0.525,27,53,0.509,15,27,0.556,29,39,0.744,128,2014-03-06,OKC,PHO
539,39,Home,W 122-104 ,240,49,78,0.628,39,62,0.629,10,16,0.625,14,19,0.737,122,42,91,0.462,37,80,0.463,5,11,0.455,15,21,0.714,104,2014-03-16,SAS,UTA
540,40,Home,L 122-123 (OT),265,47,95,0.495,38,68,0.559,9,27,0.333,19,25,0.76,122,44,92,0.478,34,63,0.54,10,29,0.345,25,31,0.806,123,2014-03-19,DAL,MIN
541,41,Home,W 122-106 ,240,48,89,0.539,36,67,0.537,12,22,0.545,14,17,0.824,122,40,81,0.494,27,51,0.529,13,30,0.433,13,21,0.619,106,2014-03-21,DAL,DEN
542,42,@,W 122-120 (OT),265,52,91,0.571,37,60,0.617,15,31,0.484,3,6,0.5,122,47,96,0.49,33,66,0.5,14,30,0.467,12,16,0.75,120,2014-04-01,GSW,DAL
543,43,@,W 122-121 (2OT),290,43,93,0.462,31,61,0.508,12,32,0.375,24,34,0.706,122,43,99,0.434,32,63,0.508,11,36,0.306,24,30,0.8,121,2014-04-04,MIN,MIA
544,44,Home,W 122-115 ,240,45,77,0.584,34,54,0.63,11,23,0.478,21,31,0.677,122,40,84,0.476,31,52,0.596,9,32,0.281,26,32,0.813,115,2014-04-06,PHO,OKC
545,45,Home,W 122-100 ,240,53,93,0.57,42,67,0.627,11,26,0.423,5,9,0.556,122,34,96,0.354,25,68,0.368,9,28,0.321,23,32,0.719,100,2014-04-09,CLE,DET
546,46,Home,W 122-119 (2OT),290,48,97,0.495,42,76,0.553,6,21,0.286,20,27,0.741,122,43,93,0.462,30,60,0.5,13,33,0.394,20,26,0.769,119,2014-11-07,CHA,ATL
547,47,@,W 122-121 ,240,43,85,0.506,35,62,0.565,8,23,0.348,28,37,0.757,122,48,88,0.545,42,68,0.618,6,20,0.3,19,23,0.826,121,2014-11-14,CLE,BOS
548,48,@,W 122-118 (3OT),315,48,108,0.444,43,84,0.512,5,24,0.208,21,28,0.75,122,44,92,0.478,35,61,0.574,9,31,0.29,21,29,0.724,118,2014-11-19,MIL,BRK
549,49,@,W 122-96 ,240,44,86,0.512,31,55,0.564,13,31,0.419,21,23,0.913,122,36,78,0.462,32,55,0.582,4,23,0.174,20,33,0.606,96,2014-11-21,PHO,PHI
550,50,Home,W 122-97 ,240,41,88,0.466,33,67,0.493,8,21,0.381,32,36,0.889,122,33,85,0.388,25,62,0.403,8,23,0.348,23,29,0.793,97,2014-11-28,DEN,PHO
551,51,@,L 122-129 (OT),265,45,104,0.433,36,70,0.514,9,34,0.265,23,31,0.742,122,47,96,0.49,37,72,0.514,10,24,0.417,25,34,0.735,129,2014-11-30,TOR,LAL
552,52,Home,L 122-128 (OT),265,47,101,0.465,39,74,0.527,8,27,0.296,20,25,0.8,122,44,86,0.512,33,62,0.532,11,24,0.458,29,35,0.829,128,2014-12-14,NOP,GSW
553,53,Home,W 122-110 (2OT),290,48,100,0.48,39,79,0.494,9,21,0.429,17,24,0.708,122,42,100,0.42,34,65,0.523,8,35,0.229,18,23,0.783,110,2015-01-11,MEM,PHO
554,54,Home,W 122-79 ,240,44,81,0.543,31,54,0.574,13,27,0.481,21,27,0.778,122,30,87,0.345,23,63,0.365,7,24,0.292,12,19,0.632,79,2015-01-19,GSW,DEN
555,55,Home,L 122-127 (OT),265,49,101,0.485,45,82,0.549,4,19,0.211,20,26,0.769,122,47,92,0.511,40,66,0.606,7,26,0.269,26,30,0.867,127,2015-01-30,BRK,TOR
556,56,@,W 122-106 ,240,52,90,0.578,47,77,0.61,5,13,0.385,13,17,0.765,122,41,88,0.466,32,73,0.438,9,15,0.6,15,17,0.882,106,2015-03-16,BRK,MIN
557,57,Home,W 122-118 ,240,42,88,0.477,37,69,0.536,5,19,0.263,33,39,0.846,122,44,84,0.524,31,50,0.62,13,34,0.382,17,28,0.607,118,2015-03-18,OKC,BOS
558,58,@,W 122-108 ,240,50,83,0.602,38,57,0.667,12,26,0.462,10,11,0.909,122,39,92,0.424,24,58,0.414,15,34,0.441,15,19,0.789,108,2015-03-24,GSW,POR
559,59,Home,L 122-126 ,240,45,89,0.506,32,64,0.5,13,25,0.52,19,25,0.76,122,46,86,0.535,31,58,0.534,15,28,0.536,19,24,0.792,126,2015-04-01,POR,LAC
560,60,Home,W 122-111 ,240,45,82,0.549,36,56,0.643,9,26,0.346,23,30,0.767,122,38,74,0.514,33,56,0.589,5,18,0.278,30,42,0.714,111,2015-04-12,DEN,SAC
561,61,@,W 122-99 ,240,46,84,0.548,38,67,0.567,8,17,0.471,22,41,0.537,122,36,94,0.383,29,70,0.414,7,24,0.292,20,25,0.8,99,2015-04-15,SAC,LAL
562,62,@,W 122-97 ,240,42,93,0.452,33,70,0.471,9,23,0.391,29,35,0.829,122,30,86,0.349,21,68,0.309,9,18,0.5,28,31,0.903,97,2015-10-28,NYK,MIL
563,63,Home,W 122-114 ,240,37,84,0.44,25,67,0.373,12,17,0.706,36,39,0.923,122,41,81,0.506,31,57,0.544,10,24,0.417,22,31,0.71,114,2015-11-16,MEM,OKC
564,64,Home,W 122-116 ,240,39,85,0.459,28,55,0.509,11,30,0.367,33,40,0.825,122,35,90,0.389,18,54,0.333,17,36,0.472,29,33,0.879,116,2015-11-22,NOP,PHO
565,65,@,L 122-127 (OT),265,52,104,0.5,44,73,0.603,8,31,0.258,10,16,0.625,122,49,98,0.5,40,69,0.58,9,29,0.31,20,26,0.769,127,2015-11-23,SAC,CHO
566,66,@,L 122-127 (OT),265,47,97,0.485,33,64,0.516,14,33,0.424,14,15,0.933,122,44,87,0.506,32,60,0.533,12,27,0.444,27,44,0.614,127,2015-12-02,PHO,DET
567,67,Home,W 122-119 (OT),265,43,92,0.467,35,69,0.507,8,23,0.348,28,37,0.757,122,40,93,0.43,28,64,0.438,12,29,0.414,27,34,0.794,119,2015-12-05,UTA,IND
568,68,@,L 122-123 (OT),265,48,93,0.516,39,70,0.557,9,23,0.391,17,27,0.63,122,46,93,0.495,39,74,0.527,7,19,0.368,24,31,0.774,123,2015-12-09,LAL,MIN
569,69,Home,W 122-112 ,240,48,83,0.578,40,68,0.588,8,15,0.533,18,21,0.857,122,46,94,0.489,37,69,0.536,9,25,0.36,11,15,0.733,112,2015-12-27,OKC,DEN
570,70,Home,W 122-103 ,240,43,89,0.483,23,47,0.489,20,42,0.476,16,24,0.667,122,37,95,0.389,24,64,0.375,13,31,0.419,16,28,0.571,103,2015-12-28,GSW,SAC
571,71,@,W 122-117 ,240,37,71,0.521,22,41,0.537,15,30,0.5,33,41,0.805,122,38,88,0.432,29,58,0.5,9,30,0.3,32,36,0.889,117,2015-12-30,LAC,CHO
572,72,Home,W 122-100 ,240,41,74,0.554,24,41,0.585,17,33,0.515,23,26,0.885,122,36,73,0.493,28,54,0.519,8,19,0.421,20,29,0.69,100,2016-01-04,CLE,TOR
573,73,Home,W 122-110 ,240,43,90,0.478,29,57,0.509,14,33,0.424,22,25,0.88,122,44,95,0.463,41,78,0.526,3,17,0.176,19,27,0.704,110,2016-01-22,GSW,IND
574,74,Home,L 122-128 (OT),265,44,95,0.463,33,72,0.458,11,23,0.478,23,30,0.767,122,46,99,0.465,35,79,0.443,11,20,0.55,25,29,0.862,128,2016-01-26,NYK,OKC
575,75,Home,L 122-123 ,240,41,86,0.477,24,51,0.471,17,35,0.486,23,33,0.697,122,45,86,0.523,34,54,0.63,11,32,0.344,22,30,0.733,123,2016-01-30,HOU,WAS
576,76,@,W 122-106 ,240,42,85,0.494,27,52,0.519,15,33,0.455,23,30,0.767,122,37,73,0.507,36,62,0.581,1,11,0.091,31,39,0.795,106,2016-02-08,OKC,PHO
577,77,@,L 122-124 ,240,49,101,0.485,39,73,0.534,10,28,0.357,14,17,0.824,122,43,83,0.518,35,68,0.515,8,15,0.533,30,40,0.75,124,2016-02-22,BOS,MIN
578,78,@,W 122-95 ,240,46,87,0.529,35,62,0.565,11,25,0.44,19,25,0.76,122,37,84,0.44,31,64,0.484,6,20,0.3,15,23,0.652,95,2016-02-22,TOR,NYK
579,79,Home,W 122-116 (OT),265,45,88,0.511,34,59,0.576,11,29,0.379,21,27,0.778,122,43,93,0.462,34,64,0.531,9,29,0.31,21,31,0.677,116,2016-02-26,DAL,DEN
580,80,Home,W 122-113 ,240,38,82,0.463,23,47,0.489,15,35,0.429,31,38,0.816,122,40,85,0.471,30,52,0.577,10,33,0.303,23,28,0.821,113,2016-03-09,CHA,NOP
581,81,@,W 122-106 ,240,43,76,0.566,31,46,0.674,12,30,0.4,24,32,0.75,122,40,82,0.488,31,57,0.544,9,25,0.36,17,24,0.708,106,2016-03-16,LAC,HOU
582,82,Home,W 122-101 ,240,46,84,0.548,35,65,0.538,11,19,0.579,19,23,0.826,122,40,76,0.526,30,52,0.577,10,24,0.417,11,13,0.846,101,2016-03-19,MIA,CLE
583,83,@,W 122-101 ,240,45,84,0.536,28,42,0.667,17,42,0.405,15,22,0.682,122,39,92,0.424,27,62,0.435,12,30,0.4,11,12,0.917,101,2016-03-23,ATL,WAS
584,84,Home,W 122-98 ,240,48,95,0.505,38,70,0.543,10,25,0.4,16,19,0.842,122,35,77,0.455,20,42,0.476,15,35,0.429,13,25,0.52,98,2016-04-12,TOR,PHI
585,85,Home,W 122-117 ,240,48,89,0.539,37,57,0.649,11,32,0.344,15,18,0.833,122,43,97,0.443,28,53,0.528,15,44,0.341,16,20,0.8,117,2016-10-26,BOS,BRK
586,86,@,W 122-114 ,240,44,91,0.484,35,63,0.556,9,28,0.321,25,28,0.893,122,47,100,0.47,42,78,0.538,5,22,0.227,15,23,0.652,114,2016-10-28,GSW,NOP
587,87,@,L 122-128 ,240,46,96,0.479,35,64,0.547,11,32,0.344,19,22,0.864,122,41,84,0.488,27,50,0.54,14,34,0.412,32,37,0.865,128,2016-11-03,BOS,CLE
588,88,Home,W 122-96 ,240,46,89,0.517,32,59,0.542,14,30,0.467,16,20,0.8,122,35,87,0.402,25,60,0.417,10,27,0.37,16,28,0.571,96,2016-11-03,GSW,OKC
589,89,Home,W 122-100 ,240,41,84,0.488,29,52,0.558,12,32,0.375,28,32,0.875,122,40,94,0.426,31,61,0.508,9,33,0.273,11,15,0.733,100,2016-11-07,CHA,IND
590,90,Home,W 122-115 (OT),265,49,90,0.544,40,71,0.563,9,19,0.474,15,20,0.75,122,46,95,0.484,32,59,0.542,14,36,0.389,9,19,0.474,115,2016-11-09,IND,PHI
591,91,Home,W 122-120 (OT),265,45,86,0.523,32,53,0.604,13,33,0.394,19,27,0.704,122,43,88,0.489,37,67,0.552,6,21,0.286,28,35,0.8,120,2016-11-11,POR,SAC
592,92,@,W 122-104 ,240,40,84,0.476,24,47,0.511,16,37,0.432,26,30,0.867,122,40,107,0.374,32,74,0.432,8,33,0.242,16,21,0.762,104,2016-11-12,BRK,PHO
593,93,@,W 122-105 ,240,46,86,0.535,33,63,0.524,13,23,0.565,17,22,0.773,122,38,87,0.437,22,48,0.458,16,39,0.41,13,14,0.929,105,2016-11-27,SAC,BRK
594,94,Home,W 122-95 ,240,42,77,0.545,29,58,0.5,13,19,0.684,25,31,0.806,122,36,86,0.419,22,52,0.423,14,34,0.412,9,13,0.692,95,2016-11-28,TOR,PHI
595,95,@,L 122-127 (2OT),290,46,109,0.422,33,69,0.478,13,40,0.325,17,22,0.773,122,45,104,0.433,32,66,0.485,13,38,0.342,24,36,0.667,127,2016-11-29,LAC,BRK
596,96,Home,W 122-118 ,240,42,91,0.462,25,48,0.521,17,43,0.395,21,36,0.583,122,42,80,0.525,35,60,0.583,7,20,0.35,27,36,0.75,118,2016-12-12,HOU,BRK
597,97,Home,W 122-100 ,240,42,81,0.519,28,56,0.5,14,25,0.56,24,28,0.857,122,42,89,0.472,38,65,0.585,4,24,0.167,12,17,0.706,100,2016-12-12,TOR,MIL
598,98,Home,W 122-100 ,240,42,94,0.447,18,33,0.545,24,61,0.393,14,19,0.737,122,40,98,0.408,31,71,0.437,9,27,0.333,11,20,0.55,100,2016-12-16,HOU,NOP
599,99,Home,W 122-108 ,240,44,77,0.571,32,52,0.615,12,25,0.48,22,27,0.815,122,42,86,0.488,32,58,0.552,10,28,0.357,14,21,0.667,108,2016-12-16,WAS,DET
600,0,Home,L 122-124 ,240,39,84,0.464,28,57,0.491,11,27,0.407,33,41,0.805,122,38,87,0.437,22,54,0.407,16,33,0.485,32,40,0.8,124,2016-12-30,DEN,PHI
601,1,@,L 122-129 ,240,47,105,0.448,37,73,0.507,10,32,0.313,18,25,0.72,122,42,92,0.457,21,37,0.568,21,55,0.382,24,29,0.828,129,2016-12-31,NYK,HOU
602,2,Home,L 122-129 ,240,42,78,0.538,31,53,0.585,11,25,0.44,27,30,0.9,122,46,89,0.517,35,51,0.686,11,38,0.289,26,31,0.839,129,2017-01-08,TOR,HOU
603,3,@,W 122-118 ,240,40,90,0.444,31,62,0.5,9,28,0.321,33,41,0.805,122,37,81,0.457,28,56,0.5,9,25,0.36,35,40,0.875,118,2017-01-15,OKC,SAC
604,4,Home,W 122-114 ,240,43,84,0.512,35,66,0.53,8,18,0.444,28,35,0.8,122,36,73,0.493,30,60,0.5,6,13,0.462,36,41,0.878,114,2017-01-17,SAS,MIN
605,5,Home,W 122-73 ,240,43,87,0.494,26,48,0.542,17,39,0.436,19,19,1.0,122,28,73,0.384,25,52,0.481,3,21,0.143,14,17,0.824,73,2017-01-22,DAL,LAL
606,6,@,L 122-124 ,240,43,93,0.462,28,56,0.5,15,37,0.405,21,25,0.84,122,43,87,0.494,27,48,0.563,16,39,0.41,22,30,0.733,124,2017-01-23,CLE,NOP
607,7,Home,W 122-119 ,240,45,83,0.542,34,52,0.654,11,31,0.355,21,26,0.808,122,41,74,0.554,28,45,0.622,13,29,0.448,24,29,0.828,119,2017-01-30,PHI,SAC
608,8,@,W 122-107 ,240,39,77,0.506,24,44,0.545,15,33,0.455,29,38,0.763,122,34,87,0.391,25,61,0.41,9,26,0.346,30,37,0.811,107,2017-02-10,GSW,MEM
609,9,@,W 122-114 ,240,39,75,0.52,24,45,0.533,15,30,0.5,29,35,0.829,122,40,76,0.526,32,48,0.667,8,28,0.286,26,31,0.839,114,2017-02-10,LAL,MIL
610,10,@,W 122-106 ,240,45,75,0.6,33,50,0.66,12,25,0.48,20,27,0.741,122,38,82,0.463,32,55,0.582,6,27,0.222,24,32,0.75,106,2017-02-10,NOP,MIN
611,11,@,W 122-103 ,240,37,87,0.425,17,35,0.486,20,52,0.385,28,33,0.848,122,42,94,0.447,30,60,0.5,12,34,0.353,7,13,0.538,103,2017-03-01,HOU,LAC
612,12,@,W 122-109 ,240,39,73,0.534,25,43,0.581,14,30,0.467,30,38,0.789,122,34,77,0.442,24,52,0.462,10,25,0.4,31,39,0.795,109,2017-03-06,BRK,MEM
613,13,Home,W 122-111 ,240,45,83,0.542,28,52,0.538,17,31,0.548,15,19,0.789,122,42,90,0.467,31,60,0.517,11,30,0.367,16,22,0.727,111,2017-03-07,DAL,LAL
614,14,@,W 122-110 ,240,47,98,0.48,35,71,0.493,12,27,0.444,16,24,0.667,122,42,91,0.462,36,72,0.5,6,19,0.316,20,25,0.8,110,2017-03-09,LAL,PHO
615,15,Home,W 121-117 ,240,49,89,0.551,40,69,0.58,9,20,0.45,14,18,0.778,121,46,81,0.568,38,65,0.585,8,16,0.5,17,26,0.654,117,2012-01-07,SAS,DEN
616,16,Home,W 121-94 ,240,46,83,0.554,35,59,0.593,11,24,0.458,18,24,0.75,121,34,70,0.486,27,50,0.54,7,20,0.35,19,27,0.704,94,2012-01-21,ATL,CLE
617,17,Home,W 121-115 ,240,44,84,0.524,35,65,0.538,9,19,0.474,24,26,0.923,121,42,89,0.472,33,72,0.458,9,17,0.529,22,28,0.786,115,2012-02-14,CHI,SAC
618,18,Home,W 121-79 ,240,43,80,0.538,24,42,0.571,19,38,0.5,16,26,0.615,121,28,75,0.373,23,58,0.397,5,17,0.294,18,23,0.783,79,2012-03-14,NYK,POR
619,19,Home,W 121-102 ,240,48,81,0.593,41,66,0.621,7,15,0.467,18,29,0.621,121,36,78,0.462,30,60,0.5,6,18,0.333,24,32,0.75,102,2012-03-23,UTA,DEN
620,20,@,W 121-84 ,240,50,88,0.568,40,72,0.556,10,16,0.625,11,18,0.611,121,34,85,0.4,28,63,0.444,6,22,0.273,10,19,0.526,84,2012-03-30,MIL,CLE
621,21,@,L 121-123 (3OT),315,42,98,0.429,28,64,0.438,14,34,0.412,23,25,0.92,121,41,95,0.432,29,67,0.433,12,28,0.429,29,37,0.784,123,2012-04-16,DAL,UTA
622,22,Home,W 121-112 ,240,49,88,0.557,42,75,0.56,7,13,0.538,16,25,0.64,121,42,93,0.452,37,74,0.5,5,19,0.263,23,27,0.852,112,2012-04-18,WAS,MIL
623,23,Home,W 121-97 ,240,47,77,0.61,37,62,0.597,10,15,0.667,17,18,0.944,121,33,76,0.434,27,62,0.435,6,14,0.429,25,30,0.833,97,2012-04-20,SAS,LAL
624,24,Home,W 121-100 ,240,38,79,0.481,21,46,0.457,17,33,0.515,28,31,0.903,121,37,78,0.474,28,58,0.483,9,20,0.45,17,22,0.773,100,2012-11-25,NYK,DET
625,25,Home,W 121-104 ,240,47,85,0.553,30,57,0.526,17,28,0.607,10,11,0.909,121,40,86,0.465,34,76,0.447,6,10,0.6,18,22,0.818,104,2012-12-19,PHO,CHA
626,26,Home,W 121-96 ,240,44,82,0.537,32,54,0.593,12,28,0.429,21,26,0.808,121,42,79,0.532,40,66,0.606,2,13,0.154,10,14,0.714,96,2012-12-22,HOU,MEM
627,27,Home,W 121-118 (OT),265,45,93,0.484,37,75,0.493,8,18,0.444,23,34,0.676,121,35,76,0.461,27,52,0.519,8,24,0.333,40,48,0.833,118,2013-01-20,DEN,OKC
628,28,Home,W 121-93 ,240,47,89,0.528,34,58,0.586,13,31,0.419,14,17,0.824,121,37,88,0.42,29,66,0.439,8,22,0.364,11,22,0.5,93,2013-01-26,DEN,SAC
629,29,Home,W 121-112 ,240,45,82,0.549,32,55,0.582,13,27,0.481,18,21,0.857,121,43,90,0.478,36,67,0.537,7,23,0.304,19,23,0.826,112,2013-03-08,SAC,PHO
630,30,Home,W 121-79 ,240,45,83,0.542,36,60,0.6,9,23,0.391,22,26,0.846,121,32,83,0.386,30,62,0.484,2,21,0.095,13,15,0.867,79,2013-03-13,SAC,CHI
631,31,Home,W 121-110 ,240,47,85,0.553,37,65,0.569,10,20,0.5,17,23,0.739,121,38,78,0.487,32,60,0.533,6,18,0.333,28,35,0.8,110,2013-04-10,SAC,NOH
632,32,Home,W 121-100 ,240,45,83,0.542,32,56,0.571,13,27,0.481,18,24,0.75,121,39,100,0.39,31,75,0.413,8,25,0.32,14,17,0.824,100,2013-04-14,HOU,SAC
633,33,Home,W 121-82 ,240,48,82,0.585,40,61,0.656,8,21,0.381,17,19,0.895,121,32,81,0.395,28,69,0.406,4,12,0.333,14,23,0.609,82,2013-11-24,LAC,CHI
634,34,@,W 121-105 ,240,51,93,0.548,43,73,0.589,8,20,0.4,11,14,0.786,121,42,92,0.457,30,61,0.492,12,31,0.387,9,21,0.429,105,2013-11-29,NOP,PHI
635,35,Home,W 121-83 ,240,44,83,0.53,27,49,0.551,17,34,0.5,16,19,0.842,121,30,70,0.429,20,45,0.444,10,25,0.4,13,20,0.65,83,2013-12-06,NYK,ORL
636,36,@,W 121-94 ,240,41,85,0.482,30,61,0.492,11,24,0.458,28,33,0.848,121,39,83,0.47,31,55,0.564,8,28,0.286,8,16,0.5,94,2013-12-10,MIN,DET
637,37,Home,W 121-120 (OT),265,51,100,0.51,42,71,0.592,9,29,0.31,10,15,0.667,121,42,85,0.494,27,52,0.519,15,33,0.455,21,30,0.7,120,2013-12-20,PHI,BRK
638,38,Home,W 121-119 (OT),265,46,91,0.505,36,62,0.581,10,29,0.345,19,29,0.655,121,44,91,0.484,27,57,0.474,17,34,0.5,14,19,0.737,119,2013-12-23,MIA,ATL
639,39,Home,W 121-114 ,240,49,100,0.49,45,81,0.556,4,19,0.211,19,25,0.76,121,43,91,0.473,37,71,0.521,6,20,0.3,22,24,0.917,114,2014-01-15,PHO,LAL
640,40,@,L 121-127 ,240,43,82,0.524,27,55,0.491,16,27,0.593,19,34,0.559,121,47,81,0.58,38,59,0.644,9,22,0.409,24,33,0.727,127,2014-01-17,GSW,OKC
641,41,Home,W 121-114 ,240,42,81,0.519,30,50,0.6,12,31,0.387,25,27,0.926,121,38,78,0.487,23,45,0.511,15,33,0.455,23,28,0.821,114,2014-01-20,ATL,MIA
642,42,@,W 121-120 ,240,47,94,0.5,38,72,0.528,9,22,0.409,18,28,0.643,121,49,89,0.551,40,67,0.597,9,22,0.409,13,15,0.867,120,2014-01-24,MIN,GSW
643,43,@,L 121-129 (2OT),290,45,95,0.474,30,61,0.492,15,34,0.441,16,23,0.696,121,49,99,0.495,40,83,0.482,9,16,0.563,22,26,0.846,129,2014-02-21,NYK,ORL
644,44,@,W 121-104 ,240,43,84,0.512,32,62,0.516,11,22,0.5,24,33,0.727,121,37,79,0.468,34,60,0.567,3,19,0.158,27,36,0.75,104,2014-02-22,MIN,UTA
645,45,Home,W 121-112 ,240,43,81,0.531,34,61,0.557,9,20,0.45,26,35,0.743,121,46,96,0.479,39,78,0.5,7,18,0.389,13,17,0.765,112,2014-03-08,SAS,ORL
646,46,Home,W 121-120 (OT),265,47,94,0.5,44,79,0.557,3,15,0.2,24,28,0.857,121,45,97,0.464,33,71,0.465,12,26,0.462,18,23,0.783,120,2014-03-16,NOP,BOS
647,47,@,W 121-113 ,240,38,75,0.507,27,52,0.519,11,23,0.478,34,38,0.895,121,42,85,0.494,35,62,0.565,7,23,0.304,22,25,0.88,113,2014-03-16,PHO,TOR
648,48,Home,L 121-122 (2OT),290,43,99,0.434,32,63,0.508,11,36,0.306,24,30,0.8,121,43,93,0.462,31,61,0.508,12,32,0.375,24,34,0.706,122,2014-04-04,MIA,MIN
649,49,Home,W 121-105 ,240,49,88,0.557,41,66,0.621,8,22,0.364,15,23,0.652,121,39,80,0.488,32,61,0.525,7,19,0.368,20,26,0.769,105,2014-10-29,BOS,BRK
650,50,Home,W 121-104 ,240,43,74,0.581,28,49,0.571,15,25,0.6,20,20,1.0,121,38,82,0.463,31,63,0.492,7,19,0.368,21,27,0.778,104,2014-11-05,GSW,LAC
651,51,Home,L 121-122 ,240,48,88,0.545,42,68,0.618,6,20,0.3,19,23,0.826,121,43,85,0.506,35,62,0.565,8,23,0.348,28,37,0.757,122,2014-11-14,BOS,CLE
652,52,@,W 121-92 ,240,46,84,0.548,33,63,0.524,13,21,0.619,16,18,0.889,121,37,90,0.411,33,77,0.429,4,13,0.308,14,22,0.636,92,2014-11-21,SAS,MIN
653,53,Home,W 121-120 (OT),265,44,96,0.458,35,65,0.538,9,31,0.29,24,30,0.8,121,44,91,0.484,28,54,0.519,16,37,0.432,16,20,0.8,120,2014-12-08,LAC,PHO
654,54,@,W 121-114 ,240,48,81,0.593,41,63,0.651,7,18,0.389,18,29,0.621,121,41,84,0.488,33,57,0.579,8,27,0.296,24,33,0.727,114,2015-01-12,ORL,CHI
655,55,Home,L 121-126 ,240,43,91,0.473,33,62,0.532,10,29,0.345,25,36,0.694,121,46,83,0.554,36,60,0.6,10,23,0.435,24,31,0.774,126,2015-01-16,LAC,CLE
656,56,@,W 121-96 ,240,46,91,0.505,36,68,0.529,10,23,0.435,19,26,0.731,121,35,79,0.443,28,63,0.444,7,16,0.438,19,24,0.792,96,2015-02-03,GSW,SAC
657,57,@,W 121-115 (2OT),290,45,109,0.413,39,91,0.429,6,18,0.333,25,26,0.962,121,39,97,0.402,31,66,0.47,8,31,0.258,29,40,0.725,115,2015-02-27,NYK,DET
658,58,Home,W 121-113 ,240,46,85,0.541,42,78,0.538,4,7,0.571,25,31,0.806,121,43,88,0.489,29,61,0.475,14,27,0.519,13,17,0.765,113,2015-03-07,MIN,POR
659,59,Home,W 121-114 ,240,39,73,0.534,30,49,0.612,9,24,0.375,34,48,0.708,121,44,91,0.484,33,64,0.516,11,27,0.407,15,22,0.682,114,2015-04-12,HOU,NOP
660,60,@,W 121-115 ,240,41,77,0.532,32,56,0.571,9,21,0.429,30,35,0.857,121,42,84,0.5,32,54,0.593,10,30,0.333,21,24,0.875,115,2015-11-06,ATL,NOP
661,61,Home,W 121-97 ,240,45,80,0.563,33,56,0.589,12,24,0.5,19,22,0.864,121,34,82,0.415,25,61,0.41,9,21,0.429,20,26,0.769,97,2015-11-24,ATL,BOS
662,62,Home,W 121-112 ,240,42,87,0.483,33,61,0.541,9,26,0.346,28,37,0.757,121,42,91,0.462,38,73,0.521,4,18,0.222,24,28,0.857,112,2015-12-18,GSW,MIL
663,63,@,W 121-115 ,240,43,99,0.434,29,58,0.5,14,41,0.341,21,25,0.84,121,39,72,0.542,28,52,0.538,11,20,0.55,26,39,0.667,115,2015-12-29,ATL,HOU
664,64,Home,W 121-103 ,240,45,86,0.523,32,62,0.516,13,24,0.542,18,19,0.947,121,37,74,0.5,28,52,0.538,9,22,0.409,20,33,0.606,103,2016-01-02,SAS,HOU
665,65,@,W 121-115 ,240,48,89,0.539,36,60,0.6,12,29,0.414,13,19,0.684,121,42,76,0.553,28,52,0.538,14,24,0.583,17,27,0.63,115,2016-01-06,CLE,WAS
666,66,Home,W 121-103 ,240,47,93,0.505,37,62,0.597,10,31,0.323,17,22,0.773,121,34,69,0.493,27,52,0.519,7,17,0.412,28,32,0.875,103,2016-01-23,POR,LAL
667,67,Home,W 121-117 ,240,41,79,0.519,33,61,0.541,8,18,0.444,31,37,0.838,121,38,92,0.413,29,68,0.426,9,24,0.375,32,38,0.842,117,2016-01-30,MEM,SAC
668,68,Home,L 121-134 ,240,46,91,0.505,38,68,0.559,8,23,0.348,21,30,0.7,121,49,93,0.527,29,52,0.558,20,41,0.488,16,29,0.552,134,2016-02-03,WAS,GSW
669,69,@,W 121-119 (OT),265,48,92,0.522,42,66,0.636,6,26,0.231,19,27,0.704,121,36,75,0.48,25,46,0.543,11,29,0.379,36,41,0.878,119,2016-02-09,UTA,DAL
670,70,Home,W 121-95 ,240,45,86,0.523,33,54,0.611,12,32,0.375,19,23,0.826,121,38,88,0.432,35,72,0.486,3,16,0.188,16,24,0.667,95,2016-02-11,OKC,NOP
671,71,Home,W 121-114 ,240,41,81,0.506,34,64,0.531,7,17,0.412,32,40,0.8,121,40,76,0.526,28,49,0.571,12,27,0.444,22,26,0.846,114,2016-02-19,NOP,PHI
672,72,@,W 121-101 ,240,47,97,0.485,37,65,0.569,10,32,0.313,17,20,0.85,121,34,73,0.466,28,52,0.538,6,21,0.286,27,34,0.794,101,2016-02-21,BOS,DEN
673,73,@,W 121-118 (OT),265,45,95,0.474,31,63,0.492,14,32,0.438,17,25,0.68,121,46,96,0.479,37,70,0.529,9,26,0.346,17,26,0.654,118,2016-02-27,GSW,OKC
674,74,@,L 121-128 ,240,41,87,0.471,26,51,0.51,15,36,0.417,24,35,0.686,121,48,81,0.593,40,66,0.606,8,15,0.533,24,33,0.727,128,2016-02-29,HOU,MIL
675,75,Home,W 121-108 ,240,43,77,0.558,34,58,0.586,9,19,0.474,26,31,0.839,121,41,91,0.451,32,61,0.525,9,30,0.3,17,20,0.85,108,2016-03-01,DAL,ORL
676,76,Home,W 121-106 ,240,47,87,0.54,36,53,0.679,11,34,0.324,16,21,0.762,121,40,86,0.465,36,66,0.545,4,20,0.2,22,27,0.815,106,2016-03-03,GSW,OKC
677,77,@,W 121-120 (OT),265,46,91,0.505,33,69,0.478,13,22,0.591,16,21,0.762,121,46,96,0.479,40,70,0.571,6,26,0.231,22,25,0.88,120,2016-03-04,BRK,DEN
678,78,Home,W 121-114 (OT),265,47,96,0.49,41,82,0.5,6,14,0.429,21,32,0.656,121,42,96,0.438,35,72,0.486,7,24,0.292,23,34,0.676,114,2016-03-11,MEM,NOP
679,79,Home,W 121-84 ,240,47,84,0.56,30,49,0.612,17,35,0.486,10,11,0.909,121,34,91,0.374,27,65,0.415,7,26,0.269,9,18,0.5,84,2016-03-12,POR,ORL
680,80,Home,W 121-85 ,240,46,91,0.505,28,54,0.519,18,37,0.486,11,12,0.917,121,36,91,0.396,29,72,0.403,7,19,0.368,6,10,0.6,85,2016-03-16,GSW,NYK
681,81,Home,W 121-116 ,240,41,81,0.506,34,55,0.618,7,26,0.269,32,40,0.8,121,41,84,0.488,26,51,0.51,15,33,0.455,19,23,0.826,116,2016-03-28,MIN,PHO
682,82,Home,W 121-103 ,240,48,95,0.505,40,67,0.597,8,28,0.286,17,20,0.85,121,39,92,0.424,32,75,0.427,7,17,0.412,18,24,0.75,103,2016-04-06,WAS,BRK
683,83,@,W 121-100 ,240,43,83,0.518,33,58,0.569,10,25,0.4,25,31,0.806,121,39,95,0.411,32,74,0.432,7,21,0.333,15,20,0.75,100,2016-04-09,PHO,NOP
684,84,@,W 121-116 ,240,44,77,0.571,34,54,0.63,10,23,0.435,23,26,0.885,121,41,80,0.513,29,54,0.537,12,26,0.462,22,28,0.786,116,2016-04-11,CHI,NOP
685,85,@,L 121-130 (OT),265,45,104,0.433,27,56,0.482,18,48,0.375,13,18,0.722,121,47,93,0.505,37,74,0.5,10,19,0.526,26,34,0.765,130,2016-10-26,DAL,IND
686,86,@,L 121-124 ,240,43,86,0.5,36,65,0.554,7,21,0.333,28,33,0.848,121,45,81,0.556,31,50,0.62,14,31,0.452,20,28,0.714,124,2016-11-08,PHO,POR
687,87,Home,W 121-117 ,240,44,83,0.53,31,50,0.62,13,33,0.394,20,28,0.714,121,46,96,0.479,33,67,0.493,13,29,0.448,12,18,0.667,117,2016-11-15,CLE,TOR
688,88,Home,L 121-127 ,240,37,82,0.451,27,57,0.474,10,25,0.4,37,41,0.902,121,44,87,0.506,31,51,0.608,13,36,0.361,26,28,0.929,127,2016-11-16,TOR,GSW
689,89,@,W 121-115 ,240,40,76,0.526,27,47,0.574,13,29,0.448,28,34,0.824,121,38,86,0.442,28,60,0.467,10,26,0.385,29,35,0.829,115,2016-11-18,LAC,SAC
690,90,Home,L 121-124 ,240,46,89,0.517,36,69,0.522,10,20,0.5,19,25,0.76,121,42,95,0.442,28,57,0.491,14,38,0.368,26,32,0.813,124,2016-11-19,MIL,GSW
691,91,Home,W 121-116 (OT),265,43,98,0.439,29,62,0.468,14,36,0.389,21,25,0.84,121,40,97,0.412,25,54,0.463,15,43,0.349,21,28,0.75,116,2016-11-19,NOP,CHO
692,92,@,W 121-114 ,240,48,87,0.552,39,67,0.582,9,20,0.45,16,21,0.762,121,40,91,0.44,25,49,0.51,15,42,0.357,19,20,0.95,114,2016-11-30,DET,BOS
693,93,@,W 121-85 ,240,48,89,0.539,31,60,0.517,17,29,0.586,8,12,0.667,121,32,88,0.364,26,64,0.406,6,24,0.25,15,20,0.75,85,2016-12-02,DET,ATL
694,94,@,W 121-113 ,240,47,83,0.566,39,64,0.609,8,19,0.421,19,25,0.76,121,43,88,0.489,32,61,0.525,11,27,0.407,16,24,0.667,113,2016-12-10,DEN,ORL
695,95,Home,W 121-120 ,240,42,89,0.472,31,66,0.47,11,23,0.478,26,28,0.929,121,44,87,0.506,34,66,0.515,10,21,0.476,22,25,0.88,120,2016-12-12,LAC,POR
696,96,Home,L 121-125 ,240,47,86,0.547,37,65,0.569,10,21,0.476,17,26,0.654,121,46,86,0.535,35,61,0.574,11,25,0.44,22,32,0.688,125,2016-12-16,TOR,ATL
697,97,@,L 121-126 ,240,44,86,0.512,40,59,0.678,4,27,0.148,29,40,0.725,121,40,72,0.556,30,49,0.612,10,23,0.435,36,43,0.837,126,2016-12-20,POR,SAC
698,98,@,W 121-110 ,240,45,88,0.511,34,60,0.567,11,28,0.393,20,24,0.833,121,42,88,0.477,34,68,0.5,8,20,0.4,18,23,0.783,110,2016-12-21,OKC,NOP
699,99,Home,W 121-111 ,240,46,81,0.568,32,58,0.552,14,23,0.609,15,18,0.833,121,40,103,0.388,27,68,0.397,13,35,0.371,18,22,0.818,111,2016-12-28,GSW,TOR
700,0,@,W 121-109 ,240,43,85,0.506,29,54,0.537,14,31,0.452,21,25,0.84,121,40,78,0.513,31,54,0.574,9,24,0.375,20,23,0.87,109,2016-12-31,CLE,CHO
701,1,@,W 121-116 ,240,43,74,0.581,34,58,0.586,9,16,0.563,26,30,0.867,121,48,97,0.495,38,68,0.559,10,29,0.345,10,12,0.833,116,2017-01-03,IND,DET
702,2,Home,W 121-109 ,240,48,93,0.516,38,71,0.535,10,22,0.455,15,19,0.789,121,41,90,0.456,24,52,0.462,17,38,0.447,10,13,0.769,109,2017-01-05,IND,BRK
703,3,Home,W 121-106 ,240,43,89,0.483,31,53,0.585,12,36,0.333,23,29,0.793,121,40,99,0.404,31,75,0.413,9,24,0.375,17,24,0.708,106,2017-01-07,OKC,DEN
704,4,Home,W 121-114 ,240,40,82,0.488,23,43,0.535,17,39,0.436,24,33,0.727,121,44,92,0.478,25,49,0.51,19,43,0.442,7,9,0.778,114,2017-01-10,HOU,CHO
705,5,Home,L 121-127 ,240,47,108,0.435,36,78,0.462,11,30,0.367,16,18,0.889,121,50,88,0.568,39,62,0.629,11,26,0.423,16,26,0.615,127,2017-01-17,LAL,DEN
706,6,Home,W 121-100 ,240,46,85,0.541,36,64,0.563,10,21,0.476,19,27,0.704,121,38,90,0.422,30,62,0.484,8,28,0.286,16,19,0.842,100,2017-01-18,GSW,OKC
707,7,Home,W 121-110 ,240,45,90,0.5,35,61,0.574,10,29,0.345,21,22,0.955,121,33,71,0.465,15,37,0.405,18,34,0.529,26,41,0.634,110,2017-01-24,PHI,LAC
708,8,Home,W 121-108 ,240,45,89,0.506,37,75,0.493,8,14,0.571,23,28,0.821,121,44,99,0.444,34,71,0.479,10,28,0.357,10,14,0.714,108,2017-01-29,CHI,PHI
709,9,Home,W 121-117 ,240,40,89,0.449,31,61,0.508,9,28,0.321,32,44,0.727,121,45,83,0.542,36,59,0.61,9,24,0.375,18,23,0.783,117,2017-02-03,DEN,MIL
710,10,Home,W 121-117 (OT),265,44,98,0.449,28,55,0.509,16,43,0.372,17,25,0.68,121,48,100,0.48,40,75,0.533,8,25,0.32,13,18,0.722,117,2017-02-03,HOU,CHI
711,11,Home,W 121-97 ,240,45,79,0.57,35,58,0.603,10,21,0.476,21,26,0.808,121,41,92,0.446,31,66,0.47,10,26,0.385,5,10,0.5,97,2017-02-04,SAS,DEN
712,12,@,W 121-107 ,240,44,102,0.431,36,74,0.486,8,28,0.286,25,31,0.806,121,37,82,0.451,30,61,0.492,7,21,0.333,26,33,0.788,107,2017-02-06,LAL,NYK
713,13,Home,W 121-102 ,240,51,97,0.526,47,81,0.58,4,16,0.25,15,24,0.625,121,37,86,0.43,31,63,0.492,6,23,0.261,22,26,0.846,102,2017-02-08,DET,LAL
714,14,@,L 121-128 (OT),265,49,93,0.527,41,69,0.594,8,24,0.333,15,25,0.6,121,46,98,0.469,34,72,0.472,12,26,0.462,24,31,0.774,128,2017-02-24,PHO,CHI
715,15,@,L 121-124 (OT),265,38,80,0.475,20,40,0.5,18,40,0.45,27,30,0.9,121,45,97,0.464,35,65,0.538,10,32,0.313,24,34,0.706,124,2017-02-26,CHA,LAC
716,16,Home,L 121-126 ,240,44,85,0.518,34,60,0.567,10,25,0.4,23,30,0.767,121,47,85,0.553,36,62,0.581,11,23,0.478,21,27,0.778,126,2017-03-07,OKC,POR
717,17,Home,W 120-89 ,240,47,85,0.553,35,67,0.522,12,18,0.667,14,19,0.737,120,36,81,0.444,32,64,0.5,4,17,0.235,13,20,0.65,89,2012-01-13,PHI,WAS
718,18,Home,W 120-98 ,240,46,79,0.582,30,53,0.566,16,26,0.615,12,19,0.632,120,38,80,0.475,28,55,0.509,10,25,0.4,12,17,0.706,98,2012-01-17,MIA,SAS
719,19,@,W 120-109 ,240,42,88,0.477,38,71,0.535,4,17,0.235,32,37,0.865,120,41,87,0.471,29,59,0.492,12,28,0.429,15,19,0.789,109,2012-01-27,OKC,GSW
720,20,@,W 120-108 ,240,43,74,0.581,37,57,0.649,6,17,0.353,28,31,0.903,120,40,85,0.471,33,66,0.5,7,19,0.368,21,30,0.7,108,2012-01-30,MIN,HOU
721,21,@,W 120-103 ,240,41,78,0.526,35,63,0.556,6,15,0.4,32,39,0.821,120,40,77,0.519,31,61,0.508,9,16,0.563,14,17,0.824,103,2012-02-01,PHO,NOH
722,22,Home,W 120-108 ,240,45,81,0.556,35,58,0.603,10,23,0.435,20,23,0.87,120,40,89,0.449,27,62,0.435,13,27,0.481,15,19,0.789,108,2012-02-21,MIA,SAC
723,23,Home,W 120-103 ,240,43,85,0.506,37,65,0.569,6,20,0.3,28,42,0.667,120,38,82,0.463,29,62,0.468,9,20,0.45,18,27,0.667,103,2012-02-29,NYK,CLE
724,24,@,W 120-100 ,240,45,83,0.542,30,60,0.5,15,23,0.652,15,16,0.938,120,36,85,0.424,28,63,0.444,8,22,0.364,20,36,0.556,100,2012-03-05,GSW,WAS
725,25,@,W 120-108 ,240,43,84,0.512,29,57,0.509,14,27,0.519,20,24,0.833,120,38,78,0.487,26,48,0.542,12,30,0.4,20,32,0.625,108,2012-03-09,LAC,SAS
726,26,Home,W 120-111 ,240,44,78,0.564,35,59,0.593,9,19,0.474,23,32,0.719,120,47,90,0.522,42,77,0.545,5,13,0.385,12,17,0.706,111,2012-03-14,PHO,UTA
727,27,@,W 120-98 ,240,45,93,0.484,35,71,0.493,10,22,0.455,20,22,0.909,120,35,79,0.443,25,57,0.439,10,22,0.455,18,20,0.9,98,2012-03-16,MIL,GSW
728,28,Home,W 120-95 ,240,46,86,0.535,37,65,0.569,9,21,0.429,19,21,0.905,120,36,80,0.45,30,61,0.492,6,19,0.316,17,21,0.81,95,2012-03-16,SAC,BOS
729,29,Home,W 120-112 ,240,44,82,0.537,34,63,0.54,10,19,0.526,22,31,0.71,120,44,90,0.489,33,69,0.478,11,21,0.524,13,15,0.867,112,2012-04-01,LAL,GSW
730,30,Home,W 120-93 ,240,47,83,0.566,38,64,0.594,9,19,0.474,17,19,0.895,120,36,79,0.456,31,65,0.477,5,14,0.357,16,20,0.8,93,2012-04-04,ATL,CHA
731,31,@,W 120-99 ,240,36,92,0.391,24,65,0.369,12,27,0.444,36,43,0.837,120,38,93,0.409,30,73,0.411,8,20,0.4,15,17,0.882,99,2012-04-16,SAS,GSW
732,32,Home,W 120-107 ,240,43,79,0.544,35,63,0.556,8,16,0.5,26,32,0.813,120,39,75,0.52,33,62,0.532,6,13,0.462,23,28,0.821,107,2012-10-30,MIA,BOS
733,33,Home,W 120-98 ,240,47,87,0.54,38,65,0.585,9,22,0.409,17,22,0.773,120,36,87,0.414,28,66,0.424,8,21,0.381,18,30,0.6,98,2012-11-28,OKC,HOU
734,34,@,W 120-97 ,240,46,82,0.561,38,62,0.613,8,20,0.4,20,24,0.833,120,37,83,0.446,31,63,0.492,6,20,0.3,17,20,0.85,97,2012-12-25,HOU,CHI
735,35,Home,W 120-91 ,240,46,82,0.561,39,71,0.549,7,11,0.636,21,25,0.84,120,37,87,0.425,32,69,0.464,5,18,0.278,12,15,0.8,91,2013-01-14,WAS,ORL
736,36,Home,W 120-81 ,240,47,86,0.547,28,43,0.651,19,43,0.442,7,13,0.538,120,32,76,0.421,26,55,0.473,6,21,0.286,11,15,0.733,81,2013-02-02,NYK,SAC
737,37,Home,W 120-109 ,240,44,85,0.518,36,66,0.545,8,19,0.421,24,35,0.686,120,40,82,0.488,36,67,0.537,4,15,0.267,25,26,0.962,109,2013-02-09,SAC,UTA
738,38,@,W 120-113 ,240,46,85,0.541,38,69,0.551,8,16,0.5,20,32,0.625,120,39,85,0.459,27,54,0.5,12,31,0.387,23,28,0.821,113,2013-03-05,DEN,SAC
739,39,@,W 120-117 ,240,44,82,0.537,34,60,0.567,10,22,0.455,22,38,0.579,120,45,97,0.464,40,80,0.5,5,17,0.294,22,30,0.733,117,2013-03-27,LAL,MIN
740,40,Home,L 120-125 ,240,45,78,0.577,36,61,0.59,9,17,0.529,21,25,0.84,120,46,93,0.495,31,59,0.525,15,34,0.441,18,24,0.75,125,2013-04-07,OKC,NYK
741,41,Home,W 120-99 ,240,45,80,0.563,25,44,0.568,20,36,0.556,10,14,0.714,120,35,77,0.455,27,57,0.474,8,20,0.4,21,30,0.7,99,2013-04-09,NYK,WAS
742,42,@,W 120-88 ,240,48,81,0.593,38,65,0.585,10,16,0.625,14,19,0.737,120,35,83,0.422,30,69,0.435,5,14,0.357,13,15,0.867,88,2013-04-13,BOS,ORL
743,43,Home,W 120-115 (OT),265,42,100,0.42,34,75,0.453,8,25,0.32,28,34,0.824,120,47,100,0.47,37,73,0.507,10,27,0.37,11,18,0.611,115,2013-10-30,MIN,ORL
744,44,@,W 120-89 ,240,41,76,0.539,29,48,0.604,12,28,0.429,26,30,0.867,120,31,82,0.378,25,60,0.417,6,22,0.273,21,29,0.724,89,2013-11-10,SAS,NYK
745,45,Home,W 120-105 ,240,51,85,0.6,46,73,0.63,5,12,0.417,13,15,0.867,120,39,85,0.459,32,67,0.478,7,18,0.389,20,23,0.87,105,2013-11-11,BOS,ORL
746,46,@,L 120-123 ,240,42,76,0.553,30,45,0.667,12,31,0.387,24,33,0.727,120,42,72,0.583,31,50,0.62,11,22,0.5,28,33,0.848,123,2013-11-20,HOU,DAL
747,47,@,W 120-92 ,240,38,74,0.514,23,50,0.46,15,24,0.625,29,32,0.906,120,29,71,0.408,14,42,0.333,15,29,0.517,19,21,0.905,92,2013-11-20,MIA,ORL
748,48,Home,W 120-106 ,240,42,81,0.519,32,57,0.561,10,24,0.417,26,31,0.839,120,39,86,0.453,32,67,0.478,7,19,0.368,21,24,0.875,106,2013-11-27,PHO,POR
749,49,Home,W 120-109 ,240,46,93,0.495,39,74,0.527,7,19,0.368,21,26,0.808,120,40,94,0.426,26,54,0.481,14,40,0.35,15,19,0.789,109,2013-12-18,MIN,POR
750,50,@,L 120-121 (OT),265,42,85,0.494,27,52,0.519,15,33,0.455,21,30,0.7,120,51,100,0.51,42,71,0.592,9,29,0.31,10,15,0.667,121,2013-12-20,BRK,PHI
751,51,Home,W 120-116 (OT),265,46,97,0.474,39,68,0.574,7,29,0.241,21,27,0.778,120,45,96,0.469,39,74,0.527,6,22,0.273,20,27,0.741,116,2013-12-22,LAC,MIN
752,52,Home,W 120-98 ,240,42,85,0.494,37,70,0.529,5,15,0.333,31,38,0.816,120,38,83,0.458,30,62,0.484,8,21,0.381,14,17,0.824,98,2013-12-27,MIN,WAS
753,53,Home,W 120-99 ,240,47,91,0.516,39,72,0.542,8,19,0.421,18,25,0.72,120,33,70,0.471,23,48,0.479,10,22,0.455,23,28,0.821,99,2013-12-28,MEM,DEN
754,54,Home,W 120-94 ,240,44,87,0.506,32,59,0.542,12,28,0.429,20,26,0.769,120,37,84,0.44,33,64,0.516,4,20,0.2,16,23,0.696,94,2014-01-11,DEN,ORL
755,55,@,W 120-118 ,240,41,88,0.466,28,71,0.394,13,17,0.765,25,32,0.781,120,44,84,0.524,31,50,0.62,13,34,0.382,17,23,0.739,118,2014-01-14,CLE,LAL
756,56,Home,L 120-121 ,240,49,89,0.551,40,67,0.597,9,22,0.409,13,15,0.867,120,47,94,0.5,38,72,0.528,9,22,0.409,18,28,0.643,121,2014-01-24,GSW,MIN
757,57,@,W 120-95 ,240,49,77,0.636,44,62,0.71,5,15,0.333,17,20,0.85,120,35,74,0.473,24,50,0.48,11,24,0.458,14,17,0.824,95,2014-01-31,OKC,BRK
758,58,Home,W 120-113 ,240,43,92,0.467,34,69,0.493,9,23,0.391,25,30,0.833,120,37,84,0.44,31,68,0.456,6,16,0.375,33,39,0.846,113,2014-02-01,ATL,MIN
759,59,Home,W 120-110 ,240,44,82,0.537,35,63,0.556,9,19,0.474,23,25,0.92,120,45,90,0.5,40,80,0.5,5,10,0.5,15,17,0.882,110,2014-02-26,SAS,DET
760,60,@,L 120-129 ,240,44,84,0.524,30,53,0.566,14,31,0.452,18,26,0.692,120,44,80,0.55,29,56,0.518,15,24,0.625,26,30,0.867,129,2014-03-02,ATL,PHO
761,61,@,W 120-112 ,240,47,92,0.511,37,70,0.529,10,22,0.455,16,24,0.667,120,45,93,0.484,36,69,0.522,9,24,0.375,13,13,1.0,112,2014-03-12,DEN,ORL
762,62,@,L 120-121 (OT),265,45,97,0.464,33,71,0.465,12,26,0.462,18,23,0.783,120,47,94,0.5,44,79,0.557,3,15,0.2,24,28,0.857,121,2014-03-16,BOS,NOP
763,63,Home,W 120-115 (OT),265,42,97,0.433,30,58,0.517,12,39,0.308,24,27,0.889,120,45,98,0.459,37,81,0.457,8,17,0.471,17,26,0.654,115,2014-03-18,POR,MIL
764,64,Home,L 120-127 ,240,40,91,0.44,32,68,0.471,8,23,0.348,32,37,0.865,120,46,80,0.575,34,53,0.642,12,27,0.444,23,29,0.793,127,2014-03-23,MIN,PHO
765,65,Home,W 120-98 ,240,44,90,0.489,35,64,0.547,9,26,0.346,23,34,0.676,120,35,90,0.389,21,54,0.389,14,36,0.389,14,22,0.636,98,2014-03-27,HOU,PHI
766,66,Home,L 120-122 (OT),265,47,96,0.49,33,66,0.5,14,30,0.467,12,16,0.75,120,52,91,0.571,37,60,0.617,15,31,0.484,3,6,0.5,122,2014-04-01,DAL,GSW
767,67,Home,W 120-97 ,240,47,83,0.566,37,64,0.578,10,19,0.526,16,26,0.615,120,36,86,0.419,29,55,0.527,7,31,0.226,18,23,0.783,97,2014-04-06,LAC,LAL
768,68,@,L 120-130 ,240,43,81,0.531,35,66,0.53,8,15,0.533,26,33,0.788,120,49,101,0.485,34,64,0.531,15,37,0.405,17,19,0.895,130,2014-04-14,MIN,GSW
769,69,Home,W 120-102 ,240,47,85,0.553,39,64,0.609,8,21,0.381,18,23,0.783,120,36,83,0.434,22,48,0.458,14,35,0.4,16,18,0.889,102,2014-10-30,DAL,UTA
770,70,Home,W 120-88 ,240,43,76,0.566,36,59,0.61,7,17,0.412,27,30,0.9,120,33,87,0.379,23,53,0.434,10,34,0.294,12,18,0.667,88,2014-11-09,TOR,PHI
771,71,Home,W 120-107 ,240,36,68,0.529,22,39,0.564,14,29,0.483,34,43,0.791,120,38,99,0.384,27,69,0.391,11,30,0.367,20,23,0.87,107,2014-11-15,LAC,PHO
772,72,Home,W 120-112 ,240,45,88,0.511,32,63,0.508,13,25,0.52,17,21,0.81,120,39,90,0.433,31,65,0.477,8,25,0.32,26,34,0.765,112,2014-11-26,PHO,DEN
773,73,@,W 120-119 ,240,45,79,0.57,35,61,0.574,10,18,0.556,20,24,0.833,120,48,89,0.539,40,68,0.588,8,21,0.381,15,22,0.682,119,2014-11-28,MIN,LAL
774,74,Home,W 120-100 ,240,43,78,0.551,26,46,0.565,17,32,0.531,17,24,0.708,120,38,80,0.475,30,57,0.526,8,23,0.348,16,25,0.64,100,2014-12-06,LAC,NOP
775,75,@,L 120-121 (OT),265,44,91,0.484,28,54,0.519,16,37,0.432,16,20,0.8,120,44,96,0.458,35,65,0.538,9,31,0.29,24,30,0.8,121,2014-12-08,PHO,LAC
776,76,@,W 120-115 (OT),265,45,93,0.484,34,67,0.507,11,26,0.423,19,27,0.704,120,40,82,0.488,29,54,0.537,11,28,0.393,24,34,0.706,115,2014-12-13,MEM,PHI
777,77,@,L 120-129 ,240,44,100,0.44,35,70,0.5,9,30,0.3,23,32,0.719,120,40,74,0.541,34,62,0.548,6,12,0.5,43,47,0.915,129,2014-12-22,TOR,CHI
778,78,@,W 120-96 ,240,41,77,0.532,25,41,0.61,16,36,0.444,22,32,0.688,120,37,80,0.463,26,54,0.481,11,26,0.423,11,21,0.524,96,2015-01-08,HOU,NYK
779,79,Home,W 120-100 ,240,46,88,0.523,33,57,0.579,13,31,0.419,15,21,0.714,120,38,86,0.442,26,56,0.464,12,30,0.4,12,17,0.706,100,2015-01-10,LAC,DAL
780,80,Home,W 120-89 ,240,42,89,0.472,26,58,0.448,16,31,0.516,20,24,0.833,120,36,76,0.474,31,56,0.554,5,20,0.25,12,15,0.8,89,2015-01-11,ATL,WAS
781,81,Home,W 120-113 ,240,44,90,0.489,35,64,0.547,9,26,0.346,23,26,0.885,120,42,83,0.506,33,57,0.579,9,26,0.346,20,23,0.87,113,2015-01-14,ORL,HOU
782,82,@,W 120-100 ,240,43,87,0.494,33,64,0.516,10,23,0.435,24,36,0.667,120,34,80,0.425,24,51,0.471,10,29,0.345,22,27,0.815,100,2015-01-25,LAC,PHO
783,83,@,W 120-116 (OT),265,44,88,0.5,33,62,0.532,11,26,0.423,21,30,0.7,120,37,79,0.468,27,55,0.491,10,24,0.417,32,41,0.78,116,2015-01-31,TOR,WAS
784,84,Home,W 120-105 ,240,45,82,0.549,27,49,0.551,18,33,0.545,12,20,0.6,120,41,100,0.41,34,77,0.442,7,23,0.304,16,19,0.842,105,2015-02-08,CLE,LAL
785,85,@,W 120-112 ,240,40,78,0.513,25,42,0.595,15,36,0.417,25,34,0.735,120,43,79,0.544,33,58,0.569,10,21,0.476,16,17,0.941,112,2015-03-04,CLE,TOR
786,86,Home,W 120-111 ,240,43,79,0.544,34,55,0.618,9,24,0.375,25,33,0.758,120,45,86,0.523,39,69,0.565,6,17,0.353,15,23,0.652,111,2015-03-06,SAS,DEN
787,87,@,W 120-108 ,240,35,76,0.461,20,46,0.435,15,30,0.5,35,47,0.745,120,33,76,0.434,21,51,0.412,12,25,0.48,30,36,0.833,108,2015-03-11,LAC,OKC
788,88,Home,W 120-110 ,240,44,83,0.53,24,39,0.615,20,44,0.455,12,17,0.706,120,37,76,0.487,31,62,0.5,6,14,0.429,30,34,0.882,110,2015-03-27,HOU,MIN
789,89,Home,W 120-114 ,240,48,85,0.565,40,67,0.597,8,18,0.444,16,18,0.889,120,43,92,0.467,34,68,0.5,9,24,0.375,19,22,0.864,114,2015-03-28,POR,DEN
790,90,@,W 120-106 ,240,45,83,0.542,35,62,0.565,10,21,0.476,20,26,0.769,120,34,78,0.436,25,54,0.463,9,24,0.375,29,36,0.806,106,2015-04-12,DAL,LAL
791,91,Home,L 120-134 ,240,46,100,0.46,38,78,0.487,8,22,0.364,20,23,0.87,120,46,84,0.548,29,54,0.537,17,30,0.567,25,35,0.714,134,2015-10-31,NOP,GSW
792,92,@,W 120-109 ,240,43,85,0.506,36,65,0.554,7,20,0.35,27,31,0.871,120,36,86,0.419,30,60,0.5,6,26,0.231,31,38,0.816,109,2015-11-03,DEN,LAL
793,93,@,W 120-103 ,240,47,96,0.49,36,66,0.545,11,30,0.367,15,22,0.682,120,41,76,0.539,32,51,0.627,9,25,0.36,12,18,0.667,103,2015-11-08,DET,POR
794,94,Home,W 120-105 ,240,46,92,0.5,32,59,0.542,14,33,0.424,14,18,0.778,120,39,88,0.443,34,68,0.5,5,20,0.25,22,26,0.846,105,2015-11-10,NOP,DAL
795,95,Home,W 120-101 ,240,45,93,0.484,34,63,0.54,11,30,0.367,19,25,0.76,120,37,77,0.481,28,57,0.491,9,20,0.45,18,20,0.9,101,2015-11-16,PHO,LAL
796,96,Home,W 120-95 ,240,51,87,0.586,41,58,0.707,10,29,0.345,8,10,0.8,120,35,89,0.393,27,70,0.386,8,19,0.421,17,24,0.708,95,2015-11-20,BOS,BRK
797,97,@,W 120-114 ,240,42,81,0.519,32,59,0.542,10,22,0.455,26,34,0.765,120,44,96,0.458,34,70,0.486,10,26,0.385,16,20,0.8,114,2015-11-25,NOP,PHO
798,98,Home,W 120-101 ,240,39,80,0.488,23,50,0.46,16,30,0.533,26,31,0.839,120,39,100,0.39,29,75,0.387,10,25,0.4,13,15,0.867,101,2015-11-28,GSW,SAC
799,99,Home,W 120-113 ,240,36,78,0.462,20,44,0.455,16,34,0.471,32,43,0.744,120,46,98,0.469,36,72,0.5,10,26,0.385,11,13,0.846,113,2015-12-05,HOU,SAC
800,0,@,W 120-85 ,240,51,95,0.537,46,76,0.605,5,19,0.263,13,17,0.765,120,32,89,0.36,25,64,0.391,7,25,0.28,14,22,0.636,85,2015-12-23,OKC,LAL
801,1,@,W 120-116 ,240,45,77,0.584,39,63,0.619,6,14,0.429,24,35,0.686,120,41,82,0.5,28,52,0.538,13,30,0.433,21,26,0.808,116,2015-12-31,MIL,IND
802,2,Home,W 120-105 ,240,49,94,0.521,39,70,0.557,10,24,0.417,12,15,0.8,120,36,83,0.434,29,65,0.446,7,18,0.389,26,31,0.839,105,2016-01-09,ATL,CHI
803,3,Home,W 120-114 ,240,43,81,0.531,36,61,0.59,7,20,0.35,27,30,0.9,120,42,86,0.488,33,57,0.579,9,29,0.31,21,26,0.808,114,2016-01-12,NYK,BOS
804,4,@,W 120-116 (OT),265,45,101,0.446,35,74,0.473,10,27,0.37,20,22,0.909,120,45,91,0.495,34,68,0.5,11,23,0.478,15,19,0.789,116,2016-01-22,CHA,ORL
805,5,Home,W 120-90 ,240,44,85,0.518,33,59,0.559,11,26,0.423,21,25,0.84,120,31,74,0.419,26,60,0.433,5,14,0.357,23,31,0.742,90,2016-01-25,GSW,SAS
806,6,Home,W 120-93 ,240,45,84,0.536,28,52,0.538,17,32,0.531,13,19,0.684,120,40,93,0.43,35,78,0.449,5,15,0.333,8,11,0.727,93,2016-01-31,LAC,CHI
807,7,Home,W 120-100 ,240,45,94,0.479,29,59,0.492,16,35,0.457,14,19,0.737,120,36,82,0.439,27,59,0.458,9,23,0.391,19,29,0.655,100,2016-02-08,CLE,SAC
808,8,Home,W 120-111 ,240,48,94,0.511,35,63,0.556,13,31,0.419,11,18,0.611,120,38,86,0.442,25,58,0.431,13,28,0.464,22,27,0.815,111,2016-02-10,CLE,LAL
809,9,Home,L 120-121 (OT),265,46,96,0.479,40,70,0.571,6,26,0.231,22,25,0.88,120,46,91,0.505,33,69,0.478,13,22,0.591,16,21,0.762,121,2016-03-04,DEN,BRK
810,10,Home,W 120-103 ,240,42,82,0.512,32,52,0.615,10,30,0.333,26,34,0.765,120,37,80,0.463,27,57,0.474,10,23,0.435,19,27,0.704,103,2016-03-05,CLE,BOS
811,11,Home,W 120-108 ,240,48,91,0.527,39,67,0.582,9,24,0.375,15,18,0.833,120,41,81,0.506,29,47,0.617,12,34,0.353,14,23,0.609,108,2016-03-09,OKC,LAC
812,12,@,W 120-111 ,240,39,90,0.433,26,46,0.565,13,44,0.295,29,35,0.829,120,40,84,0.476,32,62,0.516,8,22,0.364,23,32,0.719,111,2016-03-09,CLE,SAC
813,13,@,W 120-108 ,240,45,85,0.529,29,50,0.58,16,35,0.457,14,20,0.7,120,42,80,0.525,35,58,0.603,7,22,0.318,17,21,0.81,108,2016-03-10,CLE,LAL
814,14,@,L 120-132 (OT),265,42,104,0.404,24,58,0.414,18,46,0.391,18,28,0.643,120,49,89,0.551,34,64,0.531,15,25,0.6,19,23,0.826,132,2016-03-20,POR,DAL
815,15,@,W 120-105 ,240,46,94,0.489,36,69,0.522,10,25,0.4,18,21,0.857,120,39,92,0.424,31,71,0.437,8,21,0.381,19,27,0.704,105,2016-03-20,BOS,PHI
816,16,@,L 120-128 ,240,43,96,0.448,25,61,0.41,18,35,0.514,16,21,0.762,120,43,88,0.489,22,43,0.512,21,45,0.467,21,23,0.913,128,2016-03-25,DAL,GSW
817,17,Home,W 120-110 ,240,42,77,0.545,37,66,0.561,5,11,0.455,31,36,0.861,120,37,77,0.481,26,53,0.491,11,24,0.458,25,30,0.833,110,2016-03-26,BRK,IND
818,18,Home,W 120-111 ,240,47,84,0.56,39,66,0.591,8,18,0.444,18,25,0.72,120,43,89,0.483,34,63,0.54,9,26,0.346,16,20,0.8,111,2016-03-30,SAC,WAS
819,19,Home,W 120-115 ,240,43,84,0.512,28,51,0.549,15,33,0.455,19,24,0.792,120,43,91,0.473,34,69,0.493,9,22,0.409,20,31,0.645,115,2016-04-06,POR,OKC
820,20,@,W 120-111 ,240,46,89,0.517,37,64,0.578,9,25,0.36,19,24,0.792,120,44,98,0.449,34,67,0.507,10,31,0.323,13,21,0.619,111,2016-04-11,WAS,BRK
821,21,Home,W 120-114 ,240,45,89,0.506,33,54,0.611,12,35,0.343,18,22,0.818,120,44,86,0.512,37,57,0.649,7,29,0.241,19,27,0.704,114,2016-10-26,LAL,HOU
822,22,@,L 120-128 ,240,43,90,0.478,26,46,0.565,17,44,0.386,17,25,0.68,120,43,83,0.518,27,51,0.529,16,32,0.5,26,31,0.839,128,2016-11-01,HOU,CLE
823,23,@,L 120-122 (OT),265,43,88,0.489,37,67,0.552,6,21,0.286,28,35,0.8,120,45,86,0.523,32,53,0.604,13,33,0.394,19,27,0.704,122,2016-11-11,SAC,POR
824,24,@,L 120-133 ,240,46,90,0.511,38,66,0.576,8,24,0.333,20,26,0.769,120,45,87,0.517,29,54,0.537,16,33,0.485,27,31,0.871,133,2016-11-13,PHO,GSW
825,25,Home,W 120-104 ,240,45,93,0.484,37,76,0.487,8,17,0.471,22,24,0.917,120,39,79,0.494,31,59,0.525,8,20,0.4,18,29,0.621,104,2016-11-16,DEN,PHO
826,26,Home,W 120-105 ,240,45,86,0.523,28,51,0.549,17,35,0.486,13,20,0.65,120,39,92,0.424,33,71,0.465,6,21,0.286,21,34,0.618,105,2016-11-19,PHI,PHO
827,27,@,W 120-83 ,240,40,90,0.444,27,54,0.5,13,36,0.361,27,32,0.844,120,33,103,0.32,27,80,0.338,6,23,0.261,11,12,0.917,83,2016-11-21,GSW,IND
828,28,@,W 120-114 ,240,39,89,0.438,26,60,0.433,13,29,0.448,29,32,0.906,120,36,89,0.404,25,64,0.391,11,25,0.44,31,36,0.861,114,2016-11-27,DEN,PHO
829,29,Home,W 120-101 ,240,41,74,0.554,26,46,0.565,15,28,0.536,23,27,0.852,120,37,91,0.407,26,61,0.426,11,30,0.367,16,22,0.727,101,2016-11-29,UTA,HOU
830,30,Home,W 120-105 ,240,38,69,0.551,22,37,0.595,16,32,0.5,28,33,0.848,120,36,81,0.444,25,54,0.463,11,27,0.407,22,26,0.846,105,2016-11-30,TOR,MEM
831,31,Home,L 120-125 (OT),265,44,101,0.436,30,65,0.462,14,36,0.389,18,26,0.692,120,48,106,0.453,38,79,0.481,10,27,0.37,19,22,0.864,125,2016-12-03,CHA,MIN
832,32,@,W 120-89 ,240,47,84,0.56,37,62,0.597,10,22,0.455,16,21,0.762,120,32,78,0.41,22,48,0.458,10,30,0.333,15,20,0.75,89,2016-12-07,SAC,DAL
833,33,@,W 120-119 (OT),265,38,97,0.392,22,57,0.386,16,40,0.4,28,35,0.8,120,44,96,0.458,30,55,0.545,14,41,0.341,17,26,0.654,119,2016-12-11,NOP,PHO
834,34,@,L 120-121 ,240,44,87,0.506,34,66,0.515,10,21,0.476,22,25,0.88,120,42,89,0.472,31,66,0.47,11,23,0.478,26,28,0.929,121,2016-12-12,POR,LAC
835,35,Home,L 120-131 ,240,45,89,0.506,34,61,0.557,11,28,0.393,19,21,0.905,120,51,87,0.586,36,53,0.679,15,34,0.441,14,20,0.7,131,2016-12-13,ATL,ORL
836,36,@,L 120-132 ,240,41,88,0.466,33,65,0.508,8,23,0.348,30,36,0.833,120,43,84,0.512,28,53,0.528,15,31,0.484,31,35,0.886,132,2016-12-15,POR,DEN
837,37,Home,W 120-118 ,240,40,75,0.533,25,44,0.568,15,31,0.484,25,31,0.806,120,44,94,0.468,36,68,0.529,8,26,0.308,22,25,0.88,118,2016-12-26,BRK,CHO
838,38,@,W 120-101 ,240,46,84,0.548,36,60,0.6,10,24,0.417,18,19,0.947,120,42,86,0.488,33,52,0.635,9,34,0.265,8,10,0.8,101,2016-12-28,CHA,ORL
839,39,@,W 120-113 ,240,46,88,0.523,35,59,0.593,11,29,0.379,17,18,0.944,120,41,82,0.5,23,44,0.523,18,38,0.474,13,13,1.0,113,2017-01-03,SAC,DEN
840,40,@,W 120-116 ,240,44,82,0.537,29,48,0.604,15,34,0.441,17,19,0.895,120,46,87,0.529,37,60,0.617,9,27,0.333,15,19,0.789,116,2017-01-08,CLE,PHO
841,41,@,W 120-108 ,240,44,87,0.506,29,50,0.58,15,37,0.405,17,22,0.773,120,42,80,0.525,33,55,0.6,9,25,0.36,15,19,0.789,108,2017-01-13,CLE,SAC
842,42,Home,W 120-98 ,240,45,82,0.549,33,54,0.611,12,28,0.429,18,22,0.818,120,36,85,0.424,26,55,0.473,10,30,0.333,16,19,0.842,98,2017-01-16,LAC,OKC
843,43,Home,W 120-101 ,240,42,86,0.488,29,63,0.46,13,23,0.565,23,25,0.92,120,37,88,0.42,29,62,0.468,8,26,0.308,19,25,0.76,101,2017-01-16,WAS,POR
844,44,Home,W 120-109 ,240,47,91,0.516,36,59,0.61,11,32,0.344,15,16,0.938,120,36,77,0.468,26,46,0.565,10,31,0.323,27,38,0.711,109,2017-01-25,BOS,HOU
845,45,@,L 120-127 ,240,48,89,0.539,38,65,0.585,10,24,0.417,14,17,0.824,120,44,86,0.512,35,63,0.556,9,23,0.391,30,35,0.857,127,2017-01-26,PHO,DEN
846,46,Home,W 120-101 ,240,47,87,0.54,42,66,0.636,5,21,0.238,21,26,0.808,120,34,83,0.41,23,44,0.523,11,39,0.282,22,25,0.88,101,2017-01-29,IND,HOU
847,47,Home,W 120-116 ,240,47,89,0.528,35,63,0.556,12,26,0.462,14,18,0.778,120,41,99,0.414,26,72,0.361,15,27,0.556,19,23,0.826,116,2017-01-31,LAL,DEN
848,48,Home,L 120-133 ,240,40,80,0.5,30,55,0.545,10,25,0.4,30,39,0.769,120,52,99,0.525,38,65,0.585,14,34,0.412,15,18,0.833,133,2017-02-02,LAC,GSW
849,49,@,W 120-95 ,240,49,80,0.613,39,54,0.722,10,26,0.385,12,18,0.667,120,33,74,0.446,27,57,0.474,6,17,0.353,23,32,0.719,95,2017-02-06,UTA,ATL
850,50,@,W 120-111 ,240,44,91,0.484,34,61,0.557,10,30,0.333,22,27,0.815,120,39,77,0.506,30,51,0.588,9,26,0.346,24,31,0.774,111,2017-02-09,BOS,POR
851,51,Home,W 120-98 ,240,42,73,0.575,29,53,0.547,13,20,0.65,23,28,0.821,120,34,96,0.354,27,62,0.435,7,34,0.206,23,30,0.767,98,2017-02-13,WAS,OKC
852,52,Home,W 120-112 ,240,43,87,0.494,33,58,0.569,10,29,0.345,24,30,0.8,120,38,90,0.422,33,66,0.5,5,24,0.208,31,40,0.775,112,2017-02-24,PHI,WAS
853,53,Home,W 120-113 (OT),265,45,104,0.433,38,79,0.481,7,25,0.28,23,31,0.742,120,44,84,0.524,34,59,0.576,10,25,0.4,15,22,0.682,113,2017-02-28,DET,POR
854,54,Home,W 120-103 ,240,46,77,0.597,39,58,0.672,7,19,0.368,21,25,0.84,120,35,89,0.393,25,55,0.455,10,34,0.294,23,28,0.821,103,2017-03-02,PHO,CHO
855,55,Home,W 120-92 ,240,46,88,0.523,28,54,0.519,18,34,0.529,10,12,0.833,120,35,73,0.479,24,46,0.522,11,27,0.407,11,18,0.611,92,2017-03-04,MIA,CLE
856,56,@,W 119-114 (2OT),290,41,98,0.418,35,74,0.473,6,24,0.25,31,43,0.721,119,44,97,0.454,33,64,0.516,11,33,0.333,15,21,0.714,114,2012-01-21,DEN,NYK
857,57,Home,W 119-101 ,240,45,96,0.469,37,72,0.514,8,24,0.333,21,25,0.84,119,36,79,0.456,33,67,0.493,3,12,0.25,26,34,0.765,101,2012-02-02,GSW,UTA
858,58,@,W 119-116 ,240,44,84,0.524,33,58,0.569,11,26,0.423,20,21,0.952,119,44,80,0.55,35,59,0.593,9,21,0.429,19,23,0.826,116,2012-02-07,OKC,GSW
859,59,Home,W 119-104 ,240,42,84,0.5,33,65,0.508,9,19,0.474,26,35,0.743,119,34,70,0.486,27,52,0.519,7,18,0.389,29,34,0.853,104,2012-02-22,OKC,BOS
860,60,Home,W 119-118 ,240,41,91,0.451,33,66,0.5,8,25,0.32,29,37,0.784,119,42,87,0.483,29,63,0.46,13,24,0.542,21,21,1.0,118,2012-02-28,MIL,WAS
861,61,Home,W 119-116 (OT),265,40,88,0.455,29,61,0.475,11,27,0.407,28,35,0.8,119,45,98,0.459,33,71,0.465,12,27,0.444,14,21,0.667,116,2012-03-05,DEN,SAC
862,62,Home,W 119-114 ,240,45,93,0.484,32,67,0.478,13,26,0.5,16,21,0.762,119,46,83,0.554,39,66,0.591,7,17,0.412,15,21,0.714,114,2012-03-09,MIL,NYK
863,63,Home,W 119-110 ,240,47,88,0.534,43,71,0.606,4,17,0.235,21,32,0.656,119,43,90,0.478,39,74,0.527,4,16,0.25,20,25,0.8,110,2012-03-20,SAC,MEM
864,64,Home,W 119-106 ,240,46,88,0.523,37,60,0.617,9,28,0.321,18,20,0.9,119,36,78,0.462,31,57,0.544,5,21,0.238,29,35,0.829,106,2012-04-01,POR,MIN
865,65,Home,W 119-89 ,240,42,80,0.525,27,52,0.519,15,28,0.536,20,24,0.833,119,30,74,0.405,23,54,0.426,7,20,0.35,22,26,0.846,89,2012-04-09,ORL,DET
866,66,Home,W 119-116 ,240,43,83,0.518,33,58,0.569,10,25,0.4,23,27,0.852,119,49,95,0.516,44,74,0.595,5,21,0.238,13,20,0.65,116,2012-11-03,MIA,DEN
867,67,Home,W 119-117 (OT),265,44,86,0.512,34,61,0.557,10,25,0.4,21,29,0.724,119,41,88,0.466,32,63,0.508,9,25,0.36,26,31,0.839,117,2012-11-16,POR,HOU
868,68,Home,W 119-108 ,240,46,85,0.541,37,65,0.569,9,20,0.45,18,28,0.643,119,44,90,0.489,35,67,0.522,9,23,0.391,11,18,0.611,108,2012-11-18,LAL,HOU
869,69,Home,W 119-109 ,240,42,83,0.506,29,63,0.46,13,20,0.65,22,26,0.846,119,43,82,0.524,38,66,0.576,5,16,0.313,18,22,0.818,109,2012-11-18,OKC,GSW
870,70,Home,W 119-96 ,240,48,87,0.552,41,67,0.612,7,20,0.35,16,21,0.762,119,37,84,0.44,25,57,0.439,12,27,0.444,10,16,0.625,96,2012-12-10,DAL,SAC
871,71,@,L 119-126 (2OT),290,48,109,0.44,34,82,0.415,14,27,0.519,9,15,0.6,119,46,98,0.469,35,65,0.538,11,33,0.333,23,31,0.742,126,2012-12-26,DET,ATL
872,72,Home,W 119-109 (OT),265,42,89,0.472,32,63,0.508,10,26,0.385,25,31,0.806,119,41,94,0.436,31,66,0.47,10,28,0.357,17,20,0.85,109,2013-01-02,MIA,DAL
873,73,@,L 119-125 (OT),265,46,93,0.495,35,63,0.556,11,30,0.367,16,18,0.889,119,48,94,0.511,40,70,0.571,8,24,0.333,21,24,0.875,125,2013-01-07,ORL,POR
874,74,Home,W 119-106 ,240,43,87,0.494,31,59,0.525,12,28,0.429,21,27,0.778,119,36,80,0.45,20,44,0.455,16,36,0.444,18,21,0.857,106,2013-01-26,HOU,BRK
875,75,Home,W 119-98 ,240,48,95,0.505,40,72,0.556,8,23,0.348,15,20,0.75,119,38,93,0.409,28,73,0.384,10,20,0.5,12,16,0.75,98,2013-02-06,OKC,GSW
876,76,Home,W 119-108 ,240,39,80,0.488,32,66,0.485,7,14,0.5,34,41,0.829,119,45,86,0.523,37,65,0.569,8,21,0.381,10,13,0.769,108,2013-02-08,CLE,ORL
877,77,Home,W 119-109 ,240,46,89,0.517,36,67,0.537,10,22,0.455,17,20,0.85,119,37,81,0.457,27,57,0.474,10,24,0.417,25,30,0.833,109,2013-02-08,DET,SAS
878,78,Home,W 119-108 ,240,41,75,0.547,25,48,0.521,16,27,0.593,21,30,0.7,119,42,79,0.532,30,62,0.484,12,17,0.706,12,22,0.545,108,2013-02-13,BRK,DEN
879,79,@,L 119-122 ,240,42,87,0.483,31,59,0.525,11,28,0.393,24,27,0.889,119,44,92,0.478,29,59,0.492,15,33,0.455,19,23,0.826,122,2013-02-20,OKC,HOU
880,80,Home,W 119-113 ,240,42,88,0.477,31,64,0.484,11,24,0.458,24,33,0.727,119,39,81,0.481,35,59,0.593,4,22,0.182,31,37,0.838,113,2013-02-22,WAS,DEN
881,81,Home,W 119-108 ,240,49,88,0.557,44,70,0.629,5,18,0.278,16,27,0.593,119,43,78,0.551,35,59,0.593,8,19,0.421,14,31,0.452,108,2013-02-25,DEN,LAL
882,82,Home,W 119-74 ,240,42,76,0.553,34,58,0.586,8,18,0.444,27,28,0.964,119,27,77,0.351,21,56,0.375,6,21,0.286,14,18,0.778,74,2013-02-27,OKC,NOH
883,83,Home,W 119-83 ,240,42,90,0.467,29,57,0.509,13,33,0.394,22,27,0.815,119,28,77,0.364,22,54,0.407,6,23,0.261,21,27,0.778,83,2013-03-03,SAC,CHA
884,84,Home,W 119-113 ,240,45,78,0.577,39,61,0.639,6,17,0.353,23,29,0.793,119,43,85,0.506,36,70,0.514,7,15,0.467,20,31,0.645,113,2013-03-16,SAS,CLE
885,85,Home,W 119-114 ,240,42,79,0.532,33,57,0.579,9,22,0.409,26,33,0.788,119,43,81,0.531,37,66,0.561,6,15,0.4,22,29,0.759,114,2013-03-18,CHA,WAS
886,86,@,W 119-118 (OT),265,46,100,0.46,39,80,0.488,7,20,0.35,20,27,0.741,119,47,96,0.49,39,75,0.52,8,21,0.381,16,19,0.842,118,2013-03-18,DEN,CHI
887,87,@,W 119-82 ,240,45,83,0.542,36,62,0.581,9,21,0.429,20,23,0.87,119,34,78,0.436,33,60,0.55,1,18,0.056,13,15,0.867,82,2013-03-18,BRK,DET
888,88,Home,W 119-112 ,240,47,95,0.495,40,72,0.556,7,23,0.304,18,23,0.783,119,43,92,0.467,32,63,0.508,11,29,0.379,15,23,0.652,112,2013-04-15,PHO,HOU
889,89,@,W 119-110 ,240,37,82,0.451,31,65,0.477,6,17,0.353,39,44,0.886,119,39,91,0.429,28,60,0.467,11,31,0.355,21,27,0.778,110,2013-11-08,OKC,DET
890,90,@,W 119-116 ,240,41,92,0.446,26,59,0.441,15,33,0.455,22,25,0.88,119,48,102,0.471,39,85,0.459,9,17,0.529,11,16,0.688,116,2013-12-17,POR,CLE
891,91,@,L 119-121 (OT),265,44,91,0.484,27,57,0.474,17,34,0.5,14,19,0.737,119,46,91,0.505,36,62,0.581,10,29,0.345,19,29,0.655,121,2013-12-23,ATL,MIA
892,92,@,W 119-112 ,240,40,82,0.488,31,59,0.525,9,23,0.391,30,38,0.789,119,45,88,0.511,33,60,0.55,12,28,0.429,10,14,0.714,112,2014-01-03,LAC,DAL
893,93,Home,W 119-96 ,240,43,83,0.518,34,64,0.531,9,19,0.474,24,31,0.774,119,35,80,0.438,24,57,0.421,11,23,0.478,15,24,0.625,96,2014-01-05,OKC,BOS
894,94,@,L 119-123 ,240,39,90,0.433,29,63,0.46,10,27,0.37,31,36,0.861,119,40,85,0.471,33,70,0.471,7,15,0.467,36,50,0.72,123,2014-01-07,POR,SAC
895,95,Home,W 119-92 ,240,48,88,0.545,39,69,0.565,9,19,0.474,14,19,0.737,119,37,84,0.44,29,65,0.446,8,19,0.421,10,14,0.714,92,2014-01-10,MIN,CHA
896,96,Home,W 119-98 ,240,43,90,0.478,35,59,0.593,8,31,0.258,25,40,0.625,119,34,86,0.395,22,56,0.393,12,30,0.4,18,30,0.6,98,2014-01-22,HOU,SAC
897,97,@,W 119-108 ,240,42,79,0.532,24,42,0.571,18,37,0.486,17,22,0.773,119,38,101,0.376,33,68,0.485,5,33,0.152,27,37,0.73,108,2014-02-05,LAL,CLE
898,98,Home,W 119-80 ,240,46,80,0.575,42,64,0.656,4,16,0.25,23,26,0.885,119,28,89,0.315,22,63,0.349,6,26,0.231,18,26,0.692,80,2014-02-10,IND,DEN
899,99,Home,W 119-85 ,240,48,98,0.49,35,71,0.493,13,27,0.481,10,13,0.769,119,31,91,0.341,27,70,0.386,4,21,0.19,19,25,0.76,85,2014-03-14,SAS,LAL
900,0,@,W 119-118 (2OT),290,38,98,0.388,26,62,0.419,12,36,0.333,31,38,0.816,119,41,101,0.406,33,72,0.458,8,29,0.276,28,33,0.848,118,2014-03-21,OKC,TOR
901,1,@,L 119-128 (OT),265,46,93,0.495,34,60,0.567,12,33,0.364,15,19,0.789,119,45,90,0.5,30,52,0.577,15,38,0.395,23,28,0.821,128,2014-03-25,OKC,DAL
902,2,@,W 119-98 ,240,45,78,0.577,36,60,0.6,9,18,0.5,20,24,0.833,119,35,79,0.443,24,51,0.471,11,28,0.393,17,20,0.85,98,2014-04-02,CLE,ORL
903,3,Home,W 119-116 ,240,44,84,0.524,38,68,0.559,6,16,0.375,25,38,0.658,119,42,85,0.494,38,65,0.585,4,20,0.2,28,35,0.8,116,2014-04-11,MIL,CLE
904,4,Home,W 119-117 (OT),265,43,86,0.5,33,62,0.532,10,24,0.417,23,32,0.719,119,44,91,0.484,27,54,0.5,17,37,0.459,12,16,0.75,117,2014-04-13,POR,GSW
905,5,@,W 119-104 ,240,45,82,0.549,35,58,0.603,10,24,0.417,19,22,0.864,119,42,81,0.519,36,62,0.581,6,19,0.316,14,20,0.7,104,2014-04-14,LAL,UTA
906,6,Home,W 119-99 ,240,45,82,0.549,29,50,0.58,16,32,0.5,13,18,0.722,119,37,86,0.43,33,73,0.452,4,13,0.308,21,25,0.84,99,2014-10-29,PHO,LAL
907,7,@,L 119-122 (2OT),290,43,93,0.462,30,60,0.5,13,33,0.394,20,26,0.769,119,48,97,0.495,42,76,0.553,6,21,0.286,20,27,0.741,122,2014-11-07,ATL,CHO
908,8,Home,W 119-93 ,240,46,86,0.535,39,69,0.565,7,17,0.412,20,22,0.909,119,34,78,0.436,26,44,0.591,8,34,0.235,17,21,0.81,93,2014-11-17,MEM,HOU
909,9,Home,L 119-120 ,240,48,89,0.539,40,68,0.588,8,21,0.381,15,22,0.682,119,45,79,0.57,35,61,0.574,10,18,0.556,20,24,0.833,120,2014-11-28,LAL,MIN
910,10,Home,W 119-89 ,240,45,85,0.529,38,65,0.585,7,20,0.35,22,27,0.815,119,31,82,0.378,26,60,0.433,5,22,0.227,22,30,0.733,89,2014-12-05,WAS,DEN
911,11,Home,W 119-114 ,240,44,79,0.557,32,51,0.627,12,28,0.429,19,25,0.76,119,44,89,0.494,36,67,0.537,8,22,0.364,18,23,0.783,114,2014-12-12,NOP,CLE
912,12,Home,W 119-111 ,240,47,79,0.595,39,63,0.619,8,16,0.5,17,18,0.944,119,45,90,0.5,40,75,0.533,5,15,0.333,16,19,0.842,111,2014-12-16,NOP,UTA
913,13,Home,L 119-129 (3OT),315,45,109,0.413,37,89,0.416,8,20,0.4,21,26,0.808,119,47,110,0.427,34,75,0.453,13,35,0.371,22,23,0.957,129,2014-12-19,SAS,POR
914,14,Home,W 119-109 ,240,47,86,0.547,37,60,0.617,10,26,0.385,15,29,0.517,119,42,83,0.506,33,63,0.524,9,20,0.45,16,22,0.727,109,2014-12-26,DET,IND
915,15,@,W 119-101 ,240,45,96,0.469,32,69,0.464,13,27,0.481,16,17,0.941,119,38,89,0.427,26,55,0.473,12,34,0.353,13,19,0.684,101,2015-01-02,DAL,BOS
916,16,@,W 119-103 ,240,48,89,0.539,35,64,0.547,13,25,0.52,10,12,0.833,119,42,85,0.494,37,69,0.536,5,16,0.313,14,16,0.875,103,2015-01-16,CHI,BOS
917,17,Home,W 119-102 ,240,43,84,0.512,26,50,0.52,17,34,0.5,16,19,0.842,119,35,73,0.479,28,56,0.5,7,17,0.412,25,29,0.862,102,2015-01-28,TOR,SAC
918,18,Home,W 119-115 ,240,42,77,0.545,34,58,0.586,8,19,0.421,27,52,0.519,119,43,84,0.512,33,56,0.589,10,28,0.357,19,23,0.826,115,2015-02-19,LAC,SAS
919,19,Home,W 119-94 ,240,48,92,0.522,40,72,0.556,8,20,0.4,15,23,0.652,119,35,97,0.361,28,70,0.4,7,27,0.259,17,20,0.85,94,2015-02-22,OKC,DEN
920,20,Home,W 119-108 ,240,46,83,0.554,35,62,0.565,11,21,0.524,16,22,0.727,119,40,84,0.476,27,53,0.509,13,31,0.419,15,28,0.536,108,2015-02-23,MIA,PHI
921,21,Home,W 119-114 ,240,48,85,0.565,35,61,0.574,13,24,0.542,10,12,0.833,119,38,85,0.447,28,58,0.483,10,27,0.37,28,38,0.737,114,2015-03-06,ORL,SAC
922,22,Home,W 119-115 ,240,42,89,0.472,32,64,0.5,10,25,0.4,25,35,0.714,119,40,90,0.444,33,64,0.516,7,26,0.269,28,35,0.8,115,2015-03-16,DAL,OKC
923,23,@,W 119-100 ,240,42,90,0.467,30,62,0.484,12,28,0.429,23,30,0.767,119,41,85,0.482,37,68,0.544,4,17,0.235,14,17,0.824,100,2015-03-22,DEN,ORL
924,24,@,W 119-98 ,240,44,82,0.537,32,53,0.604,12,29,0.414,19,31,0.613,119,36,86,0.419,25,55,0.455,11,31,0.355,15,27,0.556,98,2015-03-27,LAC,PHI
925,25,@,W 119-106 ,240,41,84,0.488,28,52,0.538,13,32,0.406,24,40,0.6,119,39,93,0.419,31,62,0.5,8,31,0.258,20,23,0.87,106,2015-03-29,LAC,BOS
926,26,Home,W 119-101 ,240,44,88,0.5,31,58,0.534,13,30,0.433,18,24,0.75,119,36,75,0.48,31,59,0.525,5,16,0.313,24,35,0.686,101,2015-04-08,DEN,LAL
927,27,@,W 119-90 ,240,47,72,0.653,39,57,0.684,8,15,0.533,17,23,0.739,119,31,89,0.348,22,62,0.355,9,27,0.333,19,27,0.704,90,2015-04-08,WAS,PHI
928,28,Home,W 119-69 ,240,43,84,0.512,32,59,0.542,11,25,0.44,22,30,0.733,119,26,96,0.271,23,73,0.315,3,23,0.13,14,20,0.7,69,2015-11-02,GSW,MEM
929,29,Home,W 119-114 (OT),265,42,88,0.477,31,54,0.574,11,34,0.324,24,34,0.706,119,46,91,0.505,39,71,0.549,7,20,0.35,15,19,0.789,114,2015-11-04,HOU,ORL
930,30,Home,W 119-104 ,240,46,93,0.495,29,56,0.518,17,37,0.459,10,18,0.556,119,39,92,0.424,31,68,0.456,8,24,0.333,18,22,0.818,104,2015-11-06,GSW,DEN
931,31,@,W 119-103 ,240,43,89,0.483,38,71,0.535,5,18,0.278,28,31,0.903,119,40,87,0.46,28,58,0.483,12,29,0.414,11,17,0.647,103,2015-11-11,TOR,PHI
932,32,@,L 119-122 (OT),265,40,93,0.43,28,64,0.438,12,29,0.414,27,34,0.794,119,43,92,0.467,35,69,0.507,8,23,0.348,28,37,0.757,122,2015-12-05,IND,UTA
933,33,@,W 119-68 ,240,47,76,0.618,43,65,0.662,4,11,0.364,21,25,0.84,119,26,75,0.347,22,51,0.431,4,24,0.167,12,21,0.571,68,2015-12-07,SAS,PHI
934,34,Home,L 119-124 (2OT),290,49,114,0.43,37,81,0.457,12,33,0.364,9,16,0.563,119,42,107,0.393,33,76,0.434,9,31,0.29,31,39,0.795,124,2015-12-11,BOS,GSW
935,35,Home,W 119-116 ,240,38,78,0.487,27,57,0.474,11,21,0.524,32,43,0.744,119,43,89,0.483,33,64,0.516,10,25,0.4,20,24,0.833,116,2015-12-16,DET,BOS
936,36,@,W 119-118 (OT),265,45,82,0.549,29,48,0.604,16,34,0.471,13,15,0.867,119,51,101,0.505,41,82,0.5,10,19,0.526,6,14,0.429,118,2015-12-23,DAL,BRK
937,37,@,L 119-142 ,240,43,83,0.518,33,54,0.611,10,29,0.345,23,28,0.821,119,53,87,0.609,44,64,0.688,9,23,0.391,27,34,0.794,142,2016-01-02,PHO,SAC
938,38,@,W 119-117 ,240,39,88,0.443,30,59,0.508,9,29,0.31,32,36,0.889,119,40,89,0.449,34,67,0.507,6,22,0.273,31,36,0.861,117,2016-01-16,BOS,WAS
939,39,@,L 119-124 (2OT),290,44,104,0.423,29,59,0.492,15,45,0.333,16,20,0.8,119,41,88,0.466,27,61,0.443,14,27,0.519,28,32,0.875,124,2016-01-18,UTA,CHO
940,40,Home,W 119-113 (2OT),290,43,97,0.443,35,77,0.455,8,20,0.4,25,30,0.833,119,45,102,0.441,35,74,0.473,10,28,0.357,13,25,0.52,113,2016-01-18,NYK,PHI
941,41,@,W 119-105 ,240,43,86,0.5,34,59,0.576,9,27,0.333,24,26,0.923,119,33,84,0.393,27,64,0.422,6,20,0.3,33,37,0.892,105,2016-01-25,ATL,DEN
942,42,Home,W 119-114 ,240,44,82,0.537,34,58,0.586,10,24,0.417,21,35,0.6,119,39,93,0.419,23,47,0.489,16,46,0.348,20,25,0.8,114,2016-01-31,ORL,BOS
943,43,Home,W 119-115 ,240,40,80,0.5,28,54,0.519,12,26,0.462,27,35,0.771,119,46,80,0.575,42,63,0.667,4,17,0.235,19,25,0.76,115,2016-02-02,LAL,MIN
944,44,@,L 119-128 ,240,45,89,0.506,37,63,0.587,8,26,0.308,21,22,0.955,119,48,86,0.558,30,58,0.517,18,28,0.643,14,15,0.933,128,2016-02-05,SAC,BRK
945,45,@,L 119-128 ,240,47,95,0.495,37,69,0.536,10,26,0.385,15,19,0.789,119,51,91,0.56,38,67,0.567,13,24,0.542,13,15,0.867,128,2016-02-07,SAC,BOS
946,46,Home,L 119-121 (OT),265,36,75,0.48,25,46,0.543,11,29,0.379,36,41,0.878,119,48,92,0.522,42,66,0.636,6,26,0.231,19,27,0.704,121,2016-02-09,DAL,UTA
947,47,@,W 119-101 ,240,47,89,0.528,41,75,0.547,6,14,0.429,19,26,0.731,119,40,70,0.571,36,58,0.621,4,12,0.333,17,24,0.708,101,2016-02-09,SAS,MIA
948,48,@,W 119-113 ,240,48,88,0.545,42,76,0.553,6,12,0.5,17,18,0.944,119,40,81,0.494,30,59,0.508,10,22,0.455,23,26,0.885,113,2016-02-19,SAS,LAL
949,49,@,L 119-128 ,240,39,88,0.443,22,49,0.449,17,39,0.436,24,33,0.727,119,48,85,0.565,35,58,0.603,13,27,0.481,19,29,0.655,128,2016-02-24,LAL,MEM
950,50,@,L 119-123 ,240,47,86,0.547,39,67,0.582,8,19,0.421,17,22,0.773,119,47,90,0.522,35,70,0.5,12,20,0.6,17,18,0.944,123,2016-02-25,OKC,NOP
951,51,@,W 119-105 ,240,44,82,0.537,34,53,0.642,10,29,0.345,21,35,0.6,119,37,80,0.463,24,45,0.533,13,35,0.371,18,22,0.818,105,2016-02-25,HOU,POR
952,52,@,W 119-99 ,240,40,81,0.494,30,56,0.536,10,25,0.4,29,35,0.829,119,34,85,0.4,21,52,0.404,13,33,0.394,18,26,0.692,99,2016-03-02,CHA,PHI
953,53,Home,W 119-113 ,240,42,84,0.5,26,49,0.531,16,35,0.457,19,27,0.704,119,40,90,0.444,35,69,0.507,5,21,0.238,28,34,0.824,113,2016-03-07,GSW,ORL
954,54,@,L 119-124 ,240,49,93,0.527,42,73,0.575,7,20,0.35,14,20,0.7,119,47,79,0.595,39,62,0.629,8,17,0.471,22,28,0.786,124,2016-03-14,DEN,MIA
955,55,Home,W 119-107 ,240,47,93,0.505,34,65,0.523,13,28,0.464,12,20,0.6,119,39,93,0.419,32,66,0.485,7,27,0.259,22,26,0.846,107,2016-03-23,PHO,LAL
956,56,@,W 119-100 ,240,41,86,0.477,30,60,0.5,11,26,0.423,26,32,0.813,119,38,93,0.409,30,69,0.435,8,24,0.333,16,23,0.696,100,2016-03-28,OKC,TOR
957,57,Home,W 119-117 ,240,45,87,0.517,35,55,0.636,10,32,0.313,19,24,0.792,119,42,76,0.553,26,47,0.553,16,29,0.552,17,22,0.773,117,2016-03-31,OKC,LAC
958,58,Home,W 119-107 ,240,43,90,0.478,33,64,0.516,10,26,0.385,23,29,0.793,119,41,89,0.461,33,68,0.485,8,21,0.381,17,26,0.654,107,2016-04-03,ORL,MEM
959,59,Home,W 119-108 ,240,41,90,0.456,31,67,0.463,10,23,0.435,27,35,0.771,119,40,91,0.44,34,71,0.479,6,20,0.3,22,28,0.786,108,2016-11-06,LAL,PHO
960,60,Home,W 119-110 ,240,42,76,0.553,30,43,0.698,12,33,0.364,23,26,0.885,119,39,92,0.424,27,64,0.422,12,28,0.429,20,28,0.714,110,2016-11-08,BRK,MIN
961,61,@,W 119-105 ,240,40,76,0.526,29,52,0.558,11,24,0.458,28,37,0.757,119,40,89,0.449,32,67,0.478,8,22,0.364,17,21,0.81,105,2016-11-12,LAC,MIN
962,62,@,W 119-117 ,240,46,86,0.535,35,62,0.565,11,24,0.458,16,20,0.8,119,47,92,0.511,40,67,0.597,7,25,0.28,16,26,0.615,117,2016-11-13,ORL,OKC
963,63,Home,W 119-112 ,240,44,81,0.543,29,56,0.518,15,25,0.6,16,18,0.889,119,41,86,0.477,29,57,0.509,12,29,0.414,18,20,0.9,112,2016-11-17,WAS,NYK
964,64,@,W 119-114 ,240,44,86,0.512,31,55,0.564,13,31,0.419,18,20,0.9,119,45,89,0.506,34,69,0.493,11,20,0.55,13,18,0.722,114,2016-11-23,SAS,CHO
965,65,Home,W 119-104 ,240,47,100,0.47,35,68,0.515,12,32,0.375,13,17,0.765,119,36,76,0.474,23,53,0.434,13,23,0.565,19,29,0.655,104,2016-11-25,POR,NOP
966,66,@,W 119-115 ,240,45,95,0.474,32,65,0.492,13,30,0.433,16,21,0.762,119,40,87,0.46,31,61,0.508,9,26,0.346,26,34,0.765,115,2016-12-09,PHO,LAL
967,67,Home,L 119-120 (OT),265,44,96,0.458,30,55,0.545,14,41,0.341,17,26,0.654,119,38,97,0.392,22,57,0.386,16,40,0.4,28,35,0.8,120,2016-12-11,PHO,NOP
968,68,Home,W 119-108 ,240,46,89,0.517,31,56,0.554,15,33,0.455,12,18,0.667,119,41,86,0.477,25,49,0.51,16,37,0.432,10,13,0.769,108,2016-12-17,CLE,LAL
969,69,Home,W 119-102 ,240,47,86,0.547,31,50,0.62,16,36,0.444,9,13,0.692,119,39,90,0.433,28,51,0.549,11,39,0.282,13,20,0.65,102,2016-12-20,LAC,DEN
970,70,Home,W 119-99 ,240,45,99,0.455,37,64,0.578,8,35,0.229,21,24,0.875,119,38,85,0.447,30,55,0.545,8,30,0.267,15,18,0.833,99,2016-12-23,CLE,BRK
971,71,@,W 119-113 ,240,43,77,0.558,32,50,0.64,11,27,0.407,22,24,0.917,119,43,85,0.506,33,56,0.589,10,29,0.345,17,28,0.607,113,2016-12-23,GSW,DET
972,72,@,W 119-114 ,240,45,93,0.484,31,57,0.544,14,36,0.389,15,20,0.75,119,41,87,0.471,33,64,0.516,8,23,0.348,24,27,0.889,114,2016-12-25,BOS,NYK
973,73,Home,W 119-100 ,240,48,85,0.565,39,67,0.582,9,18,0.5,14,19,0.737,119,39,86,0.453,32,68,0.471,7,18,0.389,15,20,0.75,100,2016-12-25,SAS,CHI
974,74,@,W 119-94 ,240,48,84,0.571,37,62,0.597,11,22,0.5,12,16,0.75,119,39,88,0.443,33,64,0.516,6,24,0.25,10,16,0.625,94,2016-12-28,MIL,DET
975,75,Home,W 119-98 ,240,47,87,0.54,42,70,0.6,5,17,0.294,20,25,0.8,119,36,74,0.486,29,58,0.5,7,16,0.438,19,24,0.792,98,2016-12-28,SAS,PHO
976,76,@,L 119-127 ,240,48,101,0.475,39,66,0.591,9,35,0.257,14,18,0.778,119,50,95,0.526,39,70,0.557,11,25,0.44,16,21,0.762,127,2017-01-02,DEN,GSW
977,77,Home,L 119-128 (OT),265,41,83,0.494,33,53,0.623,8,30,0.267,29,39,0.744,119,50,103,0.485,37,70,0.529,13,33,0.394,15,19,0.789,128,2017-01-06,GSW,MEM
978,78,Home,W 119-105 ,240,44,81,0.543,36,58,0.621,8,23,0.348,23,25,0.92,119,36,87,0.414,21,45,0.467,15,42,0.357,18,22,0.818,105,2017-01-11,MIN,HOU
979,79,@,W 119-109 ,240,48,92,0.522,38,73,0.521,10,19,0.526,13,16,0.813,119,40,89,0.449,33,63,0.524,7,26,0.269,22,24,0.917,109,2017-01-17,TOR,BRK
980,80,@,W 119-95 ,240,41,80,0.513,25,38,0.658,16,42,0.381,21,25,0.84,119,33,89,0.371,24,55,0.436,9,34,0.265,20,28,0.714,95,2017-01-21,HOU,MEM
981,81,@,W 119-114 ,240,43,83,0.518,26,53,0.491,17,30,0.567,16,19,0.842,119,43,94,0.457,35,67,0.522,8,27,0.296,20,26,0.769,114,2017-01-25,ATL,CHI
982,82,Home,W 119-103 ,240,48,93,0.516,35,63,0.556,13,30,0.433,10,14,0.714,119,33,85,0.388,21,57,0.368,12,28,0.429,25,29,0.862,103,2017-01-27,NOP,SAS
983,83,@,L 119-122 ,240,41,74,0.554,28,45,0.622,13,29,0.448,24,29,0.828,119,45,83,0.542,34,52,0.654,11,31,0.355,21,26,0.808,122,2017-01-30,SAC,PHI
984,84,@,W 119-99 ,240,45,92,0.489,31,62,0.5,14,30,0.467,15,20,0.75,119,32,80,0.4,23,55,0.418,9,25,0.36,26,35,0.743,99,2017-02-01,MEM,DEN
985,85,@,W 119-115 ,240,45,92,0.489,35,67,0.522,10,25,0.4,19,28,0.679,119,46,92,0.5,38,65,0.585,8,27,0.296,15,18,0.833,115,2017-02-08,LAC,NYK
986,86,Home,W 119-104 ,240,46,87,0.529,31,49,0.633,15,38,0.395,12,15,0.8,119,42,100,0.42,34,74,0.459,8,26,0.308,12,17,0.706,104,2017-02-23,CLE,NYK
987,87,@,W 119-98 ,240,49,94,0.521,39,73,0.534,10,21,0.476,11,13,0.846,119,40,87,0.46,33,65,0.508,7,22,0.318,11,18,0.611,98,2017-02-26,SAS,LAL
988,88,@,W 119-108 ,240,40,89,0.449,34,60,0.567,6,29,0.207,33,39,0.846,119,37,82,0.451,27,48,0.563,10,34,0.294,24,27,0.889,108,2017-02-27,GSW,PHI
989,89,@,W 119-111 ,240,41,87,0.471,21,43,0.488,20,44,0.455,17,22,0.773,119,38,82,0.463,25,54,0.463,13,28,0.464,22,31,0.71,111,2017-03-06,GSW,ATL
990,90,Home,W 118-83 ,240,42,80,0.525,34,59,0.576,8,21,0.381,26,28,0.929,118,24,69,0.348,19,50,0.38,5,19,0.263,30,39,0.769,83,2012-01-04,MIA,IND
991,91,@,W 118-110 ,240,47,85,0.553,40,74,0.541,7,11,0.636,17,21,0.81,118,42,85,0.494,31,56,0.554,11,29,0.379,15,20,0.75,110,2012-01-04,CHA,NYK
992,92,Home,W 118-97 ,240,47,88,0.534,42,78,0.538,5,10,0.5,19,24,0.792,118,38,74,0.514,33,63,0.524,5,11,0.455,16,19,0.842,97,2012-01-17,CHI,PHO
993,93,@,L 118-124 (OT),265,49,101,0.485,43,79,0.544,6,22,0.273,14,18,0.778,118,46,94,0.489,37,66,0.561,9,28,0.321,23,28,0.821,124,2012-02-19,DEN,OKC
994,94,@,L 118-119 ,240,42,87,0.483,29,63,0.46,13,24,0.542,21,21,1.0,118,41,91,0.451,33,66,0.5,8,25,0.32,29,37,0.784,119,2012-02-28,WAS,MIL
995,95,Home,W 118-105 ,240,46,85,0.541,39,66,0.591,7,19,0.368,19,25,0.76,118,41,96,0.427,31,68,0.456,10,28,0.357,13,17,0.765,105,2012-03-07,SAS,NYK
996,96,Home,W 118-107 ,240,39,82,0.476,28,62,0.452,11,20,0.55,29,36,0.806,118,44,86,0.512,36,69,0.522,8,17,0.471,11,17,0.647,107,2012-03-11,CLE,HOU
997,97,Home,W 118-117 (OT),265,45,87,0.517,38,67,0.567,7,20,0.35,21,26,0.808,118,43,92,0.467,29,63,0.46,14,29,0.483,17,19,0.895,117,2012-03-13,DEN,ATL
998,98,Home,W 118-110 ,240,42,88,0.477,32,65,0.492,10,23,0.435,24,28,0.857,118,47,90,0.522,39,74,0.527,8,16,0.5,8,11,0.727,110,2012-04-11,POR,GSW
999,99,Home,W 118-110 ,240,42,74,0.568,23,42,0.548,19,32,0.594,15,17,0.882,118,36,66,0.545,25,45,0.556,11,21,0.524,27,34,0.794,110,2012-04-17,NYK,BOS
1000,0,Home,W 118-109 ,240,43,91,0.473,36,74,0.486,7,17,0.412,25,32,0.781,118,37,88,0.42,31,68,0.456,6,20,0.3,29,33,0.879,109,2012-04-19,IND,MIL
1001,1,@,W 118-107 ,240,48,87,0.552,42,74,0.568,6,13,0.462,16,17,0.941,118,44,95,0.463,33,69,0.478,11,26,0.423,8,11,0.727,107,2012-04-21,DEN,PHO
1002,2,Home,W 118-110 ,240,38,81,0.469,29,61,0.475,9,20,0.45,33,36,0.917,118,43,82,0.524,39,66,0.591,4,16,0.25,20,27,0.741,110,2012-04-24,OKC,SAC
1003,3,@,W 118-92 ,240,45,80,0.563,32,57,0.561,13,23,0.565,15,20,0.75,118,37,90,0.411,33,76,0.434,4,14,0.286,14,17,0.824,92,2012-11-26,SAS,WAS
1004,4,@,W 118-117 (2OT),290,46,94,0.489,37,69,0.536,9,25,0.36,17,21,0.81,118,43,99,0.434,30,64,0.469,13,35,0.371,18,22,0.818,117,2012-12-01,POR,CLE
1005,5,@,W 118-112 (OT),265,43,92,0.467,31,57,0.544,12,35,0.343,20,26,0.769,118,41,88,0.466,28,61,0.459,13,27,0.481,17,22,0.773,112,2012-12-03,POR,CHA
1006,6,@,W 118-115 (OT),265,49,107,0.458,40,80,0.5,9,27,0.333,11,14,0.786,118,46,103,0.447,36,74,0.486,10,29,0.345,13,15,0.867,115,2012-12-22,LAL,GSW
1007,7,Home,W 118-96 ,240,44,82,0.537,34,62,0.548,10,20,0.5,20,25,0.8,118,36,86,0.419,29,64,0.453,7,22,0.318,17,19,0.895,96,2012-12-30,SAC,BOS
1008,8,Home,W 118-92 ,240,44,82,0.537,34,68,0.5,10,14,0.714,20,24,0.833,118,33,78,0.423,26,64,0.406,7,14,0.5,19,23,0.826,92,2013-01-07,CHI,CLE
1009,9,@,L 118-124 ,240,44,92,0.478,36,76,0.474,8,16,0.5,22,30,0.733,118,43,84,0.512,34,65,0.523,9,19,0.474,29,33,0.879,124,2013-01-14,CLE,SAC
1010,10,@,L 118-121 (OT),265,35,76,0.461,27,52,0.519,8,24,0.333,40,48,0.833,118,45,93,0.484,37,75,0.493,8,18,0.444,23,34,0.676,121,2013-01-20,OKC,DEN
1011,11,Home,W 118-110 ,240,42,82,0.512,34,54,0.63,8,28,0.286,26,36,0.722,118,39,81,0.481,31,54,0.574,8,27,0.296,24,35,0.686,110,2013-01-30,DEN,HOU
1012,12,Home,W 118-103 ,240,47,79,0.595,35,53,0.66,12,26,0.462,12,16,0.75,118,40,88,0.455,32,62,0.516,8,26,0.308,15,20,0.75,103,2013-02-08,HOU,POR
1013,13,Home,W 118-114 (3OT),315,43,108,0.398,30,78,0.385,13,30,0.433,19,24,0.792,118,48,113,0.425,40,87,0.46,8,26,0.308,10,17,0.588,114,2013-02-10,BOS,DEN
1014,14,@,W 118-94 ,240,43,87,0.494,34,66,0.515,9,21,0.429,23,28,0.821,118,38,79,0.481,34,65,0.523,4,14,0.286,14,22,0.636,94,2013-02-23,CLE,ORL
1015,15,@,W 118-110 ,240,42,77,0.545,27,45,0.6,15,32,0.469,19,28,0.679,118,44,78,0.564,35,56,0.625,9,22,0.409,13,16,0.813,110,2013-03-01,HOU,ORL
1016,16,@,L 118-125 ,240,41,94,0.436,32,68,0.471,9,26,0.346,27,35,0.771,118,47,82,0.573,39,65,0.6,8,17,0.471,23,28,0.821,125,2013-03-04,TOR,GSW
1017,17,Home,W 118-116 (OT),265,39,91,0.429,25,52,0.481,14,39,0.359,26,36,0.722,118,48,93,0.516,40,71,0.563,8,22,0.364,12,16,0.75,116,2013-03-08,LAL,TOR
1018,18,Home,L 118-119 (OT),265,47,96,0.49,39,75,0.52,8,21,0.381,16,19,0.842,118,46,100,0.46,39,80,0.488,7,20,0.35,20,27,0.741,119,2013-03-18,CHI,DEN
1019,19,Home,W 118-107 ,240,45,83,0.542,34,60,0.567,11,23,0.478,17,21,0.81,118,40,88,0.455,32,68,0.471,8,20,0.4,19,24,0.792,107,2013-03-29,BOS,ATL
1020,20,Home,W 118-111 (OT),265,39,87,0.448,29,60,0.483,10,27,0.37,30,37,0.811,118,42,104,0.404,32,74,0.432,10,30,0.333,17,22,0.773,111,2013-04-11,CHI,NYK
1021,21,Home,W 118-116 ,240,34,66,0.515,22,41,0.537,12,25,0.48,38,50,0.76,118,46,97,0.474,35,71,0.493,11,26,0.423,13,16,0.813,116,2013-04-12,LAL,GSW
1022,22,Home,W 118-109 ,240,43,81,0.531,35,59,0.593,8,22,0.364,24,27,0.889,118,38,82,0.463,26,50,0.52,12,32,0.375,21,26,0.808,109,2013-04-14,DEN,POR
1023,23,Home,W 118-98 ,240,49,93,0.527,45,77,0.584,4,16,0.25,16,20,0.8,118,40,104,0.385,33,79,0.418,7,25,0.28,11,17,0.647,98,2013-04-17,DEN,PHO
1024,24,Home,W 118-109 ,240,44,77,0.571,33,53,0.623,11,24,0.458,19,24,0.792,118,37,76,0.487,29,52,0.558,8,24,0.333,27,35,0.771,109,2013-10-30,DAL,ATL
1025,25,@,L 118-137 ,240,41,82,0.5,34,57,0.596,7,25,0.28,29,43,0.674,118,49,94,0.521,34,56,0.607,15,38,0.395,24,28,0.857,137,2013-11-04,HOU,LAC
1026,26,Home,W 118-95 ,240,46,79,0.582,34,56,0.607,12,23,0.522,14,24,0.583,118,33,79,0.418,22,49,0.449,11,30,0.367,18,21,0.857,95,2013-11-12,MIA,MIL
1027,27,@,W 118-110 (OT),265,44,99,0.444,29,67,0.433,15,32,0.469,15,20,0.75,118,42,94,0.447,39,77,0.506,3,17,0.176,23,31,0.742,110,2013-11-17,POR,TOR
1028,28,Home,W 118-94 ,240,47,77,0.61,42,64,0.656,5,13,0.385,19,20,0.95,118,34,85,0.4,27,64,0.422,7,21,0.333,19,21,0.905,94,2013-12-08,OKC,IND
1029,29,Home,W 118-85 ,240,45,86,0.523,35,60,0.583,10,26,0.385,18,24,0.75,118,35,94,0.372,32,76,0.421,3,18,0.167,12,15,0.8,85,2013-12-20,ATL,UTA
1030,30,Home,W 118-116 (OT),265,37,91,0.407,21,52,0.404,16,39,0.41,28,34,0.824,118,45,104,0.433,35,78,0.449,10,26,0.385,16,22,0.727,116,2013-12-28,ATL,CHA
1031,31,Home,W 118-103 ,240,44,79,0.557,36,61,0.59,8,18,0.444,22,29,0.759,118,37,84,0.44,30,58,0.517,7,26,0.269,22,35,0.629,103,2014-01-13,UTA,DEN
1032,32,Home,L 118-120 ,240,44,84,0.524,31,50,0.62,13,34,0.382,17,23,0.739,118,41,88,0.466,28,71,0.394,13,17,0.765,25,32,0.781,120,2014-01-14,LAL,CLE
1033,33,Home,L 118-126 ,240,36,74,0.486,22,45,0.489,14,29,0.483,32,38,0.842,118,46,84,0.548,34,62,0.548,12,22,0.545,22,25,0.88,126,2014-01-25,TOR,LAC
1034,34,Home,L 118-125 (2OT),290,44,101,0.436,39,85,0.459,5,16,0.313,25,32,0.781,118,48,98,0.49,39,70,0.557,9,28,0.321,20,25,0.8,125,2014-02-05,WAS,SAS
1035,35,Home,W 118-113 (OT),265,42,92,0.457,37,79,0.468,5,13,0.385,29,35,0.829,118,45,104,0.433,38,84,0.452,7,20,0.35,16,20,0.8,113,2014-02-07,IND,POR
1036,36,Home,W 118-105 ,240,36,71,0.507,27,47,0.574,9,24,0.375,37,54,0.685,118,34,85,0.4,27,59,0.458,7,26,0.269,30,40,0.75,105,2014-02-07,LAC,TOR
1037,37,Home,W 118-98 ,240,47,101,0.465,42,85,0.494,5,16,0.313,19,25,0.76,118,39,90,0.433,31,67,0.463,8,23,0.348,12,20,0.6,98,2014-02-25,IND,LAL
1038,38,Home,W 118-110 ,240,42,84,0.5,31,51,0.608,11,33,0.333,23,33,0.697,118,45,100,0.45,41,81,0.506,4,19,0.211,16,19,0.842,110,2014-03-01,HOU,DET
1039,39,@,W 118-106 ,240,47,90,0.522,36,63,0.571,11,27,0.407,13,19,0.684,118,39,90,0.433,32,64,0.5,7,26,0.269,21,24,0.875,106,2014-03-05,NYK,MIN
1040,40,Home,W 118-111 ,240,47,97,0.485,37,66,0.561,10,31,0.323,14,21,0.667,118,40,86,0.465,36,71,0.507,4,15,0.267,27,39,0.692,111,2014-03-09,BOS,DET
1041,41,Home,W 118-113 (OT),265,38,89,0.427,29,60,0.483,9,29,0.31,33,45,0.733,118,39,96,0.406,30,71,0.423,9,25,0.36,26,33,0.788,113,2014-03-09,HOU,POR
1042,42,Home,W 118-113 (OT),265,40,94,0.426,29,60,0.483,11,34,0.324,27,31,0.871,118,40,81,0.494,33,57,0.579,7,24,0.292,26,29,0.897,113,2014-03-18,ATL,TOR
1043,43,Home,W 118-109 ,240,44,86,0.512,33,59,0.559,11,27,0.407,19,27,0.704,118,43,95,0.453,33,69,0.478,10,26,0.385,13,19,0.684,109,2014-03-19,DEN,DET
1044,44,Home,L 118-119 (2OT),290,41,101,0.406,33,72,0.458,8,29,0.276,28,33,0.848,118,38,98,0.388,26,62,0.419,12,36,0.333,31,38,0.816,119,2014-03-21,TOR,OKC
1045,45,@,W 118-111 ,240,38,79,0.481,26,44,0.591,12,35,0.343,30,34,0.882,118,46,92,0.5,40,75,0.533,6,17,0.353,13,17,0.765,111,2014-03-22,HOU,CLE
1046,46,@,W 118-107 ,240,42,89,0.472,30,48,0.625,12,41,0.293,22,36,0.611,118,32,79,0.405,25,54,0.463,7,25,0.28,36,45,0.8,107,2014-03-29,LAC,HOU
1047,47,Home,W 118-92 ,240,45,72,0.625,35,53,0.66,10,19,0.526,18,21,0.857,118,32,81,0.395,29,57,0.509,3,24,0.125,25,30,0.833,92,2014-04-02,WAS,BOS
1048,48,@,W 118-102 ,240,50,88,0.568,44,70,0.629,6,18,0.333,12,17,0.706,118,39,84,0.464,32,54,0.593,7,30,0.233,17,23,0.739,102,2014-04-16,WAS,BOS
1049,49,@,W 118-111 ,240,34,71,0.479,22,38,0.579,12,33,0.364,38,44,0.864,118,42,82,0.512,35,62,0.565,7,20,0.35,20,28,0.714,111,2014-10-31,LAC,LAL
1050,50,Home,W 118-91 ,240,42,88,0.477,35,62,0.565,7,26,0.269,27,33,0.818,118,36,87,0.414,29,56,0.518,7,31,0.226,12,15,0.8,91,2014-11-01,UTA,PHO
1051,51,Home,W 118-113 ,240,44,82,0.537,30,57,0.526,14,25,0.56,16,20,0.8,118,45,102,0.441,34,71,0.479,11,31,0.355,12,16,0.75,113,2014-11-03,DAL,BOS
1052,52,@,W 118-115 ,240,40,78,0.513,28,54,0.519,12,24,0.5,26,34,0.765,118,43,91,0.473,31,61,0.508,12,30,0.4,17,25,0.68,115,2014-11-07,CHI,PHI
1053,53,Home,W 118-111 ,240,40,81,0.494,27,54,0.5,13,27,0.481,25,30,0.833,118,41,93,0.441,29,66,0.439,12,27,0.444,17,20,0.85,111,2014-11-10,CLE,NOP
1054,54,@,W 118-114 ,240,48,93,0.516,39,72,0.542,9,21,0.429,13,16,0.813,118,45,87,0.517,41,77,0.532,4,10,0.4,20,31,0.645,114,2014-11-17,PHO,BOS
1055,55,Home,L 118-122 (3OT),315,44,92,0.478,35,61,0.574,9,31,0.29,21,29,0.724,118,48,108,0.444,43,84,0.512,5,24,0.208,21,28,0.75,122,2014-11-19,BRK,MIL
1056,56,@,W 118-106 ,240,45,80,0.563,32,54,0.593,13,26,0.5,15,17,0.882,118,40,88,0.455,36,69,0.522,4,19,0.211,22,30,0.733,106,2014-12-05,PHO,DAL
1057,57,Home,W 118-108 ,240,42,86,0.488,28,53,0.528,14,33,0.424,20,27,0.741,118,40,82,0.488,35,68,0.515,5,14,0.357,23,26,0.885,108,2014-12-21,TOR,NYK
1058,58,@,L 118-125 ,240,43,86,0.5,33,62,0.532,10,24,0.417,22,29,0.759,118,49,77,0.636,36,54,0.667,13,23,0.565,14,22,0.636,125,2014-12-22,LAC,SAS
1059,59,@,W 118-108 ,240,47,85,0.553,42,68,0.618,5,17,0.294,19,28,0.679,118,42,86,0.488,36,67,0.537,6,19,0.316,18,24,0.75,108,2015-01-09,DEN,SAC
1060,60,@,L 118-128 ,240,48,97,0.495,42,82,0.512,6,15,0.4,16,16,1.0,118,49,94,0.521,39,70,0.557,10,24,0.417,20,24,0.833,128,2015-01-21,ORL,DET
1061,61,Home,W 118-113 ,240,47,92,0.511,38,65,0.585,9,27,0.333,15,24,0.625,118,39,87,0.448,26,55,0.473,13,32,0.406,22,28,0.786,113,2015-01-21,PHO,POR
1062,62,@,L 118-123 (2OT),290,43,104,0.413,37,79,0.468,6,25,0.24,26,32,0.813,118,50,106,0.472,47,97,0.485,3,9,0.333,20,25,0.8,123,2015-01-29,CHI,LAL
1063,63,Home,L 118-127 ,240,41,87,0.471,29,61,0.475,12,26,0.462,24,30,0.8,118,48,95,0.505,33,58,0.569,15,37,0.405,16,23,0.696,127,2015-02-10,PHO,HOU
1064,64,Home,W 118-111 (OT),265,43,84,0.512,36,66,0.545,7,18,0.389,25,38,0.658,118,42,98,0.429,34,65,0.523,8,33,0.242,19,27,0.704,111,2015-02-22,LAL,BOS
1065,65,@,L 118-123 (OT),265,34,96,0.354,19,61,0.311,15,35,0.429,35,44,0.795,118,44,96,0.458,37,75,0.493,7,21,0.333,28,34,0.824,123,2015-03-04,PHI,OKC
1066,66,Home,W 118-86 ,240,45,85,0.529,28,51,0.549,17,34,0.5,11,12,0.917,118,34,92,0.37,30,75,0.4,4,17,0.235,14,20,0.7,86,2015-03-10,IND,ORL
1067,67,Home,W 118-99 ,240,46,80,0.575,35,59,0.593,11,21,0.524,15,17,0.882,118,41,91,0.451,34,66,0.515,7,25,0.28,10,12,0.833,99,2015-03-13,POR,DET
1068,68,@,W 118-111 (2OT),290,46,104,0.442,36,73,0.493,10,31,0.323,16,20,0.8,118,46,99,0.465,40,77,0.519,6,22,0.273,13,21,0.619,111,2015-03-15,DEN,NOP
1069,69,@,L 118-122 ,240,44,84,0.524,31,50,0.62,13,34,0.382,17,28,0.607,118,42,88,0.477,37,69,0.536,5,19,0.263,33,39,0.846,122,2015-03-18,BOS,OKC
1070,70,Home,W 118-108 ,240,37,83,0.446,25,53,0.472,12,30,0.4,32,40,0.8,118,42,93,0.452,29,57,0.509,13,36,0.361,11,19,0.579,108,2015-03-19,HOU,DEN
1071,71,@,W 118-113 ,240,35,68,0.515,23,47,0.489,12,21,0.571,36,44,0.818,118,42,82,0.512,35,58,0.603,7,24,0.292,22,28,0.786,113,2015-10-30,WAS,MIL
1072,72,Home,W 118-97 ,240,45,83,0.542,31,60,0.517,14,23,0.609,14,22,0.636,118,40,84,0.476,29,60,0.483,11,24,0.458,6,12,0.5,97,2015-11-04,PHO,SAC
1073,73,Home,W 118-98 ,240,44,97,0.454,32,67,0.478,12,30,0.4,18,23,0.783,118,36,88,0.409,28,63,0.444,8,25,0.32,18,23,0.783,98,2015-11-06,BOS,WAS
1074,74,Home,W 118-114 ,240,37,74,0.5,26,50,0.52,11,24,0.458,33,43,0.767,118,40,82,0.488,30,60,0.5,10,22,0.455,24,28,0.857,114,2015-11-10,CLE,UTA
1075,75,Home,W 118-108 ,240,42,76,0.553,31,52,0.596,11,24,0.458,23,30,0.767,118,37,86,0.43,25,59,0.424,12,27,0.444,22,33,0.667,108,2015-11-11,DAL,LAC
1076,76,Home,W 118-104 ,240,44,83,0.53,30,53,0.566,14,30,0.467,16,21,0.762,118,40,90,0.444,31,64,0.484,9,26,0.346,15,28,0.536,104,2015-11-12,PHO,LAC
1077,77,@,W 118-105 ,240,47,89,0.528,32,60,0.533,15,29,0.517,9,13,0.692,118,37,86,0.43,33,71,0.465,4,15,0.267,27,35,0.771,105,2015-11-22,GSW,DEN
1078,78,Home,L 118-129 ,240,42,88,0.477,29,57,0.509,13,31,0.419,21,27,0.778,118,44,77,0.571,34,54,0.63,10,23,0.435,31,37,0.838,129,2015-11-25,MIL,SAC
1079,79,Home,W 118-96 ,240,45,90,0.5,32,61,0.525,13,29,0.448,15,19,0.789,118,41,82,0.5,38,66,0.576,3,16,0.188,11,18,0.611,96,2015-12-12,DET,IND
1080,80,Home,W 118-81 ,240,42,75,0.56,33,54,0.611,9,21,0.429,25,27,0.926,118,32,79,0.405,29,68,0.426,3,11,0.273,14,17,0.824,81,2015-12-14,SAS,UTA
1081,81,Home,W 118-78 ,240,46,84,0.548,37,65,0.569,9,19,0.474,17,25,0.68,118,30,86,0.349,22,58,0.379,8,28,0.286,10,17,0.588,78,2015-12-19,OKC,LAL
1082,82,Home,L 118-119 (OT),265,51,101,0.505,41,82,0.5,10,19,0.526,6,14,0.429,118,45,82,0.549,29,48,0.604,16,34,0.471,13,15,0.867,119,2015-12-23,BRK,DAL
1083,83,Home,W 118-111 ,240,40,87,0.46,24,54,0.444,16,33,0.485,22,28,0.786,118,42,78,0.538,34,57,0.596,8,21,0.381,19,26,0.731,111,2015-12-26,DAL,CHI
1084,84,Home,W 118-115 ,240,47,85,0.553,41,64,0.641,6,21,0.286,18,27,0.667,118,41,76,0.539,33,52,0.635,8,24,0.333,25,29,0.862,115,2016-01-07,SAC,LAL
1085,85,@,W 118-104 ,240,51,98,0.52,40,73,0.548,11,25,0.44,5,10,0.5,118,38,80,0.475,35,63,0.556,3,17,0.176,25,32,0.781,104,2016-01-15,WAS,IND
1086,86,Home,W 118-113 (OT),265,40,93,0.43,24,59,0.407,16,34,0.471,22,24,0.917,118,40,94,0.426,28,64,0.438,12,30,0.4,21,26,0.808,113,2016-01-18,DAL,BOS
1087,87,Home,W 118-111 (OT),265,47,90,0.522,40,73,0.548,7,17,0.412,17,18,0.944,118,37,86,0.43,25,59,0.424,12,27,0.444,25,31,0.806,111,2016-01-20,NYK,UTA
1088,88,@,W 118-111 ,240,43,82,0.524,33,66,0.5,10,16,0.625,22,34,0.647,118,43,93,0.462,34,69,0.493,9,24,0.375,16,22,0.727,111,2016-02-21,SAS,PHO
1089,89,@,W 118-112 ,240,42,90,0.467,29,62,0.468,13,28,0.464,21,25,0.84,118,40,86,0.465,34,72,0.472,6,14,0.429,26,31,0.839,112,2016-02-24,GSW,MIA
1090,90,Home,L 118-121 (OT),265,46,96,0.479,37,70,0.529,9,26,0.346,17,26,0.654,118,45,95,0.474,31,63,0.492,14,32,0.438,17,25,0.68,121,2016-02-27,OKC,GSW
1091,91,@,L 118-132 ,240,45,92,0.489,36,66,0.545,9,26,0.346,19,26,0.731,118,52,76,0.684,42,58,0.724,10,18,0.556,18,22,0.818,132,2016-03-05,BRK,MIN
1092,92,@,W 118-104 ,240,38,86,0.442,27,53,0.509,11,33,0.333,31,41,0.756,118,35,86,0.407,23,53,0.434,12,33,0.364,22,32,0.688,104,2016-03-09,HOU,PHI
1093,93,@,W 118-96 ,240,47,91,0.516,37,73,0.507,10,18,0.556,14,20,0.7,118,38,81,0.469,30,60,0.5,8,21,0.381,12,15,0.8,96,2016-03-11,MIA,CHI
1094,94,Home,W 118-103 ,240,42,83,0.506,32,58,0.552,10,25,0.4,24,29,0.828,118,36,76,0.474,27,46,0.587,9,30,0.3,22,27,0.815,103,2016-03-11,CHA,DET
1095,95,@,W 118-114 ,240,39,89,0.438,27,55,0.491,12,34,0.353,28,34,0.824,118,39,84,0.464,31,59,0.525,8,25,0.32,28,39,0.718,114,2016-03-16,ATL,DET
1096,96,Home,W 118-102 ,240,46,94,0.489,35,70,0.5,11,24,0.458,15,15,1.0,118,40,86,0.465,34,65,0.523,6,21,0.286,16,20,0.8,102,2016-03-17,CHI,BRK
1097,97,Home,W 118-110 ,240,45,86,0.523,37,70,0.529,8,16,0.5,20,22,0.909,118,39,89,0.438,29,67,0.433,10,22,0.455,22,30,0.733,110,2016-03-17,SAS,POR
1098,98,Home,W 118-102 ,240,43,80,0.538,32,56,0.571,11,24,0.458,21,25,0.84,118,39,98,0.398,31,73,0.425,8,25,0.32,16,19,0.842,102,2016-03-23,DET,ORL
1099,99,Home,W 118-110 ,240,41,102,0.402,28,60,0.467,13,42,0.31,23,26,0.885,118,38,82,0.463,31,55,0.564,7,27,0.259,27,32,0.844,110,2016-04-03,HOU,OKC
1100,0,Home,W 118-107 ,240,46,88,0.523,29,55,0.527,17,33,0.515,9,11,0.818,118,40,90,0.444,29,62,0.468,11,28,0.393,16,24,0.667,107,2016-04-09,ATL,BOS
1101,1,Home,W 118-96 ,240,43,77,0.558,37,57,0.649,6,20,0.3,26,30,0.867,118,37,83,0.446,30,65,0.462,7,18,0.389,15,19,0.789,96,2016-04-10,MIA,ORL
1102,2,Home,W 118-101 ,240,45,86,0.523,36,65,0.554,9,21,0.429,19,21,0.905,118,43,88,0.489,36,70,0.514,7,18,0.389,8,9,0.889,101,2016-10-29,CHI,IND
1103,3,@,W 118-88 ,240,45,89,0.506,34,62,0.548,11,27,0.407,17,18,0.944,118,33,96,0.344,28,65,0.431,5,31,0.161,17,21,0.81,88,2016-10-31,CHI,BRK
1104,4,@,W 118-99 ,240,42,89,0.472,27,49,0.551,15,40,0.375,19,27,0.704,118,37,85,0.435,29,65,0.446,8,20,0.4,17,25,0.68,99,2016-11-02,HOU,NYK
1105,5,Home,W 118-115 (OT),265,44,103,0.427,39,87,0.448,5,16,0.313,25,30,0.833,118,42,101,0.416,30,68,0.441,12,33,0.364,19,21,0.905,115,2016-11-02,PHO,POR
1106,6,Home,W 118-93 ,240,46,92,0.5,36,71,0.507,10,21,0.476,16,20,0.8,118,35,81,0.432,25,50,0.5,10,31,0.323,13,22,0.591,93,2016-11-09,WAS,BOS
1107,7,Home,W 118-107 ,240,39,83,0.47,32,61,0.525,7,22,0.318,33,38,0.868,118,44,97,0.454,37,74,0.5,7,23,0.304,12,16,0.75,107,2016-11-12,TOR,NYK
1108,8,@,L 118-125 ,240,45,99,0.455,33,58,0.569,12,41,0.293,16,20,0.8,118,41,92,0.446,32,64,0.5,9,28,0.321,34,43,0.791,125,2016-11-15,BRK,LAL
1109,9,@,W 118-110 ,240,45,87,0.517,37,65,0.569,8,22,0.364,20,28,0.714,118,41,93,0.441,28,62,0.452,13,31,0.419,15,21,0.714,110,2016-11-20,CHI,LAL
1110,10,Home,W 118-97 ,240,48,87,0.552,37,61,0.607,11,26,0.423,11,16,0.688,118,36,79,0.456,25,45,0.556,11,34,0.324,14,23,0.609,97,2016-11-25,IND,BRK
1111,11,Home,W 118-101 ,240,46,86,0.535,39,67,0.582,7,19,0.368,19,23,0.826,118,32,75,0.427,18,36,0.5,14,39,0.359,23,31,0.742,101,2016-11-29,MIL,CLE
1112,12,Home,W 118-114 ,240,41,86,0.477,29,55,0.527,12,31,0.387,24,30,0.8,118,41,88,0.466,31,60,0.517,10,28,0.357,22,24,0.917,114,2016-12-02,NYK,MIN
1113,13,@,W 118-113 ,240,45,92,0.489,31,58,0.534,14,34,0.412,14,18,0.778,118,40,81,0.494,29,54,0.537,11,27,0.407,22,30,0.733,113,2016-12-05,WAS,BRK
1114,14,Home,W 118-111 ,240,40,83,0.482,25,54,0.463,15,29,0.517,23,28,0.821,118,40,82,0.488,24,45,0.533,16,37,0.432,15,16,0.938,111,2016-12-10,IND,POR
1115,15,@,W 118-112 ,240,41,84,0.488,31,62,0.5,10,22,0.455,26,31,0.839,118,42,88,0.477,32,60,0.533,10,28,0.357,18,22,0.818,112,2016-12-11,NYK,LAL
1116,16,@,L 118-122 ,240,42,80,0.525,35,60,0.583,7,20,0.35,27,36,0.75,118,42,91,0.462,25,48,0.521,17,43,0.395,21,36,0.583,122,2016-12-12,BRK,HOU
1117,17,Home,W 118-111 ,240,39,97,0.402,32,68,0.471,7,29,0.241,33,42,0.786,118,39,83,0.47,28,56,0.5,11,27,0.407,22,26,0.846,111,2016-12-16,ORL,BRK
1118,18,Home,W 118-111 ,240,44,88,0.5,31,65,0.477,13,23,0.565,17,21,0.81,118,39,91,0.429,33,68,0.485,6,23,0.261,27,33,0.818,111,2016-12-20,NYK,IND
1119,19,@,L 118-120 ,240,44,94,0.468,36,68,0.529,8,26,0.308,22,25,0.88,118,40,75,0.533,25,44,0.568,15,31,0.484,25,31,0.806,120,2016-12-26,CHA,BRK
1120,20,@,L 118-124 ,240,43,85,0.506,31,48,0.646,12,37,0.324,20,21,0.952,118,43,83,0.518,29,45,0.644,14,38,0.368,24,33,0.727,124,2016-12-29,BOS,CLE
1121,21,Home,W 118-95 ,240,47,83,0.566,36,61,0.59,11,22,0.5,13,14,0.929,118,32,74,0.432,22,49,0.449,10,25,0.4,21,25,0.84,95,2016-12-30,WAS,BRK
1122,22,Home,W 118-111 ,240,42,90,0.467,35,67,0.522,7,23,0.304,27,29,0.931,118,41,83,0.494,32,64,0.5,9,19,0.474,20,22,0.909,111,2017-01-02,CHI,CHO
1123,23,Home,W 118-116 ,240,41,86,0.477,26,47,0.553,15,39,0.385,21,30,0.7,118,41,91,0.451,29,61,0.475,12,30,0.4,22,27,0.815,116,2017-01-05,HOU,OKC
1124,24,Home,W 118-109 ,240,43,81,0.531,31,48,0.646,12,33,0.364,20,30,0.667,118,36,86,0.419,26,55,0.473,10,31,0.323,27,33,0.818,109,2017-01-05,POR,LAL
1125,25,@,L 118-123 (OT),265,37,85,0.435,29,54,0.537,8,31,0.258,36,43,0.837,118,38,97,0.392,27,69,0.391,11,28,0.393,36,39,0.923,123,2017-01-07,TOR,CHI
1126,26,Home,L 118-122 ,240,37,81,0.457,28,56,0.5,9,25,0.36,35,40,0.875,118,40,90,0.444,31,62,0.5,9,28,0.321,33,41,0.805,122,2017-01-15,SAC,OKC
1127,27,Home,W 118-95 ,240,45,91,0.495,35,66,0.53,10,25,0.4,18,28,0.643,118,30,78,0.385,24,53,0.453,6,25,0.24,29,37,0.784,95,2017-01-18,DET,ATL
1128,28,Home,W 118-98 ,240,46,93,0.495,31,57,0.544,15,36,0.417,11,15,0.733,118,39,88,0.443,28,56,0.5,11,32,0.344,9,11,0.818,98,2017-01-18,NOP,ORL
1129,29,Home,W 118-103 ,240,43,85,0.506,24,43,0.558,19,42,0.452,13,19,0.684,118,37,85,0.435,33,66,0.5,4,19,0.211,25,31,0.806,103,2017-01-19,CLE,PHO
1130,30,Home,W 118-104 ,240,44,86,0.512,35,64,0.547,9,22,0.409,21,25,0.84,118,37,91,0.407,27,60,0.45,10,31,0.323,20,26,0.769,104,2017-01-19,SAS,DEN
1131,31,@,W 118-115 (OT),265,48,96,0.5,38,70,0.543,10,26,0.385,12,14,0.857,118,45,91,0.495,32,57,0.561,13,34,0.382,12,22,0.545,115,2017-01-21,SAS,CLE
1132,32,@,W 118-98 ,240,42,89,0.472,23,47,0.489,19,42,0.452,15,19,0.789,118,42,96,0.438,35,68,0.515,7,28,0.25,7,16,0.438,98,2017-01-22,GSW,ORL
1133,33,Home,L 118-123 ,240,42,78,0.538,32,53,0.604,10,25,0.4,24,32,0.75,118,42,81,0.519,30,50,0.6,12,31,0.387,27,28,0.964,123,2017-01-27,PHI,HOU
1134,34,Home,W 118-98 ,240,48,88,0.545,38,62,0.613,10,26,0.385,12,17,0.706,118,41,82,0.5,36,61,0.59,5,21,0.238,11,14,0.786,98,2017-02-01,DET,NOP
1135,35,Home,W 118-109 ,240,41,84,0.488,31,60,0.517,10,24,0.417,26,29,0.897,118,42,90,0.467,29,55,0.527,13,35,0.371,12,18,0.667,109,2017-02-06,TOR,LAC
1136,36,Home,W 118-109 ,240,50,106,0.472,42,79,0.532,8,27,0.296,10,13,0.769,118,38,79,0.481,28,58,0.483,10,21,0.476,23,30,0.767,109,2017-02-09,OKC,CLE
1137,37,Home,W 118-110 ,240,42,88,0.477,36,67,0.537,6,21,0.286,28,37,0.757,118,36,80,0.45,28,59,0.475,8,21,0.381,30,37,0.811,110,2017-02-26,OKC,NOP
1138,38,Home,W 118-111 ,240,44,89,0.494,39,68,0.574,5,21,0.238,25,31,0.806,118,37,87,0.425,28,52,0.538,9,35,0.257,28,35,0.8,111,2017-03-03,PHO,OKC
1139,39,Home,W 117-100 ,240,46,86,0.535,40,67,0.597,6,19,0.316,19,26,0.731,117,38,79,0.481,31,63,0.492,7,16,0.438,17,25,0.68,100,2011-12-28,DEN,UTA
1140,40,Home,W 117-89 ,240,47,82,0.573,41,66,0.621,6,16,0.375,17,24,0.708,117,35,76,0.461,28,60,0.467,7,16,0.438,12,17,0.706,89,2012-01-04,LAC,HOU
1141,41,@,L 117-121 ,240,46,81,0.568,38,65,0.585,8,16,0.5,17,26,0.654,117,49,89,0.551,40,69,0.58,9,20,0.45,14,18,0.778,121,2012-01-07,DEN,SAS
1142,42,@,W 117-109 ,240,35,68,0.515,24,45,0.533,11,23,0.478,36,55,0.655,117,43,82,0.524,33,59,0.559,10,23,0.435,13,19,0.684,109,2012-01-12,ORL,GSW
1143,43,Home,W 117-104 ,240,43,78,0.551,31,53,0.585,12,25,0.48,19,26,0.731,117,38,81,0.469,31,65,0.477,7,16,0.438,21,29,0.724,104,2012-01-13,DEN,MIA
1144,44,Home,W 117-97 ,240,46,86,0.535,31,53,0.585,15,33,0.455,10,12,0.833,117,35,79,0.443,30,57,0.526,5,22,0.227,22,24,0.917,97,2012-02-04,POR,DEN
1145,45,Home,W 117-108 (OT),265,44,88,0.5,37,69,0.536,7,19,0.368,22,31,0.71,117,42,79,0.532,33,58,0.569,9,21,0.429,15,23,0.652,108,2012-02-21,IND,NOH
1146,46,@,W 117-105 ,240,43,97,0.443,35,75,0.467,8,22,0.364,23,35,0.657,117,36,76,0.474,26,47,0.553,10,29,0.345,23,29,0.793,105,2012-03-02,DEN,HOU
1147,47,@,L 117-118 (OT),265,43,92,0.467,29,63,0.46,14,29,0.483,17,19,0.895,117,45,87,0.517,38,67,0.567,7,20,0.35,21,26,0.808,118,2012-03-13,ATL,DEN
1148,48,Home,W 117-100 ,240,45,99,0.455,33,64,0.516,12,35,0.343,15,15,1.0,117,41,81,0.506,38,66,0.576,3,15,0.2,15,22,0.682,100,2012-03-25,MIN,DEN
1149,49,@,W 117-101 ,240,44,81,0.543,29,47,0.617,15,34,0.441,14,19,0.737,117,35,74,0.473,24,52,0.462,11,22,0.5,20,24,0.833,101,2012-03-26,ORL,TOR
1150,50,@,W 117-112 ,240,49,91,0.538,39,71,0.549,10,20,0.5,9,12,0.75,117,47,86,0.547,39,65,0.6,8,21,0.381,10,13,0.769,112,2012-03-28,SAS,SAC
1151,51,@,L 117-122 (OT),265,43,96,0.448,31,72,0.431,12,24,0.5,19,25,0.76,117,44,98,0.449,36,72,0.5,8,26,0.308,26,32,0.813,122,2012-04-08,CLE,NJN
1152,52,Home,W 117-110 ,240,41,79,0.519,30,53,0.566,11,26,0.423,24,26,0.923,117,43,86,0.5,31,58,0.534,12,28,0.429,12,15,0.8,110,2012-04-18,DAL,HOU
1153,53,Home,W 117-107 (OT),265,47,88,0.534,43,80,0.538,4,8,0.5,19,23,0.826,117,42,96,0.438,27,58,0.466,15,38,0.395,8,13,0.615,107,2012-04-21,UTA,ORL
1154,54,@,W 117-110 ,240,43,93,0.462,31,66,0.47,12,27,0.444,19,28,0.679,117,38,87,0.437,28,65,0.431,10,22,0.455,24,27,0.889,110,2012-11-07,PHO,CHA
1155,55,@,L 117-119 (OT),265,41,88,0.466,32,63,0.508,9,25,0.36,26,31,0.839,117,44,86,0.512,34,61,0.557,10,25,0.4,21,29,0.724,119,2012-11-16,HOU,POR
1156,56,Home,W 117-113 ,240,43,93,0.462,30,68,0.441,13,25,0.52,18,24,0.75,117,41,77,0.532,31,56,0.554,10,21,0.476,21,22,0.955,113,2012-11-17,MIL,NOH
1157,57,Home,W 117-111 (OT),265,36,79,0.456,25,56,0.446,11,23,0.478,34,39,0.872,117,40,93,0.43,33,73,0.452,7,20,0.35,24,33,0.727,111,2012-11-21,OKC,LAC
1158,58,Home,W 117-101 ,240,44,83,0.53,31,57,0.544,13,26,0.5,16,21,0.762,117,42,86,0.488,34,63,0.54,8,23,0.348,9,12,0.75,101,2012-11-27,HOU,TOR
1159,59,Home,W 117-77 ,240,40,76,0.526,28,60,0.467,12,16,0.75,25,35,0.714,117,28,82,0.341,22,61,0.361,6,21,0.286,15,20,0.75,77,2012-11-28,DET,PHO
1160,60,Home,L 117-118 (2OT),290,43,99,0.434,30,64,0.469,13,35,0.371,18,22,0.818,117,46,94,0.489,37,69,0.536,9,25,0.36,17,21,0.81,118,2012-12-01,CLE,POR
1161,61,@,W 117-111 ,240,40,66,0.606,33,52,0.635,7,14,0.5,30,34,0.882,117,39,91,0.429,25,57,0.439,14,34,0.412,19,23,0.826,111,2012-12-04,OKC,BRK
1162,62,Home,W 117-99 ,240,48,93,0.516,41,70,0.586,7,23,0.304,14,24,0.583,117,36,78,0.462,27,54,0.5,9,24,0.375,18,20,0.9,99,2012-12-08,LAC,PHO
1163,63,@,W 117-110 ,240,45,83,0.542,39,65,0.6,6,18,0.333,21,27,0.778,117,40,85,0.471,25,57,0.439,15,28,0.536,15,18,0.833,110,2012-12-09,UTA,LAL
1164,64,Home,W 117-115 (2OT),290,43,100,0.43,37,78,0.474,6,22,0.273,25,30,0.833,117,47,92,0.511,39,69,0.565,8,23,0.348,13,17,0.765,115,2012-12-12,BOS,DAL
1165,65,@,W 117-110 ,240,46,89,0.517,37,72,0.514,9,17,0.529,16,23,0.696,117,43,88,0.489,38,71,0.535,5,17,0.294,19,24,0.792,110,2013-01-02,SAS,MIL
1166,66,@,W 117-112 (OT),265,41,96,0.427,36,75,0.48,5,21,0.238,30,35,0.857,117,40,81,0.494,33,54,0.611,7,27,0.259,25,32,0.781,112,2013-01-10,DAL,SAC
1167,67,@,W 117-109 ,240,42,78,0.538,31,59,0.525,11,19,0.579,22,26,0.846,117,41,82,0.5,28,45,0.622,13,37,0.351,14,25,0.56,109,2013-01-15,LAC,HOU
1168,68,Home,W 117-97 ,240,44,85,0.518,35,66,0.53,9,19,0.474,20,26,0.769,117,33,73,0.452,31,58,0.534,2,15,0.133,29,37,0.784,97,2013-01-16,OKC,DEN
1169,69,@,W 117-114 (OT),265,39,95,0.411,33,75,0.44,6,20,0.3,33,36,0.917,117,41,91,0.451,34,71,0.479,7,20,0.35,25,30,0.833,114,2013-01-18,OKC,DAL
1170,70,@,W 117-90 ,240,46,98,0.469,35,75,0.467,11,23,0.478,14,22,0.636,117,34,84,0.405,32,73,0.438,2,11,0.182,20,28,0.714,90,2013-01-29,MIL,DET
1171,71,Home,W 117-99 ,240,45,83,0.542,41,69,0.594,4,14,0.286,23,43,0.535,117,35,88,0.398,29,68,0.426,6,20,0.3,23,26,0.885,99,2013-02-01,DET,CLE
1172,72,Home,W 117-111 ,240,40,87,0.46,29,67,0.433,11,20,0.55,26,27,0.963,117,44,89,0.494,34,56,0.607,10,33,0.303,13,17,0.765,111,2013-02-10,SAC,HOU
1173,73,Home,W 117-104 ,240,43,74,0.581,35,55,0.636,8,19,0.421,23,27,0.852,117,39,73,0.534,31,49,0.633,8,24,0.333,18,20,0.9,104,2013-02-12,MIA,POR
1174,74,Home,W 117-101 ,240,47,87,0.54,35,58,0.603,12,29,0.414,11,14,0.786,117,38,79,0.481,25,50,0.5,13,29,0.448,12,15,0.8,101,2013-03-06,LAC,MIL
1175,75,Home,W 117-94 ,240,41,84,0.488,32,63,0.508,9,21,0.429,26,37,0.703,117,34,79,0.43,23,51,0.451,11,28,0.393,15,22,0.682,94,2013-03-13,DEN,NYK
1176,76,Home,W 117-104 ,240,42,76,0.553,38,63,0.603,4,13,0.308,29,43,0.674,117,40,92,0.435,33,65,0.508,7,27,0.259,17,21,0.81,104,2013-03-15,OKC,ORL
1177,77,@,W 117-86 ,240,42,79,0.532,40,67,0.597,2,12,0.167,31,40,0.775,117,36,95,0.379,32,73,0.438,4,22,0.182,10,21,0.476,86,2013-03-22,MIN,PHO
1178,78,@,W 117-103 ,240,47,96,0.49,39,75,0.52,8,21,0.381,15,21,0.714,117,42,85,0.494,33,61,0.541,9,24,0.375,10,12,0.833,103,2013-03-24,PHI,SAC
1179,79,Home,L 117-120 ,240,45,97,0.464,40,80,0.5,5,17,0.294,22,30,0.733,117,44,82,0.537,34,60,0.567,10,22,0.455,22,38,0.579,120,2013-03-27,MIN,LAL
1180,80,@,W 117-103 ,240,44,83,0.53,37,65,0.569,7,18,0.389,22,24,0.917,117,42,94,0.447,35,74,0.473,7,20,0.35,12,23,0.522,103,2013-03-28,SAC,PHO
1181,81,@,W 117-108 ,240,46,90,0.511,40,70,0.571,6,20,0.3,19,19,1.0,117,39,87,0.448,33,61,0.541,6,26,0.231,24,31,0.774,108,2013-04-05,DAL,SAC
1182,82,@,W 117-109 ,240,42,82,0.512,30,57,0.526,12,25,0.48,21,26,0.808,117,40,80,0.5,32,61,0.525,8,19,0.421,21,26,0.808,109,2013-04-12,BRK,IND
1183,83,@,L 117-123 (OT),265,43,96,0.448,28,55,0.509,15,41,0.366,16,25,0.64,117,43,103,0.417,32,78,0.41,11,25,0.44,26,34,0.765,123,2013-11-13,HOU,PHI
1184,84,Home,W 117-113 ,240,47,97,0.485,40,77,0.519,7,20,0.35,16,21,0.762,117,46,94,0.489,40,72,0.556,6,22,0.273,15,19,0.789,113,2013-11-15,DEN,MIN
1185,85,@,W 117-110 ,240,45,88,0.511,37,72,0.514,8,16,0.5,19,25,0.76,117,40,88,0.455,35,68,0.515,5,20,0.25,25,28,0.893,110,2013-11-27,DEN,MIN
1186,86,Home,W 117-110 ,240,48,87,0.552,38,65,0.585,10,22,0.455,11,13,0.846,117,38,88,0.432,27,65,0.415,11,23,0.478,23,26,0.885,110,2013-12-13,SAS,MIN
1187,87,Home,W 117-94 ,240,45,71,0.634,39,56,0.696,6,15,0.4,21,26,0.808,117,39,84,0.464,34,66,0.515,5,18,0.278,11,17,0.647,94,2013-12-16,MIA,UTA
1188,88,Home,W 117-90 ,240,42,90,0.467,28,58,0.483,14,32,0.438,19,25,0.76,117,30,81,0.37,24,61,0.393,6,20,0.3,24,37,0.649,90,2013-12-23,PHO,LAL
1189,89,@,W 117-95 ,240,43,90,0.478,32,66,0.485,11,24,0.458,20,29,0.69,117,40,89,0.449,35,67,0.522,5,22,0.227,10,17,0.588,95,2013-12-28,MIN,MIL
1190,90,Home,W 117-86 ,240,47,82,0.573,37,60,0.617,10,22,0.455,13,16,0.813,117,31,85,0.365,24,57,0.421,7,28,0.25,17,31,0.548,86,2013-12-29,OKC,HOU
1191,91,Home,W 117-89 ,240,43,86,0.5,33,63,0.524,10,23,0.435,21,23,0.913,117,34,85,0.4,30,66,0.455,4,19,0.211,17,22,0.773,89,2014-01-16,IND,NYK
1192,92,@,W 117-109 ,240,42,88,0.477,37,72,0.514,5,16,0.313,28,35,0.8,117,40,92,0.435,26,55,0.473,14,37,0.378,15,19,0.789,109,2014-01-17,CLE,DEN
1193,93,Home,W 117-103 ,240,46,91,0.505,38,72,0.528,8,19,0.421,17,26,0.654,117,36,82,0.439,27,54,0.5,9,28,0.321,22,30,0.733,103,2014-01-19,PHO,DEN
1194,94,Home,L 117-125 ,240,42,81,0.519,38,65,0.585,4,16,0.25,29,34,0.853,117,42,81,0.519,32,56,0.571,10,25,0.4,31,40,0.775,125,2014-01-26,SAC,DEN
1195,95,@,W 117-115 ,240,41,74,0.554,32,53,0.604,9,21,0.429,26,36,0.722,117,40,86,0.465,35,67,0.522,5,19,0.263,30,36,0.833,115,2014-01-29,HOU,DAL
1196,96,Home,L 117-126 ,240,38,89,0.427,31,70,0.443,7,19,0.368,34,36,0.944,117,42,78,0.538,30,55,0.545,12,23,0.522,30,32,0.938,126,2014-01-29,MIL,PHO
1197,97,Home,W 117-86 ,240,43,76,0.566,31,50,0.62,12,26,0.462,19,28,0.679,117,31,87,0.356,23,64,0.359,8,23,0.348,16,22,0.727,86,2014-01-30,NYK,CLE
1198,98,Home,W 117-90 ,240,48,85,0.565,37,57,0.649,11,28,0.393,10,14,0.714,117,32,76,0.421,25,50,0.5,7,26,0.269,19,26,0.731,90,2014-02-07,NYK,DEN
1199,99,@,W 117-110 ,240,40,83,0.482,32,60,0.533,8,23,0.348,29,38,0.763,117,40,97,0.412,35,80,0.438,5,17,0.294,25,34,0.735,110,2014-02-08,POR,MIN
1200,0,@,L 117-122 ,240,43,84,0.512,30,53,0.566,13,31,0.419,18,22,0.818,117,46,79,0.582,42,69,0.609,4,10,0.4,26,31,0.839,122,2014-02-12,POR,LAC
1201,1,Home,W 117-90 ,240,45,86,0.523,33,60,0.55,12,26,0.462,15,23,0.652,117,33,84,0.393,24,60,0.4,9,24,0.375,15,20,0.75,90,2014-02-12,MIN,DEN
1202,2,@,W 117-106 ,240,44,77,0.571,34,51,0.667,10,26,0.385,19,24,0.792,117,34,85,0.4,25,58,0.431,9,27,0.333,29,32,0.906,106,2014-02-18,MIA,DAL
1203,3,Home,W 117-89 ,240,42,84,0.5,32,67,0.478,10,17,0.588,23,27,0.852,117,35,87,0.402,28,72,0.389,7,15,0.467,12,22,0.545,89,2014-02-21,CHI,DEN
1204,4,Home,L 117-125 ,240,43,93,0.462,31,64,0.484,12,29,0.414,19,24,0.792,117,42,81,0.519,29,51,0.569,13,30,0.433,28,39,0.718,125,2014-02-23,OKC,LAC
1205,5,Home,W 117-111 (OT),265,40,87,0.46,34,69,0.493,6,18,0.333,31,40,0.775,117,40,91,0.44,29,63,0.46,11,28,0.393,20,30,0.667,111,2014-03-18,SAC,WAS
1206,6,@,W 117-107 ,240,42,87,0.483,32,62,0.516,10,25,0.4,23,29,0.793,117,43,91,0.473,36,72,0.5,7,19,0.368,14,23,0.609,107,2014-03-21,WAS,LAL
1207,7,Home,W 117-96 ,240,45,89,0.506,34,67,0.507,11,22,0.5,16,21,0.762,117,30,77,0.39,21,49,0.429,9,28,0.321,27,40,0.675,96,2014-03-24,OKC,DEN
1208,8,Home,W 117-98 ,240,48,82,0.585,35,53,0.66,13,29,0.448,8,10,0.8,117,36,91,0.396,31,70,0.443,5,21,0.238,21,25,0.84,98,2014-04-04,ATL,CLE
1209,9,Home,W 117-95 ,240,44,81,0.543,39,68,0.574,5,13,0.385,24,32,0.75,117,39,88,0.443,33,70,0.471,6,18,0.333,11,17,0.647,95,2014-04-11,MEM,PHI
1210,10,Home,W 117-101 ,240,41,81,0.506,32,62,0.516,9,19,0.474,26,36,0.722,117,35,82,0.427,31,73,0.425,4,9,0.444,27,33,0.818,101,2014-04-12,LAC,SAC
1211,11,@,L 117-119 (OT),265,44,91,0.484,27,54,0.5,17,37,0.459,12,16,0.75,117,43,86,0.5,33,62,0.532,10,24,0.417,23,32,0.719,119,2014-04-13,GSW,POR
1212,12,Home,W 117-105 ,240,44,83,0.53,35,59,0.593,9,24,0.375,20,30,0.667,117,35,82,0.427,27,53,0.509,8,29,0.276,27,30,0.9,105,2014-04-15,LAC,DEN
1213,13,@,L 117-131 ,240,43,86,0.5,36,69,0.522,7,17,0.412,24,29,0.828,117,52,94,0.553,44,68,0.647,8,26,0.308,19,23,0.826,131,2014-11-15,MIN,DAL
1214,14,Home,W 117-113 ,240,43,78,0.551,34,61,0.557,9,17,0.529,22,27,0.815,117,44,80,0.55,33,55,0.6,11,25,0.44,14,19,0.737,113,2014-11-18,MIL,NYK
1215,15,Home,W 117-97 ,240,43,82,0.524,32,58,0.552,11,24,0.458,20,25,0.8,117,31,78,0.397,26,62,0.419,5,16,0.313,30,34,0.882,97,2014-11-21,DEN,NOP
1216,16,Home,W 117-100 ,240,48,91,0.527,40,75,0.533,8,16,0.5,13,14,0.929,117,38,88,0.432,29,61,0.475,9,27,0.333,15,21,0.714,100,2014-11-21,MEM,BOS
1217,17,@,W 117-103 ,240,44,87,0.506,29,49,0.592,15,38,0.395,14,16,0.875,117,33,74,0.446,27,55,0.491,6,19,0.316,31,35,0.886,103,2014-11-29,HOU,MIL
1218,18,@,W 117-109 ,240,44,88,0.5,34,65,0.523,10,23,0.435,19,21,0.905,117,39,75,0.52,36,65,0.554,3,10,0.3,28,37,0.757,109,2014-12-02,TOR,SAC
1219,19,@,W 117-106 ,240,40,79,0.506,30,57,0.526,10,22,0.455,27,35,0.771,117,40,89,0.449,27,56,0.482,13,33,0.394,13,19,0.684,106,2014-12-17,DAL,DET
1220,20,@,W 117-116 (3OT),315,48,107,0.449,38,80,0.475,10,27,0.37,11,14,0.786,117,43,105,0.41,26,70,0.371,17,35,0.486,13,27,0.481,116,2014-12-17,MEM,SAS
1221,21,@,W 117-111 (OT),265,41,91,0.451,27,57,0.474,14,34,0.412,21,28,0.75,117,43,104,0.413,36,80,0.45,7,24,0.292,18,23,0.783,111,2014-12-26,HOU,MEM
1222,22,Home,W 117-91 ,240,41,88,0.466,26,60,0.433,15,28,0.536,20,32,0.625,117,30,98,0.306,25,70,0.357,5,28,0.179,26,34,0.765,91,2015-01-05,GSW,OKC
1223,23,Home,W 117-102 ,240,45,91,0.495,33,63,0.524,12,28,0.429,15,20,0.75,117,37,81,0.457,31,55,0.564,6,26,0.231,22,23,0.957,102,2015-01-07,GSW,IND
1224,24,@,W 117-108 ,240,44,92,0.478,35,64,0.547,9,28,0.321,20,31,0.645,117,41,89,0.461,36,71,0.507,5,18,0.278,21,26,0.808,108,2015-01-17,LAC,SAC
1225,25,@,W 117-115 (OT),265,48,90,0.533,44,76,0.579,4,14,0.286,17,23,0.739,117,41,101,0.406,29,72,0.403,12,29,0.414,21,28,0.75,115,2015-01-25,WAS,DEN
1226,26,Home,W 117-111 ,240,41,81,0.506,26,49,0.531,15,32,0.469,20,29,0.69,117,48,95,0.505,44,78,0.564,4,17,0.235,11,15,0.733,111,2015-02-06,HOU,MIL
1227,27,@,W 117-105 ,240,44,86,0.512,34,65,0.523,10,21,0.476,19,20,0.95,117,42,93,0.452,37,77,0.481,5,16,0.313,16,22,0.727,105,2015-02-09,ATL,MIN
1228,28,Home,W 117-113 (OT),265,48,97,0.495,39,71,0.549,9,26,0.346,12,21,0.571,117,39,101,0.386,31,77,0.403,8,24,0.333,27,30,0.9,113,2015-02-26,PHO,OKC
1229,29,Home,W 117-107 ,240,41,85,0.482,30,67,0.448,11,18,0.611,24,30,0.8,117,43,97,0.443,35,71,0.493,8,26,0.308,13,18,0.722,107,2015-03-10,SAS,TOR
1230,30,@,W 117-98 ,240,39,82,0.476,27,59,0.458,12,23,0.522,27,33,0.818,117,38,88,0.432,36,69,0.522,2,19,0.105,20,25,0.8,98,2015-03-16,TOR,IND
1231,31,Home,W 117-92 ,240,45,82,0.549,30,53,0.566,15,29,0.517,12,20,0.6,117,36,80,0.45,31,60,0.517,5,20,0.25,15,21,0.714,92,2015-03-18,CLE,BRK
1232,32,@,W 117-102 ,240,46,92,0.5,38,77,0.494,8,15,0.533,17,24,0.708,117,41,87,0.471,31,53,0.585,10,34,0.294,10,12,0.833,102,2015-03-21,PHO,HOU
1233,33,@,L 117-127 ,240,44,85,0.518,35,66,0.53,9,19,0.474,20,27,0.741,117,48,86,0.558,37,65,0.569,11,21,0.524,20,23,0.87,127,2015-03-24,LAL,OKC
1234,34,@,W 117-116 (OT),265,47,97,0.485,39,71,0.549,8,26,0.308,15,22,0.682,117,40,83,0.482,34,60,0.567,6,23,0.261,30,38,0.789,116,2015-04-04,BOS,TOR
1235,35,Home,W 117-80 ,240,45,89,0.506,33,69,0.478,12,20,0.6,15,23,0.652,117,32,82,0.39,27,67,0.403,5,15,0.333,11,17,0.647,80,2015-04-10,BRK,WAS
1236,36,Home,W 117-78 ,240,46,84,0.548,36,60,0.6,10,24,0.417,15,22,0.682,117,31,79,0.392,28,57,0.491,3,22,0.136,13,19,0.684,78,2015-04-12,BOS,CLE
1237,37,Home,W 117-91 ,240,41,76,0.539,29,48,0.604,12,28,0.429,23,34,0.676,117,38,101,0.376,33,74,0.446,5,27,0.185,10,18,0.556,91,2015-04-15,HOU,UTA
1238,38,@,W 117-110 ,240,41,86,0.477,32,67,0.478,9,19,0.474,26,32,0.813,117,38,90,0.422,32,68,0.471,6,22,0.273,28,33,0.848,110,2015-10-31,NYK,WAS
1239,39,Home,W 117-93 ,240,45,86,0.523,32,61,0.525,13,25,0.52,14,18,0.778,117,35,92,0.38,26,66,0.394,9,26,0.346,14,19,0.737,93,2015-11-01,OKC,DEN
1240,40,@,W 117-107 ,240,46,80,0.575,39,65,0.6,7,15,0.467,18,22,0.818,117,44,86,0.512,31,55,0.564,13,31,0.419,6,7,0.857,107,2015-11-09,MIN,ATL
1241,41,Home,L 117-124 ,240,44,88,0.5,31,59,0.525,13,29,0.448,16,24,0.667,117,38,73,0.521,21,43,0.488,17,30,0.567,31,36,0.861,124,2015-11-19,LAC,GSW
1242,42,Home,W 117-114 ,240,47,90,0.522,38,68,0.559,9,22,0.409,14,18,0.778,117,44,83,0.53,34,64,0.531,10,19,0.526,16,28,0.571,114,2015-11-22,OKC,DAL
1243,43,Home,W 117-103 ,240,43,81,0.531,25,46,0.543,18,35,0.514,13,22,0.591,117,40,81,0.494,30,59,0.508,10,22,0.455,13,21,0.619,103,2015-11-23,CLE,ORL
1244,44,Home,W 117-98 ,240,47,88,0.534,39,63,0.619,8,25,0.32,15,18,0.833,117,39,81,0.481,32,57,0.561,7,24,0.292,13,17,0.765,98,2015-12-26,ATL,NYK
1245,45,Home,L 117-122 ,240,38,88,0.432,29,58,0.5,9,30,0.3,32,36,0.889,117,37,71,0.521,22,41,0.537,15,30,0.5,33,41,0.805,122,2015-12-30,CHA,LAC
1246,46,Home,W 117-106 ,240,46,83,0.554,41,64,0.641,5,19,0.263,20,20,1.0,117,46,102,0.451,40,86,0.465,6,16,0.375,8,14,0.571,106,2016-01-05,CHI,MIL
1247,47,Home,W 117-116 (2OT),290,45,98,0.459,33,69,0.478,12,29,0.414,15,23,0.652,117,47,99,0.475,35,67,0.522,12,32,0.375,10,14,0.714,116,2016-01-05,DAL,SAC
1248,48,@,W 117-113 ,240,45,89,0.506,40,72,0.556,5,17,0.294,22,26,0.846,117,40,84,0.476,31,58,0.534,9,26,0.346,24,25,0.96,113,2016-01-08,OKC,LAL
1249,49,Home,W 117-103 ,240,42,96,0.438,28,66,0.424,14,30,0.467,19,29,0.655,117,35,89,0.393,25,62,0.403,10,27,0.37,23,28,0.821,103,2016-01-15,BOS,PHO
1250,50,Home,L 117-119 ,240,40,89,0.449,34,67,0.507,6,22,0.273,31,36,0.861,117,39,88,0.443,30,59,0.508,9,29,0.31,32,36,0.889,119,2016-01-16,WAS,BOS
1251,51,Home,W 117-87 ,240,39,69,0.565,32,51,0.627,7,18,0.389,32,40,0.8,117,35,81,0.432,32,66,0.485,3,15,0.2,14,25,0.56,87,2016-01-17,MIN,PHO
1252,52,@,W 117-89 ,240,42,86,0.488,33,72,0.458,9,14,0.643,24,28,0.857,117,32,81,0.395,26,63,0.413,6,18,0.333,19,23,0.826,89,2016-01-21,SAS,PHO
1253,53,@,W 117-113 ,240,41,81,0.506,32,63,0.508,9,18,0.5,26,33,0.788,117,39,88,0.443,28,60,0.467,11,28,0.393,24,30,0.8,113,2016-01-28,DEN,WAS
1254,54,Home,W 117-103 ,240,45,82,0.549,36,59,0.61,9,23,0.391,18,21,0.857,117,40,81,0.494,34,63,0.54,6,18,0.333,17,21,0.81,103,2016-01-30,CLE,SAS
1255,55,@,L 117-121 ,240,38,92,0.413,29,68,0.426,9,24,0.375,32,38,0.842,117,41,79,0.519,33,61,0.541,8,18,0.444,31,37,0.838,121,2016-01-30,SAC,MEM
1256,56,Home,W 117-114 ,240,44,93,0.473,35,66,0.53,9,27,0.333,20,25,0.8,117,47,95,0.495,37,72,0.514,10,23,0.435,10,12,0.833,114,2016-02-03,OKC,ORL
1257,57,@,W 117-110 (OT),265,46,93,0.495,37,64,0.578,9,29,0.31,16,22,0.727,117,43,92,0.467,31,63,0.492,12,29,0.414,12,20,0.6,110,2016-02-08,ORL,ATL
1258,58,@,W 117-95 ,240,45,87,0.517,33,59,0.559,12,28,0.429,15,19,0.789,117,40,92,0.435,36,74,0.486,4,18,0.222,11,15,0.733,95,2016-02-10,CHA,IND
1259,59,Home,W 117-112 ,240,35,76,0.461,31,62,0.5,4,14,0.286,43,53,0.811,117,39,86,0.453,29,55,0.527,10,31,0.323,24,32,0.75,112,2016-02-10,MIN,TOR
1260,60,@,W 117-109 (2OT),290,46,104,0.442,43,87,0.494,3,17,0.176,22,32,0.688,117,44,106,0.415,35,65,0.538,9,41,0.22,12,18,0.667,109,2016-02-20,MIL,ATL
1261,61,Home,W 117-114 (OT),265,38,74,0.514,28,50,0.56,10,24,0.417,31,38,0.816,117,36,87,0.414,25,53,0.472,11,34,0.324,31,41,0.756,114,2016-02-23,UTA,HOU
1262,62,@,W 117-107 ,240,43,89,0.483,34,60,0.567,9,29,0.31,22,26,0.846,117,34,78,0.436,22,54,0.407,12,24,0.5,27,37,0.73,107,2016-02-26,LAC,SAC
1263,63,Home,W 117-107 ,240,38,78,0.487,26,55,0.473,12,23,0.522,29,38,0.763,117,35,79,0.443,24,48,0.5,11,31,0.355,26,32,0.813,107,2016-03-02,DEN,LAL
1264,64,Home,W 117-115 ,240,34,67,0.507,28,55,0.509,6,12,0.5,43,54,0.796,117,39,83,0.47,28,56,0.5,11,27,0.407,26,35,0.743,115,2016-03-04,TOR,POR
1265,65,Home,W 117-96 ,240,43,88,0.489,30,67,0.448,13,21,0.619,18,24,0.75,117,35,87,0.402,29,67,0.433,6,20,0.3,20,23,0.87,96,2016-03-16,WAS,CHI
1266,66,@,W 117-112 ,240,36,78,0.462,27,51,0.529,9,27,0.333,36,40,0.9,117,40,83,0.482,30,62,0.484,10,21,0.476,22,28,0.786,112,2016-03-18,POR,NOP
1267,67,@,W 117-102 ,240,46,91,0.505,33,66,0.5,13,25,0.52,12,20,0.6,117,38,78,0.487,25,45,0.556,13,33,0.394,13,17,0.765,102,2016-03-21,WAS,ATL
1268,68,Home,W 117-105 ,240,44,83,0.53,30,50,0.6,14,33,0.424,15,20,0.75,117,42,90,0.467,32,60,0.533,10,30,0.333,11,12,0.917,105,2016-03-27,GSW,PHI
1269,69,@,L 117-119 ,240,42,76,0.553,26,47,0.553,16,29,0.552,17,22,0.773,117,45,87,0.517,35,55,0.636,10,32,0.313,19,24,0.792,119,2016-03-31,LAC,OKC
1270,70,Home,L 117-124 (OT),265,49,98,0.5,37,63,0.587,12,35,0.343,7,8,0.875,117,44,86,0.512,36,69,0.522,8,17,0.471,28,36,0.778,124,2016-04-05,GSW,MIN
1271,71,Home,W 117-103 ,240,47,86,0.547,36,57,0.632,11,29,0.379,12,19,0.632,117,42,91,0.462,34,64,0.531,8,27,0.296,11,18,0.611,103,2016-04-13,CHA,ORL
1272,72,Home,W 117-88 ,240,45,94,0.479,32,59,0.542,13,35,0.371,14,19,0.737,117,32,87,0.368,23,60,0.383,9,27,0.333,15,20,0.75,88,2016-10-25,CLE,NYK
1273,73,@,L 117-122 ,240,43,97,0.443,28,53,0.528,15,44,0.341,16,20,0.8,117,48,89,0.539,37,57,0.649,11,32,0.344,15,18,0.833,122,2016-10-26,BRK,BOS
1274,74,@,W 117-113 ,240,44,91,0.484,34,59,0.576,10,32,0.313,19,21,0.905,117,36,82,0.439,27,56,0.482,9,26,0.346,32,41,0.78,113,2016-11-01,MIL,NOP
1275,75,@,W 117-104 ,240,46,89,0.517,37,68,0.544,9,21,0.429,16,21,0.762,117,37,84,0.44,29,61,0.475,8,23,0.348,22,27,0.815,104,2016-11-04,NYK,CHI
1276,76,Home,W 117-97 ,240,45,95,0.474,37,65,0.569,8,30,0.267,19,21,0.905,117,39,86,0.453,34,54,0.63,5,32,0.156,14,20,0.7,97,2016-11-04,LAL,GSW
1277,77,Home,W 117-91 ,240,41,82,0.5,27,49,0.551,14,33,0.424,21,25,0.84,117,33,84,0.393,23,56,0.411,10,28,0.357,15,19,0.789,91,2016-11-05,MIL,SAC
1278,78,Home,W 117-96 ,240,48,95,0.505,35,63,0.556,13,32,0.406,8,14,0.571,117,36,83,0.434,25,54,0.463,11,29,0.379,13,20,0.65,96,2016-11-12,ATL,PHI
1279,79,Home,L 117-119 ,240,47,92,0.511,40,67,0.597,7,25,0.28,16,26,0.615,117,46,86,0.535,35,62,0.565,11,24,0.458,16,20,0.8,119,2016-11-13,OKC,ORL
1280,80,@,L 117-121 ,240,46,96,0.479,33,67,0.493,13,29,0.448,12,18,0.667,117,44,83,0.53,31,50,0.62,13,33,0.394,20,28,0.714,121,2016-11-15,TOR,CLE
1281,81,Home,W 117-96 ,240,45,83,0.542,36,59,0.61,9,24,0.375,18,23,0.783,117,33,86,0.384,30,69,0.435,3,17,0.176,27,33,0.818,96,2016-11-23,NOP,MIN
1282,82,@,W 117-104 ,240,40,85,0.471,19,35,0.543,21,50,0.42,16,20,0.8,117,39,80,0.488,30,48,0.625,9,32,0.281,17,21,0.81,104,2016-11-25,HOU,SAC
1283,83,@,W 117-87 ,240,43,84,0.512,36,58,0.621,7,26,0.269,24,29,0.828,117,30,81,0.37,19,55,0.345,11,26,0.423,16,24,0.667,87,2016-12-07,BOS,ORL
1284,84,@,W 117-90 ,240,42,84,0.5,28,55,0.509,14,29,0.483,19,23,0.826,117,37,78,0.474,34,62,0.548,3,16,0.188,13,20,0.65,90,2016-12-09,DET,MIN
1285,85,Home,W 117-110 ,240,43,81,0.531,33,62,0.532,10,19,0.526,21,30,0.7,117,43,87,0.494,36,64,0.563,7,23,0.304,17,24,0.708,110,2016-12-18,WAS,LAC
1286,86,Home,W 117-107 ,240,45,79,0.57,32,55,0.582,13,24,0.542,14,18,0.778,117,43,81,0.531,29,56,0.518,14,25,0.56,7,9,0.778,107,2016-12-19,DEN,DAL
1287,87,Home,W 117-113 ,240,43,94,0.457,32,69,0.464,11,25,0.44,20,24,0.833,117,44,90,0.489,28,57,0.491,16,33,0.485,9,11,0.818,113,2016-12-20,CHA,LAL
1288,88,@,W 117-101 ,240,47,104,0.452,35,67,0.522,12,37,0.324,11,14,0.786,117,38,86,0.442,25,51,0.49,13,35,0.371,12,16,0.75,101,2016-12-22,GSW,BRK
1289,89,@,W 117-112 ,240,41,80,0.513,30,54,0.556,11,26,0.423,24,36,0.667,117,41,93,0.441,32,65,0.492,9,28,0.321,21,26,0.808,112,2016-12-23,OKC,BOS
1290,90,Home,W 117-114 ,240,38,74,0.514,21,42,0.5,17,32,0.531,24,29,0.828,117,48,90,0.533,37,62,0.597,11,28,0.393,7,10,0.7,114,2016-12-30,BOS,MIA
1291,91,Home,W 117-104 ,240,43,86,0.5,34,64,0.531,9,22,0.409,22,24,0.917,117,42,97,0.433,32,59,0.542,10,38,0.263,10,11,0.909,104,2017-01-01,IND,ORL
1292,92,@,L 117-125 ,240,40,89,0.449,28,63,0.444,12,26,0.462,25,28,0.893,117,44,87,0.506,31,51,0.608,13,36,0.361,24,29,0.828,125,2017-01-04,POR,GSW
1293,93,Home,W 117-108 ,240,40,93,0.43,22,57,0.386,18,36,0.5,19,21,0.905,117,40,85,0.471,30,54,0.556,10,31,0.323,18,23,0.783,108,2017-01-07,BOS,NOP
1294,94,@,W 117-106 ,240,45,89,0.506,35,60,0.583,10,29,0.345,17,20,0.85,117,36,74,0.486,25,46,0.543,11,28,0.393,23,29,0.793,106,2017-01-08,GSW,SAC
1295,95,@,W 117-97 ,240,44,92,0.478,37,69,0.536,7,23,0.304,22,38,0.579,117,35,87,0.402,25,58,0.431,10,29,0.345,17,23,0.739,97,2017-01-10,ATL,BRK
1296,96,Home,W 117-108 ,240,43,85,0.506,26,44,0.591,17,41,0.415,14,18,0.778,117,45,105,0.429,35,79,0.443,10,26,0.385,8,12,0.667,108,2017-01-11,BOS,WAS
1297,97,@,W 117-106 ,240,46,91,0.505,36,66,0.545,10,25,0.4,15,18,0.833,117,35,91,0.385,26,58,0.448,9,33,0.273,27,29,0.931,106,2017-01-18,NYK,BOS
1298,98,Home,W 117-101 ,240,49,88,0.557,42,66,0.636,7,22,0.318,12,15,0.8,117,34,93,0.366,29,69,0.42,5,24,0.208,28,35,0.8,101,2017-01-31,WAS,NYK
1299,99,@,L 117-121 ,240,45,83,0.542,36,59,0.61,9,24,0.375,18,23,0.783,117,40,89,0.449,31,61,0.508,9,28,0.321,32,44,0.727,121,2017-02-03,MIL,DEN
1300,0,@,L 117-121 (OT),265,48,100,0.48,40,75,0.533,8,25,0.32,13,18,0.722,117,44,98,0.449,28,55,0.509,16,43,0.372,17,25,0.68,121,2017-02-03,CHI,HOU
1301,1,Home,W 117-106 ,240,47,93,0.505,39,66,0.591,8,27,0.296,15,18,0.833,117,40,100,0.4,27,56,0.482,13,44,0.295,13,21,0.619,106,2017-02-08,ATL,DEN
1302,2,Home,L 117-132 ,240,41,82,0.5,28,57,0.491,13,25,0.52,22,26,0.846,117,46,84,0.548,30,48,0.625,16,36,0.444,24,26,0.923,132,2017-02-08,IND,CLE
1303,3,Home,W 117-109 ,240,39,86,0.453,30,61,0.492,9,25,0.36,30,38,0.789,117,39,85,0.459,32,62,0.516,7,23,0.304,24,28,0.857,109,2017-02-11,PHI,MIA
1304,4,Home,W 117-89 ,240,44,81,0.543,38,57,0.667,6,24,0.25,23,26,0.885,117,35,84,0.417,25,59,0.424,10,25,0.4,9,13,0.692,89,2017-02-12,MIN,CHI
1305,5,@,W 117-109 ,240,44,84,0.524,31,49,0.633,13,35,0.371,16,24,0.667,117,36,87,0.414,23,47,0.489,13,40,0.325,24,31,0.774,109,2017-02-15,MIA,HOU
1306,6,@,W 117-99 ,240,46,93,0.495,31,63,0.492,15,30,0.5,10,16,0.625,117,37,80,0.463,23,43,0.535,14,37,0.378,11,15,0.733,99,2017-02-25,CHI,CLE
1307,7,@,W 117-108 ,240,41,91,0.451,28,61,0.459,13,30,0.433,22,25,0.88,117,32,88,0.364,22,43,0.512,10,45,0.222,34,42,0.81,108,2017-02-27,IND,HOU
1308,8,@,W 116-109 (3OT),315,45,102,0.441,37,74,0.5,8,28,0.286,18,23,0.783,116,36,94,0.383,30,72,0.417,6,22,0.273,31,46,0.674,109,2012-01-05,MIA,ATL
1309,9,Home,W 116-101 ,240,45,82,0.549,34,63,0.54,11,19,0.579,15,22,0.682,116,39,84,0.464,34,72,0.472,5,12,0.417,18,22,0.818,101,2012-01-27,DAL,UTA
1310,10,Home,L 116-119 ,240,44,80,0.55,35,59,0.593,9,21,0.429,19,23,0.826,116,44,84,0.524,33,58,0.569,11,26,0.423,20,21,0.952,119,2012-02-07,GSW,OKC
1311,11,@,L 116-119 (OT),265,45,98,0.459,33,71,0.465,12,27,0.444,14,21,0.667,116,40,88,0.455,29,61,0.475,11,27,0.407,28,35,0.8,119,2012-03-05,SAC,DEN
1312,12,Home,W 116-98 ,240,45,76,0.592,39,64,0.609,6,12,0.5,20,24,0.833,116,29,70,0.414,26,59,0.441,3,11,0.273,37,44,0.841,98,2012-03-07,TOR,HOU
1313,13,@,W 116-111 (2OT),290,41,83,0.494,35,63,0.556,6,20,0.3,28,34,0.824,116,52,116,0.448,50,97,0.515,2,19,0.105,5,5,1.0,111,2012-03-13,LAL,MEM
1314,14,@,W 116-87 ,240,48,83,0.578,37,62,0.597,11,21,0.524,9,13,0.692,116,29,82,0.354,22,58,0.379,7,24,0.292,22,26,0.846,87,2012-03-20,MIL,POR
1315,15,Home,W 116-115 ,240,46,79,0.582,37,62,0.597,9,17,0.529,15,22,0.682,116,40,79,0.506,26,61,0.426,14,18,0.778,21,30,0.7,115,2012-03-21,DEN,DET
1316,16,Home,W 116-100 ,240,45,95,0.474,38,76,0.5,7,19,0.368,19,25,0.76,116,39,88,0.443,32,66,0.485,7,22,0.318,15,20,0.75,100,2012-03-21,SAS,MIN
1317,17,Home,W 116-108 ,240,43,85,0.506,36,62,0.581,7,23,0.304,23,28,0.821,116,39,81,0.481,28,60,0.467,11,21,0.524,19,26,0.731,108,2012-04-02,SAC,MIN
1318,18,@,W 116-96 ,240,43,82,0.524,34,62,0.548,9,20,0.45,21,23,0.913,116,38,81,0.469,35,74,0.473,3,7,0.429,17,24,0.708,96,2012-04-07,ATL,CHA
1319,19,Home,W 116-94 ,240,47,94,0.5,35,69,0.507,12,25,0.48,10,11,0.909,116,34,78,0.436,28,56,0.5,6,22,0.273,20,23,0.87,94,2012-04-07,MIL,POR
1320,20,Home,W 116-77 ,240,45,75,0.6,37,57,0.649,8,18,0.444,18,20,0.9,116,27,78,0.346,20,57,0.351,7,21,0.333,16,21,0.762,77,2012-04-17,DET,CLE
1321,21,Home,W 116-84 ,240,42,85,0.494,34,57,0.596,8,28,0.286,24,29,0.828,116,32,92,0.348,25,67,0.373,7,25,0.28,13,19,0.684,84,2012-04-18,ATL,DET
1322,22,Home,W 116-106 ,240,42,83,0.506,33,63,0.524,9,20,0.45,23,28,0.821,116,36,72,0.5,28,54,0.519,8,18,0.444,26,32,0.813,106,2012-10-31,POR,LAL
1323,23,@,L 116-119 ,240,49,95,0.516,44,74,0.595,5,21,0.238,13,20,0.65,116,43,83,0.518,33,58,0.569,10,25,0.4,23,27,0.852,119,2012-11-03,DEN,MIA
1324,24,@,W 116-109 (OT),265,39,88,0.443,33,67,0.493,6,21,0.286,32,37,0.865,116,45,91,0.495,38,71,0.535,7,20,0.35,12,17,0.706,109,2012-11-24,OKC,PHI
1325,25,@,W 116-110 (OT),265,47,105,0.448,40,87,0.46,7,18,0.389,15,19,0.789,116,41,90,0.456,30,64,0.469,11,26,0.423,17,19,0.895,110,2012-11-25,BOS,ORL
1326,26,@,L 116-124 ,240,48,94,0.511,37,74,0.5,11,20,0.55,9,11,0.818,116,46,83,0.554,35,61,0.574,11,22,0.5,21,26,0.808,124,2012-12-01,UTA,HOU
1327,27,Home,W 116-81 ,240,47,86,0.547,35,62,0.565,12,24,0.5,10,16,0.625,116,29,76,0.382,20,53,0.377,9,23,0.391,14,18,0.778,81,2012-12-01,LAC,SAC
1328,28,@,W 116-109 ,240,43,91,0.473,33,67,0.493,10,24,0.417,20,25,0.8,116,35,72,0.486,23,37,0.622,12,35,0.343,27,38,0.711,109,2012-12-08,DAL,HOU
1329,29,Home,W 116-107 ,240,42,79,0.532,30,54,0.556,12,25,0.48,20,30,0.667,116,35,84,0.417,23,47,0.489,12,37,0.324,25,29,0.862,107,2012-12-13,NYK,LAL
1330,30,@,L 116-122 ,240,45,86,0.523,34,54,0.63,11,32,0.344,15,26,0.577,116,44,77,0.571,32,54,0.593,12,23,0.522,22,24,0.917,122,2012-12-28,HOU,SAS
1331,31,@,W 116-114 ,240,38,77,0.494,31,54,0.574,7,23,0.304,33,41,0.805,116,34,71,0.479,25,56,0.446,9,15,0.6,37,40,0.925,114,2012-12-28,LAC,UTA
1332,32,@,W 116-101 ,240,44,87,0.506,35,58,0.603,9,29,0.31,19,28,0.679,116,39,98,0.398,33,70,0.471,6,28,0.214,17,22,0.773,101,2013-01-11,OKC,LAL
1333,33,Home,W 116-105 ,240,43,90,0.478,34,63,0.54,9,27,0.333,21,27,0.778,116,43,83,0.518,30,59,0.508,13,24,0.542,6,8,0.75,105,2013-01-13,DEN,GSW
1334,34,@,W 116-112 ,240,38,77,0.494,28,55,0.509,10,22,0.455,30,35,0.857,116,45,79,0.57,36,55,0.655,9,24,0.375,13,23,0.565,112,2013-01-19,GSW,NOH
1335,35,@,L 116-123 (OT),265,44,88,0.5,30,57,0.526,14,31,0.452,14,18,0.778,116,45,82,0.549,36,60,0.6,9,22,0.409,24,38,0.632,123,2013-01-23,TOR,MIA
1336,36,Home,W 116-95 ,240,46,87,0.529,41,76,0.539,5,11,0.455,19,25,0.76,116,36,87,0.414,31,64,0.484,5,23,0.217,18,30,0.6,95,2013-02-07,BOS,LAL
1337,37,Home,W 116-91 ,240,38,77,0.494,27,57,0.474,11,20,0.55,29,38,0.763,116,34,89,0.382,28,73,0.384,6,16,0.375,17,24,0.708,91,2013-02-09,DAL,GSW
1338,38,@,W 116-107 ,240,43,91,0.473,33,57,0.579,10,34,0.294,20,25,0.8,116,38,84,0.452,30,64,0.469,8,20,0.4,23,31,0.742,107,2013-02-12,HOU,GSW
1339,39,@,W 116-90 ,240,43,73,0.589,35,56,0.625,8,17,0.471,22,28,0.786,116,32,76,0.421,27,60,0.45,5,16,0.313,21,25,0.84,90,2013-02-21,SAS,LAC
1340,40,Home,W 116-94 ,240,44,83,0.53,28,51,0.549,16,32,0.5,12,21,0.571,116,37,81,0.457,30,60,0.5,7,21,0.333,13,15,0.867,94,2013-02-28,LAL,MIN
1341,41,@,W 116-94 ,240,46,81,0.568,34,57,0.596,12,24,0.5,12,16,0.75,116,35,85,0.412,28,62,0.452,7,23,0.304,17,25,0.68,94,2013-03-08,OKC,CHA
1342,42,@,L 116-118 (OT),265,48,93,0.516,40,71,0.563,8,22,0.364,12,16,0.75,116,39,91,0.429,25,52,0.481,14,39,0.359,26,36,0.722,118,2013-03-08,TOR,LAL
1343,43,Home,W 116-101 ,240,37,73,0.507,23,45,0.511,14,28,0.5,28,34,0.824,116,36,80,0.45,27,54,0.5,9,26,0.346,20,26,0.769,101,2013-03-19,SAC,LAC
1344,44,Home,W 116-78 ,240,44,77,0.571,34,48,0.708,10,29,0.345,18,27,0.667,116,31,86,0.36,27,66,0.409,4,20,0.2,12,15,0.8,78,2013-03-22,HOU,CLE
1345,45,Home,W 116-107 ,240,45,81,0.556,35,64,0.547,10,17,0.588,16,24,0.667,116,42,81,0.519,34,58,0.586,8,23,0.348,15,19,0.789,107,2013-03-30,UTA,BRK
1346,46,@,W 116-98 ,240,39,76,0.513,27,48,0.563,12,28,0.429,26,35,0.743,116,38,91,0.418,36,71,0.507,2,20,0.1,20,24,0.833,98,2013-04-05,HOU,POR
1347,47,@,W 116-97 ,240,42,83,0.506,30,56,0.536,12,27,0.444,20,23,0.87,116,37,84,0.44,30,68,0.441,7,16,0.438,16,26,0.615,97,2013-04-11,OKC,GSW
1348,48,@,L 116-118 ,240,46,97,0.474,35,71,0.493,11,26,0.423,13,16,0.813,116,34,66,0.515,22,41,0.537,12,25,0.48,38,50,0.76,118,2013-04-12,GSW,LAL
1349,49,Home,W 116-106 ,240,46,85,0.541,37,65,0.569,9,20,0.45,15,18,0.833,116,45,98,0.459,37,74,0.5,8,24,0.333,8,13,0.615,106,2013-04-15,GSW,SAS
1350,50,Home,W 116-103 ,240,42,93,0.452,28,64,0.438,14,29,0.483,18,28,0.643,116,41,83,0.494,33,62,0.532,8,21,0.381,13,23,0.565,103,2013-10-29,LAL,LAC
1351,51,@,W 116-101 ,240,41,75,0.547,35,53,0.66,6,22,0.273,28,34,0.824,116,36,87,0.414,26,56,0.464,10,31,0.323,19,29,0.655,101,2013-11-05,HOU,POR
1352,52,@,W 116-102 ,240,43,98,0.439,25,65,0.385,18,33,0.545,12,16,0.75,116,39,83,0.47,33,65,0.508,6,18,0.333,18,26,0.692,102,2013-11-06,WAS,PHI
1353,53,Home,W 116-108 ,240,41,89,0.461,33,69,0.478,8,20,0.4,26,30,0.867,116,44,90,0.489,34,68,0.5,10,22,0.455,10,15,0.667,108,2013-11-08,MIN,DAL
1354,54,Home,W 116-95 ,240,44,79,0.557,33,59,0.559,11,20,0.55,17,21,0.81,116,34,84,0.405,31,74,0.419,3,10,0.3,24,33,0.727,95,2013-11-12,LAL,NOP
1355,55,Home,W 116-115 ,240,45,94,0.479,31,71,0.437,14,23,0.609,12,14,0.857,116,41,80,0.513,32,58,0.552,9,22,0.409,24,28,0.857,115,2013-11-14,GSW,OKC
1356,56,Home,W 116-111 ,240,46,87,0.529,40,66,0.606,6,21,0.286,18,22,0.818,116,44,83,0.53,31,55,0.564,13,28,0.464,10,13,0.769,111,2013-11-26,WAS,LAL
1357,57,@,W 116-103 ,240,45,82,0.549,32,59,0.542,13,23,0.565,13,16,0.813,116,38,83,0.458,28,60,0.467,10,23,0.435,17,19,0.895,103,2013-12-10,SAS,TOR
1358,58,@,W 116-100 ,240,40,71,0.563,31,53,0.585,9,18,0.5,27,33,0.818,116,34,81,0.42,28,66,0.424,6,15,0.4,26,34,0.765,100,2013-12-11,OKC,MEM
1359,59,@,W 116-112 ,240,39,79,0.494,27,50,0.54,12,29,0.414,26,35,0.743,116,43,90,0.478,37,68,0.544,6,22,0.273,20,24,0.833,112,2013-12-13,HOU,GSW
1360,60,Home,W 116-107 ,240,41,83,0.494,29,59,0.492,12,24,0.5,22,29,0.759,116,38,87,0.437,32,68,0.471,6,19,0.316,25,29,0.862,107,2013-12-13,PHO,SAC
1361,61,Home,L 116-119 ,240,48,102,0.471,39,85,0.459,9,17,0.529,11,16,0.688,116,41,92,0.446,26,59,0.441,15,33,0.455,22,25,0.88,119,2013-12-17,CLE,POR
1362,62,@,W 116-106 ,240,44,84,0.524,41,74,0.554,3,10,0.3,25,28,0.893,116,42,90,0.467,30,67,0.448,12,23,0.522,10,17,0.588,106,2013-12-20,CHA,DET
1363,63,Home,W 116-106 ,240,43,82,0.524,36,57,0.632,7,25,0.28,23,25,0.92,116,38,93,0.409,28,70,0.4,10,23,0.435,20,22,0.909,106,2013-12-21,MIL,PHI
1364,64,@,L 116-120 (OT),265,45,96,0.469,39,74,0.527,6,22,0.273,20,27,0.741,116,46,97,0.474,39,68,0.574,7,29,0.241,21,27,0.778,120,2013-12-22,MIN,LAC
1365,65,@,W 116-107 ,240,37,75,0.493,30,59,0.508,7,16,0.438,35,42,0.833,116,39,85,0.459,34,68,0.5,5,17,0.294,24,31,0.774,107,2013-12-26,SAS,DAL
1366,66,Home,W 116-112 (OT),265,42,96,0.438,29,60,0.483,13,36,0.361,19,22,0.864,116,49,110,0.445,41,90,0.456,8,20,0.4,6,12,0.5,112,2013-12-26,POR,LAC
1367,67,@,L 116-118 (OT),265,45,104,0.433,35,78,0.449,10,26,0.385,16,22,0.727,116,37,91,0.407,21,52,0.404,16,39,0.41,28,34,0.824,118,2013-12-28,CHA,ATL
1368,68,Home,W 116-100 ,240,41,85,0.482,29,58,0.5,12,27,0.444,22,25,0.88,116,37,68,0.544,27,47,0.574,10,21,0.476,16,20,0.8,100,2014-01-04,PHO,MIL
1369,69,Home,W 116-92 ,240,50,90,0.556,46,72,0.639,4,18,0.222,12,16,0.75,116,37,79,0.468,34,64,0.531,3,15,0.2,15,21,0.714,92,2014-01-04,SAS,LAC
1370,70,Home,W 116-94 ,240,40,79,0.506,28,56,0.5,12,23,0.522,24,30,0.8,116,35,83,0.422,26,64,0.406,9,19,0.474,15,22,0.682,94,2014-01-13,TOR,MIL
1371,71,Home,W 116-92 ,240,45,82,0.549,39,66,0.591,6,16,0.375,20,25,0.8,116,39,92,0.424,35,79,0.443,4,13,0.308,10,17,0.588,92,2014-01-14,IND,SAC
1372,72,Home,L 116-123 ,240,39,90,0.433,30,62,0.484,9,28,0.321,29,33,0.879,116,45,83,0.542,33,59,0.559,12,24,0.5,21,29,0.724,123,2014-01-15,GSW,DEN
1373,73,@,W 116-111 (OT),265,41,95,0.432,33,71,0.465,8,24,0.333,26,33,0.788,116,39,101,0.386,27,69,0.391,12,32,0.375,21,29,0.724,111,2014-01-24,IND,SAC
1374,74,Home,W 116-106 ,240,43,74,0.581,36,53,0.679,7,21,0.333,23,28,0.821,116,43,91,0.473,39,78,0.5,4,13,0.308,16,28,0.571,106,2014-01-26,DAL,DET
1375,75,Home,W 116-115 ,240,40,83,0.482,35,65,0.538,5,18,0.278,31,44,0.705,116,42,84,0.5,36,63,0.571,6,21,0.286,25,34,0.735,115,2014-02-03,DEN,LAC
1376,76,@,W 116-112 ,240,41,78,0.526,28,47,0.596,13,31,0.419,21,26,0.808,116,37,86,0.43,30,61,0.492,7,25,0.28,31,42,0.738,112,2014-02-05,MIA,LAC
1377,77,Home,W 116-98 ,240,42,82,0.512,34,62,0.548,8,20,0.4,24,31,0.774,116,38,90,0.422,30,72,0.417,8,18,0.444,14,20,0.7,98,2014-02-19,CHA,DET
1378,78,Home,W 116-104 ,240,40,74,0.541,30,51,0.588,10,23,0.435,26,32,0.813,116,42,78,0.538,37,65,0.569,5,13,0.385,15,17,0.882,104,2014-02-28,PHO,NOP
1379,79,Home,W 116-99 ,240,41,82,0.5,33,60,0.55,8,22,0.364,26,30,0.867,116,30,68,0.441,22,46,0.478,8,22,0.364,31,40,0.775,99,2014-03-02,OKC,CHA
1380,80,@,W 116-102 ,240,43,83,0.518,39,69,0.565,4,14,0.286,26,32,0.813,116,36,82,0.439,30,65,0.462,6,17,0.353,24,29,0.828,102,2014-03-05,SAC,MIL
1381,81,@,W 116-92 ,240,42,80,0.525,31,61,0.508,11,19,0.579,21,24,0.875,116,34,81,0.42,26,62,0.419,8,19,0.421,16,23,0.696,92,2014-03-12,NYK,BOS
1382,82,Home,W 116-103 ,240,41,81,0.506,27,46,0.587,14,35,0.4,20,25,0.8,116,38,90,0.422,26,63,0.413,12,27,0.444,15,17,0.882,103,2014-03-20,POR,WAS
1383,83,Home,W 116-111 (OT),265,46,92,0.5,38,71,0.535,8,21,0.381,16,23,0.696,116,40,83,0.482,23,46,0.5,17,37,0.459,14,16,0.875,111,2014-03-26,CHA,BRK
1384,84,Home,W 116-96 ,240,41,74,0.554,30,56,0.536,11,18,0.611,23,26,0.885,116,36,86,0.419,30,65,0.462,6,21,0.286,18,24,0.75,96,2014-03-30,OKC,UTA
1385,85,Home,W 116-111 ,240,46,97,0.474,37,74,0.5,9,23,0.391,15,21,0.714,116,39,88,0.443,34,71,0.479,5,17,0.294,28,36,0.778,111,2014-03-31,DET,MIL
1386,86,Home,W 116-104 ,240,46,76,0.605,31,45,0.689,15,31,0.484,9,11,0.818,116,41,88,0.466,32,61,0.525,9,27,0.333,13,21,0.619,104,2014-04-04,BRK,DET
1387,87,@,L 116-123 ,240,40,92,0.435,25,52,0.481,15,40,0.375,21,25,0.84,116,50,101,0.495,39,73,0.534,11,28,0.393,12,14,0.857,123,2014-04-09,HOU,DEN
1388,88,@,L 116-119 ,240,42,85,0.494,38,65,0.585,4,20,0.2,28,35,0.8,116,44,84,0.524,38,68,0.559,6,16,0.375,25,38,0.658,119,2014-04-11,CLE,MIL
1389,89,Home,W 116-94 ,240,44,82,0.537,39,69,0.565,5,13,0.385,23,27,0.852,116,35,86,0.407,26,68,0.382,9,18,0.5,15,19,0.789,94,2014-04-11,OKC,NOP
1390,90,@,W 116-107 ,240,39,81,0.481,30,58,0.517,9,23,0.391,29,35,0.829,116,35,84,0.417,30,64,0.469,5,20,0.25,32,48,0.667,107,2014-04-13,TOR,DET
1391,91,@,W 116-112 ,240,44,90,0.489,36,67,0.537,8,23,0.348,20,35,0.571,116,37,84,0.44,28,50,0.56,9,34,0.265,29,35,0.829,112,2014-04-16,GSW,DEN
1392,92,Home,W 116-85 ,240,44,84,0.524,33,61,0.541,11,23,0.478,17,19,0.895,116,32,82,0.39,24,59,0.407,8,23,0.348,13,21,0.619,85,2014-11-03,BRK,OKC
1393,93,Home,W 116-100 ,240,45,100,0.45,29,69,0.42,16,31,0.516,10,14,0.714,116,36,91,0.396,31,78,0.397,5,13,0.385,23,30,0.767,100,2014-11-09,POR,DEN
1394,94,Home,W 116-99 ,240,43,86,0.5,31,61,0.508,12,25,0.48,18,26,0.692,116,41,85,0.482,37,72,0.514,4,13,0.308,13,17,0.765,99,2014-12-02,PHO,IND
1395,95,Home,L 116-117 (3OT),315,43,105,0.41,26,70,0.371,17,35,0.486,13,27,0.481,116,48,107,0.449,38,80,0.475,10,27,0.37,11,14,0.786,117,2014-12-17,SAS,MEM
1396,96,@,W 116-102 ,240,43,88,0.489,33,65,0.508,10,23,0.435,20,32,0.625,116,37,87,0.425,33,70,0.471,4,17,0.235,24,34,0.706,102,2014-12-28,TOR,DEN
1397,97,@,W 116-107 ,240,44,87,0.506,35,65,0.538,9,22,0.409,19,24,0.792,116,42,81,0.519,30,61,0.492,12,20,0.6,11,20,0.55,107,2014-12-28,PHO,LAL
1398,98,@,W 116-105 ,240,46,91,0.505,33,66,0.5,13,25,0.52,11,13,0.846,116,39,81,0.481,32,60,0.533,7,21,0.333,20,24,0.833,105,2015-01-13,GSW,UTA
1399,99,Home,L 116-120 (OT),265,37,79,0.468,27,55,0.491,10,24,0.417,32,41,0.78,116,44,88,0.5,33,62,0.532,11,26,0.423,21,30,0.7,120,2015-01-31,WAS,TOR
1400,0,@,L 116-124 ,240,47,103,0.456,35,70,0.5,12,33,0.364,10,15,0.667,116,38,77,0.494,23,50,0.46,15,27,0.556,33,37,0.892,124,2015-02-06,GSW,ATL
1401,1,@,W 116-113 ,240,40,83,0.482,29,63,0.46,11,20,0.55,25,30,0.833,116,40,89,0.449,32,65,0.492,8,24,0.333,25,28,0.893,113,2015-02-06,NOP,OKC
1402,2,Home,W 116-105 ,240,44,90,0.489,35,68,0.515,9,22,0.409,19,24,0.792,116,37,73,0.507,32,58,0.552,5,15,0.333,26,29,0.897,105,2015-03-08,SAS,CHI
1403,3,@,W 116-105 ,240,45,88,0.511,28,51,0.549,17,37,0.459,9,13,0.692,116,38,79,0.481,35,62,0.565,3,17,0.176,26,32,0.813,105,2015-03-18,LAC,SAC
1404,4,@,W 116-103 ,240,45,74,0.608,33,51,0.647,12,23,0.522,14,17,0.824,116,39,83,0.47,30,62,0.484,9,21,0.429,16,19,0.842,103,2015-03-25,CHI,TOR
1405,5,@,W 116-104 ,240,45,89,0.506,36,63,0.571,9,26,0.346,17,23,0.739,116,40,85,0.471,33,59,0.559,7,26,0.269,17,19,0.895,104,2015-03-30,BOS,CHO
1406,6,Home,L 116-117 (OT),265,40,83,0.482,34,60,0.567,6,23,0.261,30,38,0.789,116,47,97,0.485,39,71,0.549,8,26,0.308,15,22,0.682,117,2015-04-04,TOR,BOS
1407,7,Home,W 116-111 ,240,42,80,0.525,33,56,0.589,9,24,0.375,23,34,0.676,116,45,93,0.484,39,74,0.527,6,19,0.316,15,21,0.714,111,2015-04-07,SAC,MIN
1408,8,Home,W 116-91 ,240,42,85,0.494,30,52,0.577,12,33,0.364,20,23,0.87,116,32,85,0.376,29,74,0.392,3,11,0.273,24,29,0.828,91,2015-04-08,POR,MIN
1409,9,Home,W 116-105 ,240,48,90,0.533,36,64,0.563,12,26,0.462,8,9,0.889,116,46,98,0.469,39,74,0.527,7,24,0.292,6,8,0.75,105,2015-04-09,GSW,POR
1410,10,Home,W 116-103 ,240,44,97,0.454,34,66,0.515,10,31,0.323,18,24,0.75,116,37,81,0.457,28,57,0.491,9,24,0.375,20,28,0.714,103,2015-04-10,OKC,SAC
1411,11,Home,W 116-77 ,240,41,81,0.506,25,53,0.472,16,28,0.571,18,23,0.783,116,27,79,0.342,23,64,0.359,4,15,0.267,19,29,0.655,77,2015-04-12,DET,CHO
1412,12,Home,W 116-104 ,240,42,79,0.532,32,59,0.542,10,20,0.5,22,35,0.629,116,41,95,0.432,30,67,0.448,11,28,0.393,11,28,0.393,104,2015-04-12,IND,OKC
1413,13,@,W 116-110 ,240,40,82,0.488,25,46,0.543,15,36,0.417,21,27,0.778,116,40,93,0.43,31,65,0.477,9,28,0.321,21,29,0.724,110,2015-11-06,HOU,SAC
1414,14,Home,L 116-129 ,240,43,87,0.494,40,78,0.513,3,9,0.333,27,36,0.75,116,48,89,0.539,30,51,0.588,18,38,0.474,15,16,0.938,129,2015-11-12,MIN,GSW
1415,15,Home,W 116-111 ,240,39,80,0.488,28,55,0.509,11,25,0.44,27,36,0.75,116,44,91,0.484,39,76,0.513,5,15,0.333,18,22,0.818,111,2015-11-18,CHA,BRK
1416,16,Home,W 116-109 ,240,42,89,0.472,35,65,0.538,7,24,0.292,25,33,0.758,116,43,84,0.512,31,61,0.508,12,23,0.522,11,20,0.55,109,2015-11-19,MIA,SAC
1417,17,@,L 116-122 ,240,35,90,0.389,18,54,0.333,17,36,0.472,29,33,0.879,116,39,85,0.459,28,55,0.509,11,30,0.367,33,40,0.825,122,2015-11-22,PHO,NOP
1418,18,Home,W 116-114 ,240,38,73,0.521,27,53,0.509,11,20,0.55,29,37,0.784,116,40,83,0.482,24,48,0.5,16,35,0.457,18,26,0.692,114,2015-11-27,HOU,PHI
1419,19,@,W 116-101 ,240,35,75,0.467,21,36,0.583,14,39,0.359,32,36,0.889,116,35,80,0.438,23,50,0.46,12,30,0.4,19,21,0.905,101,2015-11-27,ATL,MEM
1420,20,Home,L 116-135 ,240,45,92,0.489,35,66,0.53,10,26,0.385,16,23,0.696,116,46,81,0.568,24,43,0.558,22,38,0.579,21,31,0.677,135,2015-11-27,PHO,GSW
1421,21,@,W 116-111 (OT),265,43,95,0.453,36,70,0.514,7,25,0.28,23,36,0.639,116,45,78,0.577,39,60,0.65,6,18,0.333,15,17,0.882,111,2015-11-29,HOU,NYK
1422,22,Home,W 116-105 ,240,45,85,0.529,37,62,0.597,8,23,0.348,18,37,0.486,116,35,88,0.398,24,61,0.393,11,27,0.407,24,28,0.857,105,2015-11-30,DET,HOU
1423,23,@,W 116-99 ,240,46,88,0.523,30,54,0.556,16,34,0.471,8,11,0.727,116,35,94,0.372,26,63,0.413,9,31,0.29,20,30,0.667,99,2015-12-02,GSW,CHO
1424,24,@,W 116-104 ,240,38,76,0.5,22,45,0.489,16,31,0.516,24,27,0.889,116,42,89,0.472,34,62,0.548,8,27,0.296,12,21,0.571,104,2015-12-06,DAL,WAS
1425,25,@,L 116-119 ,240,43,89,0.483,33,64,0.516,10,25,0.4,20,24,0.833,116,38,78,0.487,27,57,0.474,11,21,0.524,32,43,0.744,119,2015-12-16,BOS,DET
1426,26,Home,W 116-109 ,240,43,75,0.573,31,52,0.596,12,23,0.522,18,26,0.692,116,39,80,0.488,26,46,0.565,13,34,0.382,18,22,0.818,109,2015-12-20,MIA,POR
1427,27,Home,L 116-120 ,240,41,82,0.5,28,52,0.538,13,30,0.433,21,26,0.808,116,45,77,0.584,39,63,0.619,6,14,0.429,24,35,0.686,120,2015-12-31,IND,MIL
1428,28,@,W 116-104 ,240,40,89,0.449,33,72,0.458,7,17,0.412,29,39,0.744,116,39,89,0.438,29,60,0.483,10,29,0.345,16,23,0.696,104,2016-01-04,SAC,OKC
1429,29,@,L 116-117 (2OT),290,47,99,0.475,35,67,0.522,12,32,0.375,10,14,0.714,116,45,98,0.459,33,69,0.478,12,29,0.414,15,23,0.652,117,2016-01-05,SAC,DAL
1430,30,Home,L 116-128 ,240,43,92,0.467,35,69,0.507,8,23,0.348,22,29,0.759,116,49,87,0.563,30,50,0.6,19,37,0.514,11,15,0.733,128,2016-01-09,SAC,GSW
1431,31,Home,W 116-97 ,240,41,79,0.519,31,55,0.564,10,24,0.417,24,31,0.774,116,36,89,0.404,28,64,0.438,8,25,0.32,17,27,0.63,97,2016-01-12,IND,PHO
1432,32,Home,W 116-98 ,240,43,86,0.5,30,53,0.566,13,33,0.394,17,20,0.85,116,40,90,0.444,36,67,0.537,4,23,0.174,14,24,0.583,98,2016-01-14,GSW,LAL
1433,33,@,W 116-104 ,240,47,93,0.505,32,58,0.552,15,35,0.429,7,11,0.636,116,38,85,0.447,30,66,0.455,8,19,0.421,20,28,0.714,104,2016-01-15,POR,BRK
1434,34,@,W 116-88 ,240,43,76,0.566,30,53,0.566,13,23,0.565,17,24,0.708,116,33,85,0.388,29,67,0.433,4,18,0.222,18,20,0.9,88,2016-01-22,LAC,NYK
1435,35,Home,L 116-120 (OT),265,45,91,0.495,34,68,0.5,11,23,0.478,15,19,0.789,116,45,101,0.446,35,74,0.473,10,27,0.37,20,22,0.909,120,2016-01-22,ORL,CHO
1436,36,Home,W 116-99 ,240,43,94,0.457,26,63,0.413,17,31,0.548,13,17,0.765,116,39,74,0.527,33,59,0.559,6,15,0.4,15,18,0.833,99,2016-01-23,NOP,MIL
1437,37,Home,W 116-106 ,240,45,94,0.479,37,77,0.481,8,17,0.471,18,25,0.72,116,43,93,0.462,35,67,0.522,8,26,0.308,12,19,0.632,106,2016-01-24,BRK,OKC
1438,38,@,W 116-91 ,240,44,90,0.489,35,68,0.515,9,22,0.409,19,23,0.826,116,32,75,0.427,25,51,0.49,7,24,0.292,20,30,0.667,91,2016-01-25,BOS,WAS
1439,39,Home,W 116-108 ,240,41,86,0.477,33,67,0.493,8,19,0.421,26,30,0.867,116,36,95,0.379,27,56,0.482,9,39,0.231,27,43,0.628,108,2016-01-29,OKC,HOU
1440,40,@,W 116-95 ,240,42,73,0.575,26,44,0.591,16,29,0.552,16,23,0.696,116,33,90,0.367,27,72,0.375,6,18,0.333,23,26,0.885,95,2016-01-31,GSW,NYK
1441,41,@,W 116-90 ,240,41,80,0.513,29,58,0.5,12,22,0.545,22,25,0.88,116,33,73,0.452,30,58,0.517,3,15,0.2,21,27,0.778,90,2016-02-05,SAS,DAL
1442,42,Home,W 116-108 ,240,48,97,0.495,41,71,0.577,7,26,0.269,13,20,0.65,116,36,85,0.424,29,63,0.46,7,22,0.318,29,37,0.784,108,2016-02-06,GSW,OKC
1443,43,@,W 116-102 ,240,47,97,0.485,37,73,0.507,10,24,0.417,12,20,0.6,116,36,81,0.444,34,69,0.493,2,12,0.167,28,35,0.8,102,2016-02-08,NOP,MIN
1444,44,Home,W 116-103 ,240,41,89,0.461,33,61,0.541,8,28,0.286,26,34,0.765,116,37,77,0.481,26,43,0.605,11,34,0.324,18,34,0.529,103,2016-02-10,POR,HOU
1445,45,Home,W 116-106 ,240,48,93,0.516,41,77,0.532,7,16,0.438,13,20,0.65,116,38,88,0.432,33,70,0.471,5,18,0.278,25,34,0.735,106,2016-02-19,CHI,TOR
1446,46,@,W 116-100 ,240,37,78,0.474,30,54,0.556,7,24,0.292,35,56,0.625,116,30,82,0.366,19,47,0.404,11,35,0.314,29,35,0.829,100,2016-02-19,HOU,PHO
1447,47,Home,W 116-110 ,240,41,83,0.494,31,62,0.5,10,21,0.476,24,31,0.774,116,42,90,0.467,34,66,0.515,8,24,0.333,18,26,0.692,110,2016-02-19,SAC,DEN
1448,48,@,W 116-103 ,240,43,89,0.483,31,56,0.554,12,33,0.364,18,22,0.818,116,35,86,0.407,26,58,0.448,9,28,0.321,24,30,0.8,103,2016-02-24,OKC,DAL
1449,49,@,W 116-106 ,240,37,75,0.493,29,57,0.509,8,18,0.444,34,42,0.81,116,42,98,0.429,33,71,0.465,9,27,0.333,13,23,0.565,106,2016-02-25,BRK,PHO
1450,50,@,L 116-122 (OT),265,43,93,0.462,34,64,0.531,9,29,0.31,21,31,0.677,116,45,88,0.511,34,59,0.576,11,29,0.379,21,27,0.778,122,2016-02-26,DEN,DAL
1451,51,@,L 116-130 ,240,41,77,0.532,36,55,0.655,5,22,0.227,29,37,0.784,116,49,86,0.57,39,70,0.557,10,16,0.625,22,25,0.88,130,2016-02-28,PHI,ORL
1452,52,Home,L 116-131 ,240,48,107,0.449,41,82,0.5,7,25,0.28,13,19,0.684,116,47,82,0.573,33,48,0.688,14,34,0.412,23,26,0.885,131,2016-02-29,SAC,OKC
1453,53,Home,W 116-108 ,240,43,89,0.483,37,69,0.536,6,20,0.3,24,31,0.774,116,43,89,0.483,33,57,0.579,10,32,0.313,12,21,0.571,108,2016-02-29,WAS,PHI
1454,54,Home,W 116-93 ,240,43,107,0.402,36,81,0.444,7,26,0.269,23,24,0.958,116,34,84,0.405,23,55,0.418,11,29,0.379,14,20,0.7,93,2016-03-02,BOS,POR
1455,55,Home,W 116-101 ,240,43,83,0.518,29,59,0.492,14,24,0.583,16,20,0.8,116,42,87,0.483,35,65,0.538,7,22,0.318,10,14,0.714,101,2016-03-04,MIL,MIN
1456,56,Home,W 116-114 (OT),265,44,107,0.411,35,81,0.432,9,26,0.346,19,25,0.76,116,41,93,0.441,25,52,0.481,16,41,0.39,16,20,0.8,114,2016-03-06,DEN,DAL
1457,57,@,W 116-91 ,240,47,85,0.553,43,66,0.652,4,19,0.211,18,19,0.947,116,36,79,0.456,32,64,0.5,4,15,0.267,15,19,0.789,91,2016-03-08,SAS,MIN
1458,58,Home,W 116-109 (OT),265,41,89,0.461,31,65,0.477,10,24,0.417,24,31,0.774,116,45,99,0.455,37,79,0.468,8,20,0.4,11,23,0.478,109,2016-03-08,POR,WAS
1459,59,Home,W 116-96 ,240,41,87,0.471,26,55,0.473,15,32,0.469,19,24,0.792,116,32,84,0.381,25,58,0.431,7,26,0.269,25,31,0.806,96,2016-03-09,BOS,MEM
1460,60,Home,W 116-98 ,240,44,91,0.484,31,63,0.492,13,28,0.464,15,19,0.789,116,33,89,0.371,27,61,0.443,6,28,0.214,26,33,0.788,98,2016-03-10,DEN,PHO
1461,61,Home,W 116-100 ,240,42,80,0.525,34,56,0.607,8,24,0.333,24,29,0.828,116,36,86,0.419,29,65,0.446,7,21,0.333,21,29,0.724,100,2016-03-12,DEN,WAS
1462,62,@,L 116-123 ,240,45,92,0.489,34,63,0.54,11,29,0.379,15,20,0.75,116,42,84,0.5,31,51,0.608,11,33,0.333,28,33,0.848,123,2016-03-12,PHO,GSW
1463,63,Home,W 116-110 ,240,44,81,0.543,36,56,0.643,8,25,0.32,20,25,0.8,116,40,80,0.5,31,56,0.554,9,24,0.375,21,24,0.875,110,2016-03-15,ORL,DEN
1464,64,Home,W 116-98 ,240,40,80,0.5,28,54,0.519,12,26,0.462,24,28,0.857,116,39,87,0.448,33,65,0.508,6,22,0.273,14,17,0.824,98,2016-03-17,ATL,DEN
1465,65,Home,W 116-111 ,240,48,85,0.565,37,56,0.661,11,29,0.379,9,14,0.643,116,43,85,0.506,37,69,0.536,6,16,0.375,19,24,0.792,111,2016-03-18,HOU,MIN
1466,66,@,W 116-105 ,240,45,94,0.479,35,68,0.515,10,26,0.385,16,24,0.667,116,37,85,0.435,27,62,0.435,10,23,0.435,21,26,0.808,105,2016-03-25,DEN,LAL
1467,67,Home,W 116-94 ,240,40,90,0.444,33,68,0.485,7,22,0.318,29,39,0.744,116,35,94,0.372,26,62,0.419,9,32,0.281,15,23,0.652,94,2016-03-25,SAC,PHO
1468,68,@,L 116-121 ,240,41,84,0.488,26,51,0.51,15,33,0.455,19,23,0.826,116,41,81,0.506,34,55,0.618,7,26,0.269,32,40,0.8,121,2016-03-28,PHO,MIN
1469,69,Home,W 116-109 ,240,41,90,0.456,27,56,0.482,14,34,0.412,20,27,0.741,116,37,88,0.42,28,64,0.438,9,24,0.375,26,34,0.765,109,2016-03-31,POR,BOS
1470,70,Home,L 116-121 ,240,41,80,0.513,29,54,0.537,12,26,0.462,22,28,0.786,116,44,77,0.571,34,54,0.63,10,23,0.435,23,26,0.885,121,2016-04-11,NOP,CHI
1471,71,Home,W 116-81 ,240,47,97,0.485,37,62,0.597,10,35,0.286,12,19,0.632,116,32,96,0.333,21,59,0.356,11,37,0.297,6,13,0.462,81,2016-04-13,HOU,SAC
1472,72,Home,W 116-98 ,240,40,80,0.5,34,64,0.531,6,16,0.375,30,38,0.789,116,35,84,0.417,30,69,0.435,5,15,0.333,23,31,0.742,98,2016-10-31,LAC,PHO
1473,73,Home,W 116-80 ,240,43,78,0.551,31,58,0.534,12,20,0.6,18,23,0.783,116,27,75,0.36,23,51,0.451,4,24,0.167,22,29,0.759,80,2016-11-01,MIN,MEM
1474,74,Home,L 116-123 ,240,41,85,0.482,30,53,0.566,11,32,0.344,23,29,0.793,116,48,90,0.533,39,68,0.574,9,22,0.409,18,20,0.9,123,2016-11-02,ATL,LAL
1475,75,@,W 116-92 ,240,47,91,0.516,38,68,0.559,9,23,0.391,13,14,0.929,116,30,74,0.405,20,49,0.408,10,25,0.4,22,25,0.88,92,2016-11-05,LAC,SAS
1476,76,Home,W 116-106 ,240,45,90,0.5,29,55,0.527,16,35,0.457,10,12,0.833,116,39,80,0.488,32,59,0.542,7,21,0.333,21,27,0.778,106,2016-11-07,GSW,NOP
1477,77,Home,W 116-95 ,240,43,74,0.581,26,41,0.634,17,33,0.515,13,22,0.591,116,34,86,0.395,28,58,0.483,6,28,0.214,21,28,0.75,95,2016-11-09,GSW,DAL
1478,78,@,W 116-96 ,240,46,97,0.474,37,71,0.521,9,26,0.346,15,18,0.833,116,36,76,0.474,35,69,0.507,1,7,0.143,23,29,0.793,96,2016-11-18,PHO,IND
1479,79,@,W 116-107 ,240,44,78,0.564,34,54,0.63,10,24,0.417,18,19,0.947,116,39,87,0.448,27,62,0.435,12,25,0.48,17,21,0.81,107,2016-11-18,SAS,LAL
1480,80,@,L 116-121 (OT),265,40,97,0.412,25,54,0.463,15,43,0.349,21,28,0.75,116,43,98,0.439,29,62,0.468,14,36,0.389,21,25,0.84,121,2016-11-19,CHA,NOP
1481,81,Home,W 116-101 ,240,44,94,0.468,32,66,0.485,12,28,0.429,16,17,0.941,116,32,76,0.421,25,51,0.49,7,25,0.28,30,38,0.789,101,2016-11-23,SAC,OKC
1482,82,@,W 116-112 ,240,40,84,0.476,26,52,0.5,14,32,0.438,22,27,0.815,116,38,88,0.432,25,56,0.446,13,32,0.406,23,27,0.852,112,2016-12-05,CLE,TOR
1483,83,Home,L 116-124 ,240,44,93,0.473,33,70,0.471,11,23,0.478,17,24,0.708,116,43,83,0.518,31,57,0.544,12,26,0.462,26,36,0.722,124,2016-12-06,WAS,ORL
1484,84,Home,W 116-111 ,240,41,85,0.482,32,59,0.542,9,26,0.346,25,31,0.806,116,42,105,0.4,31,68,0.456,11,37,0.297,16,21,0.762,111,2016-12-07,BRK,DEN
1485,85,Home,W 116-105 ,240,42,73,0.575,29,42,0.69,13,31,0.419,19,28,0.679,116,39,86,0.453,29,59,0.492,10,27,0.37,17,24,0.708,105,2016-12-10,CLE,CHO
1486,86,@,W 116-108 ,240,38,83,0.458,25,51,0.49,13,32,0.406,27,30,0.9,116,36,81,0.444,27,57,0.474,9,24,0.375,27,36,0.75,108,2016-12-11,GSW,MIN
1487,87,Home,W 116-92 ,240,47,84,0.56,37,61,0.607,10,23,0.435,12,21,0.571,116,33,84,0.393,23,61,0.377,10,23,0.435,16,21,0.762,92,2016-12-12,SAC,LAL
1488,88,Home,W 116-104 ,240,42,91,0.462,34,73,0.466,8,18,0.444,24,31,0.774,116,36,91,0.396,26,56,0.464,10,35,0.286,22,28,0.786,104,2016-12-20,TOR,BRK
1489,89,@,L 116-123 ,240,42,83,0.506,29,52,0.558,13,31,0.419,19,22,0.864,116,42,79,0.532,30,53,0.566,12,26,0.462,27,37,0.73,123,2016-12-23,PHI,PHO
1490,90,@,L 116-140 ,240,45,96,0.469,32,63,0.508,13,33,0.394,13,16,0.813,116,45,81,0.556,31,41,0.756,14,40,0.35,36,43,0.837,140,2016-12-30,LAC,HOU
1491,91,Home,W 116-99 ,240,43,77,0.558,30,52,0.577,13,25,0.52,17,21,0.81,116,40,74,0.541,32,56,0.571,8,18,0.444,11,17,0.647,99,2016-12-30,MIN,MIL
1492,92,@,W 116-96 ,240,43,76,0.566,34,61,0.557,9,15,0.6,21,27,0.778,116,33,83,0.398,23,56,0.411,10,27,0.37,20,28,0.714,96,2016-12-31,MIL,CHI
1493,93,Home,L 116-121 ,240,48,97,0.495,38,68,0.559,10,29,0.345,10,12,0.833,116,43,74,0.581,34,58,0.586,9,16,0.563,26,30,0.867,121,2017-01-03,DET,IND
1494,94,Home,W 116-102 ,240,42,82,0.512,25,49,0.51,17,33,0.515,15,28,0.536,116,30,77,0.39,20,46,0.435,10,31,0.323,32,35,0.914,102,2017-01-03,LAL,MEM
1495,95,@,L 116-118 ,240,41,91,0.451,29,61,0.475,12,30,0.4,22,27,0.815,116,41,86,0.477,26,47,0.553,15,39,0.385,21,30,0.7,118,2017-01-05,OKC,HOU
1496,96,@,W 116-108 ,240,38,88,0.432,29,55,0.527,9,33,0.273,31,43,0.721,116,41,91,0.451,32,61,0.525,9,30,0.3,17,19,0.895,108,2017-01-06,CLE,BRK
1497,97,@,W 116-111 ,240,41,83,0.494,28,60,0.467,13,23,0.565,21,27,0.778,116,39,78,0.5,27,56,0.482,12,22,0.545,21,28,0.75,111,2017-01-06,NYK,MIL
1498,98,Home,L 116-120 ,240,46,87,0.529,37,60,0.617,9,27,0.333,15,19,0.789,116,44,82,0.537,29,48,0.604,15,34,0.441,17,19,0.895,120,2017-01-08,PHO,CLE
1499,99,Home,W 116-108 ,240,40,80,0.5,31,65,0.477,9,15,0.6,27,31,0.871,116,41,83,0.494,29,51,0.569,12,32,0.375,14,18,0.778,108,2017-01-13,MIL,MIA
1500,0,Home,W 116-101 ,240,44,89,0.494,36,67,0.537,8,22,0.364,20,23,0.87,116,35,84,0.417,23,55,0.418,12,29,0.414,19,27,0.704,101,2017-01-15,TOR,NYK
1501,1,@,W 116-112 (OT),265,43,95,0.453,32,64,0.5,11,31,0.355,19,22,0.864,116,40,82,0.488,25,44,0.568,15,38,0.395,17,34,0.5,112,2017-01-25,SAC,CLE
1502,2,@,L 116-124 ,240,43,87,0.494,27,54,0.5,16,33,0.485,14,16,0.875,116,49,92,0.533,36,56,0.643,13,36,0.361,13,20,0.65,124,2017-01-27,BRK,CLE
1503,3,Home,W 116-103 ,240,42,80,0.525,28,52,0.538,14,28,0.5,18,23,0.783,116,46,89,0.517,42,77,0.545,4,12,0.333,7,12,0.583,103,2017-01-28,MIA,DET
1504,4,@,L 116-120 ,240,41,99,0.414,26,72,0.361,15,27,0.556,19,23,0.826,116,47,89,0.528,35,63,0.556,12,26,0.462,14,18,0.778,120,2017-01-31,DEN,LAL
1505,5,Home,W 116-93 ,240,45,93,0.484,33,61,0.541,12,32,0.375,14,19,0.737,116,34,86,0.395,27,60,0.45,7,26,0.269,18,21,0.857,93,2017-02-01,MIA,ATL
1506,6,Home,W 116-108 ,240,44,96,0.458,32,63,0.508,12,33,0.364,16,21,0.762,116,40,87,0.46,28,48,0.583,12,39,0.308,16,22,0.727,108,2017-02-02,WAS,LAL
1507,7,Home,W 116-108 ,240,44,98,0.449,33,72,0.458,11,26,0.423,17,22,0.773,116,44,89,0.494,39,72,0.542,5,17,0.294,15,19,0.789,108,2017-02-03,DET,MIN
1508,8,@,W 116-100 ,240,35,73,0.479,18,42,0.429,17,31,0.548,29,37,0.784,116,35,73,0.479,25,51,0.49,10,22,0.455,20,24,0.833,100,2017-02-11,MIL,IND
1509,9,@,W 116-107 ,240,44,90,0.489,36,76,0.474,8,14,0.571,20,29,0.69,116,39,83,0.47,33,61,0.541,6,22,0.273,23,27,0.852,107,2017-02-13,ORL,MIA
1510,10,@,W 116-108 ,240,44,86,0.512,31,47,0.66,13,39,0.333,15,22,0.682,116,42,86,0.488,33,63,0.524,9,23,0.391,15,19,0.789,108,2017-02-14,CLE,MIN
1511,11,Home,W 116-108 ,240,38,80,0.475,25,52,0.481,13,28,0.464,27,36,0.75,116,44,93,0.473,36,62,0.581,8,31,0.258,12,18,0.667,108,2017-02-15,BOS,PHI
1512,12,Home,W 116-105 ,240,41,88,0.466,29,65,0.446,12,23,0.522,22,31,0.71,116,41,86,0.477,30,65,0.462,11,21,0.524,12,14,0.857,105,2017-02-15,OKC,NYK
1513,13,Home,W 116-100 ,240,46,88,0.523,39,74,0.527,7,14,0.5,17,19,0.895,116,39,88,0.443,27,53,0.509,12,35,0.343,10,14,0.714,100,2017-02-23,SAC,DEN
1514,14,@,L 116-130 ,240,45,86,0.523,31,56,0.554,14,30,0.467,12,17,0.706,116,49,86,0.57,33,61,0.541,16,25,0.64,16,22,0.727,130,2017-03-04,BRK,POR
1515,15,Home,W 116-102 ,240,39,73,0.534,30,53,0.566,9,20,0.45,29,47,0.617,116,34,83,0.41,24,48,0.5,10,35,0.286,24,29,0.828,102,2017-03-06,LAC,BOS
1516,16,@,W 115-93 ,240,39,79,0.494,29,52,0.558,10,27,0.37,27,34,0.794,115,32,76,0.421,24,49,0.49,8,27,0.296,21,27,0.778,93,2011-12-26,DEN,DAL
1517,17,Home,W 115-107 ,240,42,75,0.56,36,65,0.554,6,10,0.6,25,35,0.714,115,37,72,0.514,25,53,0.472,12,19,0.632,21,27,0.778,107,2011-12-27,MIA,BOS
1518,18,Home,W 115-90 ,240,45,80,0.563,35,61,0.574,10,19,0.526,15,15,1.0,115,29,74,0.392,22,54,0.407,7,20,0.35,25,33,0.758,90,2011-12-28,SAS,LAC
1519,19,Home,W 115-101 ,240,45,90,0.5,35,69,0.507,10,21,0.476,15,26,0.577,115,40,90,0.444,36,76,0.474,4,14,0.286,17,19,0.895,101,2012-01-03,CLE,CHA
1520,20,@,L 115-123 ,240,43,83,0.518,23,48,0.479,20,35,0.571,9,12,0.75,115,44,74,0.595,33,56,0.589,11,18,0.611,24,30,0.8,123,2012-01-11,BRK,DEN
1521,21,@,L 115-121 ,240,42,89,0.472,33,72,0.458,9,17,0.529,22,28,0.786,115,44,84,0.524,35,65,0.538,9,19,0.474,24,26,0.923,121,2012-02-14,SAC,CHI
1522,22,@,W 115-107 ,240,43,96,0.448,39,79,0.494,4,17,0.235,25,27,0.926,115,41,84,0.488,32,61,0.525,9,23,0.391,16,27,0.593,107,2012-02-22,SAC,WAS
1523,23,Home,W 115-107 ,240,44,82,0.537,38,65,0.585,6,17,0.353,21,26,0.808,115,45,103,0.437,36,78,0.462,9,25,0.36,8,9,0.889,107,2012-03-02,LAL,SAC
1524,24,Home,W 115-111 (OT),265,45,103,0.437,38,85,0.447,7,18,0.389,18,22,0.818,115,41,94,0.436,33,76,0.434,8,18,0.444,21,26,0.808,111,2012-03-04,BOS,NYK
1525,25,Home,W 115-104 ,240,40,91,0.44,32,65,0.492,8,26,0.308,27,32,0.844,115,38,84,0.452,35,65,0.538,3,19,0.158,25,34,0.735,104,2012-03-07,OKC,PHO
1526,26,@,W 115-89 ,240,46,91,0.505,34,67,0.507,12,24,0.5,11,15,0.733,115,33,82,0.402,26,63,0.413,7,19,0.368,16,21,0.762,89,2012-03-13,GSW,SAC
1527,27,Home,W 115-105 ,240,46,86,0.535,39,63,0.619,7,23,0.304,16,21,0.762,115,38,85,0.447,27,61,0.443,11,24,0.458,18,25,0.72,105,2012-03-14,MIL,CLE
1528,28,Home,W 115-100 ,240,41,81,0.506,30,56,0.536,11,25,0.44,22,28,0.786,115,32,81,0.395,24,62,0.387,8,19,0.421,28,34,0.824,100,2012-03-16,NYK,IND
1529,29,Home,W 115-99 ,240,44,96,0.458,36,68,0.529,8,28,0.286,19,21,0.905,115,38,92,0.413,32,67,0.478,6,25,0.24,17,17,1.0,99,2012-03-18,SAC,MIN
1530,30,@,L 115-116 ,240,40,79,0.506,26,61,0.426,14,18,0.778,21,30,0.7,115,46,79,0.582,37,62,0.597,9,17,0.529,15,22,0.682,116,2012-03-21,DET,DEN
1531,31,@,W 115-107 ,240,43,71,0.606,34,57,0.596,9,14,0.643,20,25,0.8,115,39,87,0.448,31,69,0.449,8,18,0.444,21,27,0.778,107,2012-04-10,BOS,MIA
1532,32,Home,W 115-89 ,240,43,90,0.478,38,78,0.487,5,12,0.417,24,32,0.75,115,35,90,0.389,26,65,0.4,9,25,0.36,10,14,0.714,89,2012-04-13,OKC,SAC
1533,33,@,W 115-110 ,240,40,91,0.44,33,66,0.5,7,25,0.28,28,32,0.875,115,42,84,0.5,38,73,0.521,4,11,0.364,22,34,0.647,110,2012-04-14,OKC,MIN
1534,34,@,W 115-86 ,240,44,69,0.638,40,59,0.678,4,10,0.4,23,30,0.767,115,32,79,0.405,24,59,0.407,8,20,0.4,14,27,0.519,86,2012-11-02,CHI,CLE
1535,35,Home,W 115-94 ,240,45,92,0.489,36,81,0.444,9,11,0.818,16,19,0.842,115,39,91,0.429,34,72,0.472,5,19,0.263,11,18,0.611,94,2012-11-04,ORL,PHO
1536,36,Home,W 115-107 (OT),265,40,92,0.435,25,65,0.385,15,27,0.556,20,28,0.714,115,39,92,0.424,33,82,0.402,6,10,0.6,23,27,0.852,107,2012-11-21,IND,NOH
1537,37,@,W 115-89 ,240,40,82,0.488,28,60,0.467,12,22,0.545,23,34,0.676,115,34,92,0.37,24,64,0.375,10,28,0.357,11,20,0.55,89,2012-11-24,LAL,DAL
1538,38,@,L 115-117 (2OT),290,47,92,0.511,39,69,0.565,8,23,0.348,13,17,0.765,115,43,100,0.43,37,78,0.474,6,22,0.273,25,30,0.833,117,2012-12-12,DAL,BOS
1539,39,@,W 115-93 ,240,49,99,0.495,39,75,0.52,10,24,0.417,7,8,0.875,115,31,84,0.369,26,58,0.448,5,26,0.192,26,36,0.722,93,2012-12-15,GSW,ATL
1540,40,Home,W 115-100 ,240,44,85,0.518,30,58,0.517,14,27,0.519,13,16,0.813,115,33,90,0.367,25,69,0.362,8,21,0.381,26,35,0.743,100,2012-12-21,GSW,CHA
1541,41,Home,L 115-118 (OT),265,46,103,0.447,36,74,0.486,10,29,0.345,13,15,0.867,115,49,107,0.458,40,80,0.5,9,27,0.333,11,14,0.786,118,2012-12-22,GSW,LAL
1542,42,Home,W 115-94 ,240,42,84,0.5,30,61,0.492,12,23,0.522,19,22,0.864,115,29,80,0.363,21,51,0.412,8,29,0.276,28,39,0.718,94,2013-01-02,GSW,LAC
1543,43,@,W 115-101 ,240,45,83,0.542,32,50,0.64,13,33,0.394,12,19,0.632,115,39,87,0.448,33,73,0.452,6,14,0.429,17,23,0.739,101,2013-01-04,HOU,MIL
1544,44,@,W 115-113 (2OT),290,41,89,0.461,33,65,0.508,8,24,0.333,25,36,0.694,115,43,91,0.473,34,73,0.466,9,18,0.5,18,31,0.581,113,2013-01-04,BRK,WAS
1545,45,Home,W 115-89 ,240,47,90,0.522,37,62,0.597,10,28,0.357,11,15,0.733,115,32,72,0.444,27,52,0.519,5,20,0.25,20,26,0.769,89,2013-01-05,LAC,GSW
1546,46,Home,W 115-111 (OT),265,47,99,0.475,38,74,0.514,9,25,0.36,12,19,0.632,115,42,88,0.477,34,61,0.557,8,27,0.296,19,23,0.826,111,2013-01-15,DEN,POR
1547,47,Home,W 115-110 ,240,43,90,0.478,34,72,0.472,9,18,0.5,20,23,0.87,115,41,83,0.494,34,62,0.548,7,21,0.333,21,26,0.808,110,2013-02-02,CLE,OKC
1548,48,Home,W 115-86 ,240,45,77,0.584,40,62,0.645,5,15,0.333,20,29,0.69,115,28,70,0.4,25,56,0.446,3,14,0.214,27,33,0.818,86,2013-02-02,MIN,NOH
1549,49,Home,W 115-101 ,240,39,78,0.5,29,57,0.509,10,21,0.476,27,33,0.818,115,39,83,0.47,34,66,0.515,5,17,0.294,18,24,0.75,101,2013-02-19,UTA,GSW
1550,50,@,W 115-86 ,240,43,83,0.518,32,64,0.5,11,19,0.579,18,23,0.783,115,32,82,0.39,27,67,0.403,5,15,0.333,17,19,0.895,86,2013-03-08,IND,ORL
1551,51,@,W 115-113 ,240,40,87,0.46,33,68,0.485,7,19,0.368,28,38,0.737,115,44,94,0.468,38,72,0.528,6,22,0.273,19,25,0.76,113,2013-03-10,MIL,SAC
1552,52,@,W 115-108 ,240,41,82,0.5,30,53,0.566,11,29,0.379,22,27,0.815,115,43,89,0.483,35,68,0.515,8,21,0.381,14,17,0.824,108,2013-03-12,DAL,MIL
1553,53,Home,W 115-109 ,240,40,90,0.444,28,63,0.444,12,27,0.444,23,26,0.885,115,47,93,0.505,42,72,0.583,5,21,0.238,10,15,0.667,109,2013-03-17,MIL,ORL
1554,54,@,L 115-120 (OT),265,47,100,0.47,37,73,0.507,10,27,0.37,11,18,0.611,115,42,100,0.42,34,75,0.453,8,25,0.32,28,34,0.824,120,2013-10-30,ORL,MIN
1555,55,@,L 115-126 ,240,40,76,0.526,28,55,0.509,12,21,0.571,23,33,0.697,115,42,85,0.494,33,57,0.579,9,28,0.321,33,50,0.66,126,2013-10-31,GSW,LAC
1556,56,Home,W 115-105 ,240,45,81,0.556,37,61,0.607,8,20,0.4,17,19,0.895,115,47,94,0.5,41,82,0.5,6,12,0.5,5,8,0.625,105,2013-11-02,POR,SAS
1557,57,Home,W 115-91 ,240,40,83,0.482,30,58,0.517,10,25,0.4,25,29,0.862,115,34,77,0.442,31,59,0.525,3,18,0.167,20,24,0.833,91,2013-11-09,TOR,UTA
1558,58,@,L 115-116 ,240,41,80,0.513,32,58,0.552,9,22,0.409,24,28,0.857,115,45,94,0.479,31,71,0.437,14,23,0.609,12,14,0.857,116,2013-11-14,OKC,GSW
1559,59,Home,W 115-113 ,240,38,93,0.409,25,66,0.379,13,27,0.481,26,32,0.813,115,40,83,0.482,32,60,0.533,8,23,0.348,25,43,0.581,113,2013-11-18,OKC,DEN
1560,60,Home,W 115-107 (OT),265,45,79,0.57,38,59,0.644,7,20,0.35,18,29,0.621,115,41,93,0.441,33,64,0.516,8,29,0.276,17,24,0.708,107,2013-11-22,PHI,MIL
1561,61,Home,W 115-100 ,240,41,89,0.461,31,61,0.508,10,28,0.357,23,39,0.59,115,38,88,0.432,31,65,0.477,7,23,0.304,17,19,0.895,100,2013-12-01,DET,PHI
1562,62,@,W 115-113 ,240,42,82,0.512,27,57,0.474,15,25,0.6,16,22,0.727,115,40,76,0.526,31,57,0.544,9,19,0.474,24,28,0.857,113,2013-12-01,GSW,SAC
1563,63,Home,W 115-111 ,240,43,94,0.457,37,82,0.451,6,12,0.5,23,29,0.793,115,41,90,0.456,30,53,0.566,11,37,0.297,18,22,0.818,111,2013-12-09,CHA,GSW
1564,64,Home,W 115-92 ,240,39,76,0.513,28,53,0.528,11,23,0.478,26,35,0.743,115,37,76,0.487,31,58,0.534,6,18,0.333,12,21,0.571,92,2013-12-16,LAC,SAS
1565,65,@,W 115-92 ,240,46,96,0.479,36,72,0.5,10,24,0.417,13,18,0.722,115,34,88,0.386,26,60,0.433,8,28,0.286,16,24,0.667,92,2013-12-23,DET,CLE
1566,66,Home,W 115-86 ,240,45,85,0.529,37,65,0.569,8,20,0.4,17,24,0.708,115,32,89,0.36,28,66,0.424,4,23,0.174,18,23,0.783,86,2013-12-27,GSW,PHO
1567,67,Home,W 115-101 ,240,44,95,0.463,35,62,0.565,9,33,0.273,18,23,0.783,115,37,95,0.389,26,66,0.394,11,29,0.379,16,22,0.727,101,2013-12-28,PHO,PHI
1568,68,Home,W 115-100 ,240,36,80,0.45,21,48,0.438,15,32,0.469,28,34,0.824,115,39,80,0.488,32,59,0.542,7,21,0.333,15,20,0.75,100,2013-12-28,TOR,NYK
1569,69,@,W 115-111 ,240,40,83,0.482,32,59,0.542,8,24,0.333,27,28,0.964,115,43,94,0.457,36,74,0.486,7,20,0.35,18,29,0.621,111,2014-01-04,OKC,MIN
1570,70,Home,L 115-137 ,240,42,89,0.472,39,68,0.574,3,21,0.143,28,36,0.778,115,53,99,0.535,41,70,0.586,12,29,0.414,19,24,0.792,137,2014-01-05,LAL,DEN
1571,71,Home,W 115-104 ,240,46,95,0.484,42,79,0.532,4,16,0.25,19,24,0.792,115,38,89,0.427,29,67,0.433,9,22,0.409,19,22,0.864,104,2014-01-25,POR,MIN
1572,72,Home,L 115-117 ,240,40,86,0.465,35,67,0.522,5,19,0.263,30,36,0.833,115,41,74,0.554,32,53,0.604,9,21,0.429,26,36,0.722,117,2014-01-29,DAL,HOU
1573,73,@,L 115-116 ,240,42,84,0.5,36,63,0.571,6,21,0.286,25,34,0.735,115,40,83,0.482,35,65,0.538,5,18,0.278,31,44,0.705,116,2014-02-03,LAC,DEN
1574,74,@,W 115-113 ,240,40,77,0.519,34,62,0.548,6,15,0.4,29,33,0.879,115,43,85,0.506,32,65,0.492,11,20,0.55,16,23,0.696,113,2014-02-07,CLE,WAS
1575,75,Home,W 115-107 ,240,47,87,0.54,39,67,0.582,8,20,0.4,13,29,0.448,115,40,88,0.455,27,57,0.474,13,31,0.419,14,20,0.7,107,2014-02-21,DET,ATL
1576,76,@,W 115-112 ,240,41,78,0.526,36,62,0.581,5,16,0.313,28,32,0.875,115,42,86,0.488,31,60,0.517,11,26,0.423,17,24,0.708,112,2014-02-23,HOU,PHO
1577,77,Home,W 115-106 ,240,42,80,0.525,32,64,0.5,10,16,0.625,21,28,0.75,115,43,86,0.5,35,61,0.574,8,25,0.32,12,14,0.857,106,2014-02-25,WAS,ORL
1578,78,Home,W 115-104 ,240,43,90,0.478,35,68,0.515,8,22,0.364,21,23,0.913,115,38,76,0.5,29,57,0.509,9,19,0.474,19,24,0.792,104,2014-02-26,BOS,ATL
1579,79,Home,W 115-110 ,240,37,79,0.468,26,55,0.473,11,24,0.458,30,36,0.833,115,46,87,0.529,37,67,0.552,9,20,0.45,9,9,1.0,110,2014-03-05,DEN,DAL
1580,80,@,W 115-98 ,240,34,74,0.459,27,56,0.482,7,18,0.389,40,50,0.8,115,33,84,0.393,25,61,0.41,8,23,0.348,24,28,0.857,98,2014-03-12,SAC,PHI
1581,81,Home,W 115-94 ,240,42,76,0.553,34,56,0.607,8,20,0.4,23,28,0.821,115,35,81,0.432,31,71,0.437,4,10,0.4,20,27,0.741,94,2014-03-15,NYK,MIL
1582,82,@,L 115-120 (OT),265,45,98,0.459,37,81,0.457,8,17,0.471,17,26,0.654,115,42,97,0.433,30,58,0.517,12,39,0.308,24,27,0.889,120,2014-03-18,MIL,POR
1583,83,Home,W 115-110 ,240,43,80,0.538,35,53,0.66,8,27,0.296,21,25,0.84,115,39,80,0.488,36,68,0.529,3,12,0.25,29,39,0.744,110,2014-03-20,GSW,MIL
1584,84,Home,W 115-99 ,240,44,83,0.53,39,65,0.6,5,18,0.278,22,24,0.917,115,35,91,0.385,27,55,0.491,8,36,0.222,21,28,0.75,99,2014-03-30,LAL,PHO
1585,85,Home,W 115-111 ,240,38,79,0.481,29,56,0.518,9,23,0.391,30,36,0.833,115,42,88,0.477,28,57,0.491,14,31,0.452,13,16,0.813,111,2014-04-05,DET,BOS
1586,86,@,L 115-122 ,240,40,84,0.476,31,52,0.596,9,32,0.281,26,32,0.813,115,45,77,0.584,34,54,0.63,11,23,0.478,21,31,0.677,122,2014-04-06,OKC,PHO
1587,87,Home,W 115-111 ,240,43,77,0.558,32,53,0.604,11,24,0.458,18,30,0.6,115,38,79,0.481,28,50,0.56,10,29,0.345,25,34,0.735,111,2014-04-09,ORL,BRK
1588,88,Home,L 115-118 ,240,43,91,0.473,31,61,0.508,12,30,0.4,17,25,0.68,115,40,78,0.513,28,54,0.519,12,24,0.5,26,34,0.765,118,2014-11-07,PHI,CHI
1589,89,Home,L 115-136 ,240,39,99,0.394,36,83,0.434,3,16,0.188,34,43,0.791,115,46,86,0.535,32,58,0.552,14,28,0.5,30,34,0.882,136,2014-11-16,LAL,GSW
1590,90,Home,W 115-99 ,240,44,89,0.494,33,67,0.493,11,22,0.5,16,22,0.727,115,34,69,0.493,25,53,0.472,9,16,0.563,22,28,0.786,99,2014-11-19,MIN,NYK
1591,91,Home,L 115-126 ,240,42,82,0.512,32,58,0.552,10,24,0.417,21,24,0.875,115,42,82,0.512,28,53,0.528,14,29,0.483,28,33,0.848,126,2014-11-26,ATL,TOR
1592,92,Home,W 115-106 ,240,44,88,0.5,39,73,0.534,5,15,0.333,22,28,0.786,115,43,88,0.489,31,64,0.484,12,24,0.5,8,11,0.727,106,2014-12-12,CHI,POR
1593,93,Home,L 115-120 (OT),265,40,82,0.488,29,54,0.537,11,28,0.393,24,34,0.706,115,45,93,0.484,34,67,0.507,11,26,0.423,19,27,0.704,120,2014-12-13,PHI,MEM
1594,94,@,W 115-111 (OT),265,35,85,0.412,27,57,0.474,8,28,0.286,37,48,0.771,115,40,99,0.404,27,69,0.391,13,30,0.433,18,23,0.783,111,2014-12-17,HOU,DEN
1595,95,Home,W 115-105 ,240,46,89,0.517,34,63,0.54,12,26,0.462,11,17,0.647,115,39,84,0.464,27,58,0.466,12,26,0.462,15,17,0.882,105,2014-12-23,LAL,GSW
1596,96,@,W 115-111 (OT),265,38,91,0.418,21,60,0.35,17,31,0.548,22,24,0.917,115,46,101,0.455,40,82,0.488,6,19,0.316,13,15,0.867,111,2014-12-23,POR,OKC
1597,97,@,L 115-124 ,240,41,88,0.466,32,63,0.508,9,25,0.36,24,29,0.828,115,44,97,0.454,31,64,0.484,13,33,0.394,23,32,0.719,124,2014-12-23,DAL,PHO
1598,98,@,W 115-106 ,240,46,94,0.489,32,61,0.525,14,33,0.424,9,12,0.75,115,41,93,0.441,34,73,0.466,7,20,0.35,17,24,0.708,106,2014-12-26,PHO,SAC
1599,99,Home,W 115-79 ,240,41,83,0.494,28,52,0.538,13,31,0.419,20,28,0.714,115,30,68,0.441,26,51,0.51,4,17,0.235,15,25,0.6,79,2015-01-03,HOU,MIA
1600,0,@,W 115-107 ,240,43,84,0.512,37,67,0.552,6,17,0.353,23,31,0.742,115,42,93,0.452,29,60,0.483,13,33,0.394,10,12,0.833,107,2015-01-03,ATL,POR
1601,1,@,L 115-127 ,240,42,92,0.457,33,68,0.485,9,24,0.375,22,28,0.786,115,51,97,0.526,41,75,0.547,10,22,0.455,15,19,0.789,127,2015-01-16,GSW,OKC
1602,2,Home,W 115-100 ,240,43,86,0.5,30,54,0.556,13,32,0.406,16,22,0.727,115,34,75,0.453,26,58,0.448,8,17,0.471,24,35,0.686,100,2015-01-19,PHO,LAL
1603,3,Home,L 115-117 (OT),265,41,101,0.406,29,72,0.403,12,29,0.414,21,28,0.75,115,48,90,0.533,44,76,0.579,4,14,0.286,17,23,0.739,117,2015-01-25,DEN,WAS
1604,4,@,W 115-100 ,240,45,87,0.517,33,62,0.532,12,25,0.48,13,18,0.722,115,37,82,0.451,32,64,0.5,5,18,0.278,21,30,0.7,100,2015-01-29,MIL,ORL
1605,5,Home,W 115-100 ,240,43,86,0.5,34,63,0.54,9,23,0.391,20,23,0.87,115,40,89,0.449,33,67,0.493,7,22,0.318,13,17,0.765,100,2015-02-02,NOP,ATL
1606,6,@,W 115-98 ,240,41,92,0.446,32,65,0.492,9,27,0.333,24,29,0.828,115,33,81,0.407,23,47,0.489,10,34,0.294,22,30,0.733,98,2015-02-09,LAC,DAL
1607,7,@,L 115-119 ,240,43,84,0.512,33,56,0.589,10,28,0.357,19,23,0.826,115,42,77,0.545,34,58,0.586,8,19,0.421,27,52,0.519,119,2015-02-19,SAS,LAC
1608,8,@,W 115-110 ,240,39,89,0.438,25,60,0.417,14,29,0.483,23,30,0.767,115,44,97,0.454,35,65,0.538,9,32,0.281,13,16,0.813,110,2015-02-23,BOS,PHO
1609,9,Home,W 115-94 ,240,42,83,0.506,28,52,0.538,14,31,0.452,17,20,0.85,115,34,82,0.415,32,61,0.525,2,21,0.095,24,31,0.774,94,2015-02-25,BOS,NYK
1610,10,Home,L 115-121 (2OT),290,39,97,0.402,31,66,0.47,8,31,0.258,29,40,0.725,115,45,109,0.413,39,91,0.429,6,18,0.333,25,26,0.962,121,2015-02-27,DET,NYK
1611,11,Home,W 115-112 ,240,39,89,0.438,29,63,0.46,10,26,0.385,27,31,0.871,115,45,94,0.479,41,80,0.513,4,14,0.286,18,22,0.818,112,2015-02-27,POR,OKC
1612,12,Home,W 115-98 ,240,43,82,0.524,36,68,0.529,7,14,0.5,22,30,0.733,115,33,78,0.423,26,47,0.553,7,31,0.226,25,38,0.658,98,2015-03-02,MIA,PHO
1613,13,@,W 115-91 ,240,42,85,0.494,34,66,0.515,8,19,0.421,23,28,0.821,115,35,88,0.398,32,72,0.444,3,16,0.188,18,24,0.75,91,2015-03-04,CHA,BRK
1614,14,Home,W 115-102 ,240,42,84,0.5,29,53,0.547,13,31,0.419,18,20,0.9,115,34,81,0.42,25,54,0.463,9,27,0.333,25,27,0.926,102,2015-03-11,DEN,ATL
1615,15,@,L 115-119 ,240,40,90,0.444,33,64,0.516,7,26,0.269,28,35,0.8,115,42,89,0.472,32,64,0.5,10,25,0.4,25,35,0.714,119,2015-03-16,OKC,DAL
1616,16,@,L 115-123 ,240,41,82,0.5,28,53,0.528,13,29,0.448,20,25,0.8,115,43,84,0.512,30,54,0.556,13,30,0.433,24,26,0.923,123,2015-03-20,ATL,OKC
1617,17,Home,W 115-100 ,240,42,80,0.525,30,54,0.556,12,26,0.462,19,22,0.864,115,37,86,0.43,22,56,0.393,15,30,0.5,11,14,0.786,100,2015-03-28,CHA,ATL
1618,18,Home,W 115-111 ,240,41,89,0.461,23,49,0.469,18,40,0.45,15,25,0.6,115,48,96,0.5,41,82,0.5,7,14,0.5,8,16,0.5,111,2015-04-01,HOU,SAC
1619,19,@,W 115-112 ,240,38,81,0.469,30,53,0.566,8,28,0.286,31,50,0.62,115,40,92,0.435,26,62,0.419,14,30,0.467,18,26,0.692,112,2015-04-05,HOU,OKC
1620,20,@,W 115-100 ,240,42,78,0.538,28,50,0.56,14,28,0.5,17,20,0.85,115,39,93,0.419,39,84,0.464,0,9,0.0,22,28,0.786,100,2015-10-28,CHI,BRK
1621,21,Home,W 115-96 ,240,44,87,0.506,29,57,0.509,15,30,0.5,12,20,0.6,115,37,77,0.481,30,57,0.526,7,20,0.35,15,21,0.714,96,2015-11-05,POR,MEM
1622,22,Home,L 115-121 ,240,42,84,0.5,32,54,0.593,10,30,0.333,21,24,0.875,115,41,77,0.532,32,56,0.571,9,21,0.429,30,35,0.857,121,2015-11-06,NOP,ATL
1623,23,Home,W 115-110 ,240,43,80,0.538,32,51,0.627,11,29,0.379,18,27,0.667,115,37,79,0.468,31,61,0.508,6,18,0.333,30,39,0.769,110,2015-11-17,GSW,TOR
1624,24,@,W 115-98 ,240,45,85,0.529,30,55,0.545,15,30,0.5,10,13,0.769,115,41,83,0.494,34,60,0.567,7,23,0.304,9,11,0.818,98,2015-11-17,DEN,NOP
1625,25,Home,W 115-86 ,240,37,70,0.529,25,48,0.521,12,22,0.545,29,41,0.707,115,31,72,0.431,21,51,0.412,10,21,0.476,14,24,0.583,86,2015-11-17,WAS,MIL
1626,26,Home,W 115-100 ,240,40,71,0.563,29,47,0.617,11,24,0.458,24,30,0.8,115,38,73,0.521,35,65,0.538,3,8,0.375,21,26,0.808,100,2015-11-19,CLE,MIL
1627,27,@,W 115-112 (OT),265,43,94,0.457,34,65,0.523,9,29,0.31,20,24,0.833,115,41,100,0.41,26,60,0.433,15,40,0.375,15,17,0.882,112,2015-12-01,DAL,POR
1628,28,Home,W 115-96 ,240,43,85,0.506,35,63,0.556,8,22,0.364,21,26,0.808,115,38,92,0.413,27,61,0.443,11,31,0.355,9,13,0.692,96,2015-12-14,CHI,PHI
1629,29,Home,W 115-107 ,240,43,87,0.494,33,68,0.485,10,19,0.526,19,24,0.792,115,36,72,0.5,26,48,0.542,10,24,0.417,25,40,0.625,107,2015-12-18,SAS,LAC
1630,30,Home,W 115-89 ,240,41,85,0.482,28,54,0.519,13,31,0.419,20,23,0.87,115,33,95,0.347,26,67,0.388,7,28,0.25,16,24,0.667,89,2015-12-23,NOP,POR
1631,31,Home,L 115-121 ,240,39,72,0.542,28,52,0.538,11,20,0.55,26,39,0.667,115,43,99,0.434,29,58,0.5,14,41,0.341,21,25,0.84,121,2015-12-29,HOU,ATL
1632,32,Home,W 115-90 ,240,41,86,0.477,27,51,0.529,14,35,0.4,19,28,0.679,115,35,86,0.407,30,72,0.417,5,14,0.357,15,19,0.789,90,2015-12-31,DET,MIN
1633,33,@,W 115-113 ,240,42,82,0.512,33,61,0.541,9,21,0.429,22,25,0.88,115,42,92,0.457,29,61,0.475,13,31,0.419,16,19,0.842,113,2016-01-03,CHI,TOR
1634,34,Home,W 115-89 ,240,43,88,0.489,29,58,0.5,14,30,0.467,15,21,0.714,115,36,81,0.444,30,61,0.492,6,20,0.3,11,11,1.0,89,2016-01-04,DET,ORL
1635,35,Home,L 115-121 ,240,42,76,0.553,28,52,0.538,14,24,0.583,17,27,0.63,115,48,89,0.539,36,60,0.6,12,29,0.414,13,19,0.684,121,2016-01-06,WAS,CLE
1636,36,@,L 115-118 ,240,41,76,0.539,33,52,0.635,8,24,0.333,25,29,0.862,115,47,85,0.553,41,64,0.641,6,21,0.286,18,27,0.667,118,2016-01-07,LAL,SAC
1637,37,Home,W 115-110 ,240,42,100,0.42,23,56,0.411,19,44,0.432,12,14,0.857,115,37,76,0.487,27,55,0.491,10,21,0.476,26,36,0.722,110,2016-01-10,POR,OKC
1638,38,@,W 115-111 (OT),265,41,88,0.466,34,71,0.479,7,17,0.412,26,31,0.839,115,42,93,0.452,30,66,0.455,12,27,0.444,15,20,0.75,111,2016-01-14,CHI,PHI
1639,39,Home,W 115-109 ,240,46,83,0.554,35,54,0.648,11,29,0.379,12,17,0.706,115,43,85,0.506,31,59,0.525,12,26,0.462,11,15,0.733,109,2016-01-20,TOR,BOS
1640,40,Home,W 115-102 ,240,42,83,0.506,29,55,0.527,13,28,0.464,18,24,0.75,115,36,80,0.45,30,55,0.545,6,25,0.24,24,36,0.667,102,2016-01-21,CLE,LAC
1641,41,Home,W 115-99 ,240,46,86,0.535,41,74,0.554,5,12,0.417,18,18,1.0,115,38,91,0.418,31,61,0.508,7,30,0.233,16,20,0.8,99,2016-01-21,NOP,DET
1642,42,Home,W 115-104 ,240,43,89,0.483,28,45,0.622,15,44,0.341,14,21,0.667,115,36,79,0.456,21,49,0.429,15,30,0.5,17,22,0.773,104,2016-01-24,HOU,DAL
1643,43,Home,W 115-93 ,240,45,81,0.556,34,53,0.642,11,28,0.393,14,16,0.875,115,33,70,0.471,25,50,0.5,8,20,0.4,19,25,0.76,93,2016-01-27,CLE,PHO
1644,44,Home,W 115-102 ,240,44,84,0.524,28,49,0.571,16,35,0.457,11,16,0.688,115,38,85,0.447,32,68,0.471,6,17,0.353,20,27,0.741,102,2016-02-02,HOU,MIA
1645,45,@,L 115-119 ,240,46,80,0.575,42,63,0.667,4,17,0.235,19,25,0.76,115,40,80,0.5,28,54,0.519,12,26,0.462,27,35,0.771,119,2016-02-02,MIN,LAL
1646,46,Home,W 115-110 ,240,39,87,0.448,33,69,0.478,6,18,0.333,31,44,0.705,115,43,93,0.462,38,81,0.469,5,12,0.417,19,27,0.704,110,2016-02-05,DEN,CHI
1647,47,@,W 115-111 ,240,44,88,0.5,36,68,0.529,8,20,0.4,19,28,0.679,115,41,87,0.471,25,51,0.49,16,36,0.444,13,13,1.0,111,2016-02-19,MIA,ATL
1648,48,@,W 115-112 ,240,42,82,0.512,31,51,0.608,11,31,0.355,20,26,0.769,115,42,94,0.447,29,58,0.5,13,36,0.361,15,18,0.833,112,2016-02-20,GSW,LAC
1649,49,@,L 115-126 ,240,43,93,0.462,36,72,0.5,7,21,0.333,22,33,0.667,115,44,79,0.557,31,60,0.517,13,19,0.684,25,26,0.962,126,2016-02-21,LAL,CHI
1650,50,@,W 115-92 ,240,41,80,0.513,31,57,0.544,10,23,0.435,23,27,0.852,115,37,90,0.411,32,69,0.464,5,21,0.238,13,19,0.684,92,2016-02-21,CLE,OKC
1651,51,Home,W 115-111 ,240,39,90,0.433,27,58,0.466,12,32,0.375,25,38,0.658,115,43,86,0.5,35,70,0.5,8,16,0.5,17,23,0.739,111,2016-02-21,POR,UTA
1652,52,Home,L 115-124 ,240,43,79,0.544,33,58,0.569,10,21,0.476,19,26,0.731,115,41,85,0.482,34,71,0.479,7,14,0.5,35,41,0.854,124,2016-02-23,PHI,ORL
1653,53,@,L 115-117 ,240,39,83,0.47,28,56,0.5,11,27,0.407,26,35,0.743,115,34,67,0.507,28,55,0.509,6,12,0.5,43,54,0.796,117,2016-03-04,POR,TOR
1654,54,Home,W 115-112 ,240,45,94,0.479,38,69,0.551,7,25,0.28,18,26,0.692,115,41,83,0.494,34,58,0.586,7,25,0.28,23,27,0.852,112,2016-03-07,NOP,SAC
1655,55,Home,W 115-94 ,240,48,84,0.571,35,54,0.648,13,30,0.433,6,10,0.6,115,32,79,0.405,24,59,0.407,8,20,0.4,22,31,0.71,94,2016-03-09,GSW,UTA
1656,56,Home,W 115-108 ,240,44,92,0.478,32,66,0.485,12,26,0.462,15,18,0.833,115,40,79,0.506,36,64,0.563,4,15,0.267,24,29,0.828,108,2016-03-18,DET,SAC
1657,57,Home,W 115-103 ,240,46,94,0.489,36,70,0.514,10,24,0.417,13,21,0.619,115,42,80,0.525,37,66,0.561,5,14,0.357,14,21,0.667,103,2016-03-19,DET,BRK
1658,58,@,W 115-111 ,240,42,80,0.525,32,52,0.615,10,28,0.357,21,26,0.808,115,40,83,0.482,31,61,0.508,9,22,0.409,22,30,0.733,111,2016-03-19,OKC,IND
1659,59,@,W 115-107 ,240,45,87,0.517,31,62,0.5,14,25,0.56,11,15,0.733,115,38,82,0.463,23,50,0.46,15,32,0.469,16,21,0.762,107,2016-03-23,NYK,CHI
1660,60,@,W 115-91 ,240,41,74,0.554,25,45,0.556,16,29,0.552,17,21,0.81,115,37,84,0.44,33,69,0.478,4,15,0.267,13,15,0.867,91,2016-03-26,CHA,MIL
1661,61,@,W 115-91 ,240,39,73,0.534,27,44,0.614,12,29,0.414,25,28,0.893,115,37,85,0.435,33,70,0.471,4,15,0.267,13,20,0.65,91,2016-03-26,TOR,NOP
1662,62,@,W 115-106 ,240,41,88,0.466,33,67,0.493,8,21,0.381,25,31,0.806,115,40,92,0.435,31,63,0.492,9,29,0.31,17,24,0.708,106,2016-04-02,SAC,DEN
1663,63,@,W 115-102 ,240,44,84,0.524,36,61,0.59,8,23,0.348,19,23,0.826,115,34,83,0.41,18,46,0.391,16,37,0.432,18,26,0.692,102,2016-04-02,IND,PHI
1664,64,@,W 115-107 ,240,40,93,0.43,28,62,0.452,12,31,0.387,23,27,0.852,115,41,78,0.526,30,56,0.536,11,22,0.5,14,21,0.667,107,2016-04-05,POR,SAC
1665,65,@,L 115-120 ,240,43,91,0.473,34,69,0.493,9,22,0.409,20,31,0.645,115,43,84,0.512,28,51,0.549,15,33,0.455,19,24,0.792,120,2016-04-06,OKC,POR
1666,66,Home,L 115-124 ,240,42,74,0.568,28,41,0.683,14,33,0.424,17,28,0.607,115,44,94,0.468,32,63,0.508,12,31,0.387,24,29,0.828,124,2016-04-07,HOU,PHO
1667,67,Home,W 115-105 ,240,39,83,0.47,24,59,0.407,15,24,0.625,22,27,0.815,115,37,81,0.457,20,46,0.435,17,35,0.486,14,18,0.778,105,2016-04-13,CHI,PHI
1668,68,@,W 115-113 (OT),265,45,98,0.459,35,66,0.53,10,32,0.313,15,21,0.714,115,38,100,0.38,32,77,0.416,6,23,0.261,31,39,0.795,113,2016-10-29,POR,DEN
1669,69,Home,W 115-108 ,240,41,87,0.471,31,59,0.525,10,28,0.357,23,29,0.793,115,40,89,0.449,34,61,0.557,6,28,0.214,22,25,0.88,108,2016-11-01,IND,LAL
1670,70,@,L 115-118 (OT),265,42,101,0.416,30,68,0.441,12,33,0.364,19,21,0.905,115,44,103,0.427,39,87,0.448,5,16,0.313,25,30,0.833,118,2016-11-02,POR,PHO
1671,71,Home,W 115-107 ,240,42,83,0.506,33,63,0.524,9,20,0.45,22,27,0.815,115,41,91,0.451,32,64,0.5,9,27,0.333,16,21,0.762,107,2016-11-09,ATL,CHI
1672,72,@,L 115-122 (OT),265,46,95,0.484,32,59,0.542,14,36,0.389,9,19,0.474,115,49,90,0.544,40,71,0.563,9,19,0.474,15,20,0.75,122,2016-11-09,PHI,IND
1673,73,Home,W 115-87 ,240,35,90,0.389,24,63,0.381,11,27,0.407,34,43,0.791,115,33,94,0.351,27,71,0.38,6,23,0.261,15,17,0.882,87,2016-11-11,BOS,NYK
1674,74,Home,W 115-88 ,240,44,91,0.484,27,51,0.529,17,40,0.425,10,17,0.588,115,34,90,0.378,29,68,0.426,5,22,0.227,15,17,0.882,88,2016-11-14,HOU,PHI
1675,75,@,W 115-108 ,240,43,80,0.538,32,56,0.571,11,24,0.458,18,22,0.818,115,38,89,0.427,23,54,0.426,15,35,0.429,17,21,0.81,108,2016-11-15,CHA,MIN
1676,76,Home,L 115-121 ,240,38,86,0.442,28,60,0.467,10,26,0.385,29,35,0.829,115,40,76,0.526,27,47,0.574,13,29,0.448,28,34,0.824,121,2016-11-18,SAC,LAC
1677,77,@,W 115-111 (OT),265,40,89,0.449,29,67,0.433,11,22,0.5,24,31,0.774,115,44,101,0.436,34,65,0.523,10,36,0.278,13,18,0.722,111,2016-11-20,IND,OKC
1678,78,@,L 115-123 ,240,40,80,0.5,32,61,0.525,8,19,0.421,27,32,0.844,115,39,74,0.527,29,49,0.592,10,25,0.4,35,42,0.833,123,2016-11-21,TOR,LAC
1679,79,@,W 115-102 ,240,43,88,0.489,31,65,0.477,12,23,0.522,17,21,0.81,115,38,78,0.487,24,36,0.667,14,42,0.333,12,12,1.0,102,2016-11-23,TOR,HOU
1680,80,Home,W 115-102 ,240,45,81,0.556,34,59,0.576,11,22,0.5,14,17,0.824,115,41,89,0.461,31,54,0.574,10,35,0.286,10,12,0.833,102,2016-11-26,GSW,MIN
1681,81,@,L 115-126 (OT),265,44,98,0.449,34,70,0.486,10,28,0.357,17,26,0.654,115,46,95,0.484,34,65,0.523,12,30,0.4,22,31,0.71,126,2016-11-30,WAS,OKC
1682,82,@,W 115-98 ,240,42,89,0.472,35,58,0.603,7,31,0.226,24,29,0.828,115,36,92,0.391,28,66,0.424,8,26,0.308,18,24,0.75,98,2016-12-07,GSW,LAC
1683,83,Home,W 115-107 ,240,40,77,0.519,30,53,0.566,10,24,0.417,25,37,0.676,115,37,85,0.435,20,45,0.444,17,40,0.425,16,19,0.842,107,2016-12-07,MIL,POR
1684,84,Home,L 115-119 ,240,40,87,0.46,31,61,0.508,9,26,0.346,26,34,0.765,115,45,95,0.474,32,65,0.492,13,30,0.433,16,21,0.762,119,2016-12-09,LAL,PHO
1685,85,Home,W 115-108 ,240,42,86,0.488,35,67,0.522,7,19,0.368,24,25,0.96,115,37,82,0.451,28,61,0.459,9,21,0.429,25,35,0.714,108,2016-12-19,MIN,PHO
1686,86,Home,W 115-107 ,240,45,84,0.536,34,62,0.548,11,22,0.5,14,21,0.667,115,40,90,0.444,26,52,0.5,14,38,0.368,13,15,0.867,107,2016-12-22,MIA,LAL
1687,87,Home,W 115-109 ,240,41,81,0.506,28,56,0.5,13,25,0.52,20,25,0.8,115,38,89,0.427,18,37,0.486,20,52,0.385,13,15,0.867,109,2016-12-23,MEM,HOU
1688,88,@,L 115-131 ,240,43,101,0.426,36,71,0.507,7,30,0.233,22,27,0.815,115,46,92,0.5,31,49,0.633,15,43,0.349,24,30,0.8,131,2016-12-26,PHO,HOU
1689,89,@,W 115-103 ,240,45,91,0.495,30,60,0.5,15,31,0.484,10,14,0.714,115,39,83,0.47,31,62,0.5,8,21,0.381,17,24,0.708,103,2017-01-02,ORL,NYK
1690,90,Home,W 115-104 ,240,41,74,0.554,24,43,0.558,17,31,0.548,16,17,0.941,115,38,82,0.463,27,56,0.482,11,26,0.423,17,21,0.81,104,2017-01-03,BOS,UTA
1691,91,Home,W 115-106 ,240,37,73,0.507,28,50,0.56,9,23,0.391,32,45,0.711,115,38,88,0.432,27,60,0.45,11,28,0.393,19,25,0.76,106,2017-01-04,LAC,MEM
1692,92,Home,W 115-114 ,240,39,97,0.402,29,69,0.42,10,28,0.357,27,32,0.844,115,37,91,0.407,27,65,0.415,10,26,0.385,30,34,0.882,114,2017-01-05,DET,CHO
1693,93,@,W 115-109 ,240,41,83,0.494,31,65,0.477,10,18,0.556,23,26,0.885,115,39,97,0.402,29,63,0.46,10,34,0.294,21,25,0.84,109,2017-01-13,ORL,POR
1694,94,Home,L 115-118 (OT),265,45,91,0.495,32,57,0.561,13,34,0.382,12,22,0.545,115,48,96,0.5,38,70,0.543,10,26,0.385,12,14,0.857,118,2017-01-21,CLE,SAS
1695,95,@,W 115-103 ,240,40,79,0.506,31,57,0.544,9,22,0.409,26,28,0.929,115,33,83,0.398,26,56,0.464,7,27,0.259,30,35,0.857,103,2017-01-22,PHO,TOR
1696,96,@,W 115-105 ,240,42,84,0.5,28,60,0.467,14,24,0.583,17,22,0.773,115,37,88,0.42,28,59,0.475,9,29,0.31,22,26,0.846,105,2017-01-23,LAC,ATL
1697,97,Home,W 115-111 (OT),265,38,78,0.487,28,50,0.56,10,28,0.357,29,33,0.879,115,35,71,0.493,22,45,0.489,13,26,0.5,28,36,0.778,111,2017-01-27,IND,SAC
1698,98,@,W 115-96 ,240,39,80,0.488,23,52,0.442,16,28,0.571,21,24,0.875,115,31,74,0.419,26,55,0.473,5,19,0.263,29,39,0.744,96,2017-01-30,MEM,PHO
1699,99,Home,W 115-98 ,240,42,93,0.452,31,62,0.5,11,31,0.355,20,23,0.87,115,33,83,0.398,22,52,0.423,11,31,0.355,21,25,0.84,98,2017-01-31,POR,CHO
1700,0,@,W 115-113 ,240,45,86,0.523,30,58,0.517,15,28,0.536,10,14,0.714,115,43,80,0.538,38,69,0.551,5,11,0.455,22,28,0.786,113,2017-02-06,MIA,MIN
1701,1,Home,L 115-119 ,240,46,92,0.5,38,65,0.585,8,27,0.296,15,18,0.833,115,45,92,0.489,35,67,0.522,10,25,0.4,19,28,0.679,119,2017-02-08,NYK,LAC
1702,2,Home,W 115-97 ,240,48,95,0.505,40,76,0.526,8,19,0.421,11,13,0.846,115,37,86,0.43,32,67,0.478,5,19,0.263,18,22,0.818,97,2017-02-10,PHO,CHI
1703,3,@,W 115-95 ,240,43,84,0.512,33,51,0.647,10,33,0.303,19,25,0.76,115,37,87,0.425,31,63,0.492,6,24,0.25,15,20,0.75,95,2017-03-03,BOS,LAL
1704,4,Home,W 115-114 ,240,39,81,0.481,25,55,0.455,14,26,0.538,23,25,0.92,115,44,89,0.494,30,54,0.556,14,35,0.4,12,19,0.632,114,2017-03-05,WAS,ORL
1705,5,@,W 115-108 ,240,41,76,0.539,29,45,0.644,12,31,0.387,21,24,0.875,115,35,79,0.443,27,47,0.574,8,32,0.25,30,40,0.75,108,2017-03-08,UTA,HOU
1706,6,Home,W 115-98 ,240,44,88,0.5,33,65,0.508,11,23,0.478,16,19,0.842,115,39,89,0.438,32,63,0.508,7,26,0.269,13,22,0.591,98,2017-03-08,IND,DET
1707,7,@,W 114-101 ,240,39,78,0.5,32,61,0.525,7,17,0.412,29,34,0.853,114,41,80,0.513,34,65,0.523,7,15,0.467,12,20,0.6,101,2011-12-30,CHI,LAC
1708,8,@,W 114-92 ,240,40,89,0.449,30,61,0.492,10,28,0.357,24,27,0.889,114,30,86,0.349,24,64,0.375,6,22,0.273,26,41,0.634,92,2011-12-31,NYK,SAC
1709,9,@,W 114-106 ,240,42,87,0.483,37,71,0.521,5,16,0.313,25,26,0.962,114,39,80,0.488,36,69,0.522,3,11,0.273,25,32,0.781,106,2012-01-16,HOU,WAS
1710,10,@,W 114-75 ,240,46,83,0.554,40,74,0.541,6,9,0.667,16,17,0.941,114,27,89,0.303,20,75,0.267,7,14,0.5,14,19,0.737,75,2012-01-20,CHI,CLE
1711,11,Home,L 114-119 (2OT),290,44,97,0.454,33,64,0.516,11,33,0.333,15,21,0.714,114,41,98,0.418,35,74,0.473,6,24,0.25,31,43,0.721,119,2012-01-21,NYK,DEN
1712,12,Home,W 114-106 (OT),265,43,98,0.439,33,76,0.434,10,22,0.455,18,21,0.857,114,39,90,0.433,23,61,0.377,16,29,0.552,12,13,0.923,106,2012-02-04,SAC,GSW
1713,13,@,W 114-96 ,240,43,83,0.518,36,69,0.522,7,14,0.5,21,25,0.84,114,33,84,0.393,24,61,0.393,9,23,0.391,21,25,0.84,96,2012-02-13,MIA,MIL
1714,14,Home,W 114-108 ,240,43,93,0.462,37,81,0.457,6,12,0.5,22,25,0.88,114,43,86,0.5,39,75,0.52,4,11,0.364,18,22,0.818,108,2012-02-17,DET,SAC
1715,15,Home,W 114-100 ,240,47,89,0.528,42,74,0.568,5,15,0.333,15,19,0.789,114,38,84,0.452,36,73,0.493,2,11,0.182,22,26,0.846,100,2012-02-17,UTA,WAS
1716,16,@,W 114-99 ,240,41,86,0.477,28,59,0.475,13,27,0.481,19,23,0.826,114,37,83,0.446,30,64,0.469,7,19,0.368,18,21,0.857,99,2012-02-23,SAS,DEN
1717,17,Home,W 114-98 ,240,42,81,0.519,28,54,0.519,14,27,0.519,16,27,0.593,114,37,79,0.468,31,63,0.492,6,16,0.375,18,27,0.667,98,2012-03-03,ORL,MIL
1718,18,@,L 114-119 ,240,46,83,0.554,39,66,0.591,7,17,0.412,15,21,0.714,114,45,93,0.484,32,67,0.478,13,26,0.5,16,21,0.762,119,2012-03-09,NYK,MIL
1719,19,@,W 114-110 (OT),265,39,81,0.481,32,66,0.485,7,15,0.467,29,38,0.763,114,37,82,0.451,32,66,0.485,5,16,0.313,31,51,0.608,110,2012-03-16,TOR,MEM
1720,20,@,W 114-105 ,240,45,87,0.517,36,68,0.529,9,19,0.474,15,25,0.6,114,39,88,0.443,30,63,0.476,9,25,0.36,18,20,0.9,105,2012-03-16,SAS,OKC
1721,21,Home,W 114-91 ,240,42,78,0.538,33,56,0.589,9,22,0.409,21,22,0.955,114,29,79,0.367,17,53,0.321,12,26,0.462,21,27,0.778,91,2012-03-21,OKC,LAC
1722,22,Home,W 114-104 ,240,35,69,0.507,29,47,0.617,6,22,0.273,38,43,0.884,114,41,93,0.441,35,77,0.455,6,16,0.375,16,26,0.615,104,2012-04-08,SAS,UTA
1723,23,@,W 114-90 ,240,47,82,0.573,40,62,0.645,7,20,0.35,13,16,0.813,114,32,83,0.386,26,61,0.426,6,22,0.273,20,23,0.87,90,2012-04-09,PHO,MIN
1724,24,@,W 114-88 ,240,48,87,0.552,45,78,0.577,3,9,0.333,15,20,0.75,114,39,89,0.438,37,74,0.5,2,15,0.133,8,14,0.571,88,2012-04-22,SAC,CHA
1725,25,Home,W 114-106 (2OT),290,41,106,0.387,36,90,0.4,5,16,0.313,27,40,0.675,114,37,101,0.366,29,77,0.377,8,24,0.333,24,28,0.857,106,2012-04-22,LAL,OKC
1726,26,Home,W 114-98 ,240,42,77,0.545,34,57,0.596,8,20,0.4,22,29,0.759,114,37,88,0.42,32,66,0.485,5,22,0.227,19,28,0.679,98,2012-04-22,SAS,CLE
1727,27,@,W 114-110 ,240,41,84,0.488,37,68,0.544,4,16,0.25,28,39,0.718,114,30,70,0.429,20,49,0.408,10,21,0.476,40,52,0.769,110,2012-11-03,GSW,LAC
1728,28,Home,W 114-91 ,240,48,78,0.615,38,58,0.655,10,20,0.5,8,13,0.615,114,36,93,0.387,31,71,0.437,5,22,0.227,14,18,0.778,91,2012-11-05,DAL,POR
1729,29,Home,W 114-101 ,240,42,77,0.545,37,55,0.673,5,22,0.227,25,31,0.806,114,38,87,0.437,35,73,0.479,3,14,0.214,22,26,0.846,101,2012-11-13,BRK,CLE
1730,30,Home,W 114-102 ,240,42,89,0.472,34,68,0.5,8,21,0.381,22,28,0.786,114,45,92,0.489,40,78,0.513,5,14,0.357,7,15,0.467,102,2012-11-16,LAL,PHO
1731,31,Home,W 114-111 ,240,42,85,0.494,29,56,0.518,13,29,0.448,17,21,0.81,114,39,77,0.506,24,46,0.522,15,31,0.484,18,22,0.818,111,2012-11-21,DAL,NYK
1732,32,Home,W 114-87 ,240,46,77,0.597,39,60,0.65,7,17,0.412,15,18,0.833,114,31,77,0.403,26,58,0.448,5,19,0.263,20,26,0.769,87,2012-11-21,PHO,POR
1733,33,Home,W 114-69 ,240,40,78,0.513,27,51,0.529,13,27,0.481,21,23,0.913,114,23,79,0.291,17,57,0.298,6,22,0.273,17,22,0.773,69,2012-11-26,OKC,CHA
1734,34,Home,W 114-108 ,240,41,84,0.488,32,67,0.478,9,17,0.529,23,28,0.821,114,36,84,0.429,25,56,0.446,11,28,0.393,25,31,0.806,108,2012-12-07,OKC,LAL
1735,35,Home,W 114-92 ,240,48,87,0.552,42,67,0.627,6,20,0.3,12,13,0.923,114,37,95,0.389,26,62,0.419,11,33,0.333,7,8,0.875,92,2012-12-07,SAS,HOU
1736,36,Home,W 114-106 (OT),265,41,94,0.436,35,71,0.493,6,23,0.261,26,32,0.813,114,39,84,0.464,32,70,0.457,7,14,0.5,21,25,0.84,106,2012-12-15,MIN,DAL
1737,37,@,L 114-126 ,240,41,83,0.494,30,54,0.556,11,29,0.379,21,30,0.7,114,45,94,0.479,33,72,0.458,12,22,0.545,24,32,0.75,126,2012-12-26,LAL,DEN
1738,38,Home,L 114-116 ,240,34,71,0.479,25,56,0.446,9,15,0.6,37,40,0.925,114,38,77,0.494,31,54,0.574,7,23,0.304,33,41,0.805,116,2012-12-28,UTA,LAC
1739,39,Home,W 114-96 ,240,44,87,0.506,39,72,0.542,5,15,0.333,21,24,0.875,114,37,78,0.474,29,54,0.537,8,24,0.333,14,17,0.824,96,2012-12-31,OKC,PHO
1740,40,@,W 114-106 ,240,42,88,0.477,30,55,0.545,12,33,0.364,18,22,0.818,114,41,85,0.482,31,59,0.525,10,26,0.385,14,18,0.778,106,2013-01-05,NYK,ORL
1741,41,Home,L 114-117 (OT),265,41,91,0.451,34,71,0.479,7,20,0.35,25,30,0.833,114,39,95,0.411,33,75,0.44,6,20,0.3,33,36,0.917,117,2013-01-18,DAL,OKC
1742,42,Home,W 114-105 ,240,43,89,0.483,31,64,0.484,12,25,0.48,16,21,0.762,114,38,81,0.469,35,66,0.53,3,15,0.2,26,32,0.813,105,2013-01-21,NOP,SAC
1743,43,Home,W 114-101 ,240,48,83,0.578,40,66,0.606,8,17,0.471,10,17,0.588,114,39,88,0.443,36,74,0.486,3,14,0.214,20,33,0.606,101,2013-01-25,WAS,MIN
1744,44,Home,W 114-110 (OT),265,44,83,0.53,41,73,0.562,3,10,0.3,23,26,0.885,114,44,82,0.537,37,61,0.607,7,21,0.333,15,18,0.833,110,2013-01-26,UTA,IND
1745,45,@,W 114-102 ,240,46,86,0.535,40,71,0.563,6,15,0.4,16,20,0.8,114,38,87,0.437,32,68,0.471,6,19,0.316,20,23,0.87,102,2013-01-28,GSW,TOR
1746,46,Home,W 114-103 ,240,36,75,0.48,25,50,0.5,11,25,0.44,31,40,0.775,114,36,81,0.444,28,60,0.467,8,21,0.381,23,28,0.821,103,2013-02-05,IND,ATL
1747,47,Home,W 114-108 ,240,40,82,0.488,30,59,0.508,10,23,0.435,24,28,0.857,114,39,80,0.488,30,55,0.545,9,25,0.36,21,25,0.84,108,2013-02-06,MIA,HOU
1748,48,@,L 114-118 (3OT),315,48,113,0.425,40,87,0.46,8,26,0.308,10,17,0.588,114,43,108,0.398,30,78,0.385,13,30,0.433,19,24,0.792,118,2013-02-10,DEN,BOS
1749,49,Home,W 114-82 ,240,41,73,0.562,31,59,0.525,10,14,0.714,22,33,0.667,114,29,82,0.354,26,63,0.413,3,19,0.158,21,37,0.568,82,2013-02-22,IND,DET
1750,50,@,W 114-90 ,240,45,77,0.584,36,56,0.643,9,21,0.429,15,18,0.833,114,35,78,0.449,24,50,0.48,11,28,0.393,9,10,0.9,90,2013-02-23,MIA,PHI
1751,51,@,W 114-103 ,240,40,79,0.506,26,46,0.565,14,33,0.424,20,24,0.833,114,41,84,0.488,38,70,0.543,3,14,0.214,18,22,0.818,103,2013-02-25,ATL,DET
1752,52,@,L 114-122 (OT),265,46,100,0.46,38,78,0.487,8,22,0.364,14,18,0.778,114,46,92,0.5,41,78,0.526,5,14,0.357,25,30,0.833,122,2013-03-02,TOR,MIL
1753,53,Home,W 114-75 ,240,45,89,0.506,36,69,0.522,9,20,0.45,15,20,0.75,114,28,86,0.326,22,67,0.328,6,19,0.316,13,18,0.722,75,2013-03-03,SAS,DET
1754,54,@,L 114-119 ,240,43,81,0.531,37,66,0.561,6,15,0.4,22,29,0.759,114,42,79,0.532,33,57,0.579,9,22,0.409,26,33,0.788,119,2013-03-18,WAS,CHA
1755,55,@,W 114-104 ,240,43,96,0.448,39,75,0.52,4,21,0.19,24,29,0.828,114,37,85,0.435,33,60,0.55,4,25,0.16,26,31,0.839,104,2013-03-19,DEN,OKC
1756,56,Home,W 114-108 ,240,44,85,0.518,38,65,0.585,6,20,0.3,20,28,0.714,114,44,84,0.524,37,65,0.569,7,19,0.368,13,18,0.722,108,2013-03-27,CHA,ORL
1757,57,@,L 114-132 ,240,39,83,0.47,25,49,0.51,14,34,0.412,22,32,0.688,114,54,99,0.545,43,74,0.581,11,25,0.44,13,21,0.619,132,2013-04-06,HOU,DEN
1758,58,Home,W 114-90 ,240,40,80,0.5,28,59,0.475,12,21,0.571,22,28,0.786,114,37,84,0.44,30,67,0.448,7,17,0.412,9,13,0.692,90,2013-04-17,TOR,BOS
1759,59,Home,W 114-110 ,240,43,80,0.538,35,59,0.593,8,21,0.381,20,24,0.833,114,42,85,0.494,26,45,0.578,16,40,0.4,10,13,0.769,110,2013-10-30,PHI,MIA
1760,60,Home,W 114-103 ,240,40,83,0.482,31,63,0.492,9,20,0.45,25,32,0.781,114,36,80,0.45,28,58,0.483,8,22,0.364,23,28,0.821,103,2013-11-08,PHO,DEN
1761,61,Home,W 114-99 ,240,47,90,0.522,37,65,0.569,10,25,0.4,10,10,1.0,114,42,87,0.483,34,64,0.531,8,23,0.348,7,17,0.412,99,2013-11-17,LAL,DET
1762,62,Home,W 114-95 ,240,39,74,0.527,20,42,0.476,19,32,0.594,17,20,0.85,114,37,89,0.416,31,67,0.463,6,22,0.273,15,23,0.652,95,2013-11-29,HOU,BRK
1763,63,@,W 114-108 ,240,38,87,0.437,29,64,0.453,9,23,0.391,29,34,0.853,114,40,87,0.46,30,59,0.508,10,28,0.357,18,23,0.783,108,2013-12-01,POR,LAL
1764,64,@,W 114-73 ,240,39,72,0.542,25,47,0.532,14,25,0.56,22,27,0.815,114,25,73,0.342,19,57,0.333,6,16,0.375,17,23,0.739,73,2013-12-08,BOS,NYK
1765,65,@,W 114-108 ,240,44,85,0.518,37,62,0.597,7,23,0.304,19,21,0.905,114,39,80,0.488,34,61,0.557,5,19,0.263,25,32,0.781,108,2013-12-10,PHO,LAL
1766,66,Home,W 114-107 ,240,42,76,0.553,34,55,0.618,8,21,0.381,22,30,0.733,114,39,84,0.464,29,55,0.527,10,29,0.345,19,25,0.76,107,2013-12-14,MIA,CLE
1767,67,Home,W 114-100 ,240,45,92,0.489,34,65,0.523,11,27,0.407,13,15,0.867,114,39,82,0.476,34,61,0.557,5,21,0.238,17,21,0.81,100,2013-12-16,ATL,LAL
1768,68,Home,W 114-111 (OT),265,39,100,0.39,28,72,0.389,11,28,0.393,25,27,0.926,114,40,100,0.4,30,71,0.423,10,29,0.345,21,25,0.84,111,2013-12-20,CLE,MIL
1769,69,Home,W 114-81 ,240,43,81,0.531,31,55,0.564,12,26,0.462,16,22,0.727,114,32,84,0.381,28,62,0.452,4,22,0.182,13,24,0.542,81,2013-12-20,IND,HOU
1770,70,@,W 114-97 ,240,44,79,0.557,35,56,0.625,9,23,0.391,17,23,0.739,114,40,89,0.449,39,77,0.506,1,12,0.083,16,26,0.615,97,2013-12-21,HOU,DET
1771,71,@,W 114-102 ,240,43,92,0.467,34,69,0.493,9,23,0.391,19,28,0.679,114,36,91,0.396,31,66,0.47,5,25,0.2,25,35,0.714,102,2014-01-01,PHI,DEN
1772,72,Home,L 114-123 ,240,40,78,0.513,32,60,0.533,8,18,0.444,26,31,0.839,114,46,82,0.561,31,53,0.585,15,29,0.517,16,19,0.842,123,2014-01-02,MIA,GSW
1773,73,@,W 114-104 ,240,40,94,0.426,29,64,0.453,11,30,0.367,23,33,0.697,114,41,95,0.432,33,71,0.465,8,24,0.333,14,20,0.7,104,2014-01-10,DET,PHI
1774,74,@,W 114-107 ,240,38,73,0.521,30,55,0.545,8,18,0.444,30,42,0.714,114,40,95,0.421,35,76,0.461,5,19,0.263,22,31,0.71,107,2014-01-11,HOU,WAS
1775,75,@,L 114-121 ,240,43,91,0.473,37,71,0.521,6,20,0.3,22,24,0.917,114,49,100,0.49,45,81,0.556,4,19,0.211,19,25,0.76,121,2014-01-15,LAL,PHO
1776,76,Home,W 114-97 ,240,41,75,0.547,31,53,0.585,10,22,0.455,22,26,0.846,114,37,84,0.44,30,59,0.508,7,25,0.28,16,17,0.941,97,2014-01-15,WAS,MIA
1777,77,Home,W 114-104 ,240,41,85,0.482,34,58,0.586,7,27,0.259,25,37,0.676,114,40,80,0.5,29,57,0.509,11,23,0.478,13,21,0.619,104,2014-01-18,HOU,MIL
1778,78,@,L 114-121 ,240,38,78,0.487,23,45,0.511,15,33,0.455,23,28,0.821,114,42,81,0.519,30,50,0.6,12,31,0.387,25,27,0.926,121,2014-01-20,MIA,ATL
1779,79,@,W 114-97 ,240,42,82,0.512,33,61,0.541,9,21,0.429,21,31,0.677,114,33,69,0.478,28,58,0.483,5,11,0.455,26,38,0.684,97,2014-01-21,SAC,NOP
1780,80,Home,W 114-105 ,240,39,81,0.481,30,64,0.469,9,17,0.529,27,34,0.794,114,41,90,0.456,29,68,0.426,12,22,0.545,11,17,0.647,105,2014-01-24,ORL,LAL
1781,81,@,W 114-86 ,240,43,79,0.544,29,51,0.569,14,28,0.5,14,19,0.737,114,34,89,0.382,30,67,0.448,4,22,0.182,14,22,0.636,86,2014-01-27,LAC,MIL
1782,82,Home,W 114-88 ,240,44,82,0.537,34,62,0.548,10,20,0.5,16,23,0.696,114,32,82,0.39,26,60,0.433,6,22,0.273,18,24,0.75,88,2014-01-28,NYK,BOS
1783,83,@,W 114-108 ,240,41,84,0.488,33,65,0.508,8,19,0.421,24,33,0.727,114,42,94,0.447,35,73,0.479,7,21,0.333,17,20,0.85,108,2014-02-05,BOS,PHI
1784,84,Home,W 114-89 ,240,45,82,0.549,33,58,0.569,12,24,0.5,12,15,0.8,114,37,82,0.451,32,68,0.471,5,14,0.357,10,12,0.833,89,2014-02-11,CHA,DAL
1785,85,@,W 114-85 ,240,40,87,0.46,34,69,0.493,6,18,0.333,28,33,0.848,114,31,87,0.356,26,65,0.4,5,22,0.227,18,27,0.667,85,2014-02-18,CLE,PHI
1786,86,@,W 114-97 ,240,46,89,0.517,33,65,0.508,13,24,0.542,9,11,0.818,114,33,73,0.452,27,57,0.474,6,16,0.375,25,30,0.833,97,2014-02-19,WAS,ATL
1787,87,@,W 114-104 ,240,40,86,0.465,29,60,0.483,11,26,0.423,23,24,0.958,114,39,80,0.488,26,49,0.531,13,31,0.419,13,17,0.765,104,2014-02-26,CLE,OKC
1788,88,Home,W 114-88 ,240,42,74,0.568,34,61,0.557,8,13,0.615,22,26,0.846,114,31,79,0.392,25,58,0.431,6,21,0.286,20,26,0.769,88,2014-03-03,MIL,UTA
1789,89,Home,W 114-101 ,240,41,91,0.451,35,71,0.493,6,20,0.3,26,33,0.788,114,38,94,0.404,34,81,0.42,4,13,0.308,21,30,0.7,101,2014-03-07,MIN,DET
1790,90,@,W 114-107 ,240,43,80,0.538,28,52,0.538,15,28,0.536,13,23,0.565,114,39,87,0.448,35,71,0.493,4,16,0.25,25,28,0.893,107,2014-03-08,WAS,MIL
1791,91,Home,W 114-110 ,240,38,81,0.469,25,50,0.5,13,31,0.419,25,30,0.833,114,42,100,0.42,30,65,0.462,12,35,0.343,14,21,0.667,110,2014-03-09,LAL,OKC
1792,92,Home,W 114-98 ,240,44,78,0.564,35,61,0.574,9,17,0.529,17,24,0.708,114,35,83,0.422,26,56,0.464,9,27,0.333,19,23,0.826,98,2014-03-21,BRK,BOS
1793,93,@,W 114-94 ,240,46,83,0.554,37,66,0.561,9,17,0.529,13,18,0.722,114,34,83,0.41,27,56,0.482,7,27,0.259,19,28,0.679,94,2014-03-24,DET,UTA
1794,94,Home,W 114-99 ,240,43,86,0.5,31,53,0.585,12,33,0.364,16,22,0.727,114,39,83,0.47,36,71,0.507,3,12,0.25,18,27,0.667,99,2014-03-30,BRK,MIN
1795,95,@,W 114-104 ,240,38,82,0.463,26,52,0.5,12,30,0.4,26,32,0.813,114,41,96,0.427,31,70,0.443,10,26,0.385,12,14,0.857,104,2014-03-31,LAC,MIN
1796,96,@,L 114-125 ,240,44,85,0.518,36,64,0.563,8,21,0.381,18,21,0.857,114,41,82,0.5,29,57,0.509,12,25,0.48,31,37,0.838,125,2014-04-09,PHI,TOR
1797,97,Home,W 114-93 ,240,46,78,0.59,32,49,0.653,14,29,0.483,8,15,0.533,114,36,80,0.45,29,53,0.547,7,27,0.259,14,16,0.875,93,2014-04-14,WAS,MIA
1798,98,Home,W 114-85 ,240,46,87,0.529,38,67,0.567,8,20,0.4,14,17,0.824,114,30,79,0.38,22,54,0.407,8,25,0.32,17,23,0.739,85,2014-04-16,CLE,BRK
1799,99,@,W 114-108 (OT),265,41,104,0.394,38,89,0.427,3,15,0.2,29,33,0.879,114,41,90,0.456,28,59,0.475,13,31,0.419,13,17,0.765,108,2014-10-31,CLE,CHI
1800,0,@,W 114-96 ,240,41,83,0.494,29,59,0.492,12,24,0.5,20,29,0.69,114,35,67,0.522,28,44,0.636,7,23,0.304,19,26,0.731,96,2014-11-01,MIA,PHI
1801,1,@,W 114-112 (2OT),290,39,91,0.429,36,75,0.48,3,16,0.188,33,39,0.846,114,42,98,0.429,32,67,0.478,10,31,0.323,18,25,0.72,112,2014-11-07,SAC,PHO
1802,2,Home,W 114-103 ,240,42,75,0.56,31,47,0.66,11,28,0.393,19,23,0.826,114,35,74,0.473,25,53,0.472,10,21,0.476,23,25,0.92,103,2014-11-14,ATL,MIA
1803,3,Home,L 114-118 ,240,45,87,0.517,41,77,0.532,4,10,0.4,20,31,0.645,114,48,93,0.516,39,72,0.542,9,21,0.429,13,16,0.813,118,2014-11-17,BOS,PHO
1804,4,@,W 114-109 ,240,47,87,0.54,41,70,0.586,6,17,0.353,14,22,0.636,114,41,85,0.482,32,58,0.552,9,27,0.333,18,23,0.783,109,2014-11-18,LAL,ATL
1805,5,@,W 114-90 ,240,45,84,0.536,33,63,0.524,12,21,0.571,12,16,0.75,114,34,86,0.395,26,62,0.419,8,24,0.333,14,18,0.778,90,2014-11-19,LAC,ORL
1806,6,@,W 114-104 ,240,44,89,0.494,37,62,0.597,7,27,0.259,19,23,0.826,114,42,84,0.5,42,76,0.553,0,8,0.0,20,24,0.833,104,2014-11-24,POR,PHI
1807,7,Home,W 114-109 ,240,43,85,0.506,35,69,0.507,8,16,0.5,20,27,0.741,114,35,82,0.427,28,61,0.459,7,21,0.333,32,37,0.865,109,2014-11-25,DEN,CHI
1808,8,@,W 114-97 ,240,43,75,0.573,30,47,0.638,13,28,0.464,15,23,0.652,114,33,85,0.388,23,62,0.371,10,23,0.435,21,27,0.778,97,2014-11-25,GSW,MIA
1809,9,Home,W 114-86 ,240,42,78,0.538,30,47,0.638,12,31,0.387,18,25,0.72,114,33,79,0.418,26,59,0.441,7,20,0.35,13,25,0.52,86,2014-12-03,LAC,ORL
1810,10,@,W 114-112 (OT),265,38,78,0.487,26,46,0.565,12,32,0.375,26,31,0.839,114,45,97,0.464,42,87,0.483,3,10,0.3,19,27,0.704,112,2014-12-05,HOU,MIN
1811,11,Home,W 114-105 ,240,41,85,0.482,34,71,0.479,7,14,0.5,25,29,0.862,114,38,85,0.447,20,45,0.444,18,40,0.45,11,14,0.786,105,2014-12-09,MEM,DAL
1812,12,Home,W 114-101 ,240,41,82,0.5,37,61,0.607,4,21,0.19,28,34,0.824,114,34,84,0.405,30,63,0.476,4,21,0.19,29,35,0.829,101,2014-12-09,OKC,MIL
1813,13,@,L 114-119 ,240,44,89,0.494,36,67,0.537,8,22,0.364,18,23,0.783,114,44,79,0.557,32,51,0.627,12,28,0.429,19,25,0.76,119,2014-12-12,CLE,NOP
1814,14,@,W 114-87 ,240,42,72,0.583,26,49,0.531,16,23,0.696,14,20,0.7,114,31,79,0.392,23,57,0.404,8,22,0.364,17,27,0.63,87,2014-12-13,BRK,CHO
1815,15,Home,W 114-109 ,240,48,94,0.511,36,63,0.571,12,31,0.387,6,10,0.6,114,41,86,0.477,30,61,0.492,11,25,0.44,16,24,0.667,109,2014-12-18,GSW,OKC
1816,16,Home,W 114-98 ,240,48,85,0.565,40,62,0.645,8,23,0.348,10,14,0.714,114,42,93,0.452,36,81,0.444,6,12,0.5,8,16,0.5,98,2014-12-19,BOS,MIN
1817,17,@,W 114-88 ,240,48,90,0.533,39,65,0.6,9,25,0.36,9,15,0.6,114,30,85,0.353,27,70,0.386,3,15,0.2,25,28,0.893,88,2014-12-20,POR,NOP
1818,18,@,W 114-106 ,240,42,81,0.519,33,66,0.5,9,15,0.6,21,38,0.553,114,42,81,0.519,35,58,0.603,7,23,0.304,15,21,0.714,106,2014-12-25,OKC,SAS
1819,19,Home,W 114-93 ,240,42,88,0.477,24,45,0.533,18,43,0.419,12,14,0.857,114,36,81,0.444,33,67,0.493,3,14,0.214,18,33,0.545,93,2014-12-26,POR,PHI
1820,20,Home,W 114-87 ,240,43,82,0.524,35,67,0.522,8,15,0.533,20,29,0.69,114,33,74,0.446,29,62,0.468,4,12,0.333,17,27,0.63,87,2014-12-30,DAL,WAS
1821,21,Home,W 114-85 ,240,41,79,0.519,34,64,0.531,7,15,0.467,25,31,0.806,114,37,86,0.43,35,72,0.486,2,14,0.143,9,13,0.692,85,2015-01-03,DEN,MEM
1822,22,Home,W 114-95 ,240,45,91,0.495,33,60,0.55,12,31,0.387,12,16,0.75,114,32,75,0.427,29,60,0.483,3,15,0.2,28,36,0.778,95,2015-01-04,DET,SAC
1823,23,Home,W 114-105 ,240,41,85,0.482,36,68,0.529,5,17,0.294,27,30,0.9,114,47,102,0.461,39,77,0.506,8,25,0.32,3,5,0.6,105,2015-01-05,CHI,HOU
1824,24,Home,W 114-89 ,240,40,85,0.471,28,52,0.538,12,33,0.364,22,30,0.733,114,37,85,0.435,32,65,0.492,5,20,0.25,10,17,0.588,89,2015-01-07,LAC,LAL
1825,25,Home,L 114-121 ,240,41,84,0.488,33,57,0.579,8,27,0.296,24,33,0.727,114,48,81,0.593,41,63,0.651,7,18,0.389,18,29,0.621,121,2015-01-12,CHI,ORL
1826,26,@,W 114-111 ,240,41,96,0.427,34,75,0.453,7,21,0.333,25,31,0.806,114,47,87,0.54,40,60,0.667,7,27,0.259,10,14,0.714,111,2015-01-12,DET,TOR
1827,27,Home,W 114-107 ,240,41,82,0.5,37,63,0.587,4,19,0.211,28,35,0.8,114,41,100,0.41,32,63,0.508,9,37,0.243,16,20,0.8,107,2015-01-14,DEN,DAL
1828,28,Home,W 114-111 ,240,42,89,0.472,34,66,0.515,8,23,0.348,22,25,0.88,114,41,95,0.432,31,67,0.463,10,28,0.357,19,27,0.704,111,2015-01-25,GSW,BOS
1829,29,Home,W 114-110 ,240,43,81,0.531,38,66,0.576,5,15,0.333,23,29,0.793,114,41,90,0.456,29,56,0.518,12,34,0.353,16,23,0.696,110,2015-01-25,TOR,DET
1830,30,Home,W 114-101 ,240,41,82,0.5,31,57,0.544,10,25,0.4,22,35,0.629,114,39,87,0.448,28,55,0.509,11,32,0.344,12,19,0.632,101,2015-01-31,DET,HOU
1831,31,@,L 114-128 ,240,41,98,0.418,31,68,0.456,10,30,0.333,22,28,0.786,114,45,86,0.523,26,48,0.542,19,38,0.5,19,25,0.76,128,2015-02-04,DAL,GSW
1832,32,Home,W 114-109 ,240,46,77,0.597,34,56,0.607,12,21,0.571,10,18,0.556,114,43,87,0.494,31,63,0.492,12,24,0.5,11,15,0.733,109,2015-02-04,IND,DET
1833,33,Home,W 114-77 ,240,44,87,0.506,35,67,0.522,9,20,0.45,17,23,0.739,114,26,77,0.338,22,59,0.373,4,18,0.222,21,31,0.677,77,2015-02-07,WAS,BRK
1834,34,Home,L 114-124 ,240,42,87,0.483,33,59,0.559,9,28,0.321,21,29,0.724,114,43,80,0.538,31,56,0.554,12,24,0.5,26,35,0.743,124,2015-02-09,DEN,OKC
1835,35,@,W 114-105 ,240,42,89,0.472,32,68,0.471,10,21,0.476,20,24,0.833,114,41,89,0.461,37,66,0.561,4,23,0.174,19,29,0.655,105,2015-02-20,BRK,LAL
1836,36,@,W 114-107 ,240,45,90,0.5,33,67,0.493,12,23,0.522,12,17,0.706,114,42,79,0.532,37,61,0.607,5,18,0.278,18,21,0.857,107,2015-02-24,GSW,WAS
1837,37,@,W 114-103 ,240,41,80,0.513,30,53,0.566,11,27,0.407,21,24,0.875,114,41,78,0.526,33,58,0.569,8,20,0.4,13,19,0.684,103,2015-03-02,TOR,PHI
1838,38,@,L 114-119 ,240,38,85,0.447,28,58,0.483,10,27,0.37,28,38,0.737,114,48,85,0.565,35,61,0.574,13,24,0.542,10,12,0.833,119,2015-03-06,SAC,ORL
1839,39,@,W 114-100 ,240,40,86,0.465,30,58,0.517,10,28,0.357,24,32,0.75,114,38,92,0.413,29,62,0.468,9,30,0.3,15,19,0.789,100,2015-03-07,HOU,DEN
1840,40,Home,W 114-109 (OT),265,41,80,0.513,34,56,0.607,7,24,0.292,25,33,0.758,114,40,88,0.455,30,63,0.476,10,25,0.4,19,24,0.792,109,2015-03-07,MIA,SAC
1841,41,@,W 114-103 ,240,44,75,0.587,35,60,0.583,9,15,0.6,17,21,0.81,114,37,71,0.521,33,56,0.589,4,15,0.267,25,31,0.806,103,2015-03-09,NOP,MIL
1842,42,Home,W 114-103 ,240,41,82,0.5,33,65,0.508,8,17,0.471,24,37,0.649,114,39,92,0.424,31,73,0.425,8,19,0.421,17,22,0.773,103,2015-03-13,DEN,GSW
1843,43,Home,W 114-107 ,240,45,95,0.474,36,63,0.571,9,32,0.281,15,23,0.652,114,35,87,0.402,31,73,0.425,4,14,0.286,33,40,0.825,107,2015-03-13,PHI,SAC
1844,44,Home,W 114-95 ,240,44,84,0.524,30,54,0.556,14,30,0.467,12,20,0.6,114,31,87,0.356,23,65,0.354,8,22,0.364,25,30,0.833,95,2015-03-18,GSW,ATL
1845,45,@,W 114-103 ,240,38,76,0.5,30,56,0.536,8,20,0.4,30,38,0.789,114,39,80,0.488,32,66,0.485,7,14,0.5,18,24,0.75,103,2015-03-18,SAS,MIL
1846,46,@,W 114-95 ,240,46,82,0.561,39,65,0.6,7,17,0.412,15,17,0.882,114,38,80,0.475,26,56,0.464,12,24,0.5,7,7,1.0,95,2015-03-22,SAS,ATL
1847,47,@,L 114-120 ,240,43,92,0.467,34,68,0.5,9,24,0.375,19,22,0.864,114,48,85,0.565,40,67,0.597,8,18,0.444,16,18,0.889,120,2015-03-28,DEN,POR
1848,48,Home,W 114-88 ,240,40,80,0.5,25,45,0.556,15,35,0.429,19,25,0.76,114,32,75,0.427,25,54,0.463,7,21,0.333,17,21,0.81,88,2015-04-02,CLE,MIA
1849,49,Home,W 114-109 ,240,46,88,0.523,41,72,0.569,5,16,0.313,17,23,0.739,114,42,82,0.512,34,56,0.607,8,26,0.308,17,23,0.739,109,2015-04-03,BRK,TOR
1850,50,@,W 114-111 ,240,43,86,0.5,32,58,0.552,11,28,0.393,17,25,0.68,114,41,87,0.471,34,61,0.557,7,26,0.269,22,25,0.88,111,2015-04-08,ATL,BRK
1851,51,Home,W 114-107 ,240,40,90,0.444,31,64,0.484,9,26,0.346,25,36,0.694,114,37,89,0.416,24,48,0.5,13,41,0.317,20,25,0.8,107,2015-04-11,CHI,PHI
1852,52,@,L 114-121 ,240,44,91,0.484,33,64,0.516,11,27,0.407,15,22,0.682,114,39,73,0.534,30,49,0.612,9,24,0.375,34,48,0.708,121,2015-04-12,NOP,HOU
1853,53,Home,W 114-98 ,240,39,86,0.453,30,61,0.492,9,25,0.36,27,34,0.794,114,38,91,0.418,31,66,0.47,7,25,0.28,15,18,0.833,98,2015-04-15,DAL,POR
1854,54,@,L 114-132 ,240,41,89,0.461,30,55,0.545,11,34,0.324,21,27,0.778,114,52,101,0.515,46,79,0.582,6,22,0.273,22,30,0.733,132,2015-10-30,LAL,SAC
1855,55,Home,W 114-109 ,240,39,76,0.513,35,59,0.593,4,17,0.235,32,46,0.696,114,43,101,0.426,37,83,0.446,6,18,0.333,17,25,0.68,109,2015-10-31,LAC,SAC
1856,56,@,L 114-119 (OT),265,46,91,0.505,39,71,0.549,7,20,0.35,15,19,0.789,114,42,88,0.477,31,54,0.574,11,34,0.324,24,34,0.706,119,2015-11-04,ORL,HOU
1857,57,Home,W 114-99 ,240,43,92,0.467,30,59,0.508,13,33,0.394,15,15,1.0,114,38,78,0.487,30,54,0.556,8,24,0.333,15,17,0.882,99,2015-11-07,ATL,WAS
1858,58,Home,W 114-94 ,240,45,81,0.556,36,60,0.6,9,21,0.429,15,23,0.652,114,34,73,0.466,28,54,0.519,6,19,0.316,20,31,0.645,94,2015-11-07,SAS,CHO
1859,59,@,L 114-118 ,240,40,82,0.488,30,60,0.5,10,22,0.455,24,28,0.857,114,37,74,0.5,26,50,0.52,11,24,0.458,33,43,0.767,118,2015-11-10,UTA,CLE
1860,60,@,W 114-106 ,240,40,71,0.563,31,54,0.574,9,17,0.529,25,27,0.926,114,41,82,0.5,36,66,0.545,5,16,0.313,19,21,0.905,106,2015-11-15,MEM,MIN
1861,61,@,L 114-122 ,240,41,81,0.506,31,57,0.544,10,24,0.417,22,31,0.71,114,37,84,0.44,25,67,0.373,12,17,0.706,36,39,0.923,122,2015-11-16,OKC,MEM
1862,62,@,W 114-107 ,240,40,79,0.506,25,52,0.481,15,27,0.556,19,25,0.76,114,41,90,0.456,36,66,0.545,5,24,0.208,20,26,0.769,107,2015-11-20,PHO,DEN
1863,63,@,L 114-117 ,240,44,83,0.53,34,64,0.531,10,19,0.526,16,28,0.571,114,47,90,0.522,38,68,0.559,9,22,0.409,14,18,0.778,117,2015-11-22,DAL,OKC
1864,64,Home,L 114-120 ,240,44,96,0.458,34,70,0.486,10,26,0.385,16,20,0.8,114,42,81,0.519,32,59,0.542,10,22,0.455,26,34,0.765,120,2015-11-25,PHO,NOP
1865,65,@,L 114-116 ,240,40,83,0.482,24,48,0.5,16,35,0.457,18,26,0.692,114,38,73,0.521,27,53,0.509,11,20,0.55,29,37,0.784,116,2015-11-27,PHI,HOU
1866,66,Home,W 114-90 ,240,43,82,0.524,31,55,0.564,12,27,0.444,16,22,0.727,114,31,74,0.419,23,48,0.479,8,26,0.308,20,22,0.909,90,2015-11-27,ORL,MIL
1867,67,@,W 114-97 ,240,40,84,0.476,26,51,0.51,14,33,0.424,20,24,0.833,114,29,77,0.377,22,56,0.393,7,21,0.333,32,41,0.78,97,2015-12-03,BOS,SAC
1868,68,Home,W 114-108 (OT),265,42,85,0.494,33,60,0.55,9,25,0.36,21,31,0.677,114,39,89,0.438,29,56,0.518,10,33,0.303,20,24,0.833,108,2015-12-04,NOP,CLE
1869,69,@,W 114-98 ,240,44,86,0.512,30,53,0.566,14,33,0.424,12,23,0.522,114,39,89,0.438,34,72,0.472,5,17,0.294,15,23,0.652,98,2015-12-06,GSW,BRK
1870,70,@,W 114-103 ,240,46,92,0.5,37,74,0.5,9,18,0.5,13,17,0.765,114,41,69,0.594,36,53,0.679,5,16,0.313,16,22,0.727,103,2015-12-07,WAS,MIA
1871,71,Home,W 114-106 ,240,43,77,0.558,33,49,0.673,10,28,0.357,18,24,0.75,114,38,92,0.413,23,56,0.411,15,36,0.417,15,22,0.682,106,2015-12-08,SAC,UTA
1872,72,@,W 114-111 ,240,44,85,0.518,30,56,0.536,14,29,0.483,12,15,0.8,114,38,89,0.427,24,56,0.429,14,33,0.424,21,24,0.875,111,2015-12-12,WAS,DAL
1873,73,Home,W 114-108 ,240,42,82,0.512,34,57,0.596,8,25,0.32,22,25,0.88,114,41,87,0.471,23,47,0.489,18,40,0.45,8,11,0.727,108,2015-12-14,DEN,HOU
1874,74,Home,W 114-95 ,240,44,83,0.53,36,61,0.59,8,22,0.364,18,23,0.783,114,35,84,0.417,32,69,0.464,3,15,0.2,22,25,0.88,95,2015-12-16,SAS,WAS
1875,75,Home,W 114-91 ,240,42,82,0.512,28,55,0.509,14,27,0.519,16,20,0.8,114,33,81,0.407,26,62,0.419,7,19,0.368,18,24,0.75,91,2015-12-30,DAL,GSW
1876,76,@,W 114-110 ,240,43,84,0.512,32,61,0.525,11,23,0.478,17,27,0.63,114,36,78,0.462,24,48,0.5,12,30,0.4,26,29,0.897,110,2015-12-31,GSW,HOU
1877,77,Home,W 114-111 (OT),265,42,89,0.472,30,53,0.566,12,36,0.333,18,34,0.529,114,40,100,0.4,32,70,0.457,8,30,0.267,23,29,0.793,111,2016-01-10,LAC,NOP
1878,78,@,W 114-100 ,240,48,99,0.485,39,75,0.52,9,24,0.375,9,10,0.9,114,34,81,0.42,25,59,0.424,9,22,0.409,23,27,0.852,100,2016-01-11,WAS,CHI
1879,79,@,L 114-120 ,240,42,86,0.488,33,57,0.579,9,29,0.31,21,26,0.808,114,43,81,0.531,36,61,0.59,7,20,0.35,27,30,0.9,120,2016-01-12,BOS,NYK
1880,80,Home,W 114-86 ,240,44,79,0.557,36,50,0.72,8,29,0.276,18,24,0.75,114,34,78,0.436,28,58,0.483,6,20,0.3,12,19,0.632,86,2016-01-16,ATL,BRK
1881,81,Home,W 114-89 ,240,42,76,0.553,32,53,0.604,10,23,0.435,20,30,0.667,114,34,87,0.391,29,58,0.5,5,29,0.172,16,24,0.667,89,2016-01-16,PHI,POR
1882,82,Home,W 114-99 ,240,42,83,0.506,32,60,0.533,10,23,0.435,20,23,0.87,114,36,76,0.474,33,62,0.532,3,14,0.214,24,31,0.774,99,2016-01-19,NOP,MIN
1883,83,Home,L 114-123 ,240,43,95,0.453,31,71,0.437,12,24,0.5,16,18,0.889,114,38,80,0.475,26,50,0.52,12,30,0.4,35,59,0.593,123,2016-01-20,HOU,DET
1884,84,Home,W 114-107 ,240,45,89,0.506,34,58,0.586,11,31,0.355,13,20,0.65,114,41,84,0.488,37,68,0.544,4,16,0.25,21,23,0.913,107,2016-01-25,CLE,MIN
1885,85,@,W 114-91 ,240,47,95,0.495,41,78,0.526,6,17,0.353,14,16,0.875,114,32,85,0.376,23,60,0.383,9,25,0.36,18,23,0.783,91,2016-01-28,CHI,LAL
1886,86,Home,W 114-105 ,240,43,98,0.439,33,72,0.458,10,26,0.385,18,24,0.75,114,40,89,0.449,30,61,0.492,10,28,0.357,15,20,0.75,105,2016-01-28,NOP,SAC
1887,87,@,W 114-106 ,240,39,83,0.47,30,60,0.5,9,23,0.391,27,29,0.931,114,40,84,0.476,33,61,0.541,7,23,0.304,19,26,0.731,106,2016-01-29,CLE,DET
1888,88,@,L 114-119 ,240,39,93,0.419,23,47,0.489,16,46,0.348,20,25,0.8,114,44,82,0.537,34,58,0.586,10,24,0.417,21,35,0.6,119,2016-01-31,BOS,ORL
1889,89,Home,W 114-98 ,240,43,83,0.518,36,61,0.59,7,22,0.318,21,27,0.778,114,40,86,0.465,33,60,0.55,7,26,0.269,11,15,0.733,98,2016-02-01,OKC,WAS
1890,90,@,W 114-100 ,240,44,88,0.5,32,64,0.5,12,24,0.5,14,17,0.824,114,36,81,0.444,29,58,0.5,7,23,0.304,21,31,0.677,100,2016-02-03,IND,BRK
1891,91,@,L 114-117 ,240,47,95,0.495,37,72,0.514,10,23,0.435,10,12,0.833,114,44,93,0.473,35,66,0.53,9,27,0.333,20,25,0.8,117,2016-02-03,ORL,OKC
1892,92,@,W 114-110 (OT),265,38,88,0.432,23,50,0.46,15,38,0.395,23,33,0.697,114,44,88,0.5,35,65,0.538,9,23,0.391,13,23,0.565,110,2016-02-06,DAL,MEM
1893,93,@,W 114-110 ,240,44,87,0.506,40,71,0.563,4,16,0.25,22,29,0.759,114,42,91,0.462,27,56,0.482,15,35,0.429,11,17,0.647,110,2016-02-10,SAC,PHI
1894,94,@,L 114-121 ,240,40,76,0.526,28,49,0.571,12,27,0.444,22,26,0.846,114,41,81,0.506,34,64,0.531,7,17,0.412,32,40,0.8,121,2016-02-19,PHI,NOP
1895,95,Home,W 114-94 ,240,47,96,0.49,45,83,0.542,2,13,0.154,18,28,0.643,114,40,99,0.404,37,77,0.481,3,22,0.136,11,21,0.524,94,2016-02-20,MIA,WAS
1896,96,@,W 114-110 ,240,43,83,0.518,36,66,0.545,7,17,0.412,21,28,0.75,114,41,100,0.41,31,73,0.425,10,27,0.37,18,22,0.818,110,2016-02-23,SAC,DEN
1897,97,@,L 114-117 (OT),265,36,87,0.414,25,53,0.472,11,34,0.324,31,41,0.756,114,38,74,0.514,28,50,0.56,10,24,0.417,31,38,0.816,117,2016-02-23,HOU,UTA
1898,98,Home,W 114-103 ,240,45,91,0.495,32,59,0.542,13,32,0.406,11,17,0.647,114,37,76,0.487,27,47,0.574,10,29,0.345,19,27,0.704,103,2016-02-24,CLE,CHO
1899,99,Home,W 114-105 ,240,41,85,0.482,31,59,0.525,10,26,0.385,22,26,0.846,114,37,74,0.5,31,64,0.484,6,10,0.6,25,33,0.758,105,2016-02-24,TOR,MIN
1900,0,Home,L 114-130 ,240,41,90,0.456,31,64,0.484,10,26,0.385,22,28,0.786,114,53,88,0.602,40,63,0.635,13,25,0.52,11,16,0.688,130,2016-02-25,ORL,GSW
1901,1,Home,W 114-101 ,240,41,71,0.577,29,48,0.604,12,23,0.522,20,27,0.741,114,39,80,0.488,29,59,0.492,10,21,0.476,13,18,0.722,101,2016-02-28,DET,TOR
1902,2,@,L 114-116 (OT),265,41,93,0.441,25,52,0.481,16,41,0.39,16,20,0.8,114,44,107,0.411,35,81,0.432,9,26,0.346,19,25,0.76,116,2016-03-06,DAL,DEN
1903,3,Home,W 114-108 ,240,42,80,0.525,38,72,0.528,4,8,0.5,26,37,0.703,114,42,80,0.525,36,65,0.554,6,15,0.4,18,19,0.947,108,2016-03-09,MIL,MIA
1904,4,@,L 114-121 (OT),265,42,96,0.438,35,72,0.486,7,24,0.292,23,34,0.676,114,47,96,0.49,41,82,0.5,6,14,0.429,21,32,0.656,121,2016-03-11,NOP,MEM
1905,5,Home,W 114-93 ,240,38,67,0.567,29,51,0.569,9,16,0.563,29,38,0.763,114,35,80,0.438,28,56,0.5,7,24,0.292,16,22,0.727,93,2016-03-11,UTA,WAS
1906,6,@,W 114-90 ,240,41,84,0.488,23,47,0.489,18,37,0.486,14,20,0.7,114,32,79,0.405,22,47,0.468,10,32,0.313,16,19,0.842,90,2016-03-13,CLE,LAC
1907,7,@,L 114-131 ,240,41,88,0.466,30,58,0.517,11,30,0.367,21,26,0.808,114,47,90,0.522,37,66,0.561,10,24,0.417,27,31,0.871,131,2016-03-15,PHI,BRK
1908,8,Home,L 114-118 ,240,39,84,0.464,31,59,0.525,8,25,0.32,28,39,0.718,114,39,89,0.438,27,55,0.491,12,34,0.353,28,34,0.824,118,2016-03-16,DET,ATL
1909,9,@,W 114-108 ,240,40,71,0.563,30,50,0.6,10,21,0.476,24,31,0.774,114,44,100,0.44,40,80,0.5,4,20,0.2,16,21,0.762,108,2016-03-16,MIN,MEM
1910,10,Home,W 114-98 ,240,39,87,0.448,24,53,0.453,15,34,0.441,21,28,0.75,114,36,85,0.424,28,57,0.491,8,28,0.286,18,27,0.667,98,2016-03-23,GSW,LAC
1911,11,Home,W 114-90 ,240,44,84,0.524,33,59,0.559,11,25,0.44,15,18,0.833,114,31,89,0.348,24,70,0.343,7,19,0.368,21,27,0.778,90,2016-03-28,LAC,BOS
1912,12,@,W 114-94 ,240,48,90,0.533,43,74,0.581,5,16,0.313,13,18,0.722,114,36,86,0.419,29,67,0.433,7,19,0.368,15,21,0.714,94,2016-03-31,ORL,IND
1913,13,Home,W 114-109 ,240,43,85,0.506,35,66,0.53,8,19,0.421,20,33,0.606,114,43,94,0.457,32,64,0.5,11,30,0.367,12,21,0.571,109,2016-04-03,LAC,WAS
1914,14,Home,W 114-112 ,240,45,94,0.479,32,62,0.516,13,32,0.406,11,20,0.55,114,39,81,0.481,26,49,0.531,13,32,0.406,21,28,0.75,112,2016-04-09,SAC,OKC
1915,15,@,W 114-100 ,240,41,81,0.506,27,49,0.551,14,32,0.438,18,22,0.818,114,34,89,0.382,26,65,0.4,8,24,0.333,24,29,0.828,100,2016-04-11,CHA,BOS
1916,16,Home,W 114-105 ,240,45,99,0.455,38,73,0.521,7,26,0.269,17,22,0.773,114,43,96,0.448,34,65,0.523,9,31,0.29,10,12,0.833,105,2016-04-13,PHO,LAC
1917,17,@,L 114-120 ,240,44,86,0.512,37,57,0.649,7,29,0.241,19,27,0.704,114,45,89,0.506,33,54,0.611,12,35,0.343,18,22,0.818,120,2016-10-26,HOU,LAL
1918,18,Home,W 114-99 ,240,44,88,0.5,32,62,0.516,12,26,0.462,14,18,0.778,114,40,94,0.426,34,74,0.459,6,20,0.3,13,18,0.722,99,2016-10-27,ATL,WAS
1919,19,@,W 114-106 ,240,37,91,0.407,29,62,0.468,8,29,0.276,32,46,0.696,114,39,85,0.459,35,67,0.522,4,18,0.222,24,32,0.75,106,2016-10-27,LAC,POR
1920,20,Home,L 114-122 ,240,47,100,0.47,42,78,0.538,5,22,0.227,15,23,0.652,114,44,91,0.484,35,63,0.556,9,28,0.321,25,28,0.893,122,2016-10-28,NOP,GSW
1921,21,@,W 114-109 ,240,38,75,0.507,30,50,0.6,8,25,0.32,30,35,0.857,114,42,83,0.506,34,63,0.54,8,20,0.4,17,19,0.895,109,2016-11-06,UTA,NYK
1922,22,Home,W 114-82 ,240,41,76,0.539,28,51,0.549,13,25,0.52,19,22,0.864,114,30,82,0.366,26,70,0.371,4,12,0.333,18,26,0.692,82,2016-11-07,LAC,DET
1923,23,@,W 114-106 ,240,41,79,0.519,24,42,0.571,17,37,0.459,15,18,0.833,114,39,94,0.415,29,67,0.433,10,27,0.37,18,20,0.9,106,2016-11-07,HOU,WAS
1924,24,@,W 114-111 ,240,43,85,0.506,30,58,0.517,13,27,0.481,15,26,0.577,114,42,88,0.477,31,61,0.508,11,27,0.407,16,22,0.727,111,2016-11-19,MIA,WAS
1925,25,Home,L 114-119 ,240,45,89,0.506,34,69,0.493,11,20,0.55,13,18,0.722,114,44,86,0.512,31,55,0.564,13,31,0.419,18,20,0.9,119,2016-11-23,CHA,SAS
1926,26,Home,L 114-120 ,240,36,89,0.404,25,64,0.391,11,25,0.44,31,36,0.861,114,39,89,0.438,26,60,0.433,13,29,0.448,29,32,0.906,120,2016-11-27,PHO,DEN
1927,27,Home,L 114-130 ,240,40,83,0.482,28,50,0.56,12,33,0.364,22,29,0.759,114,46,82,0.561,29,46,0.63,17,36,0.472,21,28,0.75,130,2016-11-27,POR,HOU
1928,28,Home,L 114-121 ,240,40,91,0.44,25,49,0.51,15,42,0.357,19,20,0.95,114,48,87,0.552,39,67,0.582,9,20,0.45,16,21,0.762,121,2016-11-30,BOS,DET
1929,29,@,W 114-96 ,240,45,88,0.511,35,64,0.547,10,24,0.417,14,16,0.875,114,39,85,0.459,34,65,0.523,5,20,0.25,13,21,0.619,96,2016-12-02,LAC,NOP
1930,30,@,L 114-118 ,240,41,88,0.466,31,60,0.517,10,28,0.357,22,24,0.917,114,41,86,0.477,29,55,0.527,12,31,0.387,24,30,0.8,118,2016-12-02,MIN,NYK
1931,31,@,W 114-103 ,240,48,98,0.49,41,73,0.562,7,25,0.28,11,16,0.688,114,38,89,0.427,27,64,0.422,11,25,0.44,16,27,0.593,103,2016-12-06,NYK,MIA
1932,32,Home,W 114-84 ,240,46,83,0.554,37,59,0.627,9,24,0.375,13,19,0.684,114,31,90,0.344,25,63,0.397,6,27,0.222,16,21,0.762,84,2016-12-09,CLE,MIA
1933,33,@,W 114-110 ,240,40,84,0.476,28,50,0.56,12,34,0.353,22,29,0.759,114,44,94,0.468,32,66,0.485,12,28,0.429,10,14,0.714,110,2016-12-09,ATL,MIL
1934,34,Home,W 114-95 ,240,43,80,0.538,35,57,0.614,8,23,0.348,20,27,0.741,114,33,87,0.379,25,60,0.417,8,27,0.296,21,28,0.75,95,2016-12-13,POR,OKC
1935,35,Home,L 114-123 ,240,43,86,0.5,34,57,0.596,9,29,0.31,19,25,0.76,114,41,87,0.471,31,58,0.534,10,29,0.345,31,36,0.861,123,2016-12-14,PHI,TOR
1936,36,@,L 114-127 ,240,35,80,0.438,27,57,0.474,8,23,0.348,36,39,0.923,114,50,90,0.556,40,63,0.635,10,27,0.37,17,29,0.586,127,2016-12-17,NYK,DEN
1937,37,Home,W 114-101 ,240,41,81,0.506,34,65,0.523,7,16,0.438,25,34,0.735,114,39,90,0.433,31,68,0.456,8,22,0.364,15,20,0.75,101,2016-12-17,OKC,PHO
1938,38,@,W 114-108 (OT),265,37,91,0.407,20,51,0.392,17,40,0.425,23,27,0.852,114,40,87,0.46,33,60,0.55,7,27,0.259,21,29,0.724,108,2016-12-20,CLE,MIL
1939,39,Home,L 114-119 ,240,41,87,0.471,33,64,0.516,8,23,0.348,24,27,0.889,114,45,93,0.484,31,57,0.544,14,36,0.389,15,20,0.75,119,2016-12-25,NYK,BOS
1940,40,Home,W 114-80 ,240,43,82,0.524,30,60,0.5,13,22,0.591,15,20,0.75,114,25,74,0.338,21,52,0.404,4,22,0.182,26,38,0.684,80,2016-12-29,MEM,OKC
1941,41,@,L 114-117 ,240,48,90,0.533,37,62,0.597,11,28,0.393,7,10,0.7,114,38,74,0.514,21,42,0.5,17,32,0.531,24,29,0.828,117,2016-12-30,MIA,BOS
1942,42,Home,W 114-88 ,240,37,78,0.474,27,49,0.551,10,29,0.345,30,35,0.857,114,31,75,0.413,23,45,0.511,8,30,0.267,18,21,0.857,88,2016-12-31,OKC,LAC
1943,43,Home,W 114-112 (OT),265,42,92,0.457,28,64,0.438,14,28,0.5,16,27,0.593,114,42,90,0.467,33,63,0.524,9,27,0.333,19,22,0.864,112,2017-01-01,ATL,SAS
1944,44,Home,L 114-123 ,240,37,92,0.402,22,60,0.367,15,32,0.469,25,31,0.806,114,42,75,0.56,32,58,0.552,10,17,0.588,29,32,0.906,123,2017-01-01,LAL,TOR
1945,45,@,L 114-115 ,240,37,91,0.407,27,65,0.415,10,26,0.385,30,34,0.882,114,39,97,0.402,29,69,0.42,10,28,0.357,27,32,0.844,115,2017-01-05,CHA,DET
1946,46,@,L 114-121 ,240,44,92,0.478,25,49,0.51,19,43,0.442,7,9,0.778,114,40,82,0.488,23,43,0.535,17,39,0.436,24,33,0.727,121,2017-01-10,CHA,HOU
1947,47,Home,W 114-106 ,240,41,87,0.471,31,65,0.477,10,22,0.455,22,27,0.815,114,40,85,0.471,31,58,0.534,9,27,0.333,17,20,0.85,106,2017-01-10,TOR,BOS
1948,48,Home,W 114-107 ,240,41,83,0.494,34,57,0.596,7,26,0.269,25,36,0.694,114,38,82,0.463,26,48,0.542,12,34,0.353,19,27,0.704,107,2017-01-14,UTA,ORL
1949,49,@,L 114-122 ,240,36,73,0.493,30,60,0.5,6,13,0.462,36,41,0.878,114,43,84,0.512,35,66,0.53,8,18,0.444,28,35,0.8,122,2017-01-17,MIN,SAS
1950,50,Home,L 114-143 ,240,43,105,0.41,32,71,0.451,11,34,0.324,17,23,0.739,114,48,83,0.578,33,53,0.623,15,30,0.5,32,35,0.914,143,2017-01-20,NOP,BRK
1951,51,@,L 114-127 ,240,39,77,0.506,25,42,0.595,14,35,0.4,22,28,0.786,114,47,80,0.588,36,57,0.632,11,23,0.478,22,27,0.815,127,2017-01-23,HOU,MIL
1952,52,Home,L 114-119 ,240,43,94,0.457,35,67,0.522,8,27,0.296,20,26,0.769,114,43,83,0.518,26,53,0.491,17,30,0.567,16,19,0.842,119,2017-01-25,CHI,ATL
1953,53,@,W 114-109 ,240,40,75,0.533,28,49,0.571,12,26,0.462,22,25,0.88,114,42,91,0.462,35,63,0.556,7,28,0.25,18,23,0.783,109,2017-01-25,PHI,MIL
1954,54,@,W 114-105 ,240,42,91,0.462,32,64,0.5,10,27,0.37,20,28,0.714,114,41,96,0.427,30,69,0.435,11,27,0.407,12,19,0.632,105,2017-01-25,OKC,NOP
1955,55,@,W 114-113 ,240,42,79,0.532,32,56,0.571,10,23,0.435,20,26,0.769,114,36,79,0.456,24,51,0.471,12,28,0.429,29,36,0.806,113,2017-01-29,ORL,TOR
1956,56,Home,L 114-124 ,240,39,96,0.406,32,76,0.421,7,20,0.35,29,35,0.829,114,44,84,0.524,39,65,0.6,5,19,0.263,31,38,0.816,124,2017-02-01,PHO,LAC
1957,57,Home,W 114-102 ,240,38,80,0.475,25,54,0.463,13,26,0.5,25,33,0.758,114,40,83,0.482,37,64,0.578,3,19,0.158,19,22,0.864,102,2017-02-03,OKC,MEM
1958,58,@,W 114-113 ,240,42,86,0.488,31,58,0.534,11,28,0.393,19,24,0.792,114,37,75,0.493,25,47,0.532,12,28,0.429,27,32,0.844,113,2017-02-07,POR,DAL
1959,59,@,W 114-110 (OT),265,40,97,0.412,31,72,0.431,9,25,0.36,25,33,0.758,114,38,91,0.418,29,58,0.5,9,33,0.273,25,36,0.694,110,2017-02-08,WAS,BRK
1960,60,Home,L 114-122 ,240,40,76,0.526,32,48,0.667,8,28,0.286,26,31,0.839,114,39,75,0.52,24,45,0.533,15,30,0.5,29,35,0.829,122,2017-02-10,MIL,LAL
1961,61,Home,L 114-130 ,240,40,83,0.482,34,59,0.576,6,24,0.25,28,36,0.778,114,46,87,0.529,33,56,0.589,13,31,0.419,25,35,0.714,130,2017-02-11,OKC,GSW
1962,62,Home,W 114-108 (OT),265,44,107,0.411,29,70,0.414,15,37,0.405,11,12,0.917,114,38,92,0.413,31,62,0.5,7,30,0.233,25,26,0.962,108,2017-02-23,DET,CHO
1963,63,@,W 114-98 ,240,46,95,0.484,40,70,0.571,6,25,0.24,16,20,0.8,114,34,87,0.391,24,53,0.453,10,34,0.294,20,25,0.8,98,2017-02-27,ATL,BOS
1964,64,Home,W 114-109 ,240,39,79,0.494,29,54,0.537,10,25,0.4,26,35,0.743,114,34,86,0.395,23,57,0.404,11,29,0.379,30,32,0.938,109,2017-03-02,POR,OKC
1965,65,@,W 114-106 ,240,41,81,0.506,30,56,0.536,11,25,0.44,21,27,0.778,114,34,92,0.37,24,62,0.387,10,30,0.333,28,32,0.875,106,2017-03-03,TOR,WAS
1966,66,@,L 114-115 ,240,44,89,0.494,30,54,0.556,14,35,0.4,12,19,0.632,114,39,81,0.481,25,55,0.455,14,26,0.538,23,25,0.92,115,2017-03-05,ORL,WAS
1967,67,Home,W 114-104 ,240,42,84,0.5,28,55,0.509,14,29,0.483,16,21,0.762,114,42,86,0.488,35,67,0.522,7,19,0.368,13,16,0.813,104,2017-03-08,SAS,SAC
1968,68,@,W 114-98 ,240,40,78,0.513,29,48,0.604,11,30,0.367,23,28,0.821,114,37,83,0.446,30,63,0.476,7,20,0.35,17,22,0.773,98,2017-03-09,LAC,MEM
1969,69,Home,W 114-108 (OT),265,40,88,0.455,34,67,0.507,6,21,0.286,28,33,0.848,114,41,94,0.436,30,65,0.462,11,29,0.379,15,20,0.75,108,2017-03-09,POR,PHI
1970,70,Home,W 113-93 ,240,45,80,0.563,45,75,0.6,0,5,0.0,23,33,0.697,113,34,79,0.43,23,50,0.46,11,29,0.379,14,18,0.778,93,2011-12-30,MEM,HOU
1971,71,Home,W 113-96 ,240,50,91,0.549,48,83,0.578,2,8,0.25,11,16,0.688,113,34,83,0.41,25,59,0.424,9,24,0.375,19,23,0.826,96,2012-01-03,MEM,SAC
1972,72,Home,W 113-105 ,240,45,76,0.592,42,66,0.636,3,10,0.3,20,29,0.69,113,35,78,0.449,31,58,0.534,4,20,0.2,31,43,0.721,105,2012-01-10,UTA,CLE
1973,73,Home,W 113-92 ,240,44,81,0.543,37,65,0.569,7,16,0.438,18,21,0.857,113,37,83,0.446,29,68,0.426,8,15,0.533,10,15,0.667,92,2012-01-21,MIA,PHI
1974,74,Home,W 113-86 ,240,42,70,0.6,33,52,0.635,9,18,0.5,20,25,0.8,113,32,71,0.451,29,62,0.468,3,9,0.333,19,25,0.76,86,2012-01-31,NYK,DET
1975,75,@,W 113-90 ,240,48,90,0.533,34,60,0.567,14,30,0.467,3,4,0.75,113,37,93,0.398,36,81,0.444,1,12,0.083,15,19,0.789,90,2012-02-04,CHI,MIL
1976,76,@,W 113-112 (OT),265,40,98,0.408,32,74,0.432,8,24,0.333,25,31,0.806,113,43,88,0.489,35,71,0.493,8,17,0.471,18,32,0.563,112,2012-02-10,MIL,CLE
1977,77,@,W 113-109 ,240,43,87,0.494,38,70,0.543,5,17,0.294,22,33,0.667,113,42,79,0.532,34,57,0.596,8,22,0.364,17,22,0.773,109,2012-02-11,DEN,IND
1978,78,@,W 113-106 ,240,41,76,0.539,33,57,0.579,8,19,0.421,23,25,0.92,113,47,86,0.547,44,75,0.587,3,11,0.273,9,14,0.643,106,2012-02-15,SAS,TOR
1979,79,@,W 113-111 ,240,41,84,0.488,36,67,0.537,5,17,0.294,26,37,0.703,113,42,81,0.519,35,70,0.5,7,11,0.636,20,22,0.909,111,2012-03-23,PHO,IND
1980,80,Home,W 113-106 (OT),265,43,89,0.483,39,69,0.565,4,20,0.2,23,27,0.852,113,41,96,0.427,36,78,0.462,5,18,0.278,19,26,0.731,106,2012-03-26,HOU,SAC
1981,81,@,W 113-101 ,240,44,77,0.571,39,63,0.619,5,14,0.357,20,24,0.833,113,39,72,0.542,34,58,0.586,5,14,0.357,18,19,0.947,101,2012-03-30,MIA,TOR
1982,82,@,W 113-108 ,240,43,83,0.518,37,67,0.552,6,16,0.375,21,30,0.7,113,43,95,0.453,34,70,0.486,9,25,0.36,13,20,0.65,108,2012-04-04,LAL,LAC
1983,83,@,W 113-85 ,240,40,83,0.482,29,58,0.5,11,25,0.44,22,26,0.846,113,32,82,0.39,29,73,0.397,3,9,0.333,18,22,0.818,85,2012-04-09,WAS,CHA
1984,84,Home,W 113-107 ,240,41,82,0.5,32,60,0.533,9,22,0.409,22,31,0.71,113,42,84,0.5,34,60,0.567,8,24,0.333,15,18,0.833,107,2012-04-11,DEN,MIN
1985,85,@,W 113-97 ,240,45,87,0.517,40,72,0.556,5,15,0.333,18,22,0.818,113,37,78,0.474,34,68,0.5,3,10,0.3,20,24,0.833,97,2012-04-13,MIL,DET
1986,86,Home,W 113-100 ,240,48,90,0.533,37,72,0.514,11,18,0.611,6,6,1.0,113,40,80,0.5,31,62,0.5,9,18,0.5,11,15,0.733,100,2012-04-16,ORL,PHI
1987,87,@,W 113-112 ,240,43,79,0.544,31,60,0.517,12,19,0.632,15,20,0.75,113,41,76,0.539,26,53,0.491,15,23,0.652,15,23,0.652,112,2012-04-22,NYK,ATL
1988,88,Home,W 113-96 ,240,47,92,0.511,41,77,0.532,6,15,0.4,13,18,0.722,113,41,91,0.451,34,76,0.447,7,15,0.467,7,9,0.778,96,2012-04-26,SAC,LAL
1989,89,Home,W 113-94 ,240,38,89,0.427,32,75,0.427,6,14,0.429,31,42,0.738,113,32,85,0.376,21,63,0.333,11,22,0.5,19,26,0.731,94,2012-10-31,UTA,DAL
1990,90,@,W 113-110 ,240,45,89,0.506,35,68,0.515,10,21,0.476,13,20,0.65,113,36,80,0.45,24,46,0.522,12,34,0.353,26,33,0.788,110,2012-11-12,MIA,HOU
1991,91,@,L 113-117 ,240,41,77,0.532,31,56,0.554,10,21,0.476,21,22,0.955,113,43,93,0.462,30,68,0.441,13,25,0.52,18,24,0.75,117,2012-11-17,NOP,MIL
1992,92,Home,W 113-106 (OT),265,41,86,0.477,33,68,0.485,8,18,0.444,23,33,0.697,113,46,109,0.422,41,80,0.513,5,29,0.172,9,12,0.75,106,2012-11-21,MIA,MIL
1993,93,Home,W 113-97 ,240,44,81,0.543,37,66,0.561,7,15,0.467,18,22,0.818,113,29,65,0.446,17,39,0.436,12,26,0.462,27,39,0.692,97,2012-11-21,SAC,LAL
1994,94,@,W 113-111 ,240,41,85,0.482,31,62,0.5,10,23,0.435,21,22,0.955,113,38,78,0.487,26,58,0.448,12,20,0.6,23,32,0.719,111,2012-11-30,CLE,ATL
1995,95,@,W 113-103 ,240,43,86,0.5,35,63,0.556,8,23,0.348,19,20,0.95,113,36,86,0.419,30,69,0.435,6,17,0.353,25,39,0.641,103,2012-12-02,ORL,LAL
1996,96,Home,W 113-110 ,240,40,85,0.471,34,70,0.486,6,15,0.4,27,43,0.628,113,42,86,0.488,33,58,0.569,9,28,0.321,17,19,0.895,110,2012-12-03,DEN,TOR
1997,97,Home,W 113-90 ,240,43,75,0.573,29,46,0.63,14,29,0.483,13,23,0.565,113,34,79,0.43,28,58,0.483,6,21,0.286,16,20,0.8,90,2012-12-13,ATL,CHA
1998,98,@,W 113-102 ,240,47,88,0.534,40,71,0.563,7,17,0.412,12,17,0.706,113,42,78,0.538,31,54,0.574,11,24,0.458,7,10,0.7,102,2012-12-14,MIN,NOH
1999,99,Home,W 113-103 ,240,41,83,0.494,32,62,0.516,9,21,0.429,22,22,1.0,113,34,75,0.453,27,56,0.482,7,19,0.368,28,31,0.903,103,2012-12-14,OKC,SAC
2000,0,@,W 113-99 ,240,39,75,0.52,27,51,0.529,12,24,0.5,23,27,0.852,113,36,70,0.514,29,54,0.537,7,16,0.438,20,30,0.667,99,2012-12-18,TOR,CLE
2001,1,Home,L 113-115 (2OT),290,43,91,0.473,34,73,0.466,9,18,0.5,18,31,0.581,113,41,89,0.461,33,65,0.508,8,24,0.333,25,36,0.694,115,2013-01-04,WAS,BRK
2002,2,Home,W 113-93 ,240,44,85,0.518,37,61,0.607,7,24,0.292,18,21,0.857,113,36,90,0.4,30,71,0.423,6,19,0.316,15,23,0.652,93,2013-01-05,BRK,SAC
2003,3,@,W 113-81 ,240,39,80,0.488,28,60,0.467,11,20,0.55,24,27,0.889,113,28,76,0.368,23,55,0.418,5,21,0.238,20,23,0.87,81,2013-01-07,MEM,SAC
2004,4,Home,W 113-93 ,240,40,69,0.58,27,44,0.614,13,25,0.52,20,27,0.741,113,39,95,0.411,35,74,0.473,4,21,0.19,11,12,0.917,93,2013-01-13,LAL,CLE
2005,5,Home,W 113-98 ,240,46,77,0.597,40,64,0.625,6,13,0.462,15,16,0.938,113,35,85,0.412,29,65,0.446,6,20,0.3,22,29,0.759,98,2013-01-14,DAL,MIN
2006,6,Home,W 113-106 ,240,40,81,0.494,32,60,0.533,8,21,0.381,25,28,0.893,113,40,82,0.488,33,69,0.478,7,13,0.538,19,23,0.826,106,2013-01-15,BRK,TOR
2007,7,Home,W 113-108 ,240,45,86,0.523,39,71,0.549,6,15,0.4,17,22,0.773,113,43,92,0.467,29,64,0.453,14,28,0.5,8,13,0.615,108,2013-01-25,CLE,MIL
2008,8,@,W 113-107 ,240,43,89,0.483,34,66,0.515,9,23,0.391,18,24,0.75,113,42,91,0.462,36,73,0.493,6,18,0.333,17,18,0.944,107,2013-01-25,SAS,DAL
2009,9,Home,W 113-97 ,240,47,82,0.573,33,48,0.688,14,34,0.412,5,8,0.625,113,38,77,0.494,31,51,0.608,7,26,0.269,14,16,0.875,97,2013-01-30,NYK,ORL
2010,10,Home,W 113-98 ,240,44,84,0.524,37,62,0.597,7,22,0.318,18,22,0.818,113,38,72,0.528,34,59,0.576,4,13,0.308,18,21,0.857,98,2013-02-01,DEN,NOH
2011,11,Home,W 113-93 ,240,45,89,0.506,36,70,0.514,9,19,0.474,14,20,0.7,113,35,86,0.407,30,71,0.423,5,15,0.333,18,24,0.75,93,2013-02-02,GSW,PHO
2012,12,Home,W 113-111 (OT),265,43,91,0.473,33,72,0.458,10,19,0.526,17,23,0.739,113,46,96,0.479,39,76,0.513,7,20,0.35,12,18,0.667,111,2013-02-19,BRK,MIL
2013,13,Home,W 113-99 ,240,42,83,0.506,35,61,0.574,7,22,0.318,22,31,0.71,113,39,82,0.476,30,62,0.484,9,20,0.45,12,20,0.6,99,2013-02-20,LAL,BOS
2014,14,@,W 113-88 ,240,44,79,0.557,34,57,0.596,10,22,0.455,15,23,0.652,113,35,84,0.417,31,65,0.477,4,19,0.211,14,23,0.609,88,2013-02-22,BOS,PHO
2015,15,@,L 113-119 ,240,39,81,0.481,35,59,0.593,4,22,0.182,31,37,0.838,113,42,88,0.477,31,64,0.484,11,24,0.458,24,33,0.727,119,2013-02-22,DEN,WAS
2016,16,@,W 113-99 ,240,44,83,0.53,37,64,0.578,7,19,0.368,18,22,0.818,113,37,82,0.451,35,71,0.493,2,11,0.182,23,30,0.767,99,2013-02-23,DEN,CHA
2017,17,Home,L 113-120 ,240,39,85,0.459,27,54,0.5,12,31,0.387,23,28,0.821,113,46,85,0.541,38,69,0.551,8,16,0.5,20,32,0.625,120,2013-03-05,SAC,DEN
2018,18,Home,W 113-84 ,240,38,75,0.507,25,43,0.581,13,32,0.406,24,30,0.8,113,30,78,0.385,22,52,0.423,8,26,0.308,16,21,0.762,84,2013-03-09,NYK,UTA
2019,19,Home,L 113-115 ,240,44,94,0.468,38,72,0.528,6,22,0.273,19,25,0.76,113,40,87,0.46,33,68,0.485,7,19,0.368,28,38,0.737,115,2013-03-10,SAC,MIL
2020,20,@,W 113-95 ,240,43,83,0.518,35,67,0.522,8,16,0.5,19,22,0.864,113,34,76,0.447,31,62,0.5,3,14,0.214,24,30,0.8,95,2013-03-15,CHI,GSW
2021,21,@,L 113-119 ,240,43,85,0.506,36,70,0.514,7,15,0.467,20,31,0.645,113,45,78,0.577,39,61,0.639,6,17,0.353,23,29,0.793,119,2013-03-16,CLE,SAS
2022,22,Home,W 113-102 ,240,41,72,0.569,29,44,0.659,12,28,0.429,19,29,0.655,113,42,96,0.438,32,65,0.492,10,31,0.323,8,8,1.0,102,2013-03-17,LAL,SAC
2023,23,Home,L 113-127 ,240,42,75,0.56,34,54,0.63,8,21,0.381,21,29,0.724,113,51,89,0.573,38,67,0.567,13,22,0.591,12,14,0.857,127,2013-03-18,ATL,DAL
2024,24,@,W 113-96 ,240,45,89,0.506,38,68,0.559,7,21,0.333,16,21,0.762,113,40,80,0.5,33,61,0.541,7,19,0.368,9,15,0.6,96,2013-03-20,BRK,DAL
2025,25,Home,W 113-108 ,240,38,70,0.543,29,52,0.558,9,18,0.5,28,33,0.848,113,42,82,0.512,35,65,0.538,7,17,0.412,17,21,0.81,108,2013-03-24,DAL,UTA
2026,26,Home,W 113-103 ,240,45,93,0.484,38,74,0.514,7,19,0.368,16,22,0.727,113,34,77,0.442,29,57,0.509,5,20,0.25,30,39,0.769,103,2013-03-28,MIL,LAL
2027,27,@,W 113-95 ,240,43,76,0.566,33,55,0.6,10,21,0.476,17,22,0.773,113,34,89,0.382,30,75,0.4,4,14,0.286,23,26,0.885,95,2013-04-03,BRK,CLE
2028,28,@,W 113-96 ,240,41,73,0.562,34,55,0.618,7,18,0.389,24,32,0.75,113,39,84,0.464,33,64,0.516,6,20,0.3,12,18,0.667,96,2013-04-03,DEN,UTA
2029,29,Home,W 113-103 (OT),265,51,109,0.468,43,94,0.457,8,15,0.533,3,8,0.375,113,39,101,0.386,31,73,0.425,8,28,0.286,17,26,0.654,103,2013-04-10,ORL,MIL
2030,30,@,W 113-106 ,240,43,73,0.589,37,54,0.685,6,19,0.316,21,24,0.875,113,38,85,0.447,26,59,0.441,12,26,0.462,18,20,0.9,106,2013-04-10,LAL,POR
2031,31,Home,W 113-93 ,240,43,83,0.518,31,65,0.477,12,18,0.667,15,20,0.75,113,35,78,0.449,26,54,0.481,9,24,0.375,14,17,0.824,93,2013-04-12,DET,CHA
2032,32,@,W 113-96 ,240,40,78,0.513,30,51,0.588,10,27,0.37,23,27,0.852,113,35,88,0.398,26,60,0.433,9,28,0.321,17,23,0.739,96,2013-04-16,TOR,ATL
2033,33,Home,W 113-102 ,240,39,78,0.5,30,54,0.556,9,24,0.375,26,33,0.788,113,34,78,0.436,24,53,0.453,10,25,0.4,24,32,0.75,102,2013-10-30,DET,WAS
2034,34,@,W 113-98 ,240,44,103,0.427,30,81,0.37,14,22,0.636,11,15,0.733,113,36,99,0.364,30,81,0.37,6,18,0.333,20,34,0.588,98,2013-11-01,POR,DEN
2035,35,Home,W 113-105 ,240,34,73,0.466,23,44,0.523,11,29,0.379,34,51,0.667,113,38,100,0.38,29,73,0.397,9,27,0.333,20,25,0.8,105,2013-11-01,HOU,DAL
2036,36,@,W 113-90 ,240,44,90,0.489,34,70,0.486,10,20,0.5,15,19,0.789,113,35,92,0.38,25,66,0.379,10,26,0.385,10,18,0.556,90,2013-11-10,MIN,LAL
2037,37,Home,W 113-95 ,240,42,70,0.6,34,54,0.63,8,16,0.5,21,26,0.808,113,37,87,0.425,34,69,0.493,3,18,0.167,18,27,0.667,95,2013-11-12,GSW,DET
2038,38,Home,W 113-103 ,240,39,81,0.481,29,58,0.5,10,23,0.435,25,31,0.806,113,40,86,0.465,35,67,0.522,5,19,0.263,18,23,0.783,103,2013-11-15,ATL,PHI
2039,39,@,L 113-117 ,240,46,94,0.489,40,72,0.556,6,22,0.273,15,19,0.789,113,47,97,0.485,40,77,0.519,7,20,0.35,16,21,0.762,117,2013-11-15,MIN,DEN
2040,40,@,L 113-115 ,240,40,83,0.482,32,60,0.533,8,23,0.348,25,43,0.581,113,38,93,0.409,25,66,0.379,13,27,0.481,26,32,0.813,115,2013-11-18,DEN,OKC
2041,41,@,W 113-106 ,240,37,80,0.463,30,63,0.476,7,17,0.412,32,38,0.842,113,38,85,0.447,23,52,0.442,15,33,0.455,15,22,0.682,106,2013-11-20,SAC,PHO
2042,42,@,W 113-101 ,240,37,86,0.43,27,65,0.415,10,21,0.476,29,35,0.829,113,36,77,0.468,29,60,0.483,7,17,0.412,22,30,0.733,101,2013-11-23,POR,GSW
2043,43,Home,W 113-94 ,240,43,80,0.538,31,51,0.608,12,29,0.414,15,23,0.652,113,33,73,0.452,27,54,0.5,6,19,0.316,22,26,0.846,94,2013-11-25,DET,MIL
2044,44,Home,W 113-84 ,240,43,78,0.551,29,51,0.569,14,27,0.519,13,21,0.619,113,32,75,0.427,24,53,0.453,8,22,0.364,12,15,0.8,84,2013-11-27,HOU,ATL
2045,45,Home,W 113-112 (OT),265,36,92,0.391,30,74,0.405,6,18,0.333,35,42,0.833,113,42,95,0.442,34,69,0.493,8,26,0.308,20,29,0.69,112,2013-11-29,OKC,GSW
2046,46,Home,W 113-103 ,240,49,87,0.563,40,68,0.588,9,19,0.474,6,9,0.667,113,37,89,0.416,28,60,0.467,9,29,0.31,20,26,0.769,103,2013-12-01,OKC,MIN
2047,47,Home,L 113-115 ,240,40,76,0.526,31,57,0.544,9,19,0.474,24,28,0.857,113,42,82,0.512,27,57,0.474,15,25,0.6,16,22,0.727,115,2013-12-01,SAC,GSW
2048,48,@,W 113-83 ,240,44,77,0.571,28,50,0.56,16,27,0.593,9,11,0.818,113,29,73,0.397,25,57,0.439,4,16,0.25,21,31,0.677,83,2013-12-05,NYK,BRK
2049,49,@,W 113-97 ,240,39,69,0.565,30,48,0.625,9,21,0.429,26,31,0.839,113,40,81,0.494,37,67,0.552,3,14,0.214,14,20,0.7,97,2013-12-14,LAC,WAS
2050,50,@,W 113-107 ,240,38,88,0.432,26,68,0.382,12,20,0.6,25,30,0.833,113,39,74,0.527,30,53,0.566,9,21,0.429,20,24,0.833,107,2013-12-18,WAS,BRK
2051,51,@,W 113-100 ,240,43,88,0.489,31,61,0.508,12,27,0.444,15,18,0.833,113,35,82,0.427,26,63,0.413,9,19,0.474,21,26,0.808,100,2013-12-21,OKC,SAS
2052,52,@,W 113-100 ,240,41,83,0.494,33,66,0.5,8,17,0.471,23,27,0.852,113,31,74,0.419,24,57,0.421,7,17,0.412,31,42,0.738,100,2013-12-23,NOP,SAC
2053,53,Home,W 113-92 ,240,40,78,0.513,31,58,0.534,9,20,0.45,24,28,0.857,113,37,84,0.44,32,69,0.464,5,15,0.333,13,15,0.867,92,2013-12-31,SAS,BRK
2054,54,@,W 113-104 ,240,42,90,0.467,37,71,0.521,5,19,0.263,24,31,0.774,113,35,83,0.422,28,60,0.467,7,23,0.304,27,37,0.73,104,2014-01-02,PHI,SAC
2055,55,@,W 113-103 ,240,45,83,0.542,36,68,0.529,9,15,0.6,14,23,0.609,113,42,92,0.457,36,75,0.48,6,17,0.353,13,19,0.684,103,2014-01-04,CHA,SAC
2056,56,Home,W 113-99 ,240,39,86,0.453,32,58,0.552,7,28,0.25,28,50,0.56,113,36,88,0.409,29,64,0.453,7,24,0.292,20,25,0.8,99,2014-01-08,HOU,LAL
2057,57,@,W 113-102 ,240,45,83,0.542,38,69,0.551,7,14,0.5,16,20,0.8,113,39,81,0.481,30,61,0.492,9,20,0.45,15,27,0.556,102,2014-01-10,CLE,UTA
2058,58,@,L 113-126 ,240,44,97,0.454,36,72,0.5,8,25,0.32,17,22,0.773,113,45,86,0.523,29,53,0.547,16,33,0.485,20,24,0.833,126,2014-01-20,POR,HOU
2059,59,@,W 113-111 (OT),265,41,89,0.461,26,55,0.473,15,34,0.441,16,23,0.696,113,42,94,0.447,35,72,0.486,7,22,0.318,20,27,0.741,111,2014-01-22,BOS,WAS
2060,60,Home,W 113-101 ,240,43,74,0.581,35,55,0.636,8,19,0.421,19,20,0.95,113,38,76,0.5,32,54,0.593,6,22,0.273,19,23,0.826,101,2014-01-26,MIA,SAS
2061,61,Home,L 113-124 ,240,40,87,0.46,32,67,0.478,8,20,0.4,25,26,0.962,113,43,80,0.538,34,60,0.567,9,20,0.45,29,35,0.829,124,2014-01-27,PHI,PHO
2062,62,Home,W 113-102 ,240,43,83,0.518,36,67,0.537,7,16,0.438,20,25,0.8,113,39,87,0.448,29,66,0.439,10,21,0.476,14,24,0.583,102,2014-01-31,ORL,MIL
2063,63,@,L 113-120 ,240,37,84,0.44,31,68,0.456,6,16,0.375,33,39,0.846,113,43,92,0.467,34,69,0.493,9,23,0.391,25,30,0.833,120,2014-02-01,MIN,ATL
2064,64,Home,W 113-96 ,240,41,92,0.446,34,67,0.507,7,25,0.28,24,40,0.6,113,38,89,0.427,33,68,0.485,5,21,0.238,15,23,0.652,96,2014-02-01,DET,PHI
2065,65,@,L 113-118 (OT),265,45,104,0.433,38,84,0.452,7,20,0.35,16,20,0.8,113,42,92,0.457,37,79,0.468,5,13,0.385,29,35,0.829,118,2014-02-07,POR,IND
2066,66,Home,L 113-115 ,240,43,85,0.506,32,65,0.492,11,20,0.55,16,23,0.696,113,40,77,0.519,34,62,0.548,6,15,0.4,29,33,0.879,115,2014-02-07,WAS,CLE
2067,67,Home,W 113-112 ,240,34,64,0.531,24,42,0.571,10,22,0.455,35,47,0.745,113,44,97,0.454,28,65,0.431,16,32,0.5,8,16,0.5,112,2014-02-12,HOU,WAS
2068,68,@,W 113-103 ,240,44,88,0.5,35,68,0.515,9,20,0.45,16,21,0.762,113,35,81,0.432,29,60,0.483,6,21,0.286,27,38,0.711,103,2014-02-18,SAS,LAC
2069,69,@,W 113-102 ,240,44,90,0.489,36,67,0.537,8,23,0.348,17,22,0.773,113,40,82,0.488,38,71,0.535,2,11,0.182,20,30,0.667,102,2014-02-22,DAL,DET
2070,70,Home,W 113-107 ,240,38,77,0.494,28,55,0.509,10,22,0.455,27,32,0.844,113,41,80,0.513,31,64,0.484,10,16,0.625,15,20,0.75,107,2014-02-28,OKC,MEM
2071,71,Home,W 113-107 ,240,45,85,0.529,35,63,0.556,10,22,0.455,13,21,0.619,113,36,75,0.48,26,54,0.481,10,21,0.476,25,28,0.893,107,2014-03-09,GSW,PHO
2072,72,@,L 113-118 (OT),265,39,96,0.406,30,71,0.423,9,25,0.36,26,33,0.788,113,38,89,0.427,29,60,0.483,9,29,0.31,33,45,0.733,118,2014-03-09,POR,HOU
2073,73,Home,W 113-104 ,240,40,78,0.513,31,56,0.554,9,22,0.409,24,29,0.828,113,37,75,0.493,28,52,0.538,9,23,0.391,21,28,0.75,104,2014-03-16,MIA,HOU
2074,74,@,W 113-112 ,240,42,88,0.477,31,58,0.534,11,30,0.367,18,22,0.818,113,37,88,0.42,25,60,0.417,12,28,0.429,26,30,0.867,112,2014-03-16,GSW,POR
2075,75,Home,L 113-121 ,240,42,85,0.494,35,62,0.565,7,23,0.304,22,25,0.88,113,38,75,0.507,27,52,0.519,11,23,0.478,34,38,0.895,121,2014-03-16,TOR,PHO
2076,76,@,L 113-118 (OT),265,40,81,0.494,33,57,0.579,7,24,0.292,26,29,0.897,113,40,94,0.426,29,60,0.483,11,34,0.324,27,31,0.871,118,2014-03-18,TOR,ATL
2077,77,Home,W 113-91 ,240,44,79,0.557,31,52,0.596,13,27,0.481,12,16,0.75,113,36,88,0.409,25,55,0.455,11,33,0.333,8,18,0.444,91,2014-03-24,SAS,PHI
2078,78,@,W 113-107 ,240,41,82,0.5,27,53,0.509,14,29,0.483,17,20,0.85,113,39,91,0.429,33,64,0.516,6,27,0.222,23,29,0.793,107,2014-04-03,DAL,LAC
2079,79,Home,W 113-108 ,240,43,79,0.544,40,67,0.597,3,12,0.25,24,38,0.632,113,40,86,0.465,31,62,0.5,9,24,0.375,19,26,0.731,108,2014-04-14,PHI,BOS
2080,80,@,W 113-100 ,240,45,91,0.495,34,64,0.531,11,27,0.407,12,17,0.706,113,41,99,0.414,31,69,0.449,10,30,0.333,8,10,0.8,100,2014-04-16,LAL,SAS
2081,81,@,L 113-118 ,240,45,102,0.441,34,71,0.479,11,31,0.355,12,16,0.75,113,44,82,0.537,30,57,0.526,14,25,0.56,16,20,0.8,118,2014-11-03,BOS,DAL
2082,82,@,W 113-100 ,240,46,93,0.495,36,68,0.529,10,25,0.4,11,15,0.733,113,38,70,0.543,31,50,0.62,7,20,0.35,17,20,0.85,100,2014-11-11,SAS,GSW
2083,83,Home,L 113-130 ,240,39,90,0.433,31,67,0.463,8,23,0.348,27,33,0.818,113,45,88,0.511,29,55,0.527,16,33,0.485,24,29,0.828,130,2014-11-12,DEN,POR
2084,84,@,W 113-101 ,240,43,89,0.483,30,61,0.492,13,28,0.464,14,19,0.737,113,36,81,0.444,30,69,0.435,6,12,0.5,23,30,0.767,101,2014-11-12,HOU,MIN
2085,85,@,L 113-117 ,240,44,80,0.55,33,55,0.6,11,25,0.44,14,19,0.737,113,43,78,0.551,34,61,0.557,9,17,0.529,22,27,0.815,117,2014-11-18,NYK,MIL
2086,86,@,W 113-101 ,240,40,81,0.494,32,55,0.582,8,26,0.308,25,30,0.833,113,37,90,0.411,31,73,0.425,6,17,0.353,21,27,0.778,101,2014-11-22,SAC,MIN
2087,87,@,W 113-92 ,240,45,88,0.511,30,56,0.536,15,32,0.469,8,10,0.8,113,31,75,0.413,29,55,0.527,2,20,0.1,28,35,0.8,92,2014-11-24,LAC,CHO
2088,88,Home,W 113-87 ,240,38,74,0.514,32,54,0.593,6,20,0.3,31,38,0.816,113,33,71,0.465,28,58,0.483,5,13,0.385,16,22,0.727,87,2014-11-26,CLE,WAS
2089,89,Home,W 113-96 ,240,46,90,0.511,38,70,0.543,8,20,0.4,13,22,0.591,113,38,92,0.413,32,76,0.421,6,16,0.375,14,19,0.737,96,2014-12-05,BOS,LAL
2090,90,@,W 113-109 (OT),265,38,95,0.4,23,51,0.451,15,44,0.341,22,31,0.71,113,39,84,0.464,31,66,0.47,8,18,0.444,23,34,0.676,109,2014-12-11,HOU,SAC
2091,91,Home,W 113-107 (2OT),290,39,85,0.459,33,72,0.458,6,13,0.462,29,38,0.763,113,41,98,0.418,35,81,0.432,6,17,0.353,19,27,0.704,107,2014-12-12,MEM,CHO
2092,92,Home,W 113-91 ,240,43,80,0.538,31,56,0.554,12,24,0.5,15,20,0.75,113,35,83,0.422,27,56,0.482,8,27,0.296,13,22,0.591,91,2014-12-15,LAC,DET
2093,93,Home,W 113-93 ,240,42,86,0.488,32,62,0.516,10,24,0.417,19,25,0.76,113,36,92,0.391,31,76,0.408,5,16,0.313,16,21,0.762,93,2014-12-25,CHI,LAL
2094,94,@,W 113-111 ,240,46,96,0.479,41,70,0.586,5,26,0.192,16,19,0.842,113,44,92,0.478,37,75,0.493,7,17,0.412,16,19,0.842,111,2015-01-07,PHO,MIN
2095,95,@,W 113-99 ,240,41,86,0.477,25,46,0.543,16,40,0.4,15,20,0.75,113,39,84,0.464,34,63,0.54,5,21,0.238,16,18,0.889,99,2015-01-12,HOU,BRK
2096,96,@,L 113-120 ,240,42,83,0.506,33,57,0.579,9,26,0.346,20,23,0.87,113,44,90,0.489,35,64,0.547,9,26,0.346,23,26,0.885,120,2015-01-14,HOU,ORL
2097,97,@,W 113-105 ,240,43,80,0.538,35,61,0.574,8,19,0.421,19,21,0.905,113,38,92,0.413,28,61,0.459,10,31,0.323,19,22,0.864,105,2015-01-17,MIN,DEN
2098,98,@,L 113-126 ,240,37,87,0.425,24,55,0.436,13,32,0.406,26,31,0.839,113,49,98,0.5,36,69,0.522,13,29,0.448,15,18,0.833,126,2015-01-21,HOU,GSW
2099,99,@,L 113-118 ,240,39,87,0.448,26,55,0.473,13,32,0.406,22,28,0.786,113,47,92,0.511,38,65,0.585,9,27,0.333,15,24,0.625,118,2015-01-21,POR,PHO
2100,0,Home,W 113-106 ,240,43,91,0.473,33,66,0.5,10,25,0.4,17,21,0.81,113,44,87,0.506,37,60,0.617,7,27,0.259,11,19,0.579,106,2015-01-23,NYK,ORL
2101,1,@,W 113-111 ,240,44,84,0.524,34,57,0.596,10,27,0.37,15,20,0.75,113,42,91,0.462,32,61,0.525,10,30,0.333,17,24,0.708,111,2015-01-23,HOU,PHO
2102,2,@,W 113-111 (OT),265,42,98,0.429,34,69,0.493,8,29,0.276,21,23,0.913,113,48,113,0.425,39,80,0.488,9,33,0.273,6,12,0.5,111,2015-01-27,CHI,GSW
2103,3,Home,W 113-102 ,240,38,82,0.463,26,49,0.531,12,33,0.364,25,26,0.962,113,39,87,0.448,30,63,0.476,9,24,0.375,15,18,0.833,102,2015-01-28,ATL,BRK
2104,4,Home,W 113-105 (OT),265,41,82,0.5,30,56,0.536,11,26,0.423,20,22,0.909,113,39,93,0.419,30,65,0.462,9,28,0.321,18,25,0.72,105,2015-02-04,MIL,LAL
2105,5,Home,L 113-116 ,240,40,89,0.449,32,65,0.492,8,24,0.333,25,28,0.893,113,40,83,0.482,29,63,0.46,11,20,0.55,25,30,0.833,116,2015-02-06,OKC,NOP
2106,6,Home,W 113-93 ,240,44,78,0.564,34,53,0.642,10,25,0.4,15,19,0.789,113,34,84,0.405,25,60,0.417,9,24,0.375,16,20,0.8,93,2015-02-11,CLE,MIA
2107,7,Home,W 113-98 ,240,42,92,0.457,33,69,0.478,9,23,0.391,20,26,0.769,113,37,85,0.435,29,54,0.537,8,31,0.258,16,22,0.727,98,2015-02-12,CHI,CLE
2108,8,Home,W 113-102 ,240,39,94,0.415,27,56,0.482,12,38,0.316,23,34,0.676,113,31,93,0.333,26,75,0.347,5,18,0.278,35,39,0.897,102,2015-02-23,HOU,MIN
2109,9,@,L 113-117 (OT),265,39,101,0.386,31,77,0.403,8,24,0.333,27,30,0.9,113,48,97,0.495,39,71,0.549,9,26,0.346,12,21,0.571,117,2015-02-26,OKC,PHO
2110,10,@,W 113-89 ,240,42,87,0.483,29,59,0.492,13,28,0.464,16,19,0.842,113,31,77,0.403,27,55,0.491,4,22,0.182,23,28,0.821,89,2015-02-27,GSW,TOR
2111,11,@,L 113-121 ,240,43,88,0.489,29,61,0.475,14,27,0.519,13,17,0.765,113,46,85,0.541,42,78,0.538,4,7,0.571,25,31,0.806,121,2015-03-07,POR,MIN
2112,12,@,W 113-106 ,240,40,85,0.471,32,65,0.492,8,20,0.4,25,30,0.833,113,42,93,0.452,36,75,0.48,6,18,0.333,16,26,0.615,106,2015-03-11,SAC,CHO
2113,13,Home,W 113-99 ,240,44,101,0.436,33,77,0.429,11,24,0.458,14,14,1.0,113,34,78,0.436,31,66,0.47,3,12,0.25,28,31,0.903,99,2015-03-13,OKC,MIN
2114,14,Home,W 113-97 ,240,43,81,0.531,30,55,0.545,13,26,0.5,14,17,0.824,113,35,77,0.455,29,58,0.5,6,19,0.316,21,28,0.75,97,2015-03-14,WAS,SAC
2115,15,@,W 113-97 ,240,45,86,0.523,32,57,0.561,13,29,0.448,10,16,0.625,113,37,78,0.474,32,60,0.533,5,18,0.278,18,23,0.783,97,2015-03-15,POR,TOR
2116,16,Home,W 113-99 ,240,45,86,0.523,33,63,0.524,12,23,0.522,11,17,0.647,113,37,86,0.43,31,67,0.463,6,19,0.316,19,23,0.826,99,2015-03-20,LAC,WAS
2117,17,@,W 113-111 (OT),265,40,82,0.488,30,61,0.492,10,21,0.476,23,30,0.767,113,39,96,0.406,29,66,0.439,10,30,0.333,23,38,0.605,111,2015-03-30,LAL,PHI
2118,18,@,W 113-92 ,240,44,78,0.564,35,62,0.565,9,16,0.563,16,21,0.762,113,37,83,0.446,32,67,0.478,5,16,0.313,13,21,0.619,92,2015-04-01,NOP,LAL
2119,19,@,W 113-99 ,240,42,76,0.553,29,46,0.63,13,30,0.433,16,23,0.696,113,41,77,0.532,36,63,0.571,5,14,0.357,12,19,0.632,99,2015-04-01,TOR,MIN
2120,20,@,W 113-88 ,240,47,89,0.528,37,65,0.569,10,24,0.417,9,13,0.692,113,34,84,0.405,29,65,0.446,5,19,0.263,15,28,0.536,88,2015-04-07,SAS,OKC
2121,21,@,W 113-103 ,240,36,80,0.45,28,52,0.538,8,28,0.286,33,34,0.971,113,45,84,0.536,38,66,0.576,7,18,0.389,6,10,0.6,103,2015-04-08,BOS,DET
2122,22,@,W 113-86 ,240,44,88,0.5,32,58,0.552,12,30,0.4,13,17,0.765,113,32,87,0.368,29,75,0.387,3,12,0.25,19,22,0.864,86,2015-04-13,CHI,BRK
2123,23,Home,W 113-108 (OT),265,43,91,0.473,27,61,0.443,16,30,0.533,11,17,0.647,113,42,97,0.433,34,75,0.453,8,22,0.364,16,21,0.762,108,2015-04-15,CLE,WAS
2124,24,Home,L 113-138 ,240,39,84,0.464,33,65,0.508,6,19,0.316,29,35,0.829,113,52,95,0.547,40,67,0.597,12,28,0.429,22,31,0.71,138,2015-04-15,MIN,OKC
2125,25,@,W 113-103 ,240,36,82,0.439,25,56,0.446,11,26,0.423,30,35,0.857,113,32,85,0.376,25,59,0.424,7,26,0.269,32,41,0.78,103,2015-10-30,TOR,BOS
2126,26,Home,L 113-118 ,240,42,82,0.512,35,58,0.603,7,24,0.292,22,28,0.786,113,35,68,0.515,23,47,0.489,12,21,0.571,36,44,0.818,118,2015-10-30,MIL,WAS
2127,27,@,W 113-101 ,240,46,82,0.561,39,67,0.582,7,15,0.467,14,18,0.778,113,39,88,0.443,30,66,0.455,9,22,0.409,14,23,0.609,101,2015-11-11,SAS,POR
2128,28,Home,W 113-88 ,240,40,81,0.494,28,56,0.5,12,25,0.48,21,22,0.955,113,32,79,0.405,24,53,0.453,8,26,0.308,16,22,0.727,88,2015-11-20,CHA,PHI
2129,29,@,W 113-104 ,240,43,90,0.478,41,80,0.513,2,10,0.2,25,26,0.962,113,35,81,0.432,26,54,0.481,9,27,0.333,25,33,0.758,104,2015-12-01,MEM,NOP
2130,30,@,L 113-120 ,240,46,98,0.469,36,72,0.5,10,26,0.385,11,13,0.846,113,36,78,0.462,20,44,0.455,16,34,0.471,32,43,0.744,120,2015-12-05,SAC,HOU
2131,31,Home,W 113-95 ,240,41,89,0.461,31,62,0.5,10,27,0.37,21,25,0.84,113,40,85,0.471,36,72,0.5,4,13,0.308,11,20,0.55,95,2015-12-15,LAL,MIL
2132,32,Home,W 113-98 ,240,43,77,0.558,29,53,0.547,14,24,0.583,13,15,0.867,113,36,79,0.456,22,45,0.489,14,34,0.412,12,15,0.8,98,2015-12-16,ORL,CHO
2133,33,Home,W 113-99 ,240,46,89,0.517,34,64,0.531,12,25,0.48,9,16,0.563,113,36,79,0.456,34,66,0.515,2,13,0.154,25,32,0.781,99,2015-12-21,BOS,MIN
2134,34,Home,W 113-99 ,240,42,83,0.506,28,59,0.475,14,24,0.583,15,17,0.882,113,37,91,0.407,30,69,0.435,7,22,0.318,18,22,0.818,99,2015-12-21,WAS,SAC
2135,35,Home,W 113-100 ,240,51,85,0.6,46,73,0.63,5,12,0.417,6,8,0.75,113,37,81,0.457,30,61,0.492,7,20,0.35,19,29,0.655,100,2015-12-23,MIL,PHI
2136,36,Home,L 113-115 ,240,42,92,0.457,29,61,0.475,13,31,0.419,16,19,0.842,113,42,82,0.512,33,61,0.541,9,21,0.429,22,25,0.88,115,2016-01-03,TOR,CHI
2137,37,Home,L 113-117 ,240,40,84,0.476,31,58,0.534,9,26,0.346,24,25,0.96,113,45,89,0.506,40,72,0.556,5,17,0.294,22,26,0.846,117,2016-01-08,LAL,OKC
2138,38,Home,W 113-93 ,240,47,89,0.528,42,66,0.636,5,23,0.217,14,22,0.636,113,34,85,0.4,29,73,0.397,5,12,0.417,20,23,0.87,93,2016-01-15,OKC,MIN
2139,39,Home,W 113-95 ,240,47,101,0.465,39,78,0.5,8,23,0.348,11,20,0.55,113,34,94,0.362,24,69,0.348,10,25,0.4,17,23,0.739,95,2016-01-16,DET,GSW
2140,40,@,L 113-118 (OT),265,40,94,0.426,28,64,0.438,12,30,0.4,21,26,0.808,113,40,93,0.43,24,59,0.407,16,34,0.471,22,24,0.917,118,2016-01-18,BOS,DAL
2141,41,@,L 113-119 (2OT),290,45,102,0.441,35,74,0.473,10,28,0.357,13,25,0.52,113,43,97,0.443,35,77,0.455,8,20,0.4,25,30,0.833,119,2016-01-18,PHI,NYK
2142,42,Home,W 113-103 ,240,39,81,0.481,28,53,0.528,11,28,0.393,24,36,0.667,113,39,83,0.47,33,64,0.516,6,19,0.316,19,28,0.679,103,2016-01-26,PHI,PHO
2143,43,Home,L 113-117 ,240,39,88,0.443,28,60,0.467,11,28,0.393,24,30,0.8,113,41,81,0.506,32,63,0.508,9,18,0.5,26,33,0.788,117,2016-01-28,WAS,DEN
2144,44,Home,W 113-94 ,240,43,86,0.5,33,62,0.532,10,24,0.417,17,21,0.81,113,32,79,0.405,25,59,0.424,7,20,0.35,23,29,0.793,94,2016-01-29,BOS,ORL
2145,45,@,W 113-90 ,240,43,90,0.478,30,57,0.526,13,33,0.394,14,15,0.933,113,38,86,0.442,33,72,0.458,5,14,0.357,9,12,0.75,90,2016-02-10,ATL,CHI
2146,46,Home,L 113-119 ,240,40,81,0.494,30,59,0.508,10,22,0.455,23,26,0.885,113,48,88,0.545,42,76,0.553,6,12,0.5,17,18,0.944,119,2016-02-19,LAL,SAS
2147,47,Home,W 113-99 ,240,39,79,0.494,28,48,0.583,11,31,0.355,24,34,0.706,113,32,80,0.4,23,51,0.451,9,29,0.31,26,30,0.867,99,2016-02-28,WAS,CLE
2148,48,@,W 113-107 ,240,38,78,0.487,25,49,0.51,13,29,0.448,24,37,0.649,113,37,77,0.481,25,44,0.568,12,33,0.364,21,27,0.778,107,2016-03-06,HOU,TOR
2149,49,@,L 113-119 ,240,40,90,0.444,35,69,0.507,5,21,0.238,28,34,0.824,113,42,84,0.5,26,49,0.531,16,35,0.457,19,27,0.704,119,2016-03-07,ORL,GSW
2150,50,@,L 113-122 ,240,40,85,0.471,30,52,0.577,10,33,0.303,23,28,0.821,113,38,82,0.463,23,47,0.489,15,35,0.429,31,38,0.816,122,2016-03-09,NOP,CHO
2151,51,Home,W 113-102 ,240,40,82,0.488,36,67,0.537,4,15,0.267,29,36,0.806,113,31,66,0.47,19,36,0.528,12,30,0.4,28,39,0.718,102,2016-03-19,MEM,LAC
2152,52,@,W 113-99 ,240,44,88,0.5,41,69,0.594,3,19,0.158,22,27,0.815,113,34,87,0.391,27,71,0.38,7,16,0.438,24,30,0.8,99,2016-03-22,MIA,NOP
2153,53,Home,W 113-104 ,240,40,83,0.482,30,49,0.612,10,34,0.294,23,27,0.852,113,43,80,0.538,36,64,0.563,7,16,0.438,11,15,0.733,104,2016-03-23,CLE,MIL
2154,54,Home,W 113-104 ,240,45,80,0.563,40,67,0.597,5,13,0.385,18,32,0.563,113,42,91,0.462,34,71,0.479,8,20,0.4,12,23,0.522,104,2016-03-23,MIN,SAC
2155,55,Home,W 113-91 ,240,45,83,0.542,36,61,0.59,9,22,0.409,14,22,0.636,113,35,73,0.479,30,51,0.588,5,22,0.227,16,23,0.696,91,2016-03-24,OKC,UTA
2156,56,Home,W 113-110 ,240,47,86,0.547,43,69,0.623,4,17,0.235,15,25,0.6,113,46,86,0.535,38,62,0.613,8,24,0.333,10,12,0.833,110,2016-04-01,MIL,ORL
2157,57,Home,W 113-99 ,240,41,83,0.494,27,46,0.587,14,37,0.378,17,20,0.85,113,39,92,0.424,29,67,0.433,10,25,0.4,11,20,0.55,99,2016-04-08,CHA,BRK
2158,58,Home,W 113-98 ,240,42,80,0.525,33,59,0.559,9,21,0.429,20,28,0.714,113,28,81,0.346,16,48,0.333,12,33,0.364,30,35,0.857,98,2016-04-10,WAS,CHO
2159,59,Home,W 113-104 ,240,39,75,0.52,26,56,0.464,13,19,0.684,22,22,1.0,113,40,82,0.488,32,58,0.552,8,24,0.333,16,16,1.0,104,2016-10-25,POR,UTA
2160,60,@,W 113-94 ,240,44,86,0.512,38,65,0.585,6,21,0.286,19,26,0.731,113,36,77,0.468,32,61,0.525,4,16,0.25,18,27,0.667,94,2016-10-26,SAC,PHO
2161,61,Home,W 113-110 (OT),265,40,96,0.417,35,75,0.467,5,21,0.238,28,38,0.737,113,42,94,0.447,37,66,0.561,5,28,0.179,21,32,0.656,110,2016-10-28,OKC,PHO
2162,62,Home,L 113-115 (OT),265,38,100,0.38,32,77,0.416,6,23,0.261,31,39,0.795,113,45,98,0.459,35,66,0.53,10,32,0.313,15,21,0.714,115,2016-10-29,DEN,POR
2163,63,Home,W 113-96 ,240,45,95,0.474,36,69,0.522,9,26,0.346,14,17,0.824,113,35,87,0.402,28,55,0.509,7,32,0.219,19,24,0.792,96,2016-10-30,OKC,LAL
2164,64,Home,L 113-117 ,240,36,82,0.439,27,56,0.482,9,26,0.346,32,41,0.78,113,44,91,0.484,34,59,0.576,10,32,0.313,19,21,0.905,117,2016-11-01,NOP,MIL
2165,65,@,W 113-103 ,240,43,77,0.558,33,52,0.635,10,25,0.4,17,25,0.68,113,42,72,0.583,39,62,0.629,3,10,0.3,16,24,0.667,103,2016-11-02,TOR,WAS
2166,66,@,W 113-111 ,240,43,90,0.478,37,68,0.544,6,22,0.273,21,22,0.955,113,38,93,0.409,21,52,0.404,17,41,0.415,18,24,0.75,111,2016-11-11,TOR,CHO
2167,67,@,W 113-88 ,240,41,98,0.418,34,78,0.436,7,20,0.35,24,28,0.857,113,34,95,0.358,25,61,0.41,9,34,0.265,11,18,0.611,88,2016-11-15,CHI,POR
2168,68,@,W 113-111 (OT),265,43,94,0.457,35,71,0.493,8,23,0.348,19,31,0.613,113,39,83,0.47,35,58,0.603,4,25,0.16,29,39,0.744,111,2016-11-18,TOR,DEN
2169,69,Home,W 113-101 ,240,45,82,0.549,36,58,0.621,9,24,0.375,14,20,0.7,113,33,88,0.375,21,54,0.389,12,34,0.353,23,26,0.885,101,2016-11-18,NOP,POR
2170,70,Home,W 113-111 (OT),265,45,97,0.464,34,69,0.493,11,28,0.393,12,13,0.923,113,43,93,0.462,35,64,0.547,8,29,0.276,17,27,0.63,111,2016-11-25,NYK,CHO
2171,71,@,W 113-94 ,240,42,89,0.472,29,58,0.5,13,31,0.419,16,24,0.667,113,28,69,0.406,19,45,0.422,9,24,0.375,29,39,0.744,94,2016-12-01,LAC,CLE
2172,72,Home,W 113-80 ,240,45,83,0.542,33,54,0.611,12,29,0.414,11,13,0.846,113,32,93,0.344,26,67,0.388,6,26,0.231,10,17,0.588,80,2016-12-02,TOR,LAL
2173,73,Home,L 113-118 ,240,40,81,0.494,29,54,0.537,11,27,0.407,22,30,0.733,113,45,92,0.489,31,58,0.534,14,34,0.412,14,18,0.778,118,2016-12-05,BRK,WAS
2174,74,Home,L 113-121 ,240,43,88,0.489,32,61,0.525,11,27,0.407,16,24,0.667,113,47,83,0.566,39,64,0.609,8,19,0.421,19,25,0.76,121,2016-12-10,ORL,DEN
2175,75,@,W 113-109 ,240,42,95,0.442,28,61,0.459,14,34,0.412,15,19,0.789,113,39,82,0.476,25,47,0.532,14,35,0.4,17,21,0.81,109,2016-12-13,GSW,NOP
2176,76,Home,W 113-111 (OT),265,38,93,0.409,29,63,0.46,9,30,0.3,28,33,0.848,113,38,97,0.392,31,77,0.403,7,20,0.35,28,38,0.737,111,2016-12-13,PHO,NYK
2177,77,@,W 113-108 ,240,37,74,0.5,24,49,0.49,13,25,0.52,26,37,0.703,113,42,89,0.472,28,56,0.5,14,33,0.424,10,20,0.5,108,2016-12-14,LAC,ORL
2178,78,Home,W 113-100 ,240,42,86,0.488,31,64,0.484,11,22,0.5,18,22,0.818,113,41,89,0.461,31,63,0.492,10,26,0.385,8,14,0.571,100,2016-12-18,SAS,NOP
2179,79,Home,W 113-82 ,240,49,82,0.598,41,66,0.621,8,16,0.5,7,7,1.0,113,34,83,0.41,31,60,0.517,3,23,0.13,11,13,0.846,82,2016-12-19,CHI,DET
2180,80,@,L 113-117 ,240,44,90,0.489,28,57,0.491,16,33,0.485,9,11,0.818,113,43,94,0.457,32,69,0.464,11,25,0.44,20,24,0.833,117,2016-12-20,LAL,CHO
2181,81,Home,W 113-102 ,240,43,87,0.494,28,60,0.467,15,27,0.556,12,19,0.632,113,36,77,0.468,27,55,0.491,9,22,0.409,21,29,0.724,102,2016-12-21,CLE,MIL
2182,82,Home,L 113-119 ,240,43,85,0.506,33,56,0.589,10,29,0.345,17,28,0.607,113,43,77,0.558,32,50,0.64,11,27,0.407,22,24,0.917,119,2016-12-23,DET,GSW
2183,83,Home,W 113-103 ,240,41,85,0.482,29,54,0.537,12,31,0.387,19,21,0.905,113,37,88,0.42,28,58,0.483,9,30,0.3,20,29,0.69,103,2016-12-27,BOS,MEM
2184,84,Home,W 113-105 ,240,37,78,0.474,20,46,0.435,17,32,0.531,22,24,0.917,113,41,92,0.446,30,62,0.484,11,30,0.367,12,14,0.857,105,2017-01-03,DAL,WAS
2185,85,Home,L 113-120 ,240,41,82,0.5,23,44,0.523,18,38,0.474,13,13,1.0,113,46,88,0.523,35,59,0.593,11,29,0.379,17,18,0.944,120,2017-01-03,DEN,SAC
2186,86,@,W 113-108 ,240,43,89,0.483,28,55,0.509,15,34,0.441,12,17,0.706,113,38,78,0.487,28,60,0.467,10,18,0.556,22,27,0.815,108,2017-01-12,DAL,PHO
2187,87,@,L 113-132 ,240,40,86,0.465,23,50,0.46,17,36,0.472,16,20,0.8,113,52,97,0.536,41,69,0.594,11,28,0.393,17,21,0.81,132,2017-01-13,BRK,TOR
2188,88,Home,W 113-97 ,240,48,92,0.522,38,64,0.594,10,28,0.357,7,8,0.875,113,36,80,0.45,26,59,0.441,10,21,0.476,15,27,0.556,97,2017-01-14,LAC,LAL
2189,89,@,W 113-104 ,240,35,78,0.449,21,41,0.512,14,37,0.378,29,36,0.806,113,42,89,0.472,37,75,0.493,5,14,0.357,15,22,0.682,104,2017-01-16,PHI,MIL
2190,90,@,W 113-110 ,240,44,88,0.5,31,56,0.554,13,32,0.406,12,14,0.857,113,42,90,0.467,35,66,0.53,7,24,0.292,19,22,0.864,110,2017-01-19,WAS,NYK
2191,91,Home,W 113-78 ,240,40,80,0.5,28,55,0.509,12,25,0.48,21,25,0.84,113,29,86,0.337,22,56,0.393,7,30,0.233,13,14,0.929,78,2017-01-20,CHA,TOR
2192,92,Home,W 113-112 ,240,43,87,0.494,32,59,0.542,11,28,0.393,16,22,0.727,113,39,91,0.429,31,65,0.477,8,26,0.308,26,33,0.788,112,2017-01-21,DET,WAS
2193,93,@,W 113-103 ,240,39,82,0.476,28,54,0.519,11,28,0.393,24,27,0.889,113,38,92,0.413,31,69,0.449,7,23,0.304,20,21,0.952,103,2017-01-25,GSW,CHO
2194,94,@,W 113-111 ,240,36,79,0.456,28,53,0.528,8,26,0.308,33,39,0.846,113,46,93,0.495,36,66,0.545,10,27,0.37,9,12,0.75,111,2017-01-29,GSW,POR
2195,95,Home,L 113-114 ,240,36,79,0.456,24,51,0.471,12,28,0.429,29,36,0.806,113,42,79,0.532,32,56,0.571,10,23,0.435,20,26,0.769,114,2017-01-29,TOR,ORL
2196,96,Home,W 113-109 ,240,36,82,0.439,23,50,0.46,13,32,0.406,28,33,0.848,113,43,97,0.443,40,70,0.571,3,27,0.111,20,29,0.69,109,2017-01-30,BOS,DET
2197,97,Home,W 113-95 ,240,40,86,0.465,30,60,0.5,10,26,0.385,23,28,0.821,113,35,77,0.455,29,55,0.527,6,22,0.273,19,26,0.731,95,2017-02-01,DAL,PHI
2198,98,@,W 113-108 ,240,44,85,0.518,36,55,0.655,8,30,0.267,17,23,0.739,113,35,93,0.376,22,42,0.524,13,51,0.255,25,33,0.758,108,2017-02-02,ATL,HOU
2199,99,Home,W 113-107 ,240,39,82,0.476,26,47,0.553,13,35,0.371,22,28,0.786,113,37,94,0.394,23,56,0.411,14,38,0.368,19,26,0.731,107,2017-02-03,BOS,LAL
2200,0,Home,W 113-86 ,240,41,78,0.526,31,50,0.62,10,28,0.357,21,27,0.778,113,27,78,0.346,20,51,0.392,7,27,0.259,25,28,0.893,86,2017-02-04,ATL,ORL
2201,1,Home,W 113-96 ,240,46,99,0.465,41,77,0.532,5,22,0.227,16,17,0.941,113,36,85,0.424,31,57,0.544,5,28,0.179,19,28,0.679,96,2017-02-06,DET,PHI
2202,2,Home,L 113-115 ,240,43,80,0.538,38,69,0.551,5,11,0.455,22,28,0.786,113,45,86,0.523,30,58,0.517,15,28,0.536,10,14,0.714,115,2017-02-06,MIN,MIA
2203,3,Home,L 113-114 ,240,37,75,0.493,25,47,0.532,12,28,0.429,27,32,0.844,113,42,86,0.488,31,58,0.534,11,28,0.393,19,24,0.792,114,2017-02-07,DAL,POR
2204,4,Home,W 113-104 ,240,39,82,0.476,21,43,0.488,18,39,0.462,17,19,0.895,113,40,86,0.465,28,62,0.452,12,24,0.5,12,14,0.857,104,2017-02-15,CLE,IND
2205,5,@,L 113-123 ,240,38,93,0.409,27,65,0.415,11,28,0.393,26,37,0.703,113,43,81,0.531,30,55,0.545,13,26,0.5,24,26,0.923,123,2017-02-23,LAC,GSW
2206,6,Home,W 113-95 ,240,38,78,0.487,25,47,0.532,13,31,0.419,24,31,0.774,113,34,85,0.4,30,73,0.411,4,12,0.333,23,26,0.885,95,2017-02-25,MIA,IND
2207,7,@,L 113-120 (OT),265,44,84,0.524,34,59,0.576,10,25,0.4,15,22,0.682,113,45,104,0.433,38,79,0.481,7,25,0.28,23,31,0.742,120,2017-02-28,POR,DET
2208,8,@,W 113-105 ,240,40,86,0.465,34,72,0.472,6,14,0.429,27,28,0.964,113,40,85,0.471,31,53,0.585,9,32,0.281,16,24,0.667,105,2017-03-06,NYK,ORL
2209,9,Home,L 113-123 ,240,46,87,0.529,33,59,0.559,13,28,0.464,8,17,0.471,113,50,88,0.568,39,62,0.629,11,26,0.423,12,19,0.632,123,2017-03-08,DEN,WAS
2210,10,Home,W 112-85 ,240,47,83,0.566,42,70,0.6,5,13,0.385,13,19,0.684,112,34,86,0.395,30,67,0.448,4,19,0.211,13,21,0.619,85,2012-01-10,PHI,SAC
2211,11,Home,W 112-100 ,240,38,76,0.5,31,63,0.492,7,13,0.538,29,38,0.763,112,35,84,0.417,30,64,0.469,5,20,0.25,25,32,0.781,100,2012-01-14,CHA,GSW
2212,12,Home,W 112-100 ,240,45,80,0.563,32,55,0.582,13,25,0.52,9,15,0.6,112,38,78,0.487,29,56,0.518,9,22,0.409,15,23,0.652,100,2012-01-30,LAC,OKC
2213,13,Home,W 112-68 ,240,44,80,0.55,37,66,0.561,7,14,0.5,17,20,0.85,112,26,80,0.325,25,71,0.352,1,9,0.111,15,19,0.789,68,2012-02-01,POR,CHA
2214,14,@,W 112-91 ,240,39,73,0.534,27,52,0.519,12,21,0.571,22,25,0.88,112,39,85,0.459,31,58,0.534,8,27,0.296,5,12,0.417,91,2012-02-02,DEN,LAC
2215,15,Home,L 112-113 (OT),265,43,88,0.489,35,71,0.493,8,17,0.471,18,32,0.563,112,40,98,0.408,32,74,0.432,8,24,0.333,25,31,0.806,113,2012-02-10,CLE,MIL
2216,16,@,W 112-91 ,240,47,89,0.528,37,69,0.536,10,20,0.5,8,12,0.667,112,35,80,0.438,26,58,0.448,9,22,0.409,12,16,0.75,91,2012-03-02,CHI,CLE
2217,17,@,W 112-106 ,240,46,82,0.561,37,66,0.561,9,16,0.563,11,14,0.786,112,43,81,0.531,34,57,0.596,9,24,0.375,11,14,0.786,106,2012-03-10,HOU,NJN
2218,18,Home,W 112-97 ,240,47,87,0.54,39,65,0.6,8,22,0.364,10,19,0.526,112,39,87,0.448,31,70,0.443,8,17,0.471,11,14,0.786,97,2012-03-12,SAS,WAS
2219,19,Home,L 112-124 ,240,45,87,0.517,40,68,0.588,5,19,0.263,17,24,0.708,112,50,86,0.581,42,73,0.575,8,13,0.615,16,20,0.8,124,2012-03-14,SAC,DET
2220,20,@,W 112-95 ,240,45,84,0.536,35,59,0.593,10,25,0.4,12,15,0.8,112,36,83,0.434,30,62,0.484,6,21,0.286,17,20,0.85,95,2012-03-19,DAL,DEN
2221,21,@,W 112-92 ,240,48,90,0.533,44,77,0.571,4,13,0.308,12,21,0.571,112,34,84,0.405,33,76,0.434,1,8,0.125,23,26,0.885,92,2012-03-23,MIL,CHA
2222,22,Home,L 112-117 ,240,47,86,0.547,39,65,0.6,8,21,0.381,10,13,0.769,112,49,91,0.538,39,71,0.549,10,20,0.5,9,12,0.75,117,2012-03-28,SAC,SAS
2223,23,Home,W 112-103 ,240,38,76,0.5,29,57,0.509,9,19,0.474,27,33,0.818,112,42,79,0.532,37,65,0.569,5,14,0.357,14,18,0.778,103,2012-03-31,SAS,IND
2224,24,@,L 112-120 ,240,44,90,0.489,33,69,0.478,11,21,0.524,13,15,0.867,112,44,82,0.537,34,63,0.54,10,19,0.526,22,31,0.71,120,2012-04-01,GSW,LAL
2225,25,@,W 112-98 ,240,43,83,0.518,39,73,0.534,4,10,0.4,22,29,0.759,112,36,81,0.444,29,63,0.46,7,18,0.389,19,20,0.95,98,2012-04-02,MIL,WAS
2226,26,Home,W 112-104 ,240,41,86,0.477,35,63,0.556,6,23,0.261,24,31,0.774,112,38,83,0.458,28,60,0.467,10,23,0.435,18,25,0.72,104,2012-04-03,IND,NYK
2227,27,@,W 112-107 ,240,42,88,0.477,32,71,0.451,10,17,0.588,18,22,0.818,112,36,84,0.429,33,73,0.452,3,11,0.273,32,36,0.889,107,2012-04-06,HOU,LAL
2228,28,Home,W 112-97 ,240,46,88,0.523,38,67,0.567,8,21,0.381,12,16,0.75,112,37,80,0.463,29,55,0.527,8,25,0.32,15,20,0.75,97,2012-04-07,GSW,DEN
2229,29,@,W 112-103 ,240,44,88,0.5,35,64,0.547,9,24,0.375,15,20,0.75,112,38,81,0.469,31,63,0.492,7,18,0.389,20,23,0.87,103,2012-04-12,DAL,GSW
2230,30,@,W 112-105 ,240,38,77,0.494,30,59,0.508,8,18,0.444,28,33,0.848,112,36,84,0.429,32,65,0.492,4,19,0.211,29,33,0.879,105,2012-04-13,PHO,HOU
2231,31,Home,W 112-104 ,240,44,81,0.543,34,59,0.576,10,22,0.455,14,30,0.467,112,37,80,0.463,22,49,0.449,15,31,0.484,15,21,0.714,104,2012-04-14,LAC,GSW
2232,32,Home,W 112-108 (OT),265,42,93,0.452,35,75,0.467,7,18,0.389,21,27,0.778,112,41,88,0.466,29,67,0.433,12,21,0.571,14,15,0.933,108,2012-04-15,LAL,DAL
2233,33,@,W 112-91 ,240,50,84,0.595,43,66,0.652,7,18,0.389,5,11,0.455,112,39,80,0.488,37,70,0.529,2,10,0.2,11,11,1.0,91,2012-04-17,SAS,LAL
2234,34,@,W 112-91 ,240,38,80,0.475,28,63,0.444,10,17,0.588,26,32,0.813,112,31,79,0.392,25,59,0.424,6,20,0.3,23,29,0.793,91,2012-04-18,UTA,POR
2235,35,@,L 112-121 ,240,42,93,0.452,37,74,0.5,5,19,0.263,23,27,0.852,112,49,88,0.557,42,75,0.56,7,13,0.538,16,25,0.64,121,2012-04-18,MIL,WAS
2236,36,Home,L 112-113 ,240,41,76,0.539,26,53,0.491,15,23,0.652,15,23,0.652,112,43,79,0.544,31,60,0.517,12,19,0.632,15,20,0.75,113,2012-04-22,ATL,NYK
2237,37,@,W 112-109 ,240,40,70,0.571,33,52,0.635,7,18,0.389,25,31,0.806,112,42,89,0.472,32,67,0.478,10,22,0.455,15,19,0.789,109,2012-11-10,SAS,POR
2238,38,@,W 112-106 (OT),265,44,88,0.5,38,76,0.5,6,12,0.5,18,25,0.72,112,42,105,0.4,36,84,0.429,6,21,0.286,16,17,0.941,106,2012-11-14,CHI,PHO
2239,39,@,W 112-96 ,240,42,76,0.553,34,61,0.557,8,15,0.533,20,27,0.741,112,39,85,0.459,31,65,0.477,8,20,0.4,10,14,0.714,96,2012-11-16,ATL,SAC
2240,40,@,W 112-100 ,240,45,77,0.584,37,61,0.607,8,16,0.5,14,19,0.737,112,41,77,0.532,38,69,0.551,3,8,0.375,15,17,0.882,100,2012-11-21,SAS,BOS
2241,41,Home,L 112-118 (OT),265,41,88,0.466,28,61,0.459,13,27,0.481,17,22,0.773,112,43,92,0.467,31,57,0.544,12,35,0.343,20,26,0.769,118,2012-12-03,CHA,POR
2242,42,Home,W 112-90 ,240,45,90,0.5,39,70,0.557,6,20,0.3,16,21,0.762,112,34,84,0.405,29,65,0.446,5,19,0.263,17,19,0.895,90,2012-12-05,LAC,DAL
2243,43,@,W 112-92 ,240,41,91,0.451,23,47,0.489,18,44,0.409,12,19,0.632,112,32,76,0.421,26,60,0.433,6,16,0.375,22,28,0.786,92,2012-12-06,NYK,MIA
2244,44,Home,W 112-106 ,240,37,86,0.43,25,56,0.446,12,30,0.4,26,37,0.703,112,40,72,0.556,35,55,0.636,5,17,0.294,21,29,0.724,106,2012-12-09,NYK,DEN
2245,45,Home,W 112-106 ,240,38,87,0.437,31,68,0.456,7,19,0.368,29,42,0.69,112,38,95,0.4,24,59,0.407,14,36,0.389,16,18,0.889,106,2012-12-18,DEN,SAS
2246,46,Home,W 112-100 ,240,45,93,0.484,34,68,0.5,11,25,0.44,11,19,0.579,112,40,80,0.5,37,67,0.552,3,13,0.231,17,24,0.708,100,2012-12-25,LAC,DEN
2247,47,@,W 112-110 (OT),265,40,85,0.471,34,64,0.531,6,21,0.286,26,35,0.743,112,42,88,0.477,34,65,0.523,8,23,0.348,18,22,0.818,110,2012-12-31,MIA,ORL
2248,48,@,W 112-104 ,240,37,79,0.468,25,45,0.556,12,34,0.353,26,36,0.722,112,36,91,0.396,29,68,0.426,7,23,0.304,25,28,0.893,104,2013-01-05,HOU,CLE
2249,49,@,W 112-105 ,240,44,101,0.436,35,77,0.455,9,24,0.375,15,23,0.652,112,38,82,0.463,28,52,0.538,10,30,0.333,19,27,0.704,105,2013-01-06,DEN,LAL
2250,50,@,L 112-125 ,240,43,91,0.473,29,60,0.483,14,31,0.452,12,13,0.923,112,48,87,0.552,37,62,0.597,11,25,0.44,18,23,0.783,125,2013-01-08,LAL,HOU
2251,51,@,W 112-102 ,240,44,82,0.537,34,60,0.567,10,22,0.455,14,21,0.667,112,42,88,0.477,38,80,0.475,4,8,0.5,14,22,0.636,102,2013-01-09,UTA,CHA
2252,52,Home,L 112-117 (OT),265,40,81,0.494,33,54,0.611,7,27,0.259,25,32,0.781,112,41,96,0.427,36,75,0.48,5,21,0.238,30,35,0.857,117,2013-01-10,SAC,DAL
2253,53,@,W 112-108 ,240,41,80,0.513,30,57,0.526,11,23,0.478,19,28,0.679,112,41,84,0.488,34,68,0.5,7,16,0.438,19,31,0.613,108,2013-01-18,WAS,DEN
2254,54,Home,L 112-116 ,240,45,79,0.57,36,55,0.655,9,24,0.375,13,23,0.565,112,38,77,0.494,28,55,0.509,10,22,0.455,30,35,0.857,116,2013-01-19,NOP,GSW
2255,55,Home,W 112-91 ,240,41,87,0.471,31,62,0.5,10,25,0.4,20,27,0.741,112,36,87,0.414,33,71,0.465,3,16,0.188,16,20,0.8,91,2013-02-04,OKC,DAL
2256,56,Home,W 112-104 ,240,40,91,0.44,35,75,0.467,5,16,0.313,27,37,0.73,112,48,100,0.48,45,84,0.536,3,16,0.188,5,11,0.455,104,2013-02-05,DEN,MIL
2257,57,Home,W 112-108 ,240,45,83,0.542,34,57,0.596,11,26,0.423,11,14,0.786,112,35,78,0.449,23,46,0.5,12,32,0.375,26,33,0.788,108,2013-03-06,DAL,HOU
2258,58,@,L 112-121 ,240,43,90,0.478,36,67,0.537,7,23,0.304,19,23,0.826,112,45,82,0.549,32,55,0.582,13,27,0.481,18,21,0.857,121,2013-03-08,PHO,SAC
2259,59,Home,W 112-88 ,240,39,76,0.513,33,61,0.541,6,15,0.4,28,35,0.8,112,34,79,0.43,31,66,0.47,3,13,0.231,17,19,0.895,88,2013-03-13,BOS,TOR
2260,60,Home,W 112-101 ,240,41,86,0.477,34,67,0.507,7,19,0.368,23,24,0.958,112,40,76,0.526,35,59,0.593,5,17,0.294,16,24,0.667,101,2013-03-16,POR,DET
2261,61,@,W 112-104 ,240,37,80,0.463,33,65,0.508,4,15,0.267,34,46,0.739,112,40,82,0.488,34,70,0.486,6,12,0.5,18,19,0.947,104,2013-03-30,IND,PHO
2262,62,Home,W 112-92 ,240,40,74,0.541,28,53,0.528,12,21,0.571,20,29,0.69,112,38,82,0.463,31,64,0.484,7,18,0.389,9,12,0.75,92,2013-03-31,NOP,CLE
2263,63,Home,W 112-102 ,240,45,83,0.542,36,61,0.59,9,22,0.409,13,18,0.722,112,39,67,0.582,26,44,0.591,13,23,0.565,11,17,0.647,102,2013-04-01,UTA,POR
2264,64,@,W 112-102 ,240,42,86,0.488,32,56,0.571,10,30,0.333,18,21,0.857,112,34,87,0.391,28,66,0.424,6,21,0.286,28,34,0.824,102,2013-04-03,HOU,SAC
2265,65,@,W 112-111 ,240,37,85,0.435,31,71,0.437,6,14,0.429,32,46,0.696,112,42,100,0.42,30,65,0.462,12,35,0.343,15,23,0.652,111,2013-04-15,DEN,MIL
2266,66,@,L 112-119 ,240,43,92,0.467,32,63,0.508,11,29,0.379,15,23,0.652,112,47,95,0.495,40,72,0.556,7,23,0.304,18,23,0.783,119,2013-04-15,HOU,PHO
2267,67,@,W 112-108 ,240,44,88,0.5,32,64,0.5,12,24,0.5,12,18,0.667,112,40,89,0.449,31,63,0.492,9,26,0.346,19,25,0.76,108,2013-04-17,LAC,SAC
2268,68,Home,W 112-108 (OT),265,41,88,0.466,31,64,0.484,10,24,0.417,20,26,0.769,112,41,88,0.466,35,64,0.547,6,24,0.25,20,29,0.69,108,2013-11-08,WAS,BRK
2269,69,Home,W 112-101 ,240,41,79,0.519,24,48,0.5,17,31,0.548,13,16,0.813,112,40,100,0.4,32,74,0.432,8,26,0.308,13,17,0.765,101,2013-11-23,HOU,MIN
2270,70,Home,W 112-93 ,240,44,81,0.543,34,56,0.607,10,25,0.4,14,19,0.737,112,37,97,0.381,35,82,0.427,2,15,0.133,17,20,0.85,93,2013-11-25,SAS,NOP
2271,71,@,L 112-113 (OT),265,42,95,0.442,34,69,0.493,8,26,0.308,20,29,0.69,112,36,92,0.391,30,74,0.405,6,18,0.333,35,42,0.833,113,2013-11-29,GSW,OKC
2272,72,@,W 112-101 ,240,41,75,0.547,33,50,0.66,8,25,0.32,22,25,0.88,112,40,83,0.482,35,63,0.556,5,20,0.25,16,20,0.8,101,2013-11-29,PHO,UTA
2273,73,@,W 112-106 ,240,40,79,0.506,29,53,0.547,11,26,0.423,21,30,0.7,112,45,92,0.489,38,68,0.559,7,24,0.292,9,11,0.818,106,2013-11-30,MIN,DAL
2274,74,@,W 112-104 ,240,39,76,0.513,30,58,0.517,9,18,0.5,25,29,0.862,112,37,78,0.474,25,51,0.49,12,27,0.444,18,25,0.72,104,2013-11-30,UTA,PHO
2275,75,@,W 112-106 ,240,40,90,0.444,27,60,0.45,13,30,0.433,19,30,0.633,112,44,91,0.484,35,65,0.538,9,26,0.346,9,13,0.692,106,2013-11-30,HOU,SAS
2276,76,@,W 112-98 ,240,44,87,0.506,34,64,0.531,10,23,0.435,14,19,0.737,112,35,87,0.402,27,65,0.415,8,22,0.364,20,26,0.769,98,2013-12-01,DEN,TOR
2277,77,Home,W 112-103 ,240,40,79,0.506,28,50,0.56,12,29,0.414,20,25,0.8,112,40,77,0.519,32,57,0.561,8,20,0.4,15,18,0.833,103,2013-12-03,GSW,TOR
2278,78,@,W 112-102 (OT),265,39,94,0.415,36,79,0.456,3,15,0.2,31,38,0.816,112,36,89,0.404,28,70,0.4,8,19,0.421,22,30,0.733,102,2013-12-07,SAC,UTA
2279,79,Home,W 112-97 ,240,38,81,0.469,29,56,0.518,9,25,0.36,27,34,0.794,112,37,95,0.389,32,68,0.471,5,27,0.185,18,20,0.9,97,2013-12-09,SAC,DAL
2280,80,Home,L 112-116 ,240,43,90,0.478,37,68,0.544,6,22,0.273,20,24,0.833,112,39,79,0.494,27,50,0.54,12,29,0.414,26,35,0.743,116,2013-12-13,GSW,HOU
2281,81,Home,W 112-91 ,240,39,86,0.453,26,53,0.491,13,33,0.394,21,31,0.677,112,31,88,0.352,25,58,0.431,6,30,0.2,23,29,0.793,91,2013-12-21,LAC,DEN
2282,82,Home,W 112-99 ,240,41,91,0.451,32,68,0.471,9,23,0.391,21,27,0.778,112,37,81,0.457,30,60,0.5,7,21,0.333,18,25,0.72,99,2013-12-23,SAS,TOR
2283,83,@,L 112-116 (OT),265,49,110,0.445,41,90,0.456,8,20,0.4,6,12,0.5,112,42,96,0.438,29,60,0.483,13,36,0.361,19,22,0.864,116,2013-12-26,LAC,POR
2284,84,Home,W 112-104 ,240,44,94,0.468,36,70,0.514,8,24,0.333,16,19,0.842,112,41,91,0.451,34,77,0.442,7,14,0.5,15,20,0.75,104,2013-12-29,SAS,SAC
2285,85,Home,W 112-85 ,240,47,85,0.553,36,51,0.706,11,34,0.324,7,10,0.7,112,29,76,0.382,23,55,0.418,6,21,0.286,21,22,0.955,85,2014-01-01,LAC,CHA
2286,86,@,L 112-124 ,240,45,87,0.517,39,67,0.582,6,20,0.3,16,22,0.727,112,44,79,0.557,36,57,0.632,8,22,0.364,28,35,0.8,124,2014-01-01,NOP,MIN
2287,87,Home,L 112-119 ,240,45,88,0.511,33,60,0.55,12,28,0.429,10,14,0.714,112,40,82,0.488,31,59,0.525,9,23,0.391,30,38,0.789,119,2014-01-03,DAL,LAC
2288,88,@,W 112-84 ,240,43,92,0.467,35,77,0.455,8,15,0.533,18,22,0.818,112,35,86,0.407,31,69,0.449,4,17,0.235,10,20,0.5,84,2014-01-05,MEM,DET
2289,89,@,W 112-96 ,240,43,85,0.506,34,63,0.54,9,22,0.409,17,20,0.85,112,37,86,0.43,31,66,0.47,6,20,0.3,16,16,1.0,96,2014-01-05,GSW,WAS
2290,90,Home,W 112-101 ,240,40,68,0.588,32,50,0.64,8,18,0.444,24,31,0.774,112,35,89,0.393,29,55,0.527,6,34,0.176,25,31,0.806,101,2014-01-07,UTA,OKC
2291,91,Home,W 112-90 ,240,40,76,0.526,31,56,0.554,9,20,0.45,23,26,0.885,112,39,93,0.419,32,74,0.432,7,19,0.368,5,8,0.625,90,2014-01-08,SAS,DAL
2292,92,Home,W 112-91 ,240,35,86,0.407,24,55,0.436,11,31,0.355,31,34,0.912,112,34,86,0.395,30,70,0.429,4,16,0.25,19,35,0.543,91,2014-01-08,TOR,DET
2293,93,Home,W 112-104 ,240,40,93,0.43,30,72,0.417,10,21,0.476,22,26,0.846,112,44,95,0.463,40,81,0.494,4,14,0.286,12,17,0.706,104,2014-01-11,POR,BOS
2294,94,@,W 112-106 ,240,37,80,0.463,25,58,0.431,12,22,0.545,26,28,0.929,112,44,90,0.489,35,60,0.583,9,30,0.3,9,11,0.818,106,2014-01-19,LAL,TOR
2295,95,@,W 112-103 ,240,40,72,0.556,31,51,0.608,9,21,0.429,23,37,0.622,112,40,79,0.506,38,65,0.585,2,14,0.143,21,29,0.724,103,2014-01-20,LAC,DET
2296,96,@,W 112-97 ,240,41,90,0.456,33,69,0.478,8,21,0.381,22,24,0.917,112,41,87,0.471,36,70,0.514,5,17,0.294,10,12,0.833,97,2014-01-21,MIN,UTA
2297,97,@,W 112-109 ,240,41,83,0.494,32,58,0.552,9,25,0.36,21,24,0.875,112,41,83,0.494,35,71,0.493,6,12,0.5,21,24,0.875,109,2014-01-22,ATL,ORL
2298,98,@,W 112-95 ,240,41,76,0.539,28,55,0.509,13,21,0.619,17,26,0.654,112,40,93,0.43,34,74,0.459,6,19,0.316,9,11,0.818,95,2014-01-24,LAC,CHI
2299,99,@,W 112-87 ,240,40,76,0.526,27,50,0.54,13,26,0.5,19,25,0.76,112,38,82,0.463,33,61,0.541,5,21,0.238,6,13,0.462,87,2014-01-25,ATL,MIL
2300,0,@,W 112-95 ,240,41,80,0.513,25,53,0.472,16,27,0.593,14,19,0.737,112,37,72,0.514,34,53,0.642,3,19,0.158,18,22,0.818,95,2014-01-29,OKC,MIA
2301,1,Home,L 112-116 ,240,37,86,0.43,30,61,0.492,7,25,0.28,31,42,0.738,112,41,78,0.526,28,47,0.596,13,31,0.419,21,26,0.808,116,2014-02-05,LAC,MIA
2302,2,Home,W 112-98 ,240,44,89,0.494,38,71,0.535,6,18,0.333,18,20,0.9,112,39,85,0.459,33,65,0.508,6,20,0.3,14,23,0.609,98,2014-02-05,ORL,DET
2303,3,@,W 112-98 ,240,45,89,0.506,37,71,0.521,8,18,0.444,14,20,0.7,112,37,87,0.425,22,55,0.4,15,32,0.469,9,17,0.529,98,2014-02-07,LAL,PHI
2304,4,Home,W 112-100 ,240,40,73,0.548,28,46,0.609,12,27,0.444,20,27,0.741,112,38,86,0.442,29,62,0.468,9,24,0.375,15,20,0.75,100,2014-02-09,OKC,NYK
2305,5,@,L 112-113 ,240,44,97,0.454,28,65,0.431,16,32,0.5,8,16,0.5,112,34,64,0.531,24,42,0.571,10,22,0.455,35,47,0.745,113,2014-02-12,WAS,HOU
2306,6,@,W 112-107 (OT),265,35,93,0.376,24,64,0.375,11,29,0.379,31,39,0.795,112,38,99,0.384,33,71,0.465,5,28,0.179,26,37,0.703,107,2014-02-18,PHO,DEN
2307,7,Home,L 112-124 ,240,42,94,0.447,37,69,0.536,5,25,0.2,23,32,0.719,112,48,77,0.623,39,54,0.722,9,23,0.391,19,25,0.76,124,2014-02-21,PHI,DAL
2308,8,Home,L 112-115 ,240,42,86,0.488,31,60,0.517,11,26,0.423,17,24,0.708,112,41,78,0.526,36,62,0.581,5,16,0.313,28,32,0.875,115,2014-02-23,PHO,HOU
2309,9,@,W 112-89 ,240,39,82,0.476,29,51,0.569,10,31,0.323,24,29,0.828,112,30,81,0.37,24,59,0.407,6,22,0.273,23,33,0.697,89,2014-02-27,BRK,DEN
2310,10,Home,W 112-98 ,240,43,74,0.581,37,58,0.638,6,16,0.375,20,24,0.833,112,36,83,0.434,32,65,0.492,4,18,0.222,22,29,0.759,98,2014-03-01,MIA,ORL
2311,11,Home,W 112-106 ,240,39,84,0.464,29,57,0.509,10,27,0.37,24,28,0.857,112,45,97,0.464,38,79,0.481,7,18,0.389,9,14,0.643,106,2014-03-02,SAS,DAL
2312,12,Home,W 112-86 ,240,40,76,0.526,27,48,0.563,13,28,0.464,19,25,0.76,112,34,74,0.459,27,58,0.466,7,16,0.438,11,15,0.733,86,2014-03-07,HOU,IND
2313,13,Home,W 112-104 ,240,42,84,0.5,34,64,0.531,8,20,0.4,20,23,0.87,112,40,89,0.449,35,69,0.507,5,20,0.25,19,25,0.76,104,2014-03-07,NOP,MIL
2314,14,@,L 112-121 ,240,46,96,0.479,39,78,0.5,7,18,0.389,13,17,0.765,112,43,81,0.531,34,61,0.557,9,20,0.45,26,35,0.743,121,2014-03-08,ORL,SAS
2315,15,Home,W 112-105 ,240,43,78,0.551,39,64,0.609,4,14,0.286,22,31,0.71,112,39,85,0.459,32,65,0.492,7,20,0.35,20,29,0.69,105,2014-03-10,LAC,PHO
2316,16,@,W 112-110 ,240,38,78,0.487,25,49,0.51,13,29,0.448,23,27,0.852,112,40,82,0.488,30,61,0.492,10,21,0.476,20,24,0.833,110,2014-03-10,ATL,UTA
2317,17,Home,W 112-101 ,240,41,85,0.482,33,65,0.508,8,20,0.4,22,30,0.733,112,39,74,0.527,34,59,0.576,5,15,0.333,18,29,0.621,101,2014-03-11,MIN,MIL
2318,18,Home,L 112-120 ,240,45,93,0.484,36,69,0.522,9,24,0.375,13,13,1.0,112,47,92,0.511,37,70,0.529,10,22,0.455,16,24,0.667,120,2014-03-12,ORL,DEN
2319,19,@,W 112-104 (OT),265,41,104,0.394,34,80,0.425,7,24,0.292,23,25,0.92,112,37,91,0.407,30,68,0.441,7,23,0.304,23,30,0.767,104,2014-03-15,IND,DET
2320,20,Home,L 112-113 ,240,37,88,0.42,25,60,0.417,12,28,0.429,26,30,0.867,112,42,88,0.477,31,58,0.534,11,30,0.367,18,22,0.818,113,2014-03-16,POR,GSW
2321,21,Home,W 112-103 ,240,45,83,0.542,34,54,0.63,11,29,0.379,11,17,0.647,112,42,93,0.452,30,64,0.469,12,29,0.414,7,13,0.538,103,2014-03-22,LAC,DET
2322,22,Home,W 112-88 ,240,40,88,0.455,26,55,0.473,14,33,0.424,18,23,0.783,112,35,87,0.402,27,62,0.435,8,25,0.32,10,16,0.625,88,2014-03-28,PHO,NYK
2323,23,Home,L 112-124 ,240,41,92,0.446,30,67,0.448,11,25,0.44,19,22,0.864,112,46,99,0.465,33,70,0.471,13,29,0.448,19,21,0.905,124,2014-04-01,LAL,POR
2324,24,@,W 112-108 ,240,37,79,0.468,26,53,0.491,11,26,0.423,27,30,0.9,112,36,78,0.462,28,50,0.56,8,28,0.286,28,33,0.848,108,2014-04-02,LAC,PHO
2325,25,Home,W 112-92 ,240,43,77,0.558,34,55,0.618,9,22,0.409,17,18,0.944,112,38,86,0.442,33,72,0.458,5,14,0.357,11,17,0.647,92,2014-04-06,SAS,MEM
2326,26,@,W 112-95 ,240,45,92,0.489,32,67,0.478,13,25,0.52,9,13,0.692,112,35,89,0.393,26,61,0.426,9,28,0.321,16,20,0.8,95,2014-04-11,GSW,LAL
2327,27,Home,W 112-110 ,240,41,94,0.436,38,82,0.463,3,12,0.25,27,40,0.675,112,36,83,0.434,25,58,0.431,11,25,0.44,27,36,0.75,110,2014-04-11,MIN,HOU
2328,28,Home,W 112-104 ,240,43,96,0.448,30,66,0.455,13,30,0.433,13,16,0.813,112,39,82,0.476,30,56,0.536,9,26,0.346,17,19,0.895,104,2014-04-11,SAS,PHO
2329,29,Home,L 112-116 ,240,37,84,0.44,28,50,0.56,9,34,0.265,29,35,0.829,112,44,90,0.489,36,67,0.537,8,23,0.348,20,35,0.571,116,2014-04-16,DEN,GSW
2330,30,Home,W 112-111 ,240,38,86,0.442,33,63,0.524,5,23,0.217,31,41,0.756,112,42,83,0.506,34,64,0.531,8,19,0.421,19,31,0.613,111,2014-04-16,OKC,DET
2331,31,@,W 112-106 ,240,41,91,0.451,35,73,0.479,6,18,0.333,24,31,0.774,112,35,88,0.398,29,72,0.403,6,16,0.375,30,41,0.732,106,2014-11-04,PHO,LAL
2332,32,Home,W 112-103 (OT),265,46,91,0.505,41,81,0.506,5,10,0.5,15,19,0.789,112,40,93,0.43,36,75,0.48,4,18,0.222,19,25,0.76,103,2014-11-07,ORL,MIN
2333,33,Home,L 112-114 (2OT),290,42,98,0.429,32,67,0.478,10,31,0.323,18,25,0.72,112,39,91,0.429,36,75,0.48,3,16,0.188,33,39,0.846,114,2014-11-07,PHO,SAC
2334,34,Home,W 112-104 ,240,39,81,0.481,31,57,0.544,8,24,0.333,26,29,0.897,112,35,74,0.473,26,53,0.491,9,21,0.429,25,32,0.781,104,2014-11-12,PHO,BRK
2335,35,Home,W 112-87 ,240,45,87,0.517,34,61,0.557,11,26,0.423,11,14,0.786,112,32,84,0.381,25,67,0.373,7,17,0.412,16,28,0.571,87,2014-11-15,GSW,CHO
2336,36,@,L 112-120 ,240,39,90,0.433,31,65,0.477,8,25,0.32,26,34,0.765,112,45,88,0.511,32,63,0.508,13,25,0.52,17,21,0.81,120,2014-11-26,DEN,PHO
2337,37,@,W 112-99 ,240,45,84,0.536,39,71,0.549,6,13,0.462,16,26,0.615,112,39,97,0.402,31,69,0.449,8,28,0.286,13,18,0.722,99,2014-11-28,MEM,POR
2338,38,Home,W 112-104 ,240,42,82,0.512,30,58,0.517,12,24,0.5,16,20,0.8,112,38,75,0.507,32,65,0.492,6,10,0.6,22,26,0.846,104,2014-11-28,SAS,SAC
2339,39,@,W 112-96 ,240,45,80,0.563,34,52,0.654,11,28,0.393,11,15,0.733,112,34,75,0.453,27,54,0.5,7,21,0.333,21,33,0.636,96,2014-11-29,LAC,UTA
2340,40,Home,W 112-104 ,240,39,88,0.443,34,71,0.479,5,17,0.294,29,45,0.644,112,37,84,0.44,30,60,0.5,7,24,0.292,23,27,0.852,104,2014-12-02,NOP,OKC
2341,41,@,W 112-102 ,240,40,74,0.541,28,49,0.571,12,25,0.48,20,23,0.87,112,36,64,0.563,30,48,0.625,6,16,0.375,24,32,0.75,102,2014-12-03,ATL,MIA
2342,42,Home,W 112-85 ,240,47,100,0.47,37,78,0.474,10,22,0.455,8,17,0.471,112,37,89,0.416,34,74,0.459,3,15,0.2,8,13,0.615,85,2014-12-04,GSW,NOP
2343,43,Home,L 112-114 (OT),265,45,97,0.464,42,87,0.483,3,10,0.3,19,27,0.704,112,38,78,0.487,26,46,0.565,12,32,0.375,26,31,0.839,114,2014-12-05,MIN,HOU
2344,44,@,W 112-102 ,240,40,89,0.449,28,59,0.475,12,30,0.4,20,25,0.8,112,36,83,0.434,29,62,0.468,7,21,0.333,23,27,0.852,102,2014-12-06,GSW,CHI
2345,45,Home,W 112-107 (OT),265,41,81,0.506,32,48,0.667,9,33,0.273,21,29,0.724,112,43,104,0.413,33,74,0.446,10,30,0.333,11,15,0.733,107,2014-12-08,TOR,DEN
2346,46,Home,W 112-107 ,240,44,83,0.53,35,62,0.565,9,21,0.429,15,17,0.882,112,40,88,0.455,33,70,0.471,7,18,0.389,20,24,0.833,107,2014-12-10,DAL,NOP
2347,47,@,W 112-110 (OT),265,44,96,0.458,32,72,0.444,12,24,0.5,12,15,0.8,112,42,90,0.467,30,59,0.508,12,31,0.387,14,21,0.667,110,2014-12-12,LAL,SAS
2348,48,Home,W 112-88 ,240,39,80,0.488,35,62,0.565,4,18,0.222,30,34,0.882,112,34,99,0.343,27,68,0.397,7,31,0.226,13,18,0.722,88,2014-12-14,OKC,PHO
2349,49,Home,W 112-107 ,240,39,88,0.443,29,57,0.509,10,31,0.323,24,28,0.857,112,45,90,0.5,40,76,0.526,5,14,0.357,12,21,0.571,107,2014-12-28,DAL,OKC
2350,50,Home,W 112-96 ,240,42,84,0.5,28,52,0.538,14,32,0.438,14,16,0.875,112,37,87,0.425,30,61,0.492,7,26,0.269,15,25,0.6,96,2015-01-02,PHO,PHI
2351,51,Home,W 112-94 ,240,43,86,0.5,33,56,0.589,10,30,0.333,16,17,0.941,112,35,86,0.407,28,63,0.444,7,23,0.304,17,23,0.739,94,2015-01-09,GSW,CLE
2352,52,Home,W 112-101 ,240,41,86,0.477,25,50,0.5,16,36,0.444,14,19,0.737,112,35,81,0.432,24,52,0.462,11,29,0.379,20,28,0.714,101,2015-01-15,HOU,OKC
2353,53,Home,W 112-100 ,240,45,80,0.563,35,52,0.673,10,28,0.357,12,18,0.667,112,37,71,0.521,31,55,0.564,6,16,0.375,20,25,0.8,100,2015-01-25,ATL,MIN
2354,54,@,W 112-101 ,240,39,76,0.513,34,64,0.531,5,12,0.417,29,34,0.853,112,37,79,0.468,27,48,0.563,10,31,0.323,17,22,0.773,101,2015-02-08,MIN,DET
2355,55,Home,W 112-107 ,240,43,89,0.483,31,65,0.477,12,24,0.5,14,16,0.875,112,47,88,0.534,37,63,0.587,10,25,0.4,3,8,0.375,107,2015-02-21,CHI,PHO
2356,56,@,L 112-115 ,240,45,94,0.479,41,80,0.513,4,14,0.286,18,22,0.818,112,39,89,0.438,29,63,0.46,10,26,0.385,27,31,0.871,115,2015-02-27,OKC,POR
2357,57,Home,W 112-85 ,240,45,85,0.529,35,62,0.565,10,23,0.435,12,16,0.75,112,29,78,0.372,26,69,0.377,3,9,0.333,24,34,0.706,85,2015-03-04,SAS,SAC
2358,58,Home,L 112-120 ,240,43,79,0.544,33,58,0.569,10,21,0.476,16,17,0.941,112,40,78,0.513,25,42,0.595,15,36,0.417,25,34,0.735,120,2015-03-04,TOR,CLE
2359,59,@,W 112-101 ,240,41,77,0.532,33,59,0.559,8,18,0.444,22,32,0.688,112,34,76,0.447,26,54,0.481,8,22,0.364,25,36,0.694,101,2015-03-20,MEM,DAL
2360,60,Home,W 112-96 ,240,44,88,0.5,39,69,0.565,5,19,0.263,19,23,0.826,112,33,77,0.429,22,55,0.4,11,22,0.5,19,22,0.864,96,2015-03-20,GSW,NOP
2361,61,Home,W 112-89 ,240,37,85,0.435,23,55,0.418,14,30,0.467,24,36,0.667,112,37,82,0.451,35,62,0.565,2,20,0.1,13,19,0.684,89,2015-04-05,IND,MIA
2362,62,Home,L 112-115 ,240,40,92,0.435,26,62,0.419,14,30,0.467,18,26,0.692,112,38,81,0.469,30,53,0.566,8,28,0.286,31,50,0.62,115,2015-04-05,OKC,HOU
2363,63,@,W 112-108 ,240,43,77,0.558,30,52,0.577,13,25,0.52,13,19,0.684,112,39,88,0.443,28,56,0.5,11,32,0.344,19,23,0.826,108,2015-04-13,NYK,ATL
2364,64,@,W 112-101 ,240,42,87,0.483,27,49,0.551,15,38,0.395,13,18,0.722,112,39,80,0.488,28,54,0.519,11,26,0.423,12,20,0.6,101,2015-04-14,LAC,PHO
2365,65,@,W 112-90 ,240,41,81,0.506,31,55,0.564,10,26,0.385,20,27,0.741,112,33,77,0.429,26,58,0.448,7,19,0.368,17,27,0.63,90,2015-04-15,DET,NYK
2366,66,Home,W 112-95 ,240,39,85,0.459,31,61,0.508,8,24,0.333,26,27,0.963,112,34,83,0.41,27,61,0.443,7,22,0.318,20,23,0.87,95,2015-10-28,BOS,PHI
2367,67,@,W 112-111 ,240,38,83,0.458,33,63,0.524,5,20,0.25,31,37,0.838,112,35,90,0.389,26,56,0.464,9,34,0.265,32,35,0.914,111,2015-10-28,MIN,LAL
2368,68,Home,W 112-106 ,240,42,86,0.488,35,67,0.522,7,19,0.368,21,22,0.955,112,45,93,0.484,40,78,0.513,5,15,0.333,11,13,0.846,106,2015-10-28,OKC,SAS
2369,69,Home,W 112-94 ,240,44,88,0.5,32,56,0.571,12,32,0.375,12,14,0.857,112,36,91,0.396,25,58,0.431,11,33,0.333,11,18,0.611,94,2015-10-28,POR,NOP
2370,70,@,W 112-103 ,240,41,82,0.5,34,66,0.515,7,16,0.438,23,29,0.793,112,37,78,0.474,25,48,0.521,12,30,0.4,17,24,0.708,103,2015-10-29,MEM,IND
2371,71,@,W 112-101 ,240,42,83,0.506,32,59,0.542,10,24,0.417,18,26,0.692,112,38,93,0.409,32,64,0.5,6,29,0.207,19,21,0.905,101,2015-10-29,ATL,NYK
2372,72,@,W 112-92 ,240,43,93,0.462,34,67,0.507,9,26,0.346,17,25,0.68,112,30,82,0.366,25,59,0.424,5,23,0.217,27,36,0.75,92,2015-10-30,GSW,HOU
2373,73,Home,W 112-108 ,240,39,85,0.459,29,59,0.492,10,26,0.385,24,31,0.774,112,43,88,0.489,35,66,0.53,8,22,0.364,14,22,0.636,108,2015-11-04,GSW,LAC
2374,74,@,W 112-85 ,240,42,92,0.457,30,65,0.462,12,27,0.444,16,20,0.8,112,35,76,0.461,30,51,0.588,5,25,0.2,10,16,0.625,85,2015-11-18,IND,PHI
2375,75,Home,W 112-98 ,240,36,79,0.456,27,48,0.563,9,31,0.29,31,44,0.705,112,36,84,0.429,27,47,0.574,9,37,0.243,17,22,0.773,98,2015-11-30,SAC,DAL
2376,76,Home,L 112-115 (OT),265,41,100,0.41,26,60,0.433,15,40,0.375,15,17,0.882,112,43,94,0.457,34,65,0.523,9,29,0.31,20,24,0.833,115,2015-12-01,POR,DAL
2377,77,@,W 112-109 ,240,35,73,0.479,19,43,0.442,16,30,0.533,26,36,0.722,112,40,91,0.44,32,71,0.451,8,20,0.4,21,26,0.808,109,2015-12-05,GSW,TOR
2378,78,@,W 112-110 ,240,39,75,0.52,30,54,0.556,9,21,0.429,25,28,0.893,112,41,89,0.461,35,68,0.515,6,21,0.286,22,29,0.759,110,2015-12-12,NYK,POR
2379,79,Home,W 112-95 ,240,44,78,0.564,34,63,0.54,10,15,0.667,14,15,0.933,112,37,86,0.43,28,62,0.452,9,24,0.375,12,20,0.6,95,2015-12-14,MEM,WAS
2380,80,@,W 112-100 ,240,41,73,0.562,31,55,0.564,10,18,0.556,20,27,0.741,112,36,77,0.468,32,67,0.478,4,10,0.4,24,31,0.774,100,2015-12-15,DEN,MIN
2381,81,@,L 112-121 ,240,42,91,0.462,38,73,0.521,4,18,0.222,24,28,0.857,112,42,87,0.483,33,61,0.541,9,26,0.346,28,37,0.757,121,2015-12-18,MIL,GSW
2382,82,Home,W 112-96 ,240,45,80,0.563,39,64,0.609,6,16,0.375,16,22,0.727,112,32,84,0.381,24,55,0.436,8,29,0.276,24,32,0.75,96,2015-12-27,MEM,LAL
2383,83,@,L 112-122 ,240,46,94,0.489,37,69,0.536,9,25,0.36,11,15,0.733,112,48,83,0.578,40,68,0.588,8,15,0.533,18,21,0.857,122,2015-12-27,DEN,OKC
2384,84,@,W 112-104 ,240,43,94,0.457,34,75,0.453,9,19,0.474,17,23,0.739,112,38,88,0.432,31,61,0.508,7,27,0.259,21,25,0.84,104,2015-12-30,LAL,BOS
2385,85,Home,W 112-79 ,240,43,76,0.566,37,62,0.597,6,14,0.429,20,33,0.606,112,32,81,0.395,27,63,0.429,5,18,0.278,10,18,0.556,79,2015-12-30,SAS,PHO
2386,86,@,W 112-106 ,240,40,78,0.513,30,55,0.545,10,23,0.435,22,32,0.688,112,34,80,0.425,27,58,0.466,7,22,0.318,31,48,0.646,106,2016-01-03,POR,DEN
2387,87,Home,W 112-94 ,240,38,83,0.458,30,66,0.455,8,17,0.471,28,33,0.848,112,35,90,0.389,28,69,0.406,7,21,0.333,17,24,0.708,94,2016-01-06,OKC,MEM
2388,88,Home,W 112-110 ,240,37,87,0.425,32,65,0.492,5,22,0.227,33,37,0.892,112,42,88,0.477,32,62,0.516,10,26,0.385,16,20,0.8,110,2016-01-13,DEN,GSW
2389,89,@,W 112-95 ,240,44,91,0.484,38,70,0.543,6,21,0.286,18,24,0.75,112,37,82,0.451,31,63,0.492,6,19,0.316,15,19,0.789,95,2016-01-17,HOU,LAL
2390,90,Home,W 112-83 ,240,42,90,0.467,37,70,0.529,5,20,0.25,23,28,0.821,112,29,81,0.358,23,58,0.397,6,23,0.261,19,25,0.76,83,2016-01-17,SAS,DAL
2391,91,Home,W 112-100 ,240,43,85,0.506,30,61,0.492,13,24,0.542,13,18,0.722,112,39,76,0.513,34,62,0.548,5,14,0.357,17,19,0.895,100,2016-01-18,TOR,BRK
2392,92,@,W 112-93 ,240,43,89,0.483,37,69,0.536,6,20,0.3,20,28,0.714,112,32,90,0.356,28,65,0.431,4,25,0.16,25,31,0.806,93,2016-01-20,SAC,LAL
2393,93,@,W 112-92 ,240,43,97,0.443,32,72,0.444,11,25,0.44,15,19,0.789,112,35,89,0.393,27,63,0.429,8,26,0.308,14,20,0.7,92,2016-01-24,BOS,PHI
2394,94,Home,W 112-94 ,240,41,83,0.494,29,61,0.475,12,22,0.545,18,26,0.692,112,34,76,0.447,26,50,0.52,8,26,0.308,18,30,0.6,94,2016-01-24,TOR,LAC
2395,95,@,W 112-111 ,240,38,80,0.475,19,40,0.475,19,40,0.475,17,21,0.81,112,42,91,0.462,29,62,0.468,13,29,0.448,14,25,0.56,111,2016-01-25,HOU,NOP
2396,96,Home,W 112-97 ,240,44,90,0.489,35,60,0.583,9,30,0.3,15,19,0.789,112,36,86,0.419,29,67,0.433,7,19,0.368,18,32,0.563,97,2016-01-26,POR,SAC
2397,97,Home,W 112-97 ,240,42,80,0.525,28,45,0.622,14,35,0.4,14,19,0.737,112,31,85,0.365,24,59,0.407,7,26,0.269,28,38,0.737,97,2016-02-01,ATL,DAL
2398,98,Home,W 112-93 ,240,45,83,0.542,35,61,0.574,10,22,0.455,12,15,0.8,112,29,78,0.372,21,53,0.396,8,25,0.32,27,39,0.692,93,2016-02-01,DEN,TOR
2399,99,Home,W 112-104 ,240,41,76,0.539,35,65,0.538,6,11,0.545,24,29,0.828,112,38,79,0.481,26,46,0.565,12,33,0.364,16,31,0.516,104,2016-02-06,IND,DET
2400,0,Home,W 112-105 ,240,45,87,0.517,44,75,0.587,1,12,0.083,21,22,0.955,112,40,85,0.471,32,65,0.492,8,20,0.4,17,19,0.895,105,2016-02-06,MIN,CHI
2401,1,@,W 112-106 (OT),265,44,89,0.494,34,60,0.567,10,29,0.345,14,20,0.7,112,43,86,0.5,36,67,0.537,7,19,0.368,13,19,0.684,106,2016-02-08,POR,MEM
2402,2,Home,W 112-111 ,240,45,88,0.511,38,69,0.551,7,19,0.368,15,23,0.652,112,39,84,0.464,29,55,0.527,10,29,0.345,23,24,0.958,111,2016-02-09,MIL,BOS
2403,3,@,L 112-117 ,240,39,86,0.453,29,55,0.527,10,31,0.323,24,32,0.75,112,35,76,0.461,31,62,0.5,4,14,0.286,43,53,0.811,117,2016-02-10,TOR,MIN
2404,4,@,W 112-104 ,240,37,89,0.416,23,49,0.469,14,40,0.35,24,29,0.828,112,41,93,0.441,35,72,0.486,6,21,0.286,16,22,0.727,104,2016-02-10,GSW,PHO
2405,5,Home,L 112-115 ,240,42,94,0.447,29,58,0.5,13,36,0.361,15,18,0.833,112,42,82,0.512,31,51,0.608,11,31,0.355,20,26,0.769,115,2016-02-20,LAC,GSW
2406,6,Home,W 112-104 ,240,40,80,0.5,30,57,0.526,10,23,0.435,22,25,0.88,112,43,90,0.478,40,78,0.513,3,12,0.25,15,19,0.789,104,2016-02-23,POR,BRK
2407,7,Home,L 112-118 ,240,40,86,0.465,34,72,0.472,6,14,0.429,26,31,0.839,112,42,90,0.467,29,62,0.468,13,28,0.464,21,25,0.84,118,2016-02-24,MIA,GSW
2408,8,Home,W 112-107 ,240,41,84,0.488,36,61,0.59,5,23,0.217,25,33,0.758,112,42,87,0.483,38,72,0.528,4,15,0.267,19,25,0.76,107,2016-02-25,BOS,MIL
2409,9,@,W 112-95 ,240,43,85,0.506,30,53,0.566,13,32,0.406,13,15,0.867,112,32,78,0.41,27,55,0.491,5,23,0.217,26,39,0.667,95,2016-02-26,MEM,LAL
2410,10,@,W 112-110 ,240,42,84,0.5,37,69,0.536,5,15,0.333,23,30,0.767,112,39,84,0.464,29,57,0.509,10,27,0.37,22,26,0.846,110,2016-02-27,MIN,NOP
2411,11,@,W 112-102 ,240,39,88,0.443,34,72,0.472,5,16,0.313,29,36,0.806,112,36,95,0.379,27,64,0.422,9,31,0.29,21,27,0.778,102,2016-03-04,MIA,PHI
2412,12,Home,W 112-95 ,240,41,87,0.471,32,62,0.516,9,25,0.36,21,22,0.955,112,37,92,0.402,33,62,0.532,4,30,0.133,17,21,0.81,95,2016-03-06,LAL,GSW
2413,13,@,L 112-115 ,240,41,83,0.494,34,58,0.586,7,25,0.28,23,27,0.852,112,45,94,0.479,38,69,0.551,7,25,0.28,18,26,0.692,115,2016-03-07,SAC,NOP
2414,14,@,L 112-128 ,240,37,86,0.43,18,50,0.36,19,36,0.528,19,23,0.826,112,40,89,0.449,22,49,0.449,18,40,0.45,30,39,0.769,128,2016-03-11,POR,GSW
2415,15,@,W 112-105 ,240,38,81,0.469,29,53,0.547,9,28,0.321,27,29,0.931,112,41,85,0.482,33,63,0.524,8,22,0.364,15,18,0.833,105,2016-03-12,IND,DAL
2416,16,Home,W 112-104 (OT),265,37,84,0.44,31,66,0.47,6,18,0.333,32,38,0.842,112,37,98,0.378,28,73,0.384,9,25,0.36,21,26,0.808,104,2016-03-12,TOR,MIA
2417,17,Home,L 112-130 ,240,41,93,0.441,32,64,0.5,9,29,0.31,21,22,0.955,112,48,95,0.505,26,57,0.456,22,38,0.579,12,14,0.857,130,2016-03-18,DAL,GSW
2418,18,Home,L 112-117 ,240,40,83,0.482,30,62,0.484,10,21,0.476,22,28,0.786,112,36,78,0.462,27,51,0.529,9,27,0.333,36,40,0.9,117,2016-03-18,NOP,POR
2419,19,Home,W 112-88 ,240,42,81,0.519,34,67,0.507,8,14,0.571,20,24,0.833,112,37,77,0.481,30,63,0.476,7,14,0.5,7,12,0.583,88,2016-03-23,SAS,MIA
2420,20,Home,W 112-105 ,240,42,91,0.462,34,61,0.557,8,30,0.267,20,26,0.769,112,37,93,0.398,23,63,0.365,14,30,0.467,17,22,0.773,105,2016-03-25,DET,CHO
2421,21,Home,W 112-109 ,240,42,81,0.519,30,59,0.508,12,22,0.545,16,35,0.457,112,39,94,0.415,26,63,0.413,13,31,0.419,18,26,0.692,109,2016-03-25,HOU,TOR
2422,22,@,W 112-95 ,240,43,95,0.453,30,61,0.492,13,34,0.382,13,14,0.929,112,34,88,0.386,27,59,0.458,7,29,0.241,20,28,0.714,95,2016-03-26,ATL,DET
2423,23,@,W 112-106 ,240,42,82,0.512,30,60,0.5,12,22,0.545,16,17,0.941,112,38,87,0.437,31,66,0.47,7,21,0.333,23,29,0.793,106,2016-04-01,MIA,SAC
2424,24,Home,W 112-103 ,240,45,83,0.542,29,54,0.537,16,29,0.552,6,13,0.462,112,34,76,0.447,25,50,0.5,9,26,0.346,26,27,0.963,103,2016-04-03,CLE,CHO
2425,25,Home,W 112-101 ,240,45,83,0.542,33,58,0.569,12,25,0.48,10,11,0.909,112,39,80,0.488,32,64,0.5,7,16,0.438,16,23,0.696,101,2016-04-07,GSW,SAS
2426,26,Home,W 112-99 ,240,36,77,0.468,22,45,0.489,14,32,0.438,26,29,0.897,112,38,86,0.442,32,67,0.478,6,19,0.316,17,23,0.739,99,2016-04-08,DET,WAS
2427,27,Home,W 112-109 ,240,43,82,0.524,38,71,0.535,5,11,0.455,21,28,0.75,112,45,100,0.45,37,78,0.474,8,22,0.364,11,21,0.524,109,2016-04-08,ORL,MIA
2428,28,@,L 112-114 ,240,39,81,0.481,26,49,0.531,13,32,0.406,21,28,0.75,112,45,94,0.479,32,62,0.516,13,32,0.406,11,20,0.55,114,2016-04-09,OKC,SAC
2429,29,Home,W 112-79 ,240,42,96,0.438,30,59,0.508,12,37,0.324,16,27,0.593,112,23,81,0.284,16,50,0.32,7,31,0.226,26,30,0.867,79,2016-04-11,OKC,LAL
2430,30,@,W 112-110 (OT),265,37,85,0.435,21,52,0.404,16,33,0.485,22,28,0.786,112,46,97,0.474,39,79,0.494,7,18,0.389,11,15,0.733,110,2016-04-13,DET,CLE
2431,31,Home,W 112-103 (OT),265,39,88,0.443,24,57,0.421,15,31,0.484,19,26,0.731,112,38,86,0.442,33,61,0.541,5,25,0.2,22,25,0.88,103,2016-10-30,MEM,WAS
2432,32,@,W 112-111 (OT),265,40,93,0.43,32,69,0.464,8,24,0.333,24,28,0.857,112,43,94,0.457,33,64,0.516,10,30,0.333,15,28,0.536,111,2016-11-04,PHO,NOP
2433,33,Home,W 112-97 ,240,45,85,0.529,37,65,0.569,8,20,0.4,14,24,0.583,112,37,85,0.435,25,49,0.51,12,36,0.333,11,13,0.846,97,2016-11-05,ATL,HOU
2434,34,Home,W 112-92 ,240,45,86,0.523,38,70,0.543,7,16,0.438,15,24,0.625,112,33,84,0.393,29,65,0.446,4,19,0.211,22,29,0.759,92,2016-11-05,OKC,MIN
2435,35,Home,W 112-80 ,240,42,89,0.472,39,70,0.557,3,19,0.158,25,31,0.806,112,33,85,0.388,24,55,0.436,9,30,0.3,5,6,0.833,80,2016-11-07,CHI,ORL
2436,36,@,W 112-102 ,240,43,83,0.518,32,57,0.561,11,26,0.423,15,22,0.682,112,31,74,0.419,19,40,0.475,12,34,0.353,28,31,0.903,102,2016-11-09,TOR,OKC
2437,37,@,W 112-106 ,240,39,89,0.438,30,64,0.469,9,25,0.36,25,27,0.926,112,40,91,0.44,34,73,0.466,6,18,0.333,20,25,0.8,106,2016-11-10,NOP,MIL
2438,38,Home,W 112-105 ,240,39,99,0.394,31,70,0.443,8,29,0.276,26,32,0.813,112,36,91,0.396,25,62,0.403,11,29,0.379,22,29,0.759,105,2016-11-13,POR,DEN
2439,39,@,L 112-119 ,240,41,86,0.477,29,57,0.509,12,29,0.414,18,20,0.9,112,44,81,0.543,29,56,0.518,15,25,0.6,16,18,0.889,119,2016-11-17,NYK,WAS
2440,40,@,W 112-94 ,240,45,86,0.523,34,61,0.557,11,25,0.44,11,12,0.917,112,39,85,0.459,29,56,0.518,10,29,0.345,6,10,0.6,94,2016-11-22,NOP,ATL
2441,41,@,W 112-100 ,240,40,75,0.533,31,51,0.608,9,24,0.375,23,29,0.793,112,42,88,0.477,36,66,0.545,6,22,0.273,10,14,0.714,100,2016-11-26,SAS,WAS
2442,42,@,W 112-108 ,240,38,92,0.413,26,52,0.5,12,40,0.3,24,28,0.857,112,43,92,0.467,28,58,0.483,15,34,0.441,7,10,0.7,108,2016-11-27,CLE,PHI
2443,43,@,W 112-104 ,240,40,83,0.482,29,56,0.518,11,27,0.407,21,26,0.808,112,38,80,0.475,32,50,0.64,6,30,0.2,22,32,0.688,104,2016-11-28,BOS,MIA
2444,44,@,W 112-103 ,240,40,79,0.506,36,61,0.59,4,18,0.222,28,34,0.824,112,36,81,0.444,29,62,0.468,7,19,0.368,24,25,0.96,103,2016-11-28,UTA,MIN
2445,45,@,W 112-103 ,240,46,92,0.5,38,70,0.543,8,22,0.364,12,18,0.667,112,36,91,0.396,30,72,0.417,6,19,0.316,25,28,0.893,103,2016-11-28,OKC,NYK
2446,46,@,W 112-89 ,240,45,92,0.489,33,64,0.516,12,28,0.429,10,11,0.909,112,31,78,0.397,22,51,0.431,9,27,0.333,18,21,0.857,89,2016-11-29,DET,CHO
2447,47,Home,W 112-103 ,240,40,85,0.471,34,61,0.557,6,24,0.25,26,36,0.722,112,34,91,0.374,23,50,0.46,11,41,0.268,24,33,0.727,103,2016-12-03,MIL,BRK
2448,48,@,W 112-110 ,240,45,93,0.484,36,69,0.522,9,24,0.375,13,18,0.722,112,35,83,0.422,28,60,0.467,7,23,0.304,33,38,0.868,110,2016-12-05,POR,CHI
2449,49,Home,L 112-116 ,240,38,88,0.432,25,56,0.446,13,32,0.406,23,27,0.852,112,40,84,0.476,26,52,0.5,14,32,0.438,22,27,0.815,116,2016-12-05,TOR,CLE
2450,50,Home,W 112-105 ,240,36,73,0.493,24,46,0.522,12,27,0.444,28,32,0.875,112,39,84,0.464,33,66,0.5,6,18,0.333,21,25,0.84,105,2016-12-06,UTA,PHO
2451,51,Home,L 112-118 ,240,42,88,0.477,32,60,0.533,10,28,0.357,18,22,0.818,112,41,84,0.488,31,62,0.5,10,22,0.455,26,31,0.839,118,2016-12-11,LAL,NYK
2452,52,Home,W 112-92 ,240,45,77,0.584,33,51,0.647,12,26,0.462,10,12,0.833,112,35,83,0.422,28,58,0.483,7,25,0.28,15,18,0.833,92,2016-12-12,DAL,DEN
2453,53,Home,W 112-101 ,240,45,88,0.511,36,62,0.581,9,26,0.346,13,19,0.684,112,39,84,0.464,34,61,0.557,5,23,0.217,18,22,0.818,101,2016-12-12,MIA,WAS
2454,54,@,W 112-109 (OT),265,33,81,0.407,21,44,0.477,12,37,0.324,34,38,0.895,112,38,94,0.404,26,64,0.406,12,30,0.4,21,26,0.808,109,2016-12-20,BOS,MEM
2455,55,Home,L 112-117 ,240,41,93,0.441,32,65,0.492,9,28,0.321,21,26,0.808,112,41,80,0.513,30,54,0.556,11,26,0.423,24,36,0.667,117,2016-12-23,BOS,OKC
2456,56,Home,W 112-100 ,240,42,82,0.512,34,58,0.586,8,24,0.333,20,24,0.833,112,39,83,0.47,35,71,0.493,4,12,0.333,18,23,0.783,100,2016-12-25,OKC,MIN
2457,57,Home,W 112-102 ,240,44,86,0.512,31,60,0.517,13,26,0.5,11,16,0.688,112,35,76,0.461,25,51,0.49,10,25,0.4,22,28,0.786,102,2016-12-26,ORL,MEM
2458,58,@,W 112-98 ,240,44,87,0.506,27,52,0.519,17,35,0.486,7,9,0.778,112,31,72,0.431,20,44,0.455,11,28,0.393,25,28,0.893,98,2016-12-31,MEM,SAC
2459,59,@,L 112-114 (OT),265,42,90,0.467,33,63,0.524,9,27,0.333,19,22,0.864,112,42,92,0.457,28,64,0.438,14,28,0.5,16,27,0.593,114,2017-01-01,SAS,ATL
2460,60,@,L 112-123 ,240,42,96,0.438,33,66,0.5,9,30,0.3,19,23,0.826,112,37,80,0.463,28,56,0.5,9,24,0.375,40,49,0.816,123,2017-01-04,OKC,CHO
2461,61,Home,W 112-105 ,240,46,79,0.582,34,57,0.596,12,22,0.545,8,9,0.889,112,42,88,0.477,35,70,0.5,7,18,0.389,14,17,0.824,105,2017-01-06,WAS,MIN
2462,62,@,L 112-140 ,240,44,94,0.468,32,65,0.492,12,29,0.414,12,13,0.923,112,52,91,0.571,37,59,0.627,15,32,0.469,21,23,0.913,140,2017-01-12,IND,DEN
2463,63,Home,L 112-137 ,240,41,93,0.441,26,49,0.531,15,44,0.341,15,19,0.789,112,46,92,0.5,25,48,0.521,21,44,0.477,24,32,0.75,137,2017-01-15,BRK,HOU
2464,64,@,L 112-125 ,240,45,88,0.511,37,63,0.587,8,25,0.32,14,18,0.778,112,52,89,0.584,43,62,0.694,9,27,0.333,12,15,0.8,125,2017-01-16,ORL,DEN
2465,65,@,W 112-107 (OT),265,38,82,0.463,30,59,0.508,8,23,0.348,28,39,0.718,112,39,87,0.448,31,64,0.484,8,23,0.348,21,28,0.75,107,2017-01-20,UTA,DAL
2466,66,Home,W 112-96 ,240,40,87,0.46,32,59,0.542,8,28,0.286,24,31,0.774,112,34,84,0.405,24,59,0.407,10,25,0.4,18,26,0.692,96,2017-01-20,ORL,MIL
2467,67,Home,W 112-105 ,240,39,82,0.476,25,53,0.472,14,29,0.483,20,22,0.909,112,38,89,0.427,21,48,0.438,17,41,0.415,12,15,0.8,105,2017-01-21,CHA,BRK
2468,68,@,L 112-113 ,240,39,91,0.429,31,65,0.477,8,26,0.308,26,33,0.788,112,43,87,0.494,32,59,0.542,11,28,0.393,16,22,0.727,113,2017-01-21,WAS,DET
2469,69,@,W 112-86 ,240,45,95,0.474,36,73,0.493,9,22,0.409,13,16,0.813,112,32,81,0.395,27,56,0.482,5,25,0.2,17,18,0.944,86,2017-01-23,SAS,BRK
2470,70,@,W 112-111 ,240,44,84,0.524,38,67,0.567,6,17,0.353,18,24,0.75,112,38,86,0.442,31,67,0.463,7,19,0.368,28,32,0.875,111,2017-01-24,MIN,PHO
2471,71,Home,L 112-116 (OT),265,40,82,0.488,25,44,0.568,15,38,0.395,17,34,0.5,112,43,95,0.453,32,64,0.5,11,31,0.355,19,22,0.864,116,2017-01-25,CLE,SAC
2472,72,@,W 112-86 ,240,43,89,0.483,30,58,0.517,13,31,0.419,13,19,0.684,112,30,83,0.361,21,52,0.404,9,31,0.29,17,25,0.68,86,2017-01-27,WAS,ATL
2473,73,Home,W 112-109 ,240,38,81,0.469,22,46,0.478,16,35,0.457,20,21,0.952,112,37,77,0.481,28,51,0.549,9,26,0.346,26,33,0.788,109,2017-01-27,POR,MEM
2474,74,@,W 112-108 (OT),265,37,89,0.416,23,49,0.469,14,40,0.35,24,30,0.8,112,37,87,0.425,28,66,0.424,9,21,0.429,25,32,0.781,108,2017-01-28,BOS,MIL
2475,75,Home,L 112-123 ,240,41,91,0.451,35,70,0.5,6,21,0.286,24,32,0.75,112,39,80,0.488,31,55,0.564,8,25,0.32,37,42,0.881,123,2017-01-28,PHO,DEN
2476,76,Home,L 112-137 ,240,38,91,0.418,27,63,0.429,11,28,0.393,25,30,0.833,112,52,82,0.634,45,65,0.692,7,17,0.412,26,35,0.743,137,2017-02-04,PHO,MIL
2477,77,@,W 112-107 ,240,43,81,0.531,37,62,0.597,6,19,0.316,20,31,0.645,112,41,79,0.519,30,51,0.588,11,28,0.393,14,16,0.875,107,2017-02-06,CHI,SAC
2478,78,Home,W 112-109 ,240,39,80,0.488,32,61,0.525,7,19,0.368,27,30,0.9,112,42,79,0.532,31,51,0.608,11,28,0.393,14,20,0.7,109,2017-02-08,MIN,TOR
2479,79,Home,W 112-105 (OT),265,44,87,0.506,39,67,0.582,5,20,0.25,19,25,0.76,112,39,85,0.459,26,56,0.464,13,29,0.448,14,17,0.824,105,2017-02-09,DAL,UTA
2480,80,@,W 112-111 ,240,40,95,0.421,29,67,0.433,11,28,0.393,21,27,0.778,112,41,84,0.488,31,63,0.492,10,21,0.476,19,24,0.792,111,2017-02-09,PHI,ORL
2481,81,Home,W 112-107 ,240,41,88,0.466,31,59,0.525,10,29,0.345,20,30,0.667,112,45,92,0.489,41,71,0.577,4,21,0.19,13,15,0.867,107,2017-02-10,WAS,IND
2482,82,Home,W 112-80 ,240,45,91,0.495,28,56,0.5,17,35,0.486,5,6,0.833,112,32,82,0.39,29,59,0.492,3,23,0.13,13,18,0.722,80,2017-02-11,DAL,ORL
2483,83,@,W 112-104 ,240,42,71,0.592,29,41,0.707,13,30,0.433,15,23,0.652,112,35,86,0.407,27,55,0.491,8,31,0.258,26,30,0.867,104,2017-02-11,BOS,UTA
2484,84,@,W 112-103 ,240,39,77,0.506,30,55,0.545,9,22,0.409,25,27,0.926,112,38,82,0.463,26,45,0.578,12,37,0.324,15,18,0.833,103,2017-02-13,MEM,BRK
2485,85,@,W 112-99 ,240,41,86,0.477,35,68,0.515,6,18,0.333,24,28,0.857,112,38,94,0.404,27,60,0.45,11,34,0.324,12,18,0.667,99,2017-02-15,MIN,DEN
2486,86,@,W 112-103 ,240,41,81,0.506,32,62,0.516,9,19,0.474,21,27,0.778,112,34,86,0.395,27,64,0.422,7,22,0.318,28,39,0.718,103,2017-02-23,POR,ORL
2487,87,@,L 112-120 ,240,38,90,0.422,33,66,0.5,5,24,0.208,31,40,0.775,112,43,87,0.494,33,58,0.569,10,29,0.345,24,30,0.8,120,2017-02-24,WAS,PHI
2488,88,Home,W 112-95 ,240,42,100,0.42,31,69,0.449,11,31,0.355,17,22,0.773,112,38,94,0.404,30,66,0.455,8,28,0.286,11,17,0.647,95,2017-02-25,GSW,BRK
2489,89,Home,W 112-106 ,240,42,78,0.538,35,58,0.603,7,20,0.35,21,27,0.778,112,35,79,0.443,26,58,0.448,9,21,0.429,27,35,0.771,106,2017-02-26,TOR,POR
2490,90,@,L 112-130 ,240,43,83,0.518,36,62,0.581,7,21,0.333,19,24,0.792,112,48,86,0.558,36,61,0.59,12,25,0.48,22,29,0.759,130,2017-02-28,PHO,MEM
2491,91,Home,W 112-108 ,240,41,91,0.451,29,63,0.46,12,28,0.429,18,20,0.9,112,39,84,0.464,31,55,0.564,8,29,0.276,22,27,0.815,108,2017-02-28,WAS,GSW
2492,92,Home,W 112-101 ,240,44,80,0.55,34,55,0.618,10,25,0.4,14,15,0.933,112,36,64,0.563,28,45,0.622,8,19,0.421,21,36,0.583,101,2017-03-03,MIL,LAC
2493,93,Home,W 112-97 ,240,38,74,0.514,26,48,0.542,12,26,0.462,24,34,0.706,112,36,89,0.404,29,59,0.492,7,30,0.233,18,24,0.75,97,2017-03-03,UTA,BRK
2494,94,@,W 112-102 ,240,41,90,0.456,25,63,0.397,16,27,0.593,14,17,0.824,112,36,80,0.45,27,50,0.54,9,30,0.3,21,25,0.84,102,2017-03-04,CHA,DEN
2495,95,@,W 112-105 ,240,40,88,0.455,27,53,0.509,13,35,0.371,19,23,0.826,112,39,83,0.47,32,61,0.525,7,22,0.318,20,25,0.8,105,2017-03-05,GSW,NYK
2496,96,@,W 112-98 ,240,41,83,0.494,27,50,0.54,14,33,0.424,16,20,0.8,112,39,89,0.438,31,59,0.525,8,30,0.267,12,19,0.632,98,2017-03-06,MIL,PHI
2497,97,Home,W 112-110 ,240,40,87,0.46,29,60,0.483,11,27,0.407,21,23,0.913,112,41,88,0.466,27,49,0.551,14,39,0.359,14,17,0.824,110,2017-03-06,SAS,HOU
2498,98,Home,W 111-102 ,240,41,79,0.519,33,59,0.559,8,20,0.4,21,23,0.913,111,35,87,0.402,31,67,0.463,4,20,0.2,28,33,0.848,102,2011-12-29,POR,DEN
2499,99,Home,W 111-106 (OT),265,38,95,0.4,29,68,0.426,9,27,0.333,26,30,0.867,111,39,85,0.459,37,74,0.5,2,11,0.182,26,40,0.65,106,2012-01-10,GSW,MIA
2500,0,@,W 111-100 ,240,43,81,0.531,32,61,0.525,11,20,0.55,14,21,0.667,111,33,78,0.423,25,56,0.446,8,22,0.364,26,32,0.813,100,2012-01-10,CHI,MIN
2501,1,Home,W 111-81 ,240,42,90,0.467,36,71,0.507,6,19,0.316,21,28,0.75,111,33,78,0.423,32,70,0.457,1,8,0.125,14,16,0.875,81,2012-01-12,ATL,CHA
2502,2,@,W 111-78 ,240,39,78,0.5,32,59,0.542,7,19,0.368,26,33,0.788,111,27,82,0.329,24,71,0.338,3,11,0.273,21,22,0.955,78,2012-01-24,NYK,CHA
2503,3,@,W 111-106 (2OT),290,43,96,0.448,33,68,0.485,10,28,0.357,15,19,0.789,111,39,90,0.433,35,72,0.486,4,18,0.222,24,36,0.667,106,2012-01-25,TOR,UTA
2504,4,@,W 111-107 (OT),265,43,95,0.453,37,73,0.507,6,22,0.273,19,22,0.864,111,41,97,0.423,36,77,0.468,5,20,0.25,20,26,0.769,107,2012-02-06,OKC,POR
2505,5,Home,W 111-108 (OT),265,39,80,0.488,36,71,0.507,3,9,0.333,30,41,0.732,111,34,85,0.4,21,59,0.356,13,26,0.5,27,34,0.794,108,2012-02-06,WAS,TOR
2506,6,@,W 111-86 ,240,41,78,0.526,33,58,0.569,8,20,0.4,21,24,0.875,111,26,74,0.351,25,60,0.417,1,14,0.071,33,43,0.767,86,2012-02-11,LAC,CHA
2507,7,Home,W 111-85 ,240,42,77,0.545,37,63,0.587,5,14,0.357,22,34,0.647,111,32,90,0.356,29,77,0.377,3,13,0.231,18,24,0.75,85,2012-02-14,OKC,UTA
2508,8,@,W 111-87 ,240,40,79,0.506,26,58,0.448,14,21,0.667,17,20,0.85,111,30,76,0.395,24,60,0.4,6,16,0.375,21,31,0.677,87,2012-02-17,MIA,CLE
2509,9,@,W 111-98 ,240,43,77,0.558,38,62,0.613,5,15,0.333,20,23,0.87,111,40,85,0.471,30,65,0.462,10,20,0.5,8,10,0.8,98,2012-02-17,MIN,HOU
2510,10,Home,W 111-99 ,240,44,83,0.53,39,72,0.542,5,11,0.455,18,24,0.75,111,41,90,0.456,33,64,0.516,8,26,0.308,9,13,0.692,99,2012-02-17,LAL,PHO
2511,11,@,L 111-115 (OT),265,41,94,0.436,33,76,0.434,8,18,0.444,21,26,0.808,111,45,103,0.437,38,85,0.447,7,18,0.389,18,22,0.818,115,2012-03-04,NYK,BOS
2512,12,Home,W 111-97 ,240,43,77,0.558,36,59,0.61,7,18,0.389,18,24,0.75,111,40,85,0.471,40,82,0.488,0,3,0.0,17,22,0.773,97,2012-03-10,CHI,UTA
2513,13,Home,W 111-87 ,240,40,74,0.541,30,49,0.612,10,25,0.4,21,25,0.84,111,28,75,0.373,18,52,0.346,10,23,0.435,21,26,0.808,87,2012-03-10,GSW,DAL
2514,14,Home,L 111-116 (2OT),290,52,116,0.448,50,97,0.515,2,19,0.105,5,5,1.0,111,41,83,0.494,35,63,0.556,6,20,0.3,28,34,0.824,116,2012-03-13,MEM,LAL
2515,15,Home,W 111-94 ,240,43,76,0.566,36,59,0.61,7,17,0.412,18,22,0.818,111,40,76,0.526,34,63,0.54,6,13,0.462,8,10,0.8,94,2012-03-14,IND,PHI
2516,16,@,L 111-120 ,240,47,90,0.522,42,77,0.545,5,13,0.385,12,17,0.706,111,44,78,0.564,35,59,0.593,9,19,0.474,23,32,0.719,120,2012-03-14,UTA,PHO
2517,17,@,L 111-122 ,240,45,86,0.523,34,59,0.576,11,27,0.407,10,16,0.625,111,43,83,0.518,30,57,0.526,13,26,0.5,23,27,0.852,122,2012-03-14,ORL,SAS
2518,18,Home,W 111-105 (OT),265,43,103,0.417,38,90,0.422,5,13,0.385,20,27,0.741,111,36,83,0.434,27,56,0.482,9,27,0.333,24,33,0.727,105,2012-03-15,UTA,MIN
2519,19,Home,W 111-95 ,240,41,74,0.554,30,56,0.536,11,18,0.611,18,28,0.643,111,39,84,0.464,31,63,0.492,8,21,0.381,9,14,0.643,95,2012-03-18,OKC,POR
2520,20,Home,L 111-113 ,240,42,81,0.519,35,70,0.5,7,11,0.636,20,22,0.909,111,41,84,0.488,36,67,0.537,5,17,0.294,26,37,0.703,113,2012-03-23,IND,PHO
2521,21,Home,W 111-108 ,240,43,88,0.489,36,67,0.537,7,21,0.333,18,21,0.857,111,43,91,0.473,42,76,0.553,1,15,0.067,21,27,0.778,108,2012-03-24,GSW,SAC
2522,22,@,W 111-99 ,240,43,92,0.467,33,64,0.516,10,28,0.357,15,20,0.75,111,39,90,0.433,36,73,0.493,3,17,0.176,18,23,0.783,99,2012-03-31,BRK,SAC
2523,23,@,W 111-107 ,240,41,80,0.513,35,64,0.547,6,16,0.375,23,27,0.852,111,42,85,0.494,34,60,0.567,8,25,0.32,15,24,0.625,107,2012-04-11,NYK,MIL
2524,24,Home,W 111-88 ,240,39,88,0.443,28,64,0.438,11,24,0.458,22,25,0.88,111,32,87,0.368,25,62,0.403,7,25,0.28,17,25,0.68,88,2012-04-16,IND,MIN
2525,25,@,L 111-114 ,240,39,77,0.506,24,46,0.522,15,31,0.484,18,22,0.818,111,42,85,0.494,29,56,0.518,13,29,0.448,17,21,0.81,114,2012-11-21,NYK,DAL
2526,26,@,L 111-117 (OT),265,40,93,0.43,33,73,0.452,7,20,0.35,24,33,0.727,111,36,79,0.456,25,56,0.446,11,23,0.478,34,39,0.872,117,2012-11-21,LAC,OKC
2527,27,Home,W 111-108 (OT),265,44,90,0.489,33,65,0.508,11,25,0.44,12,19,0.632,111,40,78,0.513,27,52,0.519,13,26,0.5,15,18,0.833,108,2012-11-23,PHO,NOH
2528,28,@,W 111-106 (2OT),290,44,103,0.427,36,76,0.474,8,27,0.296,15,19,0.789,111,40,110,0.364,34,86,0.395,6,24,0.25,20,24,0.833,106,2012-11-25,SAS,TOR
2529,29,Home,L 111-113 ,240,38,78,0.487,26,58,0.448,12,20,0.6,23,32,0.719,111,41,85,0.482,31,62,0.5,10,23,0.435,21,22,0.955,113,2012-11-30,ATL,CLE
2530,30,Home,L 111-117 ,240,39,91,0.429,25,57,0.439,14,34,0.412,19,23,0.826,111,40,66,0.606,33,52,0.635,7,14,0.5,30,34,0.882,117,2012-12-04,BRK,OKC
2531,31,@,W 111-85 ,240,44,82,0.537,39,71,0.549,5,11,0.455,18,24,0.75,111,30,83,0.361,23,62,0.371,7,21,0.333,18,25,0.72,85,2012-12-15,LAC,MIL
2532,32,@,W 111-98 ,240,39,80,0.488,25,46,0.543,14,34,0.412,19,24,0.792,111,41,83,0.494,31,58,0.534,10,25,0.4,6,11,0.545,98,2012-12-16,LAL,PHI
2533,33,Home,W 111-105 (OT),265,39,93,0.419,29,68,0.426,10,25,0.4,23,28,0.821,111,40,95,0.421,29,71,0.408,11,24,0.458,14,16,0.875,105,2012-12-27,OKC,DAL
2534,34,Home,W 111-107 ,240,45,89,0.506,40,71,0.563,5,18,0.278,16,26,0.615,111,45,97,0.464,43,80,0.538,2,17,0.118,15,24,0.625,107,2012-12-29,MIN,PHO
2535,35,@,W 111-86 ,240,41,81,0.506,33,62,0.532,8,19,0.421,21,24,0.875,111,38,95,0.4,37,79,0.468,1,16,0.063,9,10,0.9,86,2012-12-30,SAS,DAL
2536,36,@,L 111-115 (OT),265,42,88,0.477,34,61,0.557,8,27,0.296,19,23,0.826,111,47,99,0.475,38,74,0.514,9,25,0.36,12,19,0.632,115,2013-01-15,POR,DEN
2537,37,@,W 111-99 ,240,44,83,0.53,34,65,0.523,10,18,0.556,13,18,0.722,111,39,82,0.476,28,61,0.459,11,21,0.524,10,13,0.769,99,2013-01-15,NOP,PHI
2538,38,@,W 111-105 ,240,45,90,0.5,37,75,0.493,8,15,0.533,13,15,0.867,111,40,79,0.506,31,58,0.534,9,21,0.429,16,20,0.8,105,2013-01-20,DAL,ORL
2539,39,@,L 111-123 (2OT),290,42,93,0.452,35,74,0.473,7,19,0.368,20,20,1.0,111,42,94,0.447,30,58,0.517,12,36,0.333,27,36,0.75,123,2013-01-25,BOS,ATL
2540,40,Home,W 111-106 ,240,39,79,0.494,27,46,0.587,12,33,0.364,21,33,0.636,111,39,92,0.424,30,73,0.411,9,19,0.474,19,21,0.905,106,2013-01-29,LAL,NOH
2541,41,@,W 111-100 ,240,39,92,0.424,27,60,0.45,12,32,0.375,21,25,0.84,111,41,89,0.461,31,67,0.463,10,22,0.455,8,18,0.444,100,2013-02-01,LAL,MIN
2542,42,Home,W 111-101 ,240,39,74,0.527,33,60,0.55,6,14,0.429,27,34,0.794,111,39,88,0.443,35,72,0.486,4,16,0.25,19,22,0.864,101,2013-02-04,IND,CHI
2543,43,@,W 111-100 ,240,45,86,0.523,36,70,0.514,9,16,0.563,12,18,0.667,111,35,74,0.473,22,50,0.44,13,24,0.542,17,23,0.739,100,2013-02-08,NOP,ATL
2544,44,Home,W 111-89 ,240,36,68,0.529,21,41,0.512,15,27,0.556,24,32,0.75,111,34,77,0.442,27,61,0.443,7,16,0.438,14,19,0.737,89,2013-02-08,MIA,LAC
2545,45,@,W 111-103 ,240,40,80,0.5,34,63,0.54,6,17,0.353,25,34,0.735,111,37,84,0.44,28,64,0.438,9,20,0.45,20,26,0.769,103,2013-02-09,DEN,CLE
2546,46,@,W 111-86 ,240,43,73,0.589,31,54,0.574,12,19,0.632,13,20,0.65,111,34,72,0.472,28,53,0.528,6,19,0.316,12,17,0.706,86,2013-02-10,SAS,BRK
2547,47,@,L 111-117 ,240,44,89,0.494,34,56,0.607,10,33,0.303,13,17,0.765,111,40,87,0.46,29,67,0.433,11,20,0.55,26,27,0.963,117,2013-02-10,HOU,SAC
2548,48,@,L 111-113 (OT),265,46,96,0.479,39,76,0.513,7,20,0.35,12,18,0.667,111,43,91,0.473,33,72,0.458,10,19,0.526,17,23,0.739,113,2013-02-19,MIL,BRK
2549,49,Home,W 111-96 ,240,42,88,0.477,31,59,0.525,11,29,0.379,16,18,0.889,111,39,85,0.459,34,69,0.493,5,16,0.313,13,22,0.591,96,2013-02-20,DAL,ORL
2550,50,Home,W 111-107 ,240,40,85,0.471,34,67,0.507,6,18,0.333,25,34,0.735,111,46,94,0.489,38,74,0.514,8,20,0.4,7,12,0.583,107,2013-02-22,LAL,POR
2551,51,@,L 111-127 ,240,41,85,0.482,35,68,0.515,6,17,0.353,23,29,0.793,111,48,83,0.578,39,69,0.565,9,14,0.643,22,22,1.0,127,2013-02-22,MIN,OKC
2552,52,@,W 111-109 ,240,45,87,0.517,42,73,0.575,3,14,0.214,18,31,0.581,111,38,85,0.447,28,60,0.467,10,25,0.4,23,27,0.852,109,2013-02-27,DEN,POR
2553,53,Home,W 111-88 ,240,42,78,0.538,33,61,0.541,9,17,0.529,18,22,0.818,111,35,84,0.417,30,66,0.455,5,18,0.278,13,19,0.684,88,2013-03-09,DEN,MIN
2554,54,Home,W 111-81 ,240,39,76,0.513,29,55,0.527,10,21,0.476,23,30,0.767,111,34,81,0.42,28,60,0.467,6,21,0.286,7,10,0.7,81,2013-03-13,HOU,PHO
2555,55,@,W 111-90 ,240,39,88,0.443,31,66,0.47,8,22,0.364,25,29,0.862,111,35,92,0.38,29,68,0.426,6,24,0.25,14,21,0.667,90,2013-03-18,IND,CLE
2556,56,@,W 111-93 ,240,46,95,0.484,41,75,0.547,5,20,0.25,14,25,0.56,111,36,82,0.439,28,64,0.438,8,18,0.444,13,21,0.619,93,2013-03-27,BRK,POR
2557,57,Home,W 111-102 ,240,38,77,0.494,29,58,0.5,9,19,0.474,26,30,0.867,111,34,73,0.466,24,47,0.511,10,26,0.385,24,31,0.774,102,2013-03-29,NYK,CHA
2558,58,Home,W 111-103 ,240,44,98,0.449,35,69,0.507,9,29,0.31,14,22,0.636,111,39,93,0.419,33,78,0.423,6,15,0.4,19,21,0.905,103,2013-04-01,HOU,ORL
2559,59,@,W 111-107 ,240,44,86,0.512,35,70,0.5,9,16,0.563,14,16,0.875,111,44,72,0.611,39,58,0.672,5,14,0.357,14,17,0.824,107,2013-04-05,GSW,PHO
2560,60,@,W 111-104 ,240,40,80,0.5,36,64,0.563,4,16,0.25,27,42,0.643,111,40,82,0.488,37,67,0.552,3,15,0.2,21,26,0.808,104,2013-04-10,DET,CLE
2561,61,Home,W 111-95 ,240,44,77,0.571,33,56,0.589,11,21,0.524,12,16,0.75,111,35,90,0.389,29,67,0.433,6,23,0.261,19,22,0.864,95,2013-04-10,LAC,MIN
2562,62,@,L 111-118 (OT),265,42,104,0.404,32,74,0.432,10,30,0.333,17,22,0.773,111,39,87,0.448,29,60,0.483,10,27,0.37,30,37,0.811,118,2013-04-11,NYK,CHI
2563,63,Home,L 111-112 ,240,42,100,0.42,30,65,0.462,12,35,0.343,15,23,0.652,111,37,85,0.435,31,71,0.437,6,14,0.429,32,46,0.696,112,2013-04-15,MIL,DEN
2564,64,Home,W 111-108 (OT),265,40,77,0.519,34,59,0.576,6,18,0.333,25,30,0.833,111,42,89,0.472,35,68,0.515,7,21,0.333,17,24,0.708,108,2013-11-01,MEM,DET
2565,65,Home,W 111-99 ,240,32,80,0.4,25,61,0.41,7,19,0.368,40,46,0.87,111,37,87,0.425,34,71,0.479,3,16,0.188,22,26,0.846,99,2013-11-02,DAL,MEM
2566,66,@,W 111-110 ,240,46,89,0.517,36,68,0.529,10,21,0.476,9,12,0.75,111,41,71,0.577,36,61,0.59,5,10,0.5,23,34,0.676,110,2013-11-09,BOS,MIA
2567,67,Home,W 111-99 ,240,40,100,0.4,34,79,0.43,6,21,0.286,25,37,0.676,111,37,94,0.394,29,73,0.397,8,21,0.381,17,26,0.654,99,2013-11-13,DEN,LAL
2568,68,Home,W 111-103 ,240,39,86,0.453,33,58,0.569,6,28,0.214,27,34,0.794,111,35,75,0.467,29,59,0.492,6,16,0.375,27,33,0.818,103,2013-11-13,LAC,OKC
2569,69,Home,W 111-105 ,240,37,72,0.514,28,50,0.56,9,22,0.409,28,39,0.718,111,42,85,0.494,37,73,0.507,5,12,0.417,16,20,0.8,105,2013-11-13,UTA,NOP
2570,70,@,L 111-122 ,240,45,99,0.455,37,75,0.493,8,24,0.333,13,18,0.722,111,41,81,0.506,32,60,0.533,9,21,0.429,31,44,0.705,122,2013-11-16,DEN,HOU
2571,71,Home,W 111-81 ,240,40,97,0.412,29,61,0.475,11,36,0.306,20,23,0.87,111,31,78,0.397,26,62,0.419,5,16,0.313,14,20,0.7,81,2013-11-22,MIN,BRK
2572,72,@,L 111-116 ,240,44,83,0.53,31,55,0.564,13,28,0.464,10,13,0.769,111,46,87,0.529,40,66,0.606,6,21,0.286,18,22,0.818,116,2013-11-26,LAL,WAS
2573,73,@,W 111-87 ,240,43,85,0.506,36,67,0.537,7,18,0.389,18,28,0.643,111,30,75,0.4,28,59,0.475,2,16,0.125,25,34,0.735,87,2013-12-03,DEN,BRK
2574,74,Home,W 111-104 ,240,44,98,0.449,36,75,0.48,8,23,0.348,15,17,0.882,111,39,89,0.438,34,78,0.436,5,11,0.455,21,24,0.875,104,2013-12-04,POR,OKC
2575,75,@,W 111-100 ,240,38,71,0.535,29,52,0.558,9,19,0.474,26,28,0.929,111,41,91,0.451,28,65,0.431,13,26,0.5,5,6,0.833,100,2013-12-07,IND,SAS
2576,76,@,L 111-115 ,240,41,90,0.456,30,53,0.566,11,37,0.297,18,22,0.818,111,43,94,0.457,37,82,0.451,6,12,0.5,23,29,0.793,115,2013-12-09,GSW,CHA
2577,77,Home,W 111-106 (OT),265,38,84,0.452,29,61,0.475,9,23,0.391,26,32,0.813,111,42,96,0.438,37,75,0.493,5,21,0.238,17,27,0.63,106,2013-12-11,NOP,DET
2578,78,Home,W 111-104 ,240,39,89,0.438,31,62,0.5,8,27,0.296,25,30,0.833,111,40,94,0.426,35,74,0.473,5,20,0.25,19,24,0.792,104,2013-12-12,POR,HOU
2579,79,Home,W 111-106 ,240,44,87,0.506,36,68,0.529,8,19,0.421,15,18,0.833,111,40,66,0.606,25,34,0.735,15,32,0.469,11,11,1.0,106,2013-12-14,NYK,ATL
2580,80,@,W 111-109 (OT),265,41,99,0.414,34,73,0.466,7,26,0.269,22,26,0.846,111,44,94,0.468,41,79,0.519,3,15,0.2,18,27,0.667,109,2013-12-15,POR,DET
2581,81,@,L 111-114 (OT),265,40,100,0.4,30,71,0.423,10,29,0.345,21,25,0.84,111,39,100,0.39,28,72,0.389,11,28,0.393,25,27,0.926,114,2013-12-20,MIL,CLE
2582,82,Home,W 111-110 (OT),265,43,99,0.434,33,82,0.402,10,17,0.588,15,20,0.75,111,42,97,0.433,32,69,0.464,10,28,0.357,16,17,0.941,110,2013-12-23,CHA,MIL
2583,83,@,W 111-104 ,240,40,79,0.506,29,57,0.509,11,22,0.5,20,23,0.87,111,38,70,0.543,31,51,0.608,7,19,0.368,21,29,0.724,104,2013-12-23,DAL,HOU
2584,84,@,W 111-98 ,240,45,86,0.523,33,62,0.532,12,24,0.5,9,18,0.5,111,37,91,0.407,32,71,0.451,5,20,0.25,19,23,0.826,98,2013-12-25,HOU,SAS
2585,85,@,W 111-104 ,240,39,95,0.411,33,71,0.465,6,24,0.25,27,33,0.818,111,31,84,0.369,19,47,0.404,12,37,0.324,30,34,0.882,104,2013-12-29,PHI,LAL
2586,86,Home,W 111-108 ,240,43,80,0.538,34,58,0.586,9,22,0.409,16,21,0.762,111,37,76,0.487,32,64,0.5,5,12,0.417,29,38,0.763,108,2014-01-03,DEN,MEM
2587,87,Home,L 111-115 ,240,43,94,0.457,36,74,0.486,7,20,0.35,18,29,0.621,111,40,83,0.482,32,59,0.542,8,24,0.333,27,28,0.964,115,2014-01-04,MIN,OKC
2588,88,Home,W 111-93 ,240,44,89,0.494,31,61,0.508,13,28,0.464,10,18,0.556,111,34,86,0.395,30,67,0.448,4,19,0.211,21,27,0.778,93,2014-01-07,CLE,PHI
2589,89,Home,W 111-105 ,240,36,79,0.456,25,49,0.51,11,30,0.367,28,39,0.718,111,39,83,0.47,34,66,0.515,5,17,0.294,22,30,0.733,105,2014-01-08,LAC,BOS
2590,90,@,W 111-108 ,240,45,82,0.549,40,70,0.571,5,12,0.417,16,19,0.842,111,39,88,0.443,31,68,0.456,8,20,0.4,22,29,0.759,108,2014-01-15,SAC,MIN
2591,91,@,W 111-101 ,240,39,74,0.527,32,59,0.542,7,15,0.467,26,35,0.743,111,38,82,0.463,28,57,0.491,10,25,0.4,15,21,0.714,101,2014-01-17,CHA,ORL
2592,92,Home,L 111-127 ,240,42,90,0.467,35,72,0.486,7,18,0.389,20,25,0.8,111,46,90,0.511,37,64,0.578,9,26,0.346,26,28,0.929,127,2014-01-18,DAL,POR
2593,93,@,W 111-105 ,240,45,83,0.542,35,65,0.538,10,18,0.556,11,16,0.688,111,40,75,0.533,30,53,0.566,10,22,0.455,15,22,0.682,105,2014-01-22,OKC,SAS
2594,94,Home,L 111-113 (OT),265,42,94,0.447,35,72,0.486,7,22,0.318,20,27,0.741,111,41,89,0.461,26,55,0.473,15,34,0.441,16,23,0.696,113,2014-01-22,WAS,BOS
2595,95,Home,L 111-116 (OT),265,39,101,0.386,27,69,0.391,12,32,0.375,21,29,0.724,111,41,95,0.432,33,71,0.465,8,24,0.333,26,33,0.788,116,2014-01-24,SAC,IND
2596,96,Home,W 111-109 ,240,43,82,0.524,30,57,0.526,13,25,0.52,12,18,0.667,111,43,88,0.489,31,63,0.492,12,25,0.48,11,12,0.917,109,2014-01-27,OKC,ATL
2597,97,Home,W 111-92 ,240,45,91,0.495,39,70,0.557,6,21,0.286,15,20,0.75,111,31,76,0.408,23,52,0.442,8,24,0.333,22,34,0.647,92,2014-01-30,GSW,LAC
2598,98,Home,W 111-95 ,240,43,84,0.512,34,67,0.507,9,17,0.529,16,24,0.667,111,32,89,0.36,20,58,0.345,12,31,0.387,19,29,0.655,95,2014-02-07,DET,BRK
2599,99,@,W 111-110 ,240,42,78,0.538,32,56,0.571,10,22,0.455,17,25,0.68,111,40,83,0.482,31,67,0.463,9,16,0.563,21,26,0.808,110,2014-02-12,MIA,GSW
2600,0,@,W 111-109 ,240,43,88,0.489,34,64,0.531,9,24,0.375,16,21,0.762,111,42,93,0.452,35,71,0.493,7,22,0.318,18,25,0.72,109,2014-02-19,SAS,POR
2601,1,Home,W 111-87 ,240,40,79,0.506,31,56,0.554,9,23,0.391,22,26,0.846,111,34,79,0.43,30,66,0.455,4,13,0.308,15,18,0.833,87,2014-03-06,SAS,MIA
2602,2,Home,W 111-97 ,240,43,80,0.538,37,61,0.607,6,19,0.316,19,24,0.792,111,39,86,0.453,31,52,0.596,8,34,0.235,11,13,0.846,97,2014-03-07,GSW,ATL
2603,3,Home,W 111-89 ,240,44,87,0.506,37,74,0.5,7,13,0.538,16,22,0.727,111,37,93,0.398,32,72,0.444,5,21,0.238,10,14,0.714,89,2014-03-08,MEM,CHA
2604,4,@,L 111-118 ,240,40,86,0.465,36,71,0.507,4,15,0.267,27,39,0.692,111,47,97,0.485,37,66,0.561,10,31,0.323,14,21,0.667,118,2014-03-09,DET,BOS
2605,5,@,W 111-104 ,240,37,76,0.487,23,52,0.442,14,24,0.583,23,31,0.742,111,41,95,0.432,34,76,0.447,7,19,0.368,15,20,0.75,104,2014-03-09,TOR,MIN
2606,6,Home,W 111-107 (OT),265,41,90,0.456,36,76,0.474,5,14,0.357,24,33,0.727,111,40,85,0.471,33,62,0.532,7,23,0.304,20,26,0.769,107,2014-03-09,NOP,DEN
2607,7,Home,W 111-98 ,240,43,88,0.489,35,70,0.5,8,18,0.444,17,24,0.708,111,36,82,0.439,28,61,0.459,8,21,0.381,18,25,0.72,98,2014-03-12,LAC,GSW
2608,8,Home,W 111-87 ,240,43,86,0.5,29,62,0.468,14,24,0.583,11,13,0.846,111,28,79,0.354,23,53,0.434,5,26,0.192,26,34,0.765,87,2014-03-13,CHI,HOU
2609,9,@,W 111-107 ,240,39,82,0.476,31,61,0.508,8,21,0.381,25,29,0.862,111,42,81,0.519,35,57,0.614,7,24,0.292,16,21,0.762,107,2014-03-14,DEN,MIA
2610,10,@,W 111-103 ,240,38,78,0.487,24,45,0.533,14,33,0.424,21,27,0.778,111,41,86,0.477,38,75,0.507,3,11,0.273,18,21,0.857,103,2014-03-14,POR,NOP
2611,11,@,L 111-117 (OT),265,40,91,0.44,29,63,0.46,11,28,0.393,20,30,0.667,111,40,87,0.46,34,69,0.493,6,18,0.333,31,40,0.775,117,2014-03-18,WAS,SAC
2612,12,@,W 111-105 ,240,36,70,0.514,32,57,0.561,4,13,0.308,35,43,0.814,111,38,85,0.447,30,57,0.526,8,28,0.286,21,27,0.778,105,2014-03-21,NOP,ATL
2613,13,Home,L 111-118 ,240,46,92,0.5,40,75,0.533,6,17,0.353,13,17,0.765,111,38,79,0.481,26,44,0.591,12,35,0.343,30,34,0.882,118,2014-03-22,CLE,HOU
2614,14,@,L 111-116 (OT),265,40,83,0.482,23,46,0.5,17,37,0.459,14,16,0.875,111,46,92,0.5,38,71,0.535,8,21,0.381,16,23,0.696,116,2014-03-26,BRK,CHA
2615,15,@,L 111-116 ,240,39,88,0.443,34,71,0.479,5,17,0.294,28,36,0.778,111,46,97,0.474,37,74,0.5,9,23,0.391,15,21,0.714,116,2014-03-31,MIL,DET
2616,16,Home,W 111-90 ,240,44,83,0.53,40,64,0.625,4,19,0.211,19,22,0.864,111,36,85,0.424,28,64,0.438,8,21,0.381,10,10,1.0,90,2014-04-02,SAS,GSW
2617,17,@,W 111-102 ,240,39,77,0.506,33,58,0.569,6,19,0.316,27,37,0.73,111,38,87,0.437,29,54,0.537,9,33,0.273,17,21,0.81,102,2014-04-04,PHI,BOS
2618,18,Home,W 111-107 ,240,33,78,0.423,20,47,0.426,13,31,0.419,32,37,0.865,111,38,85,0.447,25,54,0.463,13,31,0.419,18,20,0.9,107,2014-04-04,HOU,OKC
2619,19,@,L 111-115 ,240,42,88,0.477,28,57,0.491,14,31,0.452,13,16,0.813,111,38,79,0.481,29,56,0.518,9,23,0.391,30,36,0.833,115,2014-04-05,BOS,DET
2620,20,@,L 111-115 ,240,38,79,0.481,28,50,0.56,10,29,0.345,25,34,0.735,111,43,77,0.558,32,53,0.604,11,24,0.458,18,30,0.6,115,2014-04-09,BRK,ORL
2621,21,@,W 111-99 ,240,40,87,0.46,29,65,0.446,11,22,0.5,20,24,0.833,111,40,86,0.465,34,73,0.466,6,13,0.462,13,16,0.813,99,2014-04-11,POR,UTA
2622,22,Home,W 111-105 ,240,39,72,0.542,32,53,0.604,7,19,0.368,26,41,0.634,111,41,93,0.441,36,68,0.529,5,25,0.2,18,26,0.692,105,2014-04-12,CHA,PHI
2623,23,@,W 111-99 ,240,42,90,0.467,30,60,0.5,12,30,0.4,15,18,0.833,111,37,90,0.411,32,72,0.444,5,18,0.278,20,30,0.667,99,2014-04-12,BOS,CLE
2624,24,Home,W 111-104 ,240,35,74,0.473,25,47,0.532,10,27,0.37,31,39,0.795,111,39,88,0.443,30,66,0.455,9,22,0.409,17,21,0.81,104,2014-04-12,HOU,NOP
2625,25,@,W 111-103 ,240,41,76,0.539,33,52,0.635,8,24,0.333,21,26,0.808,111,40,77,0.519,33,59,0.559,7,18,0.389,16,21,0.762,103,2014-04-16,ATL,MIL
2626,26,@,L 111-112 ,240,42,83,0.506,34,64,0.531,8,19,0.421,19,31,0.613,111,38,86,0.442,33,63,0.524,5,23,0.217,31,41,0.756,112,2014-04-16,DET,OKC
2627,27,Home,L 111-118 ,240,42,82,0.512,35,62,0.565,7,20,0.35,20,28,0.714,111,34,71,0.479,22,38,0.579,12,33,0.364,38,44,0.864,118,2014-10-31,LAL,LAC
2628,28,@,L 111-118 ,240,41,93,0.441,29,66,0.439,12,27,0.444,17,20,0.85,111,40,81,0.494,27,54,0.5,13,27,0.481,25,30,0.833,118,2014-11-10,NOP,CLE
2629,29,Home,W 111-110 ,240,39,77,0.506,33,68,0.485,6,9,0.667,27,34,0.794,111,37,77,0.481,30,64,0.469,7,13,0.538,29,34,0.853,110,2014-11-13,MEM,SAC
2630,30,Home,W 111-93 ,240,43,84,0.512,35,63,0.556,8,21,0.381,17,23,0.739,111,33,75,0.44,28,59,0.475,5,16,0.313,22,30,0.733,93,2014-11-15,TOR,UTA
2631,31,@,W 111-100 ,240,43,93,0.462,35,75,0.467,8,18,0.444,17,22,0.773,111,36,84,0.429,31,69,0.449,5,15,0.333,23,26,0.885,100,2014-11-22,WAS,MIL
2632,32,@,W 111-100 ,240,37,77,0.481,24,51,0.471,13,26,0.5,24,36,0.667,111,40,80,0.5,32,56,0.571,8,24,0.333,12,21,0.571,100,2014-11-24,IND,DAL
2633,33,@,W 111-96 ,240,44,85,0.518,32,59,0.542,12,26,0.462,11,19,0.579,111,36,87,0.414,30,67,0.448,6,20,0.3,18,24,0.75,96,2014-11-26,GSW,ORL
2634,34,@,W 111-89 ,240,41,85,0.482,30,59,0.508,11,26,0.423,18,20,0.9,111,36,87,0.414,30,69,0.435,6,18,0.333,11,15,0.733,89,2014-11-30,SAS,BOS
2635,35,Home,W 111-108 ,240,39,73,0.534,33,52,0.635,6,21,0.286,27,38,0.711,111,45,92,0.489,38,72,0.528,7,20,0.35,11,13,0.846,108,2014-12-02,CLE,MIL
2636,36,Home,W 111-95 ,240,45,93,0.484,39,74,0.527,6,19,0.316,15,19,0.789,111,33,85,0.388,21,56,0.375,12,29,0.414,17,21,0.81,95,2014-12-03,WAS,LAL
2637,37,@,W 111-92 ,240,45,88,0.511,39,64,0.609,6,24,0.25,15,20,0.75,111,36,78,0.462,35,71,0.493,1,7,0.143,19,29,0.655,92,2014-12-12,OKC,MIN
2638,38,Home,W 111-106 ,240,43,76,0.566,36,65,0.554,7,11,0.636,18,24,0.75,111,39,91,0.429,25,62,0.403,14,29,0.483,14,19,0.737,106,2014-12-13,MIL,LAC
2639,39,@,L 111-119 ,240,45,90,0.5,40,75,0.533,5,15,0.333,16,19,0.842,111,47,79,0.595,39,63,0.619,8,16,0.5,17,18,0.944,119,2014-12-16,UTA,NOP
2640,40,@,W 111-106 ,240,43,82,0.524,34,57,0.596,9,25,0.36,16,21,0.762,111,40,86,0.465,30,62,0.484,10,24,0.417,16,22,0.727,106,2014-12-17,PHO,CHO
2641,41,Home,L 111-115 (OT),265,40,99,0.404,27,69,0.391,13,30,0.433,18,23,0.783,111,35,85,0.412,27,57,0.474,8,28,0.286,37,48,0.771,115,2014-12-17,DEN,HOU
2642,42,Home,L 111-115 (OT),265,46,101,0.455,40,82,0.488,6,19,0.316,13,15,0.867,111,38,91,0.418,21,60,0.35,17,31,0.548,22,24,0.917,115,2014-12-23,OKC,POR
2643,43,Home,L 111-117 (OT),265,43,104,0.413,36,80,0.45,7,24,0.292,18,23,0.783,111,41,91,0.451,27,57,0.474,14,34,0.412,21,28,0.75,117,2014-12-26,MEM,HOU
2644,44,@,W 111-103 ,240,40,76,0.526,26,51,0.51,14,25,0.56,17,26,0.654,111,39,87,0.448,31,61,0.508,8,26,0.308,17,27,0.63,103,2014-12-30,LAL,DEN
2645,45,Home,W 111-83 ,240,44,83,0.53,37,68,0.544,7,15,0.467,16,20,0.8,111,35,88,0.398,29,59,0.492,6,29,0.207,7,11,0.636,83,2015-01-02,NOP,HOU
2646,46,Home,L 111-113 ,240,44,92,0.478,37,75,0.493,7,17,0.412,16,19,0.842,111,46,96,0.479,41,70,0.586,5,26,0.192,16,19,0.842,113,2015-01-07,MIN,PHO
2647,47,Home,L 111-114 ,240,47,87,0.54,40,60,0.667,7,27,0.259,10,14,0.714,111,41,96,0.427,34,75,0.453,7,21,0.333,25,31,0.806,114,2015-01-12,TOR,DET
2648,48,Home,W 111-76 ,240,45,81,0.556,38,68,0.559,7,13,0.538,14,18,0.778,111,28,85,0.329,22,61,0.361,6,24,0.25,14,23,0.609,76,2015-01-19,WAS,PHI
2649,49,Home,L 111-113 ,240,42,91,0.462,32,61,0.525,10,30,0.333,17,24,0.708,111,44,84,0.524,34,57,0.596,10,27,0.37,15,20,0.75,113,2015-01-23,PHO,HOU
2650,50,@,L 111-114 ,240,41,95,0.432,31,67,0.463,10,28,0.357,19,27,0.704,111,42,89,0.472,34,66,0.515,8,23,0.348,22,25,0.88,114,2015-01-25,BOS,GSW
2651,51,Home,L 111-113 (OT),265,48,113,0.425,39,80,0.488,9,33,0.273,6,12,0.5,111,42,98,0.429,34,69,0.493,8,29,0.276,21,23,0.913,113,2015-01-27,GSW,CHI
2652,52,@,L 111-117 ,240,48,95,0.505,44,78,0.564,4,17,0.235,11,15,0.733,111,41,81,0.506,26,49,0.531,15,32,0.469,20,29,0.69,117,2015-02-06,MIL,HOU
2653,53,Home,W 111-101 (OT),265,43,105,0.41,29,69,0.42,14,36,0.389,11,16,0.688,111,37,89,0.416,27,57,0.474,10,32,0.313,17,24,0.708,101,2015-02-07,DAL,POR
2654,54,Home,W 111-103 ,240,39,80,0.488,32,65,0.492,7,15,0.467,26,32,0.813,111,36,84,0.429,28,62,0.452,8,22,0.364,23,30,0.767,103,2015-02-11,MIL,SAC
2655,55,Home,W 111-100 ,240,44,93,0.473,35,69,0.507,9,24,0.375,14,18,0.778,111,36,87,0.414,24,50,0.48,12,37,0.324,16,26,0.615,100,2015-02-20,DAL,HOU
2656,56,Home,W 111-109 ,240,40,86,0.465,36,71,0.507,4,15,0.267,27,38,0.711,111,40,89,0.449,33,72,0.458,7,17,0.412,22,31,0.71,109,2015-02-20,MIN,PHO
2657,57,@,W 111-87 ,240,38,79,0.481,29,59,0.492,9,20,0.45,26,35,0.743,111,35,82,0.427,29,64,0.453,6,18,0.333,11,16,0.688,87,2015-02-20,MIA,NYK
2658,58,@,L 111-118 (OT),265,42,98,0.429,34,65,0.523,8,33,0.242,19,27,0.704,111,43,84,0.512,36,66,0.545,7,18,0.389,25,38,0.658,118,2015-02-22,BOS,LAL
2659,59,Home,W 111-95 ,240,43,85,0.506,30,59,0.508,13,26,0.5,12,15,0.8,111,37,85,0.435,29,64,0.453,8,21,0.381,13,14,0.929,95,2015-02-25,POR,SAS
2660,60,@,L 111-120 ,240,45,86,0.523,39,69,0.565,6,17,0.353,15,23,0.652,111,43,79,0.544,34,55,0.618,9,24,0.375,25,33,0.758,120,2015-03-06,DEN,SAS
2661,61,@,W 111-91 ,240,45,87,0.517,33,66,0.5,12,21,0.571,9,11,0.818,111,35,84,0.417,29,68,0.426,6,16,0.375,15,23,0.652,91,2015-03-10,NOP,BRK
2662,62,Home,L 111-118 (2OT),290,46,99,0.465,40,77,0.519,6,22,0.273,13,21,0.619,111,46,104,0.442,36,73,0.493,10,31,0.323,16,20,0.8,118,2015-03-15,NOP,DEN
2663,63,Home,W 111-104 ,240,43,94,0.457,38,82,0.463,5,12,0.417,20,24,0.833,111,38,80,0.475,31,56,0.554,7,24,0.292,21,24,0.875,104,2015-03-20,ORL,POR
2664,64,Home,L 111-123 ,240,45,90,0.5,37,67,0.552,8,23,0.348,13,18,0.722,111,46,75,0.613,40,63,0.635,6,12,0.5,25,31,0.806,123,2015-03-21,IND,BRK
2665,65,@,W 111-89 ,240,43,84,0.512,29,50,0.58,14,34,0.412,11,13,0.846,111,37,85,0.435,33,68,0.485,4,17,0.235,11,16,0.688,89,2015-03-25,CLE,MEM
2666,66,@,W 111-80 ,240,44,78,0.564,33,50,0.66,11,28,0.393,12,18,0.667,111,29,82,0.354,24,59,0.407,5,23,0.217,17,19,0.895,80,2015-03-25,LAC,NYK
2667,67,Home,W 111-107 ,240,39,73,0.534,30,54,0.556,9,19,0.474,24,34,0.706,111,30,71,0.423,16,41,0.39,14,30,0.467,33,43,0.767,107,2015-03-26,MIL,IND
2668,68,@,W 111-97 ,240,42,90,0.467,35,72,0.486,7,18,0.389,20,27,0.741,111,43,82,0.524,40,67,0.597,3,15,0.2,8,8,1.0,97,2015-03-27,DET,ORL
2669,69,Home,W 111-80 ,240,43,84,0.512,37,67,0.552,6,17,0.353,19,22,0.864,111,30,79,0.38,26,62,0.419,4,17,0.235,16,19,0.842,80,2015-03-28,CHI,NYK
2670,70,Home,L 111-113 (OT),265,39,96,0.406,29,66,0.439,10,30,0.333,23,38,0.605,111,40,82,0.488,30,61,0.492,10,21,0.476,23,30,0.767,113,2015-03-30,PHI,LAL
2671,71,Home,W 111-106 ,240,40,80,0.5,31,62,0.5,9,18,0.5,22,28,0.786,111,37,82,0.451,25,59,0.424,12,23,0.522,20,24,0.833,106,2015-03-31,BRK,IND
2672,72,@,L 111-115 ,240,48,96,0.5,41,82,0.5,7,14,0.5,8,16,0.5,111,41,89,0.461,23,49,0.469,18,40,0.45,15,25,0.6,115,2015-04-01,SAC,HOU
2673,73,@,L 111-116 ,240,45,93,0.484,39,74,0.527,6,19,0.316,15,21,0.714,111,42,80,0.525,33,56,0.589,9,24,0.375,23,34,0.676,116,2015-04-07,MIN,SAC
2674,74,Home,L 111-114 ,240,41,87,0.471,34,61,0.557,7,26,0.269,22,25,0.88,111,43,86,0.5,32,58,0.552,11,28,0.393,17,25,0.68,114,2015-04-08,BRK,ATL
2675,75,@,W 111-105 ,240,36,79,0.456,30,62,0.484,6,17,0.353,33,42,0.786,111,41,87,0.471,35,57,0.614,6,30,0.2,17,22,0.773,105,2015-04-11,UTA,POR
2676,76,@,L 111-122 ,240,38,74,0.514,33,56,0.589,5,18,0.278,30,42,0.714,111,45,82,0.549,36,56,0.643,9,26,0.346,23,30,0.767,122,2015-04-12,SAC,DEN
2677,77,Home,W 111-107 ,240,39,74,0.527,26,50,0.52,13,24,0.542,20,27,0.741,111,41,98,0.418,36,83,0.434,5,15,0.333,20,25,0.8,107,2015-04-13,GSW,MEM
2678,78,Home,W 111-95 ,240,41,96,0.427,32,66,0.485,9,30,0.3,20,22,0.909,111,35,83,0.422,29,65,0.446,6,18,0.333,19,27,0.704,95,2015-10-27,GSW,NOP
2679,79,Home,L 111-112 ,240,35,90,0.389,26,56,0.464,9,34,0.265,32,35,0.914,111,38,83,0.458,33,63,0.524,5,20,0.25,31,37,0.838,112,2015-10-28,LAL,MIN
2680,80,@,W 111-95 ,240,40,85,0.471,30,64,0.469,10,21,0.476,21,31,0.677,111,34,87,0.391,28,63,0.444,6,24,0.25,21,33,0.636,95,2015-10-28,DAL,PHO
2681,81,@,W 111-104 ,240,42,80,0.525,36,61,0.59,6,19,0.316,21,31,0.677,111,41,94,0.436,30,70,0.429,11,24,0.458,11,18,0.611,104,2015-10-28,LAC,SAC
2682,82,@,W 111-88 ,240,41,96,0.427,31,71,0.437,10,25,0.4,19,23,0.826,111,35,100,0.35,30,75,0.4,5,25,0.2,13,23,0.565,88,2015-11-09,CHI,PHI
2683,83,@,W 111-109 ,240,42,95,0.442,31,72,0.431,11,23,0.478,16,18,0.889,111,37,84,0.44,33,67,0.493,4,17,0.235,31,39,0.795,109,2015-11-10,NYK,TOR
2684,84,Home,W 111-109 ,240,40,94,0.426,29,67,0.433,11,27,0.407,20,26,0.769,111,42,89,0.472,34,68,0.5,8,21,0.381,17,21,0.81,109,2015-11-13,SAC,BRK
2685,85,@,W 111-95 ,240,44,93,0.473,33,57,0.579,11,36,0.306,12,17,0.706,111,36,85,0.424,25,53,0.472,11,32,0.344,12,23,0.522,95,2015-11-16,BOS,HOU
2686,86,@,L 111-116 ,240,44,91,0.484,39,76,0.513,5,15,0.333,18,22,0.818,111,39,80,0.488,28,55,0.509,11,25,0.44,27,36,0.75,116,2015-11-18,BRK,CHO
2687,87,Home,W 111-101 ,240,40,79,0.506,35,64,0.547,5,15,0.333,26,33,0.788,111,35,82,0.427,21,45,0.467,14,37,0.378,17,21,0.81,101,2015-11-22,BRK,BOS
2688,88,@,W 111-89 ,240,42,77,0.545,31,50,0.62,11,27,0.407,16,18,0.889,111,28,73,0.384,23,54,0.426,5,19,0.263,28,40,0.7,89,2015-11-23,OKC,UTA
2689,89,@,W 111-94 ,240,37,79,0.468,29,59,0.492,8,20,0.4,29,47,0.617,111,31,78,0.397,23,53,0.434,8,25,0.32,24,29,0.828,94,2015-11-24,LAC,DEN
2690,90,Home,W 111-77 ,240,45,92,0.489,33,57,0.579,12,35,0.343,9,15,0.6,111,31,83,0.373,28,62,0.452,3,21,0.143,12,16,0.75,77,2015-11-24,GSW,LAL
2691,91,Home,W 111-78 ,240,42,97,0.433,30,64,0.469,12,33,0.364,15,19,0.789,111,27,84,0.321,22,66,0.333,5,18,0.278,19,22,0.864,78,2015-11-27,BOS,WAS
2692,92,Home,W 111-90 ,240,40,83,0.482,33,64,0.516,7,19,0.368,24,30,0.8,111,34,94,0.362,29,74,0.392,5,20,0.25,17,23,0.739,90,2015-11-27,LAC,NOP
2693,93,Home,L 111-116 (OT),265,45,78,0.577,39,60,0.65,6,18,0.333,15,17,0.882,111,43,95,0.453,36,70,0.514,7,25,0.28,23,36,0.639,116,2015-11-29,NYK,HOU
2694,94,@,L 111-123 ,240,38,88,0.432,25,58,0.431,13,30,0.433,22,24,0.917,111,44,85,0.518,26,49,0.531,18,36,0.5,17,20,0.85,123,2015-12-03,IND,POR
2695,95,Home,W 111-91 ,240,41,93,0.441,32,69,0.464,9,24,0.375,20,26,0.769,111,32,80,0.4,27,62,0.435,5,18,0.278,22,29,0.759,91,2015-12-06,DET,LAL
2696,96,@,W 111-93 ,240,40,81,0.494,28,53,0.528,12,28,0.429,19,24,0.792,111,37,90,0.411,33,77,0.429,4,13,0.308,15,18,0.833,93,2015-12-07,BOS,NOP
2697,97,Home,W 111-108 (OT),265,38,86,0.442,27,58,0.466,11,28,0.393,24,33,0.727,111,38,87,0.437,31,68,0.456,7,19,0.368,25,29,0.862,108,2015-12-11,DEN,MIN
2698,98,@,W 111-76 ,240,41,72,0.569,30,51,0.588,11,21,0.524,18,27,0.667,111,28,72,0.389,22,50,0.44,6,22,0.273,14,20,0.7,76,2015-12-11,CLE,ORL
2699,99,Home,L 111-114 ,240,38,89,0.427,24,56,0.429,14,33,0.424,21,24,0.875,111,44,85,0.518,30,56,0.536,14,29,0.483,12,15,0.8,114,2015-12-12,DAL,WAS
2700,0,@,W 111-107 ,240,40,84,0.476,33,58,0.569,7,26,0.269,24,32,0.75,111,41,90,0.456,32,65,0.492,9,25,0.36,16,19,0.842,107,2015-12-22,LAL,DEN
2701,1,@,W 111-96 ,240,42,84,0.5,30,57,0.526,12,27,0.444,15,22,0.682,111,43,89,0.483,38,72,0.528,5,17,0.294,5,16,0.313,96,2015-12-26,WAS,BRK
2702,2,@,L 111-118 ,240,42,78,0.538,34,57,0.596,8,21,0.381,19,26,0.731,111,40,87,0.46,24,54,0.444,16,33,0.485,22,28,0.786,118,2015-12-26,CHI,DAL
2703,3,@,W 111-90 ,240,42,81,0.519,29,52,0.558,13,29,0.448,14,19,0.737,111,34,81,0.42,28,67,0.418,6,14,0.429,16,18,0.889,90,2015-12-26,TOR,MIL
2704,4,@,W 111-104 ,240,38,79,0.481,26,52,0.5,12,27,0.444,23,27,0.852,111,34,88,0.386,24,61,0.393,10,27,0.37,26,34,0.765,104,2015-12-26,PHI,PHO
2705,5,@,W 111-105 ,240,36,82,0.439,24,59,0.407,12,23,0.522,27,36,0.75,111,36,78,0.462,26,54,0.481,10,24,0.417,23,30,0.767,105,2015-12-28,BRK,MIA
2706,6,Home,W 111-108 (OT),265,43,86,0.5,33,58,0.569,10,28,0.357,15,23,0.652,111,44,105,0.419,39,75,0.52,5,30,0.167,15,23,0.652,108,2016-01-02,GSW,DEN
2707,7,Home,W 111-97 ,240,44,88,0.5,33,62,0.532,11,26,0.423,12,14,0.857,111,37,84,0.44,29,58,0.5,8,26,0.308,15,20,0.75,97,2016-01-03,NYK,ATL
2708,8,Home,W 111-101 ,240,45,87,0.517,30,53,0.566,15,34,0.441,6,6,1.0,111,38,86,0.442,31,65,0.477,7,21,0.333,18,19,0.947,101,2016-01-04,GSW,CHO
2709,9,Home,W 111-102 ,240,41,84,0.488,22,51,0.431,19,33,0.576,10,13,0.769,111,38,87,0.437,27,59,0.458,11,28,0.393,15,22,0.682,102,2016-01-06,PHO,CHO
2710,10,@,L 111-114 (OT),265,40,100,0.4,32,70,0.457,8,30,0.267,23,29,0.793,111,42,89,0.472,30,53,0.566,12,36,0.333,18,34,0.529,114,2016-01-10,NOP,LAC
2711,11,Home,W 111-103 ,240,41,86,0.477,34,63,0.54,7,23,0.304,22,30,0.733,111,41,91,0.451,34,72,0.472,7,19,0.368,14,16,0.875,103,2016-01-11,GSW,MIA
2712,12,Home,L 111-115 (OT),265,42,93,0.452,30,66,0.455,12,27,0.444,15,20,0.75,111,41,88,0.466,34,71,0.479,7,17,0.412,26,31,0.839,115,2016-01-14,PHI,CHI
2713,13,@,W 111-101 ,240,44,84,0.524,35,63,0.556,9,21,0.429,14,20,0.7,111,42,95,0.442,37,69,0.536,5,26,0.192,12,20,0.6,101,2016-01-18,CHI,DET
2714,14,@,L 111-118 (OT),265,37,86,0.43,25,59,0.424,12,27,0.444,25,31,0.806,111,47,90,0.522,40,73,0.548,7,17,0.412,17,18,0.944,118,2016-01-20,UTA,NYK
2715,15,Home,L 111-112 ,240,42,91,0.462,29,62,0.468,13,29,0.448,14,25,0.56,111,38,80,0.475,19,40,0.475,19,40,0.475,17,21,0.81,112,2016-01-25,NOP,HOU
2716,16,Home,W 111-103 ,240,41,96,0.427,32,68,0.471,9,28,0.321,20,24,0.833,111,36,84,0.429,29,63,0.46,7,21,0.333,24,32,0.75,103,2016-01-27,BOS,DEN
2717,17,Home,W 111-92 ,240,38,78,0.487,29,63,0.46,9,15,0.6,26,30,0.867,111,33,83,0.398,26,55,0.473,7,28,0.25,19,21,0.905,92,2016-01-28,IND,ATL
2718,18,Home,W 111-107 ,240,36,78,0.462,32,64,0.5,4,14,0.286,35,47,0.745,111,39,87,0.448,30,58,0.517,9,29,0.31,20,34,0.588,107,2016-01-30,TOR,DET
2719,19,@,W 111-106 (OT),265,44,88,0.5,37,66,0.561,7,22,0.318,16,23,0.696,111,43,101,0.426,35,74,0.473,8,27,0.296,12,14,0.857,106,2016-02-01,CLE,IND
2720,20,Home,W 111-104 ,240,39,86,0.453,30,60,0.5,9,26,0.346,24,30,0.8,111,42,84,0.5,34,64,0.531,8,20,0.4,12,17,0.706,104,2016-02-01,SAC,MIL
2721,21,Home,W 111-105 ,240,40,79,0.506,31,62,0.5,9,17,0.529,22,33,0.667,111,36,84,0.429,30,62,0.484,6,22,0.273,27,34,0.794,105,2016-02-04,DET,NYK
2722,22,@,W 111-105 ,240,37,86,0.43,22,44,0.5,15,42,0.357,22,32,0.688,111,32,83,0.386,21,54,0.389,11,29,0.379,30,32,0.938,105,2016-02-04,HOU,PHO
2723,23,@,L 111-112 ,240,39,84,0.464,29,55,0.527,10,29,0.345,23,24,0.958,111,45,88,0.511,38,69,0.551,7,19,0.368,15,23,0.652,112,2016-02-09,BOS,MIL
2724,24,@,W 111-108 ,240,39,78,0.5,23,52,0.442,16,26,0.615,17,25,0.68,111,44,83,0.53,36,57,0.632,8,26,0.308,12,14,0.857,108,2016-02-09,WAS,NYK
2725,25,@,L 111-120 ,240,38,86,0.442,25,58,0.431,13,28,0.464,22,27,0.815,111,48,94,0.511,35,63,0.556,13,31,0.419,11,18,0.611,120,2016-02-10,LAL,CLE
2726,26,Home,L 111-115 ,240,41,87,0.471,25,51,0.49,16,36,0.444,13,13,1.0,111,44,88,0.5,36,68,0.529,8,20,0.4,19,28,0.679,115,2016-02-19,ATL,MIA
2727,27,Home,W 111-93 ,240,37,68,0.544,27,45,0.6,10,23,0.435,27,44,0.614,111,30,81,0.37,23,56,0.411,7,25,0.28,26,36,0.722,93,2016-02-19,UTA,BOS
2728,28,@,W 111-106 ,240,41,86,0.477,37,66,0.561,4,20,0.2,25,29,0.862,111,37,89,0.416,25,56,0.446,12,33,0.364,20,32,0.625,106,2016-02-21,NOP,DET
2729,29,Home,L 111-118 ,240,43,93,0.462,34,69,0.493,9,24,0.375,16,22,0.727,111,43,82,0.524,33,66,0.5,10,16,0.625,22,34,0.647,118,2016-02-21,PHO,SAS
2730,30,@,L 111-115 ,240,43,86,0.5,35,70,0.5,8,16,0.5,17,23,0.739,111,39,90,0.433,27,58,0.466,12,32,0.375,25,38,0.658,115,2016-02-21,UTA,POR
2731,31,Home,W 111-91 ,240,39,83,0.47,28,55,0.509,11,28,0.393,22,34,0.647,111,33,83,0.398,26,60,0.433,7,23,0.304,18,26,0.692,91,2016-02-24,DET,PHI
2732,32,Home,W 111-106 ,240,37,80,0.463,25,48,0.521,12,32,0.375,25,35,0.714,111,32,80,0.4,26,60,0.433,6,20,0.3,36,42,0.857,106,2016-02-27,PHO,MEM
2733,33,@,W 111-102 ,240,41,81,0.506,27,57,0.474,14,24,0.583,15,21,0.714,111,40,93,0.43,37,79,0.468,3,14,0.214,19,25,0.76,102,2016-02-28,POR,IND
2734,34,@,L 111-129 ,240,41,90,0.456,30,67,0.448,11,23,0.478,18,26,0.692,111,52,77,0.675,46,65,0.708,6,12,0.5,19,25,0.76,129,2016-03-01,CHI,MIA
2735,35,Home,L 111-120 ,240,40,84,0.476,32,62,0.516,8,22,0.364,23,32,0.719,111,39,90,0.433,26,46,0.565,13,44,0.295,29,35,0.829,120,2016-03-09,SAC,CLE
2736,36,Home,L 111-125 ,240,39,84,0.464,29,59,0.492,10,25,0.4,23,27,0.852,111,49,91,0.538,40,73,0.548,9,18,0.5,18,22,0.818,125,2016-03-12,PHI,DET
2737,37,@,L 111-116 ,240,43,85,0.506,37,69,0.536,6,16,0.375,19,24,0.792,111,48,85,0.565,37,56,0.661,11,29,0.379,9,14,0.643,116,2016-03-18,MIN,HOU
2738,38,@,W 111-97 ,240,45,89,0.506,38,67,0.567,7,22,0.318,14,18,0.778,111,35,89,0.393,25,60,0.417,10,29,0.345,17,27,0.63,97,2016-03-18,OKC,PHI
2739,39,Home,L 111-115 ,240,40,83,0.482,31,61,0.508,9,22,0.409,22,30,0.733,111,42,80,0.525,32,52,0.615,10,28,0.357,21,26,0.808,115,2016-03-19,IND,OKC
2740,40,Home,W 111-107 ,240,41,91,0.451,33,56,0.589,8,35,0.229,21,29,0.724,111,40,92,0.435,27,55,0.491,13,37,0.351,14,17,0.824,107,2016-03-22,OKC,HOU
2741,41,Home,W 111-92 ,240,44,85,0.518,37,65,0.569,7,20,0.35,16,18,0.889,111,37,86,0.43,33,71,0.465,4,15,0.267,14,17,0.824,92,2016-03-26,OKC,SAS
2742,42,Home,W 111-89 ,240,48,89,0.539,41,70,0.586,7,19,0.368,8,12,0.667,111,36,88,0.409,30,64,0.469,6,24,0.25,11,17,0.647,89,2016-03-26,ORL,CHI
2743,43,@,L 111-133 ,240,42,88,0.477,34,64,0.531,8,24,0.333,19,24,0.792,111,51,82,0.622,42,62,0.677,9,20,0.45,22,30,0.733,133,2016-03-27,DAL,SAC
2744,44,@,L 111-120 ,240,43,89,0.483,34,63,0.54,9,26,0.346,16,20,0.8,111,47,84,0.56,39,66,0.591,8,18,0.444,18,25,0.72,120,2016-03-30,WAS,SAC
2745,45,@,L 111-136 ,240,38,85,0.447,29,61,0.475,9,24,0.375,26,33,0.788,111,50,88,0.568,32,58,0.552,18,30,0.6,18,22,0.818,136,2016-04-03,POR,GSW
2746,46,@,W 111-97 ,240,42,90,0.467,30,64,0.469,12,26,0.462,15,17,0.882,111,37,78,0.474,27,52,0.519,10,26,0.385,13,15,0.867,97,2016-04-06,CHA,NYK
2747,47,Home,W 111-98 ,240,37,68,0.544,27,46,0.587,10,22,0.455,27,38,0.711,111,37,83,0.446,29,56,0.518,8,27,0.296,16,20,0.8,98,2016-04-08,TOR,IND
2748,48,Home,L 111-120 ,240,44,98,0.449,34,67,0.507,10,31,0.323,13,21,0.619,111,46,89,0.517,37,64,0.578,9,25,0.36,19,24,0.792,120,2016-04-11,BRK,WAS
2749,49,Home,W 111-104 ,240,40,76,0.526,34,55,0.618,6,21,0.286,25,39,0.641,111,37,86,0.43,28,61,0.459,9,25,0.36,21,26,0.808,104,2016-10-29,NYK,MEM
2750,50,Home,L 111-112 (OT),265,43,94,0.457,33,64,0.516,10,30,0.333,15,28,0.536,111,40,93,0.43,32,69,0.464,8,24,0.333,24,28,0.857,112,2016-11-04,NOP,PHO
2751,51,Home,W 111-94 ,240,46,86,0.535,34,60,0.567,12,26,0.462,7,12,0.583,111,34,79,0.43,28,61,0.459,6,18,0.333,20,25,0.8,94,2016-11-05,IND,CHI
2752,52,Home,W 111-80 ,240,38,87,0.437,27,55,0.491,11,32,0.344,24,33,0.727,111,31,88,0.352,25,58,0.431,6,30,0.2,12,14,0.857,80,2016-11-09,LAC,POR
2753,53,Home,L 111-113 ,240,38,93,0.409,21,52,0.404,17,41,0.415,18,24,0.75,111,43,90,0.478,37,68,0.544,6,22,0.273,21,22,0.955,113,2016-11-11,CHA,TOR
2754,54,@,W 111-107 ,240,40,82,0.488,25,56,0.446,15,26,0.577,16,19,0.842,111,37,81,0.457,28,56,0.5,9,25,0.36,24,34,0.706,107,2016-11-16,MEM,LAC
2755,55,Home,L 111-113 (OT),265,39,83,0.47,35,58,0.603,4,25,0.16,29,39,0.744,111,43,94,0.457,35,71,0.493,8,23,0.348,19,31,0.613,113,2016-11-18,DEN,TOR
2756,56,Home,W 111-102 ,240,42,94,0.447,30,62,0.484,12,32,0.375,15,20,0.75,111,39,76,0.513,27,49,0.551,12,27,0.444,12,17,0.706,102,2016-11-19,HOU,UTA
2757,57,Home,L 111-114 ,240,42,88,0.477,31,61,0.508,11,27,0.407,16,22,0.727,111,43,85,0.506,30,58,0.517,13,27,0.481,15,26,0.577,114,2016-11-19,WAS,MIA
2758,58,Home,L 111-115 (OT),265,44,101,0.436,34,65,0.523,10,36,0.278,13,18,0.722,111,40,89,0.449,29,67,0.433,11,22,0.5,24,31,0.774,115,2016-11-20,OKC,IND
2759,59,Home,W 111-109 ,240,42,83,0.506,28,56,0.5,14,27,0.519,13,16,0.813,111,45,92,0.489,34,65,0.523,11,27,0.407,8,11,0.727,109,2016-11-22,LAL,OKC
2760,60,@,W 111-92 ,240,45,98,0.459,30,60,0.5,15,38,0.395,6,8,0.75,111,34,86,0.395,24,55,0.436,10,31,0.323,14,22,0.636,92,2016-11-23,BOS,BRK
2761,61,@,L 111-113 (OT),265,43,93,0.462,35,64,0.547,8,29,0.276,17,27,0.63,111,45,97,0.464,34,69,0.493,11,28,0.393,12,13,0.923,113,2016-11-25,CHA,NYK
2762,62,@,W 111-93 ,240,36,80,0.45,21,46,0.457,15,34,0.441,24,29,0.828,111,34,89,0.382,22,49,0.449,12,40,0.3,13,16,0.813,93,2016-12-01,MIL,BRK
2763,63,@,W 111-110 ,240,44,86,0.512,36,67,0.537,8,19,0.421,15,19,0.789,111,40,73,0.548,23,43,0.535,17,30,0.567,13,17,0.765,110,2016-12-01,MIA,UTA
2764,64,Home,W 111-105 ,240,47,96,0.49,44,78,0.564,3,18,0.167,14,17,0.824,111,45,83,0.542,35,57,0.614,10,26,0.385,5,10,0.5,105,2016-12-02,CHI,CLE
2765,65,@,W 111-102 ,240,39,79,0.494,34,65,0.523,5,14,0.357,28,35,0.8,111,36,81,0.444,26,51,0.51,10,30,0.333,20,28,0.714,102,2016-12-04,IND,LAC
2766,66,@,L 111-116 ,240,42,105,0.4,31,68,0.456,11,37,0.297,16,21,0.762,111,41,85,0.482,32,59,0.542,9,26,0.346,25,31,0.806,116,2016-12-07,DEN,BRK
2767,67,Home,W 111-103 ,240,39,80,0.488,24,48,0.5,15,32,0.469,18,24,0.75,111,32,69,0.464,18,44,0.409,14,25,0.56,25,26,0.962,103,2016-12-09,DAL,IND
2768,68,@,L 111-118 ,240,40,82,0.488,24,45,0.533,16,37,0.432,15,16,0.938,111,40,83,0.482,25,54,0.463,15,29,0.517,23,28,0.821,118,2016-12-10,POR,IND
2769,69,@,L 111-113 (OT),265,38,97,0.392,31,77,0.403,7,20,0.35,28,38,0.737,111,38,93,0.409,29,63,0.46,9,30,0.3,28,33,0.848,113,2016-12-13,NYK,PHO
2770,70,@,L 111-118 ,240,39,83,0.47,28,56,0.5,11,27,0.407,22,26,0.846,111,39,97,0.402,32,68,0.471,7,29,0.241,33,42,0.786,118,2016-12-16,BRK,ORL
2771,71,@,W 111-109 (OT),265,39,96,0.406,22,45,0.489,17,51,0.333,16,20,0.8,111,41,92,0.446,34,71,0.479,7,21,0.333,20,27,0.741,109,2016-12-17,HOU,MIN
2772,72,@,L 111-118 ,240,39,91,0.429,33,68,0.485,6,23,0.261,27,33,0.818,111,44,88,0.5,31,65,0.477,13,23,0.565,17,21,0.81,118,2016-12-20,IND,NYK
2773,73,Home,L 111-125 ,240,44,93,0.473,35,68,0.515,9,25,0.36,14,20,0.7,111,46,86,0.535,28,48,0.583,18,38,0.474,15,26,0.577,125,2016-12-21,PHO,HOU
2774,74,Home,W 111-102 ,240,40,84,0.476,32,59,0.542,8,25,0.32,23,30,0.767,111,37,85,0.435,27,56,0.482,10,29,0.345,18,22,0.818,102,2016-12-25,LAL,LAC
2775,75,Home,W 111-104 ,240,37,70,0.529,25,45,0.556,12,25,0.48,25,30,0.833,111,37,75,0.493,24,43,0.558,13,32,0.406,17,22,0.773,104,2016-12-26,NOP,DAL
2776,76,@,L 111-121 ,240,40,103,0.388,27,68,0.397,13,35,0.371,18,22,0.818,111,46,81,0.568,32,58,0.552,14,23,0.609,15,18,0.833,121,2016-12-28,TOR,GSW
2777,77,Home,W 111-105 ,240,38,78,0.487,30,56,0.536,8,22,0.364,27,37,0.73,111,35,79,0.443,24,51,0.471,11,28,0.393,24,29,0.828,105,2016-12-28,WAS,IND
2778,78,Home,W 111-101 ,240,39,81,0.481,32,62,0.516,7,19,0.368,26,30,0.867,111,35,84,0.417,29,61,0.475,6,23,0.261,25,31,0.806,101,2016-12-30,IND,CHI
2779,79,@,L 111-118 ,240,41,83,0.494,32,64,0.5,9,19,0.474,20,22,0.909,111,42,90,0.467,35,67,0.522,7,23,0.304,27,29,0.931,118,2017-01-02,CHA,CHI
2780,80,@,W 111-92 ,240,44,81,0.543,34,62,0.548,10,19,0.526,13,18,0.722,111,37,86,0.43,28,58,0.483,9,28,0.321,9,10,0.9,92,2017-01-04,ATL,ORL
2781,81,Home,L 111-116 ,240,39,78,0.5,27,56,0.482,12,22,0.545,21,28,0.75,111,41,83,0.494,28,60,0.467,13,23,0.565,21,27,0.778,116,2017-01-06,MIL,NYK
2782,82,Home,W 111-95 ,240,42,87,0.483,34,55,0.618,8,32,0.25,19,24,0.792,111,34,90,0.378,27,64,0.422,7,26,0.269,20,29,0.69,95,2017-01-08,LAL,ORL
2783,83,Home,W 111-98 ,240,42,80,0.525,29,54,0.537,13,26,0.5,14,18,0.778,111,39,79,0.494,33,60,0.55,6,19,0.316,14,18,0.778,98,2017-01-15,ATL,MIL
2784,84,Home,W 111-92 ,240,43,95,0.453,29,51,0.569,14,44,0.318,11,15,0.733,111,37,93,0.398,30,65,0.462,7,28,0.25,11,14,0.786,92,2017-01-18,HOU,MIL
2785,85,Home,W 111-108 ,240,45,85,0.529,39,70,0.557,6,15,0.4,15,21,0.714,111,42,82,0.512,35,58,0.603,7,24,0.292,17,21,0.81,108,2017-01-22,MIN,DEN
2786,86,Home,L 111-112 ,240,38,86,0.442,31,67,0.463,7,19,0.368,28,32,0.875,111,44,84,0.524,38,67,0.567,6,17,0.353,18,24,0.75,112,2017-01-24,PHO,MIN
2787,87,@,L 111-115 (OT),265,35,71,0.493,22,45,0.489,13,26,0.5,28,36,0.778,111,38,78,0.487,28,50,0.56,10,28,0.357,29,33,0.879,115,2017-01-27,SAC,IND
2788,88,Home,L 111-113 ,240,46,93,0.495,36,66,0.545,10,27,0.37,9,12,0.75,111,36,79,0.456,28,53,0.528,8,26,0.308,33,39,0.846,113,2017-01-29,POR,GSW
2789,89,Home,W 111-105 (OT),265,40,92,0.435,28,63,0.444,12,29,0.414,19,26,0.731,111,41,96,0.427,31,61,0.508,10,35,0.286,13,19,0.684,105,2017-01-30,MIN,ORL
2790,90,@,L 111-126 ,240,39,88,0.443,30,57,0.526,9,31,0.29,24,26,0.923,111,47,96,0.49,26,48,0.542,21,48,0.438,11,14,0.786,126,2017-02-01,CHA,GSW
2791,91,@,W 111-104 ,240,41,84,0.488,25,44,0.568,16,40,0.4,13,18,0.722,111,39,86,0.453,27,55,0.491,12,31,0.387,14,28,0.5,104,2017-02-04,CLE,NYK
2792,92,Home,W 111-106 ,240,42,92,0.457,33,66,0.5,9,26,0.346,18,22,0.818,111,40,93,0.43,35,66,0.53,5,27,0.185,21,25,0.84,106,2017-02-06,NOP,PHO
2793,93,Home,W 111-107 ,240,40,102,0.392,33,76,0.434,7,26,0.269,24,29,0.828,111,39,86,0.453,27,50,0.54,12,36,0.333,17,21,0.81,107,2017-02-07,CHA,BRK
2794,94,@,W 111-103 ,240,39,74,0.527,28,52,0.538,11,22,0.5,22,25,0.88,111,34,84,0.405,21,50,0.42,13,34,0.382,22,29,0.759,103,2017-02-08,SAS,PHI
2795,95,Home,L 111-112 ,240,41,84,0.488,31,63,0.492,10,21,0.476,19,24,0.792,111,40,95,0.421,29,67,0.433,11,28,0.393,21,27,0.778,112,2017-02-09,ORL,PHI
2796,96,Home,L 111-120 ,240,39,77,0.506,30,51,0.588,9,26,0.346,24,31,0.774,111,44,91,0.484,34,61,0.557,10,30,0.333,22,27,0.815,120,2017-02-09,POR,BOS
2797,97,@,W 111-98 ,240,40,81,0.494,24,47,0.511,16,34,0.471,15,18,0.833,111,35,77,0.455,26,50,0.52,9,27,0.333,19,25,0.76,98,2017-02-13,BOS,DAL
2798,98,Home,W 111-88 ,240,42,81,0.519,31,59,0.525,11,22,0.5,16,23,0.696,111,32,79,0.405,23,57,0.404,9,22,0.409,15,20,0.75,88,2017-02-15,UTA,POR
2799,99,@,W 111-98 ,240,43,83,0.518,28,54,0.519,15,29,0.517,10,15,0.667,111,40,81,0.494,36,63,0.571,4,18,0.222,14,18,0.778,98,2017-02-16,WAS,IND
2800,0,@,L 111-118 ,240,37,87,0.425,28,52,0.538,9,35,0.257,28,35,0.8,111,44,89,0.494,39,68,0.574,5,21,0.238,25,31,0.806,118,2017-03-03,OKC,PHO
2801,1,Home,L 111-119 ,240,38,82,0.463,25,54,0.463,13,28,0.464,22,31,0.71,111,41,87,0.471,21,43,0.488,20,44,0.455,17,22,0.773,119,2017-03-06,ATL,GSW
2802,2,@,L 111-122 ,240,42,90,0.467,31,60,0.517,11,30,0.367,16,22,0.727,111,45,83,0.542,28,52,0.538,17,31,0.548,15,19,0.789,122,2017-03-07,LAL,DAL
2803,3,Home,W 110-83 ,240,46,76,0.605,43,67,0.642,3,9,0.333,15,22,0.682,110,30,93,0.323,28,72,0.389,2,21,0.095,21,24,0.875,83,2012-01-04,DEN,SAC
2804,4,Home,L 110-118 ,240,42,85,0.494,31,56,0.554,11,29,0.379,15,20,0.75,110,47,85,0.553,40,74,0.541,7,11,0.636,17,21,0.81,118,2012-01-04,NYK,CHA
2805,5,@,W 110-103 ,240,40,80,0.5,25,48,0.521,15,32,0.469,15,19,0.789,110,41,79,0.519,33,57,0.579,8,22,0.364,13,16,0.813,103,2012-01-13,BRK,PHO
2806,6,Home,W 110-95 ,240,43,75,0.573,36,56,0.643,7,19,0.368,17,23,0.739,110,37,77,0.481,30,58,0.517,7,19,0.368,14,21,0.667,95,2012-01-23,CHI,NJN
2807,7,Home,W 110-87 ,240,39,74,0.527,29,50,0.58,10,24,0.417,22,27,0.815,110,31,89,0.348,24,66,0.364,7,23,0.304,18,21,0.857,87,2012-02-17,OKC,GSW
2808,8,Home,W 110-91 ,240,43,79,0.544,37,66,0.561,6,13,0.462,18,24,0.75,110,37,88,0.42,35,75,0.467,2,13,0.154,15,19,0.789,91,2012-02-22,CHI,MIL
2809,9,Home,L 110-122 ,240,40,83,0.482,30,57,0.526,10,26,0.385,20,28,0.714,110,43,80,0.538,31,57,0.544,12,23,0.522,24,28,0.857,122,2012-03-03,POR,MIN
2810,10,@,W 110-92 ,240,42,80,0.525,35,61,0.574,7,19,0.368,19,21,0.905,110,35,79,0.443,27,61,0.443,8,18,0.444,14,23,0.609,92,2012-03-07,MEM,GSW
2811,11,Home,W 110-97 ,240,41,73,0.562,35,50,0.7,6,23,0.261,22,32,0.688,110,33,72,0.458,29,61,0.475,4,11,0.364,27,32,0.844,97,2012-03-09,DEN,NOH
2812,12,Home,W 110-97 ,240,43,85,0.506,32,58,0.552,11,27,0.407,13,13,1.0,110,39,86,0.453,33,64,0.516,6,22,0.273,13,18,0.722,97,2012-03-09,SAC,DAL
2813,13,@,W 110-99 ,240,40,78,0.513,36,61,0.59,4,17,0.235,26,27,0.963,110,39,82,0.476,34,66,0.515,5,16,0.313,16,25,0.64,99,2012-03-10,POR,WAS
2814,14,Home,L 110-114 (OT),265,37,82,0.451,32,66,0.485,5,16,0.313,31,51,0.608,110,39,81,0.481,32,66,0.485,7,15,0.467,29,38,0.763,114,2012-03-16,MEM,TOR
2815,15,@,L 110-119 ,240,43,90,0.478,39,74,0.527,4,16,0.25,20,25,0.8,110,47,88,0.534,43,71,0.606,4,17,0.235,21,32,0.656,119,2012-03-20,MEM,SAC
2816,16,Home,W 110-107 (OT),265,45,87,0.517,41,77,0.532,4,10,0.4,16,22,0.727,110,40,86,0.465,32,64,0.5,8,22,0.364,19,22,0.864,107,2012-03-31,DET,CHA
2817,17,Home,W 110-98 ,240,45,80,0.563,38,62,0.613,7,18,0.389,13,19,0.684,110,38,84,0.452,33,72,0.458,5,12,0.417,17,22,0.773,98,2012-04-06,BRK,WAS
2818,18,Home,W 110-100 ,240,41,92,0.446,34,78,0.436,7,14,0.5,21,28,0.75,110,41,92,0.446,32,67,0.478,9,25,0.36,9,17,0.529,100,2012-04-10,DAL,SAC
2819,19,@,L 110-118 ,240,47,90,0.522,39,74,0.527,8,16,0.5,8,11,0.727,110,42,88,0.477,32,65,0.492,10,23,0.435,24,28,0.857,118,2012-04-11,GSW,POR
2820,20,Home,L 110-115 ,240,42,84,0.5,38,73,0.521,4,11,0.364,22,34,0.647,110,40,91,0.44,33,66,0.5,7,25,0.28,28,32,0.875,115,2012-04-14,MIN,OKC
2821,21,@,L 110-118 ,240,36,66,0.545,25,45,0.556,11,21,0.524,27,34,0.794,110,42,74,0.568,23,42,0.548,19,32,0.594,15,17,0.882,118,2012-04-17,BOS,NYK
2822,22,@,L 110-117 ,240,43,86,0.5,31,58,0.534,12,28,0.429,12,15,0.8,110,41,79,0.519,30,53,0.566,11,26,0.423,24,26,0.923,117,2012-04-18,HOU,DAL
2823,23,@,L 110-118 ,240,43,82,0.524,39,66,0.591,4,16,0.25,20,27,0.741,110,38,81,0.469,29,61,0.475,9,20,0.45,33,36,0.917,118,2012-04-24,SAC,OKC
2824,24,@,W 110-106 ,240,41,88,0.466,33,66,0.5,8,22,0.364,20,23,0.87,110,45,94,0.479,40,81,0.494,5,13,0.385,11,13,0.846,106,2012-04-25,SAS,PHO
2825,25,Home,L 110-114 ,240,30,70,0.429,20,49,0.408,10,21,0.476,40,52,0.769,110,41,84,0.488,37,68,0.544,4,16,0.25,28,39,0.718,114,2012-11-03,LAC,GSW
2826,26,Home,W 110-100 ,240,42,74,0.568,35,61,0.574,7,13,0.538,19,23,0.826,110,38,77,0.494,33,64,0.516,5,13,0.385,19,22,0.864,100,2012-11-03,SAS,UTA
2827,27,@,W 110-88 ,240,39,84,0.464,26,52,0.5,13,32,0.406,19,19,1.0,110,29,86,0.337,21,64,0.328,8,22,0.364,22,26,0.846,88,2012-11-05,NYK,PHI
2828,28,Home,L 110-117 ,240,38,87,0.437,28,65,0.431,10,22,0.455,24,27,0.889,110,43,93,0.462,31,66,0.47,12,27,0.444,19,28,0.679,117,2012-11-07,CHA,PHO
2829,29,Home,L 110-113 ,240,36,80,0.45,24,46,0.522,12,34,0.353,26,33,0.788,110,45,89,0.506,35,68,0.515,10,21,0.476,13,20,0.65,113,2012-11-12,HOU,MIA
2830,30,Home,W 110-100 ,240,43,94,0.457,36,82,0.439,7,12,0.583,17,21,0.81,110,41,76,0.539,34,60,0.567,7,16,0.438,11,18,0.611,100,2012-11-12,PHO,DEN
2831,31,@,W 110-106 ,240,44,89,0.494,37,72,0.514,7,17,0.412,15,17,0.882,110,44,82,0.537,42,74,0.568,2,8,0.25,16,20,0.8,106,2012-11-16,ORL,DET
2832,32,@,W 110-95 ,240,40,74,0.541,26,45,0.578,14,29,0.483,16,20,0.8,110,33,78,0.423,26,66,0.394,7,12,0.583,22,28,0.786,95,2012-11-16,OKC,NOH
2833,33,Home,W 110-108 ,240,36,69,0.522,27,50,0.54,9,19,0.474,29,37,0.784,110,35,79,0.443,21,48,0.438,14,31,0.452,24,33,0.727,108,2012-11-24,MIA,CLE
2834,34,Home,L 110-116 (OT),265,41,90,0.456,30,64,0.469,11,26,0.423,17,19,0.895,110,47,105,0.448,40,87,0.46,7,18,0.389,15,19,0.789,116,2012-11-25,ORL,BOS
2835,35,@,W 110-89 ,240,44,84,0.524,33,59,0.559,11,25,0.44,11,15,0.733,110,41,95,0.432,39,80,0.488,2,15,0.133,5,8,0.625,89,2012-11-28,SAS,ORL
2836,36,@,L 110-113 ,240,42,86,0.488,33,58,0.569,9,28,0.321,17,19,0.895,110,40,85,0.471,34,70,0.486,6,15,0.4,27,43,0.628,113,2012-12-03,TOR,DEN
2837,37,Home,W 110-99 ,240,40,85,0.471,34,64,0.531,6,21,0.286,24,28,0.857,110,35,84,0.417,30,72,0.417,5,12,0.417,24,29,0.828,99,2012-12-05,SAS,MIL
2838,38,Home,L 110-117 ,240,40,85,0.471,25,57,0.439,15,28,0.536,15,18,0.833,110,45,83,0.542,39,65,0.6,6,18,0.333,21,27,0.778,117,2012-12-09,LAL,UTA
2839,39,@,W 110-95 ,240,42,78,0.538,32,50,0.64,10,28,0.357,16,18,0.889,110,37,96,0.385,34,74,0.459,3,22,0.136,18,21,0.857,95,2012-12-20,MIA,DAL
2840,40,@,W 110-106 ,240,37,83,0.446,29,65,0.446,8,18,0.444,28,33,0.848,110,38,91,0.418,30,65,0.462,8,26,0.308,22,25,0.88,106,2012-12-21,CHI,NYK
2841,41,Home,W 110-88 ,240,47,92,0.511,41,72,0.569,6,20,0.3,10,15,0.667,110,33,87,0.379,30,67,0.448,3,20,0.15,19,30,0.633,88,2012-12-22,DEN,CHA
2842,42,Home,L 110-112 (OT),265,42,88,0.477,34,65,0.523,8,23,0.348,18,22,0.818,110,40,85,0.471,34,64,0.531,6,21,0.286,26,35,0.743,112,2012-12-31,ORL,MIA
2843,43,Home,L 110-117 ,240,43,88,0.489,38,71,0.535,5,17,0.294,19,24,0.792,110,46,89,0.517,37,72,0.514,9,17,0.529,16,23,0.696,117,2013-01-02,MIL,SAS
2844,44,@,W 110-93 ,240,38,76,0.5,29,59,0.492,9,17,0.529,25,29,0.862,110,36,73,0.493,28,54,0.519,8,19,0.421,13,17,0.765,93,2013-01-02,BRK,OKC
2845,45,Home,W 110-91 ,240,39,76,0.513,35,65,0.538,4,11,0.364,28,39,0.718,110,28,78,0.359,19,53,0.358,9,25,0.36,26,35,0.743,91,2013-01-05,DEN,UTA
2846,46,@,W 110-104 ,240,39,88,0.443,33,70,0.471,6,18,0.333,26,32,0.813,110,34,81,0.42,26,53,0.491,8,28,0.286,28,32,0.875,104,2013-01-19,MIL,POR
2847,47,Home,W 110-102 ,240,41,79,0.519,34,63,0.54,7,16,0.438,21,33,0.636,110,42,95,0.442,34,79,0.43,8,16,0.5,10,13,0.769,102,2013-01-22,MIL,PHI
2848,48,Home,W 110-88 ,240,43,77,0.558,38,60,0.633,5,17,0.294,19,23,0.826,110,34,72,0.472,30,60,0.5,4,12,0.333,16,23,0.696,88,2013-01-25,MIA,DET
2849,49,@,L 110-114 (OT),265,44,82,0.537,37,61,0.607,7,21,0.333,15,18,0.833,110,44,83,0.53,41,73,0.562,3,10,0.3,23,26,0.885,114,2013-01-26,IND,UTA
2850,50,Home,W 110-95 ,240,45,88,0.511,40,77,0.519,5,11,0.455,15,18,0.833,110,34,77,0.442,30,60,0.5,4,17,0.235,23,28,0.821,95,2013-01-27,DAL,PHO
2851,51,@,L 110-118 ,240,39,81,0.481,31,54,0.574,8,27,0.296,24,35,0.686,110,42,82,0.512,34,54,0.63,8,28,0.286,26,36,0.722,118,2013-01-30,HOU,DEN
2852,52,@,L 110-115 ,240,41,83,0.494,34,62,0.548,7,21,0.333,21,26,0.808,110,43,90,0.478,34,72,0.472,9,18,0.5,20,23,0.87,115,2013-02-02,OKC,CLE
2853,53,Home,W 110-104 ,240,47,93,0.505,42,78,0.538,5,15,0.333,11,18,0.611,110,42,83,0.506,32,56,0.571,10,27,0.37,10,12,0.833,104,2013-02-10,ORL,POR
2854,54,@,W 110-100 ,240,41,88,0.466,30,59,0.508,11,29,0.379,17,22,0.773,110,32,73,0.438,29,60,0.483,3,13,0.231,33,34,0.971,100,2013-02-14,MIA,OKC
2855,55,Home,W 110-95 ,240,45,89,0.506,39,73,0.534,6,16,0.375,14,15,0.933,110,35,83,0.422,23,64,0.359,12,19,0.632,13,13,1.0,95,2013-02-24,NOP,SAC
2856,56,@,W 110-107 (OT),265,41,86,0.477,31,59,0.525,10,27,0.37,18,20,0.9,110,39,88,0.443,31,71,0.437,8,17,0.471,21,24,0.875,107,2013-02-25,BOS,UTA
2857,57,@,W 110-107 ,240,43,89,0.483,34,65,0.523,9,24,0.375,15,20,0.75,110,42,89,0.472,35,66,0.53,7,23,0.304,16,25,0.64,107,2013-02-27,MIL,HOU
2858,58,Home,L 110-118 ,240,44,78,0.564,35,56,0.625,9,22,0.409,13,16,0.813,110,42,77,0.545,27,45,0.6,15,32,0.469,19,28,0.679,118,2013-03-01,ORL,HOU
2859,59,Home,W 110-87 ,240,37,69,0.536,30,53,0.566,7,16,0.438,29,33,0.879,110,28,80,0.35,23,65,0.354,5,15,0.333,26,33,0.788,87,2013-03-13,OKC,UTA
2860,60,Home,W 110-106 ,240,43,94,0.457,39,83,0.47,4,11,0.364,20,24,0.833,110,38,74,0.514,29,54,0.537,9,20,0.45,21,28,0.75,106,2013-03-23,MEM,BOS
2861,61,Home,W 110-84 ,240,41,79,0.519,34,60,0.567,7,19,0.368,21,23,0.913,110,34,76,0.447,30,53,0.566,4,23,0.174,12,18,0.667,84,2013-03-23,NYK,TOR
2862,62,Home,W 110-86 ,240,41,85,0.482,27,60,0.45,14,25,0.56,14,15,0.933,110,25,66,0.379,20,50,0.4,5,16,0.313,31,39,0.795,86,2013-03-25,NOP,DEN
2863,63,Home,W 110-100 ,240,40,83,0.482,35,65,0.538,5,18,0.278,25,27,0.926,110,42,81,0.519,35,65,0.538,7,16,0.438,9,14,0.643,100,2013-04-01,MIN,BOS
2864,64,@,L 110-121 ,240,38,78,0.487,32,60,0.533,6,18,0.333,28,35,0.8,110,47,85,0.553,37,65,0.569,10,20,0.5,17,23,0.739,121,2013-04-10,NOP,SAC
2865,65,@,L 110-114 ,240,42,85,0.494,26,45,0.578,16,40,0.4,10,13,0.769,110,43,80,0.538,35,59,0.593,8,21,0.381,20,24,0.833,114,2013-10-30,MIA,PHI
2866,66,Home,W 110-90 ,240,39,70,0.557,28,48,0.583,11,22,0.5,21,27,0.778,110,32,92,0.348,26,80,0.325,6,12,0.5,20,26,0.769,90,2013-11-01,ORL,NOP
2867,67,@,W 110-101 ,240,35,70,0.5,23,46,0.5,12,24,0.5,28,34,0.824,110,36,79,0.456,30,62,0.484,6,17,0.353,23,32,0.719,101,2013-11-01,LAC,SAC
2868,68,@,W 110-90 ,240,41,92,0.446,26,54,0.481,15,38,0.395,13,20,0.65,110,31,88,0.352,26,63,0.413,5,25,0.2,23,37,0.622,90,2013-11-04,GSW,PHI
2869,69,Home,L 110-119 ,240,39,91,0.429,28,60,0.467,11,31,0.355,21,27,0.778,110,37,82,0.451,31,65,0.477,6,17,0.353,39,44,0.886,119,2013-11-08,DET,OKC
2870,70,Home,L 110-111 ,240,41,71,0.577,36,61,0.59,5,10,0.5,23,34,0.676,110,46,89,0.517,36,68,0.529,10,21,0.476,9,12,0.75,111,2013-11-09,MIA,BOS
2871,71,Home,W 110-104 (2OT),290,37,84,0.44,30,58,0.517,7,26,0.269,29,47,0.617,110,38,114,0.333,30,89,0.337,8,25,0.32,20,27,0.741,104,2013-11-11,HOU,TOR
2872,72,Home,W 110-104 ,240,40,74,0.541,35,61,0.574,5,13,0.385,25,30,0.833,110,37,74,0.5,25,46,0.543,12,28,0.429,18,21,0.857,104,2013-11-15,MIA,DAL
2873,73,Home,W 110-94 ,240,40,79,0.506,29,60,0.483,11,19,0.579,19,24,0.792,110,34,85,0.4,30,69,0.435,4,16,0.25,22,28,0.786,94,2013-11-16,CHI,IND
2874,74,Home,W 110-103 ,240,40,77,0.519,30,54,0.556,10,23,0.435,20,30,0.667,110,36,85,0.424,27,62,0.435,9,23,0.391,22,33,0.667,103,2013-11-16,LAC,BRK
2875,75,@,W 110-90 ,240,44,78,0.564,35,56,0.625,9,22,0.409,13,17,0.765,110,34,90,0.378,24,60,0.4,10,30,0.333,12,16,0.75,90,2013-11-16,ATL,NYK
2876,76,Home,L 110-118 (OT),265,42,94,0.447,39,77,0.506,3,17,0.176,23,31,0.742,110,44,99,0.444,29,67,0.433,15,32,0.469,15,20,0.75,118,2013-11-17,TOR,POR
2877,77,@,W 110-96 ,240,41,75,0.547,33,55,0.6,8,20,0.4,20,28,0.714,110,38,82,0.463,33,63,0.524,5,19,0.263,15,19,0.789,96,2013-11-25,DEN,DAL
2878,78,Home,L 110-117 ,240,40,88,0.455,35,68,0.515,5,20,0.25,25,28,0.893,110,45,88,0.511,37,72,0.514,8,16,0.5,19,25,0.76,117,2013-11-27,MIN,DEN
2879,79,Home,W 110-91 ,240,46,84,0.548,41,70,0.586,5,14,0.357,13,21,0.619,110,37,87,0.425,30,58,0.517,7,29,0.241,10,15,0.667,91,2013-12-03,MEM,PHO
2880,80,@,W 110-95 ,240,40,72,0.556,29,44,0.659,11,28,0.393,19,21,0.905,110,36,85,0.424,29,65,0.446,7,20,0.35,16,22,0.727,95,2013-12-08,MIA,DET
2881,81,@,L 110-117 ,240,38,88,0.432,27,65,0.415,11,23,0.478,23,26,0.885,110,48,87,0.552,38,65,0.585,10,22,0.455,11,13,0.846,117,2013-12-13,MIN,SAS
2882,82,Home,W 110-107 ,240,43,98,0.439,35,69,0.507,8,29,0.276,16,18,0.889,110,44,94,0.468,38,77,0.494,6,17,0.353,13,19,0.684,107,2013-12-21,POR,NOP
2883,83,@,L 110-111 (OT),265,42,97,0.433,32,69,0.464,10,28,0.357,16,17,0.941,110,43,99,0.434,33,82,0.402,10,17,0.588,15,20,0.75,111,2013-12-23,MIL,CHA
2884,84,Home,W 110-108 ,240,48,89,0.539,46,78,0.59,2,11,0.182,12,15,0.8,110,39,88,0.443,27,56,0.482,12,32,0.375,18,24,0.75,108,2013-12-30,NOP,POR
2885,85,@,W 110-106 ,240,42,85,0.494,35,63,0.556,7,22,0.318,19,23,0.826,110,39,81,0.481,32,53,0.604,7,28,0.25,21,33,0.636,106,2013-12-31,SAC,HOU
2886,86,Home,W 110-99 ,240,42,81,0.519,32,57,0.561,10,24,0.417,16,21,0.762,110,38,86,0.442,30,60,0.5,8,26,0.308,15,23,0.652,99,2014-01-03,LAL,UTA
2887,87,@,W 110-94 ,240,40,74,0.541,34,58,0.586,6,16,0.375,24,31,0.774,110,33,80,0.413,25,54,0.463,8,26,0.308,20,24,0.833,94,2014-01-04,MIA,ORL
2888,88,Home,W 110-97 ,240,48,90,0.533,43,73,0.589,5,17,0.294,9,15,0.6,110,34,81,0.42,23,50,0.46,11,31,0.355,18,26,0.692,97,2014-01-07,DAL,LAL
2889,89,@,W 110-108 (OT),265,43,83,0.518,36,59,0.61,7,24,0.292,17,25,0.68,110,46,99,0.465,40,82,0.488,6,17,0.353,10,15,0.667,108,2014-01-07,SAS,MEM
2890,90,Home,W 110-94 ,240,45,95,0.474,36,65,0.554,9,30,0.3,11,13,0.846,110,33,83,0.398,26,63,0.413,7,20,0.35,21,27,0.778,94,2014-01-08,POR,ORL
2891,91,Home,W 110-107 ,240,30,67,0.448,19,40,0.475,11,27,0.407,39,45,0.867,110,37,77,0.481,29,58,0.5,8,19,0.421,25,31,0.806,107,2014-01-11,DAL,NOP
2892,92,Home,W 110-108 ,240,44,94,0.468,41,77,0.532,3,17,0.176,19,27,0.704,110,37,94,0.394,24,59,0.407,13,35,0.371,21,25,0.84,108,2014-01-11,DET,PHO
2893,93,Home,L 110-127 ,240,40,81,0.494,32,56,0.571,8,25,0.32,22,22,1.0,110,53,91,0.582,37,64,0.578,16,27,0.593,5,7,0.714,127,2014-01-16,ATL,BRK
2894,94,@,W 110-89 ,240,43,79,0.544,34,57,0.596,9,22,0.409,15,19,0.789,110,32,74,0.432,28,58,0.483,4,16,0.25,21,31,0.677,89,2014-01-17,UTA,DET
2895,95,@,W 110-107 ,240,44,83,0.53,35,59,0.593,9,24,0.375,13,19,0.684,110,42,93,0.452,35,71,0.493,7,22,0.318,16,21,0.762,107,2014-01-17,DAL,PHO
2896,96,Home,W 110-82 ,240,43,76,0.566,32,58,0.552,11,18,0.611,13,21,0.619,110,33,88,0.375,27,67,0.403,6,21,0.286,10,17,0.588,82,2014-01-19,SAS,MIL
2897,97,@,W 110-106 ,240,42,88,0.477,33,74,0.446,9,14,0.643,17,24,0.708,110,37,82,0.451,22,49,0.449,15,33,0.455,17,24,0.708,106,2014-01-22,PHI,NYK
2898,98,Home,W 110-105 ,240,38,88,0.432,34,70,0.486,4,18,0.222,30,34,0.882,110,39,79,0.494,29,56,0.518,10,23,0.435,17,20,0.85,105,2014-01-23,POR,DEN
2899,99,Home,W 110-103 ,240,43,90,0.478,32,64,0.5,11,26,0.423,13,18,0.722,110,39,75,0.52,28,52,0.538,11,23,0.478,14,18,0.778,103,2014-01-26,NYK,LAL
2900,0,Home,W 110-103 ,240,36,73,0.493,30,58,0.517,6,15,0.4,32,42,0.762,110,45,88,0.511,42,66,0.636,3,22,0.136,10,17,0.588,103,2014-01-29,LAC,WAS
2901,1,@,W 110-100 ,240,46,88,0.523,44,77,0.571,2,11,0.182,16,22,0.727,110,36,93,0.387,30,67,0.448,6,26,0.231,22,27,0.815,100,2014-01-31,CHA,LAL
2902,2,Home,W 110-100 ,240,39,84,0.464,29,61,0.475,10,23,0.435,22,26,0.846,110,36,95,0.379,29,79,0.367,7,16,0.438,21,31,0.677,100,2014-02-05,DEN,MIL
2903,3,@,W 110-96 ,240,42,78,0.538,34,60,0.567,8,18,0.444,18,25,0.72,110,37,69,0.536,31,53,0.585,6,16,0.375,16,22,0.727,96,2014-02-05,DAL,MEM
2904,4,Home,L 110-117 ,240,40,97,0.412,35,80,0.438,5,17,0.294,25,34,0.735,110,40,83,0.482,32,60,0.533,8,23,0.348,29,38,0.763,117,2014-02-08,MIN,POR
2905,5,Home,L 110-111 ,240,40,83,0.482,31,67,0.463,9,16,0.563,21,26,0.808,110,42,78,0.538,32,56,0.571,10,22,0.455,17,25,0.68,111,2014-02-12,GSW,MIA
2906,6,@,W 110-100 ,240,36,80,0.45,27,62,0.435,9,18,0.5,29,40,0.725,110,35,83,0.422,26,56,0.464,9,27,0.333,21,32,0.656,100,2014-02-22,IND,MIL
2907,7,Home,L 110-123 ,240,37,87,0.425,30,69,0.435,7,18,0.389,29,35,0.829,110,43,83,0.518,27,55,0.491,16,28,0.571,21,26,0.808,123,2014-02-24,NOP,LAC
2908,8,@,W 110-108 ,240,41,86,0.477,26,50,0.52,15,36,0.417,13,16,0.813,110,40,76,0.526,26,43,0.605,14,33,0.424,14,16,0.875,108,2014-02-24,DAL,NYK
2909,9,Home,L 110-130 ,240,43,88,0.489,35,64,0.547,8,24,0.333,16,23,0.696,110,48,84,0.571,36,64,0.563,12,20,0.6,22,29,0.759,130,2014-02-24,PHI,MIL
2910,10,Home,W 110-98 ,240,44,80,0.55,38,63,0.603,6,17,0.353,16,21,0.762,110,37,84,0.44,33,69,0.478,4,15,0.267,20,21,0.952,98,2014-02-24,UTA,BOS
2911,11,@,W 110-101 ,240,42,87,0.483,37,69,0.536,5,18,0.278,21,32,0.656,110,42,95,0.442,39,80,0.488,3,15,0.2,14,18,0.778,101,2014-02-25,MIN,PHO
2912,12,@,L 110-120 ,240,45,90,0.5,40,80,0.5,5,10,0.5,15,17,0.882,110,44,82,0.537,35,63,0.556,9,19,0.474,23,25,0.92,120,2014-02-26,DET,SAS
2913,13,@,L 110-118 ,240,45,100,0.45,41,81,0.506,4,19,0.211,16,19,0.842,110,42,84,0.5,31,51,0.608,11,33,0.333,23,33,0.697,118,2014-03-01,DET,HOU
2914,14,Home,W 110-96 ,240,44,81,0.543,35,62,0.565,9,19,0.474,13,18,0.722,110,39,79,0.494,32,61,0.525,7,18,0.389,11,15,0.733,96,2014-03-01,MEM,CLE
2915,15,@,W 110-104 ,240,43,79,0.544,37,66,0.561,6,13,0.462,18,21,0.857,110,39,81,0.481,30,62,0.484,9,19,0.474,17,21,0.81,104,2014-03-03,MEM,WAS
2916,16,@,L 110-115 ,240,46,87,0.529,37,67,0.552,9,20,0.45,9,9,1.0,110,37,79,0.468,26,55,0.473,11,24,0.458,30,36,0.833,115,2014-03-05,DAL,DEN
2917,17,@,L 110-114 ,240,42,100,0.42,30,65,0.462,12,35,0.343,14,21,0.667,110,38,81,0.469,25,50,0.5,13,31,0.419,25,30,0.833,114,2014-03-09,OKC,LAL
2918,18,@,L 110-123 ,240,43,84,0.512,37,64,0.578,6,20,0.3,18,25,0.72,110,44,81,0.543,31,49,0.633,13,32,0.406,22,34,0.647,123,2014-03-10,PHI,NYK
2919,19,Home,L 110-112 ,240,40,82,0.488,30,61,0.492,10,21,0.476,20,24,0.833,110,38,78,0.487,25,49,0.51,13,29,0.448,23,27,0.852,112,2014-03-10,UTA,ATL
2920,20,@,W 110-101 ,240,38,81,0.469,26,57,0.456,12,24,0.5,22,27,0.815,110,39,90,0.433,29,54,0.537,10,36,0.278,13,22,0.591,101,2014-03-12,CLE,PHO
2921,21,Home,W 110-100 ,240,38,93,0.409,32,68,0.471,6,25,0.24,28,33,0.848,110,36,92,0.391,31,71,0.437,5,21,0.238,23,25,0.92,100,2014-03-17,DEN,LAC
2922,22,@,L 110-115 ,240,39,80,0.488,36,68,0.529,3,12,0.25,29,39,0.744,110,43,80,0.538,35,53,0.66,8,27,0.296,21,25,0.84,115,2014-03-20,MIL,GSW
2923,23,@,W 110-78 ,240,43,79,0.544,35,60,0.583,8,19,0.421,16,22,0.727,110,30,79,0.38,27,55,0.491,3,24,0.125,15,21,0.714,78,2014-03-28,MIA,DET
2924,24,Home,W 110-105 (OT),265,39,87,0.448,33,69,0.478,6,18,0.333,26,35,0.743,110,43,97,0.443,35,75,0.467,8,22,0.364,11,14,0.786,105,2014-03-28,ORL,CHA
2925,25,Home,W 110-81 ,240,42,70,0.6,31,45,0.689,11,25,0.44,15,20,0.75,110,26,65,0.4,18,39,0.462,8,26,0.308,21,28,0.75,81,2014-04-02,NYK,BRK
2926,26,Home,W 110-91 ,240,42,91,0.462,37,76,0.487,5,15,0.333,21,26,0.808,110,36,81,0.444,32,64,0.5,4,17,0.235,15,25,0.6,91,2014-04-08,MIN,SAS
2927,27,@,L 110-112 ,240,36,83,0.434,25,58,0.431,11,25,0.44,27,36,0.75,110,41,94,0.436,38,82,0.463,3,12,0.25,27,40,0.675,112,2014-04-11,HOU,MIN
2928,28,Home,W 110-100 ,240,38,81,0.469,24,49,0.49,14,32,0.438,20,26,0.769,110,38,73,0.521,32,63,0.508,6,10,0.6,18,26,0.692,100,2014-04-14,TOR,MIL
2929,29,Home,W 110-104 ,240,42,101,0.416,32,75,0.427,10,26,0.385,16,22,0.727,110,34,84,0.405,26,50,0.52,8,34,0.235,28,33,0.848,104,2014-04-16,POR,LAC
2930,30,@,W 110-105 ,240,34,81,0.42,32,72,0.444,2,9,0.222,40,47,0.851,110,36,93,0.387,31,69,0.449,5,24,0.208,28,33,0.848,105,2014-11-03,SAC,DEN
2931,31,@,W 110-107 ,240,42,87,0.483,35,71,0.493,7,16,0.438,19,23,0.826,110,40,78,0.513,30,52,0.577,10,26,0.385,17,18,0.944,107,2014-11-05,TOR,BOS
2932,32,Home,W 110-99 ,240,38,74,0.514,24,50,0.48,14,24,0.583,20,26,0.769,110,37,90,0.411,29,71,0.408,8,19,0.421,17,21,0.81,99,2014-11-07,BRK,NYK
2933,33,@,W 110-101 ,240,40,84,0.476,34,61,0.557,6,23,0.261,24,33,0.727,110,40,85,0.471,29,56,0.518,11,29,0.379,10,15,0.667,101,2014-11-07,CLE,DEN
2934,34,@,L 110-111 ,240,37,77,0.481,30,64,0.469,7,13,0.538,29,34,0.853,110,39,77,0.506,33,68,0.485,6,9,0.667,27,34,0.794,111,2014-11-13,SAC,MEM
2935,35,@,W 110-93 ,240,43,77,0.558,30,46,0.652,13,31,0.419,11,17,0.647,110,30,67,0.448,24,41,0.585,6,26,0.231,27,31,0.871,93,2014-11-20,LAC,MIA
2936,36,@,W 110-93 ,240,32,80,0.4,24,56,0.429,8,24,0.333,38,42,0.905,110,35,81,0.432,32,65,0.492,3,16,0.188,20,29,0.69,93,2014-11-22,TOR,CLE
2937,37,@,W 110-103 ,240,40,89,0.449,32,59,0.542,8,30,0.267,22,30,0.733,110,36,85,0.424,30,64,0.469,6,21,0.286,25,31,0.806,103,2014-11-29,DAL,PHI
2938,38,@,W 110-88 ,240,43,90,0.478,34,65,0.523,9,25,0.36,15,22,0.682,110,36,81,0.444,32,62,0.516,4,19,0.211,12,19,0.632,88,2014-12-08,CLE,BRK
2939,39,Home,L 110-112 (OT),265,42,90,0.467,30,59,0.508,12,31,0.387,14,21,0.667,110,44,96,0.458,32,72,0.444,12,24,0.5,12,15,0.8,112,2014-12-12,SAS,LAL
2940,40,Home,W 110-91 ,240,40,83,0.482,33,66,0.5,7,17,0.412,23,27,0.852,110,29,88,0.33,19,62,0.306,10,26,0.385,23,29,0.793,91,2014-12-15,IND,LAL
2941,41,@,W 110-100 ,240,42,88,0.477,34,61,0.557,8,27,0.296,18,24,0.75,110,41,94,0.436,33,69,0.478,8,25,0.32,10,15,0.667,100,2014-12-19,TOR,DET
2942,42,Home,W 110-105 ,240,40,76,0.526,32,56,0.571,8,20,0.4,22,29,0.759,110,40,91,0.44,31,64,0.484,9,27,0.333,16,26,0.615,105,2014-12-21,BRK,DET
2943,43,Home,W 110-82 ,240,43,80,0.538,35,61,0.574,8,19,0.421,16,24,0.667,110,31,82,0.378,29,64,0.453,2,18,0.111,18,24,0.75,82,2014-12-22,CHA,DEN
2944,44,Home,W 110-95 ,240,41,87,0.471,28,51,0.549,13,36,0.361,15,20,0.75,110,34,76,0.447,24,49,0.49,10,27,0.37,17,18,0.944,95,2014-12-22,HOU,POR
2945,45,@,W 110-85 ,240,44,86,0.512,35,68,0.515,9,18,0.5,13,18,0.722,110,28,77,0.364,21,52,0.404,7,25,0.28,22,27,0.815,85,2014-12-27,IND,BRK
2946,46,Home,W 110-97 ,240,41,88,0.466,30,60,0.5,11,28,0.393,17,21,0.81,110,34,77,0.442,26,58,0.448,8,19,0.421,21,36,0.583,97,2014-12-27,GSW,MIN
2947,47,@,W 110-98 ,240,41,86,0.477,28,52,0.538,13,34,0.382,15,19,0.789,110,37,81,0.457,25,56,0.446,12,25,0.48,12,15,0.8,98,2014-12-27,TOR,LAC
2948,48,Home,W 110-106 ,240,39,83,0.47,28,53,0.528,11,30,0.367,21,24,0.875,110,38,77,0.494,26,44,0.591,12,33,0.364,18,31,0.581,106,2014-12-28,SAS,HOU
2949,49,Home,W 110-106 ,240,42,81,0.519,34,63,0.54,8,18,0.444,18,29,0.621,110,41,86,0.477,32,65,0.492,9,21,0.429,15,19,0.789,106,2014-12-30,NOP,PHO
2950,50,@,W 110-107 ,240,40,74,0.541,35,62,0.565,5,12,0.417,25,29,0.862,110,42,91,0.462,35,67,0.522,7,24,0.292,16,22,0.727,107,2015-01-01,SAC,MIN
2951,51,@,W 110-101 ,240,46,84,0.548,39,65,0.6,7,19,0.368,11,16,0.688,110,38,89,0.427,28,65,0.431,10,24,0.417,15,18,0.833,101,2015-01-05,DEN,MIN
2952,52,@,W 110-82 ,240,39,78,0.5,32,62,0.516,7,16,0.438,25,33,0.758,110,33,85,0.388,25,56,0.446,8,29,0.276,8,9,0.889,82,2015-01-10,CHA,NYK
2953,53,@,L 110-122 (2OT),290,42,100,0.42,34,65,0.523,8,35,0.229,18,23,0.783,110,48,100,0.48,39,79,0.494,9,21,0.429,17,24,0.708,122,2015-01-11,PHO,MEM
2954,54,@,W 110-101 ,240,41,87,0.471,31,67,0.463,10,20,0.5,18,19,0.947,110,39,80,0.488,34,62,0.548,5,18,0.278,18,30,0.6,101,2015-01-13,MIN,IND
2955,55,Home,W 110-99 ,240,48,87,0.552,43,72,0.597,5,15,0.333,9,11,0.818,110,42,91,0.462,34,69,0.493,8,22,0.364,7,12,0.583,99,2015-01-16,PHO,MIN
2956,56,Home,W 110-96 ,240,42,94,0.447,31,65,0.477,11,29,0.379,15,17,0.882,110,37,74,0.5,31,55,0.564,6,19,0.316,16,20,0.8,96,2015-01-16,SAS,POR
2957,57,@,W 110-89 ,240,42,69,0.609,30,46,0.652,12,23,0.522,14,16,0.875,110,35,82,0.427,29,57,0.509,6,25,0.24,13,17,0.765,89,2015-01-16,ATL,TOR
2958,58,Home,W 110-98 ,240,37,72,0.514,25,41,0.61,12,31,0.387,24,33,0.727,110,39,85,0.459,33,58,0.569,6,27,0.222,14,18,0.778,98,2015-01-19,HOU,IND
2959,59,Home,W 110-91 ,240,39,78,0.5,26,49,0.531,13,29,0.448,19,26,0.731,110,31,78,0.397,26,53,0.491,5,25,0.2,24,26,0.923,91,2015-01-21,ATL,IND
2960,60,@,L 110-114 ,240,41,90,0.456,29,56,0.518,12,34,0.353,16,23,0.696,110,43,81,0.531,38,66,0.576,5,15,0.333,23,29,0.793,114,2015-01-25,DET,TOR
2961,61,Home,W 110-98 ,240,38,77,0.494,32,61,0.525,6,16,0.375,28,32,0.875,110,42,91,0.462,35,68,0.515,7,23,0.304,7,9,0.778,98,2015-01-28,MIN,BOS
2962,62,Home,W 110-100 ,240,42,94,0.447,33,69,0.478,9,25,0.36,17,28,0.607,110,37,86,0.43,29,59,0.492,8,27,0.296,18,25,0.72,100,2015-01-30,UTA,GSW
2963,63,Home,W 110-103 ,240,44,84,0.524,30,52,0.577,14,32,0.438,8,14,0.571,110,42,84,0.5,32,63,0.508,10,21,0.476,9,14,0.643,103,2015-02-04,SAS,ORL
2964,64,Home,W 110-95 ,240,39,81,0.481,35,59,0.593,4,22,0.182,28,45,0.622,110,34,87,0.391,25,42,0.595,9,45,0.2,18,22,0.818,95,2015-02-11,LAC,HOU
2965,65,Home,W 110-99 ,240,41,84,0.488,24,51,0.471,17,33,0.515,11,18,0.611,110,39,81,0.481,33,62,0.532,6,19,0.316,15,20,0.75,99,2015-02-20,GSW,SAS
2966,66,@,W 110-103 ,240,42,95,0.442,37,77,0.481,5,18,0.278,21,26,0.808,110,40,93,0.43,33,69,0.478,7,24,0.292,16,20,0.8,103,2015-02-21,OKC,CHO
2967,67,@,W 110-82 ,240,43,92,0.467,39,71,0.549,4,21,0.19,20,23,0.87,110,31,94,0.33,24,67,0.358,7,27,0.259,13,22,0.591,82,2015-02-23,BRK,DEN
2968,68,Home,L 110-115 ,240,44,97,0.454,35,65,0.538,9,32,0.281,13,16,0.813,110,39,89,0.438,25,60,0.417,14,29,0.483,23,30,0.767,115,2015-02-23,PHO,BOS
2969,69,@,W 110-96 ,240,39,91,0.429,31,67,0.463,8,24,0.333,24,32,0.75,110,31,81,0.383,19,47,0.404,12,34,0.353,22,33,0.667,96,2015-02-25,PHO,DEN
2970,70,Home,W 110-105 ,240,36,88,0.409,19,44,0.432,17,44,0.386,21,30,0.7,110,40,91,0.44,29,59,0.492,11,32,0.344,14,19,0.737,105,2015-02-25,HOU,LAC
2971,71,Home,W 110-99 ,240,36,77,0.468,27,49,0.551,9,28,0.321,29,35,0.829,110,39,92,0.424,28,63,0.444,11,29,0.379,10,19,0.526,99,2015-02-26,CLE,GSW
2972,72,@,W 110-99 ,240,41,83,0.494,31,59,0.525,10,24,0.417,18,20,0.9,110,39,86,0.453,36,74,0.486,3,12,0.25,18,23,0.783,99,2015-03-01,POR,SAC
2973,73,Home,W 110-108 ,240,44,89,0.494,34,68,0.5,10,21,0.476,12,16,0.75,110,42,90,0.467,31,60,0.517,11,30,0.367,13,18,0.722,108,2015-03-02,BRK,GSW
2974,74,@,W 110-105 ,240,44,92,0.478,32,59,0.542,12,33,0.364,10,19,0.526,110,36,82,0.439,32,67,0.478,4,15,0.267,29,35,0.829,105,2015-03-02,LAC,MIN
2975,75,Home,W 110-79 ,240,43,89,0.483,33,61,0.541,10,28,0.357,14,14,1.0,110,31,88,0.352,24,60,0.4,7,28,0.25,10,13,0.769,79,2015-03-03,CLE,BOS
2976,76,@,W 110-103 ,240,38,84,0.452,26,53,0.491,12,31,0.387,22,30,0.733,110,38,81,0.469,31,61,0.508,7,20,0.35,20,25,0.8,103,2015-03-16,ATL,SAC
2977,77,@,W 110-91 ,240,47,92,0.511,41,70,0.586,6,22,0.273,10,14,0.714,110,32,89,0.36,31,72,0.431,1,17,0.059,26,30,0.867,91,2015-03-23,BOS,BRK
2978,78,@,W 110-100 ,240,31,65,0.477,18,41,0.439,13,24,0.542,35,37,0.946,110,40,90,0.444,32,66,0.485,8,24,0.333,12,19,0.632,100,2015-03-23,HOU,IND
2979,79,@,L 110-120 ,240,37,76,0.487,31,62,0.5,6,14,0.429,30,34,0.882,110,44,83,0.53,24,39,0.615,20,44,0.455,12,17,0.706,120,2015-03-27,MIN,HOU
2980,80,Home,W 110-107 (2OT),290,44,113,0.389,35,88,0.398,9,25,0.36,13,22,0.591,110,36,104,0.346,28,79,0.354,8,25,0.32,27,35,0.771,107,2015-03-27,WAS,CHO
2981,81,Home,W 110-88 ,240,43,75,0.573,37,62,0.597,6,13,0.462,18,24,0.75,110,32,75,0.427,30,63,0.476,2,12,0.167,22,24,0.917,88,2015-03-29,NOP,MIN
2982,82,@,W 110-106 ,240,38,85,0.447,30,64,0.469,8,21,0.381,26,34,0.765,110,36,82,0.439,30,60,0.5,6,22,0.273,28,33,0.848,106,2015-03-31,GSW,LAC
2983,83,@,W 110-101 ,240,45,85,0.529,36,61,0.59,9,24,0.375,11,18,0.611,110,39,88,0.443,31,64,0.484,8,24,0.333,15,16,0.938,101,2015-04-03,MIL,BOS
2984,84,Home,L 110-123 ,240,34,80,0.425,31,64,0.484,3,16,0.188,39,54,0.722,110,43,95,0.453,29,59,0.492,14,36,0.389,23,32,0.719,123,2015-04-04,DAL,GSW
2985,85,Home,W 110-74 ,240,45,88,0.511,37,71,0.521,8,17,0.471,12,14,0.857,110,28,80,0.35,22,59,0.373,6,21,0.286,12,18,0.667,74,2015-04-08,MEM,NOP
2986,86,Home,W 110-98 ,240,48,95,0.505,41,74,0.554,7,21,0.333,7,9,0.778,110,39,84,0.464,29,59,0.492,10,25,0.4,10,16,0.625,98,2015-04-08,SAS,HOU
2987,87,Home,W 110-101 ,240,42,93,0.452,31,62,0.5,11,31,0.355,15,21,0.714,110,35,79,0.443,24,55,0.436,11,24,0.458,20,26,0.769,101,2015-04-11,GSW,MIN
2988,88,Home,W 110-103 ,240,37,82,0.451,30,61,0.492,7,21,0.333,29,37,0.784,110,38,101,0.376,26,68,0.382,12,33,0.364,15,22,0.682,103,2015-04-13,LAC,DEN
2989,89,Home,W 110-92 ,240,37,83,0.446,33,65,0.508,4,18,0.222,32,42,0.762,110,34,86,0.395,25,62,0.403,9,24,0.375,15,19,0.789,92,2015-10-30,PHO,POR
2990,90,Home,L 110-117 ,240,38,90,0.422,32,68,0.471,6,22,0.273,28,33,0.848,110,41,86,0.477,32,67,0.478,9,19,0.474,26,32,0.813,117,2015-10-31,WAS,NYK
2991,91,Home,W 110-105 ,240,41,89,0.461,32,60,0.533,9,29,0.31,19,29,0.655,110,40,84,0.476,30,61,0.492,10,23,0.435,15,22,0.682,105,2015-11-02,HOU,OKC
2992,92,Home,L 110-116 ,240,40,93,0.43,31,65,0.477,9,28,0.321,21,29,0.724,110,40,82,0.488,25,46,0.543,15,36,0.417,21,27,0.778,116,2015-11-06,SAC,HOU
2993,93,@,W 110-98 ,240,43,89,0.483,35,61,0.574,8,28,0.286,16,21,0.762,110,32,84,0.381,23,50,0.46,9,34,0.265,25,32,0.781,98,2015-11-14,DAL,HOU
2994,94,@,L 110-115 ,240,37,79,0.468,31,61,0.508,6,18,0.333,30,39,0.769,110,43,80,0.538,32,51,0.627,11,29,0.379,18,27,0.667,115,2015-11-17,TOR,GSW
2995,95,Home,W 110-103 ,240,38,85,0.447,31,68,0.456,7,17,0.412,27,40,0.675,110,43,95,0.453,35,63,0.556,8,32,0.25,9,9,1.0,103,2015-11-18,OKC,NOP
2996,96,Home,W 110-96 ,240,37,86,0.43,30,65,0.462,7,21,0.333,29,37,0.784,110,30,77,0.39,19,43,0.442,11,34,0.324,25,28,0.893,96,2015-11-24,MEM,DAL
2997,97,Home,W 110-99 ,240,41,78,0.526,31,54,0.574,10,24,0.417,18,21,0.857,110,43,94,0.457,40,81,0.494,3,13,0.231,10,12,0.833,99,2015-11-25,OKC,BRK
2998,98,Home,W 110-91 ,240,45,93,0.484,36,68,0.529,9,25,0.36,11,16,0.688,110,36,88,0.409,31,61,0.508,5,27,0.185,14,20,0.7,91,2015-11-29,ORL,BOS
2999,99,@,W 110-106 ,240,38,86,0.442,30,61,0.492,8,25,0.32,26,29,0.897,110,36,82,0.439,29,64,0.453,7,18,0.389,27,35,0.771,106,2015-12-07,LAC,MIN
3000,0,Home,W 110-105 ,240,45,81,0.556,38,63,0.603,7,18,0.389,13,16,0.813,110,39,82,0.476,24,47,0.511,15,35,0.429,12,17,0.706,105,2015-12-08,BRK,HOU
3001,1,Home,L 110-112 ,240,41,89,0.461,35,68,0.515,6,21,0.286,22,29,0.759,110,39,75,0.52,30,54,0.556,9,21,0.429,25,28,0.893,112,2015-12-12,POR,NYK
3002,2,Home,W 110-89 ,240,36,79,0.456,27,54,0.5,9,25,0.36,29,37,0.784,110,31,79,0.392,24,55,0.436,7,24,0.292,20,22,0.909,89,2015-12-21,UTA,PHO
3003,3,Home,W 110-108 ,240,38,75,0.507,25,51,0.49,13,24,0.542,21,26,0.808,110,38,84,0.452,23,51,0.451,15,33,0.455,17,20,0.85,108,2015-12-26,NOP,HOU
3004,4,Home,W 110-103 ,240,41,87,0.471,29,55,0.527,12,32,0.375,16,20,0.8,110,37,87,0.425,25,60,0.417,12,27,0.444,17,19,0.895,103,2015-12-30,POR,DEN
3005,5,@,W 110-105 ,240,40,94,0.426,31,63,0.492,9,31,0.29,21,34,0.618,110,36,74,0.486,28,49,0.571,8,25,0.32,25,41,0.61,105,2015-12-30,PHI,SAC
3006,6,Home,L 110-114 ,240,36,78,0.462,24,48,0.5,12,30,0.4,26,29,0.897,110,43,84,0.512,32,61,0.525,11,23,0.478,17,27,0.63,114,2015-12-31,HOU,GSW
3007,7,Home,W 110-106 ,240,42,80,0.525,35,59,0.593,7,21,0.333,19,24,0.792,110,43,82,0.524,35,62,0.565,8,20,0.4,12,13,0.923,106,2015-12-31,OKC,PHO
3008,8,@,L 110-115 ,240,37,76,0.487,27,55,0.491,10,21,0.476,26,36,0.722,110,42,100,0.42,23,56,0.411,19,44,0.432,12,14,0.857,115,2016-01-10,OKC,POR
3009,9,@,W 110-107 (OT),265,40,97,0.412,23,53,0.434,17,44,0.386,13,16,0.813,110,39,79,0.494,28,51,0.549,11,28,0.393,18,22,0.818,107,2016-01-12,CLE,DAL
3010,10,Home,W 110-104 ,240,45,86,0.523,36,69,0.522,9,17,0.529,11,14,0.786,110,41,91,0.451,34,69,0.493,7,22,0.318,15,23,0.652,104,2016-01-13,BRK,NYK
3011,11,@,L 110-112 ,240,42,88,0.477,32,62,0.516,10,26,0.385,16,20,0.8,110,37,87,0.425,32,65,0.492,5,22,0.227,33,37,0.892,112,2016-01-13,GSW,DEN
3012,12,@,W 110-103 ,240,36,76,0.474,23,51,0.451,13,25,0.52,25,33,0.758,110,38,96,0.396,25,57,0.439,13,39,0.333,14,19,0.737,103,2016-01-16,SAC,LAC
3013,13,@,W 110-104 ,240,41,97,0.423,35,69,0.507,6,28,0.214,22,30,0.733,110,35,83,0.422,28,63,0.444,7,20,0.35,27,36,0.75,104,2016-01-19,OKC,DEN
3014,14,Home,W 110-101 ,240,43,96,0.448,35,73,0.479,8,23,0.348,16,21,0.762,110,38,89,0.427,35,76,0.461,3,13,0.231,22,26,0.846,101,2016-01-22,BOS,CHI
3015,15,@,L 110-122 ,240,44,95,0.463,41,78,0.526,3,17,0.176,19,27,0.704,110,43,90,0.478,29,57,0.509,14,33,0.424,22,25,0.88,122,2016-01-22,IND,GSW
3016,16,Home,W 110-97 ,240,39,91,0.429,34,70,0.486,5,21,0.238,27,38,0.711,110,39,82,0.476,32,63,0.508,7,19,0.368,12,17,0.706,97,2016-01-27,DET,PHI
3017,17,@,W 110-95 ,240,43,71,0.606,34,55,0.618,9,16,0.563,15,18,0.833,110,36,88,0.409,26,62,0.419,10,26,0.385,13,21,0.619,95,2016-02-01,MEM,NOP
3018,18,Home,W 110-97 ,240,42,81,0.519,33,66,0.5,9,15,0.6,17,18,0.944,110,41,90,0.456,38,71,0.535,3,19,0.158,12,14,0.857,97,2016-02-03,SAS,NOP
3019,19,@,W 110-103 ,240,40,85,0.471,28,66,0.424,12,19,0.632,18,25,0.72,110,38,81,0.469,28,56,0.5,10,25,0.4,17,23,0.739,103,2016-02-04,TOR,POR
3020,20,@,L 110-115 ,240,43,93,0.462,38,81,0.469,5,12,0.417,19,27,0.704,110,39,87,0.448,33,69,0.478,6,18,0.333,31,44,0.705,115,2016-02-05,CHI,DEN
3021,21,Home,L 110-114 (OT),265,44,88,0.5,35,65,0.538,9,23,0.391,13,23,0.565,110,38,88,0.432,23,50,0.46,15,38,0.395,23,33,0.697,114,2016-02-06,MEM,DAL
3022,22,Home,L 110-117 (OT),265,43,92,0.467,31,63,0.492,12,29,0.414,12,20,0.6,110,46,93,0.495,37,64,0.578,9,29,0.31,16,22,0.727,117,2016-02-08,ATL,ORL
3023,23,@,L 110-123 ,240,37,87,0.425,24,54,0.444,13,33,0.394,23,35,0.657,110,44,94,0.468,32,60,0.533,12,34,0.353,23,26,0.885,123,2016-02-09,HOU,GSW
3024,24,Home,L 110-114 ,240,42,91,0.462,27,56,0.482,15,35,0.429,11,17,0.647,110,44,87,0.506,40,71,0.563,4,16,0.25,22,29,0.759,114,2016-02-10,PHI,SAC
3025,25,Home,W 110-104 (OT),265,41,102,0.402,28,67,0.418,13,35,0.371,15,17,0.882,110,37,89,0.416,18,48,0.375,19,41,0.463,11,18,0.611,104,2016-02-19,ORL,DAL
3026,26,@,L 110-116 ,240,42,90,0.467,34,66,0.515,8,24,0.333,18,26,0.692,110,41,83,0.494,31,62,0.5,10,21,0.476,24,31,0.774,116,2016-02-19,DEN,SAC
3027,27,Home,L 110-114 ,240,41,100,0.41,31,73,0.425,10,27,0.37,18,22,0.818,110,43,83,0.518,36,66,0.545,7,17,0.412,21,28,0.75,114,2016-02-23,DEN,SAC
3028,28,Home,L 110-112 ,240,39,84,0.464,29,57,0.509,10,27,0.37,22,26,0.846,110,42,84,0.5,37,69,0.536,5,15,0.333,23,30,0.767,112,2016-02-27,NOP,MIN
3029,29,Home,W 110-94 ,240,45,99,0.455,39,78,0.5,6,21,0.286,14,19,0.737,110,33,75,0.44,27,57,0.474,6,18,0.333,22,26,0.846,94,2016-03-08,DEN,NYK
3030,30,@,L 110-116 ,240,40,80,0.5,31,56,0.554,9,24,0.375,21,24,0.875,110,44,81,0.543,36,56,0.643,8,25,0.32,20,25,0.8,116,2016-03-15,DEN,ORL
3031,31,@,L 110-118 ,240,39,89,0.438,29,67,0.433,10,22,0.455,22,30,0.733,110,45,86,0.523,37,70,0.529,8,16,0.5,20,22,0.909,118,2016-03-17,POR,SAS
3032,32,Home,W 110-104 ,240,44,77,0.571,37,59,0.627,7,18,0.389,15,18,0.833,110,44,83,0.53,37,65,0.569,7,18,0.389,9,13,0.692,104,2016-03-25,SAS,MEM
3033,33,@,L 110-120 ,240,37,77,0.481,26,53,0.491,11,24,0.458,25,30,0.833,110,42,77,0.545,37,66,0.561,5,11,0.455,31,36,0.861,120,2016-03-26,IND,BRK
3034,34,Home,W 110-99 ,240,48,84,0.571,43,68,0.632,5,16,0.313,9,12,0.75,110,41,77,0.532,38,66,0.576,3,11,0.273,14,18,0.778,99,2016-03-28,MIA,BRK
3035,35,@,W 110-108 (OT),265,39,98,0.398,27,60,0.45,12,38,0.316,20,31,0.645,110,38,95,0.4,29,65,0.446,9,30,0.3,23,26,0.885,108,2016-04-01,CLE,ATL
3036,36,@,L 110-113 ,240,46,86,0.535,38,62,0.613,8,24,0.333,10,12,0.833,110,47,86,0.547,43,69,0.623,4,17,0.235,15,25,0.6,113,2016-04-01,ORL,MIL
3037,37,Home,W 110-93 ,240,41,79,0.519,31,64,0.484,10,15,0.667,18,23,0.783,110,34,88,0.386,28,69,0.406,6,19,0.316,19,27,0.704,93,2016-04-02,POR,MIA
3038,38,@,L 110-118 ,240,38,82,0.463,31,55,0.564,7,27,0.259,27,32,0.844,110,41,102,0.402,28,60,0.467,13,42,0.31,23,26,0.885,118,2016-04-03,OKC,HOU
3039,39,Home,W 110-102 ,240,42,79,0.532,32,57,0.561,10,22,0.455,16,21,0.762,110,34,81,0.42,23,57,0.404,11,24,0.458,23,27,0.852,102,2016-04-08,NOP,LAL
3040,40,@,L 110-130 ,240,41,83,0.494,29,55,0.527,12,28,0.429,16,19,0.842,110,50,98,0.51,33,57,0.579,17,41,0.415,13,18,0.722,130,2016-04-10,LAL,HOU
3041,41,Home,W 110-84 ,240,41,75,0.547,29,50,0.58,12,25,0.48,16,21,0.762,110,35,86,0.407,30,66,0.455,5,20,0.25,9,14,0.643,84,2016-04-12,LAC,MEM
3042,42,Home,L 110-112 (OT),265,46,97,0.474,39,79,0.494,7,18,0.389,11,15,0.733,110,37,85,0.435,21,52,0.404,16,33,0.485,22,28,0.786,112,2016-04-13,CLE,DET
3043,43,@,L 110-113 (OT),265,42,94,0.447,37,66,0.561,5,28,0.179,21,32,0.656,110,40,96,0.417,35,75,0.467,5,21,0.238,28,38,0.737,113,2016-10-28,PHO,OKC
3044,44,Home,W 110-108 ,240,41,88,0.466,33,66,0.5,8,22,0.364,20,24,0.833,110,37,84,0.44,26,50,0.52,11,34,0.324,23,28,0.821,108,2016-10-29,MIL,BRK
3045,45,@,L 110-119 ,240,39,92,0.424,27,64,0.422,12,28,0.429,20,28,0.714,110,42,76,0.553,30,43,0.698,12,33,0.364,23,26,0.885,119,2016-11-08,MIN,BRK
3046,46,@,W 110-106 ,240,41,81,0.506,30,52,0.577,11,29,0.379,17,24,0.708,110,37,99,0.374,26,57,0.456,11,42,0.262,21,25,0.84,106,2016-11-08,ATL,CLE
3047,47,Home,W 110-96 ,240,44,92,0.478,34,62,0.548,10,30,0.333,12,17,0.706,110,33,79,0.418,22,46,0.478,11,33,0.333,19,27,0.704,96,2016-11-09,NYK,BRK
3048,48,@,W 110-108 ,240,39,86,0.453,28,59,0.475,11,27,0.407,21,35,0.6,110,38,88,0.432,22,60,0.367,16,28,0.571,16,19,0.842,108,2016-11-11,LAC,OKC
3049,49,@,W 110-105 ,240,43,88,0.489,32,58,0.552,11,30,0.367,13,17,0.765,110,36,76,0.474,27,56,0.482,9,20,0.45,24,31,0.774,105,2016-11-16,SAS,SAC
3050,50,Home,W 110-86 ,240,43,84,0.512,37,59,0.627,6,25,0.24,18,20,0.9,110,31,83,0.373,22,51,0.431,9,32,0.281,15,19,0.789,86,2016-11-17,MIN,PHI
3051,51,Home,L 110-118 ,240,41,93,0.441,28,62,0.452,13,31,0.419,15,21,0.714,110,45,87,0.517,37,65,0.569,8,22,0.364,20,28,0.714,118,2016-11-20,LAL,CHI
3052,52,Home,W 110-107 ,240,43,100,0.43,33,78,0.423,10,22,0.455,14,17,0.824,110,43,95,0.453,37,77,0.481,6,18,0.333,15,18,0.833,107,2016-11-22,DEN,CHI
3053,53,@,W 110-107 ,240,37,73,0.507,28,48,0.583,9,25,0.36,27,33,0.818,110,40,81,0.494,29,50,0.58,11,31,0.355,16,24,0.667,107,2016-11-26,MEM,MIA
3054,54,Home,L 110-111 ,240,40,73,0.548,23,43,0.535,17,30,0.567,13,17,0.765,110,44,86,0.512,36,67,0.537,8,19,0.421,15,19,0.789,111,2016-12-01,UTA,MIA
3055,55,Home,L 110-128 ,240,46,104,0.442,37,73,0.507,9,31,0.29,9,16,0.563,110,45,88,0.511,28,51,0.549,17,37,0.459,21,25,0.84,128,2016-12-02,DEN,HOU
3056,56,Home,L 110-112 ,240,35,83,0.422,28,60,0.467,7,23,0.304,33,38,0.868,110,45,93,0.484,36,69,0.522,9,24,0.375,13,18,0.722,112,2016-12-05,CHI,POR
3057,57,@,W 110-108 (2OT),290,42,104,0.404,29,70,0.414,13,34,0.382,13,21,0.619,110,39,99,0.394,29,67,0.433,10,32,0.313,20,21,0.952,108,2016-12-05,MEM,NOP
3058,58,@,L 110-124 ,240,45,88,0.511,36,60,0.6,9,28,0.321,11,15,0.733,110,43,87,0.494,31,60,0.517,12,27,0.444,26,33,0.788,124,2016-12-08,MIN,TOR
3059,59,Home,L 110-114 ,240,44,94,0.468,32,66,0.485,12,28,0.429,10,14,0.714,110,40,84,0.476,28,50,0.56,12,34,0.353,22,29,0.759,114,2016-12-09,MIL,ATL
3060,60,Home,W 110-89 ,240,38,87,0.437,30,61,0.492,8,26,0.308,26,29,0.897,110,34,77,0.442,25,50,0.5,9,27,0.333,12,20,0.6,89,2016-12-10,MEM,GSW
3061,61,Home,W 110-105 ,240,40,88,0.455,32,67,0.478,8,21,0.381,22,28,0.786,110,40,79,0.506,27,54,0.5,13,25,0.52,12,15,0.8,105,2016-12-10,WAS,MIL
3062,62,Home,W 110-94 ,240,43,88,0.489,26,52,0.5,17,36,0.472,7,10,0.7,110,28,84,0.333,18,58,0.31,10,26,0.385,28,32,0.875,94,2016-12-12,IND,CHO
3063,63,@,L 110-117 ,240,43,87,0.494,36,64,0.563,7,23,0.304,17,24,0.708,110,43,81,0.531,33,62,0.532,10,19,0.526,21,30,0.7,117,2016-12-18,LAC,WAS
3064,64,@,W 110-108 ,240,41,75,0.547,32,52,0.615,9,23,0.391,19,24,0.792,110,39,87,0.448,29,52,0.558,10,35,0.286,20,26,0.769,108,2016-12-19,ATL,OKC
3065,65,Home,L 110-121 ,240,42,88,0.477,34,68,0.5,8,20,0.4,18,23,0.783,110,45,88,0.511,34,60,0.567,11,28,0.393,20,24,0.833,121,2016-12-21,NOP,OKC
3066,66,@,W 110-90 ,240,39,78,0.5,27,58,0.466,12,20,0.6,20,21,0.952,110,35,79,0.443,23,49,0.469,12,30,0.4,8,16,0.5,90,2016-12-23,SAS,POR
3067,67,Home,W 110-94 ,240,39,78,0.5,28,56,0.5,11,22,0.5,21,25,0.84,110,35,77,0.455,29,57,0.509,6,20,0.3,18,21,0.857,94,2016-12-30,SAS,POR
3068,68,Home,W 110-82 ,240,43,78,0.551,30,54,0.556,13,24,0.542,11,15,0.733,110,31,83,0.373,27,65,0.415,4,18,0.222,16,22,0.727,82,2017-01-03,SAS,TOR
3069,69,Home,W 110-106 ,240,35,87,0.402,16,47,0.34,19,40,0.475,21,25,0.84,110,37,79,0.468,28,51,0.549,9,28,0.321,23,26,0.885,106,2017-01-06,BOS,PHI
3070,70,@,W 110-96 ,240,41,84,0.488,29,57,0.509,12,27,0.444,16,19,0.842,110,36,85,0.424,25,56,0.446,11,29,0.379,13,16,0.813,96,2017-01-09,NOP,NYK
3071,71,@,W 110-105 ,240,41,76,0.539,31,49,0.633,10,27,0.37,18,27,0.667,110,33,82,0.402,23,41,0.561,10,41,0.244,29,36,0.806,105,2017-01-13,MEM,HOU
3072,72,Home,W 110-77 ,240,43,80,0.538,27,49,0.551,16,31,0.516,8,13,0.615,110,30,76,0.395,24,59,0.407,6,17,0.353,11,16,0.688,77,2017-01-13,UTA,DET
3073,73,Home,L 110-113 ,240,42,90,0.467,35,66,0.53,7,24,0.292,19,22,0.864,110,44,88,0.5,31,56,0.554,13,32,0.406,12,14,0.857,113,2017-01-19,NYK,WAS
3074,74,Home,W 110-93 ,240,45,91,0.495,38,71,0.535,7,20,0.35,13,23,0.565,110,33,78,0.423,21,49,0.429,12,29,0.414,15,18,0.833,93,2017-01-21,ATL,PHI
3075,75,@,L 110-121 ,240,33,71,0.465,15,37,0.405,18,34,0.529,26,41,0.634,110,45,90,0.5,35,61,0.574,10,29,0.345,21,22,0.955,121,2017-01-24,LAC,PHI
3076,76,Home,W 110-107 ,240,46,96,0.479,37,69,0.536,9,27,0.333,9,13,0.692,110,40,90,0.444,27,53,0.509,13,37,0.351,14,15,0.933,107,2017-01-27,NYK,CHO
3077,77,Home,W 110-87 ,240,42,84,0.5,31,56,0.554,11,28,0.393,15,16,0.938,110,34,79,0.43,26,53,0.491,8,26,0.308,11,17,0.647,87,2017-02-06,DEN,DAL
3078,78,Home,L 110-114 (OT),265,38,91,0.418,29,58,0.5,9,33,0.273,25,36,0.694,110,40,97,0.412,31,72,0.431,9,25,0.36,25,33,0.758,114,2017-02-08,BRK,WAS
3079,79,Home,W 110-91 ,240,35,72,0.486,21,48,0.438,14,24,0.583,26,34,0.765,110,29,87,0.333,24,64,0.375,5,23,0.217,28,34,0.824,91,2017-02-08,MEM,PHO
3080,80,@,L 110-132 ,240,45,92,0.489,37,60,0.617,8,32,0.25,12,13,0.923,110,48,88,0.545,24,47,0.511,24,41,0.585,12,16,0.75,132,2017-02-13,GSW,DEN
3081,81,@,W 110-106 ,240,40,87,0.46,33,72,0.458,7,15,0.467,23,27,0.852,110,38,78,0.487,29,58,0.5,9,20,0.45,21,30,0.7,106,2017-02-13,SAS,IND
3082,82,@,W 110-108 ,240,37,78,0.474,29,50,0.58,8,28,0.286,28,35,0.8,110,40,93,0.43,32,70,0.457,8,23,0.348,20,24,0.833,108,2017-02-13,NOP,PHO
3083,83,Home,W 110-93 ,240,44,97,0.454,34,73,0.466,10,24,0.417,12,17,0.706,110,40,101,0.396,33,66,0.5,7,35,0.2,6,14,0.429,93,2017-02-24,OKC,LAL
3084,84,Home,W 110-109 ,240,43,91,0.473,37,70,0.529,6,21,0.286,18,23,0.783,110,40,95,0.421,33,64,0.516,7,31,0.226,22,27,0.815,109,2017-02-25,NYK,PHI
3085,85,@,L 110-118 ,240,36,80,0.45,28,59,0.475,8,21,0.381,30,37,0.811,110,42,88,0.477,36,67,0.537,6,21,0.286,28,37,0.757,118,2017-02-26,NOP,OKC
3086,86,@,W 110-98 ,240,41,84,0.488,31,51,0.608,10,33,0.303,18,20,0.9,110,38,83,0.458,29,65,0.446,9,18,0.5,13,15,0.867,98,2017-03-01,DEN,MIL
3087,87,Home,W 110-99 ,240,45,90,0.5,40,73,0.548,5,17,0.294,15,19,0.789,110,35,91,0.385,27,63,0.429,8,28,0.286,21,25,0.84,99,2017-03-03,ORL,MIA
3088,88,@,W 110-109 (OT),265,41,90,0.456,31,57,0.544,10,33,0.303,18,27,0.667,110,43,83,0.518,35,66,0.53,8,17,0.471,15,20,0.75,109,2017-03-05,UTA,SAC
3089,89,@,L 110-112 ,240,41,88,0.466,27,49,0.551,14,39,0.359,14,17,0.824,110,40,87,0.46,29,60,0.483,11,27,0.407,21,23,0.913,112,2017-03-06,HOU,SAS
3090,90,Home,W 110-105 ,240,41,95,0.432,37,75,0.493,4,20,0.2,24,32,0.75,110,37,80,0.463,26,46,0.565,11,34,0.324,20,25,0.8,105,2017-03-08,ATL,BRK
3091,91,Home,L 110-122 ,240,42,91,0.462,36,72,0.5,6,19,0.316,20,25,0.8,110,47,98,0.48,35,71,0.493,12,27,0.444,16,24,0.667,122,2017-03-09,PHO,LAL
3092,92,Home,L 109-116 (3OT),315,36,94,0.383,30,72,0.417,6,22,0.273,31,46,0.674,109,45,102,0.441,37,74,0.5,8,28,0.286,18,23,0.783,116,2012-01-05,ATL,MIA
3093,93,Home,W 109-94 ,240,42,80,0.525,36,66,0.545,6,14,0.429,19,25,0.76,109,36,78,0.462,33,65,0.508,3,13,0.231,19,27,0.704,94,2012-01-06,OKC,HOU
3094,94,Home,W 109-94 ,240,47,83,0.566,38,71,0.535,9,12,0.75,6,6,1.0,109,36,82,0.439,30,68,0.441,6,14,0.429,16,20,0.8,94,2012-01-07,ATL,CHI
3095,95,Home,W 109-93 ,240,43,77,0.558,33,55,0.6,10,22,0.455,13,17,0.765,109,37,86,0.43,34,71,0.479,3,15,0.2,16,24,0.667,93,2012-01-08,PHO,MIL
3096,96,Home,L 109-117 ,240,43,82,0.524,33,59,0.559,10,23,0.435,13,19,0.684,109,35,68,0.515,24,45,0.533,11,23,0.478,36,55,0.655,117,2012-01-12,GSW,ORL
3097,97,Home,L 109-120 ,240,41,87,0.471,29,59,0.492,12,28,0.429,15,19,0.789,109,42,88,0.477,38,71,0.535,4,17,0.235,32,37,0.865,120,2012-01-27,GSW,OKC
3098,98,Home,W 109-71 ,240,43,91,0.473,36,71,0.507,7,20,0.35,16,19,0.842,109,29,78,0.372,25,65,0.385,4,13,0.308,9,18,0.5,71,2012-01-27,POR,PHO
3099,99,@,W 109-105 ,240,39,86,0.453,25,56,0.446,14,30,0.467,17,26,0.654,109,42,85,0.494,36,67,0.537,6,18,0.333,15,20,0.75,105,2012-01-29,LAC,DEN
3100,0,Home,W 109-95 ,240,43,78,0.551,37,63,0.587,6,15,0.4,17,21,0.81,109,40,75,0.533,36,62,0.581,4,13,0.308,11,19,0.579,95,2012-01-30,MIA,NOH
3101,1,@,W 109-99 ,240,38,84,0.452,31,69,0.449,7,15,0.467,26,34,0.765,109,34,91,0.374,31,74,0.419,3,17,0.176,28,37,0.757,99,2012-02-01,IND,MIN
3102,2,Home,W 109-103 ,240,33,73,0.452,20,43,0.465,13,30,0.433,30,39,0.769,109,42,92,0.457,30,69,0.435,12,23,0.522,7,9,0.778,103,2012-02-01,ORL,WAS
3103,3,@,W 109-101 ,240,41,79,0.519,28,54,0.519,13,25,0.52,14,22,0.636,109,37,85,0.435,28,61,0.459,9,24,0.375,18,27,0.667,101,2012-02-09,GSW,DEN
3104,4,Home,W 109-92 ,240,43,79,0.544,39,69,0.565,4,10,0.4,19,25,0.76,109,31,74,0.419,26,55,0.473,5,19,0.263,25,31,0.806,92,2012-02-10,DET,NJN
3105,5,Home,L 109-113 ,240,42,79,0.532,34,57,0.596,8,22,0.364,17,22,0.773,109,43,87,0.494,38,70,0.543,5,17,0.294,22,33,0.667,113,2012-02-11,IND,DEN
3106,6,Home,W 109-92 ,240,40,78,0.513,36,64,0.563,4,14,0.286,25,34,0.735,109,33,99,0.333,24,75,0.32,9,24,0.375,17,19,0.895,92,2012-02-14,DEN,PHO
3107,7,Home,L 109-124 ,240,40,85,0.471,33,62,0.532,7,23,0.304,22,27,0.815,109,48,80,0.6,39,63,0.619,9,17,0.529,19,23,0.826,124,2012-02-14,POR,WAS
3108,8,@,W 109-97 ,240,40,78,0.513,30,56,0.536,10,22,0.455,19,27,0.704,109,40,85,0.471,38,74,0.514,2,11,0.182,15,22,0.682,97,2012-02-28,MIN,LAC
3109,9,Home,W 109-94 ,240,42,84,0.5,41,74,0.554,1,10,0.1,24,32,0.75,109,36,82,0.439,33,73,0.452,3,9,0.333,19,29,0.655,94,2012-02-29,DET,CHA
3110,10,@,W 109-100 ,240,40,80,0.5,35,71,0.493,5,9,0.556,24,29,0.828,109,37,81,0.457,28,58,0.483,9,23,0.391,17,27,0.63,100,2012-03-05,UTA,CLE
3111,11,Home,W 109-101 ,240,41,83,0.494,31,63,0.492,10,20,0.5,17,22,0.773,109,40,78,0.513,32,63,0.508,8,15,0.533,13,18,0.722,101,2012-03-16,PHO,DET
3112,12,@,W 109-93 ,240,45,77,0.584,36,59,0.61,9,18,0.5,10,13,0.769,109,35,82,0.427,27,56,0.482,8,26,0.308,15,22,0.682,93,2012-03-21,LAL,DAL
3113,13,Home,W 109-83 ,240,40,85,0.471,34,68,0.5,6,17,0.353,23,27,0.852,109,34,82,0.415,28,66,0.424,6,16,0.375,9,10,0.9,83,2012-03-22,HOU,GSW
3114,14,@,W 109-95 ,240,45,79,0.57,39,62,0.629,6,17,0.353,13,16,0.813,109,34,79,0.43,27,63,0.429,7,16,0.438,20,25,0.8,95,2012-03-27,OKC,POR
3115,15,@,W 109-100 ,240,40,90,0.444,35,68,0.515,5,22,0.227,24,28,0.857,109,39,85,0.459,38,75,0.507,1,10,0.1,21,32,0.656,100,2012-04-03,PHO,SAC
3116,16,@,W 109-96 ,240,44,76,0.579,40,65,0.615,4,11,0.364,17,19,0.895,109,39,84,0.464,33,66,0.5,6,18,0.333,12,19,0.632,96,2012-04-04,IND,WAS
3117,17,Home,W 109-94 ,240,44,89,0.494,33,62,0.532,11,27,0.407,10,19,0.526,109,34,82,0.415,27,60,0.45,7,22,0.318,19,28,0.679,94,2012-04-07,LAC,SAC
3118,18,@,W 109-89 ,240,39,81,0.481,31,61,0.508,8,20,0.4,23,25,0.92,109,37,87,0.425,31,68,0.456,6,19,0.316,9,13,0.692,89,2012-04-09,OKC,MIL
3119,19,@,W 109-85 ,240,43,82,0.524,38,69,0.551,5,13,0.385,18,21,0.857,109,31,70,0.443,25,59,0.424,6,11,0.545,17,23,0.739,85,2012-04-12,DET,CHA
3120,20,@,W 109-81 ,240,40,79,0.506,26,44,0.591,14,35,0.4,15,16,0.938,109,33,85,0.388,27,57,0.474,6,28,0.214,9,14,0.643,81,2012-04-13,ATL,ORL
3121,21,@,W 109-87 ,240,39,80,0.488,33,59,0.559,6,21,0.286,25,36,0.694,109,35,79,0.443,31,70,0.443,4,9,0.444,13,16,0.813,87,2012-04-16,ATL,TOR
3122,22,@,W 109-97 ,240,36,80,0.45,30,64,0.469,6,16,0.375,31,34,0.912,109,34,83,0.41,28,63,0.444,6,20,0.3,23,32,0.719,97,2012-04-18,OKC,PHO
3123,23,@,L 109-118 ,240,37,88,0.42,31,68,0.456,6,20,0.3,29,33,0.879,109,43,91,0.473,36,74,0.486,7,17,0.412,25,32,0.781,118,2012-04-19,MIL,IND
3124,24,@,W 109-106 (OT),265,40,89,0.449,34,71,0.479,6,18,0.333,23,33,0.697,109,42,97,0.433,39,85,0.459,3,12,0.25,19,25,0.76,106,2012-04-21,PHI,IND
3125,25,Home,W 109-101 ,240,38,81,0.469,33,68,0.485,5,13,0.385,28,36,0.778,109,37,80,0.463,26,56,0.464,11,24,0.458,16,22,0.727,101,2012-04-23,MEM,CLE
3126,26,Home,W 109-102 ,240,43,86,0.5,32,62,0.516,11,24,0.458,12,14,0.857,109,40,80,0.5,32,61,0.525,8,19,0.421,14,20,0.7,102,2012-04-24,ATL,LAC
3127,27,@,W 109-102 ,240,38,90,0.422,30,60,0.5,8,30,0.267,25,29,0.862,109,40,85,0.471,33,63,0.524,7,22,0.318,15,17,0.882,102,2012-11-02,HOU,ATL
3128,28,Home,W 109-97 ,240,41,92,0.446,31,62,0.5,10,30,0.333,17,22,0.773,109,35,78,0.449,29,66,0.439,6,12,0.5,21,25,0.84,97,2012-11-06,DEN,DET
3129,29,Home,W 109-104 ,240,39,84,0.464,31,63,0.492,8,21,0.381,23,35,0.657,109,36,81,0.444,31,59,0.525,5,22,0.227,27,31,0.871,104,2012-11-07,DAL,TOR
3130,30,Home,L 109-112 ,240,42,89,0.472,32,67,0.478,10,22,0.455,15,19,0.789,109,40,70,0.571,33,52,0.635,7,18,0.389,25,31,0.806,112,2012-11-10,POR,SAS
3131,31,@,L 109-119 ,240,43,82,0.524,38,66,0.576,5,16,0.313,18,22,0.818,109,42,83,0.506,29,63,0.46,13,20,0.65,22,26,0.846,119,2012-11-18,GSW,OKC
3132,32,Home,L 109-116 (OT),265,45,91,0.495,38,71,0.535,7,20,0.35,12,17,0.706,109,39,88,0.443,33,67,0.493,6,21,0.286,32,37,0.865,116,2012-11-24,PHI,OKC
3133,33,@,W 109-102 ,240,46,90,0.511,37,71,0.521,9,19,0.474,8,10,0.8,109,37,87,0.425,26,54,0.481,11,33,0.333,17,23,0.739,102,2012-12-07,GSW,BRK
3134,34,Home,L 109-116 ,240,35,72,0.486,23,37,0.622,12,35,0.343,27,38,0.711,109,43,91,0.473,33,67,0.493,10,24,0.417,20,25,0.8,116,2012-12-08,HOU,DAL
3135,35,@,W 109-96 ,240,40,78,0.513,30,49,0.612,10,29,0.345,19,24,0.792,109,39,90,0.433,30,59,0.508,9,31,0.29,9,16,0.563,96,2012-12-17,HOU,NYK
3136,36,Home,W 109-91 ,240,44,87,0.506,38,66,0.576,6,21,0.286,15,20,0.75,109,35,86,0.407,26,62,0.419,9,24,0.375,12,16,0.75,91,2012-12-26,POR,SAC
3137,37,Home,W 109-99 ,240,43,74,0.581,31,55,0.564,12,19,0.632,11,17,0.647,109,39,77,0.506,30,48,0.625,9,29,0.31,12,16,0.75,99,2012-12-28,DET,MIA
3138,38,Home,W 109-100 ,240,44,80,0.55,34,60,0.567,10,20,0.5,11,14,0.786,109,38,80,0.475,33,65,0.508,5,15,0.333,19,22,0.864,100,2012-12-29,ATL,IND
3139,39,@,L 109-119 (OT),265,41,94,0.436,31,66,0.47,10,28,0.357,17,20,0.85,109,42,89,0.472,32,63,0.508,10,26,0.385,25,31,0.806,119,2013-01-02,DAL,MIA
3140,40,Home,W 109-85 ,240,39,75,0.52,29,58,0.5,10,17,0.588,21,27,0.778,109,34,84,0.405,23,60,0.383,11,24,0.458,6,8,0.75,85,2013-01-04,OKC,PHI
3141,41,Home,W 109-86 ,240,41,85,0.482,33,60,0.55,8,25,0.32,19,23,0.826,109,35,84,0.417,32,67,0.478,3,17,0.176,13,20,0.65,86,2013-01-05,SAS,PHI
3142,42,@,W 109-89 ,240,40,83,0.482,30,59,0.508,10,24,0.417,19,22,0.864,109,38,79,0.481,31,62,0.5,7,17,0.412,6,10,0.6,89,2013-01-08,BRK,PHI
3143,43,Home,L 109-117 ,240,41,82,0.5,28,45,0.622,13,37,0.351,14,25,0.56,109,42,78,0.538,31,59,0.525,11,19,0.579,22,26,0.846,117,2013-01-15,HOU,LAC
3144,44,Home,W 109-95 ,240,45,78,0.577,37,57,0.649,8,21,0.381,11,17,0.647,109,37,87,0.425,33,61,0.541,4,26,0.154,17,17,1.0,95,2013-01-16,ATL,BRK
3145,45,Home,W 109-98 ,240,45,90,0.5,39,74,0.527,6,16,0.375,13,17,0.765,109,34,83,0.41,28,62,0.452,6,21,0.286,24,30,0.8,98,2013-01-19,UTA,CLE
3146,46,@,W 109-97 ,240,41,78,0.526,26,51,0.51,15,27,0.556,12,14,0.857,109,39,84,0.464,35,68,0.515,4,16,0.25,15,21,0.714,97,2013-01-22,OKC,LAC
3147,47,Home,W 109-102 ,240,41,101,0.406,28,71,0.394,13,30,0.433,14,20,0.7,109,39,93,0.419,26,65,0.4,13,28,0.464,11,11,1.0,102,2013-01-26,MIL,GSW
3148,48,@,W 109-99 ,240,40,88,0.455,32,67,0.478,8,21,0.381,21,25,0.84,109,38,89,0.427,34,74,0.459,4,15,0.267,19,25,0.76,99,2013-02-01,DAL,PHO
3149,49,Home,W 109-95 ,240,42,82,0.512,35,62,0.565,7,20,0.35,18,23,0.783,109,33,79,0.418,25,60,0.417,8,19,0.421,21,24,0.875,95,2013-02-02,HOU,CHA
3150,50,@,L 109-140 ,240,41,86,0.477,38,71,0.535,3,15,0.2,24,30,0.8,109,46,91,0.505,23,51,0.451,23,40,0.575,25,35,0.714,140,2013-02-05,GSW,HOU
3151,51,@,L 109-119 ,240,37,81,0.457,27,57,0.474,10,24,0.417,25,30,0.833,109,46,89,0.517,36,67,0.537,10,22,0.455,17,20,0.85,119,2013-02-08,SAS,DET
3152,52,@,L 109-120 ,240,40,82,0.488,36,67,0.537,4,15,0.267,25,26,0.962,109,44,85,0.518,36,66,0.545,8,19,0.421,24,35,0.686,120,2013-02-09,UTA,SAC
3153,53,Home,W 109-108 ,240,39,83,0.47,29,62,0.468,10,21,0.476,21,23,0.913,109,44,85,0.518,38,69,0.551,6,16,0.375,14,20,0.7,108,2013-02-12,TOR,DEN
3154,54,Home,W 109-94 ,240,42,87,0.483,35,68,0.515,7,19,0.368,18,22,0.818,109,38,68,0.559,33,53,0.623,5,15,0.333,13,23,0.565,94,2013-02-12,UTA,OKC
3155,55,Home,W 109-105 ,240,39,75,0.52,27,56,0.482,12,19,0.632,19,24,0.792,109,39,78,0.5,31,58,0.534,8,20,0.4,19,24,0.792,105,2013-02-24,MIA,CLE
3156,56,Home,W 109-105 ,240,36,87,0.414,25,53,0.472,11,34,0.324,26,33,0.788,109,36,72,0.5,21,45,0.467,15,27,0.556,18,21,0.857,105,2013-02-27,NYK,GSW
3157,57,Home,L 109-111 ,240,38,85,0.447,28,60,0.467,10,25,0.4,23,27,0.852,109,45,87,0.517,42,73,0.575,3,14,0.214,18,31,0.581,111,2013-02-27,POR,DEN
3158,58,Home,W 109-94 ,240,44,90,0.489,37,70,0.529,7,20,0.35,14,22,0.636,109,34,87,0.391,33,75,0.44,1,12,0.083,25,36,0.694,94,2013-03-02,POR,MIN
3159,59,Home,W 109-108 (OT),265,45,95,0.474,35,71,0.493,10,24,0.417,9,13,0.692,109,40,99,0.404,36,86,0.419,4,13,0.308,24,31,0.774,108,2013-03-04,MIL,UTA
3160,60,@,W 109-101 ,240,42,83,0.506,31,64,0.484,11,19,0.579,14,16,0.875,109,41,100,0.41,36,79,0.456,5,21,0.238,14,18,0.778,101,2013-03-05,BOS,PHI
3161,61,@,L 109-115 ,240,47,93,0.505,42,72,0.583,5,21,0.238,10,15,0.667,109,40,90,0.444,28,63,0.444,12,27,0.444,23,26,0.885,115,2013-03-17,ORL,MIL
3162,62,Home,W 109-77 ,240,38,76,0.5,25,46,0.543,13,30,0.433,20,23,0.87,109,30,89,0.337,25,64,0.391,5,25,0.2,12,18,0.667,77,2013-03-24,MIA,CHA
3163,63,Home,W 109-103 ,240,43,90,0.478,33,67,0.493,10,23,0.435,13,19,0.684,109,36,91,0.396,30,65,0.462,6,26,0.231,25,36,0.694,103,2013-03-25,GSW,LAL
3164,64,Home,W 109-102 (OT),265,40,82,0.488,34,59,0.576,6,23,0.261,23,27,0.852,109,38,85,0.447,28,52,0.538,10,33,0.303,16,25,0.64,102,2013-03-26,DAL,LAC
3165,65,Home,W 109-87 ,240,42,74,0.568,38,60,0.633,4,14,0.286,21,31,0.677,109,32,79,0.405,27,59,0.458,5,20,0.25,18,36,0.5,87,2013-03-29,DEN,BRK
3166,66,@,W 109-99 ,240,40,75,0.533,36,59,0.61,4,16,0.25,25,32,0.781,109,37,98,0.378,25,69,0.362,12,29,0.414,13,15,0.867,99,2013-03-30,OKC,MIL
3167,67,Home,W 109-92 ,240,41,85,0.482,32,68,0.471,9,17,0.529,18,28,0.643,109,32,81,0.395,25,62,0.403,7,19,0.368,21,26,0.808,92,2013-03-31,WAS,TOR
3168,68,@,W 109-106 ,240,39,71,0.549,29,48,0.604,10,23,0.435,21,28,0.75,109,39,80,0.488,34,64,0.531,5,16,0.313,23,26,0.885,106,2013-04-01,IND,LAC
3169,69,Home,W 109-95 ,240,42,84,0.5,34,63,0.54,8,21,0.381,17,21,0.81,109,33,76,0.434,26,52,0.5,7,24,0.292,22,30,0.733,95,2013-04-07,LAC,LAL
3170,70,Home,W 109-104 ,240,43,85,0.506,37,65,0.569,6,20,0.3,17,25,0.68,109,38,92,0.413,21,59,0.356,17,33,0.515,11,16,0.688,104,2013-04-12,ATL,MIL
3171,71,Home,L 109-117 ,240,40,80,0.5,32,61,0.525,8,19,0.421,21,26,0.808,109,42,82,0.512,30,57,0.526,12,25,0.48,21,26,0.808,117,2013-04-12,IND,BRK
3172,72,Home,W 109-101 ,240,39,71,0.549,27,48,0.563,12,23,0.522,19,28,0.679,109,41,85,0.482,35,62,0.565,6,23,0.261,13,13,1.0,101,2013-04-12,MIA,BOS
3173,73,@,L 109-118 ,240,38,82,0.463,26,50,0.52,12,32,0.375,21,26,0.808,109,43,81,0.531,35,59,0.593,8,22,0.364,24,27,0.889,118,2013-04-14,POR,DEN
3174,74,Home,W 109-101 ,240,41,83,0.494,32,58,0.552,9,25,0.36,18,22,0.818,109,39,87,0.448,33,65,0.508,6,22,0.273,17,21,0.81,101,2013-04-15,DET,PHI
3175,75,@,L 109-118 ,240,37,76,0.487,29,52,0.558,8,24,0.333,27,35,0.771,109,44,77,0.571,33,53,0.623,11,24,0.458,19,24,0.792,118,2013-10-30,ATL,DAL
3176,76,@,W 109-102 ,240,48,94,0.511,42,71,0.592,6,23,0.261,7,14,0.5,109,41,94,0.436,32,68,0.471,9,26,0.346,11,17,0.647,102,2013-11-01,PHI,WAS
3177,77,@,W 109-100 ,240,35,79,0.443,25,52,0.481,10,27,0.37,29,38,0.763,109,40,89,0.449,31,57,0.544,9,32,0.281,11,13,0.846,100,2013-11-03,MIN,NYK
3178,78,Home,W 109-104 ,240,36,72,0.5,23,49,0.469,13,23,0.565,24,26,0.923,109,38,85,0.447,26,57,0.456,12,28,0.429,16,22,0.727,104,2013-11-06,MIL,CLE
3179,79,Home,W 109-107 ,240,42,86,0.488,28,61,0.459,14,25,0.56,11,17,0.647,109,43,94,0.457,35,68,0.515,8,26,0.308,13,19,0.684,107,2013-11-07,DEN,ATL
3180,80,Home,W 109-107 ,240,44,80,0.55,40,64,0.625,4,16,0.25,17,28,0.607,109,40,96,0.417,29,67,0.433,11,29,0.379,16,18,0.889,107,2013-11-11,LAC,MIN
3181,81,@,W 109-85 ,240,44,89,0.494,31,61,0.508,13,28,0.464,8,11,0.727,109,34,82,0.415,29,63,0.46,5,19,0.263,12,16,0.75,85,2013-11-11,SAS,PHI
3182,82,Home,W 109-103 ,240,42,82,0.512,31,59,0.525,11,23,0.478,14,15,0.933,109,42,91,0.462,39,77,0.506,3,14,0.214,16,21,0.762,103,2013-11-11,POR,DET
3183,83,@,W 109-106 ,240,31,68,0.456,22,40,0.55,9,28,0.321,38,44,0.864,109,38,87,0.437,30,67,0.448,8,20,0.4,22,27,0.815,106,2013-11-14,HOU,NYK
3184,84,@,W 109-96 ,240,40,82,0.488,31,56,0.554,9,26,0.346,20,22,0.909,109,37,81,0.457,30,63,0.476,7,18,0.389,15,19,0.789,96,2013-11-15,POR,BOS
3185,85,Home,W 109-85 ,240,41,72,0.569,32,51,0.627,9,21,0.429,18,24,0.75,109,32,99,0.323,25,79,0.316,7,20,0.35,14,20,0.7,85,2013-11-19,HOU,BOS
3186,86,@,W 109-97 ,240,38,80,0.475,33,63,0.524,5,17,0.294,28,40,0.7,109,35,77,0.455,21,51,0.412,14,26,0.538,13,18,0.722,97,2013-11-24,DET,BRK
3187,87,@,W 109-92 ,240,42,83,0.506,34,61,0.557,8,22,0.364,17,20,0.85,109,30,73,0.411,21,51,0.412,9,22,0.409,23,27,0.852,92,2013-11-26,ORL,ATL
3188,88,@,W 109-91 ,240,42,76,0.553,34,59,0.576,8,17,0.471,17,17,1.0,109,34,78,0.436,25,59,0.424,9,19,0.474,14,15,0.933,91,2013-11-29,SAS,ORL
3189,89,Home,W 109-103 ,240,43,79,0.544,33,62,0.532,10,17,0.588,13,16,0.813,109,40,83,0.482,31,55,0.564,9,28,0.321,14,20,0.7,103,2013-12-02,UTA,HOU
3190,90,@,W 109-95 ,240,39,77,0.506,32,56,0.571,7,21,0.333,24,30,0.8,109,33,88,0.375,30,72,0.417,3,16,0.188,26,34,0.765,95,2013-12-06,OKC,NOP
3191,91,@,W 109-105 (OT),265,42,92,0.457,36,72,0.5,6,20,0.3,19,26,0.731,109,33,83,0.398,25,56,0.446,8,27,0.296,31,41,0.756,105,2013-12-06,MIL,WAS
3192,92,Home,W 109-94 ,240,42,74,0.568,33,55,0.6,9,19,0.474,16,22,0.727,109,40,87,0.46,30,56,0.536,10,31,0.323,4,5,0.8,94,2013-12-10,CLE,NYK
3193,93,@,W 109-77 ,240,46,88,0.523,42,71,0.592,4,17,0.235,13,17,0.765,109,29,84,0.345,27,69,0.391,2,15,0.133,17,23,0.739,77,2013-12-11,SAS,MIL
3194,94,@,W 109-100 ,240,42,87,0.483,34,66,0.515,8,21,0.381,17,20,0.85,109,37,85,0.435,26,55,0.473,11,30,0.367,15,16,0.938,100,2013-12-13,CLE,ORL
3195,95,Home,L 109-111 (OT),265,44,94,0.468,41,79,0.519,3,15,0.2,18,27,0.667,109,41,99,0.414,34,73,0.466,7,26,0.269,22,26,0.846,111,2013-12-15,DET,POR
3196,96,Home,W 109-94 ,240,44,82,0.537,36,60,0.6,8,22,0.364,13,16,0.813,109,38,79,0.481,33,67,0.493,5,12,0.417,13,23,0.565,94,2013-12-18,HOU,CHI
3197,97,@,L 109-120 ,240,40,94,0.426,26,54,0.481,14,40,0.35,15,19,0.789,109,46,93,0.495,39,74,0.527,7,19,0.368,21,26,0.808,120,2013-12-18,POR,MIN
3198,98,@,W 109-108 (OT),265,42,91,0.462,31,70,0.443,11,21,0.524,14,18,0.778,109,46,91,0.505,36,70,0.514,10,21,0.476,6,10,0.6,108,2013-12-20,TOR,DAL
3199,99,Home,W 109-92 ,240,45,85,0.529,41,71,0.577,4,14,0.286,15,23,0.652,109,39,95,0.411,34,77,0.442,5,18,0.278,9,18,0.5,92,2013-12-27,ORL,DET
3200,0,Home,W 109-102 ,240,41,74,0.554,33,53,0.623,8,21,0.381,19,24,0.792,109,36,81,0.444,21,42,0.5,15,39,0.385,15,21,0.714,102,2013-12-29,ORL,ATL
3201,1,Home,W 109-105 ,240,43,80,0.538,36,64,0.563,7,16,0.438,16,18,0.889,109,44,89,0.494,40,81,0.494,4,8,0.5,13,19,0.684,105,2014-01-15,SAS,UTA
3202,2,Home,L 109-117 ,240,40,92,0.435,26,55,0.473,14,37,0.378,15,19,0.789,109,42,88,0.477,37,72,0.514,5,16,0.313,28,35,0.8,117,2014-01-17,DEN,CLE
3203,3,@,W 109-95 ,240,33,78,0.423,25,48,0.521,8,30,0.267,35,42,0.833,109,29,83,0.349,22,60,0.367,7,23,0.304,30,36,0.833,95,2014-01-17,LAC,NYK
3204,4,@,W 109-100 ,240,41,86,0.477,33,70,0.471,8,16,0.5,19,20,0.95,109,38,84,0.452,30,64,0.469,8,20,0.4,16,20,0.8,100,2014-01-17,POR,SAS
3205,5,Home,L 109-112 ,240,41,83,0.494,35,71,0.493,6,12,0.5,21,24,0.875,109,41,83,0.494,32,58,0.552,9,25,0.36,21,24,0.875,112,2014-01-22,ORL,ATL
3206,6,Home,W 109-102 ,240,45,78,0.577,37,58,0.638,8,20,0.4,11,23,0.478,109,40,88,0.455,31,63,0.492,9,25,0.36,13,21,0.619,102,2014-01-23,MIA,LAL
3207,7,Home,W 109-96 ,240,40,83,0.482,32,63,0.508,8,20,0.4,21,37,0.568,109,37,88,0.42,32,76,0.421,5,12,0.417,17,27,0.63,96,2014-01-25,DEN,IND
3208,8,@,L 109-111 ,240,43,88,0.489,31,63,0.492,12,25,0.48,11,12,0.917,109,43,82,0.524,30,57,0.526,13,25,0.52,12,18,0.667,111,2014-01-27,ATL,OKC
3209,9,Home,W 109-99 ,240,37,83,0.446,29,66,0.439,8,17,0.471,27,38,0.711,109,33,79,0.418,23,58,0.397,10,21,0.476,23,26,0.885,99,2014-02-04,MIN,LAL
3210,10,Home,W 109-101 ,240,32,81,0.395,28,69,0.406,4,12,0.333,41,51,0.804,109,36,84,0.429,26,59,0.441,10,25,0.4,19,24,0.792,101,2014-02-05,SAC,TOR
3211,11,@,L 109-126 ,240,41,88,0.466,26,55,0.473,15,33,0.455,12,22,0.545,109,50,98,0.51,42,78,0.538,8,20,0.4,18,23,0.783,126,2014-02-08,DEN,DET
3212,12,@,L 109-122 ,240,41,84,0.488,33,59,0.559,8,25,0.32,19,26,0.731,109,43,80,0.538,32,59,0.542,11,21,0.524,25,30,0.833,122,2014-02-08,GSW,PHO
3213,13,Home,W 109-100 ,240,43,90,0.478,38,74,0.514,5,16,0.313,18,26,0.692,109,43,82,0.524,38,65,0.585,5,17,0.294,9,11,0.818,100,2014-02-10,DET,SAS
3214,14,Home,W 109-99 ,240,41,86,0.477,29,65,0.446,12,21,0.571,15,23,0.652,109,34,74,0.459,26,48,0.542,8,26,0.308,23,33,0.697,99,2014-02-11,CLE,SAC
3215,15,Home,L 109-111 ,240,42,93,0.452,35,71,0.493,7,22,0.318,18,25,0.72,109,43,88,0.489,34,64,0.531,9,24,0.375,16,21,0.762,111,2014-02-19,POR,SAS
3216,16,@,W 109-95 ,240,37,78,0.474,32,65,0.492,5,13,0.385,30,36,0.833,109,33,88,0.375,18,56,0.321,15,32,0.469,14,21,0.667,95,2014-02-23,SAC,DEN
3217,17,Home,W 109-86 ,240,42,74,0.568,33,56,0.589,9,18,0.5,16,24,0.667,109,31,80,0.388,25,61,0.41,6,19,0.316,18,29,0.621,86,2014-02-26,UTA,PHO
3218,18,Home,W 109-90 ,240,39,84,0.464,31,62,0.5,8,22,0.364,23,33,0.697,109,35,79,0.443,30,61,0.492,5,18,0.278,15,18,0.833,90,2014-03-02,CHI,NYK
3219,19,Home,W 109-87 ,240,43,84,0.512,34,66,0.515,9,18,0.5,14,20,0.7,109,31,76,0.408,21,53,0.396,10,23,0.435,15,20,0.75,87,2014-03-05,CHA,IND
3220,20,Home,W 109-108 ,240,42,79,0.532,35,57,0.614,7,22,0.318,18,24,0.75,109,38,76,0.5,26,48,0.542,12,28,0.429,20,26,0.769,108,2014-03-08,LAC,ATL
3221,21,Home,W 109-99 ,240,47,84,0.56,41,72,0.569,6,12,0.5,9,13,0.692,109,35,86,0.407,28,69,0.406,7,17,0.412,22,29,0.759,99,2014-03-11,MEM,POR
3222,22,@,W 109-86 ,240,40,75,0.533,27,51,0.529,13,24,0.542,16,20,0.8,109,29,79,0.367,20,50,0.4,9,29,0.31,19,27,0.704,86,2014-03-16,DAL,OKC
3223,23,@,L 109-118 ,240,43,95,0.453,33,69,0.478,10,26,0.385,13,19,0.684,109,44,86,0.512,33,59,0.559,11,27,0.407,19,27,0.704,118,2014-03-19,DET,DEN
3224,24,Home,L 109-125 ,240,39,91,0.429,30,65,0.462,9,26,0.346,22,29,0.759,109,50,95,0.526,38,68,0.559,12,27,0.444,13,16,0.813,125,2014-03-19,LAL,SAS
3225,25,Home,W 109-93 ,240,45,89,0.506,34,64,0.531,11,25,0.44,8,12,0.667,109,32,80,0.4,26,67,0.388,6,13,0.462,23,30,0.767,93,2014-03-19,PHO,ORL
3226,26,Home,W 109-92 ,240,48,91,0.527,42,79,0.532,6,12,0.5,7,13,0.538,109,34,90,0.378,27,66,0.409,7,24,0.292,17,20,0.85,92,2014-03-24,MEM,MIN
3227,27,Home,W 109-104 (OT),265,40,85,0.471,31,65,0.477,9,20,0.45,20,27,0.741,109,33,90,0.367,23,50,0.46,10,40,0.25,28,32,0.875,104,2014-03-24,NOP,BRK
3228,28,@,W 109-103 ,240,38,82,0.463,27,56,0.482,11,26,0.423,22,25,0.88,109,37,79,0.468,27,59,0.458,10,20,0.5,19,27,0.704,103,2014-03-27,LAC,DAL
3229,29,@,W 109-93 ,240,39,97,0.402,33,76,0.434,6,21,0.286,25,31,0.806,109,35,81,0.432,29,60,0.483,6,21,0.286,17,27,0.63,93,2014-04-04,PHO,POR
3230,30,@,W 109-100 ,240,38,88,0.432,22,54,0.407,16,34,0.471,17,22,0.773,109,39,83,0.47,34,71,0.479,5,12,0.417,17,21,0.81,100,2014-04-10,SAS,DAL
3231,31,@,W 109-98 ,240,32,67,0.478,21,46,0.457,11,21,0.524,34,40,0.85,109,33,75,0.44,23,50,0.46,10,25,0.4,22,31,0.71,98,2014-04-15,NYK,BRK
3232,32,Home,W 109-102 ,240,37,90,0.411,29,64,0.453,8,26,0.308,27,33,0.818,109,40,80,0.5,27,58,0.466,13,22,0.591,9,17,0.529,102,2014-10-29,TOR,ATL
3233,33,@,W 109-104 ,240,46,89,0.517,40,64,0.625,6,25,0.24,11,19,0.579,109,38,89,0.427,31,70,0.443,7,19,0.368,21,28,0.75,104,2014-11-01,DAL,NOP
3234,34,@,L 109-131 ,240,37,82,0.451,28,54,0.519,9,28,0.321,26,31,0.839,109,42,76,0.553,34,56,0.607,8,20,0.4,39,50,0.78,131,2014-11-05,DEN,SAC
3235,35,@,W 109-94 ,240,40,82,0.488,30,58,0.517,10,24,0.417,19,22,0.864,109,37,83,0.446,28,50,0.56,9,33,0.273,11,13,0.846,94,2014-11-12,OKC,BOS
3236,36,Home,W 109-102 ,240,45,82,0.549,37,63,0.587,8,19,0.421,11,18,0.611,109,35,84,0.417,28,63,0.444,7,21,0.333,25,32,0.781,102,2014-11-12,NOP,LAL
3237,37,Home,W 109-93 ,240,41,76,0.539,35,62,0.565,6,14,0.429,21,27,0.778,109,32,82,0.39,19,48,0.396,13,34,0.382,16,26,0.615,93,2014-11-16,NYK,DEN
3238,38,Home,L 109-114 ,240,41,85,0.482,32,58,0.552,9,27,0.333,18,23,0.783,109,47,87,0.54,41,70,0.586,6,17,0.353,14,22,0.636,114,2014-11-18,ATL,LAL
3239,39,@,L 109-114 ,240,35,82,0.427,28,61,0.459,7,21,0.333,32,37,0.865,109,43,85,0.506,35,69,0.507,8,16,0.5,20,27,0.741,114,2014-11-25,CHI,DEN
3240,40,Home,W 109-102 (OT),265,38,95,0.4,34,64,0.531,4,31,0.129,29,38,0.763,109,39,92,0.424,25,64,0.391,14,28,0.5,10,16,0.625,102,2014-11-26,DAL,NYK
3241,41,@,W 109-102 ,240,37,90,0.411,32,73,0.438,5,17,0.294,30,37,0.811,109,37,92,0.402,31,70,0.443,6,22,0.273,22,29,0.759,102,2014-11-28,CHI,BOS
3242,42,Home,W 109-97 ,240,41,78,0.526,34,62,0.548,7,16,0.438,20,32,0.625,109,35,89,0.393,28,67,0.418,7,22,0.318,20,26,0.769,97,2014-11-29,CLE,IND
3243,43,@,W 109-103 ,240,36,83,0.434,27,57,0.474,9,26,0.346,28,35,0.8,109,38,89,0.427,26,60,0.433,12,29,0.414,15,25,0.6,103,2014-12-01,SAS,PHI
3244,44,Home,W 109-105 ,240,43,82,0.524,32,58,0.552,11,24,0.458,12,14,0.857,109,41,84,0.488,29,61,0.475,12,23,0.522,11,13,0.846,105,2014-12-02,ATL,BOS
3245,45,Home,L 109-117 ,240,39,75,0.52,36,65,0.554,3,10,0.3,28,37,0.757,109,44,88,0.5,34,65,0.523,10,23,0.435,19,21,0.905,117,2014-12-02,SAC,TOR
3246,46,Home,W 109-102 (OT),265,37,93,0.398,24,63,0.381,13,30,0.433,22,27,0.815,109,37,102,0.363,29,75,0.387,8,27,0.296,20,29,0.69,102,2014-12-03,BOS,DET
3247,47,Home,W 109-85 ,240,39,69,0.565,30,53,0.566,9,16,0.563,22,26,0.846,109,30,68,0.441,23,50,0.46,7,18,0.389,18,27,0.667,85,2014-12-05,MIL,MIA
3248,48,Home,W 109-95 ,240,37,73,0.507,27,54,0.5,10,19,0.526,25,30,0.833,109,37,76,0.487,31,61,0.508,6,15,0.4,15,17,0.882,95,2014-12-10,SAS,NYK
3249,49,Home,L 109-113 (OT),265,39,84,0.464,31,66,0.47,8,18,0.444,23,34,0.676,109,38,95,0.4,23,51,0.451,15,44,0.341,22,31,0.71,113,2014-12-11,SAC,HOU
3250,50,Home,W 109-95 ,240,43,86,0.5,33,69,0.478,10,17,0.588,13,18,0.722,109,36,81,0.444,33,73,0.452,3,8,0.375,20,35,0.571,95,2014-12-16,WAS,MIN
3251,51,Home,W 109-92 ,240,44,80,0.55,37,61,0.607,7,19,0.368,14,18,0.778,109,37,85,0.435,32,66,0.485,5,19,0.263,13,15,0.867,92,2014-12-17,BOS,ORL
3252,52,@,L 109-114 ,240,41,86,0.477,30,61,0.492,11,25,0.44,16,24,0.667,109,48,94,0.511,36,63,0.571,12,31,0.387,6,10,0.6,114,2014-12-18,OKC,GSW
3253,53,Home,W 109-106 ,240,38,80,0.475,27,51,0.529,11,29,0.379,22,30,0.733,109,39,85,0.459,36,67,0.537,3,18,0.167,25,33,0.758,106,2014-12-19,DEN,LAC
3254,54,@,W 109-91 ,240,43,98,0.439,33,74,0.446,10,24,0.417,13,17,0.765,109,32,71,0.451,20,45,0.444,12,26,0.462,15,17,0.882,91,2014-12-19,CHA,PHI
3255,55,@,W 109-107 ,240,41,83,0.494,34,62,0.548,7,21,0.333,20,28,0.714,109,45,87,0.517,36,63,0.571,9,24,0.375,8,11,0.727,107,2014-12-26,BRK,BOS
3256,56,@,L 109-119 ,240,42,83,0.506,33,63,0.524,9,20,0.45,16,22,0.727,109,47,86,0.547,37,60,0.617,10,26,0.385,15,29,0.517,119,2014-12-26,IND,DET
3257,57,Home,W 109-101 ,240,40,79,0.506,30,50,0.6,10,29,0.345,19,26,0.731,109,37,84,0.44,24,53,0.453,13,31,0.419,14,21,0.667,101,2014-12-30,ATL,CLE
3258,58,@,W 109-86 ,240,40,86,0.465,26,53,0.491,14,33,0.424,15,29,0.517,109,38,85,0.447,34,65,0.523,4,20,0.2,6,10,0.6,86,2014-12-30,DET,ORL
3259,59,@,W 109-106 ,240,41,84,0.488,35,70,0.5,6,14,0.429,21,31,0.677,109,43,81,0.531,37,62,0.597,6,19,0.316,14,19,0.737,106,2015-01-02,MEM,LAL
3260,60,Home,W 109-102 ,240,44,83,0.53,36,64,0.563,8,19,0.421,13,19,0.684,109,39,84,0.464,28,63,0.444,11,21,0.524,13,15,0.867,102,2015-01-02,OKC,WAS
3261,61,Home,W 109-104 (OT),265,37,100,0.37,31,72,0.431,6,28,0.214,29,40,0.725,109,45,100,0.45,40,83,0.482,5,17,0.294,9,11,0.818,104,2015-01-03,CHI,BOS
3262,62,@,W 109-90 ,240,44,78,0.564,32,52,0.615,12,26,0.462,9,11,0.818,109,35,86,0.407,27,61,0.443,8,25,0.32,12,17,0.706,90,2015-01-04,DAL,CLE
3263,63,@,L 109-125 ,240,38,83,0.458,29,57,0.509,9,26,0.346,24,29,0.828,109,48,89,0.539,40,66,0.606,8,23,0.348,21,28,0.75,125,2015-01-04,TOR,PHO
3264,64,Home,W 109-96 ,240,41,91,0.451,28,61,0.459,13,30,0.433,14,19,0.737,109,39,83,0.47,33,65,0.508,6,18,0.333,12,20,0.6,96,2015-01-10,TOR,BOS
3265,65,@,W 109-102 ,240,37,78,0.474,28,48,0.583,9,30,0.3,26,36,0.722,109,39,76,0.513,31,52,0.596,8,24,0.333,16,23,0.696,102,2015-01-15,CLE,LAL
3266,66,@,W 109-99 ,240,38,84,0.452,27,57,0.474,11,27,0.407,22,27,0.815,109,37,79,0.468,32,65,0.492,5,14,0.357,20,29,0.69,99,2015-01-20,SAS,DEN
3267,67,Home,W 109-106 ,240,40,79,0.506,32,62,0.516,8,17,0.471,21,25,0.84,109,39,81,0.481,30,57,0.526,9,24,0.375,19,25,0.76,106,2015-01-25,NOP,DAL
3268,68,@,W 109-90 ,240,42,79,0.532,32,58,0.552,10,21,0.476,15,20,0.75,109,38,78,0.487,31,52,0.596,7,26,0.269,7,10,0.7,90,2015-01-27,MEM,DAL
3269,69,@,W 109-102 ,240,39,71,0.549,30,55,0.545,9,16,0.563,22,30,0.733,109,38,75,0.507,31,55,0.564,7,20,0.35,19,26,0.731,102,2015-01-27,MIL,MIA
3270,70,@,L 109-114 ,240,43,87,0.494,31,63,0.492,12,24,0.5,11,15,0.733,109,46,77,0.597,34,56,0.607,12,21,0.571,10,18,0.556,114,2015-02-04,DET,IND
3271,71,@,W 109-93 ,240,40,81,0.494,31,62,0.5,9,19,0.474,20,23,0.87,109,35,79,0.443,25,46,0.543,10,33,0.303,13,18,0.722,93,2015-02-04,BRK,TOR
3272,72,@,W 109-98 ,240,40,76,0.526,31,47,0.66,9,29,0.31,20,23,0.87,109,31,82,0.378,18,47,0.383,13,35,0.371,23,34,0.676,98,2015-02-08,POR,HOU
3273,73,Home,W 109-95 ,240,36,74,0.486,24,52,0.462,12,22,0.545,25,29,0.862,109,36,84,0.429,29,64,0.453,7,20,0.35,16,19,0.842,95,2015-02-09,MIA,NYK
3274,74,@,L 109-111 ,240,40,89,0.449,33,72,0.458,7,17,0.412,22,31,0.71,109,40,86,0.465,36,71,0.507,4,15,0.267,27,38,0.711,111,2015-02-20,PHO,MIN
3275,75,Home,W 109-101 ,240,40,83,0.482,32,61,0.525,8,22,0.364,21,26,0.808,109,40,100,0.4,34,78,0.436,6,22,0.273,15,26,0.577,101,2015-02-20,SAC,BOS
3276,76,@,L 109-114 (OT),265,40,88,0.455,30,63,0.476,10,25,0.4,19,24,0.792,109,41,80,0.513,34,56,0.607,7,24,0.292,25,33,0.758,114,2015-03-07,SAC,MIA
3277,77,Home,W 109-103 (OT),265,39,79,0.494,30,57,0.526,9,22,0.409,22,28,0.786,109,35,91,0.385,31,77,0.403,4,14,0.286,29,36,0.806,103,2015-03-12,IND,MIL
3278,78,Home,W 109-91 ,240,44,92,0.478,33,59,0.559,11,33,0.333,10,17,0.588,109,34,79,0.43,27,47,0.574,7,32,0.219,16,24,0.667,91,2015-03-12,UTA,HOU
3279,79,Home,W 109-100 ,240,40,87,0.46,32,66,0.485,8,21,0.381,21,30,0.7,109,37,83,0.446,28,54,0.519,9,29,0.31,17,24,0.708,100,2015-03-15,OKC,CHI
3280,80,@,W 109-98 ,240,45,89,0.506,39,71,0.549,6,18,0.333,13,16,0.813,109,41,74,0.554,37,63,0.587,4,11,0.364,12,16,0.75,98,2015-03-22,CHA,MIN
3281,81,Home,W 109-86 ,240,40,79,0.506,32,62,0.516,8,17,0.471,21,23,0.913,109,35,87,0.402,32,70,0.457,3,17,0.176,13,18,0.722,86,2015-03-22,SAC,WAS
3282,82,Home,W 109-102 ,240,39,82,0.476,32,64,0.5,7,18,0.389,24,29,0.828,109,40,83,0.482,32,58,0.552,8,25,0.32,14,22,0.636,102,2015-03-29,MIA,DET
3283,83,@,W 109-97 ,240,40,86,0.465,30,60,0.5,10,26,0.385,19,26,0.731,109,37,82,0.451,32,60,0.533,5,22,0.227,18,24,0.75,97,2015-03-29,OKC,PHO
3284,84,Home,W 109-86 ,240,44,86,0.512,32,59,0.542,12,27,0.444,9,10,0.9,109,38,87,0.437,35,71,0.493,3,16,0.188,7,10,0.7,86,2015-03-30,POR,PHO
3285,85,@,L 109-114 ,240,42,82,0.512,34,56,0.607,8,26,0.308,17,23,0.739,109,46,88,0.523,41,72,0.569,5,16,0.313,17,23,0.739,114,2015-04-03,TOR,BRK
3286,86,Home,W 109-97 ,240,43,85,0.506,26,53,0.491,17,32,0.531,6,12,0.5,109,38,83,0.458,29,58,0.5,9,25,0.36,12,20,0.6,97,2015-04-13,CLE,DET
3287,87,Home,W 109-92 ,240,41,82,0.5,30,54,0.556,11,28,0.393,16,26,0.615,109,34,82,0.415,25,62,0.403,9,20,0.45,15,23,0.652,92,2015-04-13,UTA,DAL
3288,88,@,L 109-114 ,240,43,101,0.426,37,83,0.446,6,18,0.333,17,25,0.68,109,39,76,0.513,35,59,0.593,4,17,0.235,32,46,0.696,114,2015-10-31,SAC,LAC
3289,89,Home,W 109-89 ,240,42,86,0.488,33,64,0.516,9,22,0.409,16,21,0.762,109,32,79,0.405,22,43,0.512,10,36,0.278,15,18,0.833,89,2015-11-01,MIA,HOU
3290,90,Home,L 109-120 ,240,36,86,0.419,30,60,0.5,6,26,0.231,31,38,0.816,109,43,85,0.506,36,65,0.554,7,20,0.35,27,31,0.871,120,2015-11-03,LAL,DEN
3291,91,@,W 109-105 ,240,38,86,0.442,31,56,0.554,7,30,0.233,26,29,0.897,109,42,88,0.477,38,66,0.576,4,22,0.182,17,25,0.68,105,2015-11-07,HOU,LAC
3292,92,Home,W 109-95 ,240,43,91,0.473,31,70,0.443,12,21,0.571,11,13,0.846,109,40,85,0.471,34,66,0.515,6,19,0.316,9,15,0.6,95,2015-11-09,GSW,DET
3293,93,Home,L 109-111 ,240,37,84,0.44,33,67,0.493,4,17,0.235,31,39,0.795,109,42,95,0.442,31,72,0.431,11,23,0.478,16,18,0.889,111,2015-11-10,TOR,NYK
3294,94,@,L 109-111 ,240,42,89,0.472,34,68,0.5,8,21,0.381,17,21,0.81,109,40,94,0.426,29,67,0.433,11,27,0.407,20,26,0.769,111,2015-11-13,BRK,SAC
3295,95,Home,W 109-98 ,240,42,86,0.488,33,68,0.485,9,18,0.5,16,20,0.8,109,38,98,0.388,33,83,0.398,5,15,0.333,17,18,0.944,98,2015-11-18,SAS,DEN
3296,96,@,L 109-116 ,240,43,84,0.512,31,61,0.508,12,23,0.522,11,20,0.55,109,42,89,0.472,35,65,0.538,7,24,0.292,25,33,0.758,116,2015-11-19,SAC,MIA
3297,97,Home,W 109-97 ,240,41,85,0.482,30,56,0.536,11,29,0.379,16,19,0.842,109,32,86,0.372,21,58,0.362,11,28,0.393,22,25,0.88,97,2015-11-21,CLE,ATL
3298,98,Home,W 109-88 ,240,43,83,0.518,34,70,0.486,9,13,0.692,14,17,0.824,109,31,91,0.341,25,63,0.397,6,28,0.214,20,24,0.833,88,2015-11-23,MIL,DET
3299,99,Home,W 109-106 ,240,40,82,0.488,30,56,0.536,10,26,0.385,19,25,0.76,109,43,84,0.512,33,61,0.541,10,23,0.435,10,16,0.625,106,2015-12-04,WAS,PHO
3300,0,@,W 109-103 ,240,39,77,0.506,29,57,0.509,10,20,0.5,21,30,0.7,109,38,83,0.458,33,68,0.485,5,15,0.333,22,26,0.846,103,2015-12-05,POR,MIN
3301,1,Home,L 109-112 ,240,40,91,0.44,32,71,0.451,8,20,0.4,21,26,0.808,109,35,73,0.479,19,43,0.442,16,30,0.533,26,36,0.722,112,2015-12-05,TOR,GSW
3302,2,@,W 109-95 ,240,38,81,0.469,26,53,0.491,12,28,0.429,21,36,0.583,109,42,90,0.467,40,80,0.5,2,10,0.2,9,12,0.75,95,2015-12-09,LAC,MIL
3303,3,@,W 109-103 ,240,40,83,0.482,28,50,0.56,12,33,0.364,17,25,0.68,109,39,89,0.438,34,64,0.531,5,25,0.2,20,24,0.833,103,2015-12-09,HOU,WAS
3304,4,Home,W 109-87 ,240,44,82,0.537,38,68,0.559,6,14,0.429,15,25,0.6,109,36,88,0.409,27,63,0.429,9,25,0.36,6,10,0.6,87,2015-12-11,SAS,LAL
3305,5,Home,W 109-99 (OT),265,37,85,0.435,27,56,0.482,10,29,0.345,25,31,0.806,109,35,97,0.361,26,58,0.448,9,39,0.231,20,28,0.714,99,2015-12-17,CHA,TOR
3306,6,@,W 109-101 ,240,41,88,0.466,37,68,0.544,4,20,0.2,23,29,0.793,109,34,77,0.442,24,54,0.444,10,23,0.435,23,31,0.742,101,2015-12-18,ATL,BOS
3307,7,Home,W 109-101 ,240,40,79,0.506,31,59,0.525,9,20,0.45,20,23,0.87,109,39,93,0.419,29,60,0.483,10,33,0.303,13,16,0.813,101,2015-12-19,WAS,CHO
3308,8,@,L 109-116 ,240,39,80,0.488,26,46,0.565,13,34,0.382,18,22,0.818,109,43,75,0.573,31,52,0.596,12,23,0.522,18,26,0.692,116,2015-12-20,POR,MIA
3309,9,@,W 109-104 ,240,38,79,0.481,25,53,0.472,13,26,0.5,20,24,0.833,109,36,74,0.486,26,47,0.553,10,27,0.37,22,27,0.815,104,2015-12-26,LAC,UTA
3310,10,Home,W 109-96 ,240,43,86,0.5,28,53,0.528,15,33,0.455,8,11,0.727,109,35,78,0.449,19,42,0.452,16,36,0.444,10,14,0.714,96,2015-12-31,UTA,POR
3311,11,@,W 109-90 ,240,35,79,0.443,26,56,0.464,9,23,0.391,30,37,0.811,109,29,84,0.345,23,62,0.371,6,22,0.273,26,34,0.765,90,2016-01-02,OKC,CHO
3312,12,Home,W 109-99 ,240,48,87,0.552,44,67,0.657,4,20,0.2,9,14,0.643,109,39,73,0.534,37,68,0.544,2,5,0.4,19,24,0.792,99,2016-01-04,PHI,MIN
3313,13,@,W 109-88 ,240,40,86,0.465,27,55,0.491,13,31,0.419,16,21,0.762,109,29,91,0.319,24,70,0.343,5,21,0.238,25,30,0.833,88,2016-01-05,GSW,LAL
3314,14,@,W 109-98 ,240,42,83,0.506,31,60,0.517,11,23,0.478,14,17,0.824,109,38,86,0.442,29,60,0.483,9,26,0.346,13,23,0.565,98,2016-01-06,LAC,POR
3315,15,@,W 109-99 ,240,41,85,0.482,36,71,0.507,5,14,0.357,22,27,0.815,109,38,91,0.418,32,68,0.471,6,23,0.261,17,26,0.654,99,2016-01-12,SAS,DET
3316,16,@,W 109-97 ,240,42,100,0.42,26,67,0.388,16,33,0.485,9,11,0.818,109,41,84,0.488,35,61,0.574,6,23,0.261,9,14,0.643,97,2016-01-13,NOP,SAC
3317,17,Home,W 109-107 ,240,43,87,0.494,31,60,0.517,12,27,0.444,11,13,0.846,109,42,86,0.488,28,51,0.549,14,35,0.4,9,12,0.75,107,2016-01-15,NOP,CHO
3318,18,Home,W 109-82 ,240,41,83,0.494,29,59,0.492,12,24,0.5,15,18,0.833,109,31,90,0.344,22,67,0.328,9,23,0.391,11,18,0.611,82,2016-01-16,UTA,LAL
3319,19,Home,W 109-95 ,240,39,83,0.47,30,59,0.508,9,24,0.375,22,30,0.733,109,34,81,0.42,25,54,0.463,9,27,0.333,18,21,0.857,95,2016-01-20,OKC,CHO
3320,20,@,L 109-115 ,240,43,85,0.506,31,59,0.525,12,26,0.462,11,15,0.733,109,46,83,0.554,35,54,0.648,11,29,0.379,12,17,0.706,115,2016-01-20,BOS,TOR
3321,21,@,W 109-106 ,240,45,91,0.495,37,61,0.607,8,30,0.267,11,15,0.733,109,40,87,0.46,30,54,0.556,10,33,0.303,16,18,0.889,106,2016-01-22,OKC,DAL
3322,22,Home,W 109-91 ,240,45,92,0.489,38,72,0.528,7,20,0.35,12,16,0.75,109,31,80,0.388,21,51,0.412,10,29,0.345,19,28,0.679,91,2016-01-29,POR,CHO
3323,23,Home,W 109-105 (OT),265,44,100,0.44,35,73,0.479,9,27,0.333,12,16,0.75,109,40,87,0.46,36,69,0.522,4,18,0.222,21,25,0.84,105,2016-01-30,IND,DEN
3324,24,@,W 109-90 ,240,45,86,0.523,36,66,0.545,9,20,0.45,10,12,0.833,109,33,71,0.465,22,49,0.449,11,22,0.5,13,19,0.684,90,2016-02-10,MEM,BRK
3325,25,Home,W 109-98 ,240,42,86,0.488,34,69,0.493,8,17,0.471,17,20,0.85,109,36,82,0.439,26,56,0.464,10,26,0.385,16,18,0.889,98,2016-02-19,BRK,NYK
3326,26,Home,W 109-104 ,240,40,82,0.488,33,61,0.541,7,21,0.333,22,28,0.786,109,31,75,0.413,20,49,0.408,11,26,0.423,31,31,1.0,104,2016-02-19,MEM,MIN
3327,27,Home,L 109-117 (2OT),290,44,106,0.415,35,65,0.538,9,41,0.22,12,18,0.667,109,46,104,0.442,43,87,0.494,3,17,0.176,22,32,0.688,117,2016-02-20,ATL,MIL
3328,28,Home,W 109-89 ,240,43,94,0.457,31,68,0.456,12,26,0.462,11,17,0.647,109,29,83,0.349,23,60,0.383,6,23,0.261,25,33,0.758,89,2016-02-23,WAS,NOP
3329,29,Home,W 109-104 ,240,44,88,0.5,36,65,0.554,8,23,0.348,13,16,0.813,109,38,90,0.422,29,62,0.468,9,28,0.321,19,26,0.731,104,2016-02-24,CHI,WAS
3330,30,Home,W 109-105 (OT),265,41,103,0.398,29,67,0.433,12,36,0.333,15,17,0.882,109,37,80,0.463,25,47,0.532,12,33,0.364,19,24,0.792,105,2016-03-01,GSW,ATL
3331,31,@,W 109-100 ,240,37,71,0.521,25,43,0.581,12,28,0.429,23,30,0.767,109,32,80,0.4,22,58,0.379,10,22,0.455,26,33,0.788,100,2016-03-06,PHO,MEM
3332,32,@,W 109-90 ,240,39,83,0.47,27,51,0.529,12,32,0.375,19,29,0.655,109,30,81,0.37,26,56,0.464,4,25,0.16,26,32,0.813,90,2016-03-07,LAC,DAL
3333,33,@,L 109-116 (OT),265,45,99,0.455,37,79,0.468,8,20,0.4,11,23,0.478,109,41,89,0.461,31,65,0.477,10,24,0.417,24,31,0.774,116,2016-03-08,WAS,POR
3334,34,Home,W 109-101 ,240,44,93,0.473,38,76,0.5,6,17,0.353,15,19,0.789,109,39,86,0.453,28,64,0.438,11,22,0.5,12,13,0.923,101,2016-03-10,SAS,CHI
3335,35,@,L 109-125 ,240,43,93,0.462,38,67,0.567,5,26,0.192,18,28,0.643,109,48,88,0.545,33,57,0.579,15,31,0.484,14,16,0.875,125,2016-03-12,HOU,CHO
3336,36,@,W 109-100 ,240,45,89,0.506,39,75,0.52,6,14,0.429,13,21,0.619,109,39,70,0.557,27,43,0.628,12,27,0.444,10,13,0.769,100,2016-03-13,MIL,BRK
3337,37,@,W 109-107 ,240,41,83,0.494,32,58,0.552,9,25,0.36,18,20,0.9,109,37,83,0.446,31,63,0.492,6,20,0.3,27,31,0.871,107,2016-03-14,CHI,TOR
3338,38,Home,L 109-130 ,240,40,93,0.43,35,74,0.473,5,19,0.263,24,27,0.889,109,47,96,0.49,35,67,0.522,12,29,0.414,24,30,0.8,130,2016-03-16,BOS,OKC
3339,39,@,W 109-106 ,240,40,86,0.465,27,60,0.45,13,26,0.5,16,21,0.762,109,40,75,0.533,33,58,0.569,7,17,0.412,19,24,0.792,106,2016-03-17,CHA,MIA
3340,40,@,W 109-103 ,240,38,76,0.5,25,48,0.521,13,28,0.464,20,27,0.741,109,37,82,0.451,26,60,0.433,11,22,0.5,18,22,0.818,103,2016-03-18,CLE,ORL
3341,41,Home,W 109-97 ,240,44,88,0.5,30,50,0.6,14,38,0.368,7,12,0.583,109,33,84,0.393,28,61,0.459,5,23,0.217,26,31,0.839,97,2016-03-19,ATL,HOU
3342,42,Home,W 109-105 ,240,35,71,0.493,28,50,0.56,7,21,0.333,32,40,0.8,109,33,82,0.402,23,43,0.535,10,39,0.256,29,42,0.69,105,2016-03-20,NOP,LAC
3343,43,Home,W 109-102 ,240,41,91,0.451,29,67,0.433,12,24,0.5,15,23,0.652,109,40,88,0.455,31,59,0.525,9,29,0.31,13,16,0.813,102,2016-03-21,CHI,SAC
3344,44,@,W 109-104 ,240,43,87,0.494,35,63,0.556,8,24,0.333,15,24,0.625,109,36,82,0.439,29,63,0.46,7,19,0.368,25,30,0.833,104,2016-03-21,GSW,MIN
3345,45,Home,W 109-103 ,240,40,89,0.449,33,62,0.532,7,27,0.259,22,25,0.88,109,42,96,0.438,33,66,0.5,9,30,0.3,10,11,0.909,103,2016-03-23,POR,DAL
3346,46,@,L 109-112 ,240,39,94,0.415,26,63,0.413,13,31,0.419,18,26,0.692,109,42,81,0.519,30,59,0.508,12,22,0.545,16,35,0.457,112,2016-03-25,TOR,HOU
3347,47,@,W 109-105 ,240,38,78,0.487,25,49,0.51,13,29,0.448,20,24,0.833,109,41,95,0.432,35,76,0.461,6,19,0.316,17,27,0.63,105,2016-03-30,DEN,MEM
3348,48,@,L 109-116 ,240,37,88,0.42,28,64,0.438,9,24,0.375,26,34,0.765,109,41,90,0.456,27,56,0.482,14,34,0.412,20,27,0.741,116,2016-03-31,BOS,POR
3349,49,@,W 109-106 ,240,41,87,0.471,33,64,0.516,8,23,0.348,19,30,0.633,109,38,83,0.458,18,40,0.45,20,43,0.465,10,13,0.769,106,2016-04-01,BOS,GSW
3350,50,@,L 109-114 ,240,43,94,0.457,32,64,0.5,11,30,0.367,12,21,0.571,109,43,85,0.506,35,66,0.53,8,19,0.421,20,33,0.606,114,2016-04-03,WAS,LAC
3351,51,@,W 109-80 ,240,41,75,0.547,23,39,0.59,18,36,0.5,9,10,0.9,109,35,88,0.398,31,72,0.431,4,16,0.25,6,12,0.5,80,2016-04-05,CLE,MIL
3352,52,@,L 109-123 ,240,35,74,0.473,27,45,0.6,8,29,0.276,31,34,0.912,109,45,80,0.563,29,49,0.592,16,31,0.516,17,22,0.773,123,2016-04-06,CLE,IND
3353,53,@,L 109-124 ,240,41,84,0.488,34,67,0.507,7,17,0.412,20,29,0.69,109,44,78,0.564,38,64,0.594,6,14,0.429,30,38,0.789,124,2016-04-08,MIL,BOS
3354,54,@,L 109-112 ,240,45,100,0.45,37,78,0.474,8,22,0.364,11,21,0.524,109,43,82,0.524,38,71,0.535,5,11,0.455,21,28,0.75,112,2016-04-08,MIA,ORL
3355,55,@,W 109-102 ,240,43,91,0.473,39,75,0.52,4,16,0.25,19,30,0.633,109,32,91,0.352,18,54,0.333,14,37,0.378,24,36,0.667,102,2016-04-08,NYK,PHI
3356,56,@,W 109-108 (OT),265,40,87,0.46,33,64,0.516,7,23,0.304,22,24,0.917,109,39,96,0.406,26,50,0.52,13,46,0.283,17,25,0.68,108,2016-04-10,MIL,PHI
3357,57,Home,W 109-94 ,240,40,83,0.482,29,54,0.537,11,29,0.379,18,20,0.9,109,39,87,0.448,31,57,0.544,8,30,0.267,8,15,0.533,94,2016-04-11,CLE,ATL
3358,58,@,L 109-144 ,240,40,92,0.435,29,62,0.468,11,30,0.367,18,22,0.818,109,56,86,0.651,43,58,0.741,13,28,0.464,19,23,0.826,144,2016-04-13,NOP,MIN
3359,59,Home,W 109-98 ,240,42,88,0.477,33,60,0.55,9,28,0.321,16,30,0.533,109,32,81,0.395,21,52,0.404,11,29,0.379,23,31,0.742,98,2016-04-13,WAS,ATL
3360,60,Home,W 109-91 ,240,41,86,0.477,38,68,0.559,3,18,0.167,24,29,0.828,109,35,84,0.417,31,62,0.5,4,22,0.182,17,22,0.773,91,2016-10-26,TOR,DET
3361,61,Home,W 109-101 ,240,41,76,0.539,28,49,0.571,13,27,0.481,14,17,0.824,109,37,88,0.42,28,63,0.444,9,25,0.36,18,21,0.857,101,2016-11-02,BRK,DET
3362,62,Home,W 109-93 ,240,39,79,0.494,26,45,0.578,13,34,0.382,18,26,0.692,109,34,86,0.395,22,48,0.458,12,38,0.316,13,15,0.867,93,2016-11-02,CHA,PHI
3363,63,Home,L 109-114 ,240,42,83,0.506,34,63,0.54,8,20,0.4,17,19,0.895,109,38,75,0.507,30,50,0.6,8,25,0.32,30,35,0.857,114,2016-11-06,NYK,UTA
3364,64,@,W 109-84 ,240,43,85,0.506,32,66,0.485,11,19,0.579,12,20,0.6,109,31,77,0.403,24,56,0.429,7,21,0.333,15,22,0.682,84,2016-11-07,UTA,PHI
3365,65,@,W 109-97 ,240,43,82,0.524,33,59,0.559,10,23,0.435,13,15,0.867,109,38,78,0.487,28,52,0.538,10,26,0.385,11,14,0.786,97,2016-11-08,DAL,LAL
3366,66,Home,W 109-105 (OT),265,36,86,0.419,25,54,0.463,11,32,0.344,26,31,0.839,109,39,88,0.443,34,69,0.493,5,19,0.263,22,23,0.957,105,2016-11-11,PHI,IND
3367,67,Home,W 109-102 ,240,42,77,0.545,32,49,0.653,10,28,0.357,15,22,0.682,109,38,91,0.418,30,68,0.441,8,23,0.348,18,25,0.72,102,2016-11-16,PHI,WAS
3368,68,@,L 109-126 ,240,41,90,0.456,31,62,0.5,10,28,0.357,17,21,0.81,109,46,95,0.484,32,63,0.508,14,32,0.438,20,25,0.8,126,2016-11-17,POR,HOU
3369,69,Home,L 109-129 ,240,37,93,0.398,27,58,0.466,10,35,0.286,25,31,0.806,109,49,85,0.576,34,49,0.694,15,36,0.417,16,21,0.762,129,2016-11-20,BRK,POR
3370,70,@,L 109-111 ,240,45,92,0.489,34,65,0.523,11,27,0.407,8,11,0.727,109,42,83,0.506,28,56,0.5,14,27,0.519,13,16,0.813,111,2016-11-22,OKC,LAL
3371,71,@,W 109-103 ,240,38,81,0.469,27,57,0.474,11,24,0.458,22,25,0.88,109,42,91,0.462,30,57,0.526,12,34,0.353,7,9,0.778,103,2016-11-25,SAS,BOS
3372,72,@,W 109-85 ,240,43,83,0.518,32,55,0.582,11,28,0.393,12,17,0.706,109,32,90,0.356,27,68,0.397,5,22,0.227,16,23,0.696,85,2016-11-25,GSW,LAL
3373,73,Home,W 109-94 ,240,42,95,0.442,34,75,0.453,8,20,0.4,17,20,0.85,109,39,88,0.443,27,53,0.509,12,35,0.343,4,10,0.4,94,2016-11-27,LAL,ATL
3374,74,Home,W 109-107 ,240,40,89,0.449,30,68,0.441,10,21,0.476,19,25,0.76,109,45,89,0.506,36,64,0.563,9,25,0.36,8,10,0.8,107,2016-11-30,PHO,ATL
3375,75,@,L 109-131 ,240,36,72,0.5,30,58,0.517,6,14,0.429,31,35,0.886,109,51,94,0.543,39,62,0.629,12,32,0.375,17,19,0.895,131,2016-11-30,IND,POR
3376,76,@,L 109-138 ,240,41,91,0.451,30,59,0.508,11,32,0.344,16,21,0.762,109,49,78,0.628,35,57,0.614,14,21,0.667,26,34,0.765,138,2016-12-03,PHO,GSW
3377,77,@,W 109-101 ,240,40,79,0.506,37,61,0.607,3,18,0.167,26,28,0.929,109,37,89,0.416,24,53,0.453,13,36,0.361,14,18,0.778,101,2016-12-05,CHA,DAL
3378,78,@,W 109-94 ,240,35,78,0.449,28,55,0.509,7,23,0.304,32,41,0.78,109,34,85,0.4,25,52,0.481,9,33,0.273,17,18,0.944,94,2016-12-07,IND,PHO
3379,79,Home,W 109-88 ,240,41,85,0.482,32,63,0.508,9,22,0.409,18,23,0.783,109,34,91,0.374,25,57,0.439,9,34,0.265,11,14,0.786,88,2016-12-09,CHA,ORL
3380,80,Home,W 109-87 ,240,37,74,0.5,18,37,0.486,19,37,0.514,16,22,0.727,109,32,79,0.405,21,45,0.467,11,34,0.324,12,14,0.857,87,2016-12-10,HOU,DAL
3381,81,Home,L 109-113 ,240,39,82,0.476,25,47,0.532,14,35,0.4,17,21,0.81,109,42,95,0.442,28,61,0.459,14,34,0.412,15,19,0.789,113,2016-12-13,NOP,GSW
3382,82,Home,W 109-89 ,240,42,72,0.583,29,49,0.592,13,23,0.565,12,15,0.8,109,30,82,0.366,24,63,0.381,6,19,0.316,23,27,0.852,89,2016-12-14,UTA,OKC
3383,83,Home,W 109-106 ,240,45,87,0.517,40,69,0.58,5,18,0.278,14,17,0.824,109,38,74,0.514,24,41,0.585,14,33,0.424,16,21,0.762,106,2016-12-14,WAS,CHO
3384,84,Home,L 109-111 (OT),265,41,92,0.446,34,71,0.479,7,21,0.333,20,27,0.741,109,39,96,0.406,22,45,0.489,17,51,0.333,16,20,0.8,111,2016-12-17,MIN,HOU
3385,85,@,W 109-79 ,240,43,87,0.494,36,60,0.6,7,27,0.259,16,21,0.762,109,34,83,0.41,31,62,0.5,3,21,0.143,8,9,0.889,79,2016-12-18,TOR,ORL
3386,86,Home,L 109-112 (OT),265,38,94,0.404,26,64,0.406,12,30,0.4,21,26,0.808,109,33,81,0.407,21,44,0.477,12,37,0.324,34,38,0.895,112,2016-12-20,MEM,BOS
3387,87,@,W 109-102 ,240,38,92,0.413,28,53,0.528,10,39,0.256,23,27,0.852,109,35,82,0.427,28,59,0.475,7,23,0.304,25,29,0.862,102,2016-12-22,BOS,IND
3388,88,@,W 109-108 ,240,37,86,0.43,29,61,0.475,8,25,0.32,27,33,0.818,109,37,78,0.474,29,53,0.547,8,25,0.32,26,35,0.743,108,2016-12-23,ATL,DEN
3389,89,@,L 109-115 ,240,38,89,0.427,18,37,0.486,20,52,0.385,13,15,0.867,109,41,81,0.506,28,56,0.5,13,25,0.52,20,25,0.8,115,2016-12-23,HOU,MEM
3390,90,@,W 109-105 ,240,42,80,0.525,27,51,0.529,15,29,0.517,10,14,0.714,109,36,79,0.456,24,47,0.511,12,32,0.375,21,26,0.808,105,2016-12-23,SAC,MIN
3391,91,Home,W 109-90 ,240,45,89,0.506,34,62,0.548,11,27,0.407,8,14,0.571,109,31,87,0.356,23,64,0.359,8,23,0.348,20,24,0.833,90,2016-12-23,ORL,LAL
3392,92,Home,W 109-108 ,240,37,95,0.389,25,60,0.417,12,35,0.343,23,32,0.719,109,37,77,0.481,28,47,0.596,9,30,0.3,25,29,0.862,108,2016-12-25,CLE,GSW
3393,93,Home,L 109-121 ,240,40,78,0.513,31,54,0.574,9,24,0.375,20,23,0.87,109,43,85,0.506,29,54,0.537,14,31,0.452,21,25,0.84,121,2016-12-31,CHA,CLE
3394,94,Home,W 109-98 ,240,37,80,0.463,30,64,0.469,7,16,0.438,28,38,0.737,109,39,102,0.382,37,87,0.425,2,15,0.133,18,22,0.818,98,2017-01-02,LAC,PHO
3395,95,@,L 109-121 ,240,41,90,0.456,24,52,0.462,17,38,0.447,10,13,0.769,109,48,93,0.516,38,71,0.535,10,22,0.455,15,19,0.789,121,2017-01-05,BRK,IND
3396,96,@,L 109-118 ,240,36,86,0.419,26,55,0.473,10,31,0.323,27,33,0.818,109,43,81,0.531,31,48,0.646,12,33,0.364,20,30,0.667,118,2017-01-05,LAL,POR
3397,97,@,L 109-123 ,240,40,87,0.46,28,56,0.5,12,31,0.387,17,24,0.708,109,43,86,0.5,32,62,0.516,11,24,0.458,26,28,0.929,123,2017-01-07,NYK,IND
3398,98,@,W 109-94 ,240,47,83,0.566,40,59,0.678,7,24,0.292,8,11,0.727,109,34,83,0.41,27,64,0.422,7,19,0.368,19,22,0.864,94,2017-01-09,OKC,CHI
3399,99,@,W 109-107 ,240,44,84,0.524,34,65,0.523,10,19,0.526,11,13,0.846,109,42,88,0.477,30,58,0.517,12,30,0.4,11,14,0.786,107,2017-01-10,MIL,SAS
3400,0,Home,L 109-115 ,240,39,97,0.402,29,63,0.46,10,34,0.294,21,25,0.84,109,41,83,0.494,31,65,0.477,10,18,0.556,23,26,0.885,115,2017-01-13,POR,ORL
3401,1,Home,W 109-93 ,240,44,91,0.484,36,74,0.486,8,17,0.471,13,18,0.722,109,36,87,0.414,26,56,0.464,10,31,0.323,11,21,0.524,93,2017-01-14,WAS,PHI
3402,2,Home,L 109-119 ,240,40,89,0.449,33,63,0.524,7,26,0.269,22,24,0.917,109,48,92,0.522,38,73,0.521,10,19,0.526,13,16,0.813,119,2017-01-17,BRK,TOR
3403,3,Home,W 109-103 ,240,42,90,0.467,33,61,0.541,9,29,0.31,16,24,0.667,109,36,90,0.4,27,51,0.529,9,39,0.231,22,28,0.786,103,2017-01-17,MIA,HOU
3404,4,Home,W 109-97 ,240,41,77,0.532,28,47,0.596,13,30,0.433,14,22,0.636,109,33,79,0.418,27,61,0.443,6,18,0.333,25,32,0.781,97,2017-01-21,MIA,MIL
3405,5,Home,W 109-100 ,240,39,84,0.464,33,60,0.55,6,24,0.25,25,32,0.781,109,39,77,0.506,29,57,0.509,10,20,0.5,12,17,0.706,100,2017-01-21,UTA,IND
3406,6,@,W 109-99 ,240,43,80,0.538,33,55,0.6,10,25,0.4,13,17,0.765,109,35,90,0.389,27,58,0.466,8,32,0.25,21,25,0.84,99,2017-01-23,WAS,CHO
3407,7,@,W 109-104 ,240,40,82,0.488,31,61,0.508,9,21,0.429,20,26,0.769,109,41,82,0.5,31,54,0.574,10,28,0.357,12,17,0.706,104,2017-01-23,SAC,DET
3408,8,@,W 109-103 ,240,35,76,0.461,27,54,0.5,8,22,0.364,31,35,0.886,109,38,86,0.442,31,60,0.517,7,26,0.269,20,25,0.8,103,2017-01-23,NYK,IND
3409,9,@,L 109-120 ,240,36,77,0.468,26,46,0.565,10,31,0.323,27,38,0.711,109,47,91,0.516,36,59,0.61,11,32,0.344,15,16,0.938,120,2017-01-25,HOU,BOS
3410,10,@,W 109-106 ,240,40,83,0.482,29,60,0.483,11,23,0.478,18,25,0.72,109,35,80,0.438,22,45,0.489,13,35,0.371,23,26,0.885,106,2017-01-25,MIA,BRK
3411,11,Home,L 109-114 ,240,42,91,0.462,35,63,0.556,7,28,0.25,18,23,0.783,109,40,75,0.533,28,49,0.571,12,26,0.462,22,25,0.88,114,2017-01-25,MIL,PHI
3412,12,@,W 109-103 ,240,42,81,0.519,32,63,0.508,10,18,0.556,15,17,0.882,109,36,81,0.444,26,54,0.481,10,27,0.37,21,27,0.778,103,2017-01-26,IND,MIN
3413,13,Home,W 109-98 ,240,37,72,0.514,28,50,0.56,9,22,0.409,26,36,0.722,109,38,84,0.452,27,58,0.466,11,26,0.423,11,13,0.846,98,2017-01-26,OKC,DAL
3414,14,@,L 109-112 ,240,37,77,0.481,28,51,0.549,9,26,0.346,26,33,0.788,109,38,81,0.469,22,46,0.478,16,35,0.457,20,21,0.952,112,2017-01-27,MEM,POR
3415,15,@,W 109-106 ,240,41,79,0.519,30,52,0.577,11,27,0.407,16,26,0.615,109,36,75,0.48,24,38,0.632,12,37,0.324,22,24,0.917,106,2017-01-28,SAC,CHO
3416,16,@,L 109-129 ,240,41,85,0.482,34,64,0.531,7,21,0.333,20,25,0.8,109,47,92,0.511,38,72,0.528,9,20,0.45,26,32,0.813,129,2017-01-28,BRK,MIN
3417,17,@,L 109-113 ,240,43,97,0.443,40,70,0.571,3,27,0.111,20,29,0.69,109,36,82,0.439,23,50,0.46,13,32,0.406,28,33,0.848,113,2017-01-30,DET,BOS
3418,18,Home,W 109-104 ,240,36,87,0.414,24,51,0.471,12,36,0.333,25,30,0.833,109,41,78,0.526,33,47,0.702,8,31,0.258,14,25,0.56,104,2017-02-01,BOS,TOR
3419,19,Home,W 109-106 (OT),265,43,88,0.489,36,65,0.554,7,23,0.304,16,19,0.842,109,36,87,0.414,21,43,0.488,15,44,0.341,19,24,0.792,106,2017-02-04,SAC,GSW
3420,20,@,L 109-118 ,240,42,90,0.467,29,55,0.527,13,35,0.371,12,18,0.667,109,41,84,0.488,31,60,0.517,10,24,0.417,26,29,0.897,118,2017-02-06,LAC,TOR
3421,21,@,L 109-112 ,240,42,79,0.532,31,51,0.608,11,28,0.393,14,20,0.7,109,39,80,0.488,32,61,0.525,7,19,0.368,27,30,0.9,112,2017-02-08,TOR,MIN
3422,22,@,L 109-118 ,240,38,79,0.481,28,58,0.483,10,21,0.476,23,30,0.767,109,50,106,0.472,42,79,0.532,8,27,0.296,10,13,0.769,118,2017-02-09,CLE,OKC
3423,23,@,L 109-125 ,240,39,97,0.402,27,60,0.45,12,37,0.324,19,22,0.864,109,46,84,0.548,31,54,0.574,15,30,0.5,18,22,0.818,125,2017-02-11,DEN,CLE
3424,24,@,L 109-117 ,240,39,85,0.459,32,62,0.516,7,23,0.304,24,28,0.857,109,39,86,0.453,30,61,0.492,9,25,0.36,30,38,0.789,117,2017-02-11,MIA,PHI
3425,25,@,W 109-104 (OT),265,32,83,0.386,24,55,0.436,8,28,0.286,37,48,0.771,109,37,103,0.359,21,61,0.344,16,42,0.381,14,25,0.56,104,2017-02-13,ATL,POR
3426,26,Home,W 109-86 ,240,41,84,0.488,28,48,0.583,13,36,0.361,14,21,0.667,109,33,89,0.371,26,65,0.4,7,24,0.292,13,17,0.765,86,2017-02-15,GSW,SAC
3427,27,Home,L 109-117 ,240,36,87,0.414,23,47,0.489,13,40,0.325,24,31,0.774,109,44,84,0.524,31,49,0.633,13,35,0.371,16,24,0.667,117,2017-02-15,HOU,MIA
3428,28,@,L 109-129 ,240,41,83,0.494,31,53,0.585,10,30,0.333,17,31,0.548,109,49,97,0.505,35,66,0.53,14,31,0.452,17,24,0.708,129,2017-02-24,BRK,DEN
3429,29,@,W 109-95 ,240,37,74,0.5,29,51,0.569,8,23,0.348,27,30,0.9,109,32,74,0.432,25,56,0.446,7,18,0.389,24,29,0.828,95,2017-02-24,UTA,MIL
3430,30,@,L 109-110 ,240,40,95,0.421,33,64,0.516,7,31,0.226,22,27,0.815,109,43,91,0.473,37,70,0.529,6,21,0.286,18,23,0.783,110,2017-02-25,PHI,NYK
3431,31,@,W 109-104 ,240,38,85,0.447,22,46,0.478,16,39,0.41,17,24,0.708,109,41,84,0.488,29,52,0.558,12,32,0.375,10,13,0.769,104,2017-02-28,CHA,LAL
3432,32,Home,W 109-106 ,240,39,76,0.513,24,54,0.444,15,22,0.682,16,23,0.696,109,43,93,0.462,34,71,0.479,9,22,0.409,11,13,0.846,106,2017-02-28,OKC,UTA
3433,33,Home,W 109-86 ,240,39,78,0.5,30,53,0.566,9,25,0.36,22,23,0.957,109,40,103,0.388,37,80,0.463,3,23,0.13,3,17,0.176,86,2017-03-01,NOP,DET
3434,34,@,W 109-100 ,240,34,74,0.459,23,46,0.5,11,28,0.393,30,36,0.833,109,35,81,0.432,24,59,0.407,11,22,0.5,19,22,0.864,100,2017-03-01,BRK,SAC
3435,35,@,L 109-114 ,240,34,86,0.395,23,57,0.404,11,29,0.379,30,32,0.938,109,39,79,0.494,29,54,0.537,10,25,0.4,26,35,0.743,114,2017-03-02,OKC,POR
3436,36,Home,W 109-106 ,240,42,94,0.447,38,74,0.514,4,20,0.2,21,26,0.808,109,32,85,0.376,19,48,0.396,13,37,0.351,29,40,0.725,106,2017-03-05,PHO,BOS
3437,37,Home,L 109-110 (OT),265,43,83,0.518,35,66,0.53,8,17,0.471,15,20,0.75,109,41,90,0.456,31,57,0.544,10,33,0.303,18,27,0.667,110,2017-03-05,SAC,UTA
3438,38,Home,W 109-95 ,240,45,92,0.489,39,71,0.549,6,21,0.286,13,20,0.65,109,34,83,0.41,26,55,0.473,8,28,0.286,19,21,0.905,95,2017-03-06,DET,CHI
3439,39,Home,L 109-122 ,240,34,77,0.442,24,52,0.462,10,25,0.4,31,39,0.795,109,39,73,0.534,25,43,0.581,14,30,0.467,30,38,0.789,122,2017-03-06,MEM,BRK
3440,40,@,W 108-98 ,240,43,80,0.538,37,68,0.544,6,12,0.5,16,21,0.762,108,35,83,0.422,27,66,0.409,8,17,0.471,20,34,0.588,98,2011-12-29,CHI,SAC
3441,41,@,W 108-94 ,240,41,78,0.526,28,57,0.491,13,21,0.619,13,18,0.722,108,33,89,0.371,26,61,0.426,7,28,0.25,21,26,0.808,94,2012-01-02,IND,NJN
3442,42,Home,W 108-99 ,240,41,78,0.526,36,64,0.563,5,14,0.357,21,27,0.778,108,41,96,0.427,30,65,0.462,11,31,0.355,6,7,0.857,99,2012-01-03,LAL,HOU
3443,43,Home,W 108-96 ,240,38,75,0.507,31,56,0.554,7,19,0.368,25,29,0.862,108,35,84,0.417,28,72,0.389,7,12,0.583,19,25,0.76,96,2012-01-08,OKC,SAS
3444,44,Home,W 108-99 ,240,35,78,0.449,30,68,0.441,5,10,0.5,33,41,0.805,108,35,75,0.467,31,65,0.477,4,10,0.4,25,31,0.806,99,2012-01-14,MEM,NOH
3445,45,Home,W 108-79 ,240,39,82,0.476,36,74,0.486,3,8,0.375,27,31,0.871,108,31,85,0.365,27,65,0.415,4,20,0.2,13,21,0.619,79,2012-01-17,UTA,LAC
3446,46,@,W 108-104 (OT),265,43,89,0.483,36,71,0.507,7,18,0.389,15,22,0.682,108,43,98,0.439,39,84,0.464,4,14,0.286,14,19,0.737,104,2012-01-18,DEN,PHI
3447,47,@,W 108-104 ,240,39,79,0.494,29,58,0.5,10,21,0.476,20,30,0.667,108,40,95,0.421,29,69,0.42,11,26,0.423,13,17,0.765,104,2012-01-20,DEN,WAS
3448,48,Home,W 108-98 ,240,41,79,0.519,36,64,0.563,5,15,0.333,21,29,0.724,108,37,83,0.446,29,62,0.468,8,21,0.381,16,21,0.762,98,2012-01-21,UTA,MIN
3449,49,Home,L 108-120 ,240,40,85,0.471,33,66,0.5,7,19,0.368,21,30,0.7,108,43,74,0.581,37,57,0.649,6,17,0.353,28,31,0.903,120,2012-01-30,HOU,MIN
3450,50,@,W 108-105 ,240,36,82,0.439,29,66,0.439,7,16,0.438,29,32,0.906,108,38,86,0.442,28,65,0.431,10,21,0.476,19,24,0.792,105,2012-02-03,MIN,NJN
3451,51,@,W 108-87 ,240,40,72,0.556,31,57,0.544,9,15,0.6,19,23,0.826,108,32,79,0.405,29,62,0.468,3,17,0.176,20,26,0.769,87,2012-02-06,CHI,NJN
3452,52,@,L 108-111 (OT),265,34,85,0.4,21,59,0.356,13,26,0.5,27,34,0.794,108,39,80,0.488,36,71,0.507,3,9,0.333,30,41,0.732,111,2012-02-06,TOR,WAS
3453,53,@,L 108-114 ,240,43,86,0.5,39,75,0.52,4,11,0.364,18,22,0.818,108,43,93,0.462,37,81,0.457,6,12,0.5,22,25,0.88,114,2012-02-17,SAC,DET
3454,54,Home,W 108-73 ,240,39,78,0.5,33,62,0.532,6,16,0.375,24,32,0.75,108,28,75,0.373,24,58,0.414,4,17,0.235,13,22,0.591,73,2012-02-19,IND,CHA
3455,55,@,L 108-117 (OT),265,42,79,0.532,33,58,0.569,9,21,0.429,15,23,0.652,108,44,88,0.5,37,69,0.536,7,19,0.368,22,31,0.71,117,2012-02-21,NOP,IND
3456,56,@,L 108-120 ,240,40,89,0.449,27,62,0.435,13,27,0.481,15,19,0.789,108,45,81,0.556,35,58,0.603,10,23,0.435,20,23,0.87,120,2012-02-21,SAC,MIA
3457,57,@,W 108-91 ,240,45,84,0.536,32,55,0.582,13,29,0.448,5,15,0.333,108,38,81,0.469,29,57,0.509,9,24,0.375,6,9,0.667,91,2012-02-22,ORL,NJN
3458,58,@,W 108-100 ,240,44,92,0.478,32,69,0.464,12,23,0.522,8,8,1.0,108,37,79,0.468,28,59,0.475,9,20,0.45,17,23,0.739,100,2012-03-01,LAC,SAC
3459,59,Home,W 108-78 ,240,45,77,0.584,35,60,0.583,10,17,0.588,8,9,0.889,108,31,83,0.373,23,61,0.377,8,22,0.364,8,12,0.667,78,2012-03-06,MIA,NJN
3460,60,Home,L 108-120 ,240,38,78,0.487,26,48,0.542,12,30,0.4,20,32,0.625,108,43,84,0.512,29,57,0.509,14,27,0.519,20,24,0.833,120,2012-03-09,SAS,LAC
3461,61,@,W 108-89 ,240,40,83,0.482,34,66,0.515,6,17,0.353,22,29,0.759,108,31,84,0.369,25,64,0.391,6,20,0.3,21,27,0.778,89,2012-03-21,WAS,NJN
3462,62,@,L 108-111 ,240,43,91,0.473,42,76,0.553,1,15,0.067,21,27,0.778,108,43,88,0.489,36,67,0.537,7,21,0.333,18,21,0.857,111,2012-03-24,SAC,GSW
3463,63,@,W 108-83 ,240,42,82,0.512,36,65,0.554,6,17,0.353,18,26,0.692,108,27,70,0.386,23,54,0.426,4,16,0.25,25,30,0.833,83,2012-03-25,PHO,CLE
3464,64,@,W 108-91 ,240,44,88,0.5,36,72,0.5,8,16,0.5,12,16,0.75,108,35,74,0.473,22,54,0.407,13,20,0.65,8,11,0.727,91,2012-03-26,DEN,CHI
3465,65,Home,W 108-101 ,240,44,88,0.5,39,77,0.506,5,11,0.455,15,16,0.938,108,42,84,0.5,35,61,0.574,7,23,0.304,10,17,0.588,101,2012-03-27,MIL,ATL
3466,66,Home,W 108-86 ,240,43,85,0.506,31,51,0.608,12,34,0.353,10,12,0.833,108,31,69,0.449,22,43,0.512,9,26,0.346,15,26,0.577,86,2012-03-28,NYK,ORL
3467,67,@,L 108-116 ,240,39,81,0.481,28,60,0.467,11,21,0.524,19,26,0.731,108,43,85,0.506,36,62,0.581,7,23,0.304,23,28,0.821,116,2012-04-02,MIN,SAC
3468,68,Home,L 108-113 ,240,43,95,0.453,34,70,0.486,9,25,0.36,13,20,0.65,108,43,83,0.518,37,67,0.552,6,16,0.375,21,30,0.7,113,2012-04-04,LAC,LAL
3469,69,@,L 108-112 (OT),265,41,88,0.466,29,67,0.433,12,21,0.571,14,15,0.933,108,42,93,0.452,35,75,0.467,7,18,0.389,21,27,0.778,112,2012-04-15,DAL,LAL
3470,70,Home,W 108-86 ,240,41,81,0.506,27,49,0.551,14,32,0.438,12,16,0.75,108,34,87,0.391,29,72,0.403,5,15,0.333,13,16,0.813,86,2012-04-26,DET,PHI
3471,71,Home,W 108-79 ,240,40,77,0.519,30,55,0.545,10,22,0.455,18,26,0.692,108,28,79,0.354,24,66,0.364,4,13,0.308,19,23,0.826,79,2012-11-04,LAL,DET
3472,72,@,W 108-101 ,240,40,92,0.435,26,63,0.413,14,29,0.483,14,22,0.636,108,39,74,0.527,30,49,0.612,9,25,0.36,14,16,0.875,101,2012-11-05,CLE,LAC
3473,73,Home,W 108-88 ,240,35,74,0.473,26,49,0.531,9,25,0.36,29,34,0.853,108,30,84,0.357,23,54,0.426,7,30,0.233,21,25,0.84,88,2012-11-06,OKC,TOR
3474,74,@,W 108-90 ,240,44,83,0.53,38,67,0.567,6,16,0.375,14,19,0.737,108,35,91,0.385,29,76,0.382,6,15,0.4,14,21,0.667,90,2012-11-07,MEM,MIL
3475,75,@,L 108-119 ,240,44,90,0.489,35,67,0.522,9,23,0.391,11,18,0.611,108,46,85,0.541,37,65,0.569,9,20,0.45,18,28,0.643,119,2012-11-18,HOU,LAL
3476,76,Home,W 108-100 ,240,39,80,0.488,30,63,0.476,9,17,0.529,21,24,0.875,108,37,79,0.468,31,55,0.564,6,24,0.25,20,24,0.833,100,2012-11-23,BOS,OKC
3477,77,Home,W 108-104 ,240,40,80,0.5,29,59,0.492,11,21,0.524,17,20,0.85,108,37,87,0.425,29,61,0.475,8,26,0.308,22,30,0.733,104,2012-11-23,ORL,CLE
3478,78,@,L 108-111 (OT),265,40,78,0.513,27,52,0.519,13,26,0.5,15,18,0.833,108,44,90,0.489,33,65,0.508,11,25,0.44,12,19,0.632,111,2012-11-23,NOP,PHO
3479,79,@,L 108-110 ,240,35,79,0.443,21,48,0.438,14,31,0.452,24,33,0.727,108,36,69,0.522,27,50,0.54,9,19,0.474,29,37,0.784,110,2012-11-24,CLE,MIA
3480,80,Home,W 108-97 ,240,40,74,0.541,34,58,0.586,6,16,0.375,22,32,0.688,108,32,79,0.405,21,54,0.389,11,25,0.44,22,30,0.733,97,2012-11-24,SAC,UTA
3481,81,@,W 108-106 (2OT),290,34,83,0.41,22,55,0.4,12,28,0.429,28,36,0.778,108,34,93,0.366,28,66,0.424,6,27,0.222,32,39,0.821,106,2012-11-24,CHA,WAS
3482,82,Home,W 108-101 ,240,42,80,0.525,33,65,0.508,9,15,0.6,15,22,0.682,108,36,85,0.424,30,66,0.455,6,19,0.316,23,31,0.742,101,2012-11-26,DET,POR
3483,83,Home,W 108-87 ,240,43,81,0.531,31,52,0.596,12,29,0.414,10,15,0.667,108,35,78,0.449,30,60,0.5,5,18,0.278,12,21,0.571,87,2012-11-30,NYK,WAS
3484,84,Home,W 108-98 (OT),265,40,85,0.471,36,66,0.545,4,19,0.211,24,31,0.774,108,38,82,0.463,32,68,0.471,6,14,0.429,16,22,0.727,98,2012-12-04,MEM,PHO
3485,85,Home,W 108-104 ,240,42,95,0.442,34,73,0.466,8,22,0.364,16,19,0.842,108,38,79,0.481,31,62,0.5,7,17,0.412,21,25,0.84,104,2012-12-05,ATL,DEN
3486,86,@,W 108-104 ,240,43,82,0.524,38,68,0.559,5,14,0.357,17,21,0.81,108,36,70,0.514,28,56,0.5,8,14,0.571,24,31,0.774,104,2012-12-07,CHI,DET
3487,87,Home,W 108-93 ,240,38,94,0.404,32,80,0.4,6,14,0.429,26,32,0.813,108,36,81,0.444,33,68,0.485,3,13,0.231,18,32,0.563,93,2012-12-07,MIL,CHA
3488,88,@,L 108-114 ,240,36,84,0.429,25,56,0.446,11,28,0.393,25,31,0.806,108,41,84,0.488,32,67,0.478,9,17,0.529,23,28,0.821,114,2012-12-07,LAL,OKC
3489,89,Home,W 108-105 ,240,38,87,0.437,36,73,0.493,2,14,0.143,30,37,0.811,108,42,83,0.506,35,67,0.522,7,16,0.438,14,24,0.583,105,2012-12-12,MIN,DEN
3490,90,Home,W 108-96 ,240,45,81,0.556,36,62,0.581,9,19,0.474,9,11,0.818,108,37,85,0.435,30,61,0.492,7,24,0.292,15,17,0.882,96,2012-12-23,SAC,POR
3491,91,Home,W 108-93 ,240,40,84,0.476,30,67,0.448,10,17,0.588,18,19,0.947,108,34,88,0.386,30,67,0.448,4,21,0.19,21,24,0.875,93,2012-12-26,MIL,BRK
3492,92,@,W 108-101 (OT),265,40,92,0.435,37,79,0.468,3,13,0.231,25,29,0.862,108,40,80,0.5,32,54,0.593,8,26,0.308,13,19,0.684,101,2013-01-06,CHA,DET
3493,93,Home,W 108-99 ,240,42,91,0.462,33,74,0.446,9,17,0.529,15,19,0.789,108,37,90,0.411,33,70,0.471,4,20,0.2,21,26,0.808,99,2013-01-08,MIL,PHO
3494,94,Home,W 108-103 ,240,40,87,0.46,32,72,0.444,8,15,0.533,20,26,0.769,108,38,77,0.494,28,55,0.509,10,22,0.455,17,21,0.81,103,2013-01-08,MIN,ATL
3495,95,Home,W 108-105 ,240,41,94,0.436,37,82,0.451,4,12,0.333,22,36,0.611,108,44,93,0.473,36,69,0.522,8,24,0.333,9,10,0.9,105,2013-01-09,DEN,ORL
3496,96,Home,W 108-105 ,240,41,84,0.488,29,59,0.492,12,25,0.48,14,16,0.875,108,44,95,0.463,36,68,0.529,8,27,0.296,9,15,0.6,105,2013-01-09,SAS,LAL
3497,97,@,W 108-101 ,240,39,68,0.574,34,57,0.596,5,11,0.455,25,34,0.735,108,37,90,0.411,26,68,0.382,11,22,0.5,16,23,0.696,101,2013-01-11,CHI,NYK
3498,98,Home,L 108-112 ,240,41,84,0.488,34,68,0.5,7,16,0.438,19,31,0.613,108,41,80,0.513,30,57,0.526,11,23,0.478,19,28,0.679,112,2013-01-18,DEN,WAS
3499,99,Home,W 108-101 (OT),265,47,91,0.516,43,72,0.597,4,19,0.211,10,14,0.714,108,40,88,0.455,29,63,0.46,11,25,0.44,10,13,0.769,101,2013-01-18,PHI,TOR
3500,0,Home,W 108-103 ,240,46,84,0.548,40,64,0.625,6,20,0.3,10,17,0.588,108,38,88,0.432,29,61,0.475,9,27,0.333,18,21,0.857,103,2013-01-20,TOR,LAL
3501,1,@,L 108-113 ,240,43,92,0.467,29,64,0.453,14,28,0.5,8,13,0.615,108,45,86,0.523,39,71,0.549,6,15,0.4,17,22,0.773,113,2013-01-25,MIL,CLE
3502,2,Home,W 108-99 ,240,41,83,0.494,34,59,0.576,7,24,0.292,19,23,0.826,108,41,81,0.506,35,69,0.507,6,12,0.5,11,14,0.786,99,2013-01-26,SAS,PHO
3503,3,@,W 108-95 ,240,45,84,0.536,34,68,0.5,11,16,0.688,7,10,0.7,108,36,84,0.429,32,66,0.485,4,18,0.222,19,25,0.76,95,2013-01-29,GSW,CLE
3504,4,@,L 108-114 ,240,39,80,0.488,30,55,0.545,9,25,0.36,21,25,0.84,108,40,82,0.488,30,59,0.508,10,23,0.435,24,28,0.857,114,2013-02-06,HOU,MIA
3505,5,@,L 108-119 ,240,45,86,0.523,37,65,0.569,8,21,0.381,10,13,0.769,108,39,80,0.488,32,66,0.485,7,14,0.5,34,41,0.829,119,2013-02-08,ORL,CLE
3506,6,Home,W 108-101 ,240,41,75,0.547,35,62,0.565,6,13,0.462,20,24,0.833,108,40,86,0.465,36,70,0.514,4,16,0.25,17,24,0.708,101,2013-02-12,MEM,SAC
3507,7,@,L 108-109 ,240,44,85,0.518,38,69,0.551,6,16,0.375,14,20,0.7,108,39,83,0.47,29,62,0.468,10,21,0.476,21,23,0.913,109,2013-02-12,DEN,TOR
3508,8,@,L 108-119 ,240,42,79,0.532,30,62,0.484,12,17,0.706,12,22,0.545,108,41,75,0.547,25,48,0.521,16,27,0.593,21,30,0.7,119,2013-02-13,DEN,BRK
3509,9,@,W 108-76 ,240,41,92,0.446,31,58,0.534,10,34,0.294,16,23,0.696,108,34,82,0.415,31,68,0.456,3,14,0.214,5,9,0.556,76,2013-02-13,ATL,ORL
3510,10,@,W 108-102 ,240,35,75,0.467,25,45,0.556,10,30,0.333,28,35,0.8,108,34,90,0.378,25,65,0.385,9,25,0.36,25,29,0.862,102,2013-02-19,SAS,SAC
3511,11,Home,W 108-98 ,240,42,87,0.483,32,67,0.478,10,20,0.5,14,17,0.824,108,40,84,0.476,31,67,0.463,9,17,0.529,9,14,0.643,98,2013-02-20,GSW,PHO
3512,12,@,L 108-122 ,240,38,88,0.432,26,66,0.394,12,22,0.545,20,25,0.8,108,49,92,0.533,37,65,0.569,12,27,0.444,12,19,0.632,122,2013-02-22,SAC,ATL
3513,13,@,L 108-119 ,240,43,78,0.551,35,59,0.593,8,19,0.421,14,31,0.452,108,49,88,0.557,44,70,0.629,5,18,0.278,16,27,0.593,119,2013-02-25,LAL,DEN
3514,14,Home,W 108-97 ,240,41,84,0.488,35,63,0.556,6,21,0.286,20,27,0.741,108,33,76,0.434,21,55,0.382,12,21,0.571,19,24,0.792,97,2013-02-26,IND,GSW
3515,15,@,W 108-104 ,240,38,80,0.475,31,59,0.525,7,21,0.333,25,34,0.735,108,38,82,0.463,29,58,0.5,9,24,0.375,19,22,0.864,104,2013-03-03,OKC,LAC
3516,16,@,W 108-82 ,240,44,83,0.53,33,59,0.559,11,24,0.458,9,15,0.6,108,29,73,0.397,27,58,0.466,2,15,0.133,22,26,0.846,82,2013-03-03,MEM,ORL
3517,17,@,L 108-109 (OT),265,40,99,0.404,36,86,0.419,4,13,0.308,24,31,0.774,108,45,95,0.474,35,71,0.493,10,24,0.417,9,13,0.692,109,2013-03-04,UTA,MIL
3518,18,@,L 108-112 ,240,35,78,0.449,23,46,0.5,12,32,0.375,26,33,0.788,108,45,83,0.542,34,57,0.596,11,26,0.423,11,14,0.786,112,2013-03-06,HOU,DAL
3519,19,@,W 108-102 ,240,38,78,0.487,27,50,0.54,11,28,0.393,21,29,0.724,108,38,88,0.432,29,64,0.453,9,24,0.375,17,20,0.85,102,2013-03-06,LAL,NOH
3520,20,@,W 108-93 ,240,44,86,0.512,41,74,0.554,3,12,0.25,17,25,0.68,108,35,84,0.417,29,64,0.453,6,20,0.3,17,22,0.773,93,2013-03-11,DEN,PHO
3521,21,Home,W 108-98 ,240,40,80,0.5,35,64,0.547,5,16,0.313,23,31,0.742,108,40,78,0.513,35,62,0.565,5,16,0.313,13,15,0.867,98,2013-03-12,BRK,NOH
3522,22,Home,L 108-115 ,240,43,89,0.483,35,68,0.515,8,21,0.381,14,17,0.824,108,41,82,0.5,30,53,0.566,11,29,0.379,22,27,0.815,115,2013-03-12,MIL,DAL
3523,23,Home,W 108-100 ,240,36,74,0.486,25,43,0.581,11,31,0.355,25,31,0.806,108,39,81,0.481,33,57,0.579,6,24,0.25,16,20,0.8,100,2013-03-15,HOU,MIN
3524,24,@,W 108-78 ,240,44,96,0.458,31,70,0.443,13,26,0.5,7,9,0.778,108,28,86,0.326,19,51,0.373,9,35,0.257,13,16,0.813,78,2013-03-17,GSW,HOU
3525,25,@,W 108-91 ,240,39,67,0.582,29,45,0.644,10,22,0.455,20,29,0.69,108,39,94,0.415,37,74,0.5,2,20,0.1,11,12,0.917,91,2013-03-17,MIA,TOR
3526,26,@,L 108-113 ,240,42,82,0.512,35,65,0.538,7,17,0.412,17,21,0.81,108,38,70,0.543,29,52,0.558,9,18,0.5,28,33,0.848,113,2013-03-24,UTA,DAL
3527,27,@,W 108-94 ,240,37,78,0.474,22,50,0.44,15,28,0.536,19,29,0.655,108,37,86,0.43,28,62,0.452,9,24,0.375,11,18,0.611,94,2013-03-25,MIA,ORL
3528,28,@,L 108-114 ,240,44,84,0.524,37,65,0.569,7,19,0.368,13,18,0.722,108,44,85,0.518,38,65,0.585,6,20,0.3,20,28,0.714,114,2013-03-27,ORL,CHA
3529,29,Home,W 108-101 ,240,38,74,0.514,25,43,0.581,13,31,0.419,19,22,0.864,108,33,70,0.471,27,49,0.551,6,21,0.286,29,35,0.829,101,2013-03-27,NYK,MEM
3530,30,@,W 108-89 ,240,42,69,0.609,28,42,0.667,14,27,0.519,10,16,0.625,108,34,74,0.459,29,56,0.518,5,18,0.278,16,18,0.889,89,2013-03-29,MIA,NOH
3531,31,Home,W 108-89 ,240,35,72,0.486,21,45,0.467,14,27,0.519,24,31,0.774,108,32,74,0.432,25,49,0.51,7,25,0.28,18,23,0.783,89,2013-03-31,NYK,BOS
3532,32,@,W 108-98 ,240,43,77,0.558,36,62,0.581,7,15,0.467,15,21,0.714,108,41,81,0.506,33,60,0.55,8,21,0.381,8,10,0.8,98,2013-04-01,DET,TOR
3533,33,Home,L 108-117 ,240,39,87,0.448,33,61,0.541,6,26,0.231,24,31,0.774,108,46,90,0.511,40,70,0.571,6,20,0.3,19,19,1.0,117,2013-04-05,SAC,DAL
3534,34,Home,W 108-105 (OT),265,43,95,0.453,32,72,0.444,11,23,0.478,11,19,0.579,108,41,93,0.441,33,69,0.478,8,24,0.333,15,21,0.714,105,2013-04-12,DAL,DEN
3535,35,Home,W 108-101 ,240,42,77,0.545,36,60,0.6,6,17,0.353,18,21,0.857,108,39,89,0.438,28,69,0.406,11,20,0.55,12,15,0.8,101,2013-04-12,SAS,SAC
3536,36,Home,L 108-112 ,240,40,89,0.449,31,63,0.492,9,26,0.346,19,25,0.76,108,44,88,0.5,32,64,0.5,12,24,0.5,12,18,0.667,112,2013-04-17,SAC,LAC
3537,37,@,W 108-95 ,240,42,91,0.462,30,62,0.484,12,29,0.414,12,16,0.75,108,33,79,0.418,26,61,0.426,7,18,0.389,22,22,1.0,95,2013-04-17,MIN,SAS
3538,38,@,L 108-111 (OT),265,42,89,0.472,35,68,0.515,7,21,0.333,17,24,0.708,108,40,77,0.519,34,59,0.576,6,18,0.333,25,30,0.833,111,2013-11-01,DET,MEM
3539,39,@,L 108-116 ,240,44,90,0.489,34,68,0.5,10,22,0.455,10,15,0.667,108,41,89,0.461,33,69,0.478,8,20,0.4,26,30,0.867,116,2013-11-08,DAL,MIN
3540,40,@,L 108-112 (OT),265,41,88,0.466,35,64,0.547,6,24,0.25,20,29,0.69,108,41,88,0.466,31,64,0.484,10,24,0.417,20,26,0.769,112,2013-11-08,BRK,WAS
3541,41,Home,W 108-90 ,240,42,79,0.532,37,66,0.561,5,13,0.385,19,25,0.76,108,33,78,0.423,23,48,0.479,10,30,0.333,14,26,0.538,90,2013-11-09,MEM,GSW
3542,42,@,W 108-100 ,240,43,84,0.512,33,57,0.579,10,27,0.37,12,18,0.667,108,37,70,0.529,33,55,0.6,4,15,0.267,22,28,0.786,100,2013-11-16,DAL,ORL
3543,43,@,W 108-98 ,240,41,76,0.539,33,58,0.569,8,18,0.444,18,21,0.857,108,31,85,0.365,28,72,0.389,3,13,0.231,33,35,0.943,98,2013-11-18,POR,BRK
3544,44,@,W 108-98 ,240,36,86,0.419,22,57,0.386,14,29,0.483,22,28,0.786,108,34,76,0.447,27,56,0.482,7,20,0.35,23,31,0.742,98,2013-11-20,TOR,PHI
3545,45,Home,W 108-101 ,240,38,78,0.487,26,54,0.481,12,24,0.5,20,30,0.667,108,36,81,0.444,29,64,0.453,7,17,0.412,22,26,0.846,101,2013-11-30,WAS,ATL
3546,46,Home,L 108-114 ,240,40,87,0.46,30,59,0.508,10,28,0.357,18,23,0.783,108,38,87,0.437,29,64,0.453,9,23,0.391,29,34,0.853,114,2013-12-01,LAL,POR
3547,47,Home,W 108-100 ,240,38,77,0.494,27,53,0.509,11,24,0.458,21,27,0.778,108,37,78,0.474,29,60,0.483,8,18,0.444,18,21,0.857,100,2013-12-03,BOS,MIL
3548,48,Home,W 108-89 ,240,47,91,0.516,39,68,0.574,8,23,0.348,6,11,0.545,108,38,94,0.404,33,74,0.446,5,20,0.25,8,17,0.471,89,2013-12-06,ATL,CLE
3549,49,@,W 108-82 ,240,44,88,0.5,36,70,0.514,8,18,0.444,12,14,0.857,108,31,85,0.365,29,75,0.387,2,10,0.2,18,22,0.818,82,2013-12-07,GSW,MEM
3550,50,@,W 108-106 ,240,46,87,0.529,38,71,0.535,8,16,0.5,8,11,0.727,108,39,87,0.448,30,57,0.526,9,30,0.3,19,24,0.792,106,2013-12-07,DAL,POR
3551,51,Home,L 108-114 ,240,39,80,0.488,34,61,0.557,5,19,0.263,25,32,0.781,108,44,85,0.518,37,62,0.597,7,23,0.304,19,21,0.905,114,2013-12-10,LAL,PHO
3552,52,Home,W 108-100 ,240,39,82,0.476,29,57,0.509,10,25,0.4,20,24,0.833,108,37,84,0.44,28,61,0.459,9,23,0.391,17,21,0.81,100,2013-12-13,TOR,PHI
3553,53,Home,W 108-95 ,240,33,78,0.423,22,49,0.449,11,29,0.379,31,36,0.861,108,37,93,0.398,30,73,0.411,7,20,0.35,14,20,0.7,95,2013-12-18,LAC,NOP
3554,54,@,W 108-101 ,240,41,87,0.471,34,69,0.493,7,18,0.389,19,24,0.792,108,38,82,0.463,31,67,0.463,7,15,0.467,18,24,0.75,101,2013-12-18,SAS,PHO
3555,55,Home,L 108-109 (OT),265,46,91,0.505,36,70,0.514,10,21,0.476,6,10,0.6,108,42,91,0.462,31,70,0.443,11,21,0.524,14,18,0.778,109,2013-12-20,DAL,TOR
3556,56,@,L 108-123 ,240,44,91,0.484,41,74,0.554,3,17,0.176,17,23,0.739,108,44,86,0.512,29,56,0.518,15,30,0.5,20,22,0.909,123,2013-12-21,DAL,PHO
3557,57,Home,W 108-103 (OT),265,41,83,0.494,36,63,0.571,5,20,0.25,21,25,0.84,108,38,86,0.442,27,54,0.5,11,32,0.344,16,21,0.762,103,2013-12-27,SAC,MIA
3558,58,@,W 108-107 ,240,45,88,0.511,37,74,0.5,8,14,0.571,10,11,0.909,108,39,77,0.506,28,51,0.549,11,26,0.423,18,21,0.857,107,2013-12-28,MIA,POR
3559,59,@,W 108-104 (OT),265,42,95,0.442,32,62,0.516,10,33,0.303,14,19,0.737,108,38,92,0.413,28,76,0.368,10,16,0.625,18,21,0.857,104,2013-12-29,GSW,CLE
3560,60,@,L 108-110 ,240,39,88,0.443,27,56,0.482,12,32,0.375,18,24,0.75,108,48,89,0.539,46,78,0.59,2,11,0.182,12,15,0.8,110,2013-12-30,POR,NOP
3561,61,@,L 108-111 ,240,37,76,0.487,32,64,0.5,5,12,0.417,29,38,0.763,108,43,80,0.538,34,58,0.586,9,22,0.409,16,21,0.762,111,2014-01-03,MEM,DEN
3562,62,Home,L 108-110 (OT),265,46,99,0.465,40,82,0.488,6,17,0.353,10,15,0.667,108,43,83,0.518,36,59,0.61,7,24,0.292,17,25,0.68,110,2014-01-07,MEM,SAS
3563,63,@,L 108-110 ,240,37,94,0.394,24,59,0.407,13,35,0.371,21,25,0.84,108,44,94,0.468,41,77,0.532,3,17,0.176,19,27,0.704,110,2014-01-11,PHO,DET
3564,64,Home,W 108-101 ,240,43,83,0.518,37,68,0.544,6,15,0.4,16,20,0.8,108,38,80,0.475,29,53,0.547,9,27,0.333,16,24,0.667,101,2014-01-12,MEM,ATL
3565,65,Home,W 108-98 ,240,38,75,0.507,32,61,0.525,6,14,0.429,26,33,0.788,108,39,81,0.481,33,64,0.516,6,17,0.353,14,18,0.778,98,2014-01-14,CHA,NYK
3566,66,Home,L 108-111 ,240,39,88,0.443,31,68,0.456,8,20,0.4,22,29,0.759,108,45,82,0.549,40,70,0.571,5,12,0.417,16,19,0.842,111,2014-01-15,MIN,SAC
3567,67,Home,W 108-96 ,240,42,88,0.477,31,61,0.508,11,27,0.407,13,17,0.765,108,39,89,0.438,33,66,0.5,6,23,0.261,12,18,0.667,96,2014-01-15,POR,CLE
3568,68,Home,W 108-93 ,240,39,86,0.453,30,65,0.462,9,21,0.429,21,30,0.7,108,33,77,0.429,28,60,0.467,5,17,0.294,22,28,0.786,93,2014-01-19,OKC,SAC
3569,69,Home,W 108-102 ,240,32,72,0.444,22,47,0.468,10,25,0.4,34,39,0.872,108,37,71,0.521,29,51,0.569,8,20,0.4,20,28,0.714,102,2014-02-03,BRK,PHI
3570,70,Home,L 108-119 ,240,38,101,0.376,33,68,0.485,5,33,0.152,27,37,0.73,108,42,79,0.532,24,42,0.571,18,37,0.486,17,22,0.773,119,2014-02-05,CLE,LAL
3571,71,@,L 108-122 ,240,42,90,0.467,34,60,0.567,8,30,0.267,16,21,0.762,108,39,71,0.549,28,55,0.509,11,16,0.688,33,42,0.786,122,2014-02-05,PHO,HOU
3572,72,Home,L 108-114 ,240,42,94,0.447,35,73,0.479,7,21,0.333,17,20,0.85,108,41,84,0.488,33,65,0.508,8,19,0.421,24,33,0.727,114,2014-02-05,PHI,BOS
3573,73,Home,W 108-101 ,240,36,76,0.474,26,52,0.5,10,24,0.417,26,33,0.788,108,39,77,0.506,33,65,0.508,6,12,0.5,17,26,0.654,101,2014-02-10,TOR,NOP
3574,74,@,W 108-96 ,240,39,75,0.52,32,58,0.552,7,17,0.412,23,37,0.622,108,39,98,0.398,34,82,0.415,5,16,0.313,13,23,0.565,96,2014-02-18,CHA,DET
3575,75,Home,W 108-98 ,240,39,79,0.494,30,56,0.536,9,23,0.391,21,26,0.808,108,37,77,0.481,25,51,0.49,12,26,0.462,12,19,0.632,98,2014-02-18,IND,ATL
3576,76,Home,L 108-134 ,240,41,84,0.488,27,57,0.474,14,27,0.519,12,15,0.8,108,52,104,0.5,34,69,0.493,18,35,0.514,12,25,0.48,134,2014-02-19,LAL,HOU
3577,77,@,W 108-102 ,240,36,76,0.474,24,51,0.471,12,25,0.48,24,32,0.75,108,39,76,0.513,32,59,0.542,7,17,0.412,17,26,0.654,102,2014-02-23,BRK,LAL
3578,78,Home,W 108-97 ,240,40,83,0.482,27,55,0.491,13,28,0.464,15,16,0.938,108,37,94,0.394,28,66,0.424,9,28,0.321,14,20,0.7,97,2014-02-23,POR,MIN
3579,79,Home,L 108-110 ,240,40,76,0.526,26,43,0.605,14,33,0.424,14,16,0.875,108,41,86,0.477,26,50,0.52,15,36,0.417,13,16,0.813,110,2014-02-24,NYK,DAL
3580,80,Home,W 108-89 ,240,41,79,0.519,31,57,0.544,10,22,0.455,16,17,0.941,108,36,71,0.507,27,51,0.529,9,20,0.45,8,19,0.421,89,2014-02-26,DAL,NOP
3581,81,Home,W 108-103 ,240,45,92,0.489,41,79,0.519,4,13,0.308,14,21,0.667,108,38,77,0.494,23,49,0.469,15,28,0.536,12,18,0.667,103,2014-02-26,MEM,LAL
3582,82,Home,W 108-82 ,240,45,74,0.608,39,59,0.661,6,15,0.4,12,18,0.667,108,31,83,0.373,27,60,0.45,4,23,0.174,16,22,0.727,82,2014-02-27,MIA,NYK
3583,83,Home,W 108-76 ,240,38,81,0.469,29,56,0.518,9,25,0.36,23,32,0.719,108,28,85,0.329,25,63,0.397,3,22,0.136,17,19,0.895,76,2014-03-01,LAC,NOP
3584,84,@,W 108-97 ,240,37,81,0.457,32,60,0.533,5,21,0.238,29,38,0.763,108,37,82,0.451,30,60,0.5,7,22,0.318,16,21,0.762,97,2014-03-01,MIN,SAC
3585,85,@,W 108-88 ,240,46,98,0.469,41,70,0.586,5,28,0.179,11,12,0.917,108,30,76,0.395,23,50,0.46,7,26,0.269,21,26,0.808,88,2014-03-05,GSW,BOS
3586,86,Home,W 108-81 ,240,42,85,0.494,30,54,0.556,12,31,0.387,12,18,0.667,108,30,73,0.411,24,46,0.522,6,27,0.222,15,20,0.75,81,2014-03-07,NYK,UTA
3587,87,@,L 108-109 ,240,38,76,0.5,26,48,0.542,12,28,0.429,20,26,0.769,108,42,79,0.532,35,57,0.614,7,22,0.318,18,24,0.75,109,2014-03-08,ATL,LAC
3588,88,Home,W 108-85 ,240,41,80,0.513,29,55,0.527,12,25,0.48,14,17,0.824,108,30,82,0.366,25,64,0.391,5,18,0.278,20,31,0.645,85,2014-03-11,GSW,DAL
3589,89,@,W 108-101 ,240,42,79,0.532,29,58,0.5,13,21,0.619,11,12,0.917,108,40,85,0.471,35,59,0.593,5,26,0.192,16,21,0.762,101,2014-03-12,DAL,UTA
3590,90,Home,W 108-95 ,240,41,70,0.586,32,49,0.653,9,21,0.429,17,27,0.63,108,37,80,0.463,31,58,0.534,6,22,0.273,15,28,0.536,95,2014-03-17,BRK,PHO
3591,91,Home,W 108-103 ,240,43,88,0.489,35,68,0.515,8,20,0.4,14,20,0.7,108,38,83,0.458,31,64,0.484,7,19,0.368,20,25,0.8,103,2014-03-26,SAS,DEN
3592,92,Home,W 108-105 ,240,39,70,0.557,33,60,0.55,6,10,0.6,24,34,0.706,108,42,85,0.494,35,64,0.547,7,21,0.333,14,18,0.778,105,2014-03-27,MIL,LAL
3593,93,Home,W 108-97 ,240,39,71,0.549,25,42,0.595,14,29,0.483,16,21,0.762,108,37,87,0.425,27,63,0.429,10,24,0.417,13,16,0.813,97,2014-03-28,BRK,CLE
3594,94,Home,L 108-112 ,240,36,78,0.462,28,50,0.56,8,28,0.286,28,33,0.848,108,37,79,0.468,26,53,0.491,11,26,0.423,27,30,0.9,112,2014-04-02,PHO,LAC
3595,95,@,W 108-100 ,240,35,73,0.479,29,49,0.592,6,24,0.25,32,36,0.889,108,30,76,0.395,15,43,0.349,15,33,0.455,25,31,0.806,100,2014-04-11,NYK,TOR
3596,96,Home,W 108-95 ,240,39,77,0.506,34,64,0.531,5,13,0.385,25,32,0.781,108,36,72,0.5,29,57,0.509,7,15,0.467,16,19,0.842,95,2014-04-14,CHI,ORL
3597,97,@,L 108-113 ,240,40,86,0.465,31,62,0.5,9,24,0.375,19,26,0.731,108,43,79,0.544,40,67,0.597,3,12,0.25,24,38,0.632,113,2014-04-14,BOS,PHI
3598,98,@,W 108-90 ,240,31,73,0.425,19,44,0.432,12,29,0.414,34,50,0.68,108,28,79,0.354,25,69,0.362,3,10,0.3,31,39,0.795,90,2014-10-28,HOU,LAL
3599,99,Home,W 108-106 (OT),265,41,101,0.406,35,80,0.438,6,21,0.286,20,29,0.69,108,39,80,0.488,32,66,0.485,7,14,0.5,21,24,0.875,106,2014-10-29,CHA,MIL
3600,0,Home,L 108-114 (OT),265,41,90,0.456,28,59,0.475,13,31,0.419,13,17,0.765,108,41,104,0.394,38,89,0.427,3,15,0.2,29,33,0.879,114,2014-10-31,CHI,CLE
3601,1,@,W 108-95 ,240,33,83,0.398,29,62,0.468,4,21,0.19,38,48,0.792,108,38,81,0.469,31,61,0.508,7,20,0.35,12,24,0.5,95,2014-11-01,TOR,ORL
3602,2,Home,W 108-97 ,240,40,73,0.548,36,60,0.6,4,13,0.308,24,33,0.727,108,34,80,0.425,25,58,0.431,9,22,0.409,20,24,0.833,97,2014-11-01,WAS,MIL
3603,3,@,W 108-91 ,240,35,68,0.515,18,31,0.581,17,37,0.459,21,27,0.778,108,31,74,0.419,19,46,0.413,12,28,0.429,17,27,0.63,91,2014-11-04,HOU,MIA
3604,4,Home,W 108-87 ,240,40,77,0.519,28,47,0.596,12,30,0.4,16,19,0.842,108,33,90,0.367,28,67,0.418,5,23,0.217,16,16,1.0,87,2014-11-06,POR,DAL
3605,5,@,W 108-87 ,240,43,87,0.494,35,64,0.547,8,23,0.348,14,25,0.56,108,34,84,0.405,26,62,0.419,8,22,0.364,11,22,0.5,87,2014-11-14,DEN,IND
3606,6,@,L 108-111 ,240,45,92,0.489,38,72,0.528,7,20,0.35,11,13,0.846,108,39,73,0.534,33,52,0.635,6,21,0.286,27,38,0.711,111,2014-12-02,MIL,CLE
3607,7,@,W 108-101 (OT),265,40,87,0.46,33,64,0.516,7,23,0.304,21,30,0.7,108,34,87,0.391,28,64,0.438,6,23,0.261,27,35,0.771,101,2014-12-06,PHI,DET
3608,8,@,W 108-92 ,240,40,77,0.519,31,56,0.554,9,21,0.429,19,27,0.704,108,37,84,0.44,28,57,0.491,9,27,0.333,9,17,0.529,92,2014-12-08,ATL,IND
3609,9,Home,W 108-96 ,240,39,88,0.443,29,54,0.537,10,34,0.294,20,34,0.588,108,36,96,0.375,29,68,0.426,7,28,0.25,17,26,0.654,96,2014-12-13,HOU,DEN
3610,10,Home,W 108-95 ,240,41,89,0.461,34,71,0.479,7,18,0.389,19,22,0.864,108,38,78,0.487,34,67,0.507,4,11,0.364,15,22,0.682,95,2014-12-15,POR,SAS
3611,11,@,W 108-107 ,240,37,75,0.493,24,52,0.462,13,23,0.565,21,27,0.778,108,38,67,0.567,32,53,0.604,6,14,0.429,25,33,0.758,107,2014-12-18,MIL,SAC
3612,12,Home,W 108-101 ,240,38,79,0.481,31,56,0.554,7,23,0.304,25,36,0.694,108,33,87,0.379,23,61,0.377,10,26,0.385,25,30,0.833,101,2014-12-21,SAC,LAL
3613,13,@,L 108-118 ,240,40,82,0.488,35,68,0.515,5,14,0.357,23,26,0.885,108,42,86,0.488,28,53,0.528,14,33,0.424,20,27,0.741,118,2014-12-21,NYK,TOR
3614,14,@,L 108-128 ,240,43,90,0.478,35,73,0.479,8,17,0.471,14,21,0.667,108,49,91,0.538,40,66,0.606,9,25,0.36,21,24,0.875,128,2014-12-22,SAC,GSW
3615,15,@,W 108-101 ,240,36,82,0.439,28,61,0.459,8,21,0.381,28,36,0.778,108,39,82,0.476,31,61,0.508,8,21,0.381,15,20,0.75,101,2014-12-23,CHA,MIL
3616,16,@,W 108-95 ,240,43,97,0.443,33,76,0.434,10,21,0.476,12,14,0.857,108,38,87,0.437,32,65,0.492,6,22,0.273,13,18,0.722,95,2015-01-07,DET,DAL
3617,17,Home,L 108-118 ,240,42,86,0.488,36,67,0.537,6,19,0.316,18,24,0.75,108,47,85,0.553,42,68,0.618,5,17,0.294,19,28,0.679,118,2015-01-09,SAC,DEN
3618,18,@,W 108-93 ,240,41,84,0.488,32,60,0.533,9,24,0.375,17,20,0.85,108,32,81,0.395,29,66,0.439,3,15,0.2,26,26,1.0,93,2015-01-10,SAS,MIN
3619,19,Home,W 108-100 ,240,37,88,0.42,29,64,0.453,8,24,0.333,26,31,0.839,108,31,75,0.413,25,60,0.417,6,15,0.4,32,37,0.865,100,2015-01-12,BOS,NOP
3620,20,@,W 108-104 (OT),265,43,100,0.43,37,76,0.487,6,24,0.25,16,23,0.696,108,38,86,0.442,37,68,0.544,1,18,0.056,27,34,0.794,104,2015-01-13,DAL,SAC
3621,21,Home,L 108-117 ,240,41,89,0.461,36,71,0.507,5,18,0.278,21,26,0.808,108,44,92,0.478,35,64,0.547,9,28,0.321,20,31,0.645,117,2015-01-17,SAC,LAC
3622,22,Home,W 108-94 ,240,41,90,0.456,33,72,0.458,8,18,0.444,18,25,0.72,108,30,80,0.375,22,64,0.344,8,16,0.5,26,32,0.813,94,2015-01-19,CLE,CHI
3623,23,Home,W 108-73 ,240,42,79,0.532,29,50,0.58,13,29,0.448,11,14,0.786,108,29,75,0.387,24,60,0.4,5,15,0.333,10,16,0.625,73,2015-01-24,UTA,BRK
3624,24,Home,W 108-98 ,240,36,82,0.439,20,46,0.435,16,36,0.444,20,29,0.69,108,37,94,0.394,27,64,0.422,10,30,0.333,14,18,0.778,98,2015-01-25,CLE,OKC
3625,25,Home,W 108-103 ,240,36,86,0.419,23,61,0.377,13,25,0.52,23,26,0.885,108,42,92,0.457,35,64,0.547,7,28,0.25,12,17,0.706,103,2015-01-30,NOP,LAC
3626,26,@,W 108-93 ,240,42,74,0.568,31,53,0.585,11,21,0.524,13,22,0.591,108,33,78,0.423,25,54,0.463,8,24,0.333,19,24,0.792,93,2015-01-31,DAL,ORL
3627,27,Home,W 108-91 ,240,42,88,0.477,33,68,0.485,9,20,0.45,15,18,0.833,108,35,74,0.473,29,60,0.483,6,14,0.429,15,23,0.652,91,2015-02-03,DET,MIA
3628,28,@,W 108-97 ,240,42,77,0.545,36,53,0.679,6,24,0.25,18,23,0.783,108,41,83,0.494,34,63,0.54,7,20,0.35,8,11,0.727,97,2015-02-03,BOS,NYK
3629,29,Home,W 108-87 ,240,40,90,0.444,32,59,0.542,8,31,0.258,20,23,0.87,108,34,88,0.386,28,65,0.431,6,23,0.261,13,17,0.765,87,2015-02-05,POR,PHO
3630,30,@,L 108-131 ,240,42,90,0.467,30,58,0.517,12,32,0.375,12,17,0.706,108,46,88,0.523,38,68,0.559,8,20,0.4,31,38,0.816,131,2015-02-08,LAC,OKC
3631,31,@,L 108-119 ,240,40,84,0.476,27,53,0.509,13,31,0.419,15,28,0.536,108,46,83,0.554,35,62,0.565,11,21,0.524,16,22,0.727,119,2015-02-23,PHI,MIA
3632,32,@,W 108-101 ,240,40,97,0.412,29,65,0.446,11,32,0.344,17,23,0.739,108,40,90,0.444,31,65,0.477,9,25,0.36,12,18,0.667,101,2015-03-01,OKC,LAL
3633,33,@,L 108-110 ,240,42,90,0.467,31,60,0.517,11,30,0.367,13,18,0.722,108,44,89,0.494,34,68,0.5,10,21,0.476,12,16,0.75,110,2015-03-02,GSW,BRK
3634,34,Home,W 108-105 ,240,40,87,0.46,33,62,0.532,7,25,0.28,21,26,0.808,108,41,88,0.466,33,68,0.485,8,20,0.4,15,19,0.789,105,2015-03-05,CHI,OKC
3635,35,@,W 108-100 (OT),265,39,91,0.429,36,65,0.554,3,26,0.115,27,35,0.771,108,34,97,0.351,26,75,0.347,8,22,0.364,24,29,0.828,100,2015-03-06,PHO,BRK
3636,36,@,W 108-101 ,240,41,79,0.519,35,62,0.565,6,17,0.353,20,23,0.87,108,39,89,0.438,36,75,0.48,3,14,0.214,20,25,0.8,101,2015-03-08,CHA,DET
3637,37,Home,W 108-104 ,240,42,82,0.512,36,61,0.59,6,21,0.286,18,25,0.72,108,42,98,0.429,31,71,0.437,11,27,0.407,9,9,1.0,104,2015-03-08,OKC,TOR
3638,38,Home,L 108-120 ,240,33,76,0.434,21,51,0.412,12,25,0.48,30,36,0.833,108,35,76,0.461,20,46,0.435,15,30,0.5,35,47,0.745,120,2015-03-11,OKC,LAC
3639,39,Home,L 108-123 ,240,42,88,0.477,33,69,0.478,9,19,0.474,15,27,0.556,108,45,76,0.592,27,41,0.659,18,35,0.514,15,19,0.789,123,2015-03-15,ORL,CLE
3640,40,Home,W 108-89 ,240,44,88,0.5,36,68,0.529,8,20,0.4,12,15,0.8,108,34,84,0.405,26,60,0.433,8,24,0.333,13,24,0.542,89,2015-03-16,BOS,PHI
3641,41,Home,W 108-105 ,240,40,84,0.476,33,57,0.579,7,27,0.259,21,23,0.913,108,39,85,0.459,31,70,0.443,8,15,0.533,19,21,0.905,105,2015-03-16,GSW,LAL
3642,42,Home,W 108-104 ,240,46,87,0.529,39,77,0.506,7,10,0.7,9,14,0.643,108,41,81,0.506,31,55,0.564,10,26,0.385,12,21,0.571,104,2015-03-18,MIA,POR
3643,43,@,L 108-118 ,240,42,93,0.452,29,57,0.509,13,36,0.361,11,19,0.579,108,37,83,0.446,25,53,0.472,12,30,0.4,32,40,0.8,118,2015-03-19,DEN,HOU
3644,44,Home,W 108-92 ,240,42,79,0.532,33,51,0.647,9,28,0.321,15,17,0.882,108,30,79,0.38,20,54,0.37,10,25,0.4,22,26,0.846,92,2015-03-20,CHI,TOR
3645,45,Home,W 108-91 ,240,43,81,0.531,36,65,0.554,7,16,0.438,15,19,0.789,108,37,79,0.468,30,52,0.577,7,27,0.259,10,19,0.526,91,2015-03-20,MIA,DEN
3646,46,@,W 108-90 ,240,42,84,0.5,29,53,0.547,13,31,0.419,11,16,0.688,108,38,70,0.543,35,58,0.603,3,12,0.25,11,14,0.786,90,2015-03-22,CLE,MIL
3647,47,Home,W 108-104 ,240,40,93,0.43,28,64,0.438,12,29,0.414,16,24,0.667,108,35,75,0.467,28,52,0.538,7,23,0.304,27,29,0.931,104,2015-03-24,DET,TOR
3648,48,Home,L 108-122 ,240,39,92,0.424,24,58,0.414,15,34,0.441,15,19,0.789,108,50,83,0.602,38,57,0.667,12,26,0.462,10,11,0.909,122,2015-03-24,POR,GSW
3649,49,@,W 108-99 ,240,40,81,0.494,32,60,0.533,8,21,0.381,20,23,0.87,108,38,87,0.437,32,62,0.516,6,25,0.24,17,26,0.654,99,2015-03-25,SAC,PHO
3650,50,@,W 108-95 ,240,42,82,0.512,30,57,0.526,12,25,0.48,12,14,0.857,108,33,87,0.379,31,72,0.431,2,15,0.133,27,32,0.844,95,2015-03-28,GSW,MIL
3651,51,@,W 108-101 ,240,34,77,0.442,23,46,0.5,11,31,0.355,29,40,0.725,108,37,84,0.44,29,58,0.5,8,26,0.308,19,27,0.704,101,2015-04-02,HOU,DAL
3652,52,Home,W 108-99 ,240,39,85,0.459,30,64,0.469,9,21,0.429,21,27,0.778,108,36,87,0.414,27,58,0.466,9,29,0.31,18,24,0.75,99,2015-04-12,WAS,ATL
3653,53,Home,L 108-112 ,240,39,88,0.443,28,56,0.5,11,32,0.344,19,23,0.826,108,43,77,0.558,30,52,0.577,13,25,0.52,13,19,0.684,112,2015-04-13,ATL,NYK
3654,54,@,L 108-113 (OT),265,42,97,0.433,34,75,0.453,8,22,0.364,16,21,0.762,108,43,91,0.473,27,61,0.443,16,30,0.533,11,17,0.647,113,2015-04-15,WAS,CLE
3655,55,Home,W 108-103 ,240,43,83,0.518,38,73,0.521,5,10,0.5,17,25,0.68,108,45,79,0.57,42,69,0.609,3,10,0.3,10,13,0.769,103,2015-04-15,NOP,SAS
3656,56,@,L 108-112 ,240,43,88,0.489,35,66,0.53,8,22,0.364,14,22,0.636,108,39,85,0.459,29,59,0.492,10,26,0.385,24,31,0.774,112,2015-11-04,LAC,GSW
3657,57,@,W 108-92 ,240,41,77,0.532,30,52,0.577,11,25,0.44,15,32,0.469,108,33,88,0.375,28,64,0.438,5,24,0.208,21,33,0.636,92,2015-11-04,POR,UTA
3658,58,@,W 108-94 ,240,44,89,0.494,38,62,0.613,6,27,0.222,14,17,0.824,108,32,82,0.39,26,53,0.491,6,29,0.207,24,27,0.889,94,2015-11-05,CHA,DAL
3659,59,Home,W 108-102 ,240,45,88,0.511,35,62,0.565,10,26,0.385,8,12,0.667,108,41,79,0.519,31,56,0.554,10,23,0.435,10,15,0.667,102,2015-11-06,CLE,PHI
3660,60,Home,W 108-104 ,240,40,77,0.519,33,58,0.569,7,19,0.368,21,32,0.656,108,36,91,0.396,26,62,0.419,10,29,0.345,22,27,0.815,104,2015-11-09,DEN,POR
3661,61,@,L 108-118 ,240,37,86,0.43,25,59,0.424,12,27,0.444,22,33,0.667,108,42,76,0.553,31,52,0.596,11,24,0.458,23,30,0.767,118,2015-11-11,LAC,DAL
3662,62,Home,W 108-105 (2OT),290,43,102,0.422,37,86,0.43,6,16,0.375,16,22,0.727,108,37,91,0.407,23,53,0.434,14,38,0.368,17,27,0.63,105,2015-11-14,MIL,CLE
3663,63,Home,W 108-99 ,240,39,83,0.47,27,54,0.5,12,29,0.414,18,26,0.692,108,38,87,0.437,34,69,0.493,4,18,0.222,19,24,0.792,99,2015-11-14,WAS,ORL
3664,64,Home,W 108-103 (OT),265,32,92,0.348,18,48,0.375,14,44,0.318,30,35,0.857,108,35,88,0.398,26,58,0.448,9,30,0.3,24,29,0.828,103,2015-11-18,HOU,POR
3665,65,Home,W 108-96 ,240,38,78,0.487,26,48,0.542,12,30,0.4,20,26,0.769,108,36,82,0.439,29,59,0.492,7,23,0.304,17,23,0.739,96,2015-11-28,POR,LAL
3666,66,Home,W 108-88 ,240,40,85,0.471,31,68,0.456,9,17,0.529,19,20,0.95,108,37,87,0.425,31,61,0.508,6,26,0.231,8,13,0.615,88,2015-11-28,SAS,ATL
3667,67,Home,W 108-101 ,240,36,87,0.414,28,60,0.467,8,27,0.296,28,39,0.718,108,36,88,0.409,29,63,0.46,7,25,0.28,22,25,0.88,101,2015-12-02,HOU,NOP
3668,68,@,W 108-104 ,240,41,96,0.427,33,71,0.465,8,25,0.32,18,20,0.9,108,37,79,0.468,30,58,0.517,7,21,0.333,23,31,0.742,104,2015-12-02,LAL,WAS
3669,69,@,L 108-114 (OT),265,39,89,0.438,29,56,0.518,10,33,0.303,20,24,0.833,108,42,85,0.494,33,60,0.55,9,25,0.36,21,31,0.677,114,2015-12-04,CLE,NOP
3670,70,Home,W 108-91 ,240,39,87,0.448,27,60,0.45,12,27,0.444,18,21,0.857,108,39,91,0.429,36,80,0.45,3,11,0.273,10,15,0.667,91,2015-12-04,NYK,BRK
3671,71,@,W 108-105 ,240,37,81,0.457,26,50,0.52,11,31,0.355,23,38,0.605,108,37,74,0.5,22,43,0.512,15,31,0.484,16,26,0.615,105,2015-12-05,DEN,PHI
3672,72,Home,W 108-105 ,240,44,83,0.53,39,66,0.591,5,17,0.294,15,22,0.682,108,39,86,0.453,27,57,0.474,12,29,0.414,15,22,0.682,105,2015-12-05,SAS,BOS
3673,73,@,L 108-111 (OT),265,38,87,0.437,31,68,0.456,7,19,0.368,25,29,0.862,108,38,86,0.442,27,58,0.466,11,28,0.393,24,33,0.727,111,2015-12-11,MIN,DEN
3674,74,Home,W 108-95 ,240,44,90,0.489,38,76,0.5,6,14,0.429,14,18,0.778,108,36,89,0.404,30,62,0.484,6,27,0.222,17,25,0.68,95,2015-12-12,MIL,GSW
3675,75,Home,W 108-101 ,240,39,87,0.448,29,57,0.509,10,30,0.333,20,24,0.833,108,33,73,0.452,25,54,0.463,8,19,0.421,27,34,0.794,101,2015-12-13,PHO,MIN
3676,76,@,L 108-114 ,240,41,87,0.471,23,47,0.489,18,40,0.45,8,11,0.727,108,42,82,0.512,34,57,0.596,8,25,0.32,22,25,0.88,114,2015-12-14,HOU,DEN
3677,77,@,W 108-94 ,240,41,80,0.513,33,59,0.559,8,21,0.381,18,22,0.818,108,35,74,0.473,26,49,0.531,9,25,0.36,15,17,0.882,94,2015-12-18,TOR,MIA
3678,78,Home,W 108-86 ,240,40,85,0.471,29,60,0.483,11,25,0.44,17,21,0.81,108,30,86,0.349,25,62,0.403,5,24,0.208,21,30,0.7,86,2015-12-20,CLE,PHI
3679,79,@,W 108-106 ,240,46,89,0.517,42,66,0.636,4,23,0.174,12,16,0.75,108,41,89,0.461,29,57,0.509,12,32,0.375,12,20,0.6,106,2015-12-23,SAC,IND
3680,80,@,W 108-83 ,240,44,82,0.537,34,58,0.586,10,24,0.417,10,14,0.714,108,30,72,0.417,27,62,0.435,3,10,0.3,20,25,0.8,83,2015-12-23,SAS,MIN
3681,81,@,L 108-110 ,240,38,84,0.452,23,51,0.451,15,33,0.455,17,20,0.85,108,38,75,0.507,25,51,0.49,13,24,0.542,21,26,0.808,110,2015-12-26,HOU,NOP
3682,82,@,W 108-101 ,240,38,77,0.494,28,57,0.491,10,20,0.5,22,23,0.957,108,43,79,0.544,34,60,0.567,9,19,0.474,6,13,0.462,101,2015-12-26,MIA,ORL
3683,83,Home,W 108-98 ,240,43,89,0.483,37,64,0.578,6,25,0.24,16,22,0.727,108,35,85,0.412,26,56,0.464,9,29,0.31,19,23,0.826,98,2015-12-28,CHA,LAL
3684,84,@,W 108-91 ,240,41,78,0.526,34,55,0.618,7,23,0.304,19,25,0.76,108,34,87,0.391,27,63,0.429,7,24,0.292,16,24,0.667,91,2015-12-28,LAC,WAS
3685,85,Home,W 108-96 ,240,43,79,0.544,35,63,0.556,8,16,0.5,14,17,0.824,108,37,89,0.416,27,62,0.435,10,27,0.37,12,17,0.706,96,2015-12-29,NYK,DET
3686,86,Home,W 108-81 ,240,39,85,0.459,29,69,0.42,10,16,0.625,20,25,0.8,108,31,84,0.369,25,65,0.385,6,19,0.316,13,17,0.765,81,2016-01-01,CHI,NYK
3687,87,@,L 108-111 (OT),265,44,105,0.419,39,75,0.52,5,30,0.167,15,23,0.652,108,43,86,0.5,33,58,0.569,10,28,0.357,15,23,0.652,111,2016-01-02,DEN,GSW
3688,88,Home,L 108-128 ,240,38,96,0.396,26,63,0.413,12,33,0.364,20,28,0.714,108,46,87,0.529,28,55,0.509,18,32,0.563,18,21,0.857,128,2016-01-08,POR,GSW
3689,89,@,W 108-95 ,240,41,75,0.547,36,58,0.621,5,17,0.294,21,27,0.778,108,39,80,0.488,28,63,0.444,11,17,0.647,6,14,0.429,95,2016-01-09,TOR,PHI
3690,90,Home,W 108-89 ,240,38,82,0.463,23,49,0.469,15,33,0.455,17,29,0.586,108,32,82,0.39,26,51,0.51,6,31,0.194,19,25,0.76,89,2016-01-13,OKC,DAL
3691,91,Home,W 108-101 (OT),265,40,96,0.417,37,86,0.43,3,10,0.3,25,37,0.676,108,43,100,0.43,34,70,0.486,9,30,0.3,6,6,1.0,101,2016-01-15,MIL,ATL
3692,92,@,W 108-98 ,240,43,84,0.512,26,53,0.491,17,31,0.548,5,11,0.455,108,37,77,0.481,28,56,0.5,9,21,0.429,15,20,0.75,98,2016-01-18,POR,WAS
3693,93,@,W 108-86 ,240,43,75,0.573,34,59,0.576,9,16,0.563,13,15,0.867,108,33,75,0.44,27,59,0.458,6,16,0.375,14,18,0.778,86,2016-01-22,UTA,BRK
3694,94,@,W 108-95 ,240,43,85,0.506,32,64,0.5,11,21,0.524,11,13,0.846,108,38,84,0.452,32,68,0.471,6,16,0.375,13,18,0.722,95,2016-01-22,SAS,LAL
3695,95,Home,W 108-97 ,240,38,85,0.447,33,69,0.478,5,16,0.313,27,36,0.75,108,36,86,0.419,29,67,0.433,7,19,0.368,18,25,0.72,97,2016-01-23,SAC,IND
3696,96,Home,W 108-102 (OT),265,43,100,0.43,37,82,0.451,6,18,0.333,16,25,0.64,108,40,86,0.465,30,58,0.517,10,28,0.357,12,14,0.857,102,2016-01-25,MEM,ORL
3697,97,@,L 108-116 ,240,36,95,0.379,27,56,0.482,9,39,0.231,27,43,0.628,108,41,86,0.477,33,67,0.493,8,19,0.421,26,30,0.867,116,2016-01-29,HOU,OKC
3698,98,@,W 108-105 ,240,47,95,0.495,34,65,0.523,13,30,0.433,1,2,0.5,108,42,92,0.457,32,63,0.508,10,29,0.345,11,21,0.524,105,2016-01-30,GSW,PHI
3699,99,@,W 108-102 ,240,39,77,0.506,31,60,0.517,8,17,0.471,22,26,0.846,108,33,75,0.44,22,43,0.512,11,32,0.344,25,34,0.735,102,2016-02-03,MIN,LAC
3700,0,Home,W 108-104 ,240,38,81,0.469,26,54,0.481,12,27,0.444,20,25,0.8,108,38,86,0.442,29,61,0.475,9,25,0.36,19,24,0.792,104,2016-02-06,CHA,WAS
3701,1,@,L 108-116 ,240,36,85,0.424,29,63,0.46,7,22,0.318,29,37,0.784,108,48,97,0.495,41,71,0.577,7,26,0.269,13,20,0.65,116,2016-02-06,OKC,GSW
3702,2,Home,W 108-91 ,240,35,80,0.438,21,44,0.477,14,36,0.389,24,31,0.774,108,35,90,0.389,25,65,0.385,10,25,0.4,11,14,0.786,91,2016-02-08,CHA,CHI
3703,3,Home,L 108-111 ,240,44,83,0.53,36,57,0.632,8,26,0.308,12,14,0.857,108,39,78,0.5,23,52,0.442,16,26,0.615,17,25,0.68,111,2016-02-09,NYK,WAS
3704,4,Home,W 108-101 ,240,44,86,0.512,39,70,0.557,5,16,0.313,15,25,0.6,108,28,76,0.368,16,47,0.34,12,29,0.414,33,43,0.767,101,2016-02-22,MIL,LAL
3705,5,Home,W 108-105 ,240,46,91,0.505,43,76,0.566,3,15,0.2,13,16,0.813,108,35,77,0.455,22,51,0.431,13,26,0.5,22,25,0.88,105,2016-02-24,IND,NYK
3706,6,@,W 108-92 ,240,44,85,0.518,36,66,0.545,8,19,0.421,12,15,0.8,108,39,96,0.406,33,78,0.423,6,18,0.333,8,15,0.533,92,2016-02-24,SAS,SAC
3707,7,Home,W 108-95 ,240,37,80,0.463,33,64,0.516,4,16,0.25,30,36,0.833,108,39,93,0.419,33,66,0.5,6,27,0.222,11,16,0.688,95,2016-02-26,NYK,ORL
3708,8,@,L 108-116 ,240,43,89,0.483,33,57,0.579,10,32,0.313,12,21,0.571,108,43,89,0.483,37,69,0.536,6,20,0.3,24,31,0.774,116,2016-02-29,PHI,WAS
3709,9,@,L 108-121 ,240,41,91,0.451,32,61,0.525,9,30,0.3,17,20,0.85,108,43,77,0.558,34,58,0.586,9,19,0.474,26,31,0.839,121,2016-03-01,ORL,DAL
3710,10,Home,W 108-92 ,240,40,83,0.482,31,66,0.47,9,17,0.529,19,25,0.76,108,33,82,0.402,28,60,0.467,5,22,0.227,21,27,0.778,92,2016-03-03,MIA,PHO
3711,11,Home,W 108-101 ,240,38,79,0.481,25,48,0.521,13,31,0.419,19,23,0.826,108,37,90,0.411,28,62,0.452,9,28,0.321,18,21,0.857,101,2016-03-04,CHA,IND
3712,12,Home,W 108-83 ,240,42,90,0.467,30,63,0.476,12,27,0.444,12,16,0.75,108,32,81,0.395,29,61,0.475,3,20,0.15,16,24,0.667,83,2016-03-04,CLE,WAS
3713,13,Home,W 108-100 ,240,36,79,0.456,27,58,0.466,9,21,0.429,27,34,0.794,108,35,87,0.402,26,52,0.5,9,35,0.257,21,30,0.7,100,2016-03-05,CHI,HOU
3714,14,Home,W 108-103 ,240,41,90,0.456,29,60,0.483,12,30,0.4,14,17,0.824,108,39,80,0.488,35,65,0.538,4,15,0.267,21,24,0.875,103,2016-03-07,CHA,MIN
3715,15,@,L 108-114 ,240,42,80,0.525,36,65,0.554,6,15,0.4,18,19,0.947,108,42,80,0.525,38,72,0.528,4,8,0.5,26,37,0.703,114,2016-03-09,MIA,MIL
3716,16,@,L 108-120 ,240,41,81,0.506,29,47,0.617,12,34,0.353,14,23,0.609,108,48,91,0.527,39,67,0.582,9,24,0.375,15,18,0.833,120,2016-03-09,LAC,OKC
3717,17,Home,L 108-120 ,240,42,80,0.525,35,58,0.603,7,22,0.318,17,21,0.81,108,45,85,0.529,29,50,0.58,16,35,0.457,14,20,0.7,120,2016-03-10,LAL,CLE
3718,18,@,W 108-99 ,240,39,82,0.476,27,54,0.5,12,28,0.429,18,22,0.818,108,38,81,0.469,29,60,0.483,9,21,0.429,14,21,0.667,99,2016-03-13,UTA,SAC
3719,19,Home,W 108-87 ,240,44,82,0.537,36,62,0.581,8,20,0.4,12,16,0.75,108,32,69,0.464,24,50,0.48,8,19,0.421,15,22,0.682,87,2016-03-15,SAS,LAC
3720,20,Home,L 108-114 ,240,44,100,0.44,40,80,0.5,4,20,0.2,16,21,0.762,108,40,71,0.563,30,50,0.6,10,21,0.476,24,31,0.774,114,2016-03-16,MEM,MIN
3721,21,Home,L 108-123 ,240,42,90,0.467,33,72,0.458,9,18,0.5,15,17,0.882,108,49,90,0.544,37,69,0.536,12,21,0.571,13,16,0.813,123,2016-03-16,SAC,NOP
3722,22,@,L 108-115 ,240,40,79,0.506,36,64,0.563,4,15,0.267,24,29,0.828,108,44,92,0.478,32,66,0.485,12,26,0.462,15,18,0.833,115,2016-03-18,SAC,DET
3723,23,Home,W 108-97 ,240,40,80,0.5,35,65,0.538,5,15,0.333,23,33,0.697,108,36,84,0.429,30,66,0.455,6,18,0.333,19,28,0.679,97,2016-03-25,MIA,ORL
3724,24,Home,W 108-105 ,240,38,91,0.418,30,66,0.455,8,25,0.32,24,30,0.8,108,39,93,0.419,29,55,0.527,10,38,0.263,17,24,0.708,105,2016-03-26,POR,PHI
3725,25,Home,L 108-110 (OT),265,38,95,0.4,29,65,0.446,9,30,0.3,23,26,0.885,108,39,98,0.398,27,60,0.45,12,38,0.316,20,31,0.645,110,2016-04-01,ATL,CLE
3726,26,Home,W 108-92 ,240,39,87,0.448,32,68,0.471,7,19,0.368,23,26,0.885,108,34,77,0.442,23,48,0.479,11,29,0.379,13,19,0.684,92,2016-04-05,MEM,CHI
3727,27,@,W 108-104 ,240,39,86,0.453,28,59,0.475,11,27,0.407,19,31,0.613,108,43,90,0.478,39,75,0.52,4,15,0.267,14,19,0.737,104,2016-04-06,DET,ORL
3728,28,Home,L 108-109 (OT),265,39,96,0.406,26,50,0.52,13,46,0.283,17,25,0.68,108,40,87,0.46,33,64,0.516,7,23,0.304,22,24,0.917,109,2016-04-10,PHI,MIL
3729,29,@,W 108-96 ,240,47,97,0.485,43,81,0.531,4,16,0.25,10,16,0.625,108,34,89,0.382,28,71,0.394,6,18,0.333,22,28,0.786,96,2016-10-26,MIA,ORL
3730,30,Home,W 108-82 ,240,48,95,0.505,41,76,0.539,7,19,0.368,5,6,0.833,108,33,95,0.347,25,69,0.362,8,26,0.308,8,12,0.667,82,2016-10-28,DET,ORL
3731,31,@,L 108-110 ,240,37,84,0.44,26,50,0.52,11,34,0.324,23,28,0.821,108,41,88,0.466,33,66,0.5,8,22,0.364,20,24,0.833,110,2016-10-29,BRK,MIL
3732,32,@,L 108-115 ,240,40,89,0.449,34,61,0.557,6,28,0.214,22,25,0.88,108,41,87,0.471,31,59,0.525,10,28,0.357,23,29,0.793,115,2016-11-01,LAL,IND
3733,33,Home,W 108-96 (OT),265,37,86,0.43,24,57,0.421,13,29,0.448,21,29,0.724,108,34,89,0.382,29,66,0.439,5,23,0.217,23,27,0.852,96,2016-11-01,MIA,SAC
3734,34,@,L 108-119 ,240,40,91,0.44,34,71,0.479,6,20,0.3,22,28,0.786,108,41,90,0.456,31,67,0.463,10,23,0.435,27,35,0.771,119,2016-11-06,PHO,LAL
3735,35,Home,W 108-107 ,240,44,86,0.512,37,62,0.597,7,24,0.292,13,19,0.684,108,35,70,0.5,25,46,0.543,10,24,0.417,27,34,0.794,107,2016-11-08,MEM,DEN
3736,36,Home,L 108-110 ,240,38,88,0.432,22,60,0.367,16,28,0.571,16,19,0.842,108,39,86,0.453,28,59,0.475,11,27,0.407,21,35,0.6,110,2016-11-11,OKC,LAC
3737,37,Home,L 108-115 ,240,38,89,0.427,23,54,0.426,15,35,0.429,17,21,0.81,108,43,80,0.538,32,56,0.571,11,24,0.458,18,22,0.818,115,2016-11-15,MIN,CHO
3738,38,Home,W 108-83 ,240,39,79,0.494,31,53,0.585,8,26,0.308,22,31,0.71,108,28,88,0.318,19,61,0.311,9,27,0.333,18,31,0.581,83,2016-11-23,UTA,DEN
3739,39,Home,W 108-97 ,240,47,90,0.522,38,71,0.535,9,19,0.474,5,7,0.714,108,35,73,0.479,28,52,0.538,7,21,0.333,20,26,0.769,97,2016-11-25,DET,LAC
3740,40,Home,L 108-112 ,240,43,92,0.467,28,58,0.483,15,34,0.441,7,10,0.7,108,38,92,0.413,26,52,0.5,12,40,0.3,24,28,0.857,112,2016-11-27,PHI,CLE
3741,41,Home,L 108-110 (2OT),290,39,99,0.394,29,67,0.433,10,32,0.313,20,21,0.952,108,42,104,0.404,29,70,0.414,13,34,0.382,13,21,0.619,110,2016-12-05,NOP,MEM
3742,42,Home,L 108-116 ,240,36,81,0.444,27,57,0.474,9,24,0.375,27,36,0.75,108,38,83,0.458,25,51,0.49,13,32,0.406,27,30,0.9,116,2016-12-11,MIN,GSW
3743,43,Home,L 108-113 ,240,42,89,0.472,28,56,0.5,14,33,0.424,10,20,0.5,108,37,74,0.5,24,49,0.49,13,25,0.52,26,37,0.703,113,2016-12-14,ORL,LAC
3744,44,Home,W 108-101 ,240,44,80,0.55,36,58,0.621,8,22,0.364,12,14,0.857,108,37,84,0.44,27,53,0.509,10,31,0.323,17,20,0.85,101,2016-12-14,SAS,BOS
3745,45,Home,W 108-97 ,240,45,95,0.474,34,75,0.453,11,20,0.55,7,13,0.538,108,35,74,0.473,30,55,0.545,5,19,0.263,22,29,0.759,97,2016-12-15,MIL,CHI
3746,46,@,L 108-122 ,240,42,86,0.488,32,58,0.552,10,28,0.357,14,21,0.667,108,44,77,0.571,32,52,0.615,12,25,0.48,22,27,0.815,122,2016-12-16,DET,WAS
3747,47,@,L 108-119 ,240,41,86,0.477,25,49,0.51,16,37,0.432,10,13,0.769,108,46,89,0.517,31,56,0.554,15,33,0.455,12,18,0.667,119,2016-12-17,LAL,CLE
3748,48,Home,W 108-107 ,240,38,88,0.432,26,60,0.433,12,28,0.429,20,23,0.87,108,36,81,0.444,24,47,0.511,12,34,0.353,23,31,0.742,107,2016-12-18,PHI,BRK
3749,49,@,L 108-115 ,240,37,82,0.451,28,61,0.459,9,21,0.429,25,35,0.714,108,42,86,0.488,35,67,0.522,7,19,0.368,24,25,0.96,115,2016-12-19,PHO,MIN
3750,50,Home,L 108-110 ,240,39,87,0.448,29,52,0.558,10,35,0.286,20,26,0.769,108,41,75,0.547,32,52,0.615,9,23,0.391,19,24,0.792,110,2016-12-19,OKC,ATL
3751,51,Home,L 108-114 (OT),265,40,87,0.46,33,60,0.55,7,27,0.259,21,29,0.724,108,37,91,0.407,20,51,0.392,17,40,0.425,23,27,0.852,114,2016-12-20,MIL,CLE
3752,52,@,W 108-93 ,240,40,93,0.43,30,76,0.395,10,17,0.588,18,26,0.692,108,33,82,0.402,22,49,0.449,11,33,0.333,16,21,0.762,93,2016-12-20,NOP,PHI
3753,53,Home,L 108-109 ,240,37,78,0.474,29,53,0.547,8,25,0.32,26,35,0.743,108,37,86,0.43,29,61,0.475,8,25,0.32,27,33,0.818,109,2016-12-23,DEN,ATL
3754,54,@,L 108-109 ,240,37,77,0.481,28,47,0.596,9,30,0.3,25,29,0.862,108,37,95,0.389,25,60,0.417,12,35,0.343,23,32,0.719,109,2016-12-25,GSW,CLE
3755,55,Home,W 108-99 ,240,42,84,0.5,31,51,0.608,11,33,0.333,13,15,0.867,108,39,93,0.419,31,61,0.508,8,32,0.25,13,15,0.867,99,2016-12-30,GSW,DAL
3756,56,Home,L 108-116 ,240,41,91,0.451,32,61,0.525,9,30,0.3,17,19,0.895,108,38,88,0.432,29,55,0.527,9,33,0.273,31,43,0.721,116,2017-01-06,BRK,CLE
3757,57,@,L 108-117 ,240,40,85,0.471,30,54,0.556,10,31,0.323,18,23,0.783,108,40,93,0.43,22,57,0.386,18,36,0.5,19,21,0.905,117,2017-01-07,NOP,BOS
3758,58,@,W 108-87 ,240,43,85,0.506,36,64,0.563,7,21,0.333,15,20,0.75,108,32,83,0.386,23,59,0.39,9,24,0.375,14,26,0.538,87,2017-01-10,POR,LAL
3759,59,@,L 108-117 ,240,45,105,0.429,35,79,0.443,10,26,0.385,8,12,0.667,108,43,85,0.506,26,44,0.591,17,41,0.415,14,18,0.778,117,2017-01-11,WAS,BOS
3760,60,Home,L 108-113 ,240,38,78,0.487,28,60,0.467,10,18,0.556,22,27,0.815,108,43,89,0.483,28,55,0.509,15,34,0.441,12,17,0.706,113,2017-01-12,PHO,DAL
3761,61,@,L 108-116 ,240,41,83,0.494,29,51,0.569,12,32,0.375,14,18,0.778,108,40,80,0.5,31,65,0.477,9,15,0.6,27,31,0.871,116,2017-01-13,MIA,MIL
3762,62,Home,L 108-120 ,240,42,80,0.525,33,55,0.6,9,25,0.36,15,19,0.789,108,44,87,0.506,29,50,0.58,15,37,0.405,17,22,0.773,120,2017-01-13,SAC,CLE
3763,63,Home,W 108-105 ,240,39,85,0.459,31,64,0.484,8,21,0.381,22,24,0.917,108,36,71,0.507,27,51,0.529,9,20,0.45,24,34,0.706,105,2017-01-14,PHO,SAS
3764,64,@,W 108-104 ,240,40,78,0.513,36,61,0.59,4,17,0.235,24,35,0.686,108,40,95,0.421,29,63,0.46,11,32,0.344,13,13,1.0,104,2017-01-15,CHI,MEM
3765,65,Home,W 108-98 ,240,42,84,0.5,27,45,0.6,15,39,0.385,9,10,0.9,108,38,86,0.442,30,61,0.492,8,25,0.32,14,17,0.824,98,2017-01-16,BOS,CHO
3766,66,@,W 108-107 ,240,40,87,0.46,28,55,0.509,12,32,0.375,16,23,0.696,108,42,85,0.494,34,59,0.576,8,26,0.308,15,23,0.652,107,2017-01-16,ATL,NYK
3767,67,Home,L 108-125 ,240,43,96,0.448,36,61,0.59,7,35,0.2,15,18,0.833,108,47,89,0.528,32,51,0.627,15,38,0.395,16,21,0.762,125,2017-01-20,HOU,GSW
3768,68,Home,W 108-95 ,240,41,87,0.471,27,54,0.5,14,33,0.424,12,15,0.8,108,34,80,0.425,25,57,0.439,9,23,0.391,18,25,0.72,95,2017-01-20,LAL,IND
3769,69,@,L 108-111 ,240,42,82,0.512,35,58,0.603,7,24,0.292,17,21,0.81,108,45,85,0.529,39,70,0.557,6,15,0.4,15,21,0.714,111,2017-01-22,DEN,MIN
3770,70,@,W 108-106 ,240,38,85,0.447,31,61,0.508,7,24,0.292,25,33,0.758,108,38,84,0.452,32,59,0.542,6,25,0.24,24,28,0.857,106,2017-01-24,SAS,TOR
3771,71,@,L 108-123 ,240,38,84,0.452,28,51,0.549,10,33,0.303,22,24,0.917,108,48,83,0.578,39,63,0.619,9,20,0.45,18,21,0.857,123,2017-01-24,BOS,WAS
3772,72,Home,L 108-112 (OT),265,37,87,0.425,28,66,0.424,9,21,0.429,25,32,0.781,108,37,89,0.416,23,49,0.469,14,40,0.35,24,30,0.8,112,2017-01-28,MIL,BOS
3773,73,@,L 108-121 ,240,44,99,0.444,34,71,0.479,10,28,0.357,10,14,0.714,108,45,89,0.506,37,75,0.493,8,14,0.571,23,28,0.821,121,2017-01-29,PHI,CHI
3774,74,Home,W 108-94 ,240,37,86,0.43,30,65,0.462,7,21,0.333,27,38,0.711,108,30,85,0.353,23,57,0.404,7,28,0.25,27,32,0.844,94,2017-01-31,SAS,OKC
3775,75,Home,W 108-106 (OT),265,43,94,0.457,33,63,0.524,10,31,0.323,12,15,0.8,108,40,94,0.426,28,64,0.438,12,30,0.4,14,19,0.737,106,2017-01-31,TOR,NOP
3776,76,Home,L 108-113 ,240,35,93,0.376,22,42,0.524,13,51,0.255,25,33,0.758,108,44,85,0.518,36,55,0.655,8,30,0.267,17,23,0.739,113,2017-02-02,HOU,ATL
3777,77,@,L 108-116 ,240,40,87,0.46,28,48,0.583,12,39,0.308,16,22,0.727,108,44,96,0.458,32,63,0.508,12,33,0.364,16,21,0.762,116,2017-02-02,LAL,WAS
3778,78,@,L 108-116 ,240,44,89,0.494,39,72,0.542,5,17,0.294,15,19,0.789,108,44,98,0.449,33,72,0.458,11,26,0.423,17,22,0.773,116,2017-02-03,MIN,DET
3779,79,@,W 108-104 ,240,36,76,0.474,19,45,0.422,17,31,0.548,19,23,0.826,108,40,88,0.455,31,58,0.534,9,30,0.3,15,20,0.75,104,2017-02-03,DAL,POR
3780,80,Home,W 108-92 ,240,42,84,0.5,32,59,0.542,10,25,0.4,14,15,0.933,108,29,73,0.397,19,41,0.463,10,32,0.313,24,27,0.889,92,2017-02-08,SAC,BOS
3781,81,@,W 108-99 ,240,41,92,0.446,34,69,0.493,7,23,0.304,19,21,0.905,108,35,81,0.432,27,61,0.443,8,20,0.4,21,28,0.75,99,2017-02-10,MIA,BRK
3782,82,Home,W 108-107 ,240,38,80,0.475,20,44,0.455,18,36,0.5,14,21,0.667,108,36,71,0.507,25,41,0.61,11,30,0.367,24,31,0.774,107,2017-02-10,SAC,ATL
3783,83,Home,L 108-110 ,240,40,93,0.43,32,70,0.457,8,23,0.348,20,24,0.833,108,37,78,0.474,29,50,0.58,8,28,0.286,28,35,0.8,110,2017-02-13,PHO,NOP
3784,84,Home,L 108-116 ,240,42,86,0.488,33,63,0.524,9,23,0.391,15,19,0.789,108,44,86,0.512,31,47,0.66,13,39,0.333,15,22,0.682,116,2017-02-14,MIN,CLE
3785,85,@,L 108-116 ,240,44,93,0.473,36,62,0.581,8,31,0.258,12,18,0.667,108,38,80,0.475,25,52,0.481,13,28,0.464,27,36,0.75,116,2017-02-15,PHI,BOS
3786,86,@,L 108-114 (OT),265,38,92,0.413,31,62,0.5,7,30,0.233,25,26,0.962,108,44,107,0.411,29,70,0.414,15,37,0.405,11,12,0.917,114,2017-02-23,CHA,DET
3787,87,@,W 108-90 ,240,40,99,0.404,23,62,0.371,17,37,0.459,11,13,0.846,108,30,79,0.38,24,59,0.407,6,20,0.3,24,36,0.667,90,2017-02-24,MIA,ATL
3788,88,Home,L 108-117 ,240,32,88,0.364,22,43,0.512,10,45,0.222,34,42,0.81,108,41,91,0.451,28,61,0.459,13,30,0.433,22,25,0.88,117,2017-02-27,HOU,IND
3789,89,Home,L 108-119 ,240,37,82,0.451,27,48,0.563,10,34,0.294,24,27,0.889,108,40,89,0.449,34,60,0.567,6,29,0.207,33,39,0.846,119,2017-02-27,PHI,GSW
3790,90,@,L 108-112 ,240,39,84,0.464,31,55,0.564,8,29,0.276,22,27,0.815,108,41,91,0.451,29,63,0.46,12,28,0.429,18,20,0.9,112,2017-02-28,GSW,WAS
3791,91,@,L 108-123 ,240,43,97,0.443,35,69,0.507,8,28,0.286,14,21,0.667,108,39,78,0.5,21,36,0.583,18,42,0.429,27,36,0.75,123,2017-03-04,MEM,HOU
3792,92,Home,W 108-96 ,240,37,75,0.493,24,45,0.533,13,30,0.433,21,28,0.75,108,36,83,0.434,30,67,0.448,6,16,0.375,18,21,0.857,96,2017-03-06,DEN,SAC
3793,93,Home,L 108-115 ,240,35,79,0.443,27,47,0.574,8,32,0.25,30,40,0.75,108,41,76,0.539,29,45,0.644,12,31,0.387,21,24,0.875,115,2017-03-08,HOU,UTA
3794,94,Home,W 108-101 ,240,37,85,0.435,20,44,0.455,17,41,0.415,17,24,0.708,108,37,80,0.463,30,59,0.508,7,21,0.333,20,21,0.952,101,2017-03-08,MIA,CHO
3795,95,@,L 108-114 (OT),265,41,94,0.436,30,65,0.462,11,29,0.379,15,20,0.75,108,40,88,0.455,34,67,0.507,6,21,0.286,28,33,0.848,114,2017-03-09,PHI,POR
3796,96,Home,W 107-103 ,240,40,97,0.412,31,78,0.397,9,19,0.474,18,23,0.783,107,40,83,0.482,32,64,0.5,8,19,0.421,15,19,0.789,103,2011-12-26,POR,PHI
3797,97,@,L 107-115 ,240,37,72,0.514,25,53,0.472,12,19,0.632,21,27,0.778,107,42,75,0.56,36,65,0.554,6,10,0.6,25,35,0.714,115,2011-12-27,BOS,MIA
3798,98,@,W 107-79 ,240,39,79,0.494,28,59,0.475,11,20,0.55,18,31,0.581,107,34,89,0.382,30,72,0.417,4,17,0.235,7,12,0.583,79,2011-12-31,PHI,GSW
3799,99,Home,W 107-97 ,240,41,77,0.532,32,55,0.582,9,22,0.409,16,18,0.889,107,35,88,0.398,27,62,0.435,8,26,0.308,19,23,0.826,97,2011-12-31,OKC,PHO
3800,0,Home,W 107-96 ,240,41,89,0.461,36,77,0.468,5,12,0.417,20,26,0.769,107,37,79,0.468,37,68,0.544,0,11,0.0,22,27,0.815,96,2012-01-05,POR,LAL
3801,1,@,W 107-104 ,240,41,70,0.586,25,43,0.581,16,27,0.593,9,19,0.474,107,41,86,0.477,31,61,0.508,10,25,0.4,12,13,0.923,104,2012-01-11,ORL,POR
3802,2,Home,W 107-105 (OT),265,39,93,0.419,34,75,0.453,5,18,0.278,24,28,0.857,107,37,90,0.411,28,64,0.438,9,26,0.346,22,31,0.71,105,2012-01-14,HOU,POR
3803,3,Home,W 107-94 ,240,42,81,0.519,39,73,0.534,3,8,0.375,20,26,0.769,107,32,74,0.432,23,47,0.489,9,27,0.333,21,27,0.778,94,2012-01-14,UTA,NJN
3804,4,Home,W 107-100 ,240,37,75,0.493,26,46,0.565,11,29,0.379,22,25,0.88,107,37,72,0.514,29,56,0.518,8,16,0.5,18,27,0.667,100,2012-01-18,BRK,GSW
3805,5,@,W 107-92 ,240,39,86,0.453,32,65,0.492,7,21,0.333,22,28,0.786,107,33,80,0.413,28,68,0.412,5,12,0.417,21,27,0.778,92,2012-01-23,HOU,MIN
3806,6,Home,W 107-100 ,240,41,90,0.456,36,73,0.493,5,17,0.294,20,33,0.606,107,39,92,0.424,32,68,0.471,7,24,0.292,15,16,0.938,100,2012-01-27,CHI,MIL
3807,7,@,W 107-101 (OT),265,40,82,0.488,30,66,0.455,10,16,0.625,17,25,0.68,107,38,93,0.409,31,77,0.403,7,16,0.438,18,22,0.818,101,2012-01-27,ATL,DET
3808,8,@,W 107-105 ,240,42,87,0.483,37,65,0.569,5,22,0.227,18,23,0.783,107,38,81,0.469,35,70,0.5,3,11,0.273,26,36,0.722,105,2012-02-01,LAC,UTA
3809,9,Home,W 107-96 ,240,37,88,0.42,25,65,0.385,12,23,0.522,21,25,0.84,107,36,77,0.468,29,56,0.518,7,21,0.333,17,28,0.607,96,2012-02-04,SAS,OKC
3810,10,@,W 107-81 ,240,45,83,0.542,34,60,0.567,11,23,0.478,6,17,0.353,107,30,80,0.375,23,62,0.371,7,18,0.389,14,23,0.609,81,2012-02-04,LAC,WAS
3811,11,@,W 107-102 (OT),265,36,82,0.439,23,51,0.451,13,31,0.419,22,25,0.88,107,40,86,0.465,29,56,0.518,11,30,0.367,11,16,0.688,102,2012-02-06,LAC,ORL
3812,12,Home,L 107-111 (OT),265,41,97,0.423,36,77,0.468,5,20,0.25,20,26,0.769,107,43,95,0.453,37,73,0.507,6,22,0.273,19,22,0.864,111,2012-02-06,POR,OKC
3813,13,Home,W 107-91 ,240,39,84,0.464,33,67,0.493,6,17,0.353,23,26,0.885,107,32,82,0.39,25,63,0.397,7,19,0.368,20,30,0.667,91,2012-02-07,MIA,CLE
3814,14,@,W 107-105 ,240,45,94,0.479,36,69,0.522,9,25,0.36,8,8,1.0,107,39,81,0.481,30,61,0.492,9,20,0.45,18,20,0.9,105,2012-02-07,PHO,MIL
3815,15,@,W 107-93 ,240,37,81,0.457,30,53,0.566,7,28,0.25,26,33,0.788,107,38,83,0.458,36,66,0.545,2,17,0.118,15,19,0.789,93,2012-02-08,NYK,WAS
3816,16,@,W 107-87 ,240,38,83,0.458,33,71,0.465,5,12,0.417,26,31,0.839,107,35,90,0.389,24,63,0.381,11,27,0.407,6,7,0.857,87,2012-02-12,MIA,ATL
3817,17,Home,L 107-115 ,240,41,84,0.488,32,61,0.525,9,23,0.391,16,27,0.593,107,43,96,0.448,39,79,0.494,4,17,0.235,25,27,0.926,115,2012-02-22,WAS,SAC
3818,18,@,W 107-93 ,240,39,82,0.476,33,71,0.465,6,11,0.545,23,29,0.793,107,36,76,0.474,31,60,0.517,5,16,0.313,16,19,0.842,93,2012-03-01,MIA,POR
3819,19,Home,W 107-94 ,240,45,87,0.517,41,71,0.577,4,16,0.25,13,17,0.765,107,34,76,0.447,29,57,0.509,5,19,0.263,21,28,0.75,94,2012-03-02,BOS,NJN
3820,20,@,L 107-115 ,240,45,103,0.437,36,78,0.462,9,25,0.36,8,9,0.889,107,44,82,0.537,38,65,0.585,6,17,0.353,21,26,0.808,115,2012-03-02,SAC,LAL
3821,21,@,L 107-118 ,240,44,86,0.512,36,69,0.522,8,17,0.471,11,17,0.647,107,39,82,0.476,28,62,0.452,11,20,0.55,29,36,0.806,118,2012-03-11,HOU,CLE
3822,22,Home,W 107-94 ,240,37,79,0.468,27,52,0.519,10,27,0.37,23,30,0.767,107,39,82,0.476,38,70,0.543,1,12,0.083,15,18,0.833,94,2012-03-11,ORL,IND
3823,23,Home,W 107-98 ,240,44,87,0.506,38,65,0.585,6,22,0.273,13,15,0.867,107,35,80,0.438,33,68,0.485,2,12,0.167,26,38,0.684,98,2012-03-13,DAL,WAS
3824,24,Home,W 107-87 ,240,45,84,0.536,39,75,0.52,6,9,0.667,11,17,0.647,107,33,81,0.407,29,69,0.42,4,12,0.333,17,19,0.895,87,2012-03-14,HOU,CHA
3825,25,@,W 107-101 (OT),265,37,82,0.451,32,63,0.508,5,19,0.263,28,35,0.8,107,44,85,0.518,41,75,0.547,3,10,0.3,10,13,0.769,101,2012-03-14,LAL,NOH
3826,26,Home,W 107-103 ,240,36,71,0.507,32,62,0.516,4,9,0.444,31,34,0.912,107,38,73,0.521,30,55,0.545,8,18,0.444,19,24,0.792,103,2012-03-17,CHA,TOR
3827,27,Home,W 107-104 ,240,39,80,0.488,30,60,0.5,9,20,0.45,20,27,0.741,107,42,83,0.506,36,67,0.537,6,16,0.375,14,16,0.875,104,2012-03-20,HOU,LAL
3828,28,@,W 107-100 ,240,45,92,0.489,39,65,0.6,6,27,0.222,11,13,0.846,107,41,87,0.471,34,68,0.5,7,19,0.368,11,12,0.917,100,2012-03-27,SAS,PHO
3829,29,@,L 107-110 (OT),265,40,86,0.465,32,64,0.5,8,22,0.364,19,22,0.864,107,45,87,0.517,41,77,0.532,4,10,0.4,16,22,0.727,110,2012-03-31,CHA,DET
3830,30,Home,W 107-98 ,240,48,84,0.571,46,73,0.63,2,11,0.182,9,17,0.529,107,39,95,0.411,31,69,0.449,8,26,0.308,12,13,0.923,98,2012-04-04,MIL,CLE
3831,31,@,W 107-105 ,240,41,91,0.451,28,60,0.467,13,31,0.419,12,22,0.545,107,40,79,0.506,37,70,0.529,3,9,0.333,22,28,0.786,105,2012-04-04,PHO,UTA
3832,32,Home,L 107-112 ,240,36,84,0.429,33,73,0.452,3,11,0.273,32,36,0.889,107,42,88,0.477,32,71,0.451,10,17,0.588,18,22,0.818,112,2012-04-06,LAL,HOU
3833,33,Home,L 107-115 ,240,39,87,0.448,31,69,0.449,8,18,0.444,21,27,0.778,107,43,71,0.606,34,57,0.596,9,14,0.643,20,25,0.8,115,2012-04-10,MIA,BOS
3834,34,@,W 107-88 ,240,39,85,0.459,33,68,0.485,6,17,0.353,23,26,0.885,107,34,88,0.386,32,77,0.416,2,11,0.182,18,21,0.857,88,2012-04-10,PHI,NJN
3835,35,@,L 107-113 ,240,42,84,0.5,34,60,0.567,8,24,0.333,15,18,0.833,107,41,82,0.5,32,60,0.533,9,22,0.409,22,31,0.71,113,2012-04-11,MIN,DEN
3836,36,Home,L 107-111 ,240,42,85,0.494,34,60,0.567,8,25,0.32,15,24,0.625,107,41,80,0.513,35,64,0.547,6,16,0.375,23,27,0.852,111,2012-04-11,MIL,NYK
3837,37,Home,W 107-97 ,240,37,76,0.487,30,56,0.536,7,20,0.35,26,31,0.839,107,36,85,0.424,32,66,0.485,4,19,0.211,21,27,0.778,97,2012-04-12,SAS,MEM
3838,38,@,L 107-125 ,240,41,89,0.461,33,68,0.485,8,21,0.381,17,23,0.739,107,51,85,0.6,44,70,0.629,7,15,0.467,16,19,0.842,125,2012-04-16,POR,PHO
3839,39,Home,L 107-118 ,240,44,95,0.463,33,69,0.478,11,26,0.423,8,11,0.727,107,48,87,0.552,42,74,0.568,6,13,0.462,16,17,0.941,118,2012-04-21,PHO,DEN
3840,40,@,L 107-117 (OT),265,42,96,0.438,27,58,0.466,15,38,0.395,8,13,0.615,107,47,88,0.534,43,80,0.538,4,8,0.5,19,23,0.826,117,2012-04-21,ORL,UTA
3841,41,Home,W 107-98 ,240,33,77,0.429,26,49,0.531,7,28,0.25,34,43,0.791,107,35,71,0.493,32,59,0.542,3,12,0.25,25,34,0.735,98,2012-04-22,LAC,NOH
3842,42,Home,W 107-75 ,240,45,85,0.529,40,69,0.58,5,16,0.313,12,17,0.706,107,28,87,0.322,26,74,0.351,2,13,0.154,17,26,0.654,75,2012-04-26,CHI,CLE
3843,43,@,W 107-101 ,240,42,96,0.438,33,65,0.508,9,31,0.29,14,17,0.824,107,45,87,0.517,43,79,0.544,2,8,0.25,9,12,0.75,101,2012-04-26,SAS,GSW
3844,44,@,L 107-120 ,240,39,75,0.52,33,62,0.532,6,13,0.462,23,28,0.821,107,43,79,0.544,35,63,0.556,8,16,0.5,26,32,0.813,120,2012-10-30,BOS,MIA
3845,45,Home,W 107-100 ,240,37,81,0.457,31,66,0.47,6,15,0.4,27,37,0.73,107,37,82,0.451,30,64,0.469,7,18,0.389,19,25,0.76,100,2012-11-03,BRK,TOR
3846,46,@,W 107-96 ,240,44,88,0.5,37,68,0.544,7,20,0.35,12,15,0.8,107,35,73,0.479,22,50,0.44,13,23,0.565,13,18,0.722,96,2012-11-05,MIN,BRK
3847,47,Home,W 107-99 ,240,43,83,0.518,35,61,0.574,8,22,0.364,13,21,0.619,107,40,83,0.482,33,62,0.532,7,21,0.333,12,18,0.667,99,2012-11-09,NOP,CHA
3848,48,@,W 107-68 ,240,41,82,0.5,32,59,0.542,9,23,0.391,16,25,0.64,107,30,70,0.429,26,59,0.441,4,11,0.364,4,8,0.5,68,2012-11-09,BRK,ORL
3849,49,Home,W 107-105 ,240,38,81,0.469,32,64,0.5,6,17,0.353,25,33,0.758,107,37,77,0.481,28,56,0.5,9,21,0.429,22,27,0.815,105,2012-11-09,PHO,CLE
3850,50,@,W 107-101 (2OT),290,43,113,0.381,38,89,0.427,5,24,0.208,16,27,0.593,107,39,102,0.382,30,77,0.39,9,25,0.36,14,23,0.609,101,2012-11-10,DEN,GSW
3851,51,Home,W 107-101 ,240,39,78,0.5,36,67,0.537,3,11,0.273,26,33,0.788,107,39,81,0.481,26,54,0.481,13,27,0.481,10,11,0.909,101,2012-11-14,DAL,WAS
3852,52,Home,W 107-100 ,240,35,72,0.486,25,51,0.49,10,21,0.476,27,32,0.844,107,35,77,0.455,26,56,0.464,9,21,0.429,21,29,0.724,100,2012-11-14,LAC,MIA
3853,53,@,W 107-97 ,240,44,93,0.473,37,76,0.487,7,17,0.412,12,14,0.857,107,35,72,0.486,29,59,0.492,6,13,0.462,21,26,0.808,97,2012-11-14,MEM,OKC
3854,54,Home,W 107-89 ,240,43,76,0.566,37,61,0.607,6,15,0.4,15,19,0.789,107,30,70,0.429,22,48,0.458,8,22,0.364,21,31,0.677,89,2012-11-17,BOS,TOR
3855,55,@,L 107-115 (OT),265,39,92,0.424,33,82,0.402,6,10,0.6,23,27,0.852,107,40,92,0.435,25,65,0.385,15,27,0.556,20,28,0.714,115,2012-11-21,NOP,IND
3856,56,Home,W 107-105 ,240,38,101,0.376,31,67,0.463,7,34,0.206,24,31,0.774,107,38,83,0.458,31,62,0.5,7,21,0.333,22,34,0.647,105,2012-12-04,HOU,LAL
3857,57,Home,W 107-100 ,240,38,82,0.463,32,67,0.478,6,15,0.4,25,34,0.735,107,35,86,0.407,29,63,0.46,6,23,0.261,24,28,0.857,100,2012-12-05,SAC,TOR
3858,58,@,L 107-116 ,240,35,84,0.417,23,47,0.489,12,37,0.324,25,29,0.862,107,42,79,0.532,30,54,0.556,12,25,0.48,20,30,0.667,116,2012-12-13,LAL,NYK
3859,59,Home,W 107-105 (2OT),290,42,93,0.452,32,67,0.478,10,26,0.385,13,16,0.813,107,40,99,0.404,35,83,0.422,5,16,0.313,20,26,0.769,105,2012-12-14,BRK,DET
3860,60,@,W 107-98 ,240,43,79,0.544,38,62,0.613,5,17,0.294,16,19,0.842,107,36,78,0.462,32,66,0.485,4,12,0.333,22,29,0.759,98,2012-12-15,ORL,CHA
3861,61,Home,W 107-93 ,240,38,85,0.447,34,71,0.479,4,14,0.286,27,30,0.9,107,36,79,0.456,30,59,0.508,6,20,0.3,15,21,0.714,93,2012-12-17,OKC,SAS
3862,62,Home,W 107-100 ,240,39,72,0.542,35,61,0.574,4,11,0.364,25,29,0.862,107,37,86,0.43,24,51,0.471,13,35,0.371,13,15,0.867,100,2012-12-18,DAL,PHI
3863,63,@,L 107-111 ,240,45,97,0.464,43,80,0.538,2,17,0.118,15,24,0.625,107,45,89,0.506,40,71,0.563,5,18,0.278,16,26,0.615,111,2012-12-29,PHO,MIN
3864,64,Home,W 107-96 ,240,39,78,0.5,31,60,0.517,8,18,0.444,21,29,0.724,107,33,80,0.413,28,67,0.418,5,13,0.385,25,34,0.735,96,2012-12-30,LAC,UTA
3865,65,Home,W 107-102 ,240,41,82,0.5,35,68,0.515,6,14,0.429,19,25,0.76,107,35,76,0.461,29,51,0.569,6,25,0.24,26,36,0.722,102,2013-01-04,LAC,LAL
3866,66,Home,W 107-100 ,240,43,87,0.494,37,69,0.536,6,18,0.333,15,19,0.789,107,37,84,0.44,29,52,0.558,8,32,0.25,18,22,0.818,100,2013-01-12,PHI,HOU
3867,67,@,W 107-96 ,240,40,77,0.519,32,58,0.552,8,19,0.421,19,23,0.826,107,36,85,0.424,33,72,0.458,3,13,0.231,21,27,0.778,96,2013-01-13,MIL,TOR
3868,68,@,W 107-105 (OT),265,39,86,0.453,36,75,0.48,3,11,0.273,26,36,0.722,107,38,85,0.447,32,69,0.464,6,16,0.375,23,32,0.719,105,2013-01-16,CHI,TOR
3869,69,Home,L 107-113 ,240,42,91,0.462,36,73,0.493,6,18,0.333,17,18,0.944,107,43,89,0.483,34,66,0.515,9,23,0.391,18,24,0.75,113,2013-01-25,DAL,SAS
3870,70,Home,W 107-98 ,240,42,90,0.467,33,66,0.5,9,24,0.375,14,20,0.7,107,41,94,0.436,36,75,0.48,5,19,0.263,11,22,0.5,98,2013-02-02,MIL,ORL
3871,71,Home,W 107-97 ,240,44,80,0.55,38,64,0.594,6,16,0.375,13,14,0.929,107,35,70,0.5,28,58,0.483,7,12,0.583,20,26,0.769,97,2013-02-10,MIA,LAL
3872,72,@,W 107-90 ,240,44,75,0.587,36,56,0.643,8,19,0.421,11,22,0.5,107,35,84,0.417,26,66,0.394,9,18,0.5,11,16,0.688,90,2013-02-11,LAC,PHI
3873,73,Home,L 107-116 ,240,38,84,0.452,30,64,0.469,8,20,0.4,23,31,0.742,107,43,91,0.473,33,57,0.579,10,34,0.294,20,25,0.8,116,2013-02-12,GSW,HOU
3874,74,Home,W 107-101 (OT),265,39,94,0.415,34,73,0.466,5,21,0.238,24,30,0.8,107,37,95,0.389,33,73,0.452,4,22,0.182,23,32,0.719,101,2013-02-22,GSW,SAS
3875,75,@,L 107-111 ,240,46,94,0.489,38,74,0.514,8,20,0.4,7,12,0.583,107,40,85,0.471,34,67,0.507,6,18,0.333,25,34,0.735,111,2013-02-22,POR,LAL
3876,76,Home,W 107-94 ,240,40,78,0.513,32,58,0.552,8,20,0.4,19,24,0.792,107,35,84,0.417,34,69,0.493,1,15,0.067,23,28,0.821,94,2013-02-23,LAC,UTA
3877,77,Home,L 107-110 (OT),265,39,88,0.443,31,71,0.437,8,17,0.471,21,24,0.875,107,41,86,0.477,31,59,0.525,10,27,0.37,18,20,0.9,110,2013-02-25,UTA,BOS
3878,78,Home,L 107-110 ,240,42,89,0.472,35,66,0.53,7,23,0.304,16,25,0.64,107,43,89,0.483,34,65,0.523,9,24,0.375,15,20,0.75,110,2013-02-27,HOU,MIL
3879,79,Home,W 107-96 ,240,43,80,0.538,32,56,0.571,11,24,0.458,10,17,0.588,107,37,86,0.43,31,69,0.449,6,17,0.353,16,21,0.762,96,2013-03-06,ATL,PHI
3880,80,Home,W 107-92 ,240,43,77,0.558,32,54,0.593,11,23,0.478,10,12,0.833,107,36,85,0.424,29,63,0.46,7,22,0.318,13,16,0.813,92,2013-03-07,DEN,LAC
3881,81,Home,W 107-102 (OT),265,40,78,0.513,30,58,0.517,10,20,0.5,17,20,0.85,107,40,88,0.455,31,61,0.508,9,27,0.333,13,17,0.765,102,2013-03-08,BOS,ATL
3882,82,Home,W 107-105 ,240,37,82,0.451,29,64,0.453,8,18,0.444,25,39,0.641,107,37,86,0.43,18,45,0.4,19,41,0.463,12,18,0.667,105,2013-03-09,PHO,HOU
3883,83,Home,W 107-83 ,240,44,82,0.537,32,62,0.516,12,20,0.6,7,18,0.389,107,29,82,0.354,20,53,0.377,9,29,0.31,16,18,0.889,83,2013-03-12,MIN,SAS
3884,84,Home,W 107-91 ,240,41,82,0.5,32,57,0.561,9,25,0.36,16,26,0.615,107,35,80,0.438,29,61,0.475,6,19,0.316,15,18,0.833,91,2013-03-13,IND,MIN
3885,85,Home,W 107-94 ,240,41,84,0.488,29,61,0.475,12,23,0.522,13,16,0.813,107,35,79,0.443,32,60,0.533,3,19,0.158,21,31,0.677,94,2013-03-15,ATL,PHO
3886,86,@,W 107-94 ,240,41,79,0.519,34,64,0.531,7,15,0.467,18,22,0.818,107,33,89,0.371,24,64,0.375,9,25,0.36,19,21,0.905,94,2013-03-15,MIA,MIL
3887,87,@,W 107-101 ,240,39,80,0.488,34,59,0.576,5,21,0.238,24,30,0.8,107,38,83,0.458,29,62,0.468,9,21,0.429,16,16,1.0,101,2013-03-17,OKC,DAL
3888,88,Home,W 107-101 ,240,35,75,0.467,27,59,0.458,8,16,0.5,29,40,0.725,107,35,83,0.422,30,61,0.492,5,22,0.227,26,26,1.0,101,2013-03-20,CHA,TOR
3889,89,Home,W 107-91 ,240,41,84,0.488,34,70,0.486,7,14,0.5,18,21,0.857,107,32,83,0.386,28,69,0.406,4,14,0.286,23,28,0.821,91,2013-03-25,UTA,PHI
3890,90,Home,W 107-94 ,240,36,72,0.5,31,59,0.525,5,13,0.385,30,44,0.682,107,34,77,0.442,28,61,0.459,6,16,0.375,20,22,0.909,94,2013-03-25,WAS,MEM
3891,91,@,W 107-88 ,240,40,81,0.494,30,60,0.5,10,21,0.476,17,20,0.85,107,35,78,0.449,31,61,0.508,4,17,0.235,14,20,0.7,88,2013-03-27,ATL,TOR
3892,92,@,L 107-118 ,240,40,88,0.455,32,68,0.471,8,20,0.4,19,24,0.792,107,45,83,0.542,34,60,0.567,11,23,0.478,17,21,0.81,118,2013-03-29,ATL,BOS
3893,93,@,L 107-116 ,240,42,81,0.519,34,58,0.586,8,23,0.348,15,19,0.789,107,45,81,0.556,35,64,0.547,10,17,0.588,16,24,0.667,116,2013-03-30,BRK,UTA
3894,94,@,W 107-98 ,240,44,84,0.524,36,71,0.507,8,13,0.615,11,16,0.688,107,42,96,0.438,34,73,0.466,8,23,0.348,6,9,0.667,98,2013-04-03,MIN,MIL
3895,95,Home,L 107-111 ,240,44,72,0.611,39,58,0.672,5,14,0.357,14,17,0.824,107,44,86,0.512,35,70,0.5,9,16,0.563,14,16,0.875,111,2013-04-05,PHO,GSW
3896,96,Home,W 107-101 ,240,36,83,0.434,30,69,0.435,6,14,0.429,29,38,0.763,107,40,75,0.533,34,60,0.567,6,15,0.4,15,21,0.714,101,2013-04-06,MIN,DET
3897,97,Home,W 107-96 ,240,43,77,0.558,39,66,0.591,4,11,0.364,17,21,0.81,107,39,88,0.443,29,62,0.468,10,26,0.385,8,12,0.667,96,2013-04-07,BOS,WAS
3898,98,Home,W 107-100 ,240,42,72,0.583,34,59,0.576,8,13,0.615,15,17,0.882,107,36,78,0.462,28,56,0.5,8,22,0.364,20,21,0.952,100,2013-04-12,UTA,MIN
3899,99,@,W 107-89 ,240,45,86,0.523,36,65,0.554,9,21,0.429,8,8,1.0,107,33,87,0.379,24,65,0.369,9,22,0.409,14,18,0.778,89,2013-04-14,DAL,NOH
3900,0,Home,W 107-95 ,240,37,72,0.514,26,52,0.5,11,20,0.55,22,29,0.759,107,35,83,0.422,28,57,0.491,7,26,0.269,18,23,0.783,95,2013-10-29,MIA,CHI
3901,1,Home,W 107-104 ,240,42,86,0.488,31,64,0.484,11,22,0.5,12,18,0.667,107,42,93,0.452,39,79,0.494,3,14,0.214,17,19,0.895,104,2013-11-02,PHI,CHI
3902,2,Home,W 107-86 ,240,42,89,0.472,35,72,0.486,7,17,0.412,16,22,0.727,107,34,89,0.382,30,72,0.417,4,17,0.235,14,15,0.933,86,2013-11-03,ORL,BRK
3903,3,Home,W 107-93 ,240,43,79,0.544,38,66,0.576,5,13,0.385,16,23,0.696,107,36,85,0.424,27,62,0.435,9,23,0.391,12,14,0.857,93,2013-11-06,OKC,DAL
3904,4,@,L 107-109 ,240,43,94,0.457,35,68,0.515,8,26,0.308,13,19,0.684,107,42,86,0.488,28,61,0.459,14,25,0.56,11,17,0.647,109,2013-11-07,ATL,DEN
3905,5,@,W 107-94 ,240,42,88,0.477,33,64,0.516,9,24,0.375,14,23,0.609,107,35,78,0.449,28,52,0.538,7,26,0.269,17,27,0.63,94,2013-11-09,LAC,HOU
3906,6,@,L 107-109 ,240,40,96,0.417,29,67,0.433,11,29,0.379,16,18,0.889,107,44,80,0.55,40,64,0.625,4,16,0.25,17,28,0.607,109,2013-11-11,MIN,LAC
3907,7,Home,W 107-86 ,240,41,94,0.436,33,70,0.471,8,24,0.333,17,23,0.739,107,31,82,0.378,28,69,0.406,3,13,0.231,21,27,0.778,86,2013-11-13,SAC,BRK
3908,8,Home,W 107-104 ,240,39,83,0.47,31,61,0.508,8,22,0.364,21,28,0.75,107,37,79,0.468,27,50,0.54,10,29,0.345,20,28,0.714,104,2013-11-19,SAC,PHO
3909,9,@,L 107-115 (OT),265,41,93,0.441,33,64,0.516,8,29,0.276,17,24,0.708,107,45,79,0.57,38,59,0.644,7,20,0.35,18,29,0.621,115,2013-11-22,MIL,PHI
3910,10,Home,W 107-92 ,240,39,79,0.494,32,57,0.561,7,22,0.318,22,24,0.917,107,33,83,0.398,25,51,0.49,8,32,0.25,18,24,0.75,92,2013-11-25,MIA,PHO
3911,11,@,W 107-97 ,240,41,80,0.513,34,64,0.531,7,16,0.438,18,26,0.692,107,36,82,0.439,27,54,0.5,9,28,0.321,16,23,0.696,97,2013-12-03,DET,MIA
3912,12,Home,W 107-97 ,240,42,82,0.512,30,59,0.508,12,23,0.522,11,16,0.688,107,39,83,0.47,35,64,0.547,4,19,0.211,15,20,0.75,97,2013-12-04,ATL,LAC
3913,13,Home,W 107-87 ,240,37,74,0.5,27,55,0.491,10,19,0.526,23,32,0.719,107,32,77,0.416,26,55,0.473,6,22,0.273,17,24,0.708,87,2013-12-05,CHI,MIA
3914,14,@,L 107-116 ,240,38,87,0.437,32,68,0.471,6,19,0.316,25,29,0.862,107,41,83,0.494,29,59,0.492,12,24,0.5,22,29,0.759,116,2013-12-13,SAC,PHO
3915,15,@,L 107-114 ,240,39,84,0.464,29,55,0.527,10,29,0.345,19,25,0.76,107,42,76,0.553,34,55,0.618,8,21,0.381,22,30,0.733,114,2013-12-14,CLE,MIA
3916,16,@,L 107-124 ,240,40,84,0.476,34,69,0.493,6,15,0.4,21,25,0.84,107,47,81,0.58,32,56,0.571,15,25,0.6,15,18,0.833,124,2013-12-18,SAC,ATL
3917,17,@,W 107-106 ,240,41,88,0.466,31,61,0.508,10,27,0.37,15,20,0.75,107,40,81,0.494,34,63,0.54,6,18,0.333,20,22,0.909,106,2013-12-18,DET,BOS
3918,18,Home,L 107-113 ,240,39,74,0.527,30,53,0.566,9,21,0.429,20,24,0.833,107,38,88,0.432,26,68,0.382,12,20,0.6,25,30,0.833,113,2013-12-18,BRK,WAS
3919,19,@,W 107-101 (2OT),290,38,101,0.376,21,60,0.35,17,41,0.415,14,19,0.737,107,34,82,0.415,26,60,0.433,8,22,0.364,25,35,0.714,101,2013-12-18,NYK,MIL
3920,20,Home,W 107-95 ,240,43,84,0.512,34,69,0.493,9,15,0.6,12,14,0.857,107,29,77,0.377,21,48,0.438,8,29,0.276,29,39,0.744,95,2013-12-19,OKC,CHI
3921,21,@,L 107-110 ,240,44,94,0.468,38,77,0.494,6,17,0.353,13,19,0.684,107,43,98,0.439,35,69,0.507,8,29,0.276,16,18,0.889,110,2013-12-21,NOP,POR
3922,22,Home,L 107-116 ,240,39,85,0.459,34,68,0.5,5,17,0.294,24,31,0.774,107,37,75,0.493,30,59,0.508,7,16,0.438,35,42,0.833,116,2013-12-26,DAL,SAS
3923,23,Home,W 107-98 ,240,38,77,0.494,32,51,0.627,6,26,0.231,25,32,0.781,107,41,93,0.441,31,71,0.437,10,22,0.455,6,8,0.75,98,2013-12-28,HOU,NOP
3924,24,Home,L 107-108 ,240,39,77,0.506,28,51,0.549,11,26,0.423,18,21,0.857,107,45,88,0.511,37,74,0.5,8,14,0.571,10,11,0.909,108,2013-12-28,POR,MIA
3925,25,@,W 107-88 ,240,41,85,0.482,29,54,0.537,12,31,0.387,13,22,0.591,107,31,85,0.365,24,65,0.369,7,20,0.35,19,26,0.731,88,2013-12-30,PHO,LAC
3926,26,Home,W 107-88 ,240,40,78,0.513,31,51,0.608,9,27,0.333,18,23,0.783,107,36,77,0.468,33,68,0.485,3,9,0.333,13,17,0.765,88,2014-01-07,MIA,NOP
3927,27,@,W 107-90 ,240,41,78,0.526,27,50,0.54,14,28,0.5,11,16,0.688,107,36,80,0.45,33,73,0.452,3,7,0.429,15,19,0.789,90,2014-01-10,DAL,NOP
3928,28,@,L 107-110 ,240,37,77,0.481,29,58,0.5,8,19,0.421,25,31,0.806,107,30,67,0.448,19,40,0.475,11,27,0.407,39,45,0.867,110,2014-01-11,NOP,DAL
3929,29,Home,L 107-114 ,240,40,95,0.421,35,76,0.461,5,19,0.263,22,31,0.71,107,38,73,0.521,30,55,0.545,8,18,0.444,30,42,0.714,114,2014-01-11,WAS,HOU
3930,30,Home,W 107-88 ,240,40,79,0.506,27,52,0.519,13,27,0.481,14,15,0.933,107,34,76,0.447,27,52,0.519,7,24,0.292,13,16,0.813,88,2014-01-13,DAL,ORL
3931,31,@,W 107-104 ,240,37,74,0.5,25,54,0.463,12,20,0.6,21,28,0.75,107,44,99,0.444,37,76,0.487,7,23,0.304,9,11,0.818,104,2014-01-17,LAL,BOS
3932,32,Home,L 107-110 ,240,42,93,0.452,35,71,0.493,7,22,0.318,16,21,0.762,107,44,83,0.53,35,59,0.593,9,24,0.375,13,19,0.684,110,2014-01-17,PHO,DAL
3933,33,Home,W 107-99 ,240,37,84,0.44,32,66,0.485,5,18,0.278,28,35,0.8,107,37,88,0.42,33,70,0.471,4,18,0.222,21,31,0.677,99,2014-01-20,WAS,PHI
3934,34,Home,W 107-106 ,240,37,73,0.507,27,46,0.587,10,27,0.37,23,28,0.821,107,34,78,0.436,24,58,0.414,10,20,0.5,28,33,0.848,106,2014-01-24,BRK,DAL
3935,35,Home,W 107-103 ,240,38,80,0.475,36,61,0.59,2,19,0.105,29,36,0.806,107,38,75,0.507,31,54,0.574,7,21,0.333,20,23,0.87,103,2014-01-31,DAL,SAC
3936,36,@,L 107-124 ,240,37,80,0.463,29,56,0.518,8,24,0.333,25,33,0.758,107,44,80,0.55,32,54,0.593,12,26,0.462,24,26,0.923,124,2014-02-03,CLE,DAL
3937,37,@,W 107-89 ,240,39,82,0.476,28,55,0.509,11,27,0.407,18,20,0.9,107,31,87,0.356,25,62,0.403,6,25,0.24,21,21,1.0,89,2014-02-10,HOU,MIN
3938,38,@,W 107-103 ,240,39,88,0.443,31,60,0.517,8,28,0.286,21,24,0.875,107,40,83,0.482,30,55,0.545,10,28,0.357,13,22,0.591,103,2014-02-13,OKC,LAL
3939,39,Home,L 107-112 (OT),265,38,99,0.384,33,71,0.465,5,28,0.179,26,37,0.703,107,35,93,0.376,24,64,0.375,11,29,0.379,31,39,0.795,112,2014-02-18,DEN,PHO
3940,40,@,L 107-115 ,240,40,88,0.455,27,57,0.474,13,31,0.419,14,20,0.7,107,47,87,0.54,39,67,0.582,8,20,0.4,13,29,0.448,115,2014-02-21,ATL,DET
3941,41,Home,W 107-98 ,240,32,74,0.432,16,43,0.372,16,31,0.516,27,33,0.818,107,39,89,0.438,29,61,0.475,10,28,0.357,10,16,0.625,98,2014-02-22,ATL,NYK
3942,42,@,W 107-103 ,240,37,88,0.42,29,64,0.453,8,24,0.333,25,29,0.862,107,38,84,0.452,24,51,0.471,14,33,0.424,13,16,0.813,103,2014-02-25,CHI,ATL
3943,43,@,L 107-113 ,240,41,80,0.513,31,64,0.484,10,16,0.625,15,20,0.75,107,38,77,0.494,28,55,0.509,10,22,0.455,27,32,0.844,113,2014-02-28,MEM,OKC
3944,44,@,W 107-98 ,240,37,83,0.446,27,58,0.466,10,25,0.4,23,31,0.742,107,34,74,0.459,29,62,0.468,5,12,0.417,25,31,0.806,98,2014-03-01,BRK,MIL
3945,45,@,L 107-124 ,240,42,82,0.512,33,59,0.559,9,23,0.391,14,21,0.667,107,46,83,0.554,30,55,0.545,16,28,0.571,16,20,0.8,124,2014-03-03,CHA,MIA
3946,46,@,W 107-106 ,240,43,94,0.457,35,76,0.461,8,18,0.444,13,15,0.867,107,43,96,0.448,34,67,0.507,9,29,0.31,11,19,0.579,106,2014-03-03,LAL,POR
3947,47,@,W 107-97 ,240,38,88,0.432,24,57,0.421,14,31,0.452,17,23,0.739,107,36,87,0.414,27,64,0.422,9,23,0.391,16,18,0.889,97,2014-03-08,NYK,CLE
3948,48,Home,L 107-114 ,240,39,87,0.448,35,71,0.493,4,16,0.25,25,28,0.893,107,43,80,0.538,28,52,0.538,15,28,0.536,13,23,0.565,114,2014-03-08,MIL,WAS
3949,49,@,L 107-113 ,240,36,75,0.48,26,54,0.481,10,21,0.476,25,28,0.893,107,45,85,0.529,35,63,0.556,10,22,0.455,13,21,0.619,113,2014-03-09,PHO,GSW
3950,50,@,L 107-111 (OT),265,40,85,0.471,33,62,0.532,7,23,0.304,20,26,0.769,107,41,90,0.456,36,76,0.474,5,14,0.357,24,33,0.727,111,2014-03-09,DEN,NOP
3951,51,Home,L 107-111 ,240,42,81,0.519,35,57,0.614,7,24,0.292,16,21,0.762,107,39,82,0.476,31,61,0.508,8,21,0.381,25,29,0.862,111,2014-03-14,MIA,DEN
3952,52,@,W 107-100 ,240,36,86,0.419,27,64,0.422,9,22,0.409,26,32,0.813,107,36,67,0.537,32,54,0.593,4,13,0.308,24,32,0.75,100,2014-03-19,TOR,NOP
3953,53,Home,L 107-117 ,240,43,91,0.473,36,72,0.5,7,19,0.368,14,23,0.609,107,42,87,0.483,32,62,0.516,10,25,0.4,23,29,0.793,117,2014-03-21,LAL,WAS
3954,54,@,W 107-104 (OT),265,34,84,0.405,23,54,0.426,11,30,0.367,28,33,0.848,107,35,91,0.385,25,60,0.417,10,31,0.323,24,31,0.774,104,2014-03-23,BRK,DAL
3955,55,@,L 107-124 ,240,42,85,0.494,38,67,0.567,4,18,0.222,19,30,0.633,107,44,86,0.512,37,66,0.561,7,20,0.35,29,36,0.806,124,2014-03-23,MIL,SAC
3956,56,Home,W 107-83 ,240,43,86,0.5,34,64,0.531,9,22,0.409,12,16,0.75,107,31,82,0.378,24,54,0.444,7,28,0.25,14,16,0.875,83,2014-03-26,MIN,ATL
3957,57,@,W 107-99 ,240,40,73,0.548,25,47,0.532,15,26,0.577,12,13,0.923,107,33,69,0.478,27,52,0.519,6,17,0.353,27,35,0.771,99,2014-03-26,NYK,SAC
3958,58,@,L 107-143 ,240,44,102,0.431,37,77,0.481,7,25,0.28,12,15,0.8,107,51,76,0.671,43,58,0.741,8,18,0.444,33,40,0.825,143,2014-03-28,LAL,MIN
3959,59,Home,L 107-118 ,240,32,79,0.405,25,54,0.463,7,25,0.28,36,45,0.8,107,42,89,0.472,30,48,0.625,12,41,0.293,22,36,0.611,118,2014-03-29,HOU,LAC
3960,60,@,W 107-102 ,240,37,70,0.529,29,54,0.537,8,16,0.5,25,31,0.806,107,40,87,0.46,30,58,0.517,10,29,0.345,12,16,0.75,102,2014-03-30,CHI,BOS
3961,61,@,L 107-137 ,240,35,74,0.473,33,65,0.508,2,9,0.222,35,45,0.778,107,52,92,0.565,37,65,0.569,15,27,0.556,18,25,0.72,137,2014-04-02,NOP,DEN
3962,62,Home,W 107-102 ,240,42,86,0.488,37,71,0.521,5,15,0.333,18,27,0.667,107,37,96,0.385,25,68,0.368,12,28,0.429,16,20,0.8,102,2014-04-02,SAC,LAL
3963,63,Home,W 107-103 ,240,34,75,0.453,24,50,0.48,10,25,0.4,29,39,0.744,107,36,87,0.414,27,61,0.443,9,26,0.346,22,30,0.733,103,2014-04-02,TOR,HOU
3964,64,Home,L 107-113 ,240,39,91,0.429,33,64,0.516,6,27,0.222,23,29,0.793,107,41,82,0.5,27,53,0.509,14,29,0.483,17,20,0.85,113,2014-04-03,LAC,DAL
3965,65,@,L 107-111 ,240,38,85,0.447,25,54,0.463,13,31,0.419,18,20,0.9,107,33,78,0.423,20,47,0.426,13,31,0.419,32,37,0.865,111,2014-04-04,OKC,HOU
3966,66,@,W 107-95 ,240,44,92,0.478,39,71,0.549,5,21,0.238,14,15,0.933,107,35,83,0.422,28,55,0.509,7,28,0.25,18,24,0.75,95,2014-04-04,DAL,LAL
3967,67,@,W 107-88 ,240,41,73,0.562,29,46,0.63,12,27,0.444,13,17,0.765,107,32,78,0.41,27,58,0.466,5,20,0.25,19,30,0.633,88,2014-04-06,ATL,IND
3968,68,@,W 107-92 ,240,38,80,0.475,26,58,0.448,12,22,0.545,19,27,0.704,107,34,82,0.415,31,68,0.456,3,14,0.214,21,28,0.75,92,2014-04-08,OKC,SAC
3969,69,@,W 107-101 ,240,38,90,0.422,33,69,0.478,5,21,0.238,26,32,0.813,107,36,86,0.419,28,59,0.475,8,27,0.296,21,34,0.618,101,2014-04-09,OKC,LAC
3970,70,Home,W 107-102 ,240,43,78,0.551,36,58,0.621,7,20,0.35,14,21,0.667,107,38,73,0.521,23,48,0.479,15,25,0.6,11,12,0.917,102,2014-04-09,MEM,MIA
3971,71,Home,L 107-116 ,240,35,84,0.417,30,64,0.469,5,20,0.25,32,48,0.667,107,39,81,0.481,30,58,0.517,9,23,0.391,29,35,0.829,116,2014-04-13,DET,TOR
3972,72,Home,W 107-95 ,240,39,81,0.481,30,53,0.566,9,28,0.321,20,23,0.87,107,36,75,0.48,30,56,0.536,6,19,0.316,17,24,0.708,95,2014-10-29,MIA,WAS
3973,73,Home,W 107-102 ,240,35,70,0.5,26,46,0.565,9,24,0.375,28,38,0.737,107,37,79,0.468,33,63,0.524,4,16,0.25,24,39,0.615,102,2014-11-02,MIA,TOR
3974,74,Home,W 107-101 ,240,41,81,0.506,31,58,0.534,10,23,0.435,15,17,0.882,107,36,77,0.468,26,50,0.52,10,27,0.37,19,24,0.792,101,2014-11-03,LAC,UTA
3975,75,Home,L 107-110 ,240,40,78,0.513,30,52,0.577,10,26,0.385,17,18,0.944,107,42,87,0.483,35,71,0.493,7,16,0.438,19,23,0.826,110,2014-11-05,BOS,TOR
3976,76,Home,W 107-92 ,240,42,82,0.512,36,65,0.554,6,17,0.353,17,22,0.773,107,35,79,0.443,32,65,0.492,3,14,0.214,19,27,0.704,92,2014-11-09,LAL,CHO
3977,77,Home,W 107-95 ,240,34,79,0.43,22,49,0.449,12,30,0.4,27,33,0.818,107,33,69,0.478,22,45,0.489,11,24,0.458,18,21,0.857,95,2014-11-09,PHO,GSW
3978,78,Home,W 107-102 ,240,41,78,0.526,37,67,0.552,4,11,0.364,21,26,0.808,107,41,87,0.471,34,65,0.523,7,22,0.318,13,17,0.765,102,2014-11-11,MEM,LAL
3979,79,Home,W 107-103 ,240,40,83,0.482,37,72,0.514,3,11,0.273,24,33,0.727,107,38,81,0.469,29,59,0.492,9,22,0.409,18,22,0.818,103,2014-11-12,WAS,DET
3980,80,Home,W 107-99 ,240,41,90,0.456,30,56,0.536,11,34,0.324,14,21,0.667,107,39,89,0.438,36,73,0.493,3,16,0.188,18,20,0.9,99,2014-11-13,GSW,BRK
3981,81,@,L 107-120 ,240,38,99,0.384,27,69,0.391,11,30,0.367,20,23,0.87,107,36,68,0.529,22,39,0.564,14,29,0.483,34,43,0.791,120,2014-11-15,PHO,LAC
3982,82,@,W 107-80 ,240,43,84,0.512,33,56,0.589,10,28,0.357,11,16,0.688,107,32,80,0.4,22,58,0.379,10,22,0.455,6,13,0.462,80,2014-11-17,DAL,CHO
3983,83,@,W 107-93 ,240,41,79,0.519,28,53,0.528,13,26,0.5,12,15,0.8,107,32,80,0.4,21,56,0.375,11,24,0.458,18,24,0.75,93,2014-11-17,ORL,DET
3984,84,Home,W 107-100 ,240,40,82,0.488,30,53,0.566,10,29,0.345,17,22,0.773,107,36,79,0.456,26,56,0.464,10,23,0.435,18,25,0.72,100,2014-11-19,DEN,OKC
3985,85,Home,W 107-91 ,240,42,85,0.494,35,64,0.547,7,21,0.333,16,23,0.696,107,32,77,0.416,25,52,0.481,7,25,0.28,20,28,0.714,91,2014-11-23,MEM,LAC
3986,86,Home,W 107-93 ,240,39,86,0.453,27,53,0.509,12,33,0.364,17,25,0.68,107,39,90,0.433,37,81,0.457,2,9,0.222,13,20,0.65,93,2014-11-30,POR,MIN
3987,87,Home,W 107-86 ,240,39,72,0.542,29,53,0.547,10,19,0.526,19,24,0.792,107,33,72,0.458,31,50,0.62,2,22,0.091,18,30,0.6,86,2014-12-01,WAS,MIA
3988,88,@,W 107-105 ,240,42,92,0.457,34,65,0.523,8,27,0.296,15,22,0.682,107,38,73,0.521,31,62,0.5,7,11,0.636,22,32,0.688,105,2014-12-03,DAL,MIL
3989,89,@,W 107-101 ,240,40,84,0.476,26,59,0.441,14,25,0.56,13,16,0.813,107,37,80,0.463,32,68,0.471,5,12,0.417,22,26,0.846,101,2014-12-05,SAS,MEM
3990,90,@,L 107-112 (OT),265,43,104,0.413,33,74,0.446,10,30,0.333,11,15,0.733,107,41,81,0.506,32,48,0.667,9,33,0.273,21,29,0.724,112,2014-12-08,DEN,TOR
3991,91,@,L 107-112 ,240,40,88,0.455,33,70,0.471,7,18,0.389,20,24,0.833,107,44,83,0.53,35,62,0.565,9,21,0.429,15,17,0.882,112,2014-12-10,NOP,DAL
3992,92,@,L 107-113 (2OT),290,41,98,0.418,35,81,0.432,6,17,0.353,19,27,0.704,107,39,85,0.459,33,72,0.458,6,13,0.462,29,38,0.763,113,2014-12-12,CHA,MEM
3993,93,@,W 107-87 ,240,42,83,0.506,27,50,0.54,15,33,0.455,8,8,1.0,107,37,84,0.44,32,63,0.508,5,21,0.238,8,10,0.8,87,2014-12-16,DAL,NYK
3994,94,Home,L 107-108 ,240,38,67,0.567,32,53,0.604,6,14,0.429,25,33,0.758,107,37,75,0.493,24,52,0.462,13,23,0.565,21,27,0.778,108,2014-12-18,SAC,MIL
3995,95,Home,W 107-104 ,240,34,76,0.447,22,53,0.415,12,23,0.522,27,35,0.771,107,37,92,0.402,26,63,0.413,11,29,0.379,19,28,0.679,104,2014-12-23,ATL,LAC
3996,96,@,W 107-77 ,240,40,79,0.506,32,60,0.533,8,19,0.421,19,23,0.826,107,31,76,0.408,27,53,0.509,4,23,0.174,11,14,0.786,77,2014-12-26,MIL,ATL
3997,97,Home,L 107-109 ,240,45,87,0.517,36,63,0.571,9,24,0.375,8,11,0.727,107,41,83,0.494,34,62,0.548,7,21,0.333,20,28,0.714,109,2014-12-26,BOS,BRK
3998,98,Home,W 107-100 ,240,41,89,0.461,35,69,0.507,6,20,0.3,19,22,0.864,107,41,88,0.466,37,74,0.5,4,14,0.286,14,16,0.875,100,2014-12-27,CHI,NOP
3999,99,@,L 107-112 ,240,45,90,0.5,40,76,0.526,5,14,0.357,12,21,0.571,107,39,88,0.443,29,57,0.509,10,31,0.323,24,28,0.857,112,2014-12-28,OKC,DAL
4000,0,Home,L 107-116 ,240,42,81,0.519,30,61,0.492,12,20,0.6,11,20,0.55,107,44,87,0.506,35,65,0.538,9,22,0.409,19,24,0.792,116,2014-12-28,LAL,PHO
4001,1,Home,W 107-99 ,240,36,80,0.45,28,59,0.475,8,21,0.381,27,39,0.692,107,37,76,0.487,28,56,0.5,9,20,0.45,16,20,0.8,99,2014-12-29,BRK,SAC
4002,2,Home,L 107-110 ,240,42,91,0.462,35,67,0.522,7,24,0.292,16,22,0.727,107,40,74,0.541,35,62,0.565,5,12,0.417,25,29,0.862,110,2015-01-01,MIN,SAC
4003,3,Home,L 107-115 ,240,42,93,0.452,29,60,0.483,13,33,0.394,10,12,0.833,107,43,84,0.512,37,67,0.552,6,17,0.353,23,31,0.742,115,2015-01-03,POR,ATL
4004,4,@,W 107-98 ,240,36,81,0.444,23,54,0.426,13,27,0.481,22,33,0.667,107,33,74,0.446,26,49,0.531,7,25,0.28,25,33,0.758,98,2015-01-05,ATL,LAC
4005,5,Home,W 107-103 (OT),265,34,92,0.37,25,69,0.362,9,23,0.391,30,34,0.882,107,41,103,0.398,31,69,0.449,10,34,0.294,11,16,0.688,103,2015-01-09,IND,BOS
4006,6,Home,W 107-100 ,240,40,76,0.526,33,56,0.589,7,20,0.35,20,27,0.741,107,36,82,0.439,23,47,0.489,13,35,0.371,15,20,0.75,100,2015-01-13,PHO,CLE
4007,7,@,L 107-114 ,240,41,100,0.41,32,63,0.508,9,37,0.243,16,20,0.8,107,41,82,0.5,37,63,0.587,4,19,0.211,28,35,0.8,114,2015-01-14,DAL,DEN
4008,8,@,W 107-99 ,240,40,84,0.476,29,58,0.5,11,26,0.423,16,21,0.762,107,37,80,0.463,28,54,0.519,9,26,0.346,16,20,0.8,99,2015-01-17,ATL,CHI
4009,9,Home,W 107-89 ,240,38,88,0.432,23,53,0.434,15,35,0.429,16,19,0.842,107,38,82,0.463,31,54,0.574,7,28,0.25,6,7,0.857,89,2015-01-17,DET,PHI
4010,10,Home,W 107-96 ,240,39,86,0.453,29,59,0.492,10,27,0.37,19,25,0.76,107,35,79,0.443,24,54,0.444,11,25,0.44,15,31,0.484,96,2015-02-06,BOS,PHI
4011,11,@,L 107-123 ,240,38,78,0.487,32,55,0.582,6,23,0.261,25,31,0.806,107,40,75,0.533,27,45,0.6,13,30,0.433,30,37,0.811,123,2015-02-06,LAC,TOR
4012,12,@,W 107-72 ,240,43,84,0.512,33,62,0.532,10,22,0.455,11,13,0.846,107,32,86,0.372,28,69,0.406,4,17,0.235,4,7,0.571,72,2015-02-07,CHI,NOP
4013,13,@,L 107-112 ,240,47,88,0.534,37,63,0.587,10,25,0.4,3,8,0.375,107,43,89,0.483,31,65,0.477,12,24,0.5,14,16,0.875,112,2015-02-21,PHO,CHI
4014,14,Home,L 107-114 ,240,42,79,0.532,37,61,0.607,5,18,0.278,18,21,0.857,107,45,90,0.5,33,67,0.493,12,23,0.522,12,17,0.706,114,2015-02-24,WAS,GSW
4015,15,@,W 107-96 ,240,35,88,0.398,27,65,0.415,8,23,0.348,29,32,0.906,107,38,79,0.481,37,75,0.493,1,4,0.25,19,23,0.826,96,2015-02-27,SAS,SAC
4016,16,@,L 107-117 ,240,43,97,0.443,35,71,0.493,8,26,0.308,13,18,0.722,107,41,85,0.482,30,67,0.448,11,18,0.611,24,30,0.8,117,2015-03-10,TOR,SAS
4017,17,Home,W 107-87 ,240,40,80,0.5,35,63,0.556,5,17,0.294,22,31,0.71,107,31,80,0.388,28,61,0.459,3,19,0.158,22,30,0.733,87,2015-03-12,WAS,MEM
4018,18,@,L 107-114 ,240,35,87,0.402,31,73,0.425,4,14,0.286,33,40,0.825,107,45,95,0.474,36,63,0.571,9,32,0.281,15,23,0.652,114,2015-03-13,SAC,PHI
4019,19,Home,W 107-94 ,240,39,78,0.5,28,51,0.549,11,27,0.407,18,27,0.667,107,38,89,0.427,32,67,0.478,6,22,0.273,12,17,0.706,94,2015-03-17,HOU,ORL
4020,20,Home,W 107-102 ,240,39,80,0.488,26,49,0.531,13,31,0.419,16,24,0.667,107,40,87,0.46,31,59,0.525,9,28,0.321,13,14,0.929,102,2015-03-18,DAL,ORL
4021,21,Home,W 107-91 ,240,44,90,0.489,33,64,0.516,11,26,0.423,8,10,0.8,107,33,77,0.429,27,56,0.482,6,21,0.286,19,24,0.792,91,2015-03-21,DET,CHI
4022,22,Home,W 107-100 ,240,42,91,0.462,35,68,0.515,7,23,0.304,16,23,0.696,107,38,75,0.507,26,53,0.491,12,22,0.545,12,16,0.75,100,2015-03-22,LAC,NOP
4023,23,Home,W 107-76 ,240,39,95,0.411,26,62,0.419,13,33,0.394,16,21,0.762,107,27,81,0.333,24,70,0.343,3,11,0.273,19,26,0.731,76,2015-03-23,GSW,WAS
4024,24,Home,W 107-106 ,240,35,97,0.361,28,77,0.364,7,20,0.35,30,38,0.789,107,40,81,0.494,27,53,0.509,13,28,0.464,13,21,0.619,106,2015-03-24,SAC,PHI
4025,25,@,L 107-111 ,240,30,71,0.423,16,41,0.39,14,30,0.467,33,43,0.767,107,39,73,0.534,30,54,0.556,9,19,0.474,24,34,0.706,111,2015-03-26,IND,MIL
4026,26,Home,W 107-91 ,240,39,76,0.513,26,52,0.5,13,24,0.542,16,23,0.696,107,32,81,0.395,27,54,0.5,5,27,0.185,22,31,0.71,91,2015-03-27,DEN,UTA
4027,27,@,W 107-84 ,240,39,90,0.433,23,59,0.39,16,31,0.516,13,17,0.765,107,34,76,0.447,29,63,0.46,5,13,0.385,11,15,0.733,84,2015-03-27,GSW,MEM
4028,28,@,L 107-110 (2OT),290,36,104,0.346,28,79,0.354,8,25,0.32,27,35,0.771,107,44,113,0.389,35,88,0.398,9,25,0.36,13,22,0.591,110,2015-03-27,CHA,WAS
4029,29,Home,W 107-99 ,240,42,87,0.483,34,59,0.576,8,28,0.286,15,21,0.714,107,42,91,0.462,36,73,0.493,6,18,0.333,9,11,0.818,99,2015-03-29,BRK,LAL
4030,30,Home,W 107-106 ,240,43,93,0.462,33,67,0.493,10,26,0.385,11,17,0.647,107,42,90,0.467,37,71,0.521,5,19,0.263,17,26,0.654,106,2015-04-02,GSW,PHO
4031,31,@,W 107-77 ,240,43,88,0.489,33,62,0.532,10,26,0.385,11,11,1.0,107,31,82,0.378,26,68,0.382,5,14,0.357,10,17,0.588,77,2015-04-03,POR,LAL
4032,32,@,W 107-92 ,240,34,79,0.43,21,45,0.467,13,34,0.382,26,42,0.619,107,32,85,0.376,26,63,0.413,6,22,0.273,22,31,0.71,92,2015-04-04,LAC,DEN
4033,33,Home,W 107-92 ,240,44,83,0.53,37,62,0.597,7,21,0.333,12,15,0.8,107,39,91,0.429,30,63,0.476,9,28,0.321,5,10,0.5,92,2015-04-05,SAS,GSW
4034,34,Home,W 107-104 ,240,45,94,0.479,41,76,0.539,4,18,0.222,13,16,0.813,107,40,82,0.488,32,57,0.561,8,25,0.32,16,19,0.842,104,2015-04-08,DAL,PHO
4035,35,@,W 107-103 ,240,38,79,0.481,27,60,0.45,11,19,0.579,20,22,0.909,107,40,89,0.449,29,66,0.439,11,23,0.478,12,23,0.522,103,2015-04-10,IND,DET
4036,36,@,L 107-114 ,240,37,89,0.416,24,48,0.5,13,41,0.317,20,25,0.8,107,40,90,0.444,31,64,0.484,9,26,0.346,25,36,0.694,114,2015-04-11,PHI,CHI
4037,37,@,W 107-104 ,240,35,83,0.422,26,57,0.456,9,26,0.346,28,37,0.757,107,37,81,0.457,31,61,0.508,6,20,0.3,24,44,0.545,104,2015-04-11,TOR,MIA
4038,38,Home,W 107-91 ,240,35,69,0.507,27,50,0.54,8,19,0.421,29,34,0.853,107,35,85,0.412,31,69,0.449,4,16,0.25,17,23,0.739,91,2015-04-12,SAS,PHO
4039,39,@,L 107-111 ,240,41,98,0.418,36,83,0.434,5,15,0.333,20,25,0.8,107,39,74,0.527,26,50,0.52,13,24,0.542,20,27,0.741,111,2015-04-13,MEM,GSW
4040,40,@,W 107-97 ,240,40,81,0.494,36,72,0.5,4,9,0.444,23,36,0.639,107,32,81,0.395,26,53,0.491,6,28,0.214,27,34,0.794,97,2015-04-13,MIL,PHI
4041,41,@,W 107-100 ,240,42,81,0.519,34,59,0.576,8,22,0.364,15,20,0.75,107,38,85,0.447,31,61,0.508,7,24,0.292,17,23,0.739,100,2015-11-02,CLE,PHI
4042,42,Home,W 107-98 ,240,40,84,0.476,31,60,0.517,9,24,0.375,18,22,0.818,107,39,86,0.453,30,58,0.517,9,28,0.321,11,13,0.846,98,2015-11-07,DAL,NOP
4043,43,Home,L 107-117 ,240,44,86,0.512,31,55,0.564,13,31,0.419,6,7,0.857,107,46,80,0.575,39,65,0.6,7,15,0.467,18,22,0.818,117,2015-11-09,ATL,MIN
4044,44,Home,W 107-98 ,240,37,81,0.457,28,61,0.459,9,20,0.45,24,32,0.75,107,33,77,0.429,24,48,0.5,9,29,0.31,23,31,0.742,98,2015-11-13,DEN,HOU
4045,45,Home,W 107-103 ,240,41,86,0.477,31,61,0.508,10,25,0.4,15,23,0.652,107,42,83,0.506,35,63,0.556,7,20,0.35,12,13,0.923,103,2015-11-13,IND,MIN
4046,46,Home,W 107-99 (OT),265,43,97,0.443,31,63,0.492,12,34,0.353,9,10,0.9,107,41,98,0.418,39,80,0.488,2,18,0.111,15,16,0.938,99,2015-11-14,GSW,BRK
4047,47,Home,W 107-101 ,240,39,76,0.513,29,51,0.569,10,25,0.4,19,24,0.792,107,38,87,0.437,23,56,0.411,15,31,0.484,10,14,0.714,101,2015-11-15,SAC,TOR
4048,48,Home,L 107-114 ,240,41,90,0.456,36,66,0.545,5,24,0.208,20,26,0.769,107,40,79,0.506,25,52,0.481,15,27,0.556,19,25,0.76,114,2015-11-20,DEN,PHO
4049,49,@,W 107-102 ,240,34,80,0.425,22,55,0.4,12,25,0.48,27,34,0.794,107,35,81,0.432,23,53,0.434,12,28,0.429,20,28,0.714,102,2015-11-21,NYK,HOU
4050,50,@,W 107-93 ,240,43,87,0.494,35,62,0.565,8,25,0.32,13,17,0.765,107,32,88,0.364,26,70,0.371,6,18,0.333,23,27,0.852,93,2015-11-22,POR,LAL
4051,51,Home,W 107-99 ,240,39,75,0.52,31,53,0.585,8,22,0.364,21,33,0.636,107,37,82,0.451,29,66,0.439,8,16,0.5,17,21,0.81,99,2015-11-29,LAC,MIN
4052,52,@,W 107-103 ,240,34,83,0.41,25,56,0.446,9,27,0.333,30,37,0.811,107,38,99,0.384,27,66,0.409,11,33,0.333,16,22,0.727,103,2015-11-29,IND,LAL
4053,53,@,W 107-102 ,240,40,94,0.426,29,67,0.433,11,27,0.407,16,20,0.8,107,38,86,0.442,26,57,0.456,12,29,0.414,14,17,0.824,102,2015-11-29,PHO,TOR
4054,54,Home,W 107-104 ,240,41,80,0.513,35,56,0.625,6,24,0.25,19,27,0.704,107,40,85,0.471,28,60,0.467,12,25,0.48,12,16,0.75,104,2015-12-09,PHO,ORL
4055,55,Home,W 107-94 ,240,39,80,0.488,30,63,0.476,9,17,0.529,20,26,0.769,107,35,78,0.449,25,50,0.5,10,28,0.357,14,23,0.609,94,2015-12-10,OKC,ATL
4056,56,Home,W 107-105 ,240,39,79,0.494,23,52,0.442,16,27,0.593,13,18,0.722,107,40,80,0.5,28,53,0.528,12,27,0.444,13,21,0.619,105,2015-12-11,NOP,WAS
4057,57,@,W 107-95 ,240,43,93,0.462,33,66,0.5,10,27,0.37,11,16,0.688,107,36,80,0.45,30,62,0.484,6,18,0.333,17,24,0.708,95,2015-12-11,DET,PHI
4058,58,Home,W 107-97 ,240,38,75,0.507,27,51,0.529,11,24,0.458,20,29,0.69,107,34,82,0.415,22,43,0.512,12,39,0.308,17,23,0.739,97,2015-12-15,SAC,HOU
4059,59,Home,W 107-81 ,240,43,89,0.483,32,60,0.533,11,29,0.379,10,17,0.588,107,33,90,0.367,25,57,0.439,8,33,0.242,7,10,0.7,81,2015-12-16,IND,DAL
4060,60,Home,W 107-102 ,240,37,85,0.435,29,64,0.453,8,21,0.381,25,30,0.833,107,42,101,0.416,38,80,0.475,4,21,0.19,14,14,1.0,102,2015-12-16,NYK,MIN
4061,61,@,W 107-87 ,240,34,88,0.386,22,57,0.386,12,31,0.387,27,42,0.643,107,36,84,0.429,31,60,0.517,5,24,0.208,10,18,0.556,87,2015-12-17,HOU,LAL
4062,62,@,W 107-97 ,240,40,85,0.471,34,66,0.515,6,19,0.316,21,28,0.75,107,37,77,0.481,31,53,0.585,6,24,0.25,17,30,0.567,97,2015-12-18,NYK,PHI
4063,63,@,L 107-115 ,240,36,72,0.5,26,48,0.542,10,24,0.417,25,40,0.625,107,43,87,0.494,33,68,0.485,10,19,0.526,19,24,0.792,115,2015-12-18,LAC,SAS
4064,64,Home,W 107-97 ,240,34,76,0.447,26,51,0.51,8,25,0.32,31,49,0.633,107,34,86,0.395,23,48,0.479,11,38,0.289,18,29,0.621,97,2015-12-19,HOU,LAC
4065,65,Home,W 107-91 ,240,41,82,0.5,36,62,0.581,5,20,0.25,20,24,0.833,107,37,94,0.394,32,73,0.438,5,21,0.238,12,17,0.706,91,2015-12-19,NYK,CHI
4066,66,@,W 107-99 ,240,44,86,0.512,34,64,0.531,10,22,0.455,9,11,0.818,107,39,76,0.513,32,52,0.615,7,24,0.292,14,16,0.875,99,2015-12-21,ORL,NYK
4067,67,Home,L 107-111 ,240,41,90,0.456,32,65,0.492,9,25,0.36,16,19,0.842,107,40,84,0.476,33,58,0.569,7,26,0.269,24,32,0.75,111,2015-12-22,DEN,LAL
4068,68,Home,W 107-100 ,240,43,89,0.483,37,69,0.536,6,20,0.3,15,20,0.75,107,38,89,0.427,31,68,0.456,7,21,0.333,17,33,0.515,100,2015-12-23,ATL,DET
4069,69,@,W 107-101 ,240,40,84,0.476,35,66,0.53,5,18,0.278,22,24,0.917,107,37,87,0.425,22,48,0.458,15,39,0.385,12,19,0.632,101,2016-01-05,NYK,ATL
4070,70,Home,W 107-103 (OT),265,39,89,0.438,25,51,0.49,14,38,0.368,15,23,0.652,107,43,90,0.478,34,59,0.576,9,31,0.29,8,10,0.8,103,2016-01-10,HOU,IND
4071,71,Home,L 107-110 (OT),265,39,79,0.494,28,51,0.549,11,28,0.393,18,22,0.818,107,40,97,0.412,23,53,0.434,17,44,0.386,13,16,0.813,110,2016-01-12,DAL,CLE
4072,72,@,W 107-91 ,240,33,77,0.429,15,42,0.357,18,35,0.514,23,27,0.852,107,33,72,0.458,26,54,0.481,7,18,0.389,18,24,0.75,91,2016-01-12,HOU,MEM
4073,73,Home,W 107-84 ,240,36,82,0.439,23,43,0.535,13,39,0.333,22,26,0.846,107,30,81,0.37,23,56,0.411,7,25,0.28,17,21,0.81,84,2016-01-13,CHA,ATL
4074,74,Home,W 107-104 ,240,37,75,0.493,30,45,0.667,7,30,0.233,26,38,0.684,107,36,78,0.462,28,61,0.459,8,17,0.471,24,30,0.8,104,2016-01-13,HOU,MIN
4075,75,@,L 107-109 ,240,42,86,0.488,28,51,0.549,14,35,0.4,9,12,0.75,107,43,87,0.494,31,60,0.517,12,27,0.444,11,13,0.846,109,2016-01-15,CHA,NOP
4076,76,@,L 107-114 ,240,41,84,0.488,37,68,0.544,4,16,0.25,21,23,0.913,107,45,89,0.506,34,58,0.586,11,31,0.355,13,20,0.65,114,2016-01-25,MIN,CLE
4077,77,Home,W 107-100 ,240,38,77,0.494,33,64,0.516,5,13,0.385,26,31,0.839,107,33,80,0.413,20,56,0.357,13,24,0.542,21,29,0.724,100,2016-01-26,MIL,ORL
4078,78,@,L 107-127 ,240,44,87,0.506,33,56,0.589,11,31,0.355,8,12,0.667,107,47,81,0.58,33,52,0.635,14,29,0.483,19,21,0.905,127,2016-01-27,DAL,GSW
4079,79,@,W 107-103 ,240,37,74,0.5,30,56,0.536,7,18,0.389,26,32,0.813,107,38,80,0.475,36,68,0.529,2,12,0.167,25,28,0.893,103,2016-01-29,MIA,MIL
4080,80,@,L 107-111 ,240,39,87,0.448,30,58,0.517,9,29,0.31,20,34,0.588,107,36,78,0.462,32,64,0.5,4,14,0.286,35,47,0.745,111,2016-01-30,DET,TOR
4081,81,Home,W 107-92 ,240,40,78,0.513,31,54,0.574,9,24,0.375,18,21,0.857,107,39,96,0.406,34,79,0.43,5,17,0.294,9,11,0.818,92,2016-02-01,SAS,ORL
4082,82,Home,W 107-95 ,240,39,85,0.459,28,54,0.519,11,31,0.355,18,25,0.72,107,38,86,0.442,33,72,0.458,5,14,0.357,14,24,0.583,95,2016-02-02,POR,MIL
4083,83,@,W 107-102 ,240,40,88,0.455,29,67,0.433,11,21,0.524,16,21,0.762,107,42,88,0.477,36,68,0.529,6,20,0.3,12,19,0.632,102,2016-02-03,CHI,SAC
4084,84,@,W 107-93 ,240,40,74,0.541,32,47,0.681,8,27,0.296,19,23,0.826,107,34,81,0.42,30,61,0.492,4,20,0.2,21,28,0.75,93,2016-02-05,LAC,ORL
4085,85,@,L 107-112 ,240,42,87,0.483,38,72,0.528,4,15,0.267,19,25,0.76,107,41,84,0.488,36,61,0.59,5,23,0.217,25,33,0.758,112,2016-02-25,MIL,BOS
4086,86,Home,L 107-117 ,240,34,78,0.436,22,54,0.407,12,24,0.5,27,37,0.73,107,43,89,0.483,34,60,0.567,9,29,0.31,22,26,0.846,117,2016-02-26,SAC,LAC
4087,87,Home,W 107-101 ,240,41,83,0.494,30,57,0.526,11,26,0.423,14,21,0.667,107,39,89,0.438,34,71,0.479,5,18,0.278,18,27,0.667,101,2016-03-01,LAL,BRK
4088,88,@,L 107-117 ,240,35,79,0.443,24,48,0.5,11,31,0.355,26,32,0.813,107,38,78,0.487,26,55,0.473,12,23,0.522,29,38,0.763,117,2016-03-02,LAL,DEN
4089,89,@,W 107-97 ,240,40,89,0.449,30,62,0.484,10,27,0.37,17,20,0.85,107,34,79,0.43,22,47,0.468,12,32,0.375,17,28,0.607,97,2016-03-05,ATL,LAC
4090,90,Home,L 107-113 ,240,37,77,0.481,25,44,0.568,12,33,0.364,21,27,0.778,107,38,78,0.487,25,49,0.51,13,29,0.448,24,37,0.649,113,2016-03-06,TOR,HOU
4091,91,Home,W 107-98 ,240,40,81,0.494,31,54,0.574,9,27,0.333,18,23,0.783,107,37,76,0.487,32,57,0.561,5,19,0.263,19,27,0.704,98,2016-03-08,LAL,ORL
4092,92,@,W 107-100 ,240,41,79,0.519,37,64,0.578,4,15,0.267,21,34,0.618,107,35,88,0.398,27,63,0.429,8,25,0.32,22,25,0.88,100,2016-03-11,ORL,SAC
4093,93,@,W 107-96 ,240,42,87,0.483,33,57,0.579,9,30,0.3,14,18,0.778,107,32,76,0.421,22,46,0.478,10,30,0.333,22,34,0.647,96,2016-03-14,DAL,CHO
4094,94,@,L 107-125 ,240,35,93,0.376,28,68,0.412,7,25,0.28,30,34,0.882,107,47,81,0.58,35,56,0.625,12,25,0.48,19,23,0.826,125,2016-03-14,NOP,GSW
4095,95,Home,W 107-104 ,240,40,95,0.421,29,60,0.483,11,35,0.314,16,20,0.8,107,37,84,0.44,33,68,0.485,4,16,0.25,26,30,0.867,104,2016-03-14,PHO,MIN
4096,96,Home,L 107-109 ,240,37,83,0.446,31,63,0.492,6,20,0.3,27,31,0.871,107,41,83,0.494,32,58,0.552,9,25,0.36,18,20,0.9,109,2016-03-14,TOR,CHI
4097,97,@,W 107-89 ,240,39,83,0.47,25,53,0.472,14,30,0.467,15,17,0.882,107,34,77,0.442,32,64,0.5,2,13,0.154,19,26,0.731,89,2016-03-15,TOR,MIL
4098,98,Home,W 107-99 ,240,40,100,0.4,29,63,0.46,11,37,0.297,16,21,0.762,107,35,83,0.422,24,58,0.414,11,25,0.44,18,21,0.857,99,2016-03-16,CHA,ORL
4099,99,Home,W 107-96 ,240,40,85,0.471,33,63,0.524,7,22,0.318,20,24,0.833,107,39,93,0.419,34,74,0.459,5,19,0.263,13,19,0.684,96,2016-03-21,BOS,ORL
4100,0,Home,W 107-100 ,240,39,77,0.506,33,58,0.569,6,19,0.316,23,24,0.958,107,40,80,0.5,36,65,0.554,4,15,0.267,16,23,0.696,100,2016-03-22,LAL,MEM
4101,1,@,L 107-111 ,240,40,92,0.435,27,55,0.491,13,37,0.351,14,17,0.824,107,41,91,0.451,33,56,0.589,8,35,0.229,21,29,0.724,111,2016-03-22,HOU,OKC
4102,2,Home,L 107-115 ,240,38,82,0.463,23,50,0.46,15,32,0.469,16,21,0.762,107,45,87,0.517,31,62,0.5,14,25,0.56,11,15,0.733,115,2016-03-23,CHI,NYK
4103,3,@,L 107-119 ,240,39,93,0.419,32,66,0.485,7,27,0.259,22,26,0.846,107,47,93,0.505,34,65,0.523,13,28,0.464,12,20,0.6,119,2016-03-23,LAL,PHO
4104,4,@,W 107-93 ,240,37,83,0.446,23,49,0.469,14,34,0.412,19,25,0.76,107,33,79,0.418,25,56,0.446,8,23,0.348,19,28,0.679,93,2016-03-26,CLE,NYK
4105,5,Home,W 107-87 ,240,38,87,0.437,26,49,0.531,12,38,0.316,19,24,0.792,107,35,94,0.372,31,73,0.425,4,21,0.19,13,21,0.619,87,2016-03-31,CLE,BRK
4106,6,@,W 107-100 ,240,41,91,0.451,33,61,0.541,8,30,0.267,17,22,0.773,107,37,90,0.411,31,69,0.449,6,21,0.286,20,29,0.69,100,2016-04-03,BOS,LAL
4107,7,@,L 107-119 ,240,41,89,0.461,33,68,0.485,8,21,0.381,17,26,0.654,107,43,90,0.478,33,64,0.516,10,26,0.385,23,29,0.793,119,2016-04-03,MEM,ORL
4108,8,Home,W 107-89 ,240,44,84,0.524,35,70,0.5,9,14,0.643,10,14,0.714,107,32,80,0.4,27,58,0.466,5,22,0.227,20,25,0.8,89,2016-04-05,MIA,DET
4109,9,Home,W 107-93 ,240,40,88,0.455,27,54,0.5,13,34,0.382,14,17,0.824,107,37,82,0.451,30,64,0.469,7,18,0.389,12,16,0.75,93,2016-04-05,PHI,NOP
4110,10,Home,L 107-115 ,240,41,78,0.526,30,56,0.536,11,22,0.5,14,21,0.667,107,40,93,0.43,28,62,0.452,12,31,0.387,23,27,0.852,115,2016-04-05,SAC,POR
4111,11,@,L 107-118 ,240,40,90,0.444,29,62,0.468,11,28,0.393,16,24,0.667,107,46,88,0.523,29,55,0.527,17,33,0.515,9,11,0.818,118,2016-04-09,BOS,ATL
4112,12,Home,W 107-98 ,240,41,84,0.488,34,61,0.557,7,23,0.304,18,28,0.643,107,41,78,0.526,38,63,0.603,3,15,0.2,13,19,0.684,98,2016-04-11,ORL,MIL
4113,13,Home,W 107-99 ,240,39,89,0.438,28,53,0.528,11,36,0.306,18,22,0.818,107,40,94,0.426,33,69,0.478,7,25,0.28,12,18,0.667,99,2016-04-13,POR,DEN
4114,14,@,W 107-96 ,240,40,89,0.449,33,66,0.5,7,23,0.304,20,24,0.833,107,39,92,0.424,36,76,0.474,3,16,0.188,15,20,0.75,96,2016-10-26,CHA,MIL
4115,15,@,W 107-102 ,240,37,83,0.446,29,59,0.492,8,24,0.333,25,33,0.758,107,38,92,0.413,35,73,0.479,3,19,0.158,23,26,0.885,102,2016-10-26,DEN,NOP
4116,16,Home,W 107-100 ,240,41,87,0.471,27,55,0.491,14,32,0.438,11,17,0.647,107,35,81,0.432,28,61,0.459,7,20,0.35,23,31,0.742,100,2016-11-02,BOS,CHI
4117,17,@,L 107-125 ,240,38,81,0.469,28,58,0.483,10,23,0.435,21,27,0.778,107,47,82,0.573,35,55,0.636,12,27,0.444,19,24,0.792,125,2016-11-03,IND,MIL
4118,18,Home,L 107-123 ,240,41,90,0.456,33,65,0.508,8,25,0.32,17,21,0.81,107,44,84,0.524,33,61,0.541,11,23,0.478,24,31,0.774,123,2016-11-06,BOS,DEN
4119,19,@,L 107-108 ,240,35,70,0.5,25,46,0.543,10,24,0.417,27,34,0.794,107,44,86,0.512,37,62,0.597,7,24,0.292,13,19,0.684,108,2016-11-08,DEN,MEM
4120,20,@,L 107-115 ,240,41,91,0.451,32,64,0.5,9,27,0.333,16,21,0.762,107,42,83,0.506,33,63,0.524,9,20,0.45,22,27,0.815,115,2016-11-09,CHI,ATL
4121,21,Home,L 107-123 ,240,38,85,0.447,30,61,0.492,8,24,0.333,23,30,0.767,107,45,87,0.517,32,64,0.5,13,23,0.565,20,26,0.769,123,2016-11-09,ORL,MIN
4122,22,Home,W 107-100 ,240,38,84,0.452,30,62,0.484,8,22,0.364,23,30,0.767,107,32,89,0.36,23,67,0.343,9,22,0.409,27,32,0.844,100,2016-11-09,PHO,DET
4123,23,@,L 107-118 ,240,44,97,0.454,37,74,0.5,7,23,0.304,12,16,0.75,107,39,83,0.47,32,61,0.525,7,22,0.318,33,38,0.868,118,2016-11-12,NYK,TOR
4124,24,Home,W 107-100 ,240,35,72,0.486,25,40,0.625,10,32,0.313,27,31,0.871,107,39,98,0.398,31,66,0.47,8,32,0.25,14,18,0.778,100,2016-11-16,ATL,MIL
4125,25,Home,L 107-111 ,240,37,81,0.457,28,56,0.5,9,25,0.36,24,34,0.706,107,40,82,0.488,25,56,0.446,15,26,0.577,16,19,0.842,111,2016-11-16,LAC,MEM
4126,26,Home,L 107-116 ,240,39,87,0.448,27,62,0.435,12,25,0.48,17,21,0.81,107,44,78,0.564,34,54,0.63,10,24,0.417,18,19,0.947,116,2016-11-18,LAL,SAS
4127,27,@,L 107-110 ,240,43,95,0.453,37,77,0.481,6,18,0.333,15,18,0.833,107,43,100,0.43,33,78,0.423,10,22,0.455,14,17,0.824,110,2016-11-22,CHI,DEN
4128,28,Home,W 107-103 ,240,45,96,0.469,36,67,0.537,9,29,0.31,8,8,1.0,107,38,86,0.442,32,64,0.5,6,22,0.273,21,26,0.808,103,2016-11-22,NYK,POR
4129,29,Home,W 107-84 ,240,40,81,0.494,34,62,0.548,6,19,0.316,21,25,0.84,107,27,75,0.36,20,49,0.408,7,26,0.269,23,30,0.767,84,2016-11-23,DET,MIA
4130,30,Home,W 107-102 ,240,35,80,0.438,27,58,0.466,8,22,0.364,29,42,0.69,107,37,98,0.378,25,66,0.379,12,32,0.375,16,20,0.8,102,2016-11-26,CHA,NYK
4131,31,Home,L 107-110 ,240,40,81,0.494,29,50,0.58,11,31,0.355,16,24,0.667,107,37,73,0.507,28,48,0.583,9,25,0.36,27,33,0.818,110,2016-11-26,MIA,MEM
4132,32,@,L 107-109 ,240,45,89,0.506,36,64,0.563,9,25,0.36,8,10,0.8,107,40,89,0.449,30,68,0.441,10,21,0.476,19,25,0.76,109,2016-11-30,ATL,PHO
4133,33,Home,W 107-105 ,240,39,80,0.488,31,60,0.517,8,20,0.4,21,33,0.636,107,41,81,0.506,34,70,0.486,7,11,0.636,16,18,0.889,105,2016-12-02,SAS,WAS
4134,34,Home,W 107-82 ,240,40,87,0.46,27,56,0.482,13,31,0.419,14,18,0.778,107,32,71,0.451,29,58,0.5,3,13,0.231,15,21,0.714,82,2016-12-03,DAL,CHI
4135,35,@,W 107-106 ,240,38,76,0.5,30,50,0.6,8,26,0.308,23,29,0.793,107,35,76,0.461,20,43,0.465,15,33,0.455,21,26,0.808,106,2016-12-03,BOS,PHI
4136,36,Home,W 107-106 ,240,34,76,0.447,22,38,0.579,12,38,0.316,27,31,0.871,107,42,99,0.424,31,67,0.463,11,32,0.344,11,12,0.917,106,2016-12-05,HOU,BOS
4137,37,@,W 107-101 ,240,38,80,0.475,25,48,0.521,13,32,0.406,18,29,0.621,107,39,87,0.448,34,73,0.466,5,14,0.357,18,23,0.783,101,2016-12-05,UTA,LAL
4138,38,@,L 107-115 ,240,37,85,0.435,20,45,0.444,17,40,0.425,16,19,0.842,107,40,77,0.519,30,53,0.566,10,24,0.417,25,37,0.676,115,2016-12-07,POR,MIL
4139,39,Home,W 107-97 ,240,33,86,0.384,22,51,0.431,11,35,0.314,30,40,0.75,107,35,91,0.385,29,64,0.453,6,27,0.222,21,34,0.618,97,2016-12-14,BRK,LAL
4140,40,@,W 107-92 ,240,39,74,0.527,34,58,0.586,5,16,0.313,24,26,0.923,107,34,85,0.4,24,58,0.414,10,27,0.37,14,18,0.778,92,2016-12-15,SAS,PHO
4141,41,@,W 107-99 ,240,43,88,0.489,31,61,0.508,12,27,0.444,9,13,0.692,107,40,86,0.465,30,60,0.5,10,26,0.385,9,16,0.563,99,2016-12-17,CHA,ATL
4142,42,@,L 107-108 ,240,36,81,0.444,24,47,0.511,12,34,0.353,23,31,0.742,107,38,88,0.432,26,60,0.433,12,28,0.429,20,23,0.87,108,2016-12-18,BRK,PHI
4143,43,@,L 107-117 ,240,43,81,0.531,29,56,0.518,14,25,0.56,7,9,0.778,107,45,79,0.57,32,55,0.582,13,24,0.542,14,18,0.778,117,2016-12-19,DAL,DEN
4144,44,Home,W 107-105 ,240,41,87,0.471,34,66,0.515,7,21,0.333,18,21,0.857,107,38,88,0.432,30,55,0.545,8,33,0.242,21,26,0.808,105,2016-12-19,IND,WAS
4145,45,@,W 107-97 ,240,43,82,0.524,40,64,0.625,3,18,0.167,18,25,0.72,107,38,95,0.4,32,74,0.432,6,21,0.286,15,19,0.789,97,2016-12-21,WAS,CHI
4146,46,@,L 107-115 ,240,40,90,0.444,26,52,0.5,14,38,0.368,13,15,0.867,107,45,84,0.536,34,62,0.548,11,22,0.5,14,21,0.667,115,2016-12-22,LAL,MIA
4147,47,Home,W 107-102 ,240,40,79,0.506,28,50,0.56,12,29,0.414,15,20,0.75,107,40,85,0.471,34,64,0.531,6,21,0.286,16,23,0.696,102,2016-12-26,WAS,MIL
4148,48,Home,L 107-123 ,240,36,87,0.414,21,49,0.429,15,38,0.395,20,25,0.8,107,41,78,0.526,24,46,0.522,17,32,0.531,24,28,0.857,123,2016-12-27,DAL,HOU
4149,49,@,W 107-98 ,240,42,86,0.488,33,64,0.516,9,22,0.409,14,22,0.636,107,35,77,0.455,21,51,0.412,14,26,0.538,14,18,0.778,98,2017-01-01,DET,MIA
4150,50,@,W 107-102 ,240,35,72,0.486,23,44,0.523,12,28,0.429,25,29,0.862,107,40,78,0.513,32,58,0.552,8,20,0.4,14,17,0.824,102,2017-01-04,MIA,SAC
4151,51,@,W 107-101 ,240,41,84,0.488,31,52,0.596,10,32,0.313,15,18,0.833,107,37,80,0.463,28,57,0.491,9,23,0.391,18,20,0.9,101,2017-01-08,WAS,MIL
4152,52,Home,W 107-95 ,240,39,86,0.453,28,59,0.475,11,27,0.407,18,22,0.818,107,38,90,0.422,32,60,0.533,6,30,0.2,13,17,0.765,95,2017-01-10,GSW,MIA
4153,53,Home,L 107-109 ,240,42,88,0.477,30,58,0.517,12,30,0.4,11,14,0.786,107,44,84,0.524,34,65,0.523,10,19,0.526,11,13,0.846,109,2017-01-10,SAS,MIL
4154,54,@,L 107-127 ,240,43,88,0.489,37,60,0.617,6,28,0.214,15,20,0.75,107,50,89,0.562,35,60,0.583,15,29,0.517,12,18,0.667,127,2017-01-12,DET,GSW
4155,55,Home,W 107-99 ,240,43,101,0.426,35,81,0.432,8,20,0.4,13,23,0.565,107,39,84,0.464,32,61,0.525,7,23,0.304,14,21,0.667,99,2017-01-14,CHI,NOP
4156,56,@,L 107-114 ,240,38,82,0.463,26,48,0.542,12,34,0.353,19,27,0.704,107,41,83,0.494,34,57,0.596,7,26,0.269,25,36,0.694,114,2017-01-14,ORL,UTA
4157,57,Home,L 107-108 ,240,42,85,0.494,34,59,0.576,8,26,0.308,15,23,0.652,107,40,87,0.46,28,55,0.509,12,32,0.375,16,23,0.696,108,2017-01-16,NYK,ATL
4158,58,Home,W 107-85 ,240,41,87,0.471,30,61,0.492,11,26,0.423,14,17,0.824,107,33,94,0.351,25,63,0.397,8,31,0.258,11,11,1.0,85,2017-01-18,CHA,POR
4159,59,Home,L 107-112 (OT),265,39,87,0.448,31,64,0.484,8,23,0.348,21,28,0.75,107,38,82,0.463,30,59,0.508,8,23,0.348,28,39,0.718,112,2017-01-20,DAL,UTA
4160,60,Home,W 107-91 ,240,38,83,0.458,27,55,0.491,11,28,0.393,20,25,0.8,107,31,76,0.408,25,47,0.532,6,29,0.207,23,32,0.719,91,2017-01-20,MEM,SAC
4161,61,@,W 107-105 ,240,37,85,0.435,28,61,0.459,9,24,0.375,24,27,0.889,107,40,89,0.449,29,68,0.426,11,21,0.524,14,16,0.875,105,2017-01-21,PHO,NYK
4162,62,@,L 107-110 ,240,40,90,0.444,27,53,0.509,13,37,0.351,14,15,0.933,107,46,96,0.479,37,69,0.536,9,27,0.333,9,13,0.692,110,2017-01-27,CHA,NYK
4163,63,Home,W 107-91 ,240,41,92,0.446,33,63,0.524,8,29,0.276,17,22,0.773,107,37,100,0.37,31,74,0.419,6,26,0.231,11,16,0.688,91,2017-01-29,CLE,OKC
4164,64,@,W 107-94 ,240,45,89,0.506,35,68,0.515,10,21,0.476,7,10,0.7,107,38,84,0.452,28,52,0.538,10,32,0.313,8,15,0.533,94,2017-01-29,WAS,NOP
4165,65,@,L 107-113 ,240,37,94,0.394,23,56,0.411,14,38,0.368,19,26,0.731,107,39,82,0.476,26,47,0.553,13,35,0.371,22,28,0.786,113,2017-02-03,LAL,BOS
4166,66,@,W 107-99 ,240,32,77,0.416,22,49,0.449,10,28,0.357,33,39,0.846,107,35,84,0.417,25,58,0.431,10,26,0.385,19,24,0.792,99,2017-02-04,MEM,MIN
4167,67,Home,W 107-102 ,240,37,88,0.42,21,36,0.583,16,52,0.308,17,20,0.85,107,35,84,0.417,25,55,0.455,10,29,0.345,22,28,0.786,102,2017-02-05,BOS,LAC
4168,68,Home,L 107-121 ,240,37,82,0.451,30,61,0.492,7,21,0.333,26,33,0.788,107,44,102,0.431,36,74,0.486,8,28,0.286,25,31,0.806,121,2017-02-06,NYK,LAL
4169,69,Home,L 107-112 ,240,41,79,0.519,30,51,0.588,11,28,0.393,14,16,0.875,107,43,81,0.531,37,62,0.597,6,19,0.316,20,31,0.645,112,2017-02-06,SAC,CHI
4170,70,@,L 107-111 ,240,39,86,0.453,27,50,0.54,12,36,0.333,17,21,0.81,107,40,102,0.392,33,76,0.434,7,26,0.269,24,29,0.828,111,2017-02-07,BRK,CHO
4171,71,@,W 107-95 ,240,39,87,0.448,26,47,0.553,13,40,0.325,16,20,0.8,107,37,85,0.435,29,59,0.492,8,26,0.308,13,14,0.929,95,2017-02-09,HOU,CHO
4172,72,Home,L 107-122 ,240,34,87,0.391,25,61,0.41,9,26,0.346,30,37,0.811,107,39,77,0.506,24,44,0.545,15,33,0.455,29,38,0.763,122,2017-02-10,MEM,GSW
4173,73,@,L 107-108 ,240,36,71,0.507,25,41,0.61,11,30,0.367,24,31,0.774,107,38,80,0.475,20,44,0.455,18,36,0.5,14,21,0.667,108,2017-02-10,ATL,SAC
4174,74,@,L 107-112 ,240,45,92,0.489,41,71,0.577,4,21,0.19,13,15,0.867,107,41,88,0.466,31,59,0.525,10,29,0.345,20,30,0.667,112,2017-02-10,IND,WAS
4175,75,@,W 107-102 ,240,40,85,0.471,26,51,0.51,14,34,0.412,13,20,0.65,107,37,85,0.435,24,48,0.5,13,37,0.351,15,20,0.75,102,2017-02-11,LAC,CHO
4176,76,Home,L 107-116 ,240,39,83,0.47,33,61,0.541,6,22,0.273,23,27,0.852,107,44,90,0.489,36,76,0.474,8,14,0.571,20,29,0.69,116,2017-02-13,MIA,ORL
4177,77,@,W 107-79 ,240,42,89,0.472,34,58,0.586,8,31,0.258,15,19,0.789,107,30,76,0.395,26,58,0.448,4,18,0.222,15,19,0.789,79,2017-02-15,SAS,ORL
4178,78,Home,W 107-97 ,240,40,81,0.494,35,66,0.53,5,15,0.333,22,29,0.759,107,33,78,0.423,21,40,0.525,12,38,0.316,19,22,0.864,97,2017-02-24,TOR,BOS
4179,79,Home,L 107-125 ,240,44,96,0.458,34,70,0.486,10,26,0.385,9,10,0.9,107,45,80,0.563,32,50,0.64,13,30,0.433,22,24,0.917,125,2017-02-28,CHI,DEN
4180,80,@,W 107-80 ,240,39,78,0.5,31,62,0.5,8,16,0.5,21,26,0.808,107,35,90,0.389,31,71,0.437,4,19,0.211,6,11,0.545,80,2017-03-01,MIN,UTA
4181,81,Home,W 107-91 ,240,42,86,0.488,37,66,0.561,5,20,0.25,18,20,0.9,107,35,83,0.422,26,59,0.441,9,24,0.375,12,18,0.667,91,2017-03-08,MIN,LAC
4182,82,Home,W 106-104 ,240,35,74,0.473,26,54,0.481,9,20,0.45,27,34,0.794,106,39,76,0.513,37,71,0.521,2,5,0.4,24,31,0.774,104,2011-12-25,NYK,BOS
4183,83,@,W 106-70 ,240,38,86,0.442,26,63,0.413,12,23,0.522,18,21,0.857,106,22,71,0.31,17,47,0.362,5,24,0.208,21,26,0.808,70,2011-12-27,ATL,NJN
4184,84,Home,W 106-96 ,240,41,71,0.577,29,50,0.58,12,21,0.571,12,15,0.8,106,36,82,0.439,29,62,0.468,7,20,0.35,17,21,0.81,96,2012-01-02,MIN,SAS
4185,85,@,W 106-101 ,240,42,78,0.538,33,57,0.579,9,21,0.429,13,19,0.684,106,36,77,0.468,25,55,0.455,11,22,0.5,18,21,0.857,101,2012-01-09,ATL,NJN
4186,86,@,L 106-111 (OT),265,39,85,0.459,37,74,0.5,2,11,0.182,26,40,0.65,106,38,95,0.4,29,68,0.426,9,27,0.333,26,30,0.867,111,2012-01-10,MIA,GSW
4187,87,Home,W 106-103 ,240,44,85,0.518,35,71,0.493,9,14,0.643,9,10,0.9,106,45,75,0.6,41,61,0.672,4,14,0.286,9,16,0.563,103,2012-01-10,MIL,SAS
4188,88,@,W 106-96 ,240,44,85,0.518,40,73,0.548,4,12,0.333,14,20,0.7,106,32,75,0.427,26,59,0.441,6,16,0.375,26,39,0.667,96,2012-01-15,UTA,DEN
4189,89,Home,L 106-114 ,240,39,80,0.488,36,69,0.522,3,11,0.273,25,32,0.781,106,42,87,0.483,37,71,0.521,5,16,0.313,25,26,0.962,114,2012-01-16,WAS,HOU
4190,90,Home,L 106-111 (2OT),290,39,90,0.433,35,72,0.486,4,18,0.222,24,36,0.667,106,43,96,0.448,33,68,0.485,10,28,0.357,15,19,0.789,111,2012-01-25,UTA,TOR
4191,91,@,W 106-101 ,240,40,79,0.506,32,60,0.533,8,19,0.421,18,23,0.783,106,40,104,0.385,35,83,0.422,5,21,0.238,16,23,0.696,101,2012-01-29,LAL,MIN
4192,92,@,W 106-85 ,240,45,88,0.511,37,71,0.521,8,17,0.471,8,11,0.727,106,31,64,0.484,21,41,0.512,10,23,0.435,13,29,0.448,85,2012-01-29,IND,ORL
4193,93,Home,W 106-99 ,240,38,73,0.521,34,62,0.548,4,11,0.364,26,36,0.722,106,35,74,0.473,23,45,0.511,12,29,0.414,17,23,0.739,99,2012-01-31,IND,NJN
4194,94,Home,W 106-73 ,240,42,76,0.553,30,50,0.6,12,26,0.462,10,11,0.909,106,31,89,0.348,29,80,0.363,2,9,0.222,9,13,0.692,73,2012-01-31,LAL,CHA
4195,95,Home,W 106-89 ,240,42,93,0.452,39,80,0.488,3,13,0.231,19,28,0.679,106,33,87,0.379,28,68,0.412,5,19,0.263,18,25,0.72,89,2012-02-03,TOR,WAS
4196,96,@,L 106-114 (OT),265,39,90,0.433,23,61,0.377,16,29,0.552,12,13,0.923,106,43,98,0.439,33,76,0.434,10,22,0.455,18,21,0.857,114,2012-02-04,GSW,SAC
4197,97,Home,W 106-101 ,240,40,99,0.404,33,79,0.418,7,20,0.35,19,26,0.731,106,37,77,0.481,30,59,0.508,7,18,0.389,20,26,0.769,101,2012-02-09,SAC,OKC
4198,98,@,W 106-89 ,240,40,81,0.494,35,66,0.53,5,15,0.333,21,23,0.913,106,34,89,0.382,30,68,0.441,4,21,0.19,17,28,0.607,89,2012-02-10,MIA,WAS
4199,99,Home,W 106-97 ,240,40,79,0.506,27,55,0.491,13,24,0.542,13,18,0.722,106,31,75,0.413,20,46,0.435,11,29,0.379,24,33,0.727,97,2012-02-12,GSW,HOU
4200,0,Home,L 106-113 ,240,47,86,0.547,44,75,0.587,3,11,0.273,9,14,0.643,106,41,76,0.539,33,57,0.579,8,19,0.421,23,25,0.92,113,2012-02-15,TOR,SAS
4201,1,@,W 106-102 ,240,36,78,0.462,26,57,0.456,10,21,0.476,24,30,0.8,106,40,84,0.476,37,76,0.487,3,8,0.375,19,23,0.826,102,2012-02-20,SAS,UTA
4202,2,@,W 106-104 ,240,39,84,0.464,30,64,0.469,9,20,0.45,19,22,0.864,106,43,90,0.478,39,71,0.549,4,19,0.211,14,20,0.7,104,2012-02-22,GSW,PHO
4203,3,@,W 106-104 ,240,43,83,0.518,38,67,0.567,5,16,0.313,15,17,0.882,106,42,88,0.477,37,73,0.507,5,15,0.333,15,19,0.789,104,2012-03-07,CHI,MIL
4204,4,Home,W 106-94 ,240,37,78,0.474,24,55,0.436,13,23,0.565,19,26,0.731,106,44,93,0.473,41,70,0.586,3,23,0.13,3,4,0.75,94,2012-03-07,MIN,POR
4205,5,Home,W 106-101 ,240,43,92,0.467,36,66,0.545,7,26,0.269,13,19,0.684,106,32,81,0.395,24,60,0.4,8,21,0.381,29,37,0.784,101,2012-03-07,WAS,LAL
4206,6,Home,L 106-112 ,240,43,81,0.531,34,57,0.596,9,24,0.375,11,14,0.786,106,46,82,0.561,37,66,0.561,9,16,0.563,11,14,0.786,112,2012-03-10,BRK,HOU
4207,7,@,W 106-94 ,240,40,79,0.506,35,70,0.5,5,9,0.556,21,26,0.808,106,33,80,0.413,26,63,0.413,7,17,0.412,21,26,0.808,94,2012-03-11,PHI,NYK
4208,8,@,W 106-99 ,240,42,82,0.512,35,61,0.574,7,21,0.333,15,23,0.652,106,38,82,0.463,28,53,0.528,10,29,0.345,13,17,0.765,99,2012-03-11,ATL,SAC
4209,9,Home,W 106-102 ,240,36,77,0.468,26,58,0.448,10,19,0.526,24,26,0.923,106,38,85,0.447,32,73,0.438,6,12,0.5,20,23,0.87,102,2012-03-14,CHI,MIA
4210,10,Home,W 106-99 ,240,37,79,0.468,26,55,0.473,11,24,0.458,21,25,0.84,106,39,79,0.494,28,55,0.509,11,24,0.458,10,18,0.556,99,2012-03-17,DAL,SAS
4211,11,Home,W 106-87 ,240,39,81,0.481,34,65,0.523,5,16,0.313,23,33,0.697,106,33,69,0.478,31,56,0.554,2,13,0.154,19,22,0.864,87,2012-03-20,NYK,TOR
4212,12,@,L 106-113 (OT),265,41,96,0.427,36,78,0.462,5,18,0.278,19,26,0.731,106,43,89,0.483,39,69,0.565,4,20,0.2,23,27,0.852,113,2012-03-26,SAC,HOU
4213,13,Home,W 106-85 ,240,39,80,0.488,34,63,0.54,5,17,0.294,23,27,0.852,106,33,78,0.423,24,54,0.444,9,24,0.375,10,13,0.769,85,2012-03-29,MIA,DAL
4214,14,@,L 106-119 ,240,36,78,0.462,31,57,0.544,5,21,0.238,29,35,0.829,106,46,88,0.523,37,60,0.617,9,28,0.321,18,20,0.9,119,2012-04-01,MIN,POR
4215,15,Home,L 106-109 (OT),265,42,97,0.433,39,85,0.459,3,12,0.25,19,25,0.76,106,40,89,0.449,34,71,0.479,6,18,0.333,23,33,0.697,109,2012-04-21,IND,PHI
4216,16,Home,W 106-95 ,240,38,84,0.452,34,71,0.479,4,13,0.308,26,37,0.703,106,40,86,0.465,36,74,0.486,4,12,0.333,11,15,0.733,95,2012-04-21,MIL,NJN
4217,17,@,L 106-114 (2OT),290,37,101,0.366,29,77,0.377,8,24,0.333,24,28,0.857,106,41,106,0.387,36,90,0.4,5,16,0.313,27,40,0.675,114,2012-04-22,OKC,LAL
4218,18,@,W 106-101 ,240,40,90,0.444,32,67,0.478,8,23,0.348,18,30,0.6,106,39,79,0.494,29,55,0.527,10,24,0.417,13,15,0.867,101,2012-04-25,DEN,OKC
4219,19,Home,L 106-110 ,240,45,94,0.479,40,81,0.494,5,13,0.385,11,13,0.846,106,41,88,0.466,33,66,0.5,8,22,0.364,20,23,0.87,110,2012-04-25,PHO,SAS
4220,20,Home,W 106-89 ,240,45,85,0.529,36,58,0.621,9,27,0.333,7,9,0.778,106,33,78,0.423,28,63,0.444,5,15,0.333,18,23,0.783,89,2012-04-26,ATL,DAL
4221,21,@,L 106-116 ,240,36,72,0.5,28,54,0.519,8,18,0.444,26,32,0.813,106,42,83,0.506,33,63,0.524,9,20,0.45,23,28,0.821,116,2012-10-31,LAL,POR
4222,22,Home,W 106-92 ,240,39,76,0.513,34,67,0.507,5,9,0.556,23,32,0.719,106,32,89,0.36,23,63,0.365,9,26,0.346,19,24,0.792,92,2012-11-02,OKC,POR
4223,23,Home,W 106-98 (2OT),290,39,99,0.394,35,77,0.455,4,22,0.182,24,27,0.889,106,37,102,0.363,29,80,0.363,8,22,0.364,16,20,0.8,98,2012-11-03,IND,SAC
4224,24,Home,W 106-96 ,240,42,78,0.538,37,60,0.617,5,18,0.278,17,23,0.739,106,36,86,0.419,25,54,0.463,11,32,0.344,13,21,0.619,96,2012-11-07,GSW,CLE
4225,25,Home,W 106-84 ,240,46,83,0.554,40,66,0.606,6,17,0.353,8,9,0.889,106,30,73,0.411,22,50,0.44,8,23,0.348,16,24,0.667,84,2012-11-07,LAC,SAS
4226,26,@,W 106-100 ,240,40,82,0.488,33,69,0.478,7,13,0.538,19,23,0.826,106,37,76,0.487,33,66,0.5,4,10,0.4,22,31,0.71,100,2012-11-09,PHI,BOS
4227,27,Home,W 106-91 ,240,40,73,0.548,33,58,0.569,7,15,0.467,19,22,0.864,106,34,83,0.41,27,60,0.45,7,23,0.304,16,23,0.696,91,2012-11-11,OKC,CLE
4228,28,Home,L 106-112 (OT),265,42,105,0.4,36,84,0.429,6,21,0.286,16,17,0.941,106,44,88,0.5,38,76,0.5,6,12,0.5,18,25,0.72,112,2012-11-14,PHO,CHI
4229,29,Home,L 106-110 ,240,44,82,0.537,42,74,0.568,2,8,0.25,16,20,0.8,106,44,89,0.494,37,72,0.514,7,17,0.412,15,17,0.882,110,2012-11-16,DET,ORL
4230,30,@,W 106-98 ,240,43,85,0.506,41,70,0.586,2,15,0.133,18,26,0.692,106,34,79,0.43,27,61,0.443,7,18,0.389,23,29,0.793,98,2012-11-16,GSW,MIN
4231,31,Home,W 106-98 ,240,40,85,0.471,31,61,0.508,9,24,0.375,17,19,0.895,106,37,82,0.451,33,66,0.5,4,16,0.25,20,29,0.69,98,2012-11-20,PHI,TOR
4232,32,@,L 106-113 (OT),265,46,109,0.422,41,80,0.513,5,29,0.172,9,12,0.75,106,41,86,0.477,33,68,0.485,8,18,0.444,23,33,0.697,113,2012-11-21,MIL,MIA
4233,33,Home,W 106-98 ,240,38,75,0.507,32,64,0.5,6,11,0.545,24,30,0.8,106,33,74,0.446,21,47,0.447,12,27,0.444,20,24,0.833,98,2012-11-23,MEM,LAL
4234,34,Home,L 106-108 (2OT),290,34,93,0.366,28,66,0.424,6,27,0.222,32,39,0.821,106,34,83,0.41,22,55,0.4,12,28,0.429,28,36,0.778,108,2012-11-24,WAS,CHA
4235,35,Home,L 106-111 (2OT),290,40,110,0.364,34,86,0.395,6,24,0.25,20,24,0.833,106,44,103,0.427,36,76,0.474,8,27,0.296,15,19,0.789,111,2012-11-25,TOR,SAS
4236,36,Home,W 106-105 ,240,44,86,0.512,36,68,0.529,8,18,0.444,10,13,0.769,106,38,84,0.452,28,63,0.444,10,21,0.476,19,24,0.792,105,2012-11-29,GSW,DEN
4237,37,Home,W 106-94 ,240,39,75,0.52,35,66,0.53,4,9,0.444,24,33,0.727,106,38,92,0.413,31,69,0.449,7,23,0.304,11,12,0.917,94,2012-11-30,OKC,UTA
4238,38,Home,W 106-99 ,240,40,90,0.444,28,61,0.459,12,29,0.414,14,17,0.824,106,39,80,0.488,31,57,0.544,8,23,0.348,13,19,0.684,99,2012-12-02,NYK,PHO
4239,39,Home,W 106-90 ,240,40,69,0.58,33,58,0.569,7,11,0.636,19,24,0.792,106,35,78,0.449,27,60,0.45,8,18,0.444,12,13,0.923,90,2012-12-08,MIA,NOH
4240,40,@,L 106-112 ,240,40,72,0.556,35,55,0.636,5,17,0.294,21,29,0.724,106,37,86,0.43,25,56,0.446,12,30,0.4,26,37,0.703,112,2012-12-09,DEN,NYK
4241,41,@,L 106-114 (OT),265,39,84,0.464,32,70,0.457,7,14,0.5,21,25,0.84,106,41,94,0.436,35,71,0.493,6,23,0.261,26,32,0.813,114,2012-12-15,DAL,MIN
4242,42,@,L 106-112 ,240,38,95,0.4,24,59,0.407,14,36,0.389,16,18,0.889,106,38,87,0.437,31,68,0.456,7,19,0.368,29,42,0.69,112,2012-12-18,SAS,DEN
4243,43,Home,L 106-110 ,240,38,91,0.418,30,65,0.462,8,26,0.308,22,25,0.88,106,37,83,0.446,29,65,0.446,8,18,0.444,28,33,0.848,110,2012-12-21,NYK,CHI
4244,44,Home,W 106-77 ,240,41,85,0.482,29,55,0.527,12,30,0.4,12,24,0.5,106,29,72,0.403,23,56,0.411,6,16,0.375,13,15,0.867,77,2012-12-27,LAC,BOS
4245,45,@,W 106-85 ,240,43,94,0.457,31,66,0.47,12,28,0.429,8,14,0.571,106,33,88,0.375,28,63,0.444,5,25,0.2,14,21,0.667,85,2012-12-28,DEN,DAL
4246,46,Home,W 106-105 ,240,39,86,0.453,24,56,0.429,15,30,0.5,13,17,0.765,106,41,83,0.494,30,53,0.566,11,30,0.367,12,20,0.6,105,2012-12-28,SAC,NYK
4247,47,Home,W 106-84 ,240,43,87,0.494,39,75,0.52,4,12,0.333,16,19,0.842,106,29,84,0.345,27,67,0.403,2,17,0.118,24,30,0.8,84,2013-01-02,UTA,MIN
4248,48,@,W 106-104 ,240,39,78,0.5,32,62,0.516,7,16,0.438,21,29,0.724,106,37,82,0.451,29,65,0.446,8,17,0.471,22,28,0.786,104,2013-01-04,CLE,CHA
4249,49,Home,L 106-114 ,240,41,85,0.482,31,59,0.525,10,26,0.385,14,18,0.778,106,42,88,0.477,30,55,0.545,12,33,0.364,18,22,0.818,114,2013-01-05,ORL,NYK
4250,50,Home,W 106-84 ,240,36,76,0.474,25,56,0.446,11,20,0.55,23,27,0.852,106,31,72,0.431,28,60,0.467,3,12,0.25,19,24,0.792,84,2013-01-09,OKC,MIN
4251,51,Home,W 106-88 ,240,45,80,0.563,37,59,0.627,8,21,0.381,8,11,0.727,106,33,89,0.371,29,73,0.397,4,16,0.25,18,23,0.783,88,2013-01-13,SAS,MIN
4252,52,@,L 106-113 ,240,40,82,0.488,33,69,0.478,7,13,0.538,19,23,0.826,106,40,81,0.494,32,60,0.533,8,21,0.381,25,28,0.893,113,2013-01-15,TOR,BRK
4253,53,@,W 106-100 ,240,37,79,0.468,33,67,0.493,4,12,0.333,28,38,0.737,106,37,79,0.468,26,48,0.542,11,31,0.355,15,21,0.714,100,2013-01-18,CHA,ORL
4254,54,Home,W 106-99 ,240,39,75,0.52,27,53,0.509,12,22,0.545,16,18,0.889,106,38,83,0.458,27,53,0.509,11,30,0.367,12,22,0.545,99,2013-01-21,GSW,LAC
4255,55,Home,W 106-93 ,240,47,96,0.49,43,83,0.518,4,13,0.308,8,10,0.8,106,31,73,0.425,24,56,0.429,7,17,0.412,24,32,0.75,93,2013-01-23,MEM,LAL
4256,56,@,W 106-96 ,240,43,90,0.478,37,71,0.521,6,19,0.316,14,16,0.875,106,38,79,0.481,33,68,0.485,5,11,0.455,15,24,0.625,96,2013-01-23,PHO,SAC
4257,57,Home,W 106-102 ,240,43,80,0.538,35,55,0.636,8,25,0.32,12,23,0.522,106,38,81,0.469,28,64,0.438,10,17,0.588,16,23,0.696,102,2013-01-23,SAS,NOH
4258,58,@,L 106-119 ,240,36,80,0.45,20,44,0.455,16,36,0.444,18,21,0.857,106,43,87,0.494,31,59,0.525,12,28,0.429,21,27,0.778,119,2013-01-26,BRK,HOU
4259,59,Home,W 106-104 ,240,39,72,0.542,23,45,0.511,16,27,0.593,12,17,0.706,106,39,65,0.6,29,42,0.69,10,23,0.435,16,20,0.8,104,2013-01-27,NYK,ATL
4260,60,@,L 106-111 ,240,39,92,0.424,30,73,0.411,9,19,0.474,19,21,0.905,106,39,79,0.494,27,46,0.587,12,33,0.364,21,33,0.636,111,2013-01-29,NOP,LAL
4261,61,Home,W 106-104 ,240,39,86,0.453,29,58,0.5,10,28,0.357,18,23,0.783,106,42,84,0.5,34,69,0.493,8,15,0.533,12,15,0.8,104,2013-01-29,POR,DAL
4262,62,Home,W 106-89 ,240,40,72,0.556,35,58,0.603,5,14,0.357,21,25,0.84,106,34,98,0.347,28,73,0.384,6,25,0.24,15,19,0.789,89,2013-01-31,OKC,MEM
4263,63,Home,W 106-104 ,240,36,72,0.5,25,54,0.463,11,18,0.611,23,27,0.852,106,40,79,0.506,31,58,0.534,9,21,0.429,15,21,0.714,104,2013-02-03,BOS,LAC
4264,64,Home,W 106-96 ,240,42,79,0.532,31,59,0.525,11,20,0.55,11,14,0.786,106,34,84,0.405,25,56,0.446,9,28,0.321,19,23,0.826,96,2013-02-06,WAS,NYK
4265,65,Home,W 106-96 ,240,37,75,0.493,24,43,0.558,13,32,0.406,19,26,0.731,106,36,82,0.439,31,58,0.534,5,24,0.208,19,22,0.864,96,2013-02-13,LAC,HOU
4266,66,@,W 106-96 ,240,41,77,0.532,25,47,0.532,16,30,0.533,8,12,0.667,106,40,91,0.44,30,61,0.492,10,30,0.333,6,11,0.545,96,2013-02-22,HOU,BRK
4267,67,Home,W 106-84 ,240,41,76,0.539,29,54,0.537,12,22,0.545,12,26,0.462,106,33,81,0.407,27,65,0.415,6,16,0.375,12,14,0.857,84,2013-02-26,LAC,CHA
4268,68,Home,L 106-136 ,240,44,84,0.524,38,65,0.585,6,19,0.316,12,15,0.8,106,53,86,0.616,40,65,0.615,13,21,0.619,17,21,0.81,136,2013-03-08,SAS,POR
4269,69,Home,W 106-97 ,240,40,76,0.526,32,61,0.525,8,15,0.533,18,27,0.667,106,40,81,0.494,34,62,0.548,6,19,0.316,11,16,0.688,97,2013-03-11,PHI,BRK
4270,70,@,W 106-97 ,240,34,73,0.466,25,48,0.521,9,25,0.36,29,47,0.617,106,37,93,0.398,27,61,0.443,10,32,0.313,13,17,0.765,97,2013-03-12,LAL,ORL
4271,71,Home,W 106-93 ,240,43,86,0.5,35,70,0.5,8,16,0.5,12,24,0.5,106,39,85,0.459,33,67,0.493,6,18,0.333,9,12,0.75,93,2013-03-13,WAS,MIL
4272,72,Home,W 106-94 ,240,40,76,0.526,25,42,0.595,15,34,0.441,11,16,0.688,106,38,79,0.481,33,62,0.532,5,17,0.294,13,18,0.722,94,2013-03-20,NYK,ORL
4273,73,@,L 106-110 ,240,38,74,0.514,29,54,0.537,9,20,0.45,21,28,0.75,106,43,94,0.457,39,83,0.47,4,11,0.364,20,24,0.833,110,2013-03-23,BOS,MEM
4274,74,Home,L 106-109 ,240,39,80,0.488,34,64,0.531,5,16,0.313,23,26,0.885,106,39,71,0.549,29,48,0.604,10,23,0.435,21,28,0.75,109,2013-04-01,LAC,IND
4275,75,Home,W 106-87 ,240,40,83,0.482,26,58,0.448,14,25,0.56,12,14,0.857,106,33,82,0.402,27,62,0.435,6,20,0.3,15,20,0.75,87,2013-04-06,MIA,PHI
4276,76,Home,L 106-113 ,240,38,85,0.447,26,59,0.441,12,26,0.462,18,20,0.9,106,43,73,0.589,37,54,0.685,6,19,0.316,21,24,0.875,113,2013-04-10,POR,LAL
4277,77,@,W 106-90 ,240,40,77,0.519,31,55,0.564,9,22,0.409,17,21,0.81,106,36,88,0.409,30,68,0.441,6,20,0.3,12,18,0.667,90,2013-04-12,OKC,POR
4278,78,Home,W 106-101 ,240,43,92,0.467,36,77,0.468,7,15,0.467,13,27,0.481,106,41,77,0.532,37,66,0.561,4,11,0.364,15,20,0.75,101,2013-04-15,BRK,WAS
4279,79,Home,W 106-95 ,240,43,74,0.581,36,56,0.643,7,18,0.389,13,14,0.929,106,34,79,0.43,20,42,0.476,14,37,0.378,13,13,1.0,95,2013-04-15,CHA,NYK
4280,80,@,L 106-116 ,240,45,98,0.459,37,74,0.5,8,24,0.333,8,13,0.615,106,46,85,0.541,37,65,0.569,9,20,0.45,15,18,0.833,116,2013-04-15,SAS,GSW
4281,81,@,W 106-93 ,240,42,84,0.5,34,64,0.531,8,20,0.4,14,20,0.7,106,34,90,0.378,30,74,0.405,4,16,0.25,21,27,0.778,93,2013-11-06,GSW,MIN
4282,82,Home,W 106-105 (OT),265,41,92,0.446,35,72,0.486,6,20,0.3,18,22,0.818,106,40,88,0.455,28,59,0.475,12,29,0.414,13,26,0.5,105,2013-11-10,OKC,WAS
4283,83,Home,L 106-109 ,240,38,87,0.437,30,67,0.448,8,20,0.4,22,27,0.815,106,31,68,0.456,22,40,0.55,9,28,0.321,38,44,0.864,109,2013-11-14,NYK,HOU
4284,84,Home,W 106-88 ,240,40,94,0.426,33,71,0.465,7,23,0.304,19,22,0.864,106,34,86,0.395,29,68,0.426,5,18,0.278,15,18,0.833,88,2013-11-16,MIN,BOS
4285,85,@,W 106-102 ,240,39,81,0.481,34,69,0.493,5,12,0.417,23,30,0.767,106,34,86,0.395,27,63,0.429,7,23,0.304,27,32,0.844,102,2013-11-18,MEM,LAC
4286,86,Home,L 106-113 ,240,38,85,0.447,23,52,0.442,15,33,0.455,15,22,0.682,106,37,80,0.463,30,63,0.476,7,17,0.412,32,38,0.842,113,2013-11-20,PHO,SAC
4287,87,Home,W 106-98 ,240,35,76,0.461,30,58,0.517,5,18,0.278,31,38,0.816,106,35,102,0.343,31,77,0.403,4,25,0.16,24,32,0.75,98,2013-11-23,IND,PHI
4288,88,@,L 106-120 ,240,39,86,0.453,32,67,0.478,7,19,0.368,21,24,0.875,106,42,81,0.519,32,57,0.561,10,24,0.417,26,31,0.839,120,2013-11-27,POR,PHO
4289,89,@,W 106-102 ,240,36,80,0.45,22,49,0.449,14,31,0.452,20,30,0.667,106,44,100,0.44,43,92,0.467,1,8,0.125,13,25,0.52,102,2013-11-29,LAL,DET
4290,90,Home,L 106-112 ,240,45,92,0.489,38,68,0.559,7,24,0.292,9,11,0.818,106,40,79,0.506,29,53,0.547,11,26,0.423,21,30,0.7,112,2013-11-30,DAL,MIN
4291,91,Home,L 106-112 ,240,44,91,0.484,35,65,0.538,9,26,0.346,9,13,0.692,106,40,90,0.444,27,60,0.45,13,30,0.433,19,30,0.633,112,2013-11-30,SAS,HOU
4292,92,Home,W 106-102 ,240,36,76,0.474,31,63,0.492,5,13,0.385,29,33,0.879,106,39,88,0.443,30,66,0.455,9,22,0.409,15,17,0.882,102,2013-12-02,POR,IND
4293,93,Home,W 106-98 ,240,43,83,0.518,37,63,0.587,6,20,0.3,14,18,0.778,106,34,77,0.442,28,60,0.467,6,17,0.353,24,29,0.828,98,2013-12-06,BOS,DEN
4294,94,Home,W 106-97 ,240,37,82,0.451,28,59,0.475,9,23,0.391,23,32,0.719,106,35,87,0.402,30,68,0.441,5,19,0.263,22,25,0.88,97,2013-12-06,PHO,TOR
4295,95,@,W 106-100 ,240,41,86,0.477,29,54,0.537,12,32,0.375,12,18,0.667,106,37,86,0.43,27,64,0.422,10,22,0.455,16,22,0.727,100,2013-12-06,LAL,SAC
4296,96,Home,L 106-108 ,240,39,87,0.448,30,57,0.526,9,30,0.3,19,24,0.792,106,46,87,0.529,38,71,0.535,8,16,0.5,8,11,0.727,108,2013-12-07,POR,DAL
4297,97,@,W 106-94 ,240,40,82,0.488,36,56,0.643,4,26,0.154,22,25,0.88,106,34,79,0.43,25,51,0.49,9,28,0.321,17,20,0.85,94,2013-12-08,TOR,LAL
4298,98,Home,W 106-99 ,240,37,96,0.385,30,76,0.395,7,20,0.35,25,29,0.862,106,39,74,0.527,30,54,0.556,9,20,0.45,12,14,0.857,99,2013-12-11,MIN,PHI
4299,99,@,L 106-111 (OT),265,42,96,0.438,37,75,0.493,5,21,0.238,17,27,0.63,106,38,84,0.452,29,61,0.475,9,23,0.391,26,32,0.813,111,2013-12-11,DET,NOP
4300,0,Home,W 106-93 ,240,42,88,0.477,32,64,0.5,10,24,0.417,12,18,0.667,106,36,81,0.444,31,64,0.484,5,17,0.294,16,19,0.842,93,2013-12-14,DAL,MIL
4301,1,@,L 106-111 ,240,40,66,0.606,25,34,0.735,15,32,0.469,11,11,1.0,106,44,87,0.506,36,68,0.529,8,19,0.421,15,18,0.833,111,2013-12-14,ATL,NYK
4302,2,Home,W 106-102 ,240,35,79,0.443,22,52,0.423,13,27,0.481,23,34,0.676,106,34,80,0.425,23,58,0.397,11,22,0.5,23,33,0.697,102,2013-12-15,PHO,GSW
4303,3,Home,W 106-91 ,240,39,81,0.481,36,68,0.529,3,13,0.231,25,30,0.833,106,31,75,0.413,24,48,0.5,7,27,0.259,22,38,0.579,91,2013-12-15,SAC,HOU
4304,4,Home,L 106-107 ,240,40,81,0.494,34,63,0.54,6,18,0.333,20,22,0.909,106,41,88,0.466,31,61,0.508,10,27,0.37,15,20,0.75,107,2013-12-18,BOS,DET
4305,5,Home,L 106-116 ,240,42,90,0.467,30,67,0.448,12,23,0.522,10,17,0.588,106,44,84,0.524,41,74,0.554,3,10,0.3,25,28,0.893,116,2013-12-20,DET,CHA
4306,6,@,W 106-99 ,240,41,87,0.471,33,66,0.5,8,21,0.381,16,22,0.727,106,42,87,0.483,38,67,0.567,4,20,0.2,11,18,0.611,99,2013-12-21,WAS,BOS
4307,7,@,L 106-116 ,240,38,93,0.409,28,70,0.4,10,23,0.435,20,22,0.909,106,43,82,0.524,36,57,0.632,7,25,0.28,23,25,0.92,116,2013-12-21,PHI,MIL
4308,8,Home,W 106-79 ,240,41,83,0.494,32,64,0.5,9,19,0.474,15,22,0.682,106,32,84,0.381,26,70,0.371,6,14,0.429,9,13,0.692,79,2013-12-22,IND,BOS
4309,9,Home,W 106-82 ,240,43,86,0.5,34,67,0.507,9,19,0.474,11,17,0.647,106,31,77,0.403,24,56,0.429,7,21,0.333,13,17,0.765,82,2013-12-28,WAS,DET
4310,10,@,W 106-99 ,240,39,78,0.5,32,59,0.542,7,19,0.368,21,27,0.778,106,36,82,0.439,30,62,0.484,6,20,0.3,21,35,0.6,99,2013-12-30,WAS,DET
4311,11,Home,L 106-110 ,240,39,81,0.481,32,53,0.604,7,28,0.25,21,33,0.636,106,42,85,0.494,35,63,0.556,7,22,0.318,19,23,0.826,110,2013-12-31,HOU,SAC
4312,12,Home,W 106-92 ,240,38,83,0.458,29,64,0.453,9,19,0.474,21,22,0.955,106,33,83,0.398,28,63,0.444,5,20,0.25,21,24,0.875,92,2014-01-18,IND,LAC
4313,13,Home,L 106-112 ,240,44,90,0.489,35,60,0.583,9,30,0.3,9,11,0.818,106,37,80,0.463,25,58,0.431,12,22,0.545,26,28,0.929,112,2014-01-19,TOR,LAL
4314,14,Home,L 106-110 ,240,37,82,0.451,22,49,0.449,15,33,0.455,17,24,0.708,106,42,88,0.477,33,74,0.446,9,14,0.643,17,24,0.708,110,2014-01-22,NYK,PHI
4315,15,@,L 106-107 ,240,34,78,0.436,24,58,0.414,10,20,0.5,28,33,0.848,106,37,73,0.507,27,46,0.587,10,27,0.37,23,28,0.821,107,2014-01-24,DAL,BRK
4316,16,@,L 106-116 ,240,43,91,0.473,39,78,0.5,4,13,0.308,16,28,0.571,106,43,74,0.581,36,53,0.679,7,21,0.333,23,28,0.821,116,2014-01-26,DET,DAL
4317,17,Home,W 106-99 ,240,32,80,0.4,25,60,0.417,7,20,0.35,35,53,0.66,106,37,90,0.411,32,68,0.471,5,22,0.227,20,26,0.769,99,2014-01-27,UTA,SAC
4318,18,Home,W 106-92 ,240,41,80,0.513,34,54,0.63,7,26,0.269,17,24,0.708,106,38,87,0.437,30,57,0.526,8,30,0.267,8,10,0.8,92,2014-02-01,HOU,CLE
4319,19,@,W 106-91 ,240,41,76,0.539,33,53,0.623,8,23,0.348,16,24,0.667,106,33,67,0.493,22,41,0.537,11,26,0.423,14,23,0.609,91,2014-02-01,MIA,NYK
4320,20,Home,W 106-103 ,240,35,76,0.461,27,58,0.466,8,18,0.444,28,35,0.8,106,40,87,0.46,34,67,0.507,6,20,0.3,17,25,0.68,103,2014-02-01,POR,TOR
4321,21,Home,W 106-97 ,240,44,91,0.484,34,64,0.531,10,27,0.37,8,11,0.727,106,37,78,0.474,31,58,0.534,6,20,0.3,17,23,0.739,97,2014-02-05,OKC,MIN
4322,22,@,W 106-101 (OT),265,40,85,0.471,30,62,0.484,10,23,0.435,16,19,0.842,106,41,90,0.456,32,66,0.485,9,24,0.375,10,14,0.714,101,2014-02-12,SAC,NYK
4323,23,Home,L 106-117 ,240,34,85,0.4,25,58,0.431,9,27,0.333,29,32,0.906,106,44,77,0.571,34,51,0.667,10,26,0.385,19,24,0.792,117,2014-02-18,DAL,MIA
4324,24,Home,W 106-85 ,240,42,82,0.512,37,57,0.649,5,25,0.2,17,25,0.68,106,29,83,0.349,27,62,0.435,2,21,0.095,25,27,0.926,85,2014-02-21,PHO,SAS
4325,25,@,L 106-115 ,240,43,86,0.5,35,61,0.574,8,25,0.32,12,14,0.857,106,42,80,0.525,32,64,0.5,10,16,0.625,21,28,0.75,115,2014-02-25,ORL,WAS
4326,26,@,L 106-112 ,240,45,97,0.464,38,79,0.481,7,18,0.389,9,14,0.643,106,39,84,0.464,29,57,0.509,10,27,0.37,24,28,0.857,112,2014-03-02,DAL,SAS
4327,27,Home,L 106-107 ,240,43,96,0.448,34,67,0.507,9,29,0.31,11,19,0.579,106,43,94,0.457,35,76,0.461,8,18,0.444,13,15,0.867,107,2014-03-03,POR,LAL
4328,28,Home,W 106-103 ,240,40,78,0.513,32,55,0.582,8,23,0.348,18,27,0.667,106,38,80,0.475,31,53,0.585,7,27,0.259,20,29,0.69,103,2014-03-04,HOU,MIA
4329,29,Home,L 106-118 ,240,39,90,0.433,32,64,0.5,7,26,0.269,21,24,0.875,106,47,90,0.522,36,63,0.571,11,27,0.407,13,19,0.684,118,2014-03-05,MIN,NYK
4330,30,Home,W 106-98 ,240,34,80,0.425,23,51,0.451,11,29,0.379,27,34,0.794,106,33,79,0.418,24,54,0.444,9,25,0.36,23,34,0.676,98,2014-03-11,OKC,HOU
4331,31,@,L 106-129 ,240,38,87,0.437,26,59,0.441,12,28,0.429,18,23,0.783,106,49,85,0.576,33,47,0.702,16,38,0.421,15,19,0.789,129,2014-03-20,MIN,HOU
4332,32,@,L 106-122 ,240,40,81,0.494,27,51,0.529,13,30,0.433,13,21,0.619,106,48,89,0.539,36,67,0.537,12,22,0.545,14,17,0.824,122,2014-03-21,DEN,DAL
4333,33,@,W 106-100 ,240,42,69,0.609,33,51,0.647,9,18,0.5,13,17,0.765,106,35,77,0.455,23,50,0.46,12,27,0.444,18,19,0.947,100,2014-03-23,CLE,NYK
4334,34,Home,W 106-98 ,240,38,78,0.487,30,60,0.5,8,18,0.444,22,27,0.815,106,41,85,0.482,36,72,0.5,5,13,0.385,11,16,0.688,98,2014-03-24,LAC,MIL
4335,35,Home,W 106-94 ,240,40,81,0.494,34,63,0.54,6,18,0.333,20,23,0.87,106,38,88,0.432,29,66,0.439,9,22,0.409,9,12,0.75,94,2014-04-03,OKC,SAS
4336,36,Home,W 106-103 ,240,41,79,0.519,30,56,0.536,11,23,0.478,13,13,1.0,106,44,87,0.506,37,69,0.536,7,18,0.389,8,12,0.667,103,2014-04-11,BOS,CHA
4337,37,Home,W 106-98 ,240,40,81,0.494,35,62,0.565,5,19,0.263,21,23,0.913,106,40,86,0.465,35,69,0.507,5,17,0.294,13,23,0.565,98,2014-04-11,CHI,DET
4338,38,Home,W 106-103 ,240,41,82,0.5,35,65,0.538,6,17,0.353,18,27,0.667,106,35,88,0.398,28,66,0.424,7,22,0.318,26,30,0.867,103,2014-04-13,SAC,MIN
4339,39,Home,W 106-105 (OT),265,43,88,0.489,38,68,0.559,5,20,0.25,15,25,0.6,106,44,92,0.478,36,62,0.581,8,30,0.267,9,11,0.818,105,2014-04-16,MEM,DAL
4340,40,@,L 106-108 (OT),265,39,80,0.488,32,66,0.485,7,14,0.5,21,24,0.875,106,41,101,0.406,35,80,0.438,6,21,0.286,20,29,0.69,108,2014-10-29,MIL,CHO
4341,41,Home,W 106-89 ,240,39,87,0.448,28,58,0.483,11,29,0.379,17,22,0.773,106,33,81,0.407,31,65,0.477,2,16,0.125,21,26,0.808,89,2014-10-29,POR,OKC
4342,42,@,W 106-105 ,240,33,69,0.478,24,46,0.522,9,23,0.391,31,40,0.775,106,38,85,0.447,34,73,0.466,4,12,0.333,25,31,0.806,105,2014-11-01,CHI,MIN
4343,43,Home,L 106-112 ,240,35,88,0.398,29,72,0.403,6,16,0.375,30,41,0.732,106,41,91,0.451,35,73,0.479,6,18,0.333,24,31,0.774,112,2014-11-04,LAL,PHO
4344,44,@,W 106-101 ,240,42,81,0.519,35,62,0.565,7,19,0.368,15,20,0.75,106,42,92,0.457,34,74,0.459,8,18,0.444,9,15,0.6,101,2014-11-08,BOS,CHI
4345,45,Home,W 106-102 ,240,40,81,0.494,35,69,0.507,5,12,0.417,21,30,0.7,106,36,80,0.45,26,55,0.473,10,25,0.4,20,25,0.8,102,2014-11-08,LAC,POR
4346,46,Home,W 106-98 ,240,38,80,0.475,28,53,0.528,10,27,0.37,20,24,0.833,106,32,72,0.444,23,53,0.434,9,19,0.474,25,32,0.781,98,2014-11-11,DAL,SAC
4347,47,@,W 106-97 ,240,41,85,0.482,29,54,0.537,12,31,0.387,12,15,0.8,106,34,79,0.43,24,50,0.48,10,29,0.345,19,23,0.826,97,2014-11-17,DEN,CLE
4348,48,@,W 106-100 ,240,39,79,0.494,30,55,0.545,9,24,0.375,19,24,0.792,106,38,86,0.442,34,75,0.453,4,11,0.364,20,29,0.69,100,2014-11-18,NOP,SAC
4349,49,@,L 106-140 ,240,44,85,0.518,39,72,0.542,5,13,0.385,13,21,0.619,106,51,82,0.622,33,47,0.702,18,35,0.514,20,28,0.714,140,2014-11-21,LAL,DAL
4350,50,@,W 106-83 ,240,38,85,0.447,26,54,0.481,12,31,0.387,18,20,0.9,106,31,84,0.369,24,61,0.393,7,23,0.304,14,20,0.7,83,2014-11-22,PHO,IND
4351,51,@,W 106-94 ,240,42,93,0.452,38,76,0.5,4,17,0.235,18,22,0.818,106,33,71,0.465,28,57,0.491,5,14,0.357,23,29,0.793,94,2014-11-22,NOP,UTA
4352,52,Home,W 106-74 ,240,42,81,0.519,36,65,0.554,6,16,0.375,16,22,0.727,106,29,80,0.363,24,63,0.381,5,17,0.294,11,15,0.733,74,2014-11-24,CLE,ORL
4353,53,@,W 106-102 ,240,36,85,0.424,29,60,0.483,7,25,0.28,27,34,0.794,106,36,84,0.429,27,64,0.422,9,20,0.45,21,29,0.724,102,2014-11-25,ATL,WAS
4354,54,Home,W 106-100 ,240,41,74,0.554,36,59,0.61,5,15,0.333,19,29,0.655,106,40,87,0.46,30,66,0.455,10,21,0.476,10,18,0.556,100,2014-11-26,SAS,IND
4355,55,@,W 106-101 ,240,42,99,0.424,35,73,0.479,7,26,0.269,15,16,0.938,106,38,87,0.437,32,68,0.471,6,19,0.316,19,23,0.826,101,2014-11-28,GSW,CHO
4356,56,@,W 106-102 ,240,40,86,0.465,29,60,0.483,11,26,0.423,15,22,0.682,106,38,91,0.418,24,58,0.414,14,33,0.424,12,16,0.75,102,2014-11-28,DAL,TOR
4357,57,@,W 106-96 ,240,39,81,0.481,29,64,0.453,10,17,0.588,18,24,0.75,106,33,90,0.367,27,69,0.391,6,21,0.286,24,31,0.774,96,2014-12-02,LAL,DET
4358,58,Home,L 106-118 ,240,40,88,0.455,36,69,0.522,4,19,0.211,22,30,0.733,106,45,80,0.563,32,54,0.593,13,26,0.5,15,17,0.882,118,2014-12-05,DAL,PHO
4359,59,@,L 106-115 ,240,43,88,0.489,31,64,0.484,12,24,0.5,8,11,0.727,106,44,88,0.5,39,73,0.534,5,15,0.333,22,28,0.786,115,2014-12-12,POR,CHI
4360,60,Home,W 106-94 ,240,38,91,0.418,28,65,0.431,10,26,0.385,20,22,0.909,106,33,80,0.413,25,58,0.431,8,22,0.364,20,23,0.87,94,2014-12-12,TOR,IND
4361,61,@,L 106-111 ,240,39,91,0.429,25,62,0.403,14,29,0.483,14,19,0.737,106,43,76,0.566,36,65,0.554,7,11,0.636,18,24,0.75,111,2014-12-13,LAC,MIL
4362,62,Home,L 106-111 ,240,40,86,0.465,30,62,0.484,10,24,0.417,16,22,0.727,106,43,82,0.524,34,57,0.596,9,25,0.36,16,21,0.762,111,2014-12-17,CHA,PHO
4363,63,Home,L 106-117 ,240,40,89,0.449,27,56,0.482,13,33,0.394,13,19,0.684,106,40,79,0.506,30,57,0.526,10,22,0.455,27,35,0.771,117,2014-12-17,DET,DAL
4364,64,@,L 106-109 ,240,39,85,0.459,36,67,0.537,3,18,0.167,25,33,0.758,106,38,80,0.475,27,51,0.529,11,29,0.379,22,30,0.733,109,2014-12-19,LAC,DEN
4365,65,Home,W 106-102 ,240,37,81,0.457,25,55,0.455,12,26,0.462,20,27,0.741,106,43,81,0.531,35,57,0.614,8,24,0.333,8,15,0.533,102,2014-12-20,LAC,MIL
4366,66,Home,L 106-114 ,240,42,81,0.519,35,58,0.603,7,23,0.304,15,21,0.714,106,42,81,0.519,33,66,0.5,9,15,0.6,21,38,0.553,114,2014-12-25,SAS,OKC
4367,67,Home,W 106-102 ,240,39,95,0.411,36,76,0.474,3,19,0.158,25,32,0.781,106,41,103,0.398,38,88,0.432,3,15,0.2,17,24,0.708,102,2014-12-26,DEN,MIN
4368,68,Home,L 106-115 ,240,41,93,0.441,34,73,0.466,7,20,0.35,17,24,0.708,106,46,94,0.489,32,61,0.525,14,33,0.424,9,12,0.75,115,2014-12-26,SAC,PHO
4369,69,@,L 106-110 ,240,38,77,0.494,26,44,0.591,12,33,0.364,18,31,0.581,106,39,83,0.47,28,53,0.528,11,30,0.367,21,24,0.875,110,2014-12-28,HOU,SAS
4370,70,@,L 106-110 ,240,41,86,0.477,32,65,0.492,9,21,0.429,15,19,0.789,106,42,81,0.519,34,63,0.54,8,18,0.444,18,29,0.621,110,2014-12-30,PHO,NOP
4371,71,Home,W 106-84 ,240,44,94,0.468,39,73,0.534,5,21,0.238,13,15,0.867,106,32,87,0.368,30,72,0.417,2,15,0.133,18,28,0.643,84,2014-12-31,BOS,SAC
4372,72,Home,W 106-95 ,240,35,79,0.443,25,61,0.41,10,18,0.556,26,30,0.867,106,38,77,0.494,33,61,0.541,5,16,0.313,14,18,0.778,95,2014-12-31,IND,MIA
4373,73,Home,W 106-101 ,240,38,91,0.418,30,76,0.395,8,15,0.533,22,25,0.88,106,37,92,0.402,32,78,0.41,5,14,0.357,22,27,0.815,101,2015-01-01,CHI,DEN
4374,74,Home,L 106-109 ,240,43,81,0.531,37,62,0.597,6,19,0.316,14,19,0.737,106,41,84,0.488,35,70,0.5,6,14,0.429,21,31,0.677,109,2015-01-02,LAL,MEM
4375,75,@,W 106-103 ,240,40,82,0.488,30,59,0.508,10,23,0.435,16,24,0.667,106,38,96,0.396,25,53,0.472,13,43,0.302,14,18,0.778,103,2015-01-09,ATL,DET
4376,76,Home,W 106-95 ,240,37,81,0.457,27,61,0.443,10,20,0.5,22,26,0.846,106,36,82,0.439,30,65,0.462,6,17,0.353,17,22,0.773,95,2015-01-09,NOP,MEM
4377,77,@,W 106-94 ,240,41,86,0.477,28,55,0.509,13,31,0.419,11,17,0.647,106,36,81,0.444,29,59,0.492,7,22,0.318,15,19,0.789,94,2015-01-11,POR,LAL
4378,78,@,W 106-96 ,240,40,87,0.46,37,73,0.507,3,14,0.214,23,29,0.793,106,36,79,0.456,27,55,0.491,9,24,0.375,15,20,0.75,96,2015-01-16,MEM,ORL
4379,79,Home,L 106-131 ,240,37,88,0.42,30,65,0.462,7,23,0.304,25,34,0.735,106,50,91,0.549,41,69,0.594,9,22,0.409,22,33,0.667,131,2015-01-17,HOU,GSW
4380,80,Home,W 106-92 ,240,42,81,0.519,37,57,0.649,5,24,0.208,17,25,0.68,106,35,84,0.417,27,62,0.435,8,22,0.364,14,18,0.778,92,2015-01-21,CLE,UTA
4381,81,@,L 106-113 ,240,44,87,0.506,37,60,0.617,7,27,0.259,11,19,0.579,106,43,91,0.473,33,66,0.5,10,25,0.4,17,21,0.81,113,2015-01-23,ORL,NYK
4382,82,@,L 106-109 ,240,39,81,0.481,30,57,0.526,9,24,0.375,19,25,0.76,106,40,79,0.506,32,62,0.516,8,17,0.471,21,25,0.84,109,2015-01-25,DAL,NOP
4383,83,@,W 106-99 ,240,43,83,0.518,35,63,0.556,8,20,0.4,12,18,0.667,106,38,78,0.487,32,61,0.525,6,17,0.353,17,23,0.739,99,2015-01-25,IND,ORL
4384,84,Home,W 106-98 ,240,40,88,0.455,29,59,0.492,11,29,0.379,15,18,0.833,106,37,88,0.42,29,70,0.414,8,18,0.444,16,23,0.696,98,2015-01-28,PHO,WAS
4385,85,Home,W 106-87 ,240,40,87,0.46,28,55,0.509,12,32,0.375,14,18,0.778,106,33,91,0.363,24,65,0.369,9,26,0.346,12,17,0.706,87,2015-01-31,GSW,PHO
4386,86,@,W 106-90 ,240,42,87,0.483,32,55,0.582,10,32,0.313,12,19,0.632,106,34,82,0.415,28,69,0.406,6,13,0.462,16,21,0.762,90,2015-01-31,CLE,MIN
4387,87,@,W 106-92 ,240,37,81,0.457,25,56,0.446,12,25,0.48,20,24,0.833,106,35,87,0.402,27,69,0.391,8,18,0.444,14,17,0.824,92,2015-02-07,GSW,NYK
4388,88,@,W 106-78 ,240,37,83,0.446,32,64,0.5,5,19,0.263,27,30,0.9,106,29,81,0.358,20,57,0.351,9,24,0.375,11,14,0.786,78,2015-02-10,DET,CHO
4389,89,@,W 106-96 ,240,43,79,0.544,39,63,0.619,4,16,0.25,16,23,0.696,106,37,85,0.435,31,67,0.463,6,18,0.333,16,27,0.593,96,2015-02-10,DEN,LAL
4390,90,@,W 106-93 ,240,40,75,0.533,31,55,0.564,9,20,0.45,17,18,0.944,106,34,74,0.459,27,59,0.458,7,15,0.467,18,25,0.72,93,2015-02-11,IND,NOP
4391,91,@,W 106-95 ,240,40,83,0.482,32,61,0.525,8,22,0.364,18,22,0.818,106,34,84,0.405,26,59,0.441,8,25,0.32,19,29,0.655,95,2015-02-20,IND,PHI
4392,92,Home,W 106-89 ,240,37,89,0.416,24,57,0.421,13,32,0.406,19,25,0.76,106,37,85,0.435,31,68,0.456,6,17,0.353,9,14,0.643,89,2015-02-22,DET,WAS
4393,93,Home,W 106-98 ,240,40,96,0.417,26,61,0.426,14,35,0.4,12,15,0.8,106,37,82,0.451,27,61,0.443,10,21,0.476,14,17,0.824,98,2015-02-27,BOS,CHO
4394,94,@,W 106-101 ,240,40,95,0.421,28,61,0.459,12,34,0.353,14,17,0.824,106,40,109,0.367,32,78,0.41,8,31,0.258,13,17,0.765,101,2015-03-01,GSW,BOS
4395,95,Home,W 106-95 ,240,39,86,0.453,27,52,0.519,12,34,0.353,16,20,0.8,106,35,86,0.407,25,62,0.403,10,24,0.417,15,22,0.682,95,2015-03-03,DEN,MIL
4396,96,Home,W 106-97 ,240,43,84,0.512,37,63,0.587,6,21,0.286,14,17,0.824,106,29,69,0.42,16,31,0.516,13,38,0.342,26,33,0.788,97,2015-03-06,ATL,CLE
4397,97,Home,W 106-98 ,240,40,80,0.5,30,58,0.517,10,22,0.455,16,23,0.696,106,40,83,0.482,32,58,0.552,8,25,0.32,10,14,0.714,98,2015-03-08,GSW,LAC
4398,98,Home,W 106-78 ,240,38,87,0.437,30,63,0.476,8,24,0.333,22,29,0.759,106,29,75,0.387,24,62,0.387,5,13,0.385,15,25,0.6,78,2015-03-09,DEN,NYK
4399,99,Home,L 106-113 ,240,42,93,0.452,36,75,0.48,6,18,0.333,16,26,0.615,106,40,85,0.471,32,65,0.492,8,20,0.4,25,30,0.833,113,2015-03-11,CHA,SAC
4400,0,Home,W 106-97 ,240,45,90,0.5,39,66,0.591,6,24,0.25,10,13,0.769,106,36,81,0.444,35,68,0.515,1,13,0.077,24,26,0.923,97,2015-03-11,PHO,MIN
4401,1,Home,W 106-92 ,240,42,76,0.553,38,61,0.623,4,15,0.267,18,22,0.818,106,30,79,0.38,19,46,0.413,11,33,0.333,21,27,0.778,92,2015-03-16,MIA,CLE
4402,2,Home,L 106-122 ,240,41,88,0.466,32,73,0.438,9,15,0.6,15,17,0.882,106,52,90,0.578,47,77,0.61,5,13,0.385,13,17,0.765,122,2015-03-16,MIN,BRK
4403,3,Home,W 106-91 ,240,38,78,0.487,30,60,0.5,8,18,0.444,22,26,0.846,106,32,73,0.438,22,51,0.431,10,22,0.455,17,21,0.81,91,2015-03-21,GSW,UTA
4404,4,Home,W 106-89 ,240,39,75,0.52,35,64,0.547,4,11,0.364,24,29,0.828,106,35,84,0.417,27,65,0.415,8,19,0.421,11,16,0.688,89,2015-03-22,TOR,NYK
4405,5,@,W 106-104 (OT),265,37,78,0.474,25,59,0.424,12,19,0.632,20,25,0.8,106,38,87,0.437,29,59,0.492,9,28,0.321,19,31,0.613,104,2015-03-23,MIN,UTA
4406,6,@,L 106-107 ,240,40,81,0.494,27,53,0.509,13,28,0.464,13,21,0.619,106,35,97,0.361,28,77,0.364,7,20,0.35,30,38,0.789,107,2015-03-24,PHI,SAC
4407,7,Home,W 106-98 ,240,40,86,0.465,31,63,0.492,9,23,0.391,17,19,0.895,106,37,81,0.457,29,51,0.569,8,30,0.267,16,20,0.8,98,2015-03-27,BRK,CLE
4408,8,Home,L 106-119 ,240,39,93,0.419,31,62,0.5,8,31,0.258,20,23,0.87,106,41,84,0.488,28,52,0.538,13,32,0.406,24,40,0.6,119,2015-03-29,BOS,LAC
4409,9,@,L 106-111 ,240,37,82,0.451,25,59,0.424,12,23,0.522,20,24,0.833,106,40,80,0.5,31,62,0.5,9,18,0.5,22,28,0.786,111,2015-03-31,IND,BRK
4410,10,Home,L 106-110 ,240,36,82,0.439,30,60,0.5,6,22,0.273,28,33,0.848,106,38,85,0.447,30,64,0.469,8,21,0.381,26,34,0.765,110,2015-03-31,LAC,GSW
4411,11,Home,W 106-93 ,240,44,76,0.579,40,64,0.625,4,12,0.333,14,22,0.636,106,36,91,0.396,26,57,0.456,10,34,0.294,11,17,0.647,93,2015-04-01,WAS,PHI
4412,12,@,L 106-107 ,240,42,90,0.467,37,71,0.521,5,19,0.263,17,26,0.654,106,43,93,0.462,33,67,0.493,10,26,0.385,11,17,0.647,107,2015-04-02,PHO,GSW
4413,13,@,W 106-78 ,240,40,75,0.533,25,48,0.521,15,27,0.556,11,18,0.611,106,29,75,0.387,22,58,0.379,7,17,0.412,13,22,0.591,78,2015-04-05,LAC,LAL
4414,14,Home,W 106-96 ,240,41,91,0.451,35,77,0.455,6,14,0.429,18,23,0.783,106,39,87,0.448,28,61,0.459,11,26,0.423,7,9,0.778,96,2015-04-06,BRK,POR
4415,15,Home,W 106-98 ,240,41,83,0.494,32,60,0.533,9,23,0.391,15,24,0.625,106,32,74,0.432,29,59,0.492,3,15,0.2,31,34,0.912,98,2015-04-10,LAL,MIN
4416,16,Home,L 106-120 ,240,34,78,0.436,25,54,0.463,9,24,0.375,29,36,0.806,106,45,83,0.542,35,62,0.565,10,21,0.476,20,26,0.769,120,2015-04-12,LAL,DAL
4417,17,@,W 106-94 ,240,37,96,0.385,25,67,0.373,12,29,0.414,20,26,0.769,106,37,82,0.451,29,55,0.527,8,27,0.296,12,15,0.8,94,2015-10-27,DET,ATL
4418,18,@,W 106-76 ,240,41,84,0.488,28,55,0.509,13,29,0.448,11,17,0.647,106,29,82,0.354,27,66,0.409,2,16,0.125,16,22,0.727,76,2015-10-28,CLE,MEM
4419,19,@,L 106-112 ,240,45,93,0.484,40,78,0.513,5,15,0.333,11,13,0.846,106,42,86,0.488,35,67,0.522,7,19,0.368,21,22,0.955,112,2015-10-28,SAS,OKC
4420,20,Home,W 106-99 ,240,36,80,0.45,29,62,0.468,7,18,0.389,27,39,0.692,106,32,86,0.372,23,63,0.365,9,23,0.391,26,31,0.839,99,2015-10-28,TOR,IND
4421,21,Home,W 106-87 ,240,41,90,0.456,30,65,0.462,11,25,0.44,13,20,0.65,106,29,69,0.42,24,50,0.48,5,19,0.263,24,24,1.0,87,2015-11-01,TOR,MIL
4422,22,@,W 106-101 ,240,41,89,0.461,32,59,0.542,9,30,0.3,15,20,0.75,106,34,79,0.43,31,66,0.47,3,13,0.231,30,39,0.769,101,2015-11-02,POR,MIN
4423,23,@,W 106-88 ,240,46,87,0.529,40,64,0.625,6,23,0.261,8,11,0.727,106,34,84,0.405,27,65,0.415,7,19,0.368,13,19,0.684,88,2015-11-09,SAS,SAC
4424,24,Home,W 106-98 ,240,42,86,0.488,32,60,0.533,10,26,0.385,12,16,0.75,106,37,83,0.446,23,54,0.426,14,29,0.483,10,15,0.667,98,2015-11-11,ATL,NOP
4425,25,@,W 106-98 ,240,42,98,0.429,34,81,0.42,8,17,0.471,14,17,0.824,106,42,98,0.429,34,64,0.531,8,34,0.235,6,12,0.5,98,2015-11-11,BRK,HOU
4426,26,Home,W 106-93 ,240,42,103,0.408,31,70,0.443,11,33,0.333,11,12,0.917,106,36,76,0.474,30,56,0.536,6,20,0.3,15,20,0.75,93,2015-11-13,BOS,ATL
4427,27,Home,W 106-94 ,240,41,83,0.494,32,52,0.615,9,31,0.29,15,19,0.789,106,35,89,0.393,30,68,0.441,5,21,0.238,19,21,0.905,94,2015-11-15,CHA,POR
4428,28,Home,L 106-114 ,240,41,82,0.5,36,66,0.545,5,16,0.313,19,21,0.905,106,40,71,0.563,31,54,0.574,9,17,0.529,25,27,0.926,114,2015-11-15,MIN,MEM
4429,29,@,W 106-102 ,240,37,72,0.514,30,52,0.577,7,20,0.35,25,35,0.714,106,38,92,0.413,30,66,0.455,8,26,0.308,18,24,0.75,102,2015-11-18,DAL,BOS
4430,30,Home,W 106-94 ,240,39,79,0.494,29,50,0.58,10,29,0.345,18,24,0.75,106,35,88,0.398,28,66,0.424,7,22,0.318,17,23,0.739,94,2015-11-20,GSW,CHI
4431,31,Home,L 106-123 ,240,38,83,0.458,25,50,0.5,13,33,0.394,17,24,0.708,106,44,80,0.55,25,54,0.463,19,26,0.731,16,23,0.696,123,2015-11-24,WAS,IND
4432,32,Home,W 106-100 ,240,39,90,0.433,29,62,0.468,10,28,0.357,18,20,0.9,106,37,93,0.398,30,74,0.405,7,19,0.368,19,22,0.864,100,2015-11-30,ATL,OKC
4433,33,@,W 106-103 ,240,40,82,0.488,26,53,0.491,14,29,0.483,12,15,0.8,106,40,89,0.449,34,70,0.486,6,19,0.316,17,22,0.773,103,2015-11-30,GSW,UTA
4434,34,@,W 106-105 ,240,38,81,0.469,26,54,0.481,12,27,0.444,18,18,1.0,106,39,92,0.424,31,65,0.477,8,27,0.296,19,22,0.864,105,2015-12-03,DEN,TOR
4435,35,@,L 106-109 ,240,43,84,0.512,33,61,0.541,10,23,0.435,10,16,0.625,106,40,82,0.488,30,56,0.536,10,26,0.385,19,25,0.76,109,2015-12-04,PHO,WAS
4436,36,Home,W 106-91 ,240,44,89,0.494,42,85,0.494,2,4,0.5,16,24,0.667,106,32,76,0.421,26,51,0.51,6,25,0.24,21,28,0.75,91,2015-12-05,MIL,NYK
4437,37,Home,L 106-110 ,240,36,82,0.439,29,64,0.453,7,18,0.389,27,35,0.771,106,38,86,0.442,30,61,0.492,8,25,0.32,26,29,0.897,110,2015-12-07,MIN,LAC
4438,38,@,L 106-114 ,240,38,92,0.413,23,56,0.411,15,36,0.417,15,22,0.682,106,43,77,0.558,33,49,0.673,10,28,0.357,18,24,0.75,114,2015-12-08,UTA,SAC
4439,39,Home,W 106-85 ,240,39,80,0.488,30,59,0.508,9,21,0.429,19,23,0.826,106,31,78,0.397,23,57,0.404,8,21,0.381,15,27,0.556,85,2015-12-09,UTA,NYK
4440,40,@,W 106-96 ,240,45,96,0.469,33,62,0.532,12,34,0.353,4,7,0.571,106,36,83,0.434,23,48,0.479,13,35,0.371,11,18,0.611,96,2015-12-11,POR,PHO
4441,41,Home,W 106-90 ,240,41,86,0.477,31,64,0.484,10,22,0.455,14,16,0.875,106,29,79,0.367,19,51,0.373,10,28,0.357,22,26,0.846,90,2015-12-14,IND,TOR
4442,42,@,L 106-127 ,240,39,75,0.52,27,49,0.551,12,26,0.462,16,24,0.667,106,48,78,0.615,38,57,0.667,10,21,0.476,21,24,0.875,127,2015-12-16,PHI,ATL
4443,43,Home,W 106-90 ,240,38,79,0.481,36,65,0.554,2,14,0.143,28,37,0.757,106,32,92,0.348,21,66,0.318,11,26,0.423,15,18,0.833,90,2015-12-16,OKC,POR
4444,44,Home,W 106-97 ,240,37,77,0.481,28,48,0.583,9,29,0.31,23,28,0.821,106,38,81,0.469,33,57,0.579,5,24,0.208,16,22,0.727,97,2015-12-21,ATL,POR
4445,45,Home,W 106-92 ,240,46,89,0.517,40,69,0.58,6,20,0.3,8,9,0.889,106,38,90,0.422,31,71,0.437,7,19,0.368,9,15,0.6,92,2015-12-21,SAS,IND
4446,46,Home,L 106-108 ,240,41,89,0.461,29,57,0.509,12,32,0.375,12,20,0.6,106,46,89,0.517,42,66,0.636,4,23,0.174,12,16,0.75,108,2015-12-23,IND,SAC
4447,47,@,L 106-110 ,240,43,82,0.524,35,62,0.565,8,20,0.4,12,13,0.923,106,42,80,0.525,35,59,0.593,7,21,0.333,19,24,0.792,110,2015-12-31,PHO,OKC
4448,48,Home,W 106-82 ,240,46,82,0.561,38,64,0.594,8,18,0.444,6,9,0.667,106,32,88,0.364,25,57,0.439,7,31,0.226,11,14,0.786,82,2016-01-01,MIA,DAL
4449,49,Home,L 106-112 ,240,34,80,0.425,27,58,0.466,7,22,0.318,31,48,0.646,106,40,78,0.513,30,55,0.545,10,23,0.435,22,32,0.688,112,2016-01-03,DEN,POR
4450,50,@,L 106-117 ,240,46,102,0.451,40,86,0.465,6,16,0.375,8,14,0.571,106,46,83,0.554,41,64,0.641,5,19,0.263,20,20,1.0,117,2016-01-05,MIL,CHI
4451,51,@,W 106-79 ,240,44,82,0.537,40,69,0.58,4,13,0.308,14,19,0.737,106,33,73,0.452,31,61,0.508,2,12,0.167,11,13,0.846,79,2016-01-11,SAS,BRK
4452,52,Home,W 106-101 ,240,43,93,0.462,40,80,0.5,3,13,0.231,17,28,0.607,106,35,85,0.412,23,56,0.411,12,29,0.414,19,24,0.792,101,2016-01-12,MIL,CHI
4453,53,Home,W 106-101 ,240,38,84,0.452,26,57,0.456,12,27,0.444,18,24,0.75,106,38,72,0.528,37,64,0.578,1,8,0.125,24,34,0.706,101,2016-01-13,WAS,MIL
4454,54,@,W 106-103 (OT),265,37,90,0.411,29,66,0.439,8,24,0.333,24,31,0.774,106,44,97,0.454,35,74,0.473,9,23,0.391,6,8,0.75,103,2016-01-14,TOR,ORL
4455,55,Home,W 106-94 (OT),265,42,97,0.433,37,72,0.514,5,25,0.2,17,22,0.773,106,40,91,0.44,35,68,0.515,5,23,0.217,9,11,0.818,94,2016-01-20,DAL,MIN
4456,56,Home,W 106-87 ,240,45,86,0.523,40,70,0.571,5,16,0.313,11,13,0.846,106,33,68,0.485,26,53,0.491,7,15,0.467,14,18,0.778,87,2016-01-20,WAS,MIA
4457,57,Home,L 106-109 ,240,40,87,0.46,30,54,0.556,10,33,0.303,16,18,0.889,106,45,91,0.495,37,61,0.607,8,30,0.267,11,15,0.733,109,2016-01-22,DAL,OKC
4458,58,Home,W 106-101 ,240,34,68,0.5,29,51,0.569,5,17,0.294,33,36,0.917,106,37,79,0.468,28,60,0.467,9,19,0.474,18,22,0.818,101,2016-01-23,MIN,MEM
4459,59,@,L 106-116 ,240,43,93,0.462,35,67,0.522,8,26,0.308,12,19,0.632,106,45,94,0.479,37,77,0.481,8,17,0.471,18,25,0.72,116,2016-01-24,OKC,BRK
4460,60,Home,W 106-89 ,240,35,79,0.443,24,50,0.48,11,29,0.379,25,32,0.781,106,32,78,0.41,28,63,0.444,4,15,0.267,21,28,0.75,89,2016-01-26,TOR,WAS
4461,61,Home,L 106-114 ,240,40,84,0.476,33,61,0.541,7,23,0.304,19,26,0.731,106,39,83,0.47,30,60,0.5,9,23,0.391,27,29,0.931,114,2016-01-29,DET,CLE
4462,62,Home,L 106-111 (OT),265,43,101,0.426,35,74,0.473,8,27,0.296,12,14,0.857,106,44,88,0.5,37,66,0.561,7,22,0.318,16,23,0.696,111,2016-02-01,IND,CLE
4463,63,Home,W 106-97 ,240,39,79,0.494,30,52,0.577,9,27,0.333,19,23,0.826,106,38,83,0.458,28,55,0.509,10,28,0.357,11,14,0.786,97,2016-02-03,CHA,CLE
4464,64,Home,W 106-94 ,240,44,84,0.524,38,62,0.613,6,22,0.273,12,20,0.6,106,37,87,0.425,28,61,0.459,9,26,0.346,11,14,0.786,94,2016-02-05,WAS,PHI
4465,65,Home,W 106-102 ,240,39,88,0.443,31,64,0.484,8,24,0.333,20,25,0.8,106,34,86,0.395,24,56,0.429,10,30,0.333,24,27,0.889,102,2016-02-06,SAS,LAL
4466,66,Home,L 106-112 (OT),265,43,86,0.5,36,67,0.537,7,19,0.368,13,19,0.684,106,44,89,0.494,34,60,0.567,10,29,0.345,14,20,0.7,112,2016-02-08,MEM,POR
4467,67,Home,L 106-122 ,240,37,73,0.507,36,62,0.581,1,11,0.091,31,39,0.795,106,42,85,0.494,27,52,0.519,15,33,0.455,23,30,0.767,122,2016-02-08,PHO,OKC
4468,68,Home,W 106-95 ,240,42,91,0.462,35,67,0.522,7,24,0.292,15,17,0.882,106,37,93,0.398,29,72,0.403,8,21,0.381,13,22,0.591,95,2016-02-18,CLE,CHI
4469,69,@,L 106-116 ,240,38,88,0.432,33,70,0.471,5,18,0.278,25,34,0.735,106,48,93,0.516,41,77,0.532,7,16,0.438,13,20,0.65,116,2016-02-19,TOR,CHI
4470,70,Home,L 106-111 ,240,37,89,0.416,25,56,0.446,12,33,0.364,20,32,0.625,106,41,86,0.477,37,66,0.561,4,20,0.2,25,29,0.862,111,2016-02-21,DET,NOP
4471,71,Home,L 106-116 ,240,42,98,0.429,33,71,0.465,9,27,0.333,13,23,0.565,106,37,75,0.493,29,57,0.509,8,18,0.444,34,42,0.81,116,2016-02-25,PHO,BRK
4472,72,@,L 106-111 ,240,32,80,0.4,26,60,0.433,6,20,0.3,36,42,0.857,106,37,80,0.463,25,48,0.521,12,32,0.375,25,35,0.714,111,2016-02-27,MEM,PHO
4473,73,@,L 106-121 ,240,40,86,0.465,36,66,0.545,4,20,0.2,22,27,0.815,106,47,87,0.54,36,53,0.679,11,34,0.324,16,21,0.762,121,2016-03-03,OKC,GSW
4474,74,@,W 106-77 ,240,37,68,0.544,24,40,0.6,13,28,0.464,19,26,0.731,106,29,85,0.341,24,58,0.414,5,27,0.185,14,20,0.7,77,2016-03-04,ATL,LAL
4475,75,@,W 106-94 ,240,37,78,0.474,31,58,0.534,6,20,0.3,26,27,0.963,106,38,92,0.413,29,73,0.397,9,19,0.474,9,11,0.818,94,2016-03-05,UTA,NOP
4476,76,@,W 106-103 ,240,41,86,0.477,35,66,0.53,6,20,0.3,18,22,0.818,106,36,80,0.45,29,51,0.569,7,29,0.241,24,29,0.828,103,2016-03-07,MEM,CLE
4477,77,@,W 106-98 ,240,38,79,0.481,34,61,0.557,4,18,0.222,26,33,0.788,106,37,84,0.44,32,58,0.552,5,26,0.192,19,26,0.731,98,2016-03-15,SAC,LAL
4478,78,Home,L 106-122 ,240,40,82,0.488,31,57,0.544,9,25,0.36,17,24,0.708,106,43,76,0.566,31,46,0.674,12,30,0.4,24,32,0.75,122,2016-03-16,HOU,LAC
4479,79,Home,L 106-109 ,240,40,75,0.533,33,58,0.569,7,17,0.412,19,24,0.792,106,40,86,0.465,27,60,0.45,13,26,0.5,16,21,0.762,109,2016-03-17,MIA,CHO
4480,80,Home,W 106-94 ,240,39,76,0.513,26,46,0.565,13,30,0.433,15,16,0.938,106,37,89,0.416,31,64,0.484,6,25,0.24,14,18,0.778,94,2016-03-24,NYK,CHI
4481,81,@,W 106-100 ,240,38,79,0.481,29,54,0.537,9,25,0.36,21,42,0.5,106,31,86,0.36,17,46,0.37,14,40,0.35,24,28,0.857,100,2016-03-29,HOU,CLE
4482,82,Home,L 106-109 ,240,38,83,0.458,18,40,0.45,20,43,0.465,10,13,0.769,106,41,87,0.471,33,64,0.516,8,23,0.348,19,30,0.633,109,2016-04-01,GSW,BOS
4483,83,@,W 106-99 ,240,38,86,0.442,28,60,0.467,10,26,0.385,20,25,0.8,106,36,93,0.387,29,70,0.414,7,23,0.304,20,26,0.769,99,2016-04-01,WAS,PHO
4484,84,Home,L 106-112 ,240,38,87,0.437,31,66,0.47,7,21,0.333,23,29,0.793,106,42,82,0.512,30,60,0.5,12,22,0.545,16,17,0.941,112,2016-04-01,SAC,MIA
4485,85,Home,L 106-115 ,240,40,92,0.435,31,63,0.492,9,29,0.31,17,24,0.708,106,41,88,0.466,33,67,0.493,8,21,0.381,25,31,0.806,115,2016-04-02,DEN,SAC
4486,86,@,W 106-87 ,240,42,76,0.553,34,54,0.63,8,22,0.364,14,23,0.609,106,33,85,0.388,25,62,0.403,8,23,0.348,13,21,0.619,87,2016-04-03,NOP,BRK
4487,87,Home,W 106-98 ,240,44,92,0.478,40,78,0.513,4,14,0.286,14,17,0.824,106,35,78,0.449,32,64,0.5,3,14,0.214,25,28,0.893,98,2016-04-07,MIA,CHI
4488,88,@,W 106-105 ,240,41,84,0.488,36,71,0.507,5,13,0.385,19,25,0.76,106,40,80,0.5,31,56,0.554,9,24,0.375,16,18,0.889,105,2016-04-09,MIN,POR
4489,89,Home,L 106-114 ,240,39,85,0.459,35,67,0.522,4,18,0.222,24,32,0.75,106,37,91,0.407,29,62,0.468,8,29,0.276,32,46,0.696,114,2016-10-27,POR,LAC
4490,90,@,W 106-98 ,240,33,70,0.471,18,38,0.474,15,32,0.469,25,31,0.806,106,35,80,0.438,27,51,0.529,8,29,0.276,20,24,0.833,98,2016-10-28,HOU,DAL
4491,91,Home,W 106-103 ,240,39,85,0.459,30,59,0.508,9,26,0.346,19,25,0.76,106,37,70,0.529,30,48,0.625,7,22,0.318,22,31,0.71,103,2016-10-29,SAC,MIN
4492,92,@,W 106-99 ,240,37,82,0.451,27,64,0.422,10,18,0.556,22,26,0.846,106,37,80,0.463,30,60,0.5,7,20,0.35,18,26,0.692,99,2016-10-30,SAS,MIA
4493,93,@,W 106-100 ,240,35,83,0.422,27,54,0.5,8,29,0.276,28,33,0.848,106,37,90,0.411,29,67,0.433,8,23,0.348,18,25,0.72,100,2016-10-30,GSW,PHO
4494,94,Home,W 106-95 ,240,33,79,0.418,22,49,0.449,11,30,0.367,29,47,0.617,106,36,75,0.48,26,52,0.5,10,23,0.435,13,19,0.684,95,2016-10-31,ATL,SAC
4495,95,@,W 106-91 ,240,38,76,0.5,23,45,0.511,15,31,0.484,15,18,0.833,106,33,76,0.434,27,56,0.482,6,20,0.3,19,21,0.905,91,2016-11-01,UTA,SAS
4496,96,@,L 106-116 ,240,39,80,0.488,32,59,0.542,7,21,0.333,21,27,0.778,106,45,90,0.5,29,55,0.527,16,35,0.457,10,12,0.833,116,2016-11-07,NOP,GSW
4497,97,Home,L 106-114 ,240,39,94,0.415,29,67,0.433,10,27,0.37,18,20,0.9,106,41,79,0.519,24,42,0.571,17,37,0.459,15,18,0.833,114,2016-11-07,WAS,HOU
4498,98,Home,L 106-110 ,240,37,99,0.374,26,57,0.456,11,42,0.262,21,25,0.84,106,41,81,0.506,30,52,0.577,11,29,0.379,17,24,0.708,110,2016-11-08,CLE,ATL
4499,99,Home,L 106-112 ,240,40,91,0.44,34,73,0.466,6,18,0.333,20,25,0.8,106,39,89,0.438,30,64,0.469,9,25,0.36,25,27,0.926,112,2016-11-10,MIL,NOP
4500,0,Home,W 106-95 ,240,39,97,0.402,34,82,0.415,5,15,0.333,23,25,0.92,106,38,91,0.418,34,78,0.436,4,13,0.308,15,18,0.833,95,2016-11-12,CHI,WAS
4501,1,@,W 106-95 ,240,46,90,0.511,42,72,0.583,4,18,0.222,10,14,0.714,106,36,84,0.429,27,59,0.458,9,25,0.36,14,19,0.737,95,2016-11-12,DET,DEN
4502,2,@,W 106-100 ,240,41,76,0.539,36,58,0.621,5,18,0.278,19,24,0.792,106,34,89,0.382,19,42,0.452,15,47,0.319,17,21,0.81,100,2016-11-12,SAS,HOU
4503,3,Home,W 106-96 ,240,36,68,0.529,29,50,0.58,7,18,0.389,27,36,0.75,106,35,78,0.449,29,48,0.604,6,30,0.2,20,21,0.952,96,2016-11-12,MIL,MEM
4504,4,Home,W 106-105 ,240,35,79,0.443,29,58,0.5,6,21,0.286,30,36,0.833,106,38,95,0.4,26,54,0.481,12,41,0.293,17,20,0.85,105,2016-11-14,NOP,BOS
4505,5,Home,W 106-101 ,240,37,91,0.407,27,63,0.429,10,28,0.357,22,34,0.647,106,39,91,0.429,28,64,0.438,11,27,0.407,12,15,0.8,101,2016-11-21,WAS,PHO
4506,6,@,L 106-149 ,240,40,93,0.43,32,73,0.438,8,20,0.4,18,22,0.818,106,53,86,0.616,34,50,0.68,19,36,0.528,24,35,0.686,149,2016-11-23,LAL,GSW
4507,7,Home,W 106-88 ,240,42,83,0.506,34,60,0.567,8,23,0.348,14,26,0.538,106,37,82,0.451,36,63,0.571,1,19,0.053,13,17,0.765,88,2016-11-26,OKC,DET
4508,8,@,W 106-98 ,240,41,93,0.441,32,69,0.464,9,24,0.375,15,26,0.577,106,38,91,0.418,31,69,0.449,7,22,0.318,15,24,0.625,98,2016-11-30,MIA,DEN
4509,9,@,W 106-104 ,240,41,91,0.451,28,59,0.475,13,32,0.406,11,15,0.733,106,34,77,0.442,30,58,0.517,4,19,0.211,32,39,0.821,104,2016-11-30,NYK,MIN
4510,10,Home,L 106-107 ,240,35,76,0.461,20,43,0.465,15,33,0.455,21,26,0.808,106,38,76,0.5,30,50,0.6,8,26,0.308,23,29,0.793,107,2016-12-03,PHI,BOS
4511,11,Home,W 106-98 ,240,39,88,0.443,28,59,0.475,11,29,0.379,17,24,0.708,106,31,97,0.32,22,69,0.319,9,28,0.321,27,31,0.871,98,2016-12-04,NYK,SAC
4512,12,@,L 106-142 ,240,35,85,0.412,32,70,0.457,3,15,0.2,33,35,0.943,106,54,104,0.519,40,67,0.597,14,37,0.378,20,26,0.769,142,2016-12-05,IND,GSW
4513,13,@,L 106-107 ,240,42,99,0.424,31,67,0.463,11,32,0.344,11,12,0.917,106,34,76,0.447,22,38,0.579,12,38,0.316,27,31,0.871,107,2016-12-05,BOS,HOU
4514,14,@,W 106-98 ,240,35,76,0.461,25,49,0.51,10,27,0.37,26,34,0.765,106,35,86,0.407,24,55,0.436,11,31,0.355,17,23,0.739,98,2016-12-05,DEN,PHI
4515,15,@,W 106-99 ,240,39,80,0.488,27,51,0.529,12,29,0.414,16,23,0.696,106,37,89,0.416,27,51,0.529,10,38,0.263,15,21,0.714,99,2016-12-08,GSW,UTA
4516,16,@,L 106-109 ,240,38,74,0.514,24,41,0.585,14,33,0.424,16,21,0.762,106,45,87,0.517,40,69,0.58,5,18,0.278,14,17,0.824,109,2016-12-14,CHA,WAS
4517,17,Home,W 106-101 ,240,39,83,0.47,28,55,0.509,11,28,0.393,17,22,0.773,106,37,92,0.402,31,73,0.425,6,19,0.316,21,25,0.84,101,2016-12-22,LAC,SAS
4518,18,Home,W 106-95 ,240,41,96,0.427,32,76,0.421,9,20,0.45,15,17,0.882,106,39,90,0.433,34,63,0.54,5,27,0.185,12,16,0.75,95,2016-12-22,NYK,ORL
4519,19,Home,W 106-90 ,240,41,92,0.446,25,64,0.391,16,28,0.571,8,15,0.533,106,30,79,0.38,19,51,0.373,11,28,0.393,19,23,0.826,90,2016-12-26,DET,CLE
4520,20,@,W 106-102 ,240,36,82,0.439,25,51,0.49,11,31,0.355,23,28,0.821,106,39,84,0.464,30,59,0.508,9,25,0.36,15,20,0.75,102,2016-12-26,DEN,LAC
4521,21,@,W 106-94 ,240,42,82,0.512,37,63,0.587,5,19,0.263,17,25,0.68,106,36,82,0.439,29,59,0.492,7,23,0.304,15,21,0.714,94,2016-12-27,OKC,MIA
4522,22,@,W 106-94 ,240,41,85,0.482,28,55,0.509,13,30,0.433,11,15,0.733,106,34,83,0.41,26,58,0.448,8,25,0.32,18,24,0.75,94,2017-01-04,CHI,CLE
4523,23,@,L 106-115 ,240,38,88,0.432,27,60,0.45,11,28,0.393,19,25,0.76,106,37,73,0.507,28,50,0.56,9,23,0.391,32,45,0.711,115,2017-01-04,MEM,LAC
4524,24,@,L 106-110 ,240,37,79,0.468,28,51,0.549,9,28,0.321,23,26,0.885,106,35,87,0.402,16,47,0.34,19,40,0.475,21,25,0.84,110,2017-01-06,PHI,BOS
4525,25,@,W 106-98 ,240,39,84,0.464,26,53,0.491,13,31,0.419,15,21,0.714,106,36,87,0.414,27,57,0.474,9,30,0.3,17,22,0.773,98,2017-01-06,LAC,SAC
4526,26,@,L 106-121 ,240,40,99,0.404,31,75,0.413,9,24,0.375,17,24,0.708,106,43,89,0.483,31,53,0.585,12,36,0.333,23,29,0.793,121,2017-01-07,DEN,OKC
4527,27,Home,L 106-117 ,240,36,74,0.486,25,46,0.543,11,28,0.393,23,29,0.793,106,45,89,0.506,35,60,0.583,10,29,0.345,17,20,0.85,117,2017-01-08,SAC,GSW
4528,28,@,L 106-114 ,240,40,85,0.471,31,58,0.534,9,27,0.333,17,20,0.85,106,41,87,0.471,31,65,0.477,10,22,0.455,22,27,0.815,114,2017-01-10,BOS,TOR
4529,29,@,W 106-101 ,240,41,89,0.461,33,66,0.5,8,23,0.348,16,24,0.667,106,40,81,0.494,35,59,0.593,5,22,0.227,16,17,0.941,101,2017-01-16,UTA,PHO
4530,30,Home,L 106-117 ,240,35,91,0.385,26,58,0.448,9,33,0.273,27,29,0.931,106,46,91,0.505,36,66,0.545,10,25,0.4,15,18,0.833,117,2017-01-18,BOS,NYK
4531,31,@,W 106-100 ,240,39,75,0.52,32,54,0.593,7,21,0.333,21,25,0.84,106,35,72,0.486,26,51,0.51,9,21,0.429,21,27,0.778,100,2017-01-18,IND,SAC
4532,32,Home,L 106-108 ,240,38,84,0.452,32,59,0.542,6,25,0.24,24,28,0.857,106,38,85,0.447,31,61,0.508,7,24,0.292,25,33,0.758,108,2017-01-24,TOR,SAS
4533,33,Home,L 106-109 ,240,35,80,0.438,22,45,0.489,13,35,0.371,23,26,0.885,106,40,83,0.482,29,60,0.483,11,23,0.478,18,25,0.72,109,2017-01-25,BRK,MIA
4534,34,Home,L 106-109 ,240,36,75,0.48,24,38,0.632,12,37,0.324,22,24,0.917,106,41,79,0.519,30,52,0.577,11,27,0.407,16,26,0.615,109,2017-01-28,CHA,SAC
4535,35,@,L 106-108 (OT),265,40,94,0.426,28,64,0.438,12,30,0.4,14,19,0.737,106,43,94,0.457,33,63,0.524,10,31,0.323,12,15,0.8,108,2017-01-31,NOP,TOR
4536,36,@,W 106-97 ,240,37,86,0.43,29,66,0.439,8,20,0.4,24,31,0.774,106,32,86,0.372,21,58,0.362,11,28,0.393,22,23,0.957,97,2017-02-03,IND,BRK
4537,37,@,L 106-109 (OT),265,36,87,0.414,21,43,0.488,15,44,0.341,19,24,0.792,106,43,88,0.489,36,65,0.554,7,23,0.304,16,19,0.842,109,2017-02-04,GSW,SAC
4538,38,@,L 106-111 ,240,40,93,0.43,35,66,0.53,5,27,0.185,21,25,0.84,106,42,92,0.457,33,66,0.5,9,26,0.346,18,22,0.818,111,2017-02-06,PHO,NOP
4539,39,@,L 106-117 ,240,40,100,0.4,27,56,0.482,13,44,0.295,13,21,0.619,106,47,93,0.505,39,66,0.591,8,27,0.296,15,18,0.833,117,2017-02-08,DEN,ATL
4540,40,@,W 106-88 ,240,41,86,0.477,30,53,0.566,11,33,0.333,13,18,0.722,106,33,71,0.465,27,56,0.482,6,15,0.4,16,28,0.571,88,2017-02-08,MIA,MIL
4541,41,Home,L 106-122 ,240,38,82,0.463,32,55,0.582,6,27,0.222,24,32,0.75,106,45,75,0.6,33,50,0.66,12,25,0.48,20,27,0.741,122,2017-02-10,MIN,NOP
4542,42,Home,L 106-110 ,240,38,78,0.487,29,58,0.5,9,20,0.45,21,30,0.7,106,40,87,0.46,33,72,0.458,7,15,0.467,23,27,0.852,110,2017-02-13,IND,SAS
4543,43,@,L 106-112 ,240,35,79,0.443,26,58,0.448,9,21,0.429,27,35,0.771,106,42,78,0.538,35,58,0.603,7,20,0.35,21,27,0.778,112,2017-02-26,POR,TOR
4544,44,@,L 106-109 ,240,43,93,0.462,34,71,0.479,9,22,0.409,11,13,0.846,106,39,76,0.513,24,54,0.444,15,22,0.682,16,23,0.696,109,2017-02-28,UTA,OKC
4545,45,Home,L 106-114 ,240,34,92,0.37,24,62,0.387,10,30,0.333,28,32,0.875,106,41,81,0.506,30,56,0.536,11,25,0.44,21,27,0.778,114,2017-03-03,WAS,TOR
4546,46,Home,L 106-136 ,240,43,88,0.489,29,54,0.537,14,34,0.412,6,7,0.857,106,54,95,0.568,44,72,0.611,10,23,0.435,18,21,0.857,136,2017-03-04,PHI,DET
4547,47,@,L 106-109 ,240,32,85,0.376,19,48,0.396,13,37,0.351,29,40,0.725,106,42,94,0.447,38,74,0.514,4,20,0.2,21,26,0.808,109,2017-03-05,BOS,PHO
4548,48,@,W 106-98 ,240,39,91,0.429,23,56,0.411,16,35,0.457,12,14,0.857,106,35,78,0.449,26,51,0.51,9,27,0.333,19,29,0.655,98,2017-03-06,MIA,CLE
4549,49,Home,W 106-101 ,240,41,87,0.471,32,61,0.525,9,26,0.346,15,19,0.789,106,39,84,0.464,28,45,0.622,11,39,0.282,12,19,0.632,101,2017-03-09,DET,CLE
4550,50,@,W 105-94 ,240,38,78,0.487,34,71,0.479,4,7,0.571,25,36,0.694,105,31,82,0.378,22,54,0.407,9,28,0.321,23,30,0.767,94,2011-12-25,MIA,DAL
4551,51,@,W 105-86 ,240,37,81,0.457,29,58,0.5,8,23,0.348,23,38,0.605,105,32,82,0.39,27,61,0.443,5,21,0.238,17,24,0.708,86,2011-12-25,LAC,GSW
4552,52,@,W 105-89 ,240,40,70,0.571,33,58,0.569,7,12,0.583,18,22,0.818,105,36,81,0.444,27,60,0.45,9,21,0.429,8,11,0.727,89,2011-12-28,CLE,DET
4553,53,Home,W 105-85 ,240,43,85,0.506,34,59,0.576,9,26,0.346,10,13,0.769,105,35,93,0.376,33,76,0.434,2,17,0.118,13,20,0.65,85,2011-12-29,HOU,SAS
4554,54,Home,W 105-98 ,240,37,77,0.481,33,62,0.532,4,15,0.267,27,38,0.711,105,38,82,0.463,29,62,0.468,9,20,0.45,13,14,0.929,98,2011-12-30,ATL,NJN
4555,55,Home,W 105-97 ,240,37,72,0.514,32,58,0.552,5,14,0.357,26,32,0.813,105,37,83,0.446,31,60,0.517,6,23,0.261,17,24,0.708,97,2012-01-10,POR,LAC
4556,56,@,L 105-113 ,240,35,78,0.449,31,58,0.534,4,20,0.2,31,43,0.721,105,45,76,0.592,42,66,0.636,3,10,0.3,20,29,0.69,113,2012-01-10,CLE,UTA
4557,57,@,L 105-107 (OT),265,37,90,0.411,28,64,0.438,9,26,0.346,22,31,0.71,105,39,93,0.419,34,75,0.453,5,18,0.278,24,28,0.857,107,2012-01-14,POR,HOU
4558,58,@,W 105-95 ,240,41,94,0.436,32,75,0.427,9,19,0.474,14,19,0.737,105,35,82,0.427,30,67,0.448,5,15,0.333,20,28,0.714,95,2012-01-17,GSW,CLE
4559,59,@,W 105-95 ,240,32,75,0.427,20,50,0.4,12,25,0.48,29,37,0.784,105,38,91,0.418,31,68,0.456,7,23,0.304,12,14,0.857,95,2012-01-17,DEN,MIL
4560,60,Home,W 105-102 ,240,33,86,0.384,25,65,0.385,8,21,0.381,31,43,0.721,105,37,77,0.481,33,58,0.569,4,19,0.211,24,30,0.8,102,2012-01-18,WAS,OKC
4561,61,Home,W 105-102 ,240,44,79,0.557,38,57,0.667,6,22,0.273,11,12,0.917,105,42,94,0.447,35,72,0.486,7,22,0.318,11,15,0.733,102,2012-01-21,HOU,SAS
4562,62,@,W 105-90 ,240,34,77,0.442,25,56,0.446,9,21,0.429,28,33,0.848,105,39,95,0.411,33,73,0.452,6,22,0.273,6,10,0.6,90,2012-01-25,MIN,DAL
4563,63,@,W 105-99 ,240,39,91,0.429,25,62,0.403,14,29,0.483,13,17,0.765,105,38,93,0.409,30,62,0.484,8,31,0.258,15,20,0.75,99,2012-01-25,MIL,HOU
4564,64,Home,W 105-83 ,240,42,82,0.512,31,59,0.525,11,23,0.478,10,15,0.667,105,35,80,0.438,29,63,0.46,6,17,0.353,7,10,0.7,83,2012-01-25,SAS,ATL
4565,65,Home,L 105-109 ,240,42,85,0.494,36,67,0.537,6,18,0.333,15,20,0.75,105,39,86,0.453,25,56,0.446,14,30,0.467,17,26,0.654,109,2012-01-29,DEN,LAC
4566,66,Home,W 105-97 ,240,39,88,0.443,29,65,0.446,10,23,0.435,17,25,0.68,105,34,73,0.466,25,53,0.472,9,20,0.45,20,24,0.833,97,2012-02-01,MIL,MIA
4567,67,Home,L 105-107 ,240,38,81,0.469,35,70,0.5,3,11,0.273,26,36,0.722,105,42,87,0.483,37,65,0.569,5,22,0.227,18,23,0.783,107,2012-02-01,UTA,LAC
4568,68,@,W 105-102 ,240,39,74,0.527,33,62,0.532,6,12,0.5,21,29,0.724,105,44,90,0.489,40,74,0.541,4,16,0.25,10,14,0.714,102,2012-02-02,CHI,NYK
4569,69,Home,L 105-108 ,240,38,86,0.442,28,65,0.431,10,21,0.476,19,24,0.792,105,36,82,0.439,29,66,0.439,7,16,0.438,29,32,0.906,108,2012-02-03,BRK,MIN
4570,70,Home,L 105-107 ,240,39,81,0.481,30,61,0.492,9,20,0.45,18,20,0.9,105,45,94,0.479,36,69,0.522,9,25,0.36,8,8,1.0,107,2012-02-07,MIL,PHO
4571,71,@,W 105-95 ,240,44,90,0.489,35,62,0.565,9,28,0.321,8,9,0.889,105,33,72,0.458,24,46,0.522,9,26,0.346,20,27,0.741,95,2012-02-08,DAL,DEN
4572,72,@,W 105-99 ,240,33,72,0.458,21,47,0.447,12,25,0.48,27,37,0.73,105,37,90,0.411,28,66,0.424,9,24,0.375,16,17,0.941,99,2012-02-08,MIL,TOR
4573,73,@,W 105-90 ,240,35,70,0.5,30,57,0.526,5,13,0.385,30,35,0.857,105,33,76,0.434,31,61,0.508,2,15,0.133,22,29,0.759,90,2012-02-14,MIA,IND
4574,74,@,W 105-100 ,240,41,88,0.466,35,73,0.479,6,15,0.4,17,20,0.85,105,37,72,0.514,26,45,0.578,11,27,0.407,15,15,1.0,100,2012-02-15,MEM,NJN
4575,75,@,W 105-102 ,240,38,74,0.514,30,56,0.536,8,18,0.444,21,27,0.778,105,40,84,0.476,31,59,0.525,9,25,0.36,13,19,0.684,102,2012-03-01,OKC,ORL
4576,76,Home,L 105-117 ,240,36,76,0.474,26,47,0.553,10,29,0.345,23,29,0.793,105,43,97,0.443,35,75,0.467,8,22,0.364,23,35,0.657,117,2012-03-02,HOU,DEN
4577,77,Home,W 105-83 ,240,42,89,0.472,34,72,0.472,8,17,0.471,13,16,0.813,105,33,82,0.402,28,64,0.438,5,18,0.278,12,14,0.857,83,2012-03-02,PHI,GSW
4578,78,@,W 105-103 (OT),265,40,86,0.465,34,72,0.472,6,14,0.429,19,25,0.76,105,37,86,0.43,27,66,0.409,10,20,0.5,19,24,0.792,103,2012-03-04,LAC,HOU
4579,79,@,L 105-118 ,240,41,96,0.427,31,68,0.456,10,28,0.357,13,17,0.765,105,46,85,0.541,39,66,0.591,7,19,0.368,19,25,0.76,118,2012-03-07,NYK,SAS
4580,80,@,W 105-102 ,240,39,82,0.476,33,64,0.516,6,18,0.333,21,27,0.778,105,37,81,0.457,29,61,0.475,8,20,0.4,20,26,0.769,102,2012-03-09,LAL,MIN
4581,81,Home,W 105-86 ,240,39,74,0.527,32,53,0.604,7,21,0.333,20,25,0.8,105,29,73,0.397,24,52,0.462,5,21,0.238,23,25,0.92,86,2012-03-10,DET,TOR
4582,82,@,W 105-99 ,240,35,73,0.479,29,55,0.527,6,18,0.333,29,35,0.829,105,40,86,0.465,36,73,0.493,4,13,0.308,15,19,0.789,99,2012-03-11,MIL,TOR
4583,83,@,W 105-99 ,240,43,92,0.467,33,67,0.493,10,25,0.4,9,11,0.818,105,37,76,0.487,33,59,0.559,4,17,0.235,21,29,0.724,99,2012-03-12,MIL,NJN
4584,84,Home,W 105-90 ,240,39,72,0.542,32,61,0.525,7,11,0.636,20,26,0.769,105,34,71,0.479,31,59,0.525,3,12,0.25,19,28,0.679,90,2012-03-12,UTA,DET
4585,85,@,W 105-103 ,240,40,78,0.513,34,65,0.523,6,13,0.462,19,21,0.905,105,41,78,0.526,36,57,0.632,5,21,0.238,16,19,0.842,103,2012-03-14,BOS,GSW
4586,86,@,L 105-115 ,240,38,85,0.447,27,61,0.443,11,24,0.458,18,25,0.72,105,46,86,0.535,39,63,0.619,7,23,0.304,16,21,0.762,115,2012-03-14,CLE,MIL
4587,87,@,L 105-111 (OT),265,36,83,0.434,27,56,0.482,9,27,0.333,24,33,0.727,105,43,103,0.417,38,90,0.422,5,13,0.385,20,27,0.741,111,2012-03-15,MIN,UTA
4588,88,Home,L 105-114 ,240,39,88,0.443,30,63,0.476,9,25,0.36,18,20,0.9,105,45,87,0.517,36,68,0.529,9,19,0.474,15,25,0.6,114,2012-03-16,OKC,SAS
4589,89,@,W 105-80 ,240,46,86,0.535,41,75,0.547,5,11,0.455,8,9,0.889,105,29,75,0.387,27,67,0.403,2,8,0.25,20,28,0.714,80,2012-03-19,PHI,CHA
4590,90,@,W 105-100 ,240,41,89,0.461,36,74,0.486,5,15,0.333,18,27,0.667,105,34,81,0.42,28,58,0.483,6,23,0.261,26,31,0.839,100,2012-03-19,CLE,NJN
4591,91,Home,W 105-90 ,240,37,81,0.457,27,63,0.429,10,18,0.556,21,28,0.75,105,29,69,0.42,21,49,0.429,8,20,0.4,24,37,0.649,90,2012-03-26,IND,MIA
4592,92,@,W 105-84 ,240,42,81,0.519,37,67,0.552,5,14,0.357,16,18,0.889,105,29,81,0.358,24,60,0.4,5,21,0.238,21,35,0.6,84,2012-03-26,UTA,NJN
4593,93,Home,W 105-96 ,240,35,86,0.407,23,64,0.359,12,22,0.545,23,33,0.697,105,33,80,0.413,28,60,0.467,5,20,0.25,25,30,0.833,96,2012-03-28,TOR,DEN
4594,94,Home,W 105-96 ,240,39,72,0.542,29,51,0.569,10,21,0.476,17,24,0.708,105,35,77,0.455,31,65,0.477,4,12,0.333,22,31,0.71,96,2012-03-31,LAC,UTA
4595,95,Home,L 105-107 ,240,40,79,0.506,37,70,0.529,3,9,0.333,22,28,0.786,105,41,91,0.451,28,60,0.467,13,31,0.419,12,22,0.545,107,2012-04-04,UTA,PHO
4596,96,Home,W 105-99 ,240,37,92,0.402,26,65,0.4,11,27,0.407,20,31,0.645,105,34,82,0.415,26,60,0.433,8,22,0.364,23,29,0.793,99,2012-04-06,DEN,PHO
4597,97,@,L 105-125 ,240,47,97,0.485,46,88,0.523,1,9,0.111,10,18,0.556,105,47,94,0.5,33,65,0.508,14,29,0.483,17,21,0.81,125,2012-04-07,LAL,PHO
4598,98,Home,W 105-96 ,240,38,68,0.559,34,59,0.576,4,9,0.444,25,36,0.694,105,36,83,0.434,29,61,0.475,7,22,0.318,17,23,0.739,96,2012-04-11,NOP,SAC
4599,99,Home,L 105-112 ,240,36,84,0.429,32,65,0.492,4,19,0.211,29,33,0.879,105,38,77,0.494,30,59,0.508,8,18,0.444,28,33,0.848,112,2012-04-13,HOU,PHO
4600,0,Home,W 105-82 ,240,44,85,0.518,42,71,0.592,2,14,0.143,15,17,0.882,105,33,74,0.446,28,57,0.491,5,17,0.294,11,19,0.579,82,2012-04-13,MIA,CHA
4601,1,@,W 105-99 ,240,37,92,0.402,30,73,0.411,7,19,0.368,24,26,0.923,105,37,84,0.44,28,61,0.459,9,23,0.391,16,26,0.615,99,2012-04-14,IND,MIL
4602,2,Home,W 105-91 ,240,40,76,0.526,31,58,0.534,9,18,0.5,16,19,0.842,105,38,96,0.396,36,80,0.45,2,16,0.125,13,18,0.722,91,2012-04-14,SAS,PHO
4603,3,@,W 105-102 ,240,38,80,0.475,29,62,0.468,9,18,0.5,20,29,0.69,105,40,94,0.426,32,65,0.492,8,29,0.276,14,17,0.824,102,2012-04-16,DEN,HOU
4604,4,Home,W 105-99 (OT),265,41,87,0.471,37,67,0.552,4,20,0.2,19,24,0.792,105,37,89,0.416,26,58,0.448,11,31,0.355,14,25,0.56,99,2012-04-19,NOP,HOU
4605,5,@,W 105-87 ,240,43,80,0.538,38,66,0.576,5,14,0.357,14,17,0.824,105,31,72,0.431,27,58,0.466,4,14,0.286,21,23,0.913,87,2012-04-23,PHI,NJN
4606,6,@,W 105-96 ,240,39,79,0.494,29,52,0.558,10,27,0.37,17,23,0.739,105,35,79,0.443,29,63,0.46,6,16,0.375,20,26,0.769,96,2012-10-31,HOU,DET
4607,7,@,W 105-95 ,240,38,84,0.452,30,62,0.484,8,22,0.364,21,27,0.778,105,34,68,0.5,27,52,0.519,7,16,0.438,20,28,0.714,95,2012-11-02,LAC,LAL
4608,8,Home,W 105-102 ,240,41,79,0.519,32,55,0.582,9,24,0.375,14,21,0.667,105,39,83,0.47,33,67,0.493,6,16,0.375,18,29,0.621,102,2012-11-03,MIL,CLE
4609,9,Home,W 105-86 ,240,40,90,0.444,30,69,0.435,10,21,0.476,15,17,0.882,105,29,64,0.453,23,48,0.479,6,16,0.375,22,31,0.71,86,2012-11-04,TOR,MIN
4610,10,Home,W 105-103 ,240,40,82,0.488,33,66,0.5,7,16,0.438,18,24,0.75,105,36,73,0.493,28,51,0.549,8,22,0.364,23,31,0.742,103,2012-11-07,SAC,DET
4611,11,Home,W 105-94 ,240,38,71,0.535,30,51,0.588,8,20,0.4,21,26,0.808,105,36,87,0.414,30,68,0.441,6,19,0.316,16,22,0.727,94,2012-11-09,OKC,DET
4612,12,@,L 105-107 ,240,37,77,0.481,28,56,0.5,9,21,0.429,22,27,0.815,105,38,81,0.469,32,64,0.5,6,17,0.353,25,33,0.758,107,2012-11-09,CLE,PHO
4613,13,@,W 105-96 ,240,41,80,0.513,34,60,0.567,7,20,0.35,16,18,0.889,105,37,85,0.435,27,61,0.443,10,24,0.417,12,16,0.75,96,2012-11-12,MIL,PHI
4614,14,Home,W 105-95 ,240,37,76,0.487,32,61,0.525,5,15,0.333,26,32,0.813,105,37,72,0.514,32,53,0.604,5,19,0.263,16,21,0.762,95,2012-11-16,MEM,NYK
4615,15,@,W 105-101 (OT),265,37,91,0.407,28,67,0.418,9,24,0.375,22,30,0.733,105,37,86,0.43,27,65,0.415,10,21,0.476,17,24,0.708,101,2012-11-19,GSW,DAL
4616,16,@,W 105-98 ,240,36,71,0.507,21,46,0.457,15,25,0.6,18,23,0.783,105,37,79,0.468,19,42,0.452,18,37,0.486,6,11,0.545,98,2012-11-26,NOP,LAC
4617,17,Home,W 105-103 ,240,36,78,0.462,28,56,0.5,8,22,0.364,25,34,0.735,105,40,73,0.548,35,59,0.593,5,14,0.357,18,32,0.563,103,2012-11-26,UTA,DEN
4618,18,@,L 105-106 ,240,38,84,0.452,28,63,0.444,10,21,0.476,19,24,0.792,105,44,86,0.512,36,68,0.529,8,18,0.444,10,13,0.769,106,2012-11-29,DEN,GSW
4619,19,Home,W 105-100 ,240,42,86,0.488,37,73,0.507,5,13,0.385,16,19,0.842,105,36,80,0.45,26,50,0.52,10,30,0.333,18,24,0.75,100,2012-11-29,MIA,SAS
4620,20,@,W 105-104 ,240,42,89,0.472,38,68,0.559,4,21,0.19,17,24,0.708,105,42,74,0.568,33,54,0.611,9,20,0.45,11,15,0.733,104,2012-12-03,LAC,UTA
4621,21,@,L 105-107 ,240,38,83,0.458,31,62,0.5,7,21,0.333,22,34,0.647,105,38,101,0.376,31,67,0.463,7,34,0.206,24,31,0.774,107,2012-12-04,LAL,HOU
4622,22,@,W 105-88 ,240,41,77,0.532,28,52,0.538,13,25,0.52,10,17,0.588,105,35,83,0.422,30,63,0.476,5,20,0.25,13,23,0.565,88,2012-12-04,MIN,PHI
4623,23,Home,W 105-101 ,240,38,79,0.481,31,60,0.517,7,19,0.368,22,29,0.759,105,41,89,0.461,33,61,0.541,8,28,0.286,11,16,0.688,101,2012-12-04,WAS,MIA
4624,24,@,L 105-108 ,240,42,83,0.506,35,67,0.522,7,16,0.438,14,24,0.583,105,38,87,0.437,36,73,0.493,2,14,0.143,30,37,0.811,108,2012-12-12,DEN,MIN
4625,25,@,L 105-107 (2OT),290,40,99,0.404,35,83,0.422,5,16,0.313,20,26,0.769,105,42,93,0.452,32,67,0.478,10,26,0.385,13,16,0.813,107,2012-12-14,DET,BRK
4626,26,Home,W 105-89 ,240,38,73,0.521,27,49,0.551,11,24,0.458,18,22,0.818,105,30,73,0.411,23,57,0.404,7,16,0.438,22,26,0.846,89,2012-12-22,MIA,UTA
4627,27,@,W 105-92 ,240,37,81,0.457,25,58,0.431,12,23,0.522,19,25,0.76,105,34,78,0.436,29,64,0.453,5,14,0.357,19,28,0.679,92,2012-12-26,MIA,CHA
4628,28,@,L 105-111 (OT),265,40,95,0.421,29,71,0.408,11,24,0.458,14,16,0.875,105,39,93,0.419,29,68,0.426,10,25,0.4,23,28,0.821,111,2012-12-27,DAL,OKC
4629,29,@,L 105-106 ,240,41,83,0.494,30,53,0.566,11,30,0.367,12,20,0.6,105,39,86,0.453,24,56,0.429,15,30,0.5,13,17,0.765,106,2012-12-28,NYK,SAC
4630,30,Home,W 105-97 ,240,42,88,0.477,36,68,0.529,6,20,0.3,15,17,0.882,105,39,86,0.453,29,58,0.5,10,28,0.357,9,11,0.818,97,2012-12-28,WAS,ORL
4631,31,@,W 105-100 ,240,41,81,0.506,30,48,0.625,11,33,0.333,12,18,0.667,105,36,84,0.429,26,47,0.553,10,37,0.27,18,24,0.75,100,2013-01-01,POR,NYK
4632,32,@,W 105-96 ,240,40,76,0.526,36,64,0.563,4,12,0.333,21,30,0.7,105,30,79,0.38,19,46,0.413,11,33,0.333,25,37,0.676,96,2013-01-04,SAC,TOR
4633,33,Home,L 105-112 ,240,38,82,0.463,28,52,0.538,10,30,0.333,19,27,0.704,105,44,101,0.436,35,77,0.455,9,24,0.375,15,23,0.652,112,2013-01-06,LAL,DEN
4634,34,@,L 105-108 ,240,44,93,0.473,36,69,0.522,8,24,0.333,9,10,0.9,105,41,94,0.436,37,82,0.451,4,12,0.333,22,36,0.611,108,2013-01-09,ORL,DEN
4635,35,@,L 105-108 ,240,44,95,0.463,36,68,0.529,8,27,0.296,9,15,0.6,105,41,84,0.488,29,59,0.492,12,25,0.48,14,16,0.875,108,2013-01-09,LAL,SAS
4636,36,@,L 105-116 ,240,43,83,0.518,30,59,0.508,13,24,0.542,6,8,0.75,105,43,90,0.478,34,63,0.54,9,27,0.333,21,27,0.778,116,2013-01-13,GSW,DEN
4637,37,Home,W 105-100 ,240,33,86,0.384,28,64,0.438,5,22,0.227,34,43,0.791,105,33,84,0.393,22,57,0.386,11,27,0.407,23,30,0.767,100,2013-01-16,DAL,HOU
4638,38,Home,L 105-107 (OT),265,38,85,0.447,32,69,0.464,6,16,0.375,23,32,0.719,105,39,86,0.453,36,75,0.48,3,11,0.273,26,36,0.722,107,2013-01-16,TOR,CHI
4639,39,Home,W 105-95 ,240,40,87,0.46,29,68,0.426,11,19,0.579,14,17,0.824,105,34,83,0.41,21,53,0.396,13,30,0.433,14,16,0.875,95,2013-01-18,IND,HOU
4640,40,Home,L 105-111 ,240,40,79,0.506,31,58,0.534,9,21,0.429,16,20,0.8,105,45,90,0.5,37,75,0.493,8,15,0.533,13,15,0.867,111,2013-01-20,ORL,DAL
4641,41,@,L 105-114 ,240,38,81,0.469,35,66,0.53,3,15,0.2,26,32,0.813,105,43,89,0.483,31,64,0.484,12,25,0.48,16,21,0.762,114,2013-01-21,SAC,NOH
4642,42,Home,W 105-90 ,240,42,91,0.462,35,68,0.515,7,23,0.304,14,21,0.667,105,38,84,0.452,30,64,0.469,8,20,0.4,6,8,0.75,90,2013-01-22,DET,ORL
4643,43,@,W 105-95 ,240,40,86,0.465,32,65,0.492,8,21,0.381,17,25,0.68,105,37,83,0.446,26,49,0.531,11,34,0.324,10,13,0.769,95,2013-01-23,DEN,HOU
4644,44,@,W 105-95 ,240,37,76,0.487,31,53,0.585,6,23,0.261,25,30,0.833,105,36,86,0.419,28,71,0.394,8,15,0.533,15,21,0.714,95,2013-01-25,OKC,SAC
4645,45,Home,W 105-96 ,240,41,74,0.554,34,57,0.596,7,17,0.412,16,29,0.552,105,36,81,0.444,32,65,0.492,4,16,0.25,20,26,0.769,96,2013-01-27,LAL,OKC
4646,46,@,W 105-85 ,240,43,83,0.518,32,64,0.5,11,19,0.579,8,14,0.571,105,31,69,0.449,26,52,0.5,5,17,0.294,18,24,0.75,85,2013-01-30,MIA,BRK
4647,47,Home,W 105-99 ,240,38,75,0.507,28,57,0.491,10,18,0.556,19,28,0.679,105,39,90,0.433,31,71,0.437,8,19,0.421,13,16,0.813,99,2013-02-02,POR,UTA
4648,48,Home,W 105-99 ,240,41,86,0.477,31,66,0.47,10,20,0.5,13,19,0.684,105,36,84,0.429,26,54,0.481,10,30,0.333,17,19,0.895,99,2013-02-06,DAL,POR
4649,49,@,W 105-100 ,240,41,83,0.494,33,66,0.5,8,17,0.471,15,19,0.789,105,34,86,0.395,27,69,0.391,7,17,0.412,25,28,0.893,100,2013-02-09,DET,MIL
4650,50,Home,W 105-88 ,240,41,79,0.519,35,66,0.53,6,13,0.462,17,22,0.773,105,34,69,0.493,30,53,0.566,4,16,0.25,16,25,0.64,88,2013-02-10,MEM,MIN
4651,51,@,W 105-101 ,240,40,77,0.519,31,51,0.608,9,26,0.346,16,23,0.696,105,38,89,0.427,29,68,0.426,9,21,0.429,16,20,0.8,101,2013-02-11,ATL,DAL
4652,52,@,W 105-86 ,240,41,83,0.494,31,62,0.5,10,21,0.476,13,14,0.929,105,29,81,0.358,24,62,0.387,5,19,0.263,23,33,0.697,86,2013-02-11,NOP,DET
4653,53,@,W 105-91 ,240,45,80,0.563,42,71,0.592,3,9,0.333,12,20,0.6,105,38,82,0.463,29,62,0.468,9,20,0.45,6,10,0.6,91,2013-02-19,MEM,DET
4654,54,@,W 105-92 ,240,38,81,0.469,29,57,0.509,9,24,0.375,20,27,0.741,105,37,89,0.416,33,64,0.516,4,25,0.16,14,17,0.824,92,2013-02-19,CHA,ORL
4655,55,@,W 105-99 ,240,40,81,0.494,32,64,0.5,8,17,0.471,17,23,0.739,105,36,89,0.404,25,64,0.391,11,25,0.44,16,21,0.762,99,2013-02-20,DET,CHA
4656,56,Home,W 105-100 ,240,38,77,0.494,33,63,0.524,5,14,0.357,24,34,0.706,105,37,76,0.487,30,61,0.492,7,15,0.467,19,22,0.864,100,2013-02-20,CLE,NOH
4657,57,@,W 105-75 ,240,42,83,0.506,37,69,0.536,5,14,0.357,16,20,0.8,105,25,75,0.333,21,59,0.356,4,16,0.25,21,35,0.6,75,2013-02-22,CHI,CHA
4658,58,Home,W 105-103 ,240,41,80,0.513,34,64,0.531,7,16,0.438,16,19,0.842,105,38,84,0.452,19,38,0.5,19,46,0.413,8,14,0.571,103,2013-02-23,WAS,HOU
4659,59,@,L 105-109 ,240,39,78,0.5,31,58,0.534,8,20,0.4,19,24,0.792,105,39,75,0.52,27,56,0.482,12,19,0.632,19,24,0.792,109,2013-02-24,CLE,MIA
4660,60,@,L 105-109 ,240,36,72,0.5,21,45,0.467,15,27,0.556,18,21,0.857,105,36,87,0.414,25,53,0.472,11,34,0.324,26,33,0.788,109,2013-02-27,GSW,NYK
4661,61,@,W 105-101 (OT),265,44,95,0.463,41,83,0.494,3,12,0.25,14,21,0.667,105,35,81,0.432,29,64,0.453,6,17,0.353,25,35,0.714,101,2013-02-27,PHO,SAS
4662,62,@,W 105-89 ,240,43,83,0.518,36,58,0.621,7,25,0.28,12,20,0.6,105,33,74,0.446,28,58,0.483,5,16,0.313,18,28,0.643,89,2013-03-01,LAC,CLE
4663,63,Home,W 105-103 ,240,43,95,0.453,36,74,0.486,7,21,0.333,12,17,0.706,105,36,83,0.434,29,63,0.46,7,20,0.35,24,34,0.706,103,2013-03-01,DEN,OKC
4664,64,@,W 105-102 ,240,43,87,0.494,36,66,0.545,7,21,0.333,12,16,0.75,105,37,80,0.463,29,59,0.492,8,21,0.381,20,26,0.769,102,2013-03-04,ORL,NOH
4665,65,@,L 105-122 ,240,45,97,0.464,44,87,0.506,1,10,0.1,14,18,0.778,105,49,82,0.598,37,58,0.638,12,24,0.5,12,17,0.706,122,2013-03-04,CHA,POR
4666,66,@,L 105-122 ,240,31,77,0.403,19,48,0.396,12,29,0.414,31,40,0.775,105,46,96,0.479,38,73,0.521,8,23,0.348,22,24,0.917,122,2013-03-05,LAL,OKC
4667,67,@,L 105-107 ,240,37,86,0.43,18,45,0.4,19,41,0.463,12,18,0.667,105,37,82,0.451,29,64,0.453,8,18,0.444,25,39,0.641,107,2013-03-09,HOU,PHO
4668,68,Home,W 105-91 ,240,38,68,0.559,31,54,0.574,7,14,0.5,22,31,0.71,105,26,63,0.413,16,36,0.444,10,27,0.37,29,34,0.853,91,2013-03-10,MIA,IND
4669,69,Home,W 105-93 ,240,43,82,0.524,35,61,0.574,8,21,0.381,11,14,0.786,105,33,77,0.429,27,60,0.45,6,17,0.353,21,24,0.875,93,2013-03-11,SAS,OKC
4670,70,Home,W 105-97 ,240,41,72,0.569,33,54,0.611,8,18,0.444,15,25,0.6,105,40,89,0.449,35,72,0.486,5,17,0.294,12,14,0.857,97,2013-03-13,GSW,DET
4671,71,Home,W 105-90 ,240,40,78,0.513,30,50,0.6,10,28,0.357,15,21,0.714,105,36,82,0.439,29,57,0.509,7,25,0.28,11,17,0.647,90,2013-03-14,POR,NYK
4672,72,Home,W 105-88 ,240,41,79,0.519,31,64,0.484,10,15,0.667,13,20,0.65,105,34,76,0.447,27,56,0.482,7,20,0.35,13,21,0.619,88,2013-03-16,BOS,CHA
4673,73,@,L 105-127 ,240,42,88,0.477,36,67,0.537,6,21,0.286,15,20,0.75,105,48,93,0.516,34,72,0.472,14,21,0.667,17,20,0.85,127,2013-03-16,PHO,WAS
4674,74,@,W 105-93 ,240,44,84,0.524,36,63,0.571,8,21,0.381,9,13,0.692,105,36,86,0.419,28,63,0.444,8,23,0.348,13,16,0.813,93,2013-03-17,ATL,BRK
4675,75,@,W 105-103 ,240,42,85,0.494,35,65,0.538,7,20,0.35,14,21,0.667,105,39,72,0.542,29,51,0.569,10,21,0.476,15,24,0.625,103,2013-03-18,MIA,BOS
4676,76,@,W 105-82 ,240,42,79,0.532,28,53,0.528,14,26,0.538,7,8,0.875,105,32,79,0.405,25,59,0.424,7,20,0.35,11,13,0.846,82,2013-03-26,MIN,DET
4677,77,@,W 105-98 ,240,41,90,0.456,30,62,0.484,11,28,0.393,12,21,0.571,105,41,90,0.456,36,66,0.545,5,24,0.208,11,13,0.846,98,2013-03-27,SAC,GSW
4678,78,@,W 105-91 ,240,34,73,0.466,21,44,0.477,13,29,0.448,24,28,0.857,105,35,71,0.493,31,57,0.544,4,14,0.286,17,24,0.708,91,2013-03-27,LAC,NOH
4679,79,@,W 105-95 ,240,43,86,0.5,39,67,0.582,4,19,0.211,15,18,0.833,105,33,67,0.493,27,54,0.5,6,13,0.462,23,32,0.719,95,2013-03-29,UTA,POR
4680,80,Home,W 105-96 ,240,39,80,0.488,34,59,0.576,5,21,0.238,22,30,0.733,105,36,80,0.45,29,59,0.492,7,21,0.333,17,23,0.739,96,2013-04-06,BRK,CHA
4681,81,Home,W 105-89 ,240,39,91,0.429,29,67,0.433,10,24,0.417,17,22,0.773,105,33,90,0.367,26,71,0.366,7,19,0.368,16,20,0.8,89,2013-04-09,GSW,MIN
4682,82,@,L 105-108 (OT),265,41,93,0.441,33,69,0.478,8,24,0.333,15,21,0.714,105,43,95,0.453,32,72,0.444,11,23,0.478,11,19,0.579,108,2013-04-12,DEN,DAL
4683,83,Home,W 105-93 ,240,41,83,0.494,35,68,0.515,6,15,0.4,17,19,0.895,105,37,73,0.507,28,53,0.528,9,20,0.45,10,14,0.714,93,2013-04-13,MIN,PHO
4684,84,Home,W 105-93 ,240,36,70,0.514,30,53,0.566,6,17,0.353,27,41,0.659,105,29,82,0.354,18,56,0.321,11,26,0.423,24,31,0.774,93,2013-04-14,MIA,CHI
4685,85,Home,W 105-98 ,240,37,73,0.507,29,53,0.547,8,20,0.4,23,30,0.767,105,39,80,0.488,31,57,0.544,8,23,0.348,12,18,0.667,98,2013-04-17,CHA,CLE
4686,86,@,W 105-95 ,240,43,85,0.506,35,66,0.53,8,19,0.421,11,14,0.786,105,36,80,0.45,30,54,0.556,6,26,0.231,17,27,0.63,95,2013-04-17,PHI,IND
4687,87,Home,W 105-93 ,240,42,78,0.538,30,49,0.612,12,29,0.414,9,19,0.474,105,40,77,0.519,38,63,0.603,2,14,0.143,11,25,0.44,93,2013-04-17,MIA,ORL
4688,88,@,W 105-98 ,240,35,84,0.417,29,69,0.42,6,15,0.4,29,34,0.853,105,34,76,0.447,30,60,0.5,4,16,0.25,26,38,0.684,98,2013-11-01,MIL,BOS
4689,89,@,L 105-113 ,240,38,100,0.38,29,73,0.397,9,27,0.333,20,25,0.8,105,34,73,0.466,23,44,0.523,11,29,0.379,34,51,0.667,113,2013-11-01,DAL,HOU
4690,90,Home,W 105-84 ,240,37,75,0.493,30,62,0.484,7,13,0.538,24,28,0.857,105,30,80,0.375,27,59,0.458,3,21,0.143,21,36,0.583,84,2013-11-02,NOP,CHA
4691,91,@,L 105-115 ,240,47,94,0.5,41,82,0.5,6,12,0.5,5,8,0.625,105,45,81,0.556,37,61,0.607,8,20,0.4,17,19,0.895,115,2013-11-02,SAS,POR
4692,92,Home,W 105-103 ,240,38,89,0.427,29,64,0.453,9,25,0.36,20,24,0.833,105,40,90,0.444,31,68,0.456,9,22,0.409,14,26,0.538,103,2013-11-03,LAL,ATL
4693,93,@,W 105-100 ,240,39,81,0.481,31,59,0.525,8,22,0.364,19,26,0.731,105,35,80,0.438,25,49,0.51,10,31,0.323,20,21,0.952,100,2013-11-05,ATL,SAC
4694,94,@,L 105-106 (OT),265,40,88,0.455,28,59,0.475,12,29,0.414,13,26,0.5,105,41,92,0.446,35,72,0.486,6,20,0.3,18,22,0.818,106,2013-11-10,WAS,OKC
4695,95,@,L 105-120 ,240,39,85,0.459,32,67,0.478,7,18,0.389,20,23,0.87,105,51,85,0.6,46,73,0.63,5,12,0.417,13,15,0.867,120,2013-11-11,ORL,BOS
4696,96,Home,W 105-95 ,240,41,84,0.488,31,58,0.534,10,26,0.385,13,19,0.684,105,33,75,0.44,24,49,0.49,9,26,0.346,20,29,0.69,95,2013-11-12,DAL,WAS
4697,97,@,L 105-111 ,240,42,85,0.494,37,73,0.507,5,12,0.417,16,20,0.8,105,37,72,0.514,28,50,0.56,9,22,0.409,28,39,0.718,111,2013-11-13,NOP,UTA
4698,98,Home,W 105-98 ,240,40,79,0.506,35,64,0.547,5,15,0.333,20,33,0.606,105,37,83,0.446,29,59,0.492,8,24,0.333,16,20,0.8,98,2013-11-20,NOP,UTA
4699,99,Home,W 105-91 ,240,41,79,0.519,37,60,0.617,4,19,0.211,19,29,0.655,105,38,92,0.413,30,64,0.469,8,28,0.286,7,15,0.467,91,2013-11-21,OKC,LAC
4700,0,Home,W 105-94 ,240,43,82,0.524,39,63,0.619,4,19,0.211,15,21,0.714,105,38,85,0.447,31,63,0.492,7,22,0.318,11,17,0.647,94,2013-11-27,ORL,PHI
4701,1,Home,L 105-121 ,240,42,92,0.457,30,61,0.492,12,31,0.387,9,21,0.429,105,51,93,0.548,43,73,0.589,8,20,0.4,11,14,0.786,121,2013-11-29,PHI,NOP
4702,2,@,W 105-100 ,240,39,89,0.438,31,63,0.492,8,26,0.308,19,26,0.731,105,36,82,0.439,32,67,0.478,4,15,0.267,24,31,0.774,100,2013-12-01,IND,LAC
4703,3,@,W 105-98 ,240,33,86,0.384,26,65,0.4,7,21,0.333,32,42,0.762,105,36,91,0.396,27,64,0.422,9,27,0.333,17,22,0.773,98,2013-12-04,DET,MIL
4704,4,Home,W 105-88 ,240,42,91,0.462,38,70,0.543,4,21,0.19,17,25,0.68,105,37,92,0.402,31,65,0.477,6,27,0.222,8,13,0.615,88,2013-12-06,CHA,PHI
4705,5,Home,W 105-83 ,240,37,83,0.446,31,55,0.564,6,28,0.214,25,39,0.641,105,27,76,0.355,25,60,0.417,2,16,0.125,27,34,0.794,83,2013-12-06,HOU,GSW
4706,6,Home,L 105-109 (OT),265,33,83,0.398,25,56,0.446,8,27,0.296,31,41,0.756,105,42,92,0.457,36,72,0.5,6,20,0.3,19,26,0.731,109,2013-12-06,WAS,MIL
4707,7,@,W 105-94 ,240,40,85,0.471,34,66,0.515,6,19,0.316,19,20,0.95,105,36,82,0.439,35,75,0.467,1,7,0.143,21,23,0.913,94,2013-12-09,POR,UTA
4708,8,Home,L 105-139 ,240,39,87,0.448,30,72,0.417,9,15,0.6,18,26,0.692,105,52,93,0.559,31,56,0.554,21,37,0.568,14,20,0.7,139,2013-12-14,PHI,POR
4709,9,@,W 105-93 ,240,43,88,0.489,38,66,0.576,5,22,0.227,14,20,0.7,105,36,87,0.414,31,68,0.456,5,19,0.263,16,22,0.727,93,2013-12-17,OKC,DEN
4710,10,Home,W 105-91 ,240,40,73,0.548,35,58,0.603,5,15,0.333,20,23,0.87,105,37,93,0.398,29,75,0.387,8,18,0.444,9,14,0.643,91,2013-12-18,DAL,MEM
4711,11,@,W 105-100 ,240,39,79,0.494,27,56,0.482,12,23,0.522,15,23,0.652,105,39,82,0.476,31,62,0.5,8,20,0.4,14,23,0.609,100,2013-12-21,SAC,ORL
4712,12,Home,W 105-103 ,240,40,95,0.421,30,71,0.423,10,24,0.417,15,22,0.682,105,40,81,0.494,36,63,0.571,4,18,0.222,19,23,0.826,103,2013-12-25,GSW,LAC
4713,13,Home,W 105-89 ,240,42,89,0.472,31,65,0.477,11,24,0.458,10,15,0.667,105,33,82,0.402,27,59,0.458,6,23,0.261,17,24,0.708,89,2013-12-27,NOP,DEN
4714,14,Home,W 105-103 ,240,40,88,0.455,31,65,0.477,9,23,0.391,16,20,0.8,105,40,80,0.5,33,57,0.579,7,23,0.304,16,23,0.696,103,2013-12-27,UTA,LAL
4715,15,@,W 105-83 ,240,41,78,0.526,28,52,0.538,13,26,0.5,10,11,0.909,105,32,74,0.432,29,57,0.509,3,17,0.176,16,19,0.842,83,2013-12-28,DAL,CHI
4716,16,Home,W 105-91 ,240,38,71,0.535,30,52,0.577,8,19,0.421,21,25,0.84,105,36,77,0.468,28,56,0.5,8,21,0.381,11,16,0.688,91,2013-12-28,IND,BRK
4717,17,@,W 105-101 ,240,39,76,0.513,30,59,0.508,9,17,0.529,18,20,0.9,105,37,77,0.481,23,45,0.511,14,32,0.438,13,19,0.684,101,2014-01-02,NYK,SAS
4718,18,@,L 105-111 ,240,39,83,0.47,34,66,0.515,5,17,0.294,22,30,0.733,105,36,79,0.456,25,49,0.51,11,30,0.367,28,39,0.718,111,2014-01-08,BOS,LAC
4719,19,@,L 105-109 ,240,44,89,0.494,40,81,0.494,4,8,0.5,13,19,0.684,105,43,80,0.538,36,64,0.563,7,16,0.438,16,18,0.889,109,2014-01-15,UTA,SAS
4720,20,Home,W 105-97 ,240,42,87,0.483,32,72,0.444,10,15,0.667,11,17,0.647,105,40,86,0.465,33,67,0.493,7,19,0.368,10,16,0.625,97,2014-01-21,OKC,POR
4721,21,Home,L 105-111 ,240,40,75,0.533,30,53,0.566,10,22,0.455,15,22,0.682,105,45,83,0.542,35,65,0.538,10,18,0.556,11,16,0.688,111,2014-01-22,SAS,OKC
4722,22,@,L 105-110 ,240,39,79,0.494,29,56,0.518,10,23,0.435,17,20,0.85,105,38,88,0.432,34,70,0.486,4,18,0.222,30,34,0.882,110,2014-01-23,DEN,POR
4723,23,@,W 105-79 ,240,41,84,0.488,30,66,0.455,11,18,0.611,12,17,0.706,105,29,76,0.382,27,63,0.429,2,13,0.154,19,27,0.704,79,2014-01-24,SAS,ATL
4724,24,@,L 105-114 ,240,41,90,0.456,29,68,0.426,12,22,0.545,11,17,0.647,105,39,81,0.481,30,64,0.469,9,17,0.529,27,34,0.794,114,2014-01-24,LAL,ORL
4725,25,Home,W 105-95 ,240,39,80,0.488,32,59,0.542,7,21,0.333,20,23,0.87,105,33,79,0.418,25,56,0.446,8,23,0.348,21,29,0.724,95,2014-02-01,PHO,CHA
4726,26,Home,W 105-100 ,240,40,86,0.465,35,72,0.486,5,14,0.357,20,22,0.909,105,38,84,0.452,24,54,0.444,14,30,0.467,10,14,0.714,100,2014-02-05,NOP,ATL
4727,27,@,L 105-118 ,240,34,85,0.4,27,59,0.458,7,26,0.269,30,40,0.75,105,36,71,0.507,27,47,0.574,9,24,0.375,37,54,0.685,118,2014-02-07,TOR,LAC
4728,28,Home,W 105-89 ,240,40,80,0.5,27,49,0.551,13,31,0.419,12,15,0.8,105,36,87,0.414,26,60,0.433,10,27,0.37,7,15,0.467,89,2014-02-12,BRK,CHA
4729,29,Home,W 105-100 ,240,37,87,0.425,34,71,0.479,3,16,0.188,28,32,0.875,105,37,80,0.463,29,61,0.475,8,19,0.421,18,23,0.783,100,2014-02-12,UTA,PHI
4730,30,@,W 105-99 ,240,41,82,0.5,32,59,0.542,9,23,0.391,14,20,0.7,105,37,82,0.451,28,58,0.483,9,24,0.375,16,17,0.941,99,2014-02-19,BRK,UTA
4731,31,Home,W 105-98 ,240,38,73,0.521,33,64,0.516,5,9,0.556,24,28,0.857,105,34,87,0.391,28,66,0.424,6,21,0.286,24,36,0.667,98,2014-02-22,SAC,BOS
4732,32,Home,W 105-90 ,240,34,65,0.523,25,48,0.521,9,17,0.529,28,36,0.778,105,36,87,0.414,31,73,0.425,5,14,0.357,13,17,0.765,90,2014-02-23,TOR,ORL
4733,33,@,W 105-94 ,240,43,80,0.538,38,61,0.623,5,19,0.263,14,17,0.824,105,39,87,0.448,37,76,0.487,2,11,0.182,14,17,0.824,94,2014-03-05,CHI,DET
4734,34,Home,W 105-94 ,240,36,81,0.444,28,61,0.459,8,20,0.4,25,31,0.806,105,32,67,0.478,25,51,0.49,7,16,0.438,23,29,0.793,94,2014-03-09,DAL,IND
4735,35,Home,W 105-98 ,240,37,81,0.457,29,61,0.475,8,20,0.4,23,28,0.821,105,36,83,0.434,31,59,0.525,5,24,0.208,21,31,0.677,98,2014-03-10,CHA,DEN
4736,36,@,L 105-112 ,240,39,85,0.459,32,65,0.492,7,20,0.35,20,29,0.69,105,43,78,0.551,39,64,0.609,4,14,0.286,22,31,0.71,112,2014-03-10,PHO,LAC
4737,37,Home,W 105-98 ,240,38,84,0.452,30,57,0.526,8,27,0.296,21,25,0.84,105,42,88,0.477,33,65,0.508,9,23,0.391,5,8,0.625,98,2014-03-10,MIL,ORL
4738,38,Home,W 105-93 ,240,44,91,0.484,36,72,0.5,8,19,0.421,9,14,0.643,105,35,82,0.427,29,67,0.433,6,15,0.4,17,21,0.81,93,2014-03-14,CHA,MIN
4739,39,@,W 105-101 (OT),265,36,90,0.4,26,67,0.388,10,23,0.435,23,29,0.793,105,43,97,0.443,36,72,0.5,7,25,0.28,8,10,0.8,101,2014-03-14,WAS,ORL
4740,40,Home,L 105-111 ,240,38,85,0.447,30,57,0.526,8,28,0.286,21,27,0.778,105,36,70,0.514,32,57,0.561,4,13,0.308,35,43,0.814,111,2014-03-21,ATL,NOP
4741,41,Home,W 105-95 ,240,43,84,0.512,36,67,0.537,7,17,0.412,12,17,0.706,105,37,73,0.507,29,47,0.617,8,26,0.308,13,17,0.765,95,2014-03-22,NOP,MIA
4742,42,Home,W 105-102 ,240,40,91,0.44,29,64,0.453,11,27,0.407,14,18,0.778,105,41,85,0.482,36,70,0.514,5,15,0.333,15,18,0.833,102,2014-03-23,DEN,WAS
4743,43,@,L 105-108 ,240,42,85,0.494,35,64,0.547,7,21,0.333,14,18,0.778,105,39,70,0.557,33,60,0.55,6,10,0.6,24,34,0.706,108,2014-03-27,LAL,MIL
4744,44,@,L 105-110 (OT),265,43,97,0.443,35,75,0.467,8,22,0.364,11,14,0.786,105,39,87,0.448,33,69,0.478,6,18,0.333,26,35,0.743,110,2014-03-28,CHA,ORL
4745,45,Home,W 105-103 ,240,40,86,0.465,35,66,0.53,5,20,0.25,20,22,0.909,105,40,76,0.526,34,58,0.586,6,18,0.333,17,20,0.85,103,2014-03-28,TOR,BOS
4746,46,Home,W 105-98 ,240,39,75,0.52,34,60,0.567,5,15,0.333,22,25,0.88,105,41,89,0.461,36,72,0.5,5,17,0.294,11,18,0.611,98,2014-03-30,POR,MEM
4747,47,Home,W 105-96 ,240,44,83,0.53,38,58,0.655,6,25,0.24,11,17,0.647,105,32,84,0.381,22,49,0.449,10,35,0.286,22,28,0.786,96,2014-04-01,BRK,HOU
4748,48,@,W 105-92 ,240,40,78,0.513,28,53,0.528,12,25,0.48,13,15,0.867,105,32,72,0.444,24,48,0.5,8,24,0.333,20,26,0.769,92,2014-04-02,CHI,ATL
4749,49,@,W 105-101 ,240,41,80,0.513,35,59,0.593,6,21,0.286,17,23,0.739,105,36,79,0.456,26,56,0.464,10,23,0.435,19,27,0.704,101,2014-04-05,BRK,PHI
4750,50,Home,W 105-97 ,240,40,76,0.526,31,53,0.585,9,23,0.391,16,22,0.727,105,37,84,0.44,25,58,0.431,12,26,0.462,11,14,0.786,97,2014-04-09,ATL,BOS
4751,51,@,L 105-111 ,240,41,93,0.441,36,68,0.529,5,25,0.2,18,26,0.692,105,39,72,0.542,32,53,0.604,7,19,0.368,26,41,0.634,111,2014-04-12,PHI,CHA
4752,52,@,L 105-117 ,240,35,82,0.427,27,53,0.509,8,29,0.276,27,30,0.9,105,44,83,0.53,35,59,0.593,9,24,0.375,20,30,0.667,117,2014-04-15,DEN,LAC
4753,53,@,L 105-106 (OT),265,44,92,0.478,36,62,0.581,8,30,0.267,9,11,0.818,105,43,88,0.489,38,68,0.559,5,20,0.25,15,25,0.6,106,2014-04-16,DAL,MEM
4754,54,Home,W 105-100 ,240,43,82,0.524,37,70,0.529,6,12,0.5,13,20,0.65,105,35,81,0.432,21,51,0.412,14,30,0.467,16,24,0.667,100,2014-04-16,NOP,HOU
4755,55,@,L 105-121 ,240,39,80,0.488,32,61,0.525,7,19,0.368,20,26,0.769,105,49,88,0.557,41,66,0.621,8,22,0.364,15,23,0.652,121,2014-10-29,BRK,BOS
4756,56,Home,W 105-101 ,240,43,82,0.524,39,67,0.582,4,15,0.267,15,20,0.75,105,39,86,0.453,33,74,0.446,6,12,0.5,17,23,0.739,101,2014-10-29,MEM,MIN
4757,57,@,W 105-98 ,240,39,80,0.488,32,67,0.478,7,13,0.538,20,26,0.769,105,37,72,0.514,31,57,0.544,6,15,0.4,18,24,0.75,98,2014-10-30,WAS,ORL
4758,58,Home,L 105-106 ,240,38,85,0.447,34,73,0.466,4,12,0.333,25,31,0.806,105,33,69,0.478,24,46,0.522,9,23,0.391,31,40,0.775,106,2014-11-01,MIN,CHI
4759,59,Home,L 105-110 ,240,36,93,0.387,31,69,0.449,5,24,0.208,28,33,0.848,105,34,81,0.42,32,72,0.444,2,9,0.222,40,47,0.851,110,2014-11-03,DEN,SAC
4760,60,@,W 105-82 ,240,42,88,0.477,33,64,0.516,9,24,0.375,12,14,0.857,105,29,68,0.426,20,40,0.5,9,28,0.321,15,19,0.789,82,2014-11-07,DAL,UTA
4761,61,@,W 105-96 ,240,42,76,0.553,33,53,0.623,9,23,0.391,12,20,0.6,105,35,83,0.422,26,54,0.481,9,29,0.31,17,24,0.708,96,2014-11-09,MIA,DAL
4762,62,@,W 105-89 ,240,39,80,0.488,29,54,0.537,10,26,0.385,17,25,0.68,105,36,81,0.444,29,58,0.5,7,23,0.304,10,22,0.455,89,2014-11-17,CHI,LAC
4763,63,@,W 105-102 ,240,34,82,0.415,22,54,0.407,12,28,0.429,25,29,0.862,105,37,84,0.44,27,62,0.435,10,22,0.455,18,21,0.857,102,2014-11-19,DAL,WAS
4764,64,@,W 105-100 ,240,39,82,0.476,35,66,0.53,4,16,0.25,23,32,0.719,105,42,91,0.462,35,71,0.493,7,20,0.35,9,15,0.6,100,2014-11-21,ORL,CHO
4765,65,Home,W 105-87 ,240,39,79,0.494,30,63,0.476,9,16,0.563,18,22,0.818,105,30,83,0.361,22,61,0.361,8,22,0.364,19,28,0.679,87,2014-11-21,POR,CHI
4766,66,@,W 105-97 ,240,39,92,0.424,27,65,0.415,12,27,0.444,15,20,0.75,105,41,94,0.436,36,79,0.456,5,15,0.333,10,15,0.667,97,2014-11-26,POR,CHO
4767,67,Home,W 105-78 ,240,38,86,0.442,28,62,0.452,10,24,0.417,19,23,0.826,105,29,75,0.387,27,56,0.482,2,19,0.105,18,24,0.75,78,2014-11-28,OKC,NYK
4768,68,Home,W 105-75 ,240,40,75,0.533,28,52,0.538,12,23,0.522,13,16,0.813,105,29,88,0.33,24,65,0.369,5,23,0.217,12,16,0.75,75,2014-11-29,ATL,CHO
4769,69,@,L 105-109 ,240,41,84,0.488,29,61,0.475,12,23,0.522,11,13,0.846,105,43,82,0.524,32,58,0.552,11,24,0.458,12,14,0.857,109,2014-12-02,BOS,ATL
4770,70,@,W 105-103 ,240,43,86,0.5,38,64,0.594,5,22,0.227,14,17,0.824,105,41,81,0.506,34,61,0.557,7,20,0.35,14,19,0.737,103,2014-12-02,POR,DEN
4771,71,Home,W 105-96 ,240,41,93,0.441,31,65,0.477,10,28,0.357,13,20,0.65,105,39,76,0.513,37,63,0.587,2,13,0.154,16,27,0.593,96,2014-12-03,HOU,MEM
4772,72,Home,L 105-107 ,240,38,73,0.521,31,62,0.5,7,11,0.636,22,32,0.688,105,42,92,0.457,34,65,0.523,8,27,0.296,15,22,0.682,107,2014-12-03,MIL,DAL
4773,73,@,W 105-91 ,240,41,84,0.488,32,64,0.5,9,20,0.45,14,21,0.667,105,35,86,0.407,27,62,0.435,8,24,0.333,13,20,0.65,91,2014-12-05,CLE,TOR
4774,74,@,W 105-96 ,240,42,83,0.506,33,57,0.579,9,26,0.346,12,14,0.857,105,35,79,0.443,31,64,0.484,4,15,0.267,22,28,0.786,96,2014-12-06,ORL,SAC
4775,75,Home,W 105-101 ,240,39,79,0.494,30,53,0.566,9,26,0.346,18,21,0.857,105,42,82,0.512,35,59,0.593,7,23,0.304,10,10,1.0,101,2014-12-09,CLE,TOR
4776,76,@,L 105-114 ,240,38,85,0.447,20,45,0.444,18,40,0.45,11,14,0.786,105,41,85,0.482,34,71,0.479,7,14,0.5,25,29,0.862,114,2014-12-09,DAL,MEM
4777,77,Home,W 105-80 ,240,37,79,0.468,29,57,0.509,8,22,0.364,23,32,0.719,105,29,88,0.33,26,74,0.351,3,14,0.214,19,24,0.792,80,2014-12-10,CHI,BRK
4778,78,Home,W 105-93 ,240,40,81,0.494,32,58,0.552,8,23,0.348,17,20,0.85,105,37,90,0.411,28,55,0.509,9,35,0.257,10,15,0.667,93,2014-12-10,GSW,HOU
4779,79,@,W 105-103 ,240,40,84,0.476,36,69,0.522,4,15,0.267,21,27,0.778,105,39,83,0.47,29,52,0.558,10,31,0.323,15,19,0.789,103,2014-12-12,DET,PHO
4780,80,@,W 105-98 ,240,37,83,0.446,27,51,0.529,10,32,0.313,21,27,0.778,105,36,89,0.404,31,64,0.484,5,25,0.2,21,30,0.7,98,2014-12-13,GSW,DAL
4781,81,@,W 105-87 ,240,38,86,0.442,32,61,0.525,6,25,0.24,23,35,0.657,105,33,93,0.355,29,65,0.446,4,28,0.143,17,21,0.81,87,2014-12-15,BOS,PHI
4782,82,Home,W 105-98 ,240,42,92,0.457,37,78,0.474,5,14,0.357,16,19,0.842,105,39,95,0.411,30,64,0.469,9,31,0.29,11,12,0.917,98,2014-12-16,MEM,GSW
4783,83,@,W 105-87 ,240,35,66,0.53,21,41,0.512,14,25,0.56,21,24,0.875,105,27,70,0.386,23,53,0.434,4,17,0.235,29,40,0.725,87,2014-12-17,UTA,MIA
4784,84,Home,W 105-89 ,240,41,80,0.513,31,60,0.517,10,20,0.5,13,19,0.684,105,35,81,0.432,26,54,0.481,9,27,0.333,10,22,0.455,89,2014-12-17,TOR,BRK
4785,85,@,W 105-103 ,240,39,79,0.494,36,65,0.554,3,14,0.214,24,33,0.727,105,40,75,0.533,31,56,0.554,9,19,0.474,14,19,0.737,103,2014-12-19,WAS,MIA
4786,86,@,L 105-110 ,240,40,91,0.44,31,64,0.484,9,27,0.333,16,26,0.615,105,40,76,0.526,32,56,0.571,8,20,0.4,22,29,0.759,110,2014-12-21,DET,BRK
4787,87,Home,W 105-91 ,240,46,76,0.605,39,62,0.629,7,14,0.5,6,10,0.6,105,39,86,0.453,38,70,0.543,1,16,0.063,12,15,0.8,91,2014-12-21,CLE,MEM
4788,88,@,W 105-102 ,240,40,81,0.494,33,62,0.532,7,19,0.368,18,27,0.667,105,39,90,0.433,28,62,0.452,11,28,0.393,13,20,0.65,102,2014-12-22,ATL,DAL
4789,89,@,L 105-115 ,240,39,84,0.464,27,58,0.466,12,26,0.462,15,17,0.882,105,46,89,0.517,34,63,0.54,12,26,0.462,11,17,0.647,115,2014-12-23,GSW,LAL
4790,90,@,L 105-126 ,240,40,86,0.465,30,61,0.492,10,25,0.4,15,20,0.75,105,49,92,0.533,37,64,0.578,12,28,0.429,16,20,0.8,126,2015-01-02,TOR,GSW
4791,91,@,L 105-114 ,240,47,102,0.461,39,77,0.506,8,25,0.32,3,5,0.6,105,41,85,0.482,36,68,0.529,5,17,0.294,27,30,0.9,114,2015-01-05,HOU,CHI
4792,92,Home,W 105-83 ,240,43,82,0.524,36,67,0.537,7,15,0.467,12,19,0.632,105,33,76,0.434,25,50,0.5,8,26,0.308,9,13,0.692,83,2015-01-05,MEM,NYK
4793,93,@,W 105-101 ,240,35,74,0.473,28,61,0.459,7,13,0.538,28,30,0.933,105,35,81,0.432,31,58,0.534,4,23,0.174,27,34,0.794,101,2015-01-05,IND,UTA
4794,94,@,W 105-104 ,240,41,87,0.471,38,68,0.559,3,19,0.158,20,28,0.714,105,36,79,0.456,27,58,0.466,9,21,0.429,23,34,0.676,104,2015-01-06,DET,SAS
4795,95,@,W 105-93 ,240,39,86,0.453,27,52,0.519,12,34,0.353,15,24,0.625,105,34,82,0.415,24,53,0.453,10,29,0.345,15,19,0.789,93,2015-01-07,HOU,CLE
4796,96,@,W 105-87 ,240,42,87,0.483,30,64,0.469,12,23,0.522,9,16,0.563,105,31,76,0.408,22,51,0.431,9,25,0.36,16,25,0.64,87,2015-01-13,ATL,PHI
4797,97,Home,L 105-116 ,240,39,81,0.481,32,60,0.533,7,21,0.333,20,24,0.833,105,46,91,0.505,33,66,0.5,13,25,0.52,11,13,0.846,116,2015-01-13,UTA,GSW
4798,98,@,W 105-91 ,240,36,73,0.493,26,44,0.591,10,29,0.345,23,27,0.852,105,34,83,0.41,23,50,0.46,11,33,0.333,12,14,0.857,91,2015-01-14,ATL,BOS
4799,99,@,W 105-99 ,240,40,78,0.513,35,63,0.556,5,15,0.333,20,25,0.8,105,34,79,0.43,21,52,0.404,13,27,0.481,18,24,0.75,99,2015-01-14,WAS,CHI
4800,0,@,W 105-94 ,240,39,80,0.488,31,59,0.525,8,21,0.381,19,23,0.826,105,34,73,0.466,26,51,0.51,8,22,0.364,18,23,0.783,94,2015-01-14,NOP,DET
4801,1,Home,L 105-113 ,240,38,92,0.413,28,61,0.459,10,31,0.323,19,22,0.864,105,43,80,0.538,35,61,0.574,8,19,0.421,19,21,0.905,113,2015-01-17,DEN,MIN
4802,2,Home,W 105-80 ,240,40,89,0.449,28,67,0.418,12,22,0.545,13,19,0.684,105,29,80,0.363,23,61,0.377,6,19,0.316,16,20,0.8,80,2015-01-19,CHA,MIN
4803,3,@,W 105-103 (OT),265,40,102,0.392,34,73,0.466,6,29,0.207,19,23,0.826,105,38,100,0.38,31,70,0.443,7,30,0.233,20,26,0.769,103,2015-01-21,OKC,WAS
4804,4,Home,W 105-99 ,240,40,84,0.476,29,61,0.475,11,23,0.478,14,22,0.636,105,39,87,0.448,28,57,0.491,11,30,0.367,10,11,0.909,99,2015-01-30,ATL,POR
4805,5,@,W 105-85 ,240,40,91,0.44,32,69,0.464,8,22,0.364,17,18,0.944,105,28,75,0.373,18,45,0.4,10,30,0.333,19,28,0.679,85,2015-01-31,LAC,SAS
4806,6,Home,W 105-98 ,240,31,70,0.443,20,43,0.465,11,27,0.407,32,42,0.762,105,33,85,0.388,21,54,0.389,12,31,0.387,20,28,0.714,98,2015-02-03,PHI,DEN
4807,7,Home,W 105-96 ,240,38,80,0.475,27,55,0.491,11,25,0.44,18,27,0.667,105,34,77,0.442,30,61,0.492,4,16,0.25,24,30,0.8,96,2015-02-04,ATL,WAS
4808,8,@,L 105-113 (OT),265,39,93,0.419,30,65,0.462,9,28,0.321,18,25,0.72,105,41,82,0.5,30,56,0.536,11,26,0.423,20,22,0.909,113,2015-02-04,LAL,MIL
4809,9,Home,W 105-94 ,240,31,72,0.431,23,42,0.548,8,30,0.267,35,44,0.795,105,38,91,0.418,33,69,0.478,5,22,0.227,13,20,0.65,94,2015-02-05,CLE,LAC
4810,10,@,L 105-120 ,240,41,100,0.41,34,77,0.442,7,23,0.304,16,19,0.842,105,45,82,0.549,27,49,0.551,18,33,0.545,12,20,0.6,120,2015-02-08,LAL,CLE
4811,11,Home,L 105-117 ,240,42,93,0.452,37,77,0.481,5,16,0.313,16,22,0.727,105,44,86,0.512,34,65,0.523,10,21,0.476,19,20,0.95,117,2015-02-09,MIN,ATL
4812,12,Home,W 105-89 ,240,37,83,0.446,30,63,0.476,7,20,0.35,24,25,0.96,105,32,86,0.372,30,74,0.405,2,12,0.167,23,30,0.767,89,2015-02-11,OKC,MEM
4813,13,@,W 105-80 ,240,43,96,0.448,30,66,0.455,13,30,0.433,6,8,0.75,105,29,88,0.33,21,50,0.42,8,38,0.211,14,21,0.667,80,2015-02-20,TOR,ATL
4814,14,Home,L 105-114 ,240,41,89,0.461,37,66,0.561,4,23,0.174,19,29,0.655,105,42,89,0.472,32,68,0.471,10,21,0.476,20,24,0.833,114,2015-02-20,LAL,BRK
4815,15,@,W 105-91 ,240,35,83,0.422,27,62,0.435,8,21,0.381,27,31,0.871,105,33,79,0.418,28,62,0.452,5,17,0.294,20,27,0.741,91,2015-02-21,NOP,MIA
4816,16,Home,W 105-92 ,240,40,96,0.417,31,72,0.431,9,24,0.375,16,18,0.889,105,38,88,0.432,29,62,0.468,9,26,0.346,7,11,0.636,92,2015-02-24,OKC,IND
4817,17,@,L 105-110 ,240,40,91,0.44,29,59,0.492,11,32,0.344,14,19,0.737,105,36,88,0.409,19,44,0.432,17,44,0.386,21,30,0.7,110,2015-02-25,LAC,HOU
4818,18,Home,W 105-103 (OT),265,34,74,0.459,23,44,0.523,11,30,0.367,26,33,0.788,105,40,98,0.408,28,58,0.483,12,40,0.3,11,21,0.524,103,2015-03-01,HOU,CLE
4819,19,Home,L 105-110 ,240,36,82,0.439,32,67,0.478,4,15,0.267,29,35,0.829,105,44,92,0.478,32,59,0.542,12,33,0.364,10,19,0.526,110,2015-03-02,MIN,LAC
4820,20,Home,W 105-82 ,240,38,80,0.475,28,58,0.483,10,22,0.455,19,24,0.792,105,30,76,0.395,24,60,0.4,6,16,0.375,16,23,0.696,82,2015-03-04,IND,NYK
4821,21,@,W 105-100 ,240,37,79,0.468,29,58,0.5,8,21,0.381,23,27,0.852,105,41,87,0.471,36,67,0.537,5,20,0.25,13,15,0.867,100,2015-03-04,PHO,ORL
4822,22,@,L 105-108 ,240,41,88,0.466,33,68,0.485,8,20,0.4,15,19,0.789,105,40,87,0.46,33,62,0.532,7,25,0.28,21,26,0.808,108,2015-03-05,OKC,CHI
4823,23,@,L 105-116 ,240,37,73,0.507,32,58,0.552,5,15,0.333,26,29,0.897,105,44,90,0.489,35,68,0.515,9,22,0.409,19,24,0.792,116,2015-03-08,CHI,SAS
4824,24,@,L 105-130 ,240,39,81,0.481,31,61,0.508,8,20,0.4,19,20,0.95,105,53,88,0.602,33,52,0.635,20,36,0.556,4,7,0.571,130,2015-03-09,SAC,ATL
4825,25,Home,W 105-98 ,240,44,84,0.524,37,64,0.578,7,20,0.35,10,13,0.769,105,42,98,0.429,38,86,0.442,4,12,0.333,10,12,0.833,98,2015-03-11,GSW,DET
4826,26,Home,W 105-100 ,240,42,92,0.457,32,59,0.542,10,33,0.303,11,14,0.786,105,38,91,0.418,27,60,0.45,11,31,0.355,13,23,0.565,100,2015-03-11,POR,HOU
4827,27,@,L 105-108 ,240,39,85,0.459,31,70,0.443,8,15,0.533,19,21,0.905,105,40,84,0.476,33,57,0.579,7,27,0.259,21,23,0.913,108,2015-03-16,LAL,GSW
4828,28,Home,W 105-97 ,240,41,82,0.5,34,70,0.486,7,12,0.583,16,26,0.615,105,36,89,0.404,28,61,0.459,8,28,0.286,17,20,0.85,97,2015-03-16,WAS,POR
4829,29,Home,W 105-95 ,240,39,83,0.47,27,50,0.54,12,33,0.364,15,22,0.682,105,35,80,0.438,25,62,0.403,10,18,0.556,15,17,0.882,95,2015-03-17,DET,MEM
4830,30,Home,L 105-116 ,240,38,79,0.481,35,62,0.565,3,17,0.176,26,32,0.813,105,45,88,0.511,28,51,0.549,17,37,0.459,9,13,0.692,116,2015-03-18,SAC,LAC
4831,31,Home,W 105-100 ,240,35,79,0.443,23,50,0.46,12,29,0.414,23,27,0.852,105,42,87,0.483,36,70,0.514,6,17,0.353,10,15,0.667,100,2015-03-18,TOR,MIN
4832,32,@,W 105-97 (OT),265,39,89,0.438,30,63,0.476,9,26,0.346,18,30,0.6,105,38,105,0.362,30,78,0.385,8,27,0.296,13,17,0.765,97,2015-03-22,DET,BOS
4833,33,Home,W 105-95 ,240,41,83,0.494,30,54,0.556,11,29,0.379,12,17,0.706,105,40,84,0.476,32,59,0.542,8,25,0.32,7,10,0.7,95,2015-03-31,DET,ATL
4834,34,Home,W 105-100 ,240,39,81,0.481,32,57,0.561,7,24,0.292,20,30,0.667,105,35,84,0.417,26,59,0.441,9,25,0.36,21,27,0.778,100,2015-04-07,LAC,LAL
4835,35,Home,W 105-100 ,240,40,81,0.494,37,66,0.561,3,15,0.2,22,28,0.786,105,39,91,0.429,34,73,0.466,5,18,0.278,17,21,0.81,100,2015-04-07,MIA,CHO
4836,36,Home,W 105-103 ,240,38,82,0.463,30,59,0.508,8,23,0.348,21,24,0.875,105,34,79,0.43,22,53,0.415,12,26,0.462,23,31,0.742,103,2015-04-08,ORL,CHI
4837,37,@,L 105-116 ,240,46,98,0.469,39,74,0.527,7,24,0.292,6,8,0.75,105,48,90,0.533,36,64,0.563,12,26,0.462,8,9,0.889,116,2015-04-09,POR,GSW
4838,38,Home,L 105-111 ,240,41,87,0.471,35,57,0.614,6,30,0.2,17,22,0.773,105,36,79,0.456,30,62,0.484,6,17,0.353,33,42,0.786,111,2015-04-11,POR,UTA
4839,39,@,W 105-100 ,240,42,85,0.494,29,55,0.527,13,30,0.433,8,14,0.571,105,41,89,0.461,34,68,0.5,7,21,0.333,11,16,0.688,100,2015-04-15,BOS,MIL
4840,40,@,W 105-101 ,240,39,89,0.438,27,58,0.466,12,31,0.387,15,20,0.75,105,38,83,0.458,33,54,0.611,5,29,0.172,20,25,0.8,101,2015-04-15,MIA,PHI
4841,41,@,W 105-85 ,240,40,79,0.506,27,52,0.519,13,27,0.481,12,18,0.667,105,30,87,0.345,22,52,0.423,8,35,0.229,17,26,0.654,85,2015-10-28,DEN,HOU
4842,42,@,L 105-110 ,240,40,84,0.476,30,61,0.492,10,23,0.435,15,22,0.682,105,41,89,0.461,32,60,0.533,9,29,0.31,19,29,0.655,110,2015-11-02,OKC,HOU
4843,43,@,L 105-130 ,240,44,90,0.489,30,60,0.5,14,30,0.467,3,8,0.375,105,47,91,0.516,33,68,0.485,14,23,0.609,22,23,0.957,130,2015-11-03,CHI,CHO
4844,44,Home,L 105-109 ,240,42,88,0.477,38,66,0.576,4,22,0.182,17,25,0.68,105,38,86,0.442,31,56,0.554,7,30,0.233,26,29,0.897,109,2015-11-07,LAC,HOU
4845,45,@,W 105-97 ,240,39,83,0.47,33,70,0.471,6,13,0.462,21,24,0.875,105,36,80,0.45,25,47,0.532,11,33,0.333,14,26,0.538,97,2015-11-07,ORL,PHI
4846,46,@,L 105-120 ,240,39,88,0.443,34,68,0.5,5,20,0.25,22,26,0.846,105,46,92,0.5,32,59,0.542,14,33,0.424,14,18,0.778,120,2015-11-10,DAL,NOP
4847,47,@,L 105-108 (2OT),290,37,91,0.407,23,53,0.434,14,38,0.368,17,27,0.63,105,43,102,0.422,37,86,0.43,6,16,0.375,16,22,0.727,108,2015-11-14,CLE,MIL
4848,48,Home,W 105-81 ,240,37,84,0.44,26,60,0.433,11,24,0.458,20,26,0.769,105,34,98,0.347,28,63,0.444,6,35,0.171,7,8,0.875,81,2015-11-14,PHO,DEN
4849,49,Home,L 105-118 ,240,37,86,0.43,33,71,0.465,4,15,0.267,27,35,0.771,105,47,89,0.528,32,60,0.533,15,29,0.517,9,13,0.692,118,2015-11-22,DEN,GSW
4850,50,@,L 105-116 ,240,35,88,0.398,24,61,0.393,11,27,0.407,24,28,0.857,105,45,85,0.529,37,62,0.597,8,23,0.348,18,37,0.486,116,2015-11-30,HOU,DET
4851,51,@,W 105-95 ,240,38,80,0.475,30,60,0.5,8,20,0.4,21,25,0.84,105,36,75,0.48,31,58,0.534,5,17,0.294,18,24,0.75,95,2015-11-30,BOS,MIA
4852,52,Home,L 105-106 ,240,39,92,0.424,31,65,0.477,8,27,0.296,19,22,0.864,105,38,81,0.469,26,54,0.481,12,27,0.444,18,18,1.0,106,2015-12-03,TOR,DEN
4853,53,Home,L 105-108 ,240,37,74,0.5,22,43,0.512,15,31,0.484,16,26,0.615,105,37,81,0.457,26,50,0.52,11,31,0.355,23,38,0.605,108,2015-12-05,PHI,DEN
4854,54,@,L 105-108 ,240,39,86,0.453,27,57,0.474,12,29,0.414,15,22,0.682,105,44,83,0.53,39,66,0.591,5,17,0.294,15,22,0.682,108,2015-12-05,BOS,SAS
4855,55,@,L 105-110 ,240,39,82,0.476,24,47,0.511,15,35,0.429,12,17,0.706,105,45,81,0.556,38,63,0.603,7,18,0.389,13,16,0.813,110,2015-12-08,HOU,BRK
4856,56,Home,W 105-100 ,240,40,79,0.506,31,58,0.534,9,21,0.429,16,20,0.8,105,40,79,0.506,29,53,0.547,11,26,0.423,9,16,0.563,100,2015-12-08,CLE,POR
4857,57,Home,W 105-100 ,240,38,92,0.413,33,69,0.478,5,23,0.217,24,28,0.857,105,39,91,0.429,33,70,0.471,6,21,0.286,16,23,0.696,100,2015-12-09,BOS,CHI
4858,58,@,L 105-107 ,240,40,80,0.5,28,53,0.528,12,27,0.444,13,21,0.619,105,39,79,0.494,23,52,0.442,16,27,0.593,13,18,0.722,107,2015-12-11,WAS,NOP
4859,59,@,W 105-100 ,240,43,86,0.5,35,62,0.565,8,24,0.333,11,18,0.611,105,35,79,0.443,30,60,0.5,5,19,0.263,25,30,0.833,100,2015-12-12,LAC,BRK
4860,60,@,W 105-82 ,240,41,76,0.539,32,55,0.582,9,21,0.429,14,20,0.7,105,31,80,0.388,24,61,0.393,7,19,0.368,13,16,0.813,82,2015-12-14,ORL,BRK
4861,61,@,W 105-103 (OT),265,44,97,0.454,38,78,0.487,6,19,0.316,11,15,0.733,105,37,89,0.416,31,70,0.443,6,19,0.316,23,31,0.742,103,2015-12-14,LAC,DET
4862,62,Home,W 105-101 ,240,35,81,0.432,22,49,0.449,13,32,0.406,22,29,0.759,105,36,82,0.439,28,57,0.491,8,25,0.32,21,27,0.778,101,2015-12-14,POR,NOP
4863,63,@,W 105-102 ,240,43,94,0.457,36,74,0.486,7,20,0.35,12,14,0.857,105,43,95,0.453,34,69,0.493,9,26,0.346,7,13,0.538,102,2015-12-21,BRK,CHI
4864,64,@,W 105-96 ,240,40,92,0.435,33,74,0.446,7,18,0.389,18,20,0.9,105,37,96,0.385,31,72,0.431,6,24,0.25,16,23,0.696,96,2015-12-25,CHI,OKC
4865,65,Home,W 105-76 ,240,41,89,0.461,32,67,0.478,9,22,0.409,14,19,0.737,105,28,77,0.364,17,46,0.37,11,31,0.355,9,15,0.6,76,2015-12-26,POR,CLE
4866,66,Home,L 105-111 ,240,36,78,0.462,26,54,0.481,10,24,0.417,23,30,0.767,105,36,82,0.439,24,59,0.407,12,23,0.522,27,36,0.75,111,2015-12-28,MIA,BRK
4867,67,Home,L 105-110 ,240,36,74,0.486,28,49,0.571,8,25,0.32,25,41,0.61,105,40,94,0.426,31,63,0.492,9,31,0.29,21,34,0.618,110,2015-12-30,SAC,PHI
4868,68,@,W 105-98 ,240,40,83,0.482,34,63,0.54,6,20,0.3,19,24,0.792,105,36,83,0.434,26,57,0.456,10,26,0.385,16,19,0.842,98,2016-01-02,NOP,DAL
4869,69,@,L 105-120 ,240,36,83,0.434,29,65,0.446,7,18,0.389,26,31,0.839,105,49,94,0.521,39,70,0.557,10,24,0.417,12,15,0.8,120,2016-01-09,CHI,ATL
4870,70,@,W 105-99 ,240,42,76,0.553,29,53,0.547,13,23,0.565,8,10,0.8,105,38,74,0.514,33,60,0.55,5,14,0.357,18,24,0.75,99,2016-01-09,WAS,ORL
4871,71,@,W 105-92 ,240,39,72,0.542,34,60,0.567,5,12,0.417,22,26,0.846,105,33,87,0.379,24,51,0.471,9,36,0.25,17,22,0.773,92,2016-01-16,MIL,CHO
4872,72,Home,L 105-119 ,240,33,84,0.393,27,64,0.422,6,20,0.3,33,37,0.892,105,43,86,0.5,34,59,0.576,9,27,0.333,24,26,0.923,119,2016-01-25,DEN,ATL
4873,73,@,L 105-114 ,240,40,89,0.449,30,61,0.492,10,28,0.357,15,20,0.75,105,43,98,0.439,33,72,0.458,10,26,0.385,18,24,0.75,114,2016-01-28,SAC,NOP
4874,74,Home,W 105-93 ,240,40,81,0.494,32,55,0.582,8,26,0.308,17,24,0.708,105,34,78,0.436,29,65,0.446,5,13,0.385,20,25,0.8,93,2016-01-29,LAC,LAL
4875,75,@,L 105-109 (OT),265,40,87,0.46,36,69,0.522,4,18,0.222,21,25,0.84,105,44,100,0.44,35,73,0.479,9,27,0.333,12,16,0.75,109,2016-01-30,DEN,IND
4876,76,Home,W 105-103 ,240,43,93,0.462,32,66,0.485,11,27,0.407,8,10,0.8,105,40,84,0.476,31,64,0.484,9,20,0.45,14,23,0.609,103,2016-01-30,NOP,BRK
4877,77,Home,L 105-108 ,240,42,92,0.457,32,63,0.508,10,29,0.345,11,21,0.524,105,47,95,0.495,34,65,0.523,13,30,0.433,1,2,0.5,108,2016-01-30,PHI,GSW
4878,78,Home,W 105-87 ,240,39,81,0.481,34,61,0.557,5,20,0.25,22,26,0.846,105,27,70,0.386,22,48,0.458,5,22,0.227,28,32,0.875,87,2016-01-31,MIA,ATL
4879,79,@,W 105-100 ,240,42,98,0.429,32,68,0.471,10,30,0.333,11,16,0.688,105,40,82,0.488,33,66,0.5,7,16,0.438,13,15,0.867,100,2016-02-01,DET,BRK
4880,80,Home,W 105-96 (OT),265,38,85,0.447,31,67,0.463,7,18,0.389,22,33,0.667,105,39,90,0.433,34,69,0.493,5,21,0.238,13,20,0.65,96,2016-02-01,UTA,CHI
4881,81,@,L 105-111 ,240,36,84,0.429,30,62,0.484,6,22,0.273,27,34,0.794,105,40,79,0.506,31,62,0.5,9,17,0.529,22,33,0.667,111,2016-02-04,NYK,DET
4882,82,Home,L 105-111 ,240,32,83,0.386,21,54,0.389,11,29,0.379,30,32,0.938,105,37,86,0.43,22,44,0.5,15,42,0.357,22,32,0.688,111,2016-02-04,PHO,HOU
4883,83,@,L 105-112 ,240,40,85,0.471,32,65,0.492,8,20,0.4,17,19,0.895,105,45,87,0.517,44,75,0.587,1,12,0.083,21,22,0.955,112,2016-02-06,CHI,MIN
4884,84,Home,W 105-104 ,240,42,81,0.519,33,62,0.532,9,19,0.474,12,15,0.8,105,42,90,0.467,33,65,0.508,9,25,0.36,11,13,0.846,104,2016-02-08,BRK,DEN
4885,85,Home,W 105-86 ,240,39,78,0.5,27,53,0.509,12,25,0.48,15,20,0.75,105,35,83,0.422,31,66,0.47,4,17,0.235,12,15,0.8,86,2016-02-18,LAC,SAS
4886,86,@,L 105-137 ,240,36,92,0.391,24,58,0.414,12,34,0.353,21,28,0.75,105,52,97,0.536,35,67,0.522,17,30,0.567,16,23,0.696,137,2016-02-19,GSW,POR
4887,87,@,W 105-102 ,240,41,82,0.5,32,58,0.552,9,24,0.375,14,21,0.667,105,38,91,0.418,31,66,0.47,7,25,0.28,19,29,0.655,102,2016-02-21,IND,ORL
4888,88,@,L 105-108 ,240,35,77,0.455,22,51,0.431,13,26,0.5,22,25,0.88,105,46,91,0.505,43,76,0.566,3,15,0.2,13,16,0.813,108,2016-02-24,NYK,IND
4889,89,@,L 105-114 ,240,37,74,0.5,31,64,0.484,6,10,0.6,25,33,0.758,105,41,85,0.482,31,59,0.525,10,26,0.385,22,26,0.846,114,2016-02-24,MIN,TOR
4890,90,Home,L 105-119 ,240,37,80,0.463,24,45,0.533,13,35,0.371,18,22,0.818,105,44,82,0.537,34,53,0.642,10,29,0.345,21,35,0.6,119,2016-02-25,POR,HOU
4891,91,Home,W 105-95 ,240,41,83,0.494,32,60,0.533,9,23,0.391,14,16,0.875,105,32,77,0.416,24,58,0.414,8,19,0.421,23,33,0.697,95,2016-02-29,LAC,BRK
4892,92,@,L 105-109 (OT),265,37,80,0.463,25,47,0.532,12,33,0.364,19,24,0.792,105,41,103,0.398,29,67,0.433,12,36,0.333,15,17,0.882,109,2016-03-01,ATL,GSW
4893,93,Home,W 105-104 ,240,41,90,0.456,37,70,0.529,4,20,0.2,19,25,0.76,105,42,92,0.457,33,69,0.478,9,23,0.391,11,14,0.786,104,2016-03-04,BOS,NYK
4894,94,Home,L 105-112 ,240,41,85,0.482,33,63,0.524,8,22,0.364,15,18,0.833,105,38,81,0.469,29,53,0.547,9,28,0.321,27,29,0.931,112,2016-03-12,DAL,IND
4895,95,Home,W 105-91 ,240,37,77,0.481,24,49,0.49,13,28,0.464,18,25,0.72,105,36,82,0.439,27,61,0.443,9,21,0.429,10,12,0.833,91,2016-03-18,TOR,BOS
4896,96,@,L 105-109 ,240,33,82,0.402,23,43,0.535,10,39,0.256,29,42,0.69,105,35,71,0.493,28,50,0.56,7,21,0.333,32,40,0.8,109,2016-03-20,LAC,NOP
4897,97,Home,L 105-120 ,240,39,92,0.424,31,71,0.437,8,21,0.381,19,27,0.704,105,46,94,0.489,36,69,0.522,10,25,0.4,18,21,0.857,120,2016-03-20,PHI,BOS
4898,98,Home,W 105-100 ,240,35,81,0.432,29,61,0.475,6,20,0.3,29,45,0.644,105,40,83,0.482,32,61,0.525,8,22,0.364,12,18,0.667,100,2016-03-20,TOR,ORL
4899,99,@,W 105-100 ,240,39,82,0.476,29,54,0.537,10,28,0.357,17,21,0.81,105,34,74,0.459,26,56,0.464,8,18,0.444,24,27,0.889,100,2016-03-22,CHA,BRK
4900,0,@,L 105-112 ,240,37,93,0.398,23,63,0.365,14,30,0.467,17,22,0.773,105,42,91,0.462,34,61,0.557,8,30,0.267,20,26,0.769,112,2016-03-25,CHA,DET
4901,1,Home,L 105-116 ,240,37,85,0.435,27,62,0.435,10,23,0.435,21,26,0.808,105,45,94,0.479,35,68,0.515,10,26,0.385,16,24,0.667,116,2016-03-25,LAL,DEN
4902,2,@,L 105-108 ,240,39,93,0.419,29,55,0.527,10,38,0.263,17,24,0.708,105,38,91,0.418,30,66,0.455,8,25,0.32,24,30,0.8,108,2016-03-26,PHI,POR
4903,3,@,L 105-117 ,240,42,90,0.467,32,60,0.533,10,30,0.333,11,12,0.917,105,44,83,0.53,30,50,0.6,14,33,0.424,15,20,0.75,117,2016-03-27,PHI,GSW
4904,4,Home,W 105-90 ,240,38,80,0.475,28,52,0.538,10,28,0.357,19,26,0.731,105,37,94,0.394,30,65,0.462,7,29,0.241,9,13,0.692,90,2016-03-27,LAC,DEN
4905,5,Home,W 105-93 ,240,38,80,0.475,24,51,0.471,14,29,0.483,15,18,0.833,105,37,89,0.416,30,74,0.405,7,15,0.467,12,19,0.632,93,2016-03-28,POR,SAC
4906,6,@,L 105-139 ,240,37,79,0.468,32,65,0.492,5,14,0.357,26,39,0.667,105,56,91,0.615,42,64,0.656,14,27,0.519,13,19,0.684,139,2016-03-29,BRK,ORL
4907,7,Home,L 105-109 ,240,41,95,0.432,35,76,0.461,6,19,0.316,17,27,0.63,105,38,78,0.487,25,49,0.51,13,29,0.448,20,24,0.833,109,2016-03-30,MEM,DEN
4908,8,Home,W 105-94 ,240,37,77,0.481,31,62,0.5,6,15,0.4,25,34,0.735,105,38,84,0.452,33,60,0.55,5,24,0.208,13,17,0.765,94,2016-03-30,MIL,PHO
4909,9,Home,W 105-97 ,240,36,80,0.45,25,57,0.439,11,23,0.478,22,28,0.786,105,37,83,0.446,23,50,0.46,14,33,0.424,9,13,0.692,97,2016-03-30,TOR,ATL
4910,10,Home,W 105-91 ,240,42,84,0.5,28,61,0.459,14,23,0.609,7,7,1.0,105,36,101,0.356,32,77,0.416,4,24,0.167,15,20,0.75,91,2016-04-01,NYK,BRK
4911,11,@,W 105-97 ,240,36,80,0.45,25,59,0.424,11,21,0.524,22,31,0.71,105,36,85,0.424,30,68,0.441,6,17,0.353,19,21,0.905,97,2016-04-07,MIN,SAC
4912,12,Home,W 105-102 ,240,40,89,0.449,32,65,0.492,8,24,0.333,17,21,0.81,105,36,83,0.434,17,43,0.395,19,40,0.475,11,18,0.611,102,2016-04-09,CHI,CLE
4913,13,Home,L 105-106 ,240,40,80,0.5,31,56,0.554,9,24,0.375,16,18,0.889,105,41,84,0.488,36,71,0.507,5,13,0.385,19,25,0.76,106,2016-04-09,POR,MIN
4914,14,@,L 105-129 ,240,35,91,0.385,21,54,0.389,14,37,0.378,21,26,0.808,105,48,86,0.558,37,59,0.627,11,27,0.407,22,27,0.815,129,2016-04-10,BRK,IND
4915,15,Home,L 105-129 ,240,38,83,0.458,33,62,0.532,5,21,0.238,24,33,0.727,105,48,86,0.558,33,56,0.589,15,30,0.5,18,26,0.692,129,2016-04-11,MIN,HOU
4916,16,@,W 105-101 ,240,41,83,0.494,35,66,0.53,6,17,0.353,17,28,0.607,105,41,100,0.41,36,78,0.462,5,22,0.227,14,17,0.824,101,2016-04-11,SAC,PHO
4917,17,@,L 105-115 ,240,37,81,0.457,20,46,0.435,17,35,0.486,14,18,0.778,105,39,83,0.47,24,59,0.407,15,24,0.625,22,27,0.815,115,2016-04-13,PHI,CHI
4918,18,@,L 105-114 ,240,43,96,0.448,34,65,0.523,9,31,0.29,10,12,0.833,105,45,99,0.455,38,73,0.521,7,26,0.269,17,22,0.773,114,2016-04-13,LAC,PHO
4919,19,Home,W 105-99 ,240,36,92,0.391,25,67,0.373,11,25,0.44,22,30,0.733,105,38,76,0.5,30,53,0.566,8,23,0.348,15,24,0.625,99,2016-10-27,CHI,BOS
4920,20,Home,W 105-99 ,240,36,88,0.409,25,51,0.49,11,37,0.297,22,30,0.733,105,38,84,0.452,30,56,0.536,8,28,0.286,15,26,0.577,99,2016-10-29,CLE,ORL
4921,21,Home,W 105-102 ,240,41,88,0.466,37,72,0.514,4,16,0.25,19,25,0.76,105,33,81,0.407,24,59,0.407,9,22,0.409,27,35,0.771,102,2016-10-31,TOR,DEN
4922,22,@,W 105-95 ,240,36,80,0.45,24,49,0.49,12,31,0.387,21,26,0.808,105,34,83,0.41,24,55,0.436,10,28,0.357,17,20,0.85,95,2016-11-04,POR,DAL
4923,23,@,L 105-109 (OT),265,39,88,0.443,34,69,0.493,5,19,0.263,22,23,0.957,105,36,86,0.419,25,54,0.463,11,32,0.344,26,31,0.839,109,2016-11-11,IND,PHI
4924,24,@,W 105-94 ,240,36,86,0.419,22,53,0.415,14,33,0.424,19,26,0.731,105,38,87,0.437,35,72,0.486,3,15,0.2,15,19,0.789,94,2016-11-11,CLE,WAS
4925,25,@,W 105-99 ,240,35,80,0.438,27,55,0.491,8,25,0.32,27,33,0.818,105,36,86,0.419,30,59,0.508,6,27,0.222,21,28,0.75,99,2016-11-12,BOS,IND
4926,26,Home,L 105-119 ,240,40,89,0.449,32,67,0.478,8,22,0.364,17,21,0.81,105,40,76,0.526,29,52,0.558,11,24,0.458,28,37,0.757,119,2016-11-12,MIN,LAC
4927,27,@,L 105-112 ,240,36,91,0.396,25,62,0.403,11,29,0.379,22,29,0.759,105,39,99,0.394,31,70,0.443,8,29,0.276,26,32,0.813,112,2016-11-13,DEN,POR
4928,28,@,L 105-106 ,240,38,95,0.4,26,54,0.481,12,41,0.293,17,20,0.85,105,35,79,0.443,29,58,0.5,6,21,0.286,30,36,0.833,106,2016-11-14,BOS,NOP
4929,29,Home,W 105-102 ,240,42,93,0.452,33,68,0.485,9,25,0.36,12,19,0.632,105,42,85,0.494,34,62,0.548,8,23,0.348,10,12,0.833,102,2016-11-16,NYK,DET
4930,30,Home,W 105-103 ,240,40,84,0.476,28,59,0.475,12,25,0.48,13,14,0.929,105,40,92,0.435,26,52,0.5,14,40,0.35,9,14,0.643,103,2016-11-16,OKC,HOU
4931,31,Home,L 105-110 ,240,36,76,0.474,27,56,0.482,9,20,0.45,24,31,0.774,105,43,88,0.489,32,58,0.552,11,30,0.367,13,17,0.765,110,2016-11-16,SAC,SAS
4932,32,@,L 105-124 ,240,35,83,0.422,24,54,0.444,11,29,0.379,24,30,0.8,105,49,89,0.551,42,63,0.667,7,26,0.269,19,24,0.792,124,2016-11-18,BRK,OKC
4933,33,@,L 105-120 ,240,39,92,0.424,33,71,0.465,6,21,0.286,21,34,0.618,105,45,86,0.523,28,51,0.549,17,35,0.486,13,20,0.65,120,2016-11-19,PHO,PHI
4934,34,Home,W 105-91 ,240,42,86,0.488,34,64,0.531,8,22,0.364,13,30,0.433,105,33,85,0.388,26,59,0.441,7,26,0.269,18,23,0.783,91,2016-11-20,DEN,UTA
4935,35,@,W 105-90 ,240,40,84,0.476,28,58,0.483,12,26,0.462,13,17,0.765,105,30,73,0.411,21,42,0.5,9,31,0.29,21,33,0.636,90,2016-11-21,MEM,CHO
4936,36,@,W 105-99 ,240,38,82,0.463,24,50,0.48,14,32,0.438,15,19,0.789,105,40,79,0.506,28,50,0.56,12,29,0.414,7,12,0.583,99,2016-11-25,TOR,MIL
4937,37,@,W 105-89 ,240,40,90,0.444,34,69,0.493,6,21,0.286,19,26,0.731,105,31,78,0.397,22,56,0.393,9,22,0.409,18,22,0.818,89,2016-11-25,CHI,PHI
4938,38,Home,L 105-122 ,240,38,87,0.437,22,48,0.458,16,39,0.41,13,14,0.929,105,46,86,0.535,33,63,0.524,13,23,0.565,17,22,0.773,122,2016-11-27,BRK,SAC
4939,39,Home,W 105-100 ,240,37,85,0.435,25,50,0.5,12,35,0.343,19,24,0.792,105,36,86,0.419,29,57,0.509,7,29,0.241,21,30,0.7,100,2016-11-28,GSW,ATL
4940,40,Home,W 105-88 ,240,38,88,0.432,30,57,0.526,8,31,0.258,21,25,0.84,105,37,87,0.425,32,57,0.561,5,30,0.167,9,18,0.5,88,2016-11-29,NOP,LAL
4941,41,@,L 105-120 ,240,36,81,0.444,25,54,0.463,11,27,0.407,22,26,0.846,105,38,69,0.551,22,37,0.595,16,32,0.5,28,33,0.848,120,2016-11-30,MEM,TOR
4942,42,@,L 105-111 ,240,45,83,0.542,35,57,0.614,10,26,0.385,5,10,0.5,105,47,96,0.49,44,78,0.564,3,18,0.167,14,17,0.824,111,2016-12-02,CLE,CHI
4943,43,@,W 105-88 ,240,37,78,0.474,24,52,0.462,13,26,0.5,18,26,0.692,105,36,95,0.379,27,63,0.429,9,32,0.281,7,10,0.7,88,2016-12-02,ORL,PHI
4944,44,@,L 105-107 ,240,41,81,0.506,34,70,0.486,7,11,0.636,16,18,0.889,105,39,80,0.488,31,60,0.517,8,20,0.4,21,33,0.636,107,2016-12-02,WAS,SAS
4945,45,Home,W 105-98 ,240,35,78,0.449,26,53,0.491,9,25,0.36,26,28,0.929,105,37,83,0.446,24,59,0.407,13,24,0.542,11,14,0.786,98,2016-12-03,UTA,DEN
4946,46,@,W 105-91 ,240,39,74,0.527,28,50,0.56,11,24,0.458,16,19,0.842,105,36,82,0.439,29,62,0.468,7,20,0.35,12,18,0.667,91,2016-12-06,SAS,MIN
4947,47,@,L 105-112 ,240,39,84,0.464,33,66,0.5,6,18,0.333,21,25,0.84,105,36,73,0.493,24,46,0.522,12,27,0.444,28,32,0.875,112,2016-12-06,PHO,UTA
4948,48,Home,W 105-100 ,240,38,84,0.452,37,76,0.487,1,8,0.125,28,31,0.903,105,42,91,0.462,37,71,0.521,5,20,0.25,11,18,0.611,100,2016-12-10,CHI,MIA
4949,49,@,L 105-116 ,240,39,86,0.453,29,59,0.492,10,27,0.37,17,24,0.708,105,42,73,0.575,29,42,0.69,13,31,0.419,19,28,0.679,116,2016-12-10,CHA,CLE
4950,50,@,L 105-133 ,240,40,83,0.482,32,64,0.5,8,19,0.421,17,26,0.654,105,54,94,0.574,37,58,0.638,17,36,0.472,8,9,0.889,133,2016-12-10,NOP,LAC
4951,51,@,L 105-110 ,240,40,79,0.506,27,54,0.5,13,25,0.52,12,15,0.8,105,40,88,0.455,32,67,0.478,8,21,0.381,22,28,0.786,110,2016-12-10,MIL,WAS
4952,52,@,W 105-90 ,240,40,83,0.482,34,64,0.531,6,19,0.316,19,25,0.76,105,32,84,0.381,22,54,0.407,10,30,0.333,16,22,0.727,90,2016-12-17,IND,DET
4953,53,@,W 105-95 ,240,41,90,0.456,32,62,0.516,9,28,0.321,14,19,0.737,105,36,69,0.522,27,45,0.6,9,24,0.375,14,25,0.56,95,2016-12-18,BOS,MIA
4954,54,@,L 105-107 ,240,38,88,0.432,30,55,0.545,8,33,0.242,21,26,0.808,105,41,87,0.471,34,66,0.515,7,21,0.333,18,21,0.857,107,2016-12-19,WAS,IND
4955,55,Home,L 105-109 ,240,36,79,0.456,24,47,0.511,12,32,0.375,21,26,0.808,105,42,80,0.525,27,51,0.529,15,29,0.517,10,14,0.714,109,2016-12-23,MIN,SAC
4956,56,Home,W 105-103 ,240,42,81,0.519,32,53,0.604,10,28,0.357,11,14,0.786,105,42,94,0.447,35,69,0.507,7,25,0.28,12,17,0.706,103,2016-12-28,DEN,MIN
4957,57,@,L 105-111 ,240,35,79,0.443,24,51,0.471,11,28,0.393,24,29,0.828,105,38,78,0.487,30,56,0.536,8,22,0.364,27,37,0.73,111,2016-12-28,IND,WAS
4958,58,Home,W 105-98 ,240,39,88,0.443,31,62,0.5,8,26,0.308,19,25,0.76,105,35,84,0.417,26,53,0.491,9,31,0.29,19,21,0.905,98,2016-12-30,ATL,DET
4959,59,@,L 105-113 ,240,41,92,0.446,30,62,0.484,11,30,0.367,12,14,0.857,105,37,78,0.474,20,46,0.435,17,32,0.531,22,24,0.917,113,2017-01-03,WAS,DAL
4960,60,@,W 105-104 ,240,37,78,0.474,28,50,0.56,9,28,0.321,22,31,0.71,105,42,94,0.447,29,66,0.439,13,28,0.464,7,12,0.583,104,2017-01-04,MIL,NYK
4961,61,@,L 105-112 ,240,42,88,0.477,35,70,0.5,7,18,0.389,14,17,0.824,105,46,79,0.582,34,57,0.596,12,22,0.545,8,9,0.889,112,2017-01-06,MIN,WAS
4962,62,@,W 105-95 ,240,37,94,0.394,29,67,0.433,8,27,0.296,23,27,0.852,105,36,78,0.462,26,51,0.51,10,27,0.37,13,17,0.765,95,2017-01-08,PHI,BRK
4963,63,Home,W 105-96 ,240,39,76,0.513,30,50,0.6,9,26,0.346,18,26,0.692,105,39,92,0.424,33,65,0.508,6,27,0.222,12,18,0.667,96,2017-01-11,LAC,ORL
4964,64,@,L 105-119 ,240,36,87,0.414,21,45,0.467,15,42,0.357,18,22,0.818,105,44,81,0.543,36,58,0.621,8,23,0.348,23,25,0.92,119,2017-01-11,HOU,MIN
4965,65,Home,L 105-110 ,240,33,82,0.402,23,41,0.561,10,41,0.244,29,36,0.806,105,41,76,0.539,31,49,0.633,10,27,0.37,18,27,0.667,110,2017-01-13,HOU,MEM
4966,66,@,L 105-108 ,240,36,71,0.507,27,51,0.529,9,20,0.45,24,34,0.706,105,39,85,0.459,31,64,0.484,8,21,0.381,22,24,0.917,108,2017-01-14,SAS,PHO
4967,67,@,L 105-112 ,240,38,89,0.427,21,48,0.438,17,41,0.415,12,15,0.8,105,39,82,0.476,25,53,0.472,14,29,0.483,20,22,0.909,112,2017-01-21,BRK,CHO
4968,68,Home,L 105-107 ,240,40,89,0.449,29,68,0.426,11,21,0.524,14,16,0.875,105,37,85,0.435,28,61,0.459,9,24,0.375,24,27,0.889,107,2017-01-21,NYK,PHO
4969,69,Home,L 105-115 ,240,37,88,0.42,28,59,0.475,9,29,0.31,22,26,0.846,105,42,84,0.5,28,60,0.467,14,24,0.583,17,22,0.773,115,2017-01-23,ATL,LAC
4970,70,Home,W 105-102 ,240,38,86,0.442,25,56,0.446,13,30,0.433,16,27,0.593,105,41,88,0.466,33,58,0.569,8,30,0.267,12,20,0.6,102,2017-01-23,MIA,GSW
4971,71,Home,L 105-114 ,240,41,96,0.427,30,69,0.435,11,27,0.407,12,19,0.632,105,42,91,0.462,32,64,0.5,10,27,0.37,20,28,0.714,114,2017-01-25,NOP,OKC
4972,72,Home,W 105-98 ,240,43,90,0.478,39,75,0.52,4,15,0.267,15,20,0.75,105,37,94,0.394,26,65,0.4,11,29,0.379,13,14,0.929,98,2017-01-25,POR,LAL
4973,73,@,W 105-101 ,240,39,87,0.448,27,53,0.509,12,34,0.353,15,16,0.938,105,39,83,0.47,31,61,0.508,8,22,0.364,15,23,0.652,101,2017-01-29,DAL,SAS
4974,74,@,L 105-111 (OT),265,41,96,0.427,31,61,0.508,10,35,0.286,13,19,0.684,105,40,92,0.435,28,63,0.444,12,29,0.414,19,26,0.731,111,2017-01-30,ORL,MIN
4975,75,Home,W 105-83 ,240,38,85,0.447,24,40,0.6,14,45,0.311,15,22,0.682,105,30,86,0.349,22,57,0.386,8,29,0.276,15,26,0.577,83,2017-01-31,HOU,SAC
4976,76,@,W 105-103 ,240,32,77,0.416,20,48,0.417,12,29,0.414,29,35,0.829,105,38,85,0.447,28,58,0.483,10,27,0.37,17,22,0.773,103,2017-02-03,PHO,SAC
4977,77,Home,W 105-84 ,240,44,91,0.484,37,67,0.552,7,24,0.292,10,15,0.667,105,31,75,0.413,25,58,0.431,6,17,0.353,16,20,0.8,84,2017-02-04,IND,DET
4978,78,Home,W 105-98 ,240,38,81,0.469,25,48,0.521,13,33,0.394,16,24,0.667,105,35,82,0.427,22,49,0.449,13,33,0.394,15,18,0.833,98,2017-02-04,UTA,CHO
4979,79,Home,W 105-91 ,240,38,83,0.458,28,52,0.538,10,31,0.323,19,22,0.864,105,37,84,0.44,32,67,0.478,5,17,0.294,12,22,0.545,91,2017-02-04,WAS,NOP
4980,80,Home,W 105-99 ,240,40,98,0.408,36,80,0.45,4,18,0.222,21,28,0.75,105,35,87,0.402,25,59,0.424,10,28,0.357,19,21,0.905,99,2017-02-05,OKC,POR
4981,81,@,L 105-112 (OT),265,39,85,0.459,26,56,0.464,13,29,0.448,14,17,0.824,105,44,87,0.506,39,67,0.582,5,20,0.25,19,25,0.76,112,2017-02-09,UTA,DAL
4982,82,Home,W 105-99 ,240,35,78,0.449,24,47,0.511,11,31,0.355,24,27,0.889,105,34,82,0.415,21,51,0.412,13,31,0.419,18,21,0.857,99,2017-02-12,SAC,NOP
4983,83,@,W 105-99 ,240,41,86,0.477,29,53,0.547,12,33,0.364,11,17,0.647,105,34,78,0.436,23,47,0.489,11,31,0.355,20,26,0.769,99,2017-02-13,PHI,CHO
4984,84,Home,W 105-94 ,240,35,73,0.479,28,56,0.5,7,17,0.412,28,35,0.8,105,35,77,0.455,30,57,0.526,5,20,0.25,19,24,0.792,94,2017-02-14,CHI,TOR
4985,85,@,L 105-116 ,240,41,86,0.477,30,65,0.462,11,21,0.524,12,14,0.857,105,41,88,0.466,29,65,0.446,12,23,0.522,22,31,0.71,116,2017-02-15,NYK,OKC
4986,86,@,W 105-97 ,240,35,82,0.427,26,56,0.464,9,26,0.346,26,30,0.867,105,35,79,0.443,28,56,0.5,7,23,0.304,20,24,0.833,97,2017-02-24,SAS,LAC
4987,87,Home,W 105-86 ,240,37,81,0.457,29,54,0.537,8,27,0.296,23,24,0.958,105,32,85,0.376,24,60,0.4,8,25,0.32,14,26,0.538,86,2017-02-25,ORL,ATL
4988,88,@,W 105-98 ,240,36,80,0.45,25,47,0.532,11,33,0.333,22,25,0.88,105,37,84,0.44,26,50,0.52,11,34,0.324,13,17,0.765,98,2017-02-26,MEM,DEN
4989,89,@,W 105-96 ,240,40,84,0.476,31,59,0.525,9,25,0.36,16,19,0.842,105,33,90,0.367,26,70,0.371,7,20,0.35,23,26,0.885,96,2017-03-01,WAS,TOR
4990,90,Home,W 105-102 ,240,36,83,0.434,27,55,0.491,9,28,0.321,24,31,0.774,105,33,84,0.393,26,63,0.413,7,21,0.333,29,33,0.879,102,2017-03-03,PHI,NYK
4991,91,@,W 105-97 ,240,36,89,0.404,27,65,0.415,9,24,0.375,24,35,0.686,105,38,83,0.458,28,55,0.509,10,28,0.357,11,15,0.733,97,2017-03-05,NOP,LAL
4992,92,Home,L 105-112 ,240,39,83,0.47,32,61,0.525,7,22,0.318,20,25,0.8,105,40,88,0.455,27,53,0.509,13,35,0.371,19,23,0.826,112,2017-03-05,NYK,GSW
4993,93,Home,L 105-113 ,240,40,85,0.471,31,53,0.585,9,32,0.281,16,24,0.667,105,40,86,0.465,34,72,0.472,6,14,0.429,27,28,0.964,113,2017-03-06,ORL,NYK
4994,94,@,L 105-110 ,240,37,80,0.463,26,46,0.565,11,34,0.324,20,25,0.8,105,41,95,0.432,37,75,0.493,4,20,0.2,24,32,0.75,110,2017-03-08,BRK,ATL
4995,95,@,L 104-106 ,240,39,76,0.513,37,71,0.521,2,5,0.4,24,31,0.774,104,35,74,0.473,26,54,0.481,9,20,0.45,27,34,0.794,106,2011-12-25,BOS,NYK
4996,96,@,W 104-96 ,240,42,79,0.532,33,58,0.569,9,21,0.429,11,13,0.846,104,35,85,0.412,29,65,0.446,6,20,0.3,20,28,0.714,96,2011-12-26,TOR,CLE
4997,97,@,W 104-100 ,240,35,78,0.449,30,62,0.484,5,16,0.313,29,31,0.935,104,39,87,0.448,36,65,0.554,3,22,0.136,19,26,0.731,100,2011-12-26,OKC,MIN
4998,98,Home,W 104-95 ,240,44,83,0.53,35,61,0.574,9,22,0.409,7,10,0.7,104,36,82,0.439,30,55,0.545,6,27,0.222,17,20,0.85,95,2011-12-26,ORL,HOU
4999,99,Home,W 104-102 ,240,37,63,0.587,31,49,0.633,6,14,0.429,24,32,0.75,104,38,90,0.422,29,64,0.453,9,26,0.346,17,21,0.81,102,2011-12-29,OKC,DAL
5000,0,Home,W 104-89 ,240,36,74,0.486,26,58,0.448,10,16,0.625,22,31,0.71,104,33,89,0.371,31,73,0.425,2,16,0.125,21,25,0.84,89,2011-12-31,SAS,UTA
5001,1,Home,W 104-64 ,240,39,84,0.464,34,71,0.479,5,13,0.385,21,29,0.724,104,26,84,0.31,25,75,0.333,1,9,0.111,11,14,0.786,64,2012-01-01,CHI,MEM
5002,2,@,W 104-97 ,240,37,87,0.425,27,55,0.491,10,32,0.313,20,31,0.645,104,38,73,0.521,35,53,0.66,3,20,0.15,18,24,0.75,97,2012-01-08,ORL,SAC
5003,3,Home,L 104-107 ,240,41,86,0.477,31,61,0.508,10,25,0.4,12,13,0.923,104,41,70,0.586,25,43,0.581,16,27,0.593,9,19,0.474,107,2012-01-11,POR,ORL
5004,4,@,L 104-117 ,240,38,81,0.469,31,65,0.477,7,16,0.438,21,29,0.724,104,43,78,0.551,31,53,0.585,12,25,0.48,19,26,0.731,117,2012-01-13,MIA,DEN
5005,5,Home,W 104-92 ,240,34,71,0.479,27,53,0.509,7,18,0.389,29,34,0.853,104,34,83,0.41,29,64,0.453,5,19,0.263,19,23,0.826,92,2012-01-14,OKC,NYK
5006,6,Home,L 104-108 (OT),265,43,98,0.439,39,84,0.464,4,14,0.286,14,19,0.737,104,43,89,0.483,36,71,0.507,7,18,0.389,15,22,0.682,108,2012-01-18,PHI,DEN
5007,7,Home,L 104-108 ,240,40,95,0.421,29,69,0.42,11,26,0.423,13,17,0.765,104,39,79,0.494,29,58,0.5,10,21,0.476,20,30,0.667,108,2012-01-20,WAS,DEN
5008,8,@,W 104-102 ,240,41,75,0.547,34,59,0.576,7,16,0.438,15,20,0.75,104,42,83,0.506,36,71,0.507,6,12,0.5,12,13,0.923,102,2012-01-23,SAS,NOH
5009,9,Home,W 104-99 ,240,41,87,0.471,37,73,0.507,4,14,0.286,18,22,0.818,104,37,78,0.474,33,68,0.485,4,10,0.4,21,23,0.913,99,2012-02-07,IND,UTA
5010,10,@,W 104-97 ,240,39,90,0.433,30,69,0.435,9,21,0.429,17,23,0.739,104,32,79,0.405,26,56,0.464,6,23,0.261,27,31,0.871,97,2012-02-10,DAL,MIN
5011,11,Home,W 104-103 ,240,37,73,0.507,33,63,0.524,4,10,0.4,26,38,0.684,104,35,82,0.427,23,56,0.411,12,26,0.462,21,27,0.778,103,2012-02-18,MEM,GSW
5012,12,Home,W 104-97 ,240,40,86,0.465,28,57,0.491,12,29,0.414,12,18,0.667,104,36,81,0.444,24,48,0.5,12,33,0.364,13,17,0.765,97,2012-02-19,NYK,DAL
5013,13,Home,W 104-97 ,240,38,83,0.458,29,60,0.483,9,23,0.391,19,24,0.792,104,33,77,0.429,22,51,0.431,11,26,0.423,20,27,0.741,97,2012-02-20,GSW,LAC
5014,14,Home,W 104-88 ,240,37,79,0.468,30,58,0.517,7,21,0.333,23,29,0.793,104,36,84,0.429,31,64,0.484,5,20,0.25,11,19,0.579,88,2012-02-20,PHO,WAS
5015,15,@,L 104-119 ,240,34,70,0.486,27,52,0.519,7,18,0.389,29,34,0.853,104,42,84,0.5,33,65,0.508,9,19,0.474,26,35,0.743,119,2012-02-22,BOS,OKC
5016,16,Home,L 104-106 ,240,43,90,0.478,39,71,0.549,4,19,0.211,14,20,0.7,104,39,84,0.464,30,64,0.469,9,20,0.45,19,22,0.864,106,2012-02-22,PHO,GSW
5017,17,Home,W 104-95 ,240,44,91,0.484,38,70,0.543,6,21,0.286,10,16,0.625,104,38,87,0.437,29,63,0.46,9,24,0.375,10,11,0.909,95,2012-02-29,DEN,POR
5018,18,Home,W 104-85 ,240,41,84,0.488,36,63,0.571,5,21,0.238,17,22,0.773,104,35,89,0.393,30,70,0.429,5,19,0.263,10,18,0.556,85,2012-02-29,LAL,MIN
5019,19,Home,W 104-83 ,240,42,87,0.483,38,75,0.507,4,12,0.333,16,16,1.0,104,32,82,0.39,26,59,0.441,6,23,0.261,13,16,0.813,83,2012-02-29,UTA,HOU
5020,20,Home,W 104-95 ,240,42,79,0.532,39,71,0.549,3,8,0.375,17,21,0.81,104,34,86,0.395,33,73,0.452,1,13,0.077,26,32,0.813,95,2012-03-01,PHO,MIN
5021,21,@,W 104-101 ,240,33,68,0.485,28,51,0.549,5,17,0.294,33,44,0.75,104,31,80,0.388,29,66,0.439,2,14,0.143,37,39,0.949,101,2012-03-04,BRK,CHA
5022,22,Home,L 104-106 ,240,42,88,0.477,37,73,0.507,5,15,0.333,15,19,0.789,104,43,83,0.518,38,67,0.567,5,16,0.313,15,17,0.882,106,2012-03-07,MIL,CHI
5023,23,@,L 104-115 ,240,38,84,0.452,35,65,0.538,3,19,0.158,25,34,0.735,104,40,91,0.44,32,65,0.492,8,26,0.308,27,32,0.844,115,2012-03-07,PHO,OKC
5024,24,Home,W 104-86 ,240,42,88,0.477,34,70,0.486,8,18,0.444,12,17,0.706,104,31,72,0.431,25,57,0.439,6,15,0.4,18,23,0.783,86,2012-03-09,BOS,POR
5025,25,Home,W 104-91 ,240,41,78,0.526,38,71,0.535,3,7,0.429,19,27,0.704,104,34,84,0.405,31,73,0.425,3,11,0.273,20,24,0.833,91,2012-03-09,PHI,UTA
5026,26,Home,W 104-99 ,240,40,93,0.43,35,79,0.443,5,14,0.357,19,28,0.679,104,37,80,0.463,34,69,0.493,3,11,0.273,22,31,0.71,99,2012-03-12,CHI,NYK
5027,27,@,W 104-103 ,240,41,89,0.461,31,65,0.477,10,24,0.417,12,14,0.857,104,39,84,0.464,31,61,0.508,8,23,0.348,17,22,0.773,103,2012-03-13,HOU,OKC
5028,28,Home,W 104-98 (OT),265,36,73,0.493,25,45,0.556,11,28,0.393,21,37,0.568,104,40,91,0.44,32,68,0.471,8,23,0.348,10,11,0.909,98,2012-03-13,ORL,MIA
5029,29,@,L 104-107 ,240,42,83,0.506,36,67,0.537,6,16,0.375,14,16,0.875,104,39,80,0.488,30,60,0.5,9,20,0.45,20,27,0.741,107,2012-03-20,LAL,HOU
5030,30,Home,W 104-87 ,240,43,88,0.489,34,63,0.54,9,25,0.36,9,11,0.818,104,31,81,0.383,20,55,0.364,11,26,0.423,14,17,0.824,87,2012-03-23,SAS,DAL
5031,31,Home,L 104-125 ,240,40,91,0.44,30,70,0.429,10,21,0.476,14,18,0.778,104,43,84,0.512,36,72,0.5,7,12,0.583,32,39,0.821,125,2012-03-24,MIL,IND
5032,32,@,W 104-101 ,240,36,86,0.419,31,66,0.47,5,20,0.25,27,34,0.794,104,39,91,0.429,33,72,0.458,6,19,0.316,17,18,0.944,101,2012-03-27,LAL,GSW
5033,33,@,W 104-103 ,240,39,90,0.433,35,74,0.473,4,16,0.25,22,32,0.688,104,31,88,0.352,28,75,0.373,3,13,0.231,38,52,0.731,103,2012-03-30,SAC,UTA
5034,34,@,W 104-102 (OT),265,37,83,0.446,31,68,0.456,6,15,0.4,24,28,0.857,104,44,101,0.436,35,80,0.438,9,21,0.429,5,10,0.5,102,2012-04-01,IND,HOU
5035,35,@,W 104-101 ,240,40,72,0.556,32,53,0.604,8,19,0.421,16,21,0.762,104,37,88,0.42,29,56,0.518,8,32,0.25,19,25,0.76,101,2012-04-01,DEN,ORL
5036,36,@,L 104-112 ,240,38,83,0.458,28,60,0.467,10,23,0.435,18,25,0.72,104,41,86,0.477,35,63,0.556,6,23,0.261,24,31,0.774,112,2012-04-03,NYK,IND
5037,37,Home,W 104-98 ,240,38,79,0.481,32,63,0.508,6,16,0.375,22,25,0.88,104,39,86,0.453,30,64,0.469,9,22,0.409,11,12,0.917,98,2012-04-06,UTA,GSW
5038,38,@,W 104-87 ,240,42,93,0.452,33,71,0.465,9,22,0.409,11,13,0.846,104,30,70,0.429,23,56,0.411,7,14,0.5,20,37,0.541,87,2012-04-08,HOU,SAC
5039,39,@,L 104-114 ,240,41,93,0.441,35,77,0.455,6,16,0.375,16,26,0.615,104,35,69,0.507,29,47,0.617,6,22,0.273,38,43,0.884,114,2012-04-08,UTA,SAS
5040,40,@,W 104-98 (OT),265,36,77,0.468,28,57,0.491,8,20,0.4,24,32,0.75,104,40,88,0.455,37,67,0.552,3,21,0.143,15,19,0.789,98,2012-04-11,IND,CLE
5041,41,Home,W 104-93 ,240,42,84,0.5,38,70,0.543,4,14,0.286,16,19,0.842,104,38,79,0.481,31,55,0.564,7,24,0.292,10,14,0.714,93,2012-04-11,MEM,PHO
5042,42,@,L 104-112 ,240,37,80,0.463,22,49,0.449,15,31,0.484,15,21,0.714,104,44,81,0.543,34,59,0.576,10,22,0.455,14,30,0.467,112,2012-04-14,GSW,LAC
5043,43,Home,W 104-103 ,240,45,95,0.474,37,76,0.487,8,19,0.421,6,9,0.667,104,40,76,0.526,24,44,0.545,16,32,0.5,7,10,0.7,103,2012-04-15,SAC,POR
5044,44,@,W 104-98 ,240,38,78,0.487,24,54,0.444,14,24,0.583,14,20,0.7,104,36,73,0.493,31,55,0.564,5,18,0.278,21,26,0.808,98,2012-04-18,LAC,DEN
5045,45,@,W 104-95 ,240,36,83,0.434,23,48,0.479,13,35,0.371,19,24,0.792,104,35,78,0.449,25,53,0.472,10,25,0.4,15,17,0.882,95,2012-04-18,NYK,NJN
5046,46,Home,W 104-94 ,240,38,81,0.469,35,62,0.565,3,19,0.158,25,26,0.962,104,37,83,0.446,28,64,0.438,9,19,0.474,11,21,0.524,94,2012-04-20,DAL,GSW
5047,47,@,W 104-84 ,240,44,85,0.518,36,65,0.554,8,20,0.4,8,15,0.533,104,32,74,0.432,26,58,0.448,6,16,0.375,14,26,0.538,84,2012-04-26,NYK,CHA
5048,48,Home,W 104-70 ,240,42,76,0.553,37,66,0.561,5,10,0.5,15,24,0.625,104,24,67,0.358,20,49,0.408,4,18,0.222,18,24,0.75,70,2012-04-26,WAS,MIA
5049,49,@,W 104-94 ,240,35,77,0.455,29,64,0.453,6,13,0.462,28,34,0.824,104,36,80,0.45,26,60,0.433,10,20,0.5,12,17,0.706,94,2012-11-02,MEM,GSW
5050,50,Home,W 104-84 ,240,36,84,0.429,17,48,0.354,19,36,0.528,13,15,0.867,104,33,71,0.465,26,51,0.51,7,20,0.35,11,13,0.846,84,2012-11-02,NYK,MIA
5051,51,@,W 104-95 ,240,41,83,0.494,33,58,0.569,8,25,0.32,14,20,0.7,104,33,71,0.465,24,49,0.49,9,22,0.409,20,22,0.909,95,2012-11-04,ATL,OKC
5052,52,@,L 104-109 ,240,36,81,0.444,31,59,0.525,5,22,0.227,27,31,0.871,104,39,84,0.464,31,63,0.492,8,21,0.381,23,35,0.657,109,2012-11-07,TOR,DAL
5053,53,Home,W 104-84 ,240,40,92,0.435,34,75,0.453,6,17,0.353,18,25,0.72,104,32,87,0.368,28,64,0.438,4,23,0.174,16,22,0.727,84,2012-11-09,DEN,UTA
5054,54,Home,W 104-94 ,240,35,84,0.417,27,62,0.435,8,22,0.364,26,38,0.684,104,33,81,0.407,25,53,0.472,8,28,0.286,20,23,0.87,94,2012-11-09,NYK,DAL
5055,55,Home,W 104-86 ,240,38,86,0.442,24,62,0.387,14,24,0.583,14,16,0.875,104,30,79,0.38,26,64,0.406,4,15,0.267,22,36,0.611,86,2012-11-11,MEM,MIA
5056,56,@,W 104-100 ,240,39,86,0.453,28,60,0.467,11,26,0.423,15,23,0.652,104,38,87,0.437,30,58,0.517,8,29,0.276,16,21,0.762,100,2012-11-15,NYK,SAS
5057,57,@,W 104-97 ,240,41,83,0.494,39,66,0.591,2,17,0.118,20,22,0.909,104,38,92,0.413,31,76,0.408,7,16,0.438,14,21,0.667,97,2012-11-23,SAS,IND
5058,58,@,L 104-108 ,240,37,87,0.425,29,61,0.475,8,26,0.308,22,30,0.733,104,40,80,0.5,29,59,0.492,11,21,0.524,17,20,0.85,108,2012-11-23,CLE,ORL
5059,59,Home,W 104-102 ,240,36,83,0.434,33,68,0.485,3,15,0.2,29,33,0.879,104,40,80,0.5,30,63,0.476,10,17,0.588,12,16,0.75,102,2012-11-23,UTA,SAC
5060,60,Home,W 104-93 ,240,38,75,0.507,31,58,0.534,7,17,0.412,21,26,0.808,104,32,75,0.427,24,56,0.429,8,19,0.421,21,25,0.84,93,2012-11-24,ATL,LAC
5061,61,Home,W 104-101 ,240,39,81,0.481,30,62,0.484,9,19,0.474,17,23,0.739,104,39,83,0.47,35,72,0.486,4,11,0.364,19,20,0.95,101,2012-11-25,PHI,PHO
5062,62,@,W 104-98 ,240,44,86,0.512,36,69,0.522,8,17,0.471,8,10,0.8,104,39,83,0.47,31,66,0.47,8,17,0.471,12,18,0.667,98,2012-11-30,PHI,CHA
5063,63,Home,L 104-105 ,240,42,74,0.568,33,54,0.611,9,20,0.45,11,15,0.733,104,42,89,0.472,38,68,0.559,4,21,0.19,17,24,0.708,105,2012-12-03,UTA,LAC
5064,64,@,L 104-108 ,240,38,79,0.481,31,62,0.5,7,17,0.412,21,25,0.84,104,42,95,0.442,34,73,0.466,8,22,0.364,16,19,0.842,108,2012-12-05,DEN,ATL
5065,65,Home,W 104-94 ,240,41,78,0.526,37,61,0.607,4,17,0.235,18,26,0.692,104,37,84,0.44,31,65,0.477,6,19,0.316,14,30,0.467,94,2012-12-05,BOS,MIN
5066,66,@,W 104-97 ,240,34,75,0.453,25,51,0.49,9,24,0.375,27,34,0.794,104,35,79,0.443,29,58,0.5,6,21,0.286,21,31,0.677,97,2012-12-05,GSW,DET
5067,67,Home,W 104-95 ,240,41,85,0.482,31,59,0.525,10,26,0.385,12,19,0.632,104,36,79,0.456,29,63,0.46,7,16,0.438,16,20,0.8,95,2012-12-07,ATL,WAS
5068,68,Home,L 104-108 ,240,36,70,0.514,28,56,0.5,8,14,0.571,24,31,0.774,104,43,82,0.524,38,68,0.559,5,14,0.357,17,21,0.81,108,2012-12-07,DET,CHI
5069,69,@,W 104-97 ,240,35,75,0.467,26,60,0.433,9,15,0.6,25,33,0.758,104,39,91,0.429,33,64,0.516,6,27,0.222,13,17,0.765,97,2012-12-08,DET,CLE
5070,70,Home,W 104-93 ,240,37,76,0.487,32,57,0.561,5,19,0.263,25,30,0.833,104,38,82,0.463,32,65,0.492,6,17,0.353,11,13,0.846,93,2012-12-09,OKC,IND
5071,71,@,W 104-96 ,240,38,84,0.452,30,64,0.469,8,20,0.4,20,23,0.87,104,31,83,0.373,22,57,0.386,9,26,0.346,25,32,0.781,96,2012-12-10,GSW,CHA
5072,72,Home,W 104-97 ,240,44,82,0.537,40,71,0.563,4,11,0.364,12,23,0.522,104,32,81,0.395,27,63,0.429,5,18,0.278,28,33,0.848,97,2012-12-10,PHI,DET
5073,73,Home,W 104-84 ,240,41,80,0.513,32,64,0.5,9,16,0.563,13,18,0.722,104,32,86,0.372,30,71,0.423,2,15,0.133,18,25,0.72,84,2012-12-19,IND,UTA
5074,74,@,L 104-121 ,240,40,86,0.465,34,76,0.447,6,10,0.6,18,22,0.818,104,47,85,0.553,30,57,0.526,17,28,0.607,10,11,0.909,121,2012-12-19,CHA,PHO
5075,75,Home,W 104-87 ,240,40,86,0.465,33,62,0.532,7,24,0.292,17,28,0.607,104,36,87,0.414,33,68,0.485,3,19,0.158,12,16,0.75,87,2012-12-28,LAL,POR
5076,76,@,W 104-97 (OT),265,37,85,0.435,32,61,0.525,5,24,0.208,25,32,0.781,104,37,82,0.451,32,69,0.464,5,13,0.385,18,24,0.75,97,2012-12-28,TOR,NOH
5077,77,Home,W 104-85 ,240,40,98,0.408,32,77,0.416,8,21,0.381,16,17,0.941,104,33,76,0.434,29,63,0.46,4,13,0.308,15,24,0.625,85,2012-12-29,MIL,MIA
5078,78,@,L 104-123 ,240,43,90,0.478,31,67,0.463,12,23,0.522,6,7,0.857,104,45,84,0.536,29,55,0.527,16,29,0.552,17,22,0.773,123,2012-12-31,ATL,HOU
5079,79,Home,W 104-73 ,240,43,73,0.589,37,59,0.627,6,14,0.429,12,16,0.75,104,28,74,0.378,24,57,0.421,4,17,0.235,13,17,0.765,73,2012-12-31,SAS,BRK
5080,80,Home,W 104-92 ,240,41,83,0.494,36,59,0.61,5,24,0.208,17,23,0.739,104,38,90,0.422,33,74,0.446,5,16,0.313,11,20,0.55,92,2013-01-02,HOU,NOH
5081,81,Home,L 104-106 ,240,37,82,0.451,29,65,0.446,8,17,0.471,22,28,0.786,104,39,78,0.5,32,62,0.516,7,16,0.438,21,29,0.724,106,2013-01-04,CHA,CLE
5082,82,Home,L 104-112 ,240,36,91,0.396,29,68,0.426,7,23,0.304,25,28,0.893,104,37,79,0.468,25,45,0.556,12,34,0.353,26,36,0.722,112,2013-01-05,CLE,HOU
5083,83,@,W 104-92 ,240,38,77,0.494,32,55,0.582,6,22,0.273,22,24,0.917,104,34,76,0.447,26,53,0.491,8,23,0.348,16,21,0.762,92,2013-01-06,OKC,TOR
5084,84,@,W 104-96 ,240,39,84,0.464,29,62,0.468,10,22,0.455,16,21,0.762,104,39,95,0.411,35,85,0.412,4,10,0.4,14,20,0.7,96,2013-01-09,MIL,CHI
5085,85,Home,W 104-92 ,240,44,84,0.524,36,62,0.581,8,22,0.364,8,9,0.889,104,31,69,0.449,27,51,0.529,4,18,0.222,26,33,0.788,92,2013-01-11,NOP,MIN
5086,86,Home,W 104-83 ,240,39,80,0.488,28,63,0.444,11,17,0.647,15,21,0.714,104,32,84,0.381,29,76,0.382,3,8,0.375,16,26,0.615,83,2013-01-12,DAL,MEM
5087,87,@,W 104-101 ,240,39,81,0.481,28,56,0.5,11,25,0.44,15,19,0.789,104,43,88,0.489,34,66,0.515,9,22,0.409,6,6,1.0,101,2013-01-12,ORL,LAC
5088,88,Home,W 104-97 ,240,36,76,0.474,28,58,0.483,8,18,0.444,24,28,0.857,104,39,72,0.542,30,49,0.612,9,23,0.391,10,16,0.625,97,2013-01-14,UTA,MIA
5089,89,Home,W 104-88 ,240,42,84,0.5,32,55,0.582,10,29,0.345,10,18,0.556,104,34,95,0.358,27,67,0.403,7,28,0.25,13,22,0.591,88,2013-01-15,LAL,MIL
5090,90,Home,L 104-110 ,240,34,81,0.42,26,53,0.491,8,28,0.286,28,32,0.875,104,39,88,0.443,33,70,0.471,6,18,0.333,26,32,0.813,110,2013-01-19,POR,MIL
5091,91,Home,W 104-96 ,240,41,71,0.577,31,55,0.564,10,16,0.625,12,21,0.571,104,36,74,0.486,31,60,0.517,5,14,0.357,19,26,0.731,96,2013-01-21,ATL,MIN
5092,92,@,W 104-92 ,240,43,87,0.494,31,62,0.5,12,25,0.48,6,12,0.5,104,31,76,0.408,25,61,0.41,6,15,0.4,24,29,0.828,92,2013-01-23,ATL,CHA
5093,93,Home,W 104-99 ,240,37,84,0.44,31,61,0.508,6,23,0.261,24,27,0.889,104,36,78,0.462,31,62,0.5,5,16,0.313,22,27,0.815,99,2013-01-23,GSW,OKC
5094,94,@,L 104-106 ,240,39,65,0.6,29,42,0.69,10,23,0.435,16,20,0.8,104,39,72,0.542,23,45,0.511,16,27,0.593,12,17,0.706,106,2013-01-27,ATL,NYK
5095,95,@,W 104-102 ,240,40,79,0.506,29,56,0.518,11,23,0.478,13,18,0.722,104,40,90,0.444,30,67,0.448,10,23,0.435,12,16,0.75,102,2013-01-27,DET,ORL
5096,96,@,L 104-106 ,240,42,84,0.5,34,69,0.493,8,15,0.533,12,15,0.8,104,39,86,0.453,29,58,0.5,10,28,0.357,18,23,0.783,106,2013-01-29,DAL,POR
5097,97,@,W 104-88 ,240,45,91,0.495,41,78,0.526,4,13,0.308,10,13,0.769,104,34,82,0.415,28,68,0.412,6,14,0.429,14,19,0.737,88,2013-01-30,CHI,MIL
5098,98,Home,W 104-99 ,240,34,68,0.5,30,56,0.536,4,12,0.333,32,46,0.696,104,37,78,0.474,29,56,0.518,8,22,0.364,17,28,0.607,99,2013-01-30,UTA,NOH
5099,99,@,L 104-106 ,240,40,79,0.506,31,58,0.534,9,21,0.429,15,21,0.714,104,36,72,0.5,25,54,0.463,11,18,0.611,23,27,0.852,106,2013-02-03,LAC,BOS
5100,0,@,L 104-112 ,240,48,100,0.48,45,84,0.536,3,16,0.188,5,11,0.455,104,40,91,0.44,35,75,0.467,5,16,0.313,27,37,0.73,112,2013-02-05,MIL,DEN
5101,1,@,W 104-94 ,240,37,81,0.457,27,56,0.482,10,25,0.4,20,21,0.952,104,33,81,0.407,25,63,0.397,8,18,0.444,20,23,0.87,94,2013-02-06,SAS,MIN
5102,2,@,L 104-110 ,240,42,83,0.506,32,56,0.571,10,27,0.37,10,12,0.833,104,47,93,0.505,42,78,0.538,5,15,0.333,11,18,0.611,110,2013-02-10,POR,ORL
5103,3,@,L 104-117 ,240,39,73,0.534,31,49,0.633,8,24,0.333,18,20,0.9,104,43,74,0.581,35,55,0.636,8,19,0.421,23,27,0.852,117,2013-02-12,POR,MIA
5104,4,@,W 104-100 ,240,40,84,0.476,32,64,0.5,8,20,0.4,16,19,0.842,104,37,91,0.407,32,74,0.432,5,17,0.294,21,24,0.875,100,2013-02-22,DAL,NOH
5105,5,Home,W 104-97 ,240,44,85,0.518,32,67,0.478,12,18,0.667,4,9,0.444,104,36,86,0.419,26,60,0.433,10,26,0.385,15,19,0.789,97,2013-03-02,PHI,GSW
5106,6,Home,L 104-108 ,240,38,82,0.463,29,58,0.5,9,24,0.375,19,22,0.864,104,38,80,0.475,31,59,0.525,7,21,0.333,25,34,0.735,108,2013-03-03,LAC,OKC
5107,7,Home,W 104-88 ,240,46,86,0.535,41,71,0.577,5,15,0.333,7,9,0.778,104,36,89,0.404,29,65,0.446,7,24,0.292,9,11,0.818,88,2013-03-04,DEN,ATL
5108,8,Home,W 104-101 ,240,37,90,0.411,30,74,0.405,7,16,0.438,23,29,0.793,104,38,87,0.437,29,68,0.426,9,19,0.474,16,19,0.842,101,2013-03-06,CLE,UTA
5109,9,Home,W 104-87 ,240,35,70,0.5,25,52,0.481,10,18,0.556,24,32,0.75,104,32,79,0.405,27,64,0.422,5,15,0.333,18,23,0.783,87,2013-03-09,WAS,CHA
5110,10,@,L 104-117 ,240,40,92,0.435,33,65,0.508,7,27,0.259,17,21,0.81,104,42,76,0.553,38,63,0.603,4,13,0.308,29,43,0.674,117,2013-03-15,ORL,OKC
5111,11,Home,L 104-114 ,240,37,85,0.435,33,60,0.55,4,25,0.16,26,31,0.839,104,43,96,0.448,39,75,0.52,4,21,0.19,24,29,0.828,114,2013-03-19,OKC,DEN
5112,12,Home,W 104-93 ,240,41,85,0.482,33,59,0.559,8,26,0.308,14,15,0.933,104,37,84,0.44,31,72,0.431,6,12,0.5,13,15,0.867,93,2013-03-20,SAS,GSW
5113,13,@,W 104-93 ,240,41,87,0.471,31,69,0.449,10,18,0.556,12,16,0.75,104,37,83,0.446,30,59,0.508,7,24,0.292,12,16,0.75,93,2013-03-22,POR,ATL
5114,14,Home,W 104-94 ,240,38,82,0.463,32,63,0.508,6,19,0.316,22,28,0.786,104,32,77,0.416,27,60,0.45,5,17,0.294,25,27,0.926,94,2013-03-22,DAL,BOS
5115,15,Home,W 104-97 (OT),265,39,84,0.464,31,64,0.484,8,20,0.4,18,24,0.75,104,41,96,0.427,33,79,0.418,8,17,0.471,7,12,0.583,97,2013-03-22,SAS,UTA
5116,16,@,W 104-99 ,240,39,78,0.5,29,52,0.558,10,26,0.385,16,21,0.762,104,42,92,0.457,37,71,0.521,5,21,0.238,10,18,0.556,99,2013-03-24,ATL,MIL
5117,17,@,W 104-97 ,240,41,89,0.461,31,63,0.492,10,26,0.385,12,17,0.706,104,39,78,0.5,33,66,0.5,6,12,0.5,13,19,0.684,97,2013-03-24,CHI,MIN
5118,18,Home,W 104-102 ,240,39,74,0.527,33,59,0.559,6,15,0.4,20,21,0.952,104,41,81,0.506,33,62,0.532,8,19,0.421,12,21,0.571,102,2013-03-29,SAS,LAC
5119,19,Home,L 104-112 ,240,40,82,0.488,34,70,0.486,6,12,0.5,18,19,0.947,104,37,80,0.463,33,65,0.508,4,15,0.267,34,46,0.739,112,2013-03-30,PHO,IND
5120,20,Home,W 104-85 ,240,39,79,0.494,35,67,0.522,4,12,0.333,22,31,0.71,104,35,86,0.407,32,66,0.485,3,20,0.15,12,15,0.8,85,2013-04-06,WAS,IND
5121,21,Home,W 104-83 ,240,42,93,0.452,37,73,0.507,5,20,0.25,15,23,0.652,104,30,80,0.375,23,66,0.348,7,14,0.5,16,20,0.8,83,2013-04-09,BRK,PHI
5122,22,Home,W 104-96 ,240,40,79,0.506,33,54,0.611,7,25,0.28,17,22,0.773,104,37,84,0.44,32,64,0.5,5,20,0.25,17,18,0.944,96,2013-04-09,LAL,NOH
5123,23,Home,L 104-111 ,240,40,82,0.488,37,67,0.552,3,15,0.2,21,26,0.808,104,40,80,0.5,36,64,0.563,4,16,0.25,27,42,0.643,111,2013-04-10,CLE,DET
5124,24,@,L 104-109 ,240,38,92,0.413,21,59,0.356,17,33,0.515,11,16,0.688,104,43,85,0.506,37,65,0.569,6,20,0.3,17,25,0.68,109,2013-04-12,MIL,ATL
5125,25,Home,W 104-95 ,240,42,92,0.457,37,69,0.536,5,23,0.217,15,20,0.75,104,38,87,0.437,31,60,0.517,7,27,0.259,12,21,0.571,95,2013-04-15,OKC,SAC
5126,26,Home,W 104-91 ,240,43,83,0.518,39,64,0.609,4,19,0.211,14,18,0.778,104,33,81,0.407,25,55,0.455,8,26,0.308,17,24,0.708,91,2013-10-30,PHO,POR
5127,27,@,L 104-107 ,240,42,93,0.452,39,79,0.494,3,14,0.214,17,19,0.895,104,42,86,0.488,31,64,0.484,11,22,0.5,12,18,0.667,107,2013-11-02,CHI,PHI
5128,28,@,W 104-93 ,240,34,67,0.507,25,45,0.556,9,22,0.409,27,35,0.771,104,34,81,0.42,30,59,0.508,4,22,0.182,21,27,0.778,93,2013-11-02,HOU,UTA
5129,29,Home,W 104-88 ,240,40,78,0.513,36,67,0.537,4,11,0.364,20,32,0.625,104,31,82,0.378,27,64,0.422,4,18,0.222,22,30,0.733,88,2013-11-05,BRK,UTA
5130,30,@,L 104-123 ,240,39,88,0.443,27,57,0.474,12,31,0.387,14,20,0.7,104,49,94,0.521,36,67,0.537,13,27,0.481,12,14,0.857,123,2013-11-05,LAL,DAL
5131,31,@,W 104-98 ,240,39,78,0.5,27,53,0.509,12,25,0.48,14,22,0.636,104,37,85,0.435,27,67,0.403,10,18,0.556,14,19,0.737,98,2013-11-05,PHO,NOP
5132,32,@,W 104-95 ,240,41,83,0.494,31,60,0.517,10,23,0.435,12,14,0.857,104,31,72,0.431,25,51,0.49,6,21,0.286,27,33,0.818,95,2013-11-05,MIA,TOR
5133,33,@,L 104-109 ,240,38,85,0.447,26,57,0.456,12,28,0.429,16,22,0.727,104,36,72,0.5,23,49,0.469,13,23,0.565,24,26,0.923,109,2013-11-06,CLE,MIL
5134,34,Home,W 104-91 ,240,39,80,0.488,29,57,0.509,10,23,0.435,16,18,0.889,104,36,86,0.419,30,64,0.469,6,22,0.273,13,15,0.867,91,2013-11-08,POR,SAC
5135,35,Home,W 104-94 ,240,43,90,0.478,37,71,0.521,6,19,0.316,12,17,0.706,104,38,82,0.463,30,65,0.462,8,17,0.471,10,18,0.556,94,2013-11-09,ATL,ORL
5136,36,@,L 104-110 (2OT),290,38,114,0.333,30,89,0.337,8,25,0.32,20,27,0.741,104,37,84,0.44,30,58,0.517,7,26,0.269,29,47,0.617,110,2013-11-11,TOR,HOU
5137,37,Home,W 104-77 ,240,40,79,0.506,35,63,0.556,5,16,0.313,19,21,0.905,104,30,88,0.341,22,72,0.306,8,16,0.5,9,11,0.818,77,2013-11-15,IND,MIL
5138,38,@,L 104-110 ,240,37,74,0.5,25,46,0.543,12,28,0.429,18,21,0.857,104,40,74,0.541,35,61,0.574,5,13,0.385,25,30,0.833,110,2013-11-15,DAL,MIA
5139,39,Home,W 104-88 ,240,41,81,0.506,31,60,0.517,10,21,0.476,12,19,0.632,104,33,74,0.446,22,50,0.44,11,24,0.458,11,15,0.733,88,2013-11-19,MIA,ATL
5140,40,@,L 104-107 ,240,37,79,0.468,27,50,0.54,10,29,0.345,20,28,0.714,104,39,83,0.47,31,61,0.508,8,22,0.364,21,28,0.75,107,2013-11-19,PHO,SAC
5141,41,Home,W 104-100 ,240,41,85,0.482,34,70,0.486,7,15,0.467,15,15,1.0,104,37,85,0.435,27,57,0.474,10,28,0.357,16,24,0.667,100,2013-11-19,WAS,MIN
5142,42,Home,W 104-93 ,240,39,81,0.481,31,60,0.517,8,21,0.381,18,24,0.75,104,39,86,0.453,35,71,0.493,4,15,0.267,11,12,0.917,93,2013-11-20,SAS,BOS
5143,43,Home,W 104-100 ,240,36,88,0.409,30,71,0.423,6,17,0.353,26,33,0.788,104,41,77,0.532,33,54,0.611,8,23,0.348,10,16,0.625,100,2013-11-22,NOP,CLE
5144,44,@,W 104-96 ,240,46,95,0.484,35,66,0.53,11,29,0.379,1,3,0.333,104,39,84,0.464,33,63,0.524,6,21,0.286,12,14,0.857,96,2013-11-24,PHO,ORL
5145,45,@,W 104-98 (OT),265,37,83,0.446,31,63,0.492,6,20,0.3,24,37,0.649,104,42,91,0.462,36,68,0.529,6,23,0.261,8,10,0.8,98,2013-11-29,LAC,SAC
5146,46,Home,L 104-112 ,240,37,78,0.474,25,51,0.49,12,27,0.444,18,25,0.72,104,39,76,0.513,30,58,0.517,9,18,0.5,25,29,0.862,112,2013-11-30,PHO,UTA
5147,47,@,L 104-111 ,240,39,89,0.438,34,78,0.436,5,11,0.455,21,24,0.875,104,44,98,0.449,36,75,0.48,8,23,0.348,15,17,0.882,111,2013-12-04,OKC,POR
5148,48,Home,W 104-96 ,240,39,70,0.557,36,58,0.621,3,12,0.25,23,28,0.821,104,35,80,0.438,24,58,0.414,11,22,0.5,15,21,0.714,96,2013-12-10,BRK,BOS
5149,49,@,L 104-111 ,240,40,94,0.426,35,74,0.473,5,20,0.25,19,24,0.792,104,39,89,0.438,31,62,0.5,8,27,0.296,25,30,0.833,111,2013-12-12,HOU,POR
5150,50,Home,W 104-98 ,240,39,76,0.513,30,54,0.556,9,22,0.409,17,20,0.85,104,40,80,0.5,34,65,0.523,6,15,0.4,12,17,0.706,98,2013-12-13,NOP,MEM
5151,51,Home,W 104-93 ,240,41,91,0.451,36,71,0.507,5,20,0.25,17,24,0.708,104,33,88,0.375,28,70,0.4,5,18,0.278,22,30,0.733,93,2013-12-17,GSW,NOP
5152,52,@,W 104-102 (OT),265,37,81,0.457,29,66,0.439,8,15,0.533,22,34,0.647,104,41,96,0.427,35,70,0.5,6,26,0.231,14,20,0.7,102,2013-12-18,CHA,TOR
5153,53,@,W 104-102 ,240,40,89,0.449,29,62,0.468,11,27,0.407,13,19,0.684,104,42,90,0.467,34,59,0.576,8,31,0.258,10,11,0.909,102,2013-12-19,SAS,GSW
5154,54,Home,W 104-91 ,240,42,78,0.538,35,59,0.593,7,19,0.368,13,15,0.867,104,33,95,0.347,28,73,0.384,5,22,0.227,20,25,0.8,91,2013-12-20,LAL,MIN
5155,55,@,W 104-98 ,240,36,91,0.396,28,71,0.394,8,20,0.4,24,29,0.828,104,28,76,0.368,21,53,0.396,7,23,0.304,35,36,0.972,98,2013-12-22,TOR,OKC
5156,56,Home,L 104-111 ,240,38,70,0.543,31,51,0.608,7,19,0.368,21,29,0.724,104,40,79,0.506,29,57,0.509,11,22,0.5,20,23,0.87,111,2013-12-23,HOU,DAL
5157,57,Home,W 104-94 ,240,39,83,0.47,28,63,0.444,11,20,0.55,15,20,0.75,104,35,75,0.467,24,51,0.471,11,24,0.458,13,15,0.867,94,2013-12-23,MEM,UTA
5158,58,Home,W 104-93 ,240,34,79,0.43,22,53,0.415,12,26,0.462,24,32,0.75,104,33,88,0.375,24,56,0.429,9,32,0.281,18,25,0.72,93,2013-12-27,BRK,MIL
5159,59,Home,L 104-108 (OT),265,38,92,0.413,28,76,0.368,10,16,0.625,18,21,0.857,104,42,95,0.442,32,62,0.516,10,33,0.303,14,19,0.737,108,2013-12-29,CLE,GSW
5160,60,Home,L 104-111 ,240,31,84,0.369,19,47,0.404,12,37,0.324,30,34,0.882,104,39,95,0.411,33,71,0.465,6,24,0.25,27,33,0.818,111,2013-12-29,LAL,PHI
5161,61,@,L 104-112 ,240,41,91,0.451,34,77,0.442,7,14,0.5,15,20,0.75,104,44,94,0.468,36,70,0.514,8,24,0.333,16,19,0.842,112,2013-12-29,SAC,SAS
5162,62,@,L 104-134 ,240,34,79,0.43,27,63,0.429,7,16,0.438,29,36,0.806,104,54,93,0.581,33,60,0.55,21,33,0.636,5,7,0.714,134,2014-01-02,CHA,POR
5163,63,Home,L 104-113 ,240,35,83,0.422,28,60,0.467,7,23,0.304,27,37,0.73,104,42,90,0.467,37,71,0.521,5,19,0.263,24,31,0.774,113,2014-01-02,SAC,PHI
5164,64,@,W 104-103 ,240,38,92,0.413,27,63,0.429,11,29,0.379,17,23,0.739,104,34,86,0.395,28,70,0.4,6,16,0.375,29,35,0.829,103,2014-01-08,PHO,MIN
5165,65,Home,W 104-95 (2OT),290,40,86,0.465,33,66,0.5,7,20,0.35,17,21,0.81,104,34,80,0.425,28,57,0.491,6,23,0.261,21,27,0.778,95,2014-01-10,BRK,MIA
5166,66,Home,W 104-99 ,240,42,86,0.488,36,71,0.507,6,15,0.4,14,23,0.609,104,38,92,0.413,27,62,0.435,11,30,0.367,12,16,0.75,99,2014-01-10,MEM,PHO
5167,67,Home,L 104-114 ,240,41,95,0.432,33,71,0.465,8,24,0.333,14,20,0.7,104,40,94,0.426,29,64,0.453,11,30,0.367,23,33,0.697,114,2014-01-10,PHI,DET
5168,68,@,L 104-112 ,240,44,95,0.463,40,81,0.494,4,14,0.286,12,17,0.706,104,40,93,0.43,30,72,0.417,10,21,0.476,22,26,0.846,112,2014-01-11,BOS,POR
5169,69,Home,W 104-86 ,240,42,74,0.568,33,61,0.541,9,13,0.692,11,14,0.786,104,33,93,0.355,28,76,0.368,5,17,0.294,15,18,0.833,86,2014-01-12,SAS,MIN
5170,70,@,W 104-92 ,240,37,79,0.468,29,60,0.483,8,19,0.421,22,34,0.647,104,38,101,0.376,35,84,0.417,3,17,0.176,13,14,0.929,92,2014-01-13,HOU,BOS
5171,71,@,W 104-92 ,240,38,82,0.463,32,57,0.561,6,25,0.24,22,25,0.88,104,33,82,0.402,21,48,0.438,12,34,0.353,14,21,0.667,92,2014-01-16,OKC,HOU
5172,72,Home,L 104-107 ,240,44,99,0.444,37,76,0.487,7,23,0.304,9,11,0.818,104,37,74,0.5,25,54,0.463,12,20,0.6,21,28,0.75,107,2014-01-17,BOS,LAL
5173,73,@,W 104-96 (OT),265,39,79,0.494,32,58,0.552,7,21,0.333,19,29,0.655,104,36,75,0.48,29,58,0.5,7,17,0.412,17,23,0.739,96,2014-01-18,MIA,CHA
5174,74,@,L 104-114 ,240,40,80,0.5,29,57,0.509,11,23,0.478,13,21,0.619,104,41,85,0.482,34,58,0.586,7,27,0.259,25,37,0.676,114,2014-01-18,MIL,HOU
5175,75,@,W 104-98 ,240,40,81,0.494,34,60,0.567,6,21,0.286,18,31,0.581,104,37,76,0.487,29,55,0.527,8,21,0.381,16,29,0.552,98,2014-01-18,DET,WAS
5176,76,Home,W 104-101 ,240,41,84,0.488,33,57,0.579,8,27,0.296,14,22,0.636,104,36,84,0.429,32,69,0.464,4,15,0.267,25,34,0.735,101,2014-01-22,MIL,DET
5177,77,@,W 104-95 ,240,40,84,0.476,32,64,0.5,8,20,0.4,16,22,0.727,104,38,89,0.427,32,69,0.464,6,20,0.3,13,16,0.813,95,2014-01-24,TOR,PHI
5178,78,@,L 104-115 ,240,38,89,0.427,29,67,0.433,9,22,0.409,19,22,0.864,104,46,95,0.484,42,79,0.532,4,16,0.25,19,24,0.792,115,2014-01-25,MIN,POR
5179,79,Home,W 104-101 ,240,38,81,0.469,28,57,0.491,10,24,0.417,18,22,0.818,104,39,91,0.429,32,71,0.451,7,20,0.35,16,18,0.889,101,2014-01-25,UTA,WAS
5180,80,@,W 104-103 ,240,37,79,0.468,28,57,0.491,9,22,0.409,21,26,0.808,104,37,77,0.481,26,53,0.491,11,24,0.458,18,22,0.818,103,2014-01-27,TOR,BRK
5181,81,@,W 104-92 ,240,42,99,0.424,37,78,0.474,5,21,0.238,15,27,0.556,104,37,94,0.394,32,70,0.457,5,24,0.208,13,16,0.813,92,2014-01-28,IND,LAL
5182,82,@,W 104-100 ,240,36,77,0.468,28,56,0.5,8,21,0.381,24,28,0.857,104,39,89,0.438,33,73,0.452,6,16,0.375,16,22,0.727,100,2014-02-08,SAS,CHA
5183,83,@,W 104-92 ,240,41,82,0.5,32,63,0.508,9,19,0.474,13,14,0.929,104,37,80,0.463,31,63,0.492,6,17,0.353,12,17,0.706,92,2014-02-12,SAS,BOS
5184,84,Home,W 104-83 ,240,38,94,0.404,27,61,0.443,11,33,0.333,17,22,0.773,104,30,78,0.385,26,58,0.448,4,20,0.2,19,23,0.826,83,2014-02-12,TOR,ATL
5185,85,Home,W 104-100 ,240,35,82,0.427,23,56,0.411,12,26,0.462,22,30,0.733,104,40,80,0.5,29,55,0.527,11,25,0.44,9,16,0.563,100,2014-02-18,MIL,ORL
5186,86,Home,W 104-91 ,240,40,83,0.482,34,63,0.54,6,20,0.3,18,31,0.581,104,35,87,0.402,29,65,0.446,6,22,0.273,15,20,0.75,91,2014-02-19,MIN,IND
5187,87,Home,L 104-121 ,240,37,79,0.468,34,60,0.567,3,19,0.158,27,36,0.75,104,43,84,0.512,32,62,0.516,11,22,0.5,24,33,0.727,121,2014-02-22,UTA,MIN
5188,88,@,W 104-96 ,240,38,82,0.463,25,51,0.49,13,31,0.419,15,22,0.682,104,40,99,0.404,36,86,0.419,4,13,0.308,12,18,0.667,96,2014-02-24,GSW,DET
5189,89,@,L 104-115 ,240,38,76,0.5,29,57,0.509,9,19,0.474,19,24,0.792,104,43,90,0.478,35,68,0.515,8,22,0.364,21,23,0.913,115,2014-02-26,ATL,BOS
5190,90,Home,L 104-114 ,240,39,80,0.488,26,49,0.531,13,31,0.419,13,17,0.765,104,40,86,0.465,29,60,0.483,11,26,0.423,23,24,0.958,114,2014-02-26,OKC,CLE
5191,91,@,L 104-116 ,240,42,78,0.538,37,65,0.569,5,13,0.385,15,17,0.882,104,40,74,0.541,30,51,0.588,10,23,0.435,26,32,0.813,116,2014-02-28,NOP,PHO
5192,92,Home,W 104-98 ,240,38,79,0.481,30,57,0.526,8,22,0.364,20,23,0.87,104,37,88,0.42,29,65,0.446,8,23,0.348,16,20,0.8,98,2014-03-02,TOR,GSW
5193,93,Home,L 104-110 ,240,39,81,0.481,30,62,0.484,9,19,0.474,17,21,0.81,104,43,79,0.544,37,66,0.561,6,13,0.462,18,21,0.857,110,2014-03-03,WAS,MEM
5194,94,@,W 104-96 ,240,40,78,0.513,32,58,0.552,8,20,0.4,16,22,0.727,104,39,86,0.453,32,67,0.478,7,19,0.368,11,19,0.579,96,2014-03-04,LAC,PHO
5195,95,Home,W 104-91 ,240,44,81,0.543,38,66,0.576,6,15,0.4,10,10,1.0,104,35,78,0.449,27,55,0.491,8,23,0.348,13,22,0.591,91,2014-03-05,WAS,UTA
5196,96,@,L 104-112 ,240,40,89,0.449,35,69,0.507,5,20,0.25,19,25,0.76,104,42,84,0.5,34,64,0.531,8,20,0.4,20,23,0.87,112,2014-03-07,MIL,NOP
5197,97,@,W 104-92 ,240,37,80,0.463,27,57,0.474,10,23,0.435,20,28,0.714,104,36,76,0.474,31,54,0.574,5,22,0.227,15,20,0.75,92,2014-03-08,UTA,PHI
5198,98,Home,W 104-89 ,240,41,77,0.532,29,52,0.558,12,25,0.48,10,16,0.625,104,36,81,0.444,31,58,0.534,5,23,0.217,12,21,0.571,89,2014-03-09,BRK,SAC
5199,99,Home,L 104-111 ,240,41,95,0.432,34,76,0.447,7,19,0.368,15,20,0.75,104,37,76,0.487,23,52,0.442,14,24,0.583,23,31,0.742,111,2014-03-09,MIN,TOR
5200,0,@,W 104-96 ,240,40,79,0.506,28,58,0.483,12,21,0.571,12,15,0.8,104,32,75,0.427,24,57,0.421,8,18,0.444,24,28,0.857,96,2014-03-11,SAS,CHI
5201,1,Home,L 104-112 (OT),265,37,91,0.407,30,68,0.441,7,23,0.304,23,30,0.767,104,41,104,0.394,34,80,0.425,7,24,0.292,23,25,0.92,112,2014-03-15,DET,IND
5202,2,@,L 104-113 ,240,37,75,0.493,28,52,0.538,9,23,0.391,21,28,0.75,104,40,78,0.513,31,56,0.554,9,22,0.409,24,29,0.828,113,2014-03-16,HOU,MIA
5203,3,Home,W 104-102 ,240,34,78,0.436,28,61,0.459,6,17,0.353,30,38,0.789,104,41,85,0.482,35,66,0.53,6,19,0.316,14,19,0.737,102,2014-03-16,MIN,SAC
5204,4,@,L 104-122 ,240,42,91,0.462,37,80,0.463,5,11,0.455,15,21,0.714,104,49,78,0.628,39,62,0.629,10,16,0.625,14,19,0.737,122,2014-03-16,UTA,SAS
5205,5,Home,W 104-99 ,240,37,75,0.493,28,55,0.509,9,20,0.45,21,35,0.6,104,40,85,0.471,31,58,0.534,9,27,0.333,10,12,0.833,99,2014-03-19,BRK,CHA
5206,6,Home,L 104-107 (OT),265,35,91,0.385,25,60,0.417,10,31,0.323,24,31,0.774,104,34,84,0.405,23,54,0.426,11,30,0.367,28,33,0.848,107,2014-03-23,DAL,BRK
5207,7,@,L 104-109 (OT),265,33,90,0.367,23,50,0.46,10,40,0.25,28,32,0.875,104,40,85,0.471,31,65,0.477,9,20,0.45,20,27,0.741,109,2014-03-24,BRK,NOP
5208,8,Home,L 104-114 ,240,41,96,0.427,31,70,0.443,10,26,0.385,12,14,0.857,104,38,82,0.463,26,52,0.5,12,30,0.4,26,32,0.813,114,2014-03-31,MIN,LAC
5209,9,@,L 104-116 ,240,41,88,0.466,32,61,0.525,9,27,0.333,13,21,0.619,104,46,76,0.605,31,45,0.689,15,31,0.484,9,11,0.818,116,2014-04-04,DET,BRK
5210,10,@,W 104-102 ,240,41,85,0.482,30,61,0.492,11,24,0.458,11,19,0.579,104,38,87,0.437,34,71,0.479,4,16,0.25,22,29,0.759,102,2014-04-09,IND,MIL
5211,11,@,L 104-112 ,240,39,82,0.476,30,56,0.536,9,26,0.346,17,19,0.895,104,43,96,0.448,30,66,0.455,13,30,0.433,13,16,0.813,112,2014-04-11,PHO,SAS
5212,12,@,L 104-111 ,240,39,88,0.443,30,66,0.455,9,22,0.409,17,21,0.81,104,35,74,0.473,25,47,0.532,10,27,0.37,31,39,0.795,111,2014-04-12,NOP,HOU
5213,13,Home,W 104-91 ,240,40,84,0.476,32,62,0.516,8,22,0.364,16,19,0.842,104,32,68,0.471,27,60,0.45,5,8,0.625,22,34,0.647,91,2014-04-12,WAS,MIL
5214,14,Home,W 104-98 ,240,38,85,0.447,34,63,0.54,4,22,0.182,24,29,0.828,104,39,89,0.438,35,72,0.486,4,17,0.235,16,18,0.889,98,2014-04-14,HOU,SAS
5215,15,Home,L 104-119 ,240,42,81,0.519,36,62,0.581,6,19,0.316,14,20,0.7,104,45,82,0.549,35,58,0.603,10,24,0.417,19,22,0.864,119,2014-04-14,UTA,LAL
5216,16,@,L 104-110 ,240,34,84,0.405,26,50,0.52,8,34,0.235,28,33,0.848,104,42,101,0.416,32,75,0.427,10,26,0.385,16,22,0.727,110,2014-04-16,LAC,POR
5217,17,@,W 104-99 ,240,40,86,0.465,32,66,0.485,8,20,0.4,16,22,0.727,104,37,86,0.43,33,67,0.493,4,19,0.211,21,30,0.7,99,2014-04-16,PHO,SAC
5218,18,@,W 104-80 ,240,36,71,0.507,29,47,0.617,7,24,0.292,25,30,0.833,104,31,85,0.365,28,68,0.412,3,17,0.176,15,17,0.882,80,2014-10-29,CHI,NYK
5219,19,@,W 104-93 ,240,40,77,0.519,26,50,0.52,14,27,0.519,10,14,0.714,104,38,81,0.469,35,63,0.556,3,18,0.167,14,17,0.824,93,2014-10-29,HOU,UTA
5220,20,@,L 104-127 ,240,41,88,0.466,37,74,0.5,4,14,0.286,18,25,0.72,104,46,83,0.554,35,60,0.583,11,23,0.478,24,28,0.857,127,2014-11-01,LAL,GSW
5221,21,Home,W 104-90 ,240,32,76,0.421,20,42,0.476,12,34,0.353,28,40,0.7,104,37,98,0.378,36,73,0.493,1,25,0.04,15,18,0.833,90,2014-11-01,HOU,BOS
5222,22,Home,L 104-109 ,240,38,89,0.427,31,70,0.443,7,19,0.368,21,28,0.75,104,46,89,0.517,40,64,0.625,6,25,0.24,11,19,0.579,109,2014-11-01,NOP,DAL
5223,23,@,W 104-93 ,240,32,75,0.427,16,41,0.39,16,34,0.471,24,30,0.8,104,33,74,0.446,22,52,0.423,11,22,0.5,16,23,0.696,93,2014-11-03,HOU,PHI
5224,24,@,L 104-121 ,240,38,82,0.463,31,63,0.492,7,19,0.368,21,27,0.778,104,43,74,0.581,28,49,0.571,15,25,0.6,20,20,1.0,121,2014-11-05,LAC,GSW
5225,25,Home,W 104-96 ,240,40,83,0.482,36,69,0.522,4,14,0.286,20,23,0.87,104,39,75,0.52,31,60,0.517,8,15,0.533,10,16,0.625,96,2014-11-09,BRK,ORL
5226,26,Home,W 104-100 ,240,35,77,0.455,26,56,0.464,9,21,0.429,25,30,0.833,104,39,81,0.481,27,56,0.482,12,25,0.48,10,16,0.625,100,2014-11-11,TOR,ORL
5227,27,@,L 104-112 ,240,35,74,0.473,26,53,0.491,9,21,0.429,25,32,0.781,104,39,81,0.481,31,57,0.544,8,24,0.333,26,29,0.897,112,2014-11-12,BRK,PHO
5228,28,Home,L 104-114 ,240,42,84,0.5,42,76,0.553,0,8,0.0,20,24,0.833,104,44,89,0.494,37,62,0.597,7,27,0.259,19,23,0.826,114,2014-11-24,PHI,POR
5229,29,Home,W 104-100 ,240,37,82,0.451,33,65,0.508,4,17,0.235,26,32,0.813,104,39,84,0.464,25,51,0.49,14,33,0.424,8,11,0.727,100,2014-11-24,TOR,PHO
5230,30,@,W 104-98 ,240,37,78,0.474,25,50,0.5,12,28,0.429,18,19,0.947,104,35,78,0.449,25,51,0.49,10,27,0.37,18,24,0.75,98,2014-11-26,LAC,DET
5231,31,@,W 104-88 ,240,39,77,0.506,26,48,0.542,13,29,0.448,13,16,0.813,104,34,83,0.41,28,60,0.467,6,23,0.261,14,25,0.56,88,2014-11-28,MIL,DET
5232,32,@,L 104-112 ,240,38,75,0.507,32,65,0.492,6,10,0.6,22,26,0.846,104,42,82,0.512,30,58,0.517,12,24,0.5,16,20,0.8,112,2014-11-28,SAC,SAS
5233,33,@,W 104-93 ,240,37,79,0.468,28,58,0.483,9,21,0.429,21,27,0.778,104,33,91,0.363,22,68,0.324,11,23,0.478,16,24,0.667,93,2014-11-30,GSW,DET
5234,34,@,L 104-112 ,240,37,84,0.44,30,60,0.5,7,24,0.292,23,27,0.852,104,39,88,0.443,34,71,0.479,5,17,0.294,29,45,0.644,112,2014-12-02,OKC,NOP
5235,35,Home,L 104-123 ,240,42,87,0.483,34,59,0.576,8,28,0.286,12,15,0.8,104,45,79,0.57,33,58,0.569,12,21,0.571,21,24,0.875,123,2014-12-03,UTA,TOR
5236,36,@,W 104-87 ,240,43,83,0.518,35,65,0.538,8,18,0.444,10,15,0.667,104,36,90,0.4,31,71,0.437,5,19,0.263,10,15,0.667,87,2014-12-07,NOP,LAL
5237,37,Home,W 104-93 ,240,40,80,0.5,36,65,0.554,4,15,0.267,20,26,0.769,104,37,78,0.474,28,59,0.475,9,19,0.474,10,13,0.769,93,2014-12-09,NOP,NYK
5238,38,Home,W 104-96 ,240,39,80,0.488,30,64,0.469,9,16,0.563,17,21,0.81,104,32,75,0.427,26,55,0.473,6,20,0.3,26,31,0.839,96,2014-12-12,WAS,LAC
5239,39,@,W 104-92 ,240,41,87,0.471,35,67,0.522,6,20,0.3,16,24,0.667,104,36,84,0.429,31,66,0.47,5,18,0.278,15,17,0.882,92,2014-12-16,OKC,SAC
5240,40,Home,W 104-97 ,240,41,87,0.471,34,64,0.531,7,23,0.304,15,29,0.517,104,37,77,0.481,30,58,0.517,7,19,0.368,16,22,0.727,97,2014-12-17,POR,MIL
5241,41,@,W 104-103 ,240,37,86,0.43,29,65,0.446,8,21,0.381,22,29,0.759,104,41,85,0.482,31,60,0.517,10,25,0.4,11,15,0.733,103,2014-12-19,OKC,LAL
5242,42,Home,W 104-86 ,240,42,87,0.483,33,65,0.508,9,22,0.409,11,16,0.688,104,33,85,0.388,25,54,0.463,8,31,0.258,12,15,0.8,86,2014-12-20,CHA,UTA
5243,43,@,W 104-97 ,240,38,74,0.514,28,48,0.583,10,26,0.385,18,24,0.75,104,34,86,0.395,19,43,0.442,15,43,0.349,14,18,0.778,97,2014-12-20,ATL,HOU
5244,44,@,W 104-92 ,240,40,78,0.513,34,61,0.557,6,17,0.353,18,25,0.72,104,34,83,0.41,31,69,0.449,3,14,0.214,21,29,0.724,92,2014-12-21,PHO,WAS
5245,45,@,L 104-107 ,240,37,92,0.402,26,63,0.413,11,29,0.379,19,28,0.679,104,34,76,0.447,22,53,0.415,12,23,0.522,27,35,0.771,107,2014-12-23,LAC,ATL
5246,46,@,L 104-125 ,240,39,88,0.443,35,75,0.467,4,13,0.308,22,29,0.759,104,44,84,0.524,32,60,0.533,12,24,0.5,25,31,0.806,125,2014-12-23,MIN,CLE
5247,47,@,W 104-94 (OT),265,40,85,0.471,34,64,0.531,6,21,0.286,18,21,0.857,104,33,90,0.367,26,65,0.4,7,25,0.28,21,26,0.808,94,2014-12-29,MIL,CHO
5248,48,@,W 104-103 ,240,35,73,0.479,27,55,0.491,8,18,0.444,26,28,0.929,104,40,86,0.465,31,57,0.544,9,29,0.31,14,23,0.609,103,2014-12-29,WAS,HOU
5249,49,@,L 104-109 (OT),265,45,100,0.45,40,83,0.482,5,17,0.294,9,11,0.818,104,37,100,0.37,31,72,0.431,6,28,0.214,29,40,0.725,109,2015-01-03,BOS,CHI
5250,50,@,W 104-95 ,240,38,78,0.487,32,59,0.542,6,19,0.316,22,23,0.957,104,36,91,0.396,29,73,0.397,7,18,0.389,16,23,0.696,95,2015-01-05,CHA,BOS
5251,51,Home,L 104-105 ,240,36,79,0.456,27,58,0.466,9,21,0.429,23,34,0.676,104,41,87,0.471,38,68,0.559,3,19,0.158,20,28,0.714,105,2015-01-06,SAS,DET
5252,52,Home,W 104-83 ,240,36,92,0.391,26,73,0.356,10,19,0.526,22,28,0.786,104,29,89,0.326,20,59,0.339,9,30,0.3,16,23,0.696,83,2015-01-07,SAC,OKC
5253,53,@,W 104-90 ,240,39,81,0.481,33,60,0.55,6,21,0.286,20,24,0.833,104,34,75,0.453,25,49,0.51,9,26,0.346,13,18,0.722,90,2015-01-11,MIA,LAC
5254,54,Home,L 104-108 (OT),265,38,86,0.442,37,68,0.544,1,18,0.056,27,34,0.794,104,43,100,0.43,37,76,0.487,6,24,0.25,16,23,0.696,108,2015-01-13,SAC,DAL
5255,55,Home,W 104-89 ,240,38,81,0.469,25,52,0.481,13,29,0.448,15,19,0.789,104,30,71,0.423,24,53,0.453,6,18,0.333,23,27,0.852,89,2015-01-14,GSW,MIA
5256,56,Home,W 104-81 ,240,36,76,0.474,30,57,0.526,6,19,0.316,26,32,0.813,104,30,81,0.37,24,60,0.4,6,21,0.286,15,18,0.833,81,2015-01-22,CHI,SAS
5257,57,@,W 104-91 ,240,34,73,0.466,25,47,0.532,9,26,0.346,27,34,0.794,104,34,82,0.415,27,64,0.422,7,18,0.389,16,23,0.696,91,2015-01-27,TOR,IND
5258,58,@,W 104-86 ,240,44,93,0.473,44,82,0.537,0,11,0.0,16,25,0.64,104,33,92,0.359,28,68,0.412,5,24,0.208,15,20,0.75,86,2015-01-31,CHA,DEN
5259,59,Home,W 104-97 ,240,37,75,0.493,29,55,0.527,8,20,0.4,22,26,0.846,104,38,90,0.422,32,67,0.478,6,23,0.261,15,18,0.833,97,2015-02-02,OKC,ORL
5260,60,Home,W 104-100 ,240,40,99,0.404,28,71,0.394,12,28,0.429,12,17,0.706,104,33,80,0.413,29,56,0.518,4,24,0.167,30,33,0.909,100,2015-02-04,BOS,DEN
5261,61,Home,W 104-86 ,240,42,80,0.525,35,60,0.583,7,20,0.35,13,15,0.867,104,35,75,0.467,33,63,0.524,2,12,0.167,14,27,0.519,86,2015-02-10,CHI,SAC
5262,62,@,W 104-87 ,240,42,88,0.477,32,61,0.525,10,27,0.37,10,11,0.909,104,33,81,0.407,24,60,0.4,9,21,0.429,12,17,0.706,87,2015-02-11,SAS,DET
5263,63,Home,W 104-89 ,240,38,91,0.418,31,69,0.449,7,22,0.318,21,26,0.808,104,33,91,0.363,24,64,0.375,9,27,0.333,14,17,0.824,89,2015-02-19,OKC,DAL
5264,64,Home,W 104-98 ,240,39,81,0.481,31,62,0.5,8,19,0.421,18,23,0.783,104,34,89,0.382,25,63,0.397,9,26,0.346,21,22,0.955,98,2015-02-22,IND,GSW
5265,65,Home,W 104-87 ,240,39,85,0.459,26,50,0.52,13,35,0.371,13,16,0.813,104,34,80,0.425,29,49,0.592,5,31,0.161,14,18,0.778,87,2015-02-25,ATL,DAL
5266,66,Home,W 104-88 ,240,44,82,0.537,39,67,0.582,5,15,0.333,11,16,0.688,104,31,75,0.413,20,50,0.4,11,25,0.44,15,19,0.789,88,2015-02-25,MIL,PHI
5267,67,@,W 104-82 ,240,39,68,0.574,30,47,0.638,9,21,0.429,17,21,0.81,104,28,84,0.333,20,52,0.385,8,32,0.25,18,29,0.621,82,2015-02-27,UTA,DEN
5268,68,Home,W 104-102 ,240,39,76,0.513,33,60,0.55,6,16,0.375,20,27,0.741,104,41,84,0.488,33,63,0.524,8,21,0.381,12,16,0.75,102,2015-02-27,NOP,MIA
5269,69,@,W 104-94 ,240,40,77,0.519,30,54,0.556,10,23,0.435,14,23,0.609,104,35,82,0.427,26,54,0.481,9,28,0.321,15,18,0.833,94,2015-02-28,BRK,DAL
5270,70,Home,W 104-96 ,240,39,86,0.453,31,57,0.544,8,29,0.276,18,21,0.857,104,39,90,0.433,25,49,0.51,14,41,0.341,4,9,0.444,96,2015-03-03,ATL,HOU
5271,71,Home,W 104-103 ,240,39,79,0.494,34,66,0.515,5,13,0.385,21,31,0.677,104,39,86,0.453,33,69,0.478,6,17,0.353,19,21,0.905,103,2015-03-03,CHA,LAL
5272,72,Home,W 104-89 ,240,38,81,0.469,27,58,0.466,11,23,0.478,17,19,0.895,104,32,87,0.368,26,67,0.388,6,20,0.3,19,26,0.731,89,2015-03-06,GSW,DAL
5273,73,@,W 104-98 ,240,36,79,0.456,26,56,0.464,10,23,0.435,22,25,0.88,104,38,80,0.475,30,59,0.508,8,21,0.381,14,15,0.933,98,2015-03-06,BOS,NOP
5274,74,@,L 104-108 ,240,42,98,0.429,31,71,0.437,11,27,0.407,9,9,1.0,104,42,82,0.512,36,61,0.59,6,21,0.286,18,25,0.72,108,2015-03-08,TOR,OKC
5275,75,Home,W 104-98 ,240,37,81,0.457,31,60,0.517,6,21,0.286,24,38,0.632,104,32,73,0.438,26,56,0.464,6,17,0.353,28,39,0.718,98,2015-03-11,MIA,BRK
5276,76,@,W 104-95 (OT),265,40,87,0.46,30,63,0.476,10,24,0.417,14,20,0.7,104,36,104,0.346,25,63,0.397,11,41,0.268,12,25,0.48,95,2015-03-11,CHI,PHI
5277,77,Home,W 104-100 (OT),265,41,91,0.451,38,77,0.494,3,14,0.214,19,27,0.704,104,36,94,0.383,33,80,0.413,3,14,0.214,25,30,0.833,100,2015-03-17,NYK,SAS
5278,78,@,L 104-108 ,240,41,81,0.506,31,55,0.564,10,26,0.385,12,21,0.571,104,46,87,0.529,39,77,0.506,7,10,0.7,9,14,0.643,108,2015-03-18,POR,MIA
5279,79,@,L 104-111 ,240,38,80,0.475,31,56,0.554,7,24,0.292,21,24,0.875,104,43,94,0.457,38,82,0.463,5,12,0.417,20,24,0.833,111,2015-03-20,POR,ORL
5280,80,Home,L 104-106 (OT),265,38,87,0.437,29,59,0.492,9,28,0.321,19,31,0.613,104,37,78,0.474,25,59,0.424,12,19,0.632,20,25,0.8,106,2015-03-23,UTA,MIN
5281,81,@,L 104-108 ,240,35,75,0.467,28,52,0.538,7,23,0.304,27,29,0.931,104,40,93,0.43,28,64,0.438,12,29,0.414,16,24,0.667,108,2015-03-24,TOR,DET
5282,82,Home,W 104-99 ,240,38,76,0.5,28,59,0.475,10,17,0.588,18,26,0.692,104,40,90,0.444,34,75,0.453,6,15,0.4,13,19,0.684,99,2015-03-29,IND,DAL
5283,83,Home,L 104-116 ,240,40,85,0.471,33,59,0.559,7,26,0.269,17,19,0.895,104,45,89,0.506,36,63,0.571,9,26,0.346,17,23,0.739,116,2015-03-30,CHA,BOS
5284,84,@,W 104-84 ,240,39,82,0.476,29,49,0.592,10,33,0.303,16,18,0.889,104,28,76,0.368,22,60,0.367,6,16,0.375,22,27,0.815,84,2015-03-30,UTA,MIN
5285,85,@,L 104-107 ,240,40,82,0.488,32,57,0.561,8,25,0.32,16,19,0.842,104,45,94,0.479,41,76,0.539,4,18,0.222,13,16,0.813,107,2015-04-08,PHO,DAL
5286,86,@,W 104-99 ,240,36,74,0.486,25,40,0.625,11,34,0.324,21,26,0.808,104,42,84,0.5,36,66,0.545,6,18,0.333,9,13,0.692,99,2015-04-08,CLE,MIL
5287,87,Home,W 104-80 ,240,41,82,0.5,31,54,0.574,10,28,0.357,12,16,0.75,104,30,83,0.361,22,53,0.415,8,30,0.267,12,18,0.667,80,2015-04-10,ATL,CHO
5288,88,@,W 104-103 ,240,41,85,0.482,37,68,0.544,4,17,0.235,18,24,0.75,104,31,66,0.47,22,45,0.489,9,21,0.429,32,53,0.604,103,2015-04-10,SAS,HOU
5289,89,Home,L 104-107 ,240,37,81,0.457,31,61,0.508,6,20,0.3,24,44,0.545,104,35,83,0.422,26,57,0.456,9,26,0.346,28,37,0.757,107,2015-04-11,MIA,TOR
5290,90,@,L 104-116 ,240,41,95,0.432,30,67,0.448,11,28,0.393,11,28,0.393,104,42,79,0.532,32,59,0.542,10,20,0.5,22,35,0.629,116,2015-04-12,OKC,IND
5291,91,Home,W 104-94 ,240,36,73,0.493,24,53,0.453,12,20,0.6,20,21,0.952,104,33,84,0.393,27,60,0.45,6,24,0.25,22,29,0.759,94,2015-10-28,MIA,CHO
5292,92,Home,L 104-111 ,240,41,94,0.436,30,70,0.429,11,24,0.458,11,18,0.611,104,42,80,0.525,36,61,0.59,6,19,0.316,21,31,0.677,111,2015-10-28,SAC,LAC
5293,93,Home,W 104-88 ,240,38,87,0.437,30,56,0.536,8,31,0.258,20,33,0.606,104,35,97,0.361,29,67,0.433,6,30,0.2,12,15,0.8,88,2015-10-29,LAC,DAL
5294,94,Home,W 104-98 ,240,40,90,0.444,33,72,0.458,7,18,0.389,17,21,0.81,104,38,84,0.452,33,71,0.465,5,13,0.385,17,20,0.85,98,2015-11-05,CHI,OKC
5295,95,@,W 104-98 ,240,33,78,0.423,26,55,0.473,7,23,0.304,31,40,0.775,104,40,93,0.43,37,74,0.5,3,19,0.158,15,20,0.75,98,2015-11-06,LAL,BRK
5296,96,@,L 104-119 ,240,39,92,0.424,31,68,0.456,8,24,0.333,18,22,0.818,104,46,93,0.495,29,56,0.518,17,37,0.459,10,18,0.556,119,2015-11-06,DEN,GSW
5297,97,@,L 104-108 ,240,36,91,0.396,26,62,0.419,10,29,0.345,22,27,0.815,104,40,77,0.519,33,58,0.569,7,19,0.368,21,32,0.656,108,2015-11-09,POR,DEN
5298,98,@,W 104-95 ,240,38,78,0.487,30,52,0.577,8,26,0.308,20,27,0.741,104,36,80,0.45,27,61,0.443,9,19,0.474,14,19,0.737,95,2015-11-10,CHA,MIN
5299,99,@,L 104-118 ,240,40,90,0.444,31,64,0.484,9,26,0.346,15,28,0.536,104,44,83,0.53,30,53,0.566,14,30,0.467,16,21,0.762,118,2015-11-12,LAC,PHO
5300,0,Home,W 104-99 ,240,36,84,0.429,29,63,0.46,7,21,0.333,25,31,0.806,104,38,80,0.475,27,47,0.574,11,33,0.333,12,20,0.6,99,2015-11-17,DET,CLE
5301,1,Home,W 104-101 (OT),265,41,110,0.373,32,89,0.36,9,21,0.429,13,21,0.619,104,36,85,0.424,32,67,0.478,4,18,0.222,25,30,0.833,101,2015-11-18,ORL,MIN
5302,2,Home,W 104-90 ,240,40,88,0.455,32,66,0.485,8,22,0.364,16,17,0.941,104,34,84,0.405,25,67,0.373,9,17,0.529,13,16,0.813,90,2015-11-20,NOP,SAS
5303,3,Home,W 104-81 ,240,41,98,0.418,25,67,0.373,16,31,0.516,6,7,0.857,104,32,79,0.405,26,59,0.441,6,20,0.3,11,16,0.688,81,2015-11-25,DET,MIA
5304,4,Home,W 104-92 ,240,37,87,0.425,29,59,0.492,8,28,0.286,22,29,0.759,104,32,92,0.348,21,66,0.318,11,26,0.423,17,20,0.85,92,2015-11-27,IND,CHI
5305,5,Home,L 104-113 ,240,35,81,0.432,26,54,0.481,9,27,0.333,25,33,0.758,104,43,90,0.478,41,80,0.513,2,10,0.2,25,26,0.962,113,2015-12-01,NOP,MEM
5306,6,Home,L 104-108 ,240,37,79,0.468,30,58,0.517,7,21,0.333,23,31,0.742,104,41,96,0.427,33,71,0.465,8,25,0.32,18,20,0.9,108,2015-12-02,WAS,LAL
5307,7,Home,L 104-116 ,240,42,89,0.472,34,62,0.548,8,27,0.296,12,21,0.571,104,38,76,0.5,22,45,0.489,16,31,0.516,24,27,0.889,116,2015-12-06,WAS,DAL
5308,8,Home,W 104-84 ,240,36,84,0.429,28,58,0.483,8,26,0.308,24,35,0.686,104,32,87,0.368,22,53,0.415,10,34,0.294,10,22,0.455,84,2015-12-07,CHA,DET
5309,9,@,W 104-97 ,240,37,82,0.451,24,51,0.471,13,31,0.419,17,20,0.85,104,40,84,0.476,31,59,0.525,9,25,0.36,8,9,0.889,97,2015-12-07,DAL,NYK
5310,10,@,L 104-107 ,240,40,85,0.471,28,60,0.467,12,25,0.48,12,16,0.75,104,41,80,0.513,35,56,0.625,6,24,0.25,19,27,0.704,107,2015-12-09,ORL,PHO
5311,11,Home,W 104-98 (OT),265,35,79,0.443,28,58,0.483,7,21,0.333,27,30,0.9,104,39,94,0.415,31,72,0.431,8,22,0.364,12,20,0.6,98,2015-12-13,OKC,UTA
5312,12,Home,W 104-94 ,240,38,77,0.494,26,45,0.578,12,32,0.375,16,21,0.762,104,33,80,0.413,24,55,0.436,9,25,0.36,19,27,0.704,94,2015-12-14,DAL,PHO
5313,13,@,W 104-98 ,240,40,75,0.533,33,54,0.611,7,21,0.333,17,24,0.708,104,42,89,0.472,38,73,0.521,4,16,0.25,10,14,0.714,98,2015-12-16,MIA,BRK
5314,14,@,W 104-94 ,240,34,73,0.466,24,52,0.462,10,21,0.476,26,28,0.929,104,32,67,0.478,25,47,0.532,7,20,0.35,23,29,0.793,94,2015-12-16,NOP,UTA
5315,15,Home,W 104-100 ,240,41,88,0.466,29,59,0.492,12,29,0.414,10,13,0.769,104,35,74,0.473,29,54,0.537,6,20,0.3,24,28,0.857,100,2015-12-17,CLE,OKC
5316,16,Home,W 104-97 ,240,37,89,0.416,30,61,0.492,7,28,0.25,23,26,0.885,104,36,86,0.419,28,70,0.4,8,16,0.5,17,17,1.0,97,2015-12-18,IND,BRK
5317,17,Home,W 104-88 ,240,44,84,0.524,38,68,0.559,6,16,0.375,10,17,0.588,104,26,71,0.366,22,49,0.449,4,22,0.182,32,38,0.842,88,2015-12-18,PHO,NOP
5318,18,@,W 104-94 ,240,40,76,0.526,31,55,0.564,9,21,0.429,15,24,0.625,104,35,94,0.372,27,65,0.415,8,29,0.276,16,17,0.941,94,2015-12-20,SAC,TOR
5319,19,@,W 104-90 ,240,40,85,0.471,35,70,0.5,5,15,0.333,19,24,0.792,104,31,66,0.47,24,43,0.558,7,23,0.304,21,32,0.656,90,2015-12-22,MEM,PHI
5320,20,Home,W 104-101 ,240,44,84,0.524,37,68,0.544,7,16,0.438,9,13,0.692,104,41,83,0.494,34,54,0.63,7,29,0.241,12,17,0.706,101,2015-12-23,ORL,HOU
5321,21,@,W 104-96 ,240,42,91,0.462,28,56,0.5,14,35,0.4,6,13,0.462,104,36,87,0.414,23,62,0.371,13,25,0.52,11,17,0.647,96,2015-12-23,DEN,PHO
5322,22,Home,L 104-111 ,240,34,88,0.386,24,61,0.393,10,27,0.37,26,34,0.765,104,38,79,0.481,26,52,0.5,12,27,0.444,23,27,0.852,111,2015-12-26,PHO,PHI
5323,23,Home,L 104-109 ,240,36,74,0.486,26,47,0.553,10,27,0.37,22,27,0.815,104,38,79,0.481,25,53,0.472,13,26,0.5,20,24,0.833,109,2015-12-26,UTA,LAC
5324,24,Home,W 104-97 ,240,40,87,0.46,32,66,0.485,8,21,0.381,16,24,0.667,104,38,88,0.432,32,68,0.471,6,20,0.3,15,24,0.625,97,2015-12-28,CHI,TOR
5325,25,Home,W 104-89 ,240,45,82,0.549,38,65,0.585,7,17,0.412,7,11,0.636,104,37,83,0.446,32,63,0.508,5,20,0.25,10,15,0.667,89,2015-12-28,ORL,NOP
5326,26,Home,L 104-112 ,240,38,88,0.432,31,61,0.508,7,27,0.259,21,25,0.84,104,43,94,0.457,34,75,0.453,9,19,0.474,17,23,0.739,112,2015-12-30,BOS,LAL
5327,27,Home,W 104-94 ,240,36,91,0.396,21,58,0.362,15,33,0.455,17,18,0.944,104,34,85,0.4,24,53,0.453,10,32,0.313,16,18,0.889,94,2016-01-01,TOR,CHO
5328,28,Home,W 104-79 ,240,34,82,0.415,22,45,0.489,12,37,0.324,24,39,0.615,104,29,76,0.382,23,51,0.451,6,25,0.24,15,17,0.882,79,2016-01-02,CLE,ORL
5329,29,Home,L 104-116 ,240,39,89,0.438,29,60,0.483,10,29,0.345,16,23,0.696,104,40,89,0.449,33,72,0.458,7,17,0.412,29,39,0.744,116,2016-01-04,OKC,SAC
5330,30,@,L 104-110 ,240,41,91,0.451,34,69,0.493,7,22,0.318,15,23,0.652,104,45,86,0.523,36,69,0.522,9,17,0.529,11,14,0.786,110,2016-01-13,NYK,BRK
5331,31,@,L 104-107 ,240,36,78,0.462,28,61,0.459,8,17,0.471,24,30,0.8,104,37,75,0.493,30,45,0.667,7,30,0.233,26,38,0.684,107,2016-01-13,MIN,HOU
5332,32,Home,W 104-90 ,240,40,94,0.426,29,69,0.42,11,25,0.44,13,16,0.813,104,31,70,0.443,22,46,0.478,9,24,0.375,19,29,0.655,90,2016-01-13,LAC,MIA
5333,33,Home,L 104-116 ,240,38,85,0.447,30,66,0.455,8,19,0.421,20,28,0.714,104,47,93,0.505,32,58,0.552,15,35,0.429,7,11,0.636,116,2016-01-15,BRK,POR
5334,34,Home,L 104-118 ,240,38,80,0.475,35,63,0.556,3,17,0.176,25,32,0.781,104,51,98,0.52,40,73,0.548,11,25,0.44,5,10,0.5,118,2016-01-15,IND,WAS
5335,35,Home,L 104-110 ,240,35,83,0.422,28,63,0.444,7,20,0.35,27,36,0.75,104,41,97,0.423,35,69,0.507,6,28,0.214,22,30,0.733,110,2016-01-19,DEN,OKC
5336,36,@,W 104-98 ,240,39,87,0.448,29,63,0.46,10,24,0.417,16,23,0.696,104,41,94,0.436,32,63,0.508,9,31,0.29,7,11,0.636,98,2016-01-20,ATL,POR
5337,37,Home,W 104-101 ,240,36,78,0.462,28,56,0.5,8,22,0.364,24,29,0.828,104,40,84,0.476,29,55,0.527,11,29,0.379,10,19,0.526,101,2016-01-23,DEN,DET
5338,38,@,L 104-115 ,240,36,79,0.456,21,49,0.429,15,30,0.5,17,22,0.773,104,43,89,0.483,28,45,0.622,15,44,0.341,14,21,0.667,115,2016-01-24,DAL,HOU
5339,39,@,L 104-111 ,240,42,84,0.5,34,64,0.531,8,20,0.4,12,17,0.706,104,39,86,0.453,30,60,0.5,9,26,0.346,24,30,0.8,111,2016-02-01,MIL,SAC
5340,40,@,W 104-97 ,240,35,74,0.473,26,47,0.553,9,27,0.333,25,32,0.781,104,37,79,0.468,25,48,0.521,12,31,0.387,11,15,0.733,97,2016-02-02,TOR,PHO
5341,41,@,W 104-103 ,240,38,88,0.432,31,68,0.456,7,20,0.35,21,25,0.84,104,37,87,0.425,29,57,0.509,8,30,0.267,21,35,0.6,103,2016-02-05,BOS,CLE
5342,42,@,L 104-108 ,240,38,86,0.442,29,61,0.475,9,25,0.36,19,24,0.792,104,38,81,0.469,26,54,0.481,12,27,0.444,20,25,0.8,108,2016-02-06,WAS,CHO
5343,43,@,L 104-112 ,240,38,79,0.481,26,46,0.565,12,33,0.364,16,31,0.516,104,41,76,0.539,35,65,0.538,6,11,0.545,24,29,0.828,112,2016-02-06,DET,IND
5344,44,@,L 104-105 ,240,42,90,0.467,33,65,0.508,9,25,0.36,11,13,0.846,104,42,81,0.519,33,62,0.532,9,19,0.474,12,15,0.8,105,2016-02-08,DEN,BRK
5345,45,Home,L 104-112 ,240,41,93,0.441,35,72,0.486,6,21,0.286,16,22,0.727,104,37,89,0.416,23,49,0.469,14,40,0.35,24,29,0.828,112,2016-02-10,PHO,GSW
5346,46,@,L 104-109 ,240,31,75,0.413,20,49,0.408,11,26,0.423,31,31,1.0,104,40,82,0.488,33,61,0.541,7,21,0.333,22,28,0.786,109,2016-02-19,MIN,MEM
5347,47,@,L 104-110 (OT),265,37,89,0.416,18,48,0.375,19,41,0.463,11,18,0.611,104,41,102,0.402,28,67,0.418,13,35,0.371,15,17,0.882,110,2016-02-19,DAL,ORL
5348,48,@,W 104-96 ,240,40,79,0.506,30,52,0.577,10,27,0.37,14,15,0.933,104,35,81,0.432,30,59,0.508,5,22,0.227,21,24,0.875,96,2016-02-21,CHA,BRK
5349,49,@,L 104-112 ,240,43,90,0.478,40,78,0.513,3,12,0.25,15,19,0.789,104,40,80,0.5,30,57,0.526,10,23,0.435,22,25,0.88,112,2016-02-23,BRK,POR
5350,50,@,L 104-109 ,240,38,90,0.422,29,62,0.468,9,28,0.321,19,26,0.731,104,44,88,0.5,36,65,0.554,8,23,0.348,13,16,0.813,109,2016-02-24,WAS,CHI
5351,51,@,W 104-94 ,240,37,76,0.487,29,57,0.509,8,19,0.421,22,28,0.786,104,35,84,0.417,27,59,0.458,8,25,0.32,16,22,0.727,94,2016-02-27,SAS,HOU
5352,52,@,W 104-85 ,240,37,88,0.42,25,58,0.431,12,30,0.4,18,20,0.9,104,33,88,0.375,27,67,0.403,6,21,0.286,13,18,0.722,85,2016-03-01,POR,NYK
5353,53,Home,W 104-98 ,240,35,79,0.443,30,61,0.492,5,18,0.278,29,33,0.879,104,39,82,0.476,30,56,0.536,9,26,0.346,11,20,0.55,98,2016-03-02,MEM,SAC
5354,54,@,W 104-99 ,240,38,80,0.475,28,60,0.467,10,20,0.5,18,26,0.692,104,34,76,0.447,31,62,0.5,3,14,0.214,28,32,0.875,99,2016-03-02,IND,MIL
5355,55,@,W 104-98 ,240,42,84,0.5,31,55,0.564,11,29,0.379,9,13,0.692,104,32,75,0.427,27,61,0.443,5,14,0.357,29,34,0.853,98,2016-03-02,WAS,MIN
5356,56,Home,W 104-94 ,240,40,80,0.5,34,58,0.586,6,22,0.273,18,21,0.857,104,37,83,0.446,27,57,0.474,10,26,0.385,10,16,0.625,94,2016-03-02,TOR,UTA
5357,57,@,W 104-101 ,240,42,80,0.525,35,55,0.636,7,25,0.28,13,24,0.542,104,45,94,0.479,38,65,0.585,7,29,0.241,4,6,0.667,101,2016-03-03,SAC,DAL
5358,58,@,L 104-105 ,240,42,92,0.457,33,69,0.478,9,23,0.391,11,14,0.786,104,41,90,0.456,37,70,0.529,4,20,0.2,19,25,0.76,105,2016-03-04,NYK,BOS
5359,59,Home,W 104-94 ,240,40,81,0.494,32,58,0.552,8,23,0.348,16,19,0.842,104,37,81,0.457,31,65,0.477,6,16,0.375,14,21,0.667,94,2016-03-05,SAS,SAC
5360,60,@,W 104-96 ,240,32,76,0.421,25,51,0.49,7,25,0.28,33,43,0.767,104,34,90,0.378,31,71,0.437,3,19,0.158,25,30,0.833,96,2016-03-06,OKC,MIL
5361,61,Home,W 104-99 ,240,37,78,0.474,27,55,0.491,10,23,0.435,20,25,0.8,104,42,82,0.512,36,70,0.514,6,12,0.5,9,9,1.0,99,2016-03-08,TOR,BRK
5362,62,Home,L 104-118 ,240,35,86,0.407,23,53,0.434,12,33,0.364,22,32,0.688,104,38,86,0.442,27,53,0.509,11,33,0.333,31,41,0.756,118,2016-03-09,PHI,HOU
5363,63,Home,W 104-96 ,240,38,82,0.463,31,58,0.534,7,24,0.292,21,29,0.724,104,35,82,0.427,28,59,0.475,7,23,0.304,19,27,0.704,96,2016-03-10,TOR,ATL
5364,64,@,L 104-112 (OT),265,37,98,0.378,28,73,0.384,9,25,0.36,21,26,0.808,104,37,84,0.44,31,66,0.47,6,18,0.333,32,38,0.842,112,2016-03-12,MIA,TOR
5365,65,Home,W 104-75 ,240,40,85,0.471,25,55,0.455,15,30,0.5,9,10,0.9,104,33,87,0.379,28,63,0.444,5,24,0.208,4,7,0.571,75,2016-03-13,ATL,IND
5366,66,@,L 104-107 ,240,37,84,0.44,33,68,0.485,4,16,0.25,26,30,0.867,104,40,95,0.421,29,60,0.483,11,35,0.314,16,20,0.8,107,2016-03-14,MIN,PHO
5367,67,Home,L 104-109 ,240,36,82,0.439,29,63,0.46,7,19,0.368,25,30,0.833,104,43,87,0.494,35,63,0.556,8,24,0.333,15,24,0.625,109,2016-03-21,MIN,GSW
5368,68,@,L 104-113 ,240,43,80,0.538,36,64,0.563,7,16,0.438,11,15,0.733,104,40,83,0.482,30,49,0.612,10,34,0.294,23,27,0.852,113,2016-03-23,MIL,CLE
5369,69,Home,W 104-103 ,240,33,76,0.434,27,59,0.458,6,17,0.353,32,40,0.8,104,37,94,0.394,22,57,0.386,15,37,0.405,14,15,0.933,103,2016-03-23,DEN,PHI
5370,70,@,L 104-113 ,240,42,91,0.462,34,71,0.479,8,20,0.4,12,23,0.522,104,45,80,0.563,40,67,0.597,5,13,0.385,18,32,0.563,113,2016-03-23,SAC,MIN
5371,71,Home,W 104-95 ,240,41,89,0.461,33,67,0.493,8,22,0.364,14,19,0.737,104,39,89,0.438,29,51,0.569,10,38,0.263,7,9,0.778,95,2016-03-24,BRK,CLE
5372,72,@,L 104-110 ,240,44,83,0.53,37,65,0.569,7,18,0.389,9,13,0.692,104,44,77,0.571,37,59,0.627,7,18,0.389,15,18,0.833,110,2016-03-25,MEM,SAS
5373,73,Home,W 104-101 ,240,41,87,0.471,32,61,0.525,9,26,0.346,13,20,0.65,104,38,85,0.447,31,52,0.596,7,33,0.212,18,27,0.667,101,2016-03-27,IND,HOU
5374,74,Home,W 104-97 ,240,36,87,0.414,26,53,0.491,10,34,0.294,22,27,0.815,104,34,78,0.436,25,54,0.463,9,24,0.375,20,23,0.87,97,2016-04-06,BOS,NOP
5375,75,Home,L 104-108 ,240,43,90,0.478,39,75,0.52,4,15,0.267,14,19,0.737,104,39,86,0.453,28,59,0.475,11,27,0.407,19,31,0.613,108,2016-04-06,ORL,DET
5376,76,@,L 104-125 ,240,42,98,0.429,34,74,0.459,8,24,0.333,12,16,0.75,104,46,87,0.529,26,40,0.65,20,47,0.426,13,16,0.813,125,2016-04-13,MEM,GSW
5377,77,@,L 104-113 ,240,40,82,0.488,32,58,0.552,8,24,0.333,16,16,1.0,104,39,75,0.52,26,56,0.464,13,19,0.684,22,22,1.0,113,2016-10-25,UTA,POR
5378,78,@,W 104-98 ,240,39,81,0.481,24,50,0.48,15,31,0.484,11,17,0.647,104,32,79,0.405,23,47,0.489,9,32,0.281,25,33,0.758,98,2016-10-29,BOS,CHO
5379,79,@,L 104-111 ,240,37,86,0.43,28,61,0.459,9,25,0.36,21,26,0.808,104,40,76,0.526,34,55,0.618,6,21,0.286,25,39,0.641,111,2016-10-29,MEM,NYK
5380,80,@,W 104-72 ,240,42,85,0.494,37,65,0.569,5,20,0.25,15,23,0.652,104,28,80,0.35,23,62,0.371,5,18,0.278,11,15,0.733,72,2016-10-29,ATL,PHI
5381,81,Home,L 104-127 ,240,37,86,0.43,23,47,0.489,14,39,0.359,16,21,0.762,104,50,89,0.562,40,63,0.635,10,26,0.385,17,23,0.739,127,2016-11-01,POR,GSW
5382,82,Home,L 104-117 ,240,37,84,0.44,29,61,0.475,8,23,0.348,22,27,0.815,104,46,89,0.517,37,68,0.544,9,21,0.429,16,21,0.762,117,2016-11-04,CHI,NYK
5383,83,Home,W 104-98 ,240,38,82,0.463,30,56,0.536,8,26,0.308,20,29,0.69,104,38,82,0.463,30,48,0.625,8,34,0.235,14,18,0.778,98,2016-11-09,CHA,UTA
5384,84,Home,L 104-122 ,240,40,107,0.374,32,74,0.432,8,33,0.242,16,21,0.762,104,40,84,0.476,24,47,0.511,16,37,0.432,26,30,0.867,122,2016-11-12,PHO,BRK
5385,85,Home,W 104-88 ,240,43,92,0.467,38,76,0.5,5,16,0.313,13,16,0.813,104,33,88,0.375,28,61,0.459,5,27,0.185,17,22,0.773,88,2016-11-14,DET,OKC
5386,86,@,L 104-120 ,240,39,79,0.494,31,59,0.525,8,20,0.4,18,29,0.621,104,45,93,0.484,37,76,0.487,8,17,0.471,22,24,0.917,120,2016-11-16,PHO,DEN
5387,87,@,W 104-88 ,240,44,90,0.489,35,62,0.565,9,28,0.321,7,12,0.583,104,31,83,0.373,20,51,0.392,11,32,0.344,15,19,0.789,88,2016-11-18,GSW,BOS
5388,88,Home,W 104-81 ,240,40,83,0.482,29,58,0.5,11,25,0.44,13,14,0.929,104,29,93,0.312,23,74,0.311,6,19,0.316,17,20,0.85,81,2016-11-18,CLE,DET
5389,89,Home,W 104-94 ,240,42,88,0.477,32,61,0.525,10,27,0.37,10,14,0.714,104,34,85,0.4,28,64,0.438,6,21,0.286,20,29,0.69,94,2016-11-20,NYK,ATL
5390,90,Home,L 104-124 ,240,38,84,0.452,27,60,0.45,11,24,0.458,17,18,0.944,104,43,85,0.506,28,53,0.528,15,32,0.469,23,31,0.742,124,2016-11-23,DAL,LAC
5391,91,@,W 104-99 (2OT),290,38,99,0.384,28,70,0.4,10,29,0.345,18,24,0.75,104,35,93,0.376,23,57,0.404,12,36,0.333,17,23,0.739,99,2016-11-23,MEM,PHI
5392,92,@,L 104-119 ,240,36,76,0.474,23,53,0.434,13,23,0.565,19,29,0.655,104,47,100,0.47,35,68,0.515,12,32,0.375,13,17,0.765,119,2016-11-25,NOP,POR
5393,93,Home,L 104-117 ,240,39,80,0.488,30,48,0.625,9,32,0.281,17,21,0.81,104,40,85,0.471,19,35,0.543,21,50,0.42,16,20,0.8,117,2016-11-25,SAC,HOU
5394,94,@,W 104-96 ,240,41,86,0.477,33,62,0.532,8,24,0.333,14,20,0.7,104,38,92,0.413,31,64,0.484,7,28,0.25,13,17,0.765,96,2016-11-27,MIL,ORL
5395,95,@,W 104-85 ,240,36,82,0.439,27,56,0.482,9,26,0.346,23,31,0.742,104,36,89,0.404,29,60,0.483,7,29,0.241,6,13,0.462,85,2016-11-28,CHA,MEM
5396,96,Home,L 104-112 ,240,38,80,0.475,32,50,0.64,6,30,0.2,22,32,0.688,104,40,83,0.482,29,56,0.518,11,27,0.407,21,26,0.808,112,2016-11-28,MIA,BOS
5397,97,Home,L 104-106 ,240,34,77,0.442,30,58,0.517,4,19,0.211,32,39,0.821,104,41,91,0.451,28,59,0.475,13,32,0.406,11,15,0.733,106,2016-11-30,MIN,NYK
5398,98,Home,W 104-84 ,240,37,77,0.481,24,48,0.5,13,29,0.448,17,18,0.944,104,34,90,0.378,25,64,0.391,9,26,0.346,7,13,0.538,84,2016-12-10,UTA,SAC
5399,99,Home,W 104-74 ,240,40,90,0.444,31,67,0.463,9,23,0.391,15,17,0.882,104,27,76,0.355,18,46,0.391,9,30,0.3,11,20,0.55,74,2016-12-20,GSW,UTA
5400,0,@,L 104-116 ,240,36,91,0.396,26,56,0.464,10,35,0.286,22,28,0.786,104,42,91,0.462,34,73,0.466,8,18,0.444,24,31,0.774,116,2016-12-20,BRK,TOR
5401,1,@,W 104-98 ,240,43,81,0.531,35,60,0.583,8,21,0.381,10,15,0.667,104,35,79,0.443,25,52,0.481,10,27,0.37,18,21,0.857,98,2016-12-23,TOR,UTA
5402,2,Home,W 104-90 ,240,37,82,0.451,22,51,0.431,15,31,0.484,15,18,0.833,104,35,83,0.422,27,51,0.529,8,32,0.25,12,17,0.706,90,2016-12-26,MIN,ATL
5403,3,@,L 104-111 ,240,37,75,0.493,24,43,0.558,13,32,0.406,17,22,0.773,104,37,70,0.529,25,45,0.556,12,25,0.48,25,30,0.833,111,2016-12-26,DAL,NOP
5404,4,Home,W 104-92 ,240,38,85,0.447,26,56,0.464,12,29,0.414,16,17,0.941,104,35,93,0.376,28,70,0.4,7,23,0.304,15,16,0.938,92,2016-12-30,NOP,NYK
5405,5,@,L 104-117 ,240,42,97,0.433,32,59,0.542,10,38,0.263,10,11,0.909,104,43,86,0.5,34,64,0.531,9,22,0.409,22,24,0.917,117,2017-01-01,ORL,IND
5406,6,@,L 104-115 ,240,38,82,0.463,27,56,0.482,11,26,0.423,17,21,0.81,104,41,74,0.554,24,43,0.558,17,31,0.548,16,17,0.941,115,2017-01-03,UTA,BOS
5407,7,Home,L 104-105 ,240,42,94,0.447,29,66,0.439,13,28,0.464,7,12,0.583,104,37,78,0.474,28,50,0.56,9,28,0.321,22,31,0.71,105,2017-01-04,NYK,MIL
5408,8,@,W 104-95 ,240,38,90,0.422,27,58,0.466,11,32,0.344,17,25,0.68,104,40,97,0.412,31,55,0.564,9,42,0.214,6,11,0.545,95,2017-01-12,NOP,BRK
5409,9,Home,W 104-89 ,240,44,92,0.478,37,69,0.536,7,23,0.304,9,11,0.818,104,35,89,0.393,32,71,0.451,3,18,0.167,16,21,0.762,89,2017-01-12,NYK,CHI
5410,10,Home,L 104-108 ,240,40,95,0.421,29,63,0.46,11,32,0.344,13,13,1.0,104,40,78,0.513,36,61,0.59,4,17,0.235,24,35,0.686,108,2017-01-15,MEM,CHI
5411,11,Home,L 104-113 ,240,42,89,0.472,37,75,0.493,5,14,0.357,15,22,0.682,104,35,78,0.449,21,41,0.512,14,37,0.378,29,36,0.806,113,2017-01-16,MIL,PHI
5412,12,Home,W 104-101 ,240,36,80,0.45,28,51,0.549,8,29,0.276,24,26,0.923,104,33,83,0.398,25,58,0.431,8,25,0.32,27,34,0.794,101,2017-01-18,WAS,MEM
5413,13,@,W 104-101 ,240,40,84,0.476,35,68,0.515,5,16,0.313,19,25,0.76,104,42,87,0.483,38,65,0.585,4,22,0.182,13,24,0.542,101,2017-01-19,MIN,LAC
5414,14,@,L 104-118 ,240,37,91,0.407,27,60,0.45,10,31,0.323,20,26,0.769,104,44,86,0.512,35,64,0.547,9,22,0.409,21,25,0.84,118,2017-01-19,DEN,SAS
5415,15,Home,L 104-109 ,240,41,82,0.5,31,54,0.574,10,28,0.357,12,17,0.706,104,40,82,0.488,31,61,0.508,9,21,0.429,20,26,0.769,109,2017-01-23,DET,SAC
5416,16,Home,W 104-97 ,240,39,86,0.453,30,54,0.556,9,32,0.281,17,18,0.944,104,35,75,0.467,23,43,0.535,12,32,0.375,15,21,0.714,97,2017-01-30,DAL,CLE
5417,17,Home,W 104-96 ,240,39,82,0.476,28,56,0.5,11,26,0.423,15,23,0.652,104,37,87,0.425,33,61,0.541,4,26,0.154,18,22,0.818,96,2017-01-30,MIA,BRK
5418,18,@,L 104-109 ,240,41,78,0.526,33,47,0.702,8,31,0.258,14,25,0.56,104,36,87,0.414,24,51,0.471,12,36,0.333,25,30,0.833,109,2017-02-01,TOR,BOS
5419,19,Home,W 104-88 ,240,36,78,0.462,25,49,0.51,11,29,0.379,21,27,0.778,104,32,73,0.438,23,50,0.46,9,23,0.391,15,25,0.6,88,2017-02-01,UTA,MIL
5420,20,Home,L 104-108 ,240,40,88,0.455,31,58,0.534,9,30,0.3,15,20,0.75,104,36,76,0.474,19,45,0.422,17,31,0.548,19,23,0.826,108,2017-02-03,POR,DAL
5421,21,Home,L 104-111 ,240,39,86,0.453,27,55,0.491,12,31,0.387,14,28,0.5,104,41,84,0.488,25,44,0.568,16,40,0.4,13,18,0.722,111,2017-02-04,NYK,CLE
5422,22,@,L 104-128 ,240,42,88,0.477,36,63,0.571,6,25,0.24,14,20,0.7,104,44,89,0.494,28,51,0.549,16,38,0.421,24,36,0.667,128,2017-02-07,ORL,HOU
5423,23,Home,L 104-112 ,240,35,86,0.407,27,55,0.491,8,31,0.258,26,30,0.867,104,42,71,0.592,29,41,0.707,13,30,0.433,15,23,0.652,112,2017-02-11,UTA,BOS
5424,24,Home,L 104-109 (OT),265,37,103,0.359,21,61,0.344,16,42,0.381,14,25,0.56,104,32,83,0.386,24,55,0.436,8,28,0.286,37,48,0.771,109,2017-02-13,POR,ATL
5425,25,@,L 104-113 ,240,40,86,0.465,28,62,0.452,12,24,0.5,12,14,0.857,104,39,82,0.476,21,43,0.488,18,39,0.462,17,19,0.895,113,2017-02-15,IND,CLE
5426,26,Home,W 104-103 ,240,38,90,0.422,32,65,0.492,6,25,0.24,22,22,1.0,104,36,77,0.468,22,40,0.55,14,37,0.378,17,20,0.85,103,2017-02-16,CHI,BOS
5427,27,@,L 104-119 ,240,42,100,0.42,34,74,0.459,8,26,0.308,12,17,0.706,104,46,87,0.529,31,49,0.633,15,38,0.395,12,15,0.8,119,2017-02-23,NYK,CLE
5428,28,@,W 104-98 ,240,34,85,0.4,22,50,0.44,12,35,0.343,24,30,0.8,104,35,81,0.432,23,48,0.479,12,33,0.364,16,35,0.457,98,2017-02-26,BOS,DET
5429,29,Home,L 104-109 ,240,41,84,0.488,29,52,0.558,12,32,0.375,10,13,0.769,104,38,85,0.447,22,46,0.478,16,39,0.41,17,24,0.708,109,2017-02-28,LAL,CHO
5430,30,Home,W 104-100 ,240,39,82,0.476,34,55,0.618,5,27,0.185,21,27,0.778,104,38,82,0.463,29,54,0.537,9,28,0.321,15,22,0.682,100,2017-03-03,DAL,MEM
5431,31,Home,W 104-89 ,240,42,86,0.488,35,61,0.574,7,25,0.28,13,16,0.813,104,33,82,0.402,31,60,0.517,2,22,0.091,21,30,0.7,89,2017-03-05,DAL,OKC
5432,32,Home,W 104-93 ,240,37,86,0.43,29,60,0.483,8,26,0.308,22,28,0.786,104,39,84,0.464,32,64,0.5,7,20,0.35,8,12,0.667,93,2017-03-08,MIL,NYK
5433,33,@,L 104-114 ,240,42,86,0.488,35,67,0.522,7,19,0.368,13,16,0.813,104,42,84,0.5,28,55,0.509,14,29,0.483,16,21,0.762,114,2017-03-08,SAC,SAS
5434,34,@,L 103-107 ,240,40,83,0.482,32,64,0.5,8,19,0.421,15,19,0.789,103,40,97,0.412,31,78,0.397,9,19,0.474,18,23,0.783,107,2011-12-26,PHI,POR
5435,35,@,W 103-83 ,240,41,86,0.477,34,69,0.493,7,17,0.412,14,18,0.778,103,33,80,0.413,31,69,0.449,2,11,0.182,15,18,0.833,83,2011-12-28,PHI,PHO
5436,36,@,W 103-101 ,240,46,93,0.495,43,79,0.544,3,14,0.214,8,14,0.571,103,39,83,0.47,28,54,0.519,11,29,0.379,12,20,0.6,101,2011-12-30,MIA,MIN
5437,37,@,W 103-93 ,240,34,76,0.447,28,61,0.459,6,15,0.4,29,36,0.806,103,36,83,0.434,31,63,0.492,5,20,0.25,16,21,0.762,93,2012-01-03,POR,OKC
5438,38,Home,W 103-85 ,240,39,85,0.459,31,66,0.47,8,19,0.421,17,25,0.68,103,34,93,0.366,32,81,0.395,2,12,0.167,15,18,0.833,85,2012-01-04,ORL,WAS
5439,39,Home,W 103-100 ,240,37,91,0.407,33,70,0.471,4,21,0.19,25,30,0.833,103,39,76,0.513,30,57,0.526,9,19,0.474,13,21,0.619,100,2012-01-05,SAC,MIL
5440,40,@,W 103-80 ,240,39,83,0.47,31,55,0.564,8,28,0.286,17,20,0.85,103,29,78,0.372,20,52,0.385,9,26,0.346,13,22,0.591,80,2012-01-07,NYK,DET
5441,41,@,L 103-106 ,240,45,75,0.6,41,61,0.672,4,14,0.286,9,16,0.563,103,44,85,0.518,35,71,0.493,9,14,0.643,9,10,0.9,106,2012-01-10,SAS,MIL
5442,42,Home,W 103-89 ,240,40,89,0.449,32,68,0.471,8,21,0.381,15,19,0.789,103,35,80,0.438,31,60,0.517,4,20,0.2,15,16,0.938,89,2012-01-13,HOU,SAC
5443,43,Home,L 103-110 ,240,41,79,0.519,33,57,0.579,8,22,0.364,13,16,0.813,103,40,80,0.5,25,48,0.521,15,32,0.469,15,19,0.789,110,2012-01-13,PHO,NJN
5444,44,@,W 103-90 ,240,37,86,0.43,31,70,0.443,6,16,0.375,23,27,0.852,103,38,88,0.432,35,74,0.473,3,14,0.214,11,17,0.647,90,2012-01-14,PHI,WAS
5445,45,Home,W 103-91 ,240,35,72,0.486,27,51,0.529,8,21,0.381,25,40,0.625,103,29,81,0.358,21,62,0.339,8,19,0.421,25,31,0.806,91,2012-01-22,LAC,TOR
5446,46,Home,W 103-83 ,240,43,83,0.518,37,67,0.552,6,16,0.375,11,20,0.55,103,32,74,0.432,32,67,0.478,0,7,0.0,19,27,0.704,83,2012-01-23,PHI,WAS
5447,47,Home,W 103-76 ,240,38,90,0.422,33,75,0.44,5,15,0.333,22,30,0.733,103,32,88,0.364,31,80,0.388,1,8,0.125,11,16,0.688,76,2012-01-27,HOU,WAS
5448,48,Home,W 103-82 ,240,36,70,0.514,26,53,0.491,10,17,0.588,21,26,0.808,103,32,83,0.386,31,74,0.419,1,9,0.111,17,20,0.85,82,2012-01-30,MIL,DET
5449,49,Home,L 103-120 ,240,40,77,0.519,31,61,0.508,9,16,0.563,14,17,0.824,103,41,78,0.526,35,63,0.556,6,15,0.4,32,39,0.821,120,2012-02-01,NOP,PHO
5450,50,@,L 103-109 ,240,42,92,0.457,30,69,0.435,12,23,0.522,7,9,0.778,103,33,73,0.452,20,43,0.465,13,30,0.433,30,39,0.769,109,2012-02-01,WAS,ORL
5451,51,@,W 103-96 ,240,41,78,0.526,31,55,0.564,10,23,0.435,11,19,0.579,103,35,74,0.473,28,56,0.5,7,18,0.389,19,22,0.864,96,2012-02-08,HOU,POR
5452,52,@,W 103-89 ,240,42,80,0.525,35,58,0.603,7,22,0.318,12,17,0.706,103,35,87,0.402,28,63,0.444,7,24,0.292,12,15,0.8,89,2012-02-11,SAS,NJN
5453,53,Home,W 103-87 ,240,40,75,0.533,25,50,0.5,15,25,0.6,8,13,0.615,103,36,85,0.424,30,67,0.448,6,18,0.333,9,12,0.75,87,2012-02-15,ORL,PHI
5454,54,Home,W 103-102 ,240,41,82,0.5,35,66,0.53,6,16,0.375,15,19,0.789,103,41,83,0.494,33,66,0.5,8,17,0.471,12,18,0.667,102,2012-02-17,MEM,DEN
5455,55,@,W 103-100 (OT),265,40,92,0.435,28,64,0.438,12,28,0.429,11,21,0.524,103,36,89,0.404,28,63,0.444,8,26,0.308,20,23,0.87,100,2012-02-18,SAS,LAC
5456,56,@,L 103-104 ,240,35,82,0.427,23,56,0.411,12,26,0.462,21,27,0.778,103,37,73,0.507,33,63,0.524,4,10,0.4,26,38,0.684,104,2012-02-18,GSW,MEM
5457,57,Home,W 103-101 (OT),265,37,92,0.402,32,70,0.457,5,22,0.227,24,35,0.686,103,36,99,0.364,30,72,0.417,6,27,0.222,23,24,0.958,101,2012-02-20,DEN,MIN
5458,58,Home,W 103-92 ,240,38,83,0.458,30,64,0.469,8,19,0.421,19,22,0.864,103,32,78,0.41,20,55,0.364,12,23,0.522,16,22,0.727,92,2012-02-20,LAL,POR
5459,59,Home,W 103-95 ,240,38,86,0.442,31,59,0.525,7,27,0.259,20,28,0.714,103,33,82,0.402,27,59,0.458,6,23,0.261,23,31,0.742,95,2012-02-22,LAC,DEN
5460,60,Home,W 103-93 ,240,40,76,0.526,37,69,0.536,3,7,0.429,20,28,0.714,103,35,84,0.417,33,72,0.458,2,12,0.167,21,27,0.778,93,2012-02-22,TOR,DET
5461,61,Home,W 103-96 ,240,37,84,0.44,32,64,0.5,5,20,0.25,24,29,0.828,103,40,85,0.471,35,72,0.486,5,13,0.385,11,22,0.5,96,2012-02-28,SAC,UTA
5462,62,@,L 103-120 ,240,38,82,0.463,29,62,0.468,9,20,0.45,18,27,0.667,103,43,85,0.506,37,65,0.569,6,20,0.3,28,42,0.667,120,2012-02-29,CLE,NYK
5463,63,Home,L 103-105 (OT),265,37,86,0.43,27,66,0.409,10,20,0.5,19,24,0.792,103,40,86,0.465,34,72,0.472,6,14,0.429,19,25,0.76,105,2012-03-04,HOU,LAC
5464,64,Home,W 103-71 ,240,43,89,0.483,37,72,0.514,6,17,0.353,11,15,0.733,103,28,80,0.35,28,72,0.389,0,8,0.0,15,18,0.833,71,2012-03-07,PHI,BOS
5465,65,Home,L 103-104 ,240,39,84,0.464,31,61,0.508,8,23,0.348,17,22,0.773,103,41,89,0.461,31,65,0.477,10,24,0.417,12,14,0.857,104,2012-03-13,OKC,HOU
5466,66,Home,L 103-105 ,240,41,78,0.526,36,57,0.632,5,21,0.238,16,19,0.842,103,40,78,0.513,34,65,0.523,6,13,0.462,19,21,0.905,105,2012-03-14,GSW,BOS
5467,67,@,W 103-90 ,240,36,79,0.456,24,54,0.444,12,25,0.48,19,24,0.792,103,34,78,0.436,29,56,0.518,5,22,0.227,17,25,0.68,90,2012-03-15,OKC,DEN
5468,68,@,L 103-107 ,240,38,73,0.521,30,55,0.545,8,18,0.444,19,24,0.792,103,36,71,0.507,32,62,0.516,4,9,0.444,31,34,0.912,107,2012-03-17,TOR,CHA
5469,69,@,W 103-87 ,240,43,85,0.506,35,67,0.522,8,18,0.444,9,12,0.75,103,33,84,0.393,28,64,0.438,5,20,0.25,16,20,0.8,87,2012-03-18,ATL,CLE
5470,70,@,W 103-99 ,240,43,91,0.473,41,81,0.506,2,10,0.2,15,22,0.682,103,33,73,0.452,31,60,0.517,2,13,0.154,31,40,0.775,99,2012-03-18,UTA,LAL
5471,71,Home,W 103-102 (OT),265,37,93,0.398,29,73,0.397,8,20,0.4,21,24,0.875,103,36,78,0.462,30,59,0.508,6,19,0.316,24,33,0.727,102,2012-03-21,ATL,CLE
5472,72,Home,W 103-93 ,240,39,83,0.47,28,60,0.467,11,23,0.478,14,21,0.667,103,38,79,0.481,34,67,0.507,4,12,0.333,13,19,0.684,93,2012-03-21,ORL,PHO
5473,73,@,W 103-102 ,240,43,91,0.473,40,74,0.541,3,17,0.176,14,17,0.824,103,43,106,0.406,39,91,0.429,4,15,0.267,12,21,0.571,102,2012-03-22,UTA,SAC
5474,74,Home,W 103-96 ,240,40,85,0.471,34,66,0.515,6,19,0.316,17,26,0.654,103,36,82,0.439,28,62,0.452,8,20,0.4,16,19,0.842,96,2012-03-23,LAL,POR
5475,75,Home,W 103-87 ,240,39,74,0.527,33,63,0.524,6,11,0.545,19,23,0.826,103,33,71,0.465,26,49,0.531,7,22,0.318,14,14,1.0,87,2012-03-25,OKC,MIA
5476,76,Home,W 103-85 ,240,45,92,0.489,35,73,0.479,10,19,0.526,3,5,0.6,103,28,70,0.4,19,47,0.404,9,23,0.391,20,28,0.714,85,2012-03-27,PHI,CLE
5477,77,Home,W 103-86 ,240,41,82,0.5,34,63,0.54,7,19,0.368,14,23,0.609,103,30,80,0.375,25,54,0.463,5,26,0.192,21,32,0.656,86,2012-03-28,LAC,PHO
5478,78,Home,L 103-104 ,240,31,88,0.352,28,75,0.373,3,13,0.231,38,52,0.731,103,39,90,0.433,35,74,0.473,4,16,0.25,22,32,0.688,104,2012-03-30,UTA,SAC
5479,79,@,L 103-112 ,240,42,79,0.532,37,65,0.569,5,14,0.357,14,18,0.778,103,38,76,0.5,29,57,0.509,9,19,0.474,27,33,0.818,112,2012-03-31,IND,SAS
5480,80,Home,W 103-98 ,240,35,85,0.412,29,66,0.439,6,19,0.316,27,34,0.794,103,34,77,0.442,28,58,0.483,6,19,0.316,24,31,0.774,98,2012-04-06,IND,OKC
5481,81,@,L 103-128 ,240,36,77,0.468,31,65,0.477,5,12,0.417,26,35,0.743,103,51,84,0.607,42,66,0.636,9,18,0.5,17,21,0.81,128,2012-04-06,NOP,SAS
5482,82,Home,W 103-79 ,240,40,68,0.588,33,53,0.623,7,15,0.467,16,19,0.842,103,29,76,0.382,27,65,0.415,2,11,0.182,19,24,0.792,79,2012-04-08,BOS,PHI
5483,83,Home,W 103-98 ,240,36,71,0.507,29,55,0.527,7,16,0.438,24,31,0.774,103,36,75,0.48,26,55,0.473,10,20,0.5,16,24,0.667,98,2012-04-09,IND,TOR
5484,84,Home,W 103-90 ,240,40,83,0.482,29,64,0.453,11,19,0.579,12,14,0.857,103,37,79,0.468,34,68,0.5,3,11,0.273,13,16,0.813,90,2012-04-10,CLE,CHA
5485,85,@,W 103-91 ,240,40,78,0.513,34,64,0.531,6,14,0.429,17,22,0.773,103,31,87,0.356,27,67,0.403,4,20,0.2,25,29,0.862,91,2012-04-11,UTA,HOU
5486,86,Home,L 103-112 ,240,38,81,0.469,31,63,0.492,7,18,0.389,20,23,0.87,103,44,88,0.5,35,64,0.547,9,24,0.375,15,20,0.75,112,2012-04-12,GSW,DAL
5487,87,Home,W 103-97 ,240,38,75,0.507,31,60,0.517,7,15,0.467,20,29,0.69,103,41,92,0.446,36,75,0.48,5,17,0.294,10,15,0.667,97,2012-04-13,LAL,DEN
5488,88,Home,W 103-65 ,240,39,84,0.464,25,55,0.455,14,29,0.483,11,13,0.846,103,22,79,0.278,18,59,0.305,4,20,0.2,17,21,0.81,65,2012-04-13,NYK,WAS
5489,89,Home,W 103-98 ,240,34,70,0.486,27,57,0.474,7,13,0.538,28,34,0.824,103,40,83,0.482,35,72,0.486,5,11,0.455,13,17,0.765,98,2012-04-14,MEM,UTA
5490,90,@,L 103-104 ,240,40,76,0.526,24,44,0.545,16,32,0.5,7,10,0.7,103,45,95,0.474,37,76,0.487,8,19,0.421,6,9,0.667,104,2012-04-15,POR,SAC
5491,91,@,W 103-87 ,240,43,82,0.524,34,67,0.507,9,15,0.6,8,10,0.8,103,36,79,0.456,31,65,0.477,5,14,0.357,10,16,0.625,87,2012-04-18,PHI,CLE
5492,92,Home,W 103-91 ,240,42,83,0.506,34,61,0.557,8,22,0.364,11,13,0.846,103,29,60,0.483,27,53,0.509,2,7,0.286,31,38,0.816,91,2012-04-18,MEM,NOH
5493,93,@,W 103-92 ,240,40,75,0.533,36,63,0.571,4,12,0.333,19,22,0.864,103,38,93,0.409,33,77,0.429,5,16,0.313,11,18,0.611,92,2012-04-20,OKC,SAC
5494,94,Home,W 103-97 ,240,35,92,0.38,31,77,0.403,4,15,0.267,29,38,0.763,103,38,83,0.458,30,67,0.448,8,16,0.5,13,22,0.591,97,2012-04-23,IND,DET
5495,95,Home,W 103-94 ,240,38,91,0.418,33,77,0.429,5,14,0.357,22,25,0.88,103,40,90,0.444,35,75,0.467,5,15,0.333,9,13,0.692,94,2012-11-05,MEM,UTA
5496,96,Home,W 103-73 ,240,40,77,0.519,30,53,0.566,10,24,0.417,13,16,0.813,103,30,80,0.375,27,59,0.458,3,21,0.143,10,17,0.588,73,2012-11-07,MIA,BRK
5497,97,@,L 103-105 ,240,36,73,0.493,28,51,0.549,8,22,0.364,23,31,0.742,103,40,82,0.488,33,66,0.5,7,16,0.438,18,24,0.75,105,2012-11-07,DET,SAC
5498,98,@,W 103-90 ,240,41,77,0.532,38,64,0.594,3,13,0.231,18,25,0.72,103,32,75,0.427,25,55,0.455,7,20,0.35,19,30,0.633,90,2012-11-08,LAC,POR
5499,99,Home,W 103-90 ,240,36,81,0.444,28,56,0.5,8,25,0.32,23,30,0.767,103,36,90,0.4,29,67,0.433,7,23,0.304,11,14,0.786,90,2012-11-11,LAL,SAC
5500,0,@,W 103-86 ,240,35,72,0.486,21,45,0.467,14,27,0.519,19,22,0.864,103,36,77,0.468,35,66,0.53,1,11,0.091,13,19,0.684,86,2012-11-13,POR,SAC
5501,1,Home,W 103-83 ,240,39,83,0.47,33,67,0.493,6,16,0.375,19,31,0.613,103,30,81,0.37,28,68,0.412,2,13,0.154,21,25,0.84,83,2012-11-16,IND,DAL
5502,2,@,W 103-95 ,240,38,74,0.514,28,51,0.549,10,23,0.435,17,20,0.85,103,36,96,0.375,28,71,0.394,8,25,0.32,15,20,0.75,95,2012-11-17,DAL,CLE
5503,3,Home,W 103-83 ,240,39,72,0.542,35,61,0.574,4,11,0.364,21,26,0.808,103,32,71,0.451,28,54,0.519,4,17,0.235,15,19,0.789,83,2012-11-18,DET,BOS
5504,4,@,L 103-131 ,240,37,86,0.43,20,47,0.426,17,39,0.436,12,14,0.857,103,46,89,0.517,32,64,0.5,14,25,0.56,25,28,0.893,131,2012-11-23,NYK,HOU
5505,5,Home,W 103-95 ,240,42,78,0.538,31,53,0.585,11,25,0.44,8,18,0.444,103,32,78,0.41,29,60,0.483,3,18,0.167,28,37,0.757,95,2012-11-23,POR,MIN
5506,6,@,L 103-105 ,240,40,73,0.548,35,59,0.593,5,14,0.357,18,32,0.563,103,36,78,0.462,28,56,0.5,8,22,0.364,25,34,0.735,105,2012-11-26,DEN,UTA
5507,7,Home,W 103-82 ,240,38,80,0.475,30,62,0.484,8,18,0.444,19,28,0.679,103,29,74,0.392,24,57,0.421,5,17,0.294,19,24,0.792,82,2012-11-28,MEM,TOR
5508,8,@,L 103-122 ,240,40,86,0.465,32,62,0.516,8,24,0.333,15,22,0.682,103,47,87,0.54,30,54,0.556,17,33,0.515,11,17,0.647,122,2012-11-30,DEN,LAL
5509,9,Home,W 103-92 ,240,38,80,0.475,29,60,0.483,9,20,0.45,18,19,0.947,103,34,74,0.459,26,52,0.5,8,22,0.364,16,20,0.8,92,2012-12-01,GSW,IND
5510,10,Home,L 103-113 ,240,36,86,0.419,30,69,0.435,6,17,0.353,25,39,0.641,103,43,86,0.5,35,63,0.556,8,23,0.348,19,20,0.95,113,2012-12-02,LAL,ORL
5511,11,@,W 103-87 ,240,37,80,0.463,24,52,0.462,13,28,0.464,16,22,0.727,103,35,85,0.412,28,66,0.424,7,19,0.368,10,18,0.556,87,2012-12-05,LAL,NOH
5512,12,@,L 103-113 ,240,34,75,0.453,27,56,0.482,7,19,0.368,28,31,0.903,103,41,83,0.494,32,62,0.516,9,21,0.429,22,22,1.0,113,2012-12-14,SAC,OKC
5513,13,Home,W 103-102 ,240,37,85,0.435,24,50,0.48,13,35,0.371,16,23,0.696,103,40,82,0.488,31,58,0.534,9,24,0.375,13,17,0.765,102,2012-12-15,NYK,CLE
5514,14,Home,W 103-88 ,240,38,81,0.469,26,56,0.464,12,25,0.48,15,20,0.75,103,38,81,0.469,32,65,0.492,6,16,0.375,6,8,0.75,88,2012-12-15,SAS,BOS
5515,15,Home,W 103-96 ,240,39,85,0.459,31,55,0.564,8,30,0.267,17,20,0.85,103,32,78,0.41,25,55,0.455,7,23,0.304,25,32,0.781,96,2012-12-16,TOR,HOU
5516,16,Home,W 103-96 ,240,34,78,0.436,28,60,0.467,6,18,0.333,29,34,0.853,103,35,75,0.467,26,48,0.542,9,27,0.333,17,17,1.0,96,2012-12-18,GSW,NOH
5517,17,Home,W 103-92 ,240,36,77,0.468,23,52,0.442,13,25,0.52,18,23,0.783,103,37,86,0.43,33,69,0.478,4,17,0.235,14,19,0.737,92,2012-12-18,MIA,MIN
5518,18,Home,W 103-91 ,240,37,62,0.597,28,45,0.622,9,17,0.529,20,27,0.741,103,36,88,0.409,31,70,0.443,5,18,0.278,14,21,0.667,91,2012-12-19,BOS,CLE
5519,19,@,L 103-125 ,240,40,89,0.449,34,72,0.472,6,17,0.353,17,24,0.708,103,42,75,0.56,31,48,0.646,11,27,0.407,30,36,0.833,125,2012-12-19,PHI,HOU
5520,20,@,W 103-77 ,240,38,71,0.535,27,50,0.54,11,21,0.524,16,29,0.552,103,29,80,0.363,26,63,0.413,3,17,0.176,16,24,0.667,77,2012-12-23,LAC,PHO
5521,21,Home,W 103-97 ,240,38,80,0.475,30,52,0.577,8,28,0.286,19,19,1.0,103,30,71,0.423,25,55,0.455,5,16,0.313,32,38,0.842,97,2012-12-25,MIA,OKC
5522,22,Home,W 103-100 ,240,35,75,0.467,31,60,0.517,4,15,0.267,29,39,0.744,103,38,82,0.463,29,62,0.468,9,20,0.45,15,19,0.789,100,2012-12-29,BRK,CLE
5523,23,Home,W 103-97 ,240,39,75,0.52,31,55,0.564,8,20,0.4,17,22,0.773,103,36,86,0.419,27,60,0.45,9,26,0.346,16,21,0.762,97,2013-01-01,DET,SAC
5524,24,@,W 103-99 ,240,41,86,0.477,33,64,0.516,8,22,0.364,13,20,0.65,103,37,94,0.394,34,72,0.472,3,22,0.136,22,33,0.667,99,2013-01-01,PHI,LAL
5525,25,@,W 103-94 ,240,41,82,0.5,31,60,0.517,10,22,0.455,11,17,0.647,103,32,79,0.405,22,53,0.415,10,26,0.385,20,26,0.769,94,2013-01-01,DAL,WAS
5526,26,@,L 103-108 ,240,38,77,0.494,28,55,0.509,10,22,0.455,17,21,0.81,103,40,87,0.46,32,72,0.444,8,15,0.533,20,26,0.769,108,2013-01-08,ATL,MIN
5527,27,Home,W 103-95 ,240,40,72,0.556,31,53,0.585,9,19,0.474,14,23,0.609,103,36,76,0.474,28,56,0.5,8,20,0.4,15,19,0.789,95,2013-01-11,ATL,UTA
5528,28,Home,W 103-91 ,240,41,79,0.519,32,56,0.571,9,23,0.391,12,16,0.75,103,35,80,0.438,26,47,0.553,9,33,0.273,12,29,0.414,91,2013-01-11,BOS,HOU
5529,29,Home,W 103-97 ,240,41,86,0.477,35,71,0.493,6,15,0.4,15,18,0.833,103,35,92,0.38,20,49,0.408,15,43,0.349,12,19,0.632,97,2013-01-11,GSW,POR
5530,30,@,W 103-87 ,240,39,90,0.433,31,68,0.456,8,22,0.364,17,25,0.68,103,36,91,0.396,35,75,0.467,1,16,0.063,14,19,0.737,87,2013-01-11,DET,MIL
5531,31,@,W 103-76 ,240,36,87,0.414,28,65,0.431,8,22,0.364,23,28,0.821,103,25,72,0.347,22,63,0.349,3,9,0.333,23,30,0.767,76,2013-01-15,IND,CHA
5532,32,Home,W 103-82 ,240,44,76,0.579,35,58,0.603,9,18,0.5,6,10,0.6,103,29,69,0.42,28,60,0.467,1,9,0.111,23,28,0.821,82,2013-01-16,SAS,MEM
5533,33,Home,W 103-88 ,240,36,78,0.462,27,59,0.458,9,19,0.474,22,31,0.71,103,33,83,0.398,29,68,0.426,4,15,0.267,18,25,0.72,88,2013-01-20,DET,BOS
5534,34,@,L 103-108 ,240,38,88,0.432,29,61,0.475,9,27,0.333,18,21,0.857,103,46,84,0.548,40,64,0.625,6,20,0.3,10,17,0.588,108,2013-01-20,LAL,TOR
5535,35,Home,W 103-87 ,240,41,88,0.466,32,68,0.471,9,20,0.45,12,18,0.667,103,27,78,0.346,23,59,0.39,4,19,0.211,29,33,0.879,87,2013-01-25,CHI,GSW
5536,36,@,W 103-100 ,240,40,73,0.548,32,60,0.533,8,13,0.615,15,19,0.789,103,45,83,0.542,41,74,0.554,4,9,0.444,6,9,0.667,100,2013-01-28,MEM,PHI
5537,37,@,L 103-114 ,240,36,81,0.444,28,60,0.467,8,21,0.381,23,28,0.821,103,36,75,0.48,25,50,0.5,11,25,0.44,31,40,0.775,114,2013-02-05,ATL,IND
5538,38,Home,W 103-92 ,240,38,74,0.514,28,50,0.56,10,24,0.417,17,23,0.739,103,38,84,0.452,33,72,0.458,5,12,0.417,11,16,0.688,92,2013-02-06,ATL,MEM
5539,39,@,L 103-118 ,240,40,88,0.455,32,62,0.516,8,26,0.308,15,20,0.75,103,47,79,0.595,35,53,0.66,12,26,0.462,12,16,0.75,118,2013-02-08,POR,HOU
5540,40,Home,L 103-111 ,240,37,84,0.44,28,64,0.438,9,20,0.45,20,26,0.769,103,40,80,0.5,34,63,0.54,6,17,0.353,25,34,0.735,111,2013-02-09,CLE,DEN
5541,41,@,W 103-89 ,240,39,75,0.52,31,59,0.525,8,16,0.5,17,20,0.85,103,37,78,0.474,35,66,0.53,2,12,0.167,13,20,0.65,89,2013-02-11,SAS,CHI
5542,42,@,W 103-90 ,240,37,78,0.474,27,55,0.491,10,23,0.435,19,25,0.76,103,36,72,0.5,29,46,0.63,7,26,0.269,11,16,0.688,90,2013-02-20,MIA,ATL
5543,43,@,W 103-102 ,240,39,91,0.429,25,63,0.397,14,28,0.5,11,14,0.786,103,41,89,0.461,37,77,0.481,4,12,0.333,16,20,0.8,102,2013-02-23,ATL,MIL
5544,44,@,L 103-105 ,240,38,84,0.452,19,38,0.5,19,46,0.413,8,14,0.571,103,41,80,0.513,34,64,0.531,7,16,0.438,16,19,0.842,105,2013-02-23,HOU,WAS
5545,45,@,W 103-99 ,240,34,72,0.472,21,47,0.447,13,25,0.52,22,31,0.71,103,39,87,0.448,31,69,0.449,8,18,0.444,13,19,0.684,99,2013-02-24,LAL,DAL
5546,46,Home,L 103-114 ,240,41,84,0.488,38,70,0.543,3,14,0.214,18,22,0.818,103,40,79,0.506,26,46,0.565,14,33,0.424,20,24,0.833,114,2013-02-25,DET,ATL
5547,47,Home,W 103-92 ,240,34,82,0.415,29,69,0.42,5,13,0.385,30,32,0.938,103,35,78,0.449,33,58,0.569,2,20,0.1,20,25,0.8,92,2013-02-27,CLE,TOR
5548,48,@,L 103-105 ,240,36,83,0.434,29,63,0.46,7,20,0.35,24,34,0.706,103,43,95,0.453,36,74,0.486,7,21,0.333,12,17,0.706,105,2013-03-01,OKC,DEN
5549,49,@,L 103-136 ,240,38,80,0.475,26,53,0.491,12,27,0.444,15,24,0.625,103,46,80,0.575,32,46,0.696,14,34,0.412,30,40,0.75,136,2013-03-03,DAL,HOU
5550,50,@,W 103-92 ,240,45,86,0.523,41,75,0.547,4,11,0.364,9,11,0.818,103,33,72,0.458,27,58,0.466,6,14,0.429,20,26,0.769,92,2013-03-08,MEM,CLE
5551,51,@,W 103-93 ,240,38,78,0.487,25,50,0.5,13,28,0.464,14,19,0.737,103,37,82,0.451,31,67,0.463,6,15,0.4,13,20,0.65,93,2013-03-09,MIL,GSW
5552,52,Home,W 103-90 ,240,42,81,0.519,36,65,0.554,6,16,0.375,13,15,0.867,103,34,80,0.425,27,60,0.45,7,20,0.35,15,18,0.833,90,2013-03-11,UTA,DET
5553,53,Home,L 103-105 ,240,39,72,0.542,29,51,0.569,10,21,0.476,15,24,0.625,103,42,85,0.494,35,65,0.538,7,20,0.35,14,21,0.667,105,2013-03-18,BOS,MIA
5554,54,@,W 103-100 ,240,40,87,0.46,29,61,0.475,11,26,0.423,12,16,0.75,103,39,81,0.481,28,58,0.483,11,23,0.478,11,17,0.647,100,2013-03-22,WAS,LAL
5555,55,Home,W 103-89 ,240,38,68,0.559,30,53,0.566,8,15,0.533,19,26,0.731,103,34,83,0.41,27,61,0.443,7,22,0.318,14,18,0.778,89,2013-03-22,MIA,DET
5556,56,Home,W 103-83 ,240,43,82,0.524,39,71,0.549,4,11,0.364,13,18,0.722,103,32,79,0.405,22,53,0.415,10,26,0.385,9,13,0.692,83,2013-03-24,OKC,POR
5557,57,Home,L 103-117 ,240,42,85,0.494,33,61,0.541,9,24,0.375,10,12,0.833,103,47,96,0.49,39,75,0.52,8,21,0.381,15,21,0.714,117,2013-03-24,SAC,PHI
5558,58,@,L 103-109 ,240,36,91,0.396,30,65,0.462,6,26,0.231,25,36,0.694,103,43,90,0.478,33,67,0.493,10,23,0.435,13,19,0.684,109,2013-03-25,LAL,GSW
5559,59,Home,W 103-80 ,240,29,63,0.46,21,49,0.429,8,14,0.571,37,41,0.902,103,27,84,0.321,22,64,0.344,5,20,0.25,21,29,0.724,80,2013-03-27,OKC,WAS
5560,60,Home,W 103-88 ,240,44,85,0.518,38,70,0.543,6,15,0.4,9,13,0.692,103,34,76,0.447,28,60,0.467,6,16,0.375,14,19,0.737,88,2013-03-27,UTA,PHO
5561,61,@,W 103-78 ,240,40,84,0.476,33,69,0.478,7,15,0.467,16,26,0.615,103,32,83,0.386,28,69,0.406,4,14,0.286,10,14,0.714,78,2013-03-28,IND,DAL
5562,62,@,L 103-113 ,240,34,77,0.442,29,57,0.509,5,20,0.25,30,39,0.769,103,45,93,0.484,38,74,0.514,7,19,0.368,16,22,0.727,113,2013-03-28,LAL,MIL
5563,63,Home,L 103-117 ,240,42,94,0.447,35,74,0.473,7,20,0.35,12,23,0.522,103,44,83,0.53,37,65,0.569,7,18,0.389,22,24,0.917,117,2013-03-28,PHO,SAC
5564,64,Home,W 103-94 ,240,40,79,0.506,36,68,0.529,4,11,0.364,19,21,0.905,103,34,81,0.42,25,54,0.463,9,27,0.333,17,21,0.81,94,2013-03-29,MEM,HOU
5565,65,@,W 103-98 ,240,38,82,0.463,28,52,0.538,10,30,0.333,17,26,0.654,103,39,86,0.453,32,62,0.516,7,24,0.292,13,16,0.813,98,2013-03-30,LAL,SAC
5566,66,@,L 103-111 ,240,39,93,0.419,33,78,0.423,6,15,0.4,19,21,0.905,103,44,98,0.449,35,69,0.507,9,29,0.31,14,22,0.636,111,2013-04-01,ORL,HOU
5567,67,@,L 103-113 (OT),265,39,101,0.386,31,73,0.425,8,28,0.286,17,26,0.654,103,51,109,0.468,43,94,0.457,8,15,0.533,3,8,0.375,113,2013-04-10,MIL,ORL
5568,68,@,W 103-98 ,240,33,75,0.44,16,34,0.471,17,41,0.415,20,23,0.87,103,36,80,0.45,25,57,0.439,11,23,0.478,15,21,0.714,98,2013-04-10,MIA,WAS
5569,69,@,W 103-97 ,240,38,80,0.475,31,59,0.525,7,21,0.333,20,25,0.8,103,34,76,0.447,25,57,0.439,9,19,0.474,20,25,0.8,97,2013-04-15,MEM,DAL
5570,70,Home,W 103-99 ,240,39,81,0.481,31,57,0.544,8,24,0.333,17,23,0.739,103,37,78,0.474,36,65,0.554,1,13,0.077,24,32,0.75,99,2013-04-17,BRK,DET
5571,71,@,L 103-116 ,240,41,83,0.494,33,62,0.532,8,21,0.381,13,23,0.565,103,42,93,0.452,28,64,0.438,14,29,0.483,18,28,0.643,116,2013-10-29,LAC,LAL
5572,72,@,L 103-105 ,240,40,90,0.444,31,68,0.456,9,22,0.409,14,26,0.538,103,38,89,0.427,29,64,0.453,9,25,0.36,20,24,0.833,105,2013-11-03,ATL,LAL
5573,73,Home,W 103-93 ,240,37,70,0.529,26,43,0.605,11,27,0.407,18,27,0.667,103,35,82,0.427,23,52,0.442,12,30,0.4,11,16,0.688,93,2013-11-03,MIA,WAS
5574,74,Home,W 103-96 ,240,35,82,0.427,33,64,0.516,2,18,0.111,31,37,0.838,103,32,80,0.4,18,43,0.419,14,37,0.378,18,22,0.818,96,2013-11-03,OKC,PHO
5575,75,@,L 103-114 ,240,36,80,0.45,28,58,0.483,8,22,0.364,23,28,0.821,103,40,83,0.482,31,63,0.492,9,20,0.45,25,32,0.781,114,2013-11-08,DEN,PHO
5576,76,@,W 103-94 ,240,35,76,0.461,25,49,0.51,10,27,0.37,23,28,0.821,103,33,81,0.407,28,68,0.412,5,13,0.385,23,29,0.793,94,2013-11-11,ATL,CHA
5577,77,@,L 103-109 ,240,42,91,0.462,39,77,0.506,3,14,0.214,16,21,0.762,103,42,82,0.512,31,59,0.525,11,23,0.478,14,15,0.933,109,2013-11-11,DET,POR
5578,78,@,L 103-111 ,240,35,75,0.467,29,59,0.492,6,16,0.375,27,33,0.818,103,39,86,0.453,33,58,0.569,6,28,0.214,27,34,0.794,111,2013-11-13,OKC,LAC
5579,79,@,W 103-87 ,240,31,67,0.463,23,52,0.442,8,15,0.533,33,39,0.846,103,35,82,0.427,29,61,0.475,6,21,0.286,11,17,0.647,87,2013-11-13,TOR,MEM
5580,80,@,L 103-113 ,240,40,86,0.465,35,67,0.522,5,19,0.263,18,23,0.783,103,39,81,0.481,29,58,0.5,10,23,0.435,25,31,0.806,113,2013-11-15,PHI,ATL
5581,81,@,L 103-110 ,240,36,85,0.424,27,62,0.435,9,23,0.391,22,33,0.667,103,40,77,0.519,30,54,0.556,10,23,0.435,20,30,0.667,110,2013-11-16,BRK,LAC
5582,82,@,W 103-96 (OT),265,36,81,0.444,26,60,0.433,10,21,0.476,21,22,0.955,103,37,93,0.398,31,68,0.456,6,25,0.24,16,22,0.727,96,2013-11-16,CLE,WAS
5583,83,@,W 103-96 (OT),265,33,87,0.379,24,57,0.421,9,30,0.3,28,36,0.778,103,37,100,0.37,29,70,0.414,8,30,0.267,14,17,0.824,96,2013-11-20,IND,NYK
5584,84,Home,W 103-93 ,240,38,75,0.507,31,58,0.534,7,17,0.412,20,27,0.741,103,39,78,0.5,32,58,0.552,7,20,0.35,8,12,0.667,93,2013-11-22,DAL,UTA
5585,85,Home,W 103-102 ,240,33,68,0.485,22,43,0.512,11,25,0.44,26,45,0.578,103,37,88,0.42,32,71,0.451,5,17,0.294,23,30,0.767,102,2013-11-23,LAC,SAC
5586,86,Home,W 103-99 ,240,44,99,0.444,37,81,0.457,7,18,0.389,8,10,0.8,103,32,76,0.421,23,53,0.434,9,23,0.391,26,34,0.765,99,2013-11-27,DAL,GSW
5587,87,Home,W 103-86 ,240,38,76,0.5,27,53,0.509,11,23,0.478,16,26,0.615,103,32,86,0.372,28,68,0.412,4,18,0.222,18,27,0.667,86,2013-11-29,BOS,CLE
5588,88,@,W 103-99 ,240,38,77,0.494,28,56,0.5,10,21,0.476,17,23,0.739,103,34,76,0.447,21,41,0.512,13,35,0.371,18,21,0.857,99,2013-12-01,NOP,NYK
5589,89,@,L 103-113 ,240,37,89,0.416,28,60,0.467,9,29,0.31,20,26,0.769,103,49,87,0.563,40,68,0.588,9,19,0.474,6,9,0.667,113,2013-12-01,MIN,OKC
5590,90,@,L 103-109 ,240,40,83,0.482,31,55,0.564,9,28,0.321,14,20,0.7,103,43,79,0.544,33,62,0.532,10,17,0.588,13,16,0.813,109,2013-12-02,HOU,UTA
5591,91,@,L 103-112 ,240,40,77,0.519,32,57,0.561,8,20,0.4,15,18,0.833,103,40,79,0.506,28,50,0.56,12,29,0.414,20,25,0.8,112,2013-12-03,TOR,GSW
5592,92,@,W 103-82 ,240,43,78,0.551,39,60,0.65,4,18,0.222,13,19,0.684,103,24,82,0.293,19,60,0.317,5,22,0.227,29,39,0.744,82,2013-12-07,MIA,MIN
5593,93,@,W 103-92 ,240,35,83,0.422,28,61,0.459,7,22,0.318,26,34,0.765,103,40,88,0.455,37,72,0.514,3,16,0.188,9,14,0.643,92,2013-12-07,DEN,PHI
5594,94,Home,L 103-116 ,240,38,83,0.458,28,60,0.467,10,23,0.435,17,19,0.895,103,45,82,0.549,32,59,0.542,13,23,0.565,13,16,0.813,116,2013-12-10,TOR,SAS
5595,95,@,W 103-93 ,240,38,84,0.452,30,63,0.476,8,21,0.381,19,20,0.95,103,36,85,0.424,29,64,0.453,7,21,0.333,14,24,0.583,93,2013-12-13,UTA,DEN
5596,96,Home,W 103-99 ,240,39,83,0.47,36,73,0.493,3,10,0.3,22,31,0.71,103,36,79,0.456,24,56,0.429,12,23,0.522,15,20,0.75,99,2013-12-13,DET,BRK
5597,97,@,W 103-99 ,240,35,88,0.398,23,54,0.426,12,34,0.353,21,31,0.677,103,35,85,0.412,31,68,0.456,4,17,0.235,25,29,0.862,99,2013-12-20,PHO,DEN
5598,98,@,L 103-122 ,240,43,74,0.581,36,52,0.692,7,22,0.318,10,24,0.417,103,51,83,0.614,41,60,0.683,10,23,0.435,10,14,0.714,122,2013-12-20,SAC,MIA
5599,99,@,W 103-86 ,240,38,83,0.458,29,55,0.527,9,28,0.321,18,19,0.947,103,29,76,0.382,23,50,0.46,6,26,0.231,22,25,0.88,86,2013-12-23,IND,BRK
5600,0,@,W 103-98 ,240,39,86,0.453,29,65,0.446,10,21,0.476,15,19,0.789,103,37,89,0.416,29,64,0.453,8,25,0.32,16,22,0.727,98,2013-12-23,NYK,ORL
5601,1,@,L 103-105 ,240,40,81,0.494,36,63,0.571,4,18,0.222,19,23,0.826,103,40,95,0.421,30,71,0.423,10,24,0.417,15,22,0.682,105,2013-12-25,LAC,GSW
5602,2,@,L 103-108 (OT),265,38,86,0.442,27,54,0.5,11,32,0.344,16,21,0.762,103,41,83,0.494,36,63,0.571,5,20,0.25,21,25,0.84,108,2013-12-27,MIA,SAC
5603,3,@,L 103-105 ,240,40,80,0.5,33,57,0.579,7,23,0.304,16,23,0.696,103,40,88,0.455,31,65,0.477,9,23,0.391,16,20,0.8,105,2013-12-27,LAL,UTA
5604,4,Home,W 103-100 ,240,38,83,0.458,29,58,0.5,9,25,0.36,18,25,0.72,103,37,79,0.468,28,61,0.459,9,18,0.5,17,24,0.708,100,2013-12-28,BOS,CLE
5605,5,Home,L 103-113 ,240,42,92,0.457,36,75,0.48,6,17,0.353,13,19,0.684,103,45,83,0.542,36,68,0.529,9,15,0.6,14,23,0.609,113,2014-01-04,SAC,CHA
5606,6,Home,L 103-104 ,240,34,86,0.395,28,70,0.4,6,16,0.375,29,35,0.829,103,38,92,0.413,27,63,0.429,11,29,0.379,17,23,0.739,104,2014-01-08,MIN,PHO
5607,7,Home,W 103-83 ,240,41,80,0.513,38,66,0.576,3,14,0.214,18,19,0.947,103,26,78,0.333,18,51,0.353,8,27,0.296,23,29,0.793,83,2014-01-10,SAC,ORL
5608,8,Home,W 103-97 ,240,38,81,0.469,32,67,0.478,6,14,0.429,21,26,0.808,103,37,79,0.468,33,68,0.485,4,11,0.364,19,20,0.95,97,2014-01-11,CHI,CHA
5609,9,@,L 103-118 ,240,37,84,0.44,30,58,0.517,7,26,0.269,22,35,0.629,103,44,79,0.557,36,61,0.59,8,18,0.444,22,29,0.759,118,2014-01-13,DEN,UTA
5610,10,@,W 103-100 ,240,37,72,0.514,33,59,0.559,4,13,0.308,25,41,0.61,103,35,77,0.455,27,57,0.474,8,20,0.4,22,29,0.759,100,2014-01-15,HOU,NOP
5611,11,Home,W 103-78 ,240,40,82,0.488,34,62,0.548,6,20,0.3,17,20,0.85,103,34,97,0.351,32,78,0.41,2,19,0.105,8,12,0.667,78,2014-01-18,CHI,PHI
5612,12,@,L 103-117 ,240,36,82,0.439,27,54,0.5,9,28,0.321,22,30,0.733,103,46,91,0.505,38,72,0.528,8,19,0.421,17,26,0.654,117,2014-01-19,DEN,PHO
5613,13,Home,L 103-112 ,240,40,79,0.506,38,65,0.585,2,14,0.143,21,29,0.724,103,40,72,0.556,31,51,0.608,9,21,0.429,23,37,0.622,112,2014-01-20,DET,LAC
5614,14,@,W 103-80 ,240,37,75,0.493,23,37,0.622,14,38,0.368,15,20,0.75,103,24,71,0.338,16,46,0.348,8,25,0.32,24,37,0.649,80,2014-01-20,BRK,NYK
5615,15,@,W 103-101 ,240,37,73,0.507,30,56,0.536,7,17,0.412,22,24,0.917,103,37,85,0.435,31,67,0.463,6,18,0.333,21,28,0.75,101,2014-01-24,NOP,DET
5616,16,@,W 103-91 ,240,40,76,0.526,36,55,0.655,4,21,0.19,19,25,0.76,103,34,90,0.378,30,63,0.476,4,27,0.148,19,27,0.704,91,2014-01-25,OKC,PHI
5617,17,Home,W 103-88 ,240,38,91,0.418,28,66,0.424,10,25,0.4,17,21,0.81,103,28,83,0.337,22,62,0.355,6,21,0.286,26,33,0.788,88,2014-01-26,GSW,POR
5618,18,@,L 103-110 ,240,39,75,0.52,28,52,0.538,11,23,0.478,14,18,0.778,103,43,90,0.478,32,64,0.5,11,26,0.423,13,18,0.722,110,2014-01-26,LAL,NYK
5619,19,Home,L 103-104 ,240,37,77,0.481,26,53,0.491,11,24,0.458,18,22,0.818,103,37,79,0.468,28,57,0.491,9,22,0.409,21,26,0.808,104,2014-01-27,BRK,TOR
5620,20,Home,W 103-87 ,240,39,86,0.453,33,66,0.5,6,20,0.3,19,28,0.679,103,32,77,0.416,24,57,0.421,8,20,0.4,15,25,0.6,87,2014-01-28,DET,ORL
5621,21,@,L 103-110 ,240,45,88,0.511,42,66,0.636,3,22,0.136,10,17,0.588,103,36,73,0.493,30,58,0.517,6,15,0.4,32,42,0.762,110,2014-01-29,WAS,LAC
5622,22,@,L 103-107 ,240,38,75,0.507,31,54,0.574,7,21,0.333,20,23,0.87,103,38,80,0.475,36,61,0.59,2,19,0.105,29,36,0.806,107,2014-01-31,SAC,DAL
5623,23,@,L 103-106 ,240,40,87,0.46,34,67,0.507,6,20,0.3,17,25,0.68,103,35,76,0.461,27,58,0.466,8,18,0.444,28,35,0.8,106,2014-02-01,TOR,POR
5624,24,Home,W 103-89 ,240,46,93,0.495,42,80,0.525,4,13,0.308,7,10,0.7,103,29,73,0.397,22,52,0.423,7,21,0.333,24,29,0.828,89,2014-02-06,BRK,SAS
5625,25,Home,W 103-81 ,240,38,81,0.469,28,63,0.444,10,18,0.556,17,22,0.773,103,31,76,0.408,19,41,0.463,12,35,0.343,7,14,0.5,81,2014-02-07,DAL,UTA
5626,26,Home,W 103-102 ,240,38,80,0.475,33,68,0.485,5,12,0.417,22,26,0.846,103,37,73,0.507,27,51,0.529,10,22,0.455,18,19,0.947,102,2014-02-07,ORL,OKC
5627,27,@,W 103-97 ,240,36,76,0.474,27,49,0.551,9,27,0.333,22,30,0.733,103,35,76,0.461,23,48,0.479,12,28,0.429,15,17,0.882,97,2014-02-11,MIA,PHO
5628,28,Home,L 103-107 ,240,40,83,0.482,30,55,0.545,10,28,0.357,13,22,0.591,103,39,88,0.443,31,60,0.517,8,28,0.286,21,24,0.875,107,2014-02-13,LAL,OKC
5629,29,Home,L 103-113 ,240,35,81,0.432,29,60,0.483,6,21,0.286,27,38,0.711,103,44,88,0.5,35,68,0.515,9,20,0.45,16,21,0.762,113,2014-02-18,LAC,SAS
5630,30,@,W 103-93 ,240,42,74,0.568,35,58,0.603,7,16,0.438,12,15,0.8,103,38,81,0.469,34,66,0.515,4,15,0.267,13,21,0.619,93,2014-02-18,TOR,WAS
5631,31,@,W 103-81 ,240,41,75,0.547,36,54,0.667,5,21,0.238,16,21,0.762,103,28,74,0.378,26,54,0.481,2,20,0.1,23,30,0.767,81,2014-02-20,MIA,OKC
5632,32,Home,L 103-107 ,240,38,84,0.452,24,51,0.471,14,33,0.424,13,16,0.813,103,37,88,0.42,29,64,0.453,8,24,0.333,25,29,0.862,107,2014-02-25,ATL,CHI
5633,33,Home,L 103-129 ,240,36,90,0.4,31,72,0.431,5,18,0.278,26,31,0.839,103,41,72,0.569,30,50,0.6,11,22,0.5,36,42,0.857,129,2014-02-25,SAC,HOU
5634,34,Home,W 103-83 ,240,37,83,0.446,32,69,0.464,5,14,0.357,24,30,0.8,103,30,84,0.357,25,63,0.397,5,21,0.238,18,22,0.818,83,2014-02-26,CHI,GSW
5635,35,@,L 103-108 ,240,38,77,0.494,23,49,0.469,15,28,0.536,12,18,0.667,103,45,92,0.489,41,79,0.519,4,13,0.308,14,21,0.667,108,2014-02-26,LAL,MEM
5636,36,Home,L 103-126 ,240,36,95,0.379,26,70,0.371,10,25,0.4,21,23,0.913,103,44,92,0.478,30,57,0.526,14,35,0.4,24,31,0.774,126,2014-02-28,NYK,GSW
5637,37,Home,L 103-122 ,240,38,84,0.452,33,62,0.532,5,22,0.227,22,32,0.688,103,45,89,0.506,33,63,0.524,12,26,0.462,20,28,0.714,122,2014-03-01,PHI,WAS
5638,38,@,L 103-106 ,240,38,80,0.475,31,53,0.585,7,27,0.259,20,29,0.69,103,40,78,0.513,32,55,0.582,8,23,0.348,18,27,0.667,106,2014-03-04,MIA,HOU
5639,39,Home,W 103-94 ,240,38,74,0.514,23,48,0.479,15,26,0.577,12,13,0.923,103,34,79,0.43,28,64,0.438,6,15,0.4,20,25,0.8,94,2014-03-05,BRK,MEM
5640,40,Home,W 103-98 ,240,37,79,0.468,33,66,0.5,4,13,0.308,25,34,0.735,103,38,83,0.458,31,57,0.544,7,26,0.269,15,21,0.714,98,2014-03-07,DAL,POR
5641,41,Home,W 103-90 ,240,38,88,0.432,27,64,0.422,11,24,0.458,16,22,0.727,103,32,83,0.386,28,62,0.452,4,21,0.19,22,30,0.733,90,2014-03-12,SAS,POR
5642,42,@,W 103-94 ,240,40,82,0.488,30,60,0.5,10,22,0.455,13,18,0.722,103,35,77,0.455,24,48,0.5,11,29,0.379,13,19,0.684,94,2014-03-14,CLE,GSW
5643,43,Home,L 103-111 ,240,41,86,0.477,38,75,0.507,3,11,0.273,18,21,0.857,103,38,78,0.487,24,45,0.533,14,33,0.424,21,27,0.778,111,2014-03-14,NOP,POR
5644,44,@,W 103-77 ,240,38,70,0.543,34,55,0.618,4,15,0.267,23,32,0.719,103,31,83,0.373,25,60,0.417,6,23,0.261,9,19,0.474,77,2014-03-15,MEM,PHI
5645,45,Home,W 103-89 ,240,37,82,0.451,27,55,0.491,10,27,0.37,19,21,0.905,103,35,77,0.455,31,64,0.484,4,13,0.308,15,20,0.75,89,2014-03-18,GSW,ORL
5646,46,@,L 103-116 ,240,38,90,0.422,26,63,0.413,12,27,0.444,15,17,0.882,103,41,81,0.506,27,46,0.587,14,35,0.4,20,25,0.8,116,2014-03-20,WAS,POR
5647,47,@,L 103-112 ,240,42,93,0.452,30,64,0.469,12,29,0.414,7,13,0.538,103,45,83,0.542,34,54,0.63,11,29,0.379,11,17,0.647,112,2014-03-22,DET,LAC
5648,48,Home,W 103-94 ,240,37,80,0.463,31,64,0.484,6,16,0.375,23,29,0.793,103,37,82,0.451,31,63,0.492,6,19,0.316,14,17,0.824,94,2014-03-23,LAL,ORL
5649,49,@,L 103-108 ,240,38,83,0.458,31,64,0.484,7,19,0.368,20,25,0.8,103,43,88,0.489,35,68,0.515,8,20,0.4,14,20,0.7,108,2014-03-26,DEN,SAS
5650,50,Home,L 103-109 ,240,37,79,0.468,27,59,0.458,10,20,0.5,19,27,0.704,103,38,82,0.463,27,56,0.482,11,26,0.423,22,25,0.88,109,2014-03-27,DAL,LAC
5651,51,@,L 103-105 ,240,40,76,0.526,34,58,0.586,6,18,0.333,17,20,0.85,103,40,86,0.465,35,66,0.53,5,20,0.25,20,22,0.909,105,2014-03-28,BOS,TOR
5652,52,Home,W 103-100 ,240,34,70,0.486,27,47,0.574,7,23,0.304,28,35,0.8,103,42,81,0.519,39,71,0.549,3,10,0.3,13,19,0.684,100,2014-03-29,DAL,SAC
5653,53,Home,W 103-95 ,240,36,84,0.429,29,53,0.547,7,31,0.226,24,30,0.8,103,36,77,0.468,25,47,0.532,11,30,0.367,12,20,0.6,95,2014-03-31,ATL,PHI
5654,54,@,W 103-77 ,240,37,80,0.463,29,63,0.46,8,17,0.471,21,25,0.84,103,26,69,0.377,20,55,0.364,6,14,0.429,19,24,0.792,77,2014-03-31,SAS,IND
5655,55,@,L 103-107 ,240,36,87,0.414,27,61,0.443,9,26,0.346,22,30,0.733,103,34,75,0.453,24,50,0.48,10,25,0.4,29,39,0.744,107,2014-04-02,HOU,TOR
5656,56,@,L 103-106 ,240,44,87,0.506,37,69,0.536,7,18,0.389,8,12,0.667,103,41,79,0.519,30,56,0.536,11,23,0.478,13,13,1.0,106,2014-04-11,CHA,BOS
5657,57,@,L 103-106 ,240,35,88,0.398,28,66,0.424,7,22,0.318,26,30,0.867,103,41,82,0.5,35,65,0.538,6,17,0.353,18,27,0.667,106,2014-04-13,MIN,SAC
5658,58,Home,L 103-111 ,240,40,77,0.519,33,59,0.559,7,18,0.389,16,21,0.762,103,41,76,0.539,33,52,0.635,8,24,0.333,21,26,0.808,111,2014-04-16,MIL,ATL
5659,59,Home,W 103-91 ,240,38,81,0.469,30,56,0.536,8,25,0.32,19,28,0.679,103,34,89,0.382,28,68,0.412,6,21,0.286,17,30,0.567,91,2014-10-29,IND,PHI
5660,60,Home,W 103-94 ,240,34,81,0.42,30,71,0.423,4,10,0.4,31,35,0.886,103,34,83,0.41,25,57,0.439,9,26,0.346,17,19,0.895,94,2014-10-31,SAC,POR
5661,61,@,L 103-112 (OT),265,40,93,0.43,36,75,0.48,4,18,0.222,19,25,0.76,103,46,91,0.505,41,81,0.506,5,10,0.5,15,19,0.789,112,2014-11-07,MIN,ORL
5662,62,Home,W 103-84 ,240,35,80,0.438,26,58,0.448,9,22,0.409,24,31,0.774,103,30,83,0.361,27,64,0.422,3,19,0.158,21,32,0.656,84,2014-11-07,TOR,WAS
5663,63,Home,W 103-96 ,240,33,81,0.407,24,59,0.407,9,22,0.409,28,36,0.778,103,40,84,0.476,32,63,0.508,8,21,0.381,8,11,0.727,96,2014-11-08,ATL,NYK
5664,64,@,L 103-107 ,240,38,81,0.469,29,59,0.492,9,22,0.409,18,22,0.818,103,40,83,0.482,37,72,0.514,3,11,0.273,24,33,0.727,107,2014-11-12,DET,WAS
5665,65,@,L 103-114 ,240,35,74,0.473,25,53,0.472,10,21,0.476,23,25,0.92,103,42,75,0.56,31,47,0.66,11,28,0.393,19,23,0.826,114,2014-11-14,MIA,ATL
5666,66,@,W 103-95 ,240,39,91,0.429,32,75,0.427,7,16,0.438,18,19,0.947,103,37,86,0.43,29,57,0.509,8,29,0.276,13,14,0.929,95,2014-11-14,CHA,PHO
5667,67,Home,W 103-88 ,240,38,74,0.514,34,68,0.5,4,6,0.667,23,27,0.852,103,36,84,0.429,31,65,0.477,5,19,0.263,11,16,0.688,88,2014-11-20,SAC,CHI
5668,68,@,W 103-86 ,240,40,85,0.471,35,69,0.507,5,16,0.313,18,19,0.947,103,31,81,0.383,28,67,0.418,3,14,0.214,21,34,0.618,86,2014-11-26,MIL,MIN
5669,69,Home,L 103-117 ,240,33,74,0.446,27,55,0.491,6,19,0.316,31,35,0.886,103,44,87,0.506,29,49,0.592,15,38,0.395,14,16,0.875,117,2014-11-29,MIL,HOU
5670,70,Home,L 103-110 ,240,36,85,0.424,30,64,0.469,6,21,0.286,25,31,0.806,103,40,89,0.449,32,59,0.542,8,30,0.267,22,30,0.733,110,2014-11-29,PHI,DAL
5671,71,Home,L 103-109 ,240,38,89,0.427,26,60,0.433,12,29,0.414,15,25,0.6,103,36,83,0.434,27,57,0.474,9,26,0.346,28,35,0.8,109,2014-12-01,PHI,SAS
5672,72,@,W 103-101 ,240,41,87,0.471,32,61,0.525,9,26,0.346,12,17,0.706,103,36,84,0.429,29,66,0.439,7,18,0.389,22,30,0.733,101,2014-12-01,DEN,UTA
5673,73,Home,L 103-105 ,240,41,81,0.506,34,61,0.557,7,20,0.35,14,19,0.737,103,43,86,0.5,38,64,0.594,5,22,0.227,14,17,0.824,105,2014-12-02,DEN,POR
5674,74,Home,W 103-102 ,240,42,88,0.477,38,70,0.543,4,18,0.222,15,18,0.833,103,37,79,0.468,27,57,0.474,10,22,0.455,18,22,0.818,102,2014-12-05,CHA,NYK
5675,75,@,W 103-91 ,240,35,71,0.493,26,48,0.542,9,23,0.391,24,31,0.774,103,32,84,0.381,24,56,0.429,8,28,0.286,19,30,0.633,91,2014-12-05,OKC,PHI
5676,76,Home,W 103-87 ,240,43,73,0.589,35,60,0.583,8,13,0.615,9,11,0.818,103,39,80,0.488,34,64,0.531,5,16,0.313,4,8,0.5,87,2014-12-07,MEM,MIA
5677,77,@,W 103-99 ,240,36,85,0.424,26,57,0.456,10,28,0.357,21,29,0.724,103,41,79,0.519,36,60,0.6,5,19,0.263,12,14,0.857,99,2014-12-07,POR,NYK
5678,78,@,W 103-97 ,240,43,80,0.538,34,63,0.54,9,17,0.529,8,12,0.667,103,37,77,0.481,20,42,0.476,17,35,0.486,6,9,0.667,97,2014-12-09,MIA,PHO
5679,79,@,W 103-96 ,240,42,88,0.477,35,64,0.547,7,24,0.292,12,14,0.857,103,35,89,0.393,26,62,0.419,9,27,0.333,17,22,0.773,96,2014-12-10,LAC,IND
5680,80,Home,W 103-94 ,240,38,87,0.437,31,61,0.508,7,26,0.269,20,22,0.909,103,31,85,0.365,22,57,0.386,9,28,0.321,23,30,0.767,94,2014-12-11,OKC,CLE
5681,81,Home,L 103-105 ,240,39,83,0.47,29,52,0.558,10,31,0.323,15,19,0.789,103,40,84,0.476,36,69,0.522,4,15,0.267,21,27,0.778,105,2014-12-12,PHO,DET
5682,82,Home,W 103-97 ,240,34,75,0.453,22,52,0.423,12,23,0.522,23,30,0.767,103,38,82,0.463,32,73,0.438,6,9,0.667,15,19,0.789,97,2014-12-18,CHI,NYK
5683,83,Home,L 103-104 ,240,41,85,0.482,31,60,0.517,10,25,0.4,11,15,0.733,103,37,86,0.43,29,65,0.446,8,21,0.381,22,29,0.759,104,2014-12-19,LAL,OKC
5684,84,@,W 103-97 ,240,32,73,0.438,22,47,0.468,10,26,0.385,29,33,0.879,103,37,94,0.394,35,81,0.432,2,13,0.154,21,24,0.875,97,2014-12-19,CHI,MEM
5685,85,Home,L 103-105 ,240,40,75,0.533,31,56,0.554,9,19,0.474,14,19,0.737,103,39,79,0.494,36,65,0.554,3,14,0.214,24,33,0.727,105,2014-12-19,MIA,WAS
5686,86,@,W 103-95 ,240,34,73,0.466,27,57,0.474,7,16,0.438,28,37,0.757,103,37,72,0.514,31,52,0.596,6,20,0.3,15,21,0.714,95,2014-12-27,MEM,MIA
5687,87,@,W 103-80 ,240,41,91,0.451,24,60,0.4,17,31,0.548,4,9,0.444,103,31,82,0.378,26,53,0.491,5,29,0.172,13,17,0.765,80,2014-12-28,DET,CLE
5688,88,Home,L 103-104 ,240,40,86,0.465,31,57,0.544,9,29,0.31,14,23,0.609,103,35,73,0.479,27,55,0.491,8,18,0.444,26,28,0.929,104,2014-12-29,HOU,WAS
5689,89,Home,L 103-111 ,240,39,87,0.448,31,61,0.508,8,26,0.308,17,27,0.63,103,40,76,0.526,26,51,0.51,14,25,0.56,17,26,0.654,111,2014-12-30,DEN,LAL
5690,90,@,W 103-95 ,240,42,88,0.477,38,72,0.528,4,16,0.25,15,22,0.682,103,33,83,0.398,23,52,0.442,10,31,0.323,19,25,0.76,95,2015-01-08,CHA,TOR
5691,91,Home,L 103-106 ,240,38,96,0.396,25,53,0.472,13,43,0.302,14,18,0.778,103,40,82,0.488,30,59,0.508,10,23,0.435,16,24,0.667,106,2015-01-09,DET,ATL
5692,92,@,L 103-107 (OT),265,41,103,0.398,31,69,0.449,10,34,0.294,11,16,0.688,103,34,92,0.37,25,69,0.362,9,23,0.391,30,34,0.882,107,2015-01-09,BOS,IND
5693,93,Home,W 103-92 ,240,36,76,0.474,26,50,0.52,10,26,0.385,21,26,0.808,103,37,92,0.402,34,71,0.479,3,21,0.143,15,20,0.75,92,2015-01-10,POR,ORL
5694,94,Home,W 103-84 ,240,42,86,0.488,36,69,0.522,6,17,0.353,13,17,0.765,103,33,78,0.423,22,46,0.478,11,32,0.344,7,12,0.583,84,2015-01-11,SAC,CLE
5695,95,@,W 103-92 ,240,39,83,0.47,36,66,0.545,3,17,0.176,22,29,0.759,103,36,75,0.48,26,49,0.531,10,26,0.385,10,12,0.833,92,2015-01-14,MEM,BRK
5696,96,Home,L 103-119 ,240,42,85,0.494,37,69,0.536,5,16,0.313,14,16,0.875,103,48,89,0.539,35,64,0.547,13,25,0.52,10,12,0.833,119,2015-01-16,BOS,CHI
5697,97,@,W 103-95 ,240,34,76,0.447,24,51,0.471,10,25,0.4,25,33,0.758,103,36,85,0.424,33,63,0.524,3,22,0.136,20,22,0.909,95,2015-01-19,DAL,MEM
5698,98,@,W 103-100 ,240,37,79,0.468,32,59,0.542,5,20,0.25,24,30,0.8,103,39,84,0.464,34,66,0.515,5,18,0.278,17,24,0.708,100,2015-01-21,BRK,SAC
5699,99,Home,L 103-105 (OT),265,38,100,0.38,31,70,0.443,7,30,0.233,20,26,0.769,103,40,102,0.392,34,73,0.466,6,29,0.207,19,23,0.826,105,2015-01-21,WAS,OKC
5700,0,Home,W 103-93 ,240,40,83,0.482,30,58,0.517,10,25,0.4,13,13,1.0,103,36,87,0.414,26,61,0.426,10,26,0.385,11,18,0.611,93,2015-01-23,ATL,OKC
5701,1,Home,W 103-96 ,240,35,87,0.402,22,56,0.393,13,31,0.419,20,20,1.0,103,40,82,0.488,35,67,0.522,5,15,0.333,11,14,0.786,96,2015-01-24,POR,WAS
5702,2,Home,W 103-94 ,240,36,76,0.474,29,58,0.5,7,18,0.389,24,26,0.923,103,37,78,0.474,33,66,0.5,4,12,0.333,16,25,0.64,94,2015-01-26,MEM,ORL
5703,3,@,W 103-95 ,240,39,93,0.419,30,59,0.508,9,34,0.265,16,17,0.941,103,35,83,0.422,27,59,0.458,8,24,0.333,17,23,0.739,95,2015-01-27,CLE,DET
5704,4,Home,W 103-82 ,240,42,79,0.532,36,61,0.59,6,18,0.333,13,18,0.722,103,34,81,0.42,29,65,0.446,5,16,0.313,9,13,0.692,82,2015-01-29,IND,NYK
5705,5,@,L 103-108 ,240,42,92,0.457,35,64,0.547,7,28,0.25,12,17,0.706,103,36,86,0.419,23,61,0.377,13,25,0.52,23,26,0.885,108,2015-01-30,LAC,NOP
5706,6,Home,W 103-94 ,240,37,74,0.5,29,51,0.569,8,23,0.348,21,25,0.84,103,34,76,0.447,29,62,0.468,5,14,0.357,21,25,0.84,94,2015-01-30,PHI,MIN
5707,7,Home,W 103-102 ,240,36,76,0.474,29,53,0.547,7,23,0.304,24,34,0.706,103,39,85,0.459,33,72,0.458,6,13,0.462,18,26,0.692,102,2015-02-03,POR,UTA
5708,8,@,L 103-110 ,240,42,84,0.5,32,63,0.508,10,21,0.476,9,14,0.643,103,44,84,0.524,30,52,0.577,14,32,0.438,8,14,0.571,110,2015-02-04,ORL,SAS
5709,9,Home,W 103-99 ,240,37,79,0.468,29,58,0.5,8,21,0.381,21,26,0.808,103,40,89,0.449,29,54,0.537,11,35,0.314,8,12,0.667,99,2015-02-06,IND,CLE
5710,10,Home,W 103-97 (OT),265,43,83,0.518,38,68,0.559,5,15,0.333,12,14,0.857,103,39,97,0.402,28,71,0.394,11,26,0.423,8,13,0.615,97,2015-02-06,ORL,LAL
5711,11,@,W 103-102 ,240,37,84,0.44,30,65,0.462,7,19,0.368,22,25,0.88,103,36,77,0.468,28,63,0.444,8,14,0.571,22,28,0.786,102,2015-02-08,IND,CHO
5712,12,Home,W 103-97 ,240,37,89,0.416,30,71,0.423,7,18,0.389,22,25,0.88,103,38,76,0.5,29,51,0.569,9,25,0.36,12,19,0.632,97,2015-02-09,MIL,BRK
5713,13,@,L 103-111 ,240,36,84,0.429,28,62,0.452,8,22,0.364,23,30,0.767,103,39,80,0.488,32,65,0.492,7,15,0.467,26,32,0.813,111,2015-02-11,SAC,MIL
5714,14,Home,L 103-110 ,240,40,93,0.43,33,69,0.478,7,24,0.292,16,20,0.8,103,42,95,0.442,37,77,0.481,5,18,0.278,21,26,0.808,110,2015-02-21,CHA,OKC
5715,15,Home,W 103-98 ,240,39,82,0.476,33,59,0.559,6,23,0.261,19,26,0.731,103,36,78,0.462,23,44,0.523,13,34,0.382,13,17,0.765,98,2015-02-22,ORL,PHI
5716,16,Home,W 103-98 ,240,33,75,0.44,26,56,0.464,7,19,0.368,30,38,0.789,103,34,81,0.42,26,52,0.5,8,29,0.276,22,28,0.786,98,2015-02-28,NYK,TOR
5717,17,@,L 103-105 (OT),265,40,98,0.408,28,58,0.483,12,40,0.3,11,21,0.524,103,34,74,0.459,23,44,0.523,11,30,0.367,26,33,0.788,105,2015-03-01,CLE,HOU
5718,18,Home,L 103-114 ,240,41,78,0.526,33,58,0.569,8,20,0.4,13,19,0.684,103,41,80,0.513,30,53,0.566,11,27,0.407,21,24,0.875,114,2015-03-02,PHI,TOR
5719,19,@,L 103-104 ,240,39,86,0.453,33,69,0.478,6,17,0.353,19,21,0.905,103,39,79,0.494,34,66,0.515,5,13,0.385,21,31,0.677,104,2015-03-03,LAL,CHO
5720,20,Home,W 103-94 ,240,40,85,0.471,35,65,0.538,5,20,0.25,18,20,0.9,103,37,91,0.407,30,69,0.435,7,22,0.318,13,15,0.867,94,2015-03-06,CHA,TOR
5721,21,Home,W 103-93 ,240,38,91,0.418,32,63,0.508,6,28,0.214,21,25,0.84,103,37,102,0.363,31,73,0.425,6,29,0.207,13,17,0.765,93,2015-03-06,HOU,DET
5722,22,Home,W 103-98 ,240,38,87,0.437,31,65,0.477,7,22,0.318,20,30,0.667,103,35,89,0.393,20,55,0.364,15,34,0.441,13,16,0.813,98,2015-03-08,ORL,BOS
5723,23,Home,L 103-114 ,240,37,71,0.521,33,56,0.589,4,15,0.267,25,31,0.806,103,44,75,0.587,35,60,0.583,9,15,0.6,17,21,0.81,114,2015-03-09,MIL,NOP
5724,24,@,L 103-109 (OT),265,35,91,0.385,31,77,0.403,4,14,0.286,29,36,0.806,103,39,79,0.494,30,57,0.526,9,22,0.409,22,28,0.786,109,2015-03-12,MIL,IND
5725,25,@,L 103-114 ,240,39,92,0.424,31,73,0.425,8,19,0.421,17,22,0.773,103,41,82,0.5,33,65,0.508,8,17,0.471,24,37,0.649,114,2015-03-13,GSW,DEN
5726,26,Home,L 103-110 ,240,38,81,0.469,31,61,0.508,7,20,0.35,20,25,0.8,103,38,84,0.452,26,53,0.491,12,31,0.387,22,30,0.733,110,2015-03-16,SAC,ATL
5727,27,Home,W 103-86 ,240,34,82,0.415,24,58,0.414,10,24,0.417,25,28,0.893,103,32,81,0.395,26,62,0.419,6,19,0.316,16,21,0.762,86,2015-03-18,CHI,IND
5728,28,Home,L 103-114 ,240,39,80,0.488,32,66,0.485,7,14,0.5,18,24,0.75,103,38,76,0.5,30,56,0.536,8,20,0.4,30,38,0.789,114,2015-03-18,MIL,SAS
5729,29,@,W 103-82 ,240,41,79,0.519,34,67,0.507,7,12,0.583,14,19,0.737,103,32,76,0.421,28,58,0.483,4,18,0.222,14,17,0.824,82,2015-03-23,MEM,NYK
5730,30,Home,L 103-116 ,240,39,83,0.47,30,62,0.484,9,21,0.429,16,19,0.842,103,45,74,0.608,33,51,0.647,12,23,0.522,14,17,0.824,116,2015-03-25,TOR,CHI
5731,31,@,W 103-101 ,240,38,85,0.447,29,59,0.492,9,26,0.346,18,28,0.643,103,33,75,0.44,28,61,0.459,5,14,0.357,30,38,0.789,101,2015-03-25,IND,WAS
5732,32,Home,W 103-89 ,240,42,83,0.506,38,66,0.576,4,17,0.235,15,18,0.833,103,36,82,0.439,30,68,0.441,6,14,0.429,11,12,0.917,89,2015-03-29,SAS,MEM
5733,33,@,W 103-91 ,240,35,86,0.407,22,57,0.386,13,29,0.448,20,23,0.87,103,39,93,0.419,34,76,0.447,5,17,0.294,8,9,0.889,91,2015-04-01,SAS,ORL
5734,34,Home,W 103-100 ,240,36,83,0.434,27,64,0.422,9,19,0.474,22,30,0.733,103,42,95,0.442,33,73,0.452,9,22,0.409,7,10,0.7,100,2015-04-07,NOP,GSW
5735,35,Home,L 103-113 ,240,45,84,0.536,38,66,0.576,7,18,0.389,6,10,0.6,103,36,80,0.45,28,52,0.538,8,28,0.286,33,34,0.971,113,2015-04-08,DET,BOS
5736,36,@,L 103-105 ,240,34,79,0.43,22,53,0.415,12,26,0.462,23,31,0.742,103,38,82,0.463,30,59,0.508,8,23,0.348,21,24,0.875,105,2015-04-08,CHI,ORL
5737,37,Home,W 103-91 ,240,36,74,0.486,23,43,0.535,13,31,0.419,18,25,0.72,103,33,75,0.44,26,59,0.441,7,16,0.438,18,28,0.643,91,2015-04-08,UTA,SAC
5738,38,Home,L 103-107 ,240,40,89,0.449,29,66,0.439,11,23,0.478,12,23,0.522,103,38,79,0.481,27,60,0.45,11,19,0.579,20,22,0.909,107,2015-04-10,DET,IND
5739,39,Home,L 103-104 ,240,31,66,0.47,22,45,0.489,9,21,0.429,32,53,0.604,103,41,85,0.482,37,68,0.544,4,17,0.235,18,24,0.75,104,2015-04-10,HOU,SAS
5740,40,@,L 103-116 ,240,37,81,0.457,28,57,0.491,9,24,0.375,20,28,0.714,103,44,97,0.454,34,66,0.515,10,31,0.323,18,24,0.75,116,2015-04-10,SAC,OKC
5741,41,@,L 103-110 ,240,38,101,0.376,26,68,0.382,12,33,0.364,15,22,0.682,103,37,82,0.451,30,61,0.492,7,21,0.333,29,37,0.784,110,2015-04-13,DEN,LAC
5742,42,@,L 103-108 ,240,45,79,0.57,42,69,0.609,3,10,0.3,10,13,0.769,103,43,83,0.518,38,73,0.521,5,10,0.5,17,25,0.68,108,2015-04-15,SAS,NOP
5743,43,Home,L 103-112 ,240,37,78,0.474,25,48,0.521,12,30,0.4,17,24,0.708,103,41,82,0.5,34,66,0.515,7,16,0.438,23,29,0.793,112,2015-10-29,IND,MEM
5744,44,Home,L 103-113 ,240,32,85,0.376,25,59,0.424,7,26,0.269,32,41,0.78,103,36,82,0.439,25,56,0.446,11,26,0.423,30,35,0.857,113,2015-10-30,BOS,TOR
5745,45,@,W 103-93 ,240,40,87,0.46,29,57,0.509,11,30,0.367,12,16,0.75,103,31,85,0.365,21,51,0.412,10,34,0.294,21,28,0.75,93,2015-11-01,DAL,LAL
5746,46,@,W 103-96 ,240,38,73,0.521,29,50,0.58,9,23,0.391,18,26,0.692,103,36,79,0.456,30,60,0.5,6,19,0.316,18,22,0.818,96,2015-11-02,MIL,BRK
5747,47,@,W 103-94 ,240,42,90,0.467,35,72,0.486,7,18,0.389,12,12,1.0,103,32,90,0.356,20,54,0.37,12,36,0.333,18,25,0.72,94,2015-11-03,ORL,NOP
5748,48,@,W 103-89 ,240,40,83,0.482,37,63,0.587,3,20,0.15,20,25,0.8,103,29,74,0.392,22,54,0.407,7,20,0.35,24,40,0.6,89,2015-11-03,MEM,SAC
5749,49,@,W 103-98 ,240,33,79,0.418,28,65,0.431,5,14,0.357,32,39,0.821,103,39,82,0.476,31,59,0.525,8,23,0.348,12,14,0.857,98,2015-11-04,TOR,OKC
5750,50,@,W 103-94 ,240,38,92,0.413,30,53,0.566,8,39,0.205,19,22,0.864,103,38,87,0.437,32,68,0.471,6,19,0.316,12,16,0.75,94,2015-11-07,GSW,SAC
5751,51,@,L 103-124 ,240,38,84,0.452,31,68,0.456,7,16,0.438,20,26,0.769,103,49,94,0.521,45,74,0.608,4,20,0.2,22,30,0.733,124,2015-11-08,PHO,OKC
5752,52,Home,L 103-120 ,240,41,76,0.539,32,51,0.627,9,25,0.36,12,18,0.667,103,47,96,0.49,36,66,0.545,11,30,0.367,15,22,0.682,120,2015-11-08,POR,DET
5753,53,Home,W 103-102 ,240,39,79,0.494,31,55,0.564,8,24,0.333,17,24,0.708,103,42,79,0.532,32,57,0.561,10,22,0.455,8,9,0.889,102,2015-11-11,DEN,MIL
5754,54,Home,L 103-119 ,240,40,87,0.46,28,58,0.483,12,29,0.414,11,17,0.647,103,43,89,0.483,38,71,0.535,5,18,0.278,28,31,0.903,119,2015-11-11,PHI,TOR
5755,55,@,L 103-107 ,240,42,83,0.506,35,63,0.556,7,20,0.35,12,13,0.923,103,41,86,0.477,31,61,0.508,10,25,0.4,15,23,0.652,107,2015-11-13,MIN,IND
5756,56,@,W 103-91 ,240,36,97,0.371,32,76,0.421,4,21,0.19,27,35,0.771,103,36,79,0.456,31,55,0.564,5,24,0.208,14,30,0.467,91,2015-11-17,MIN,MIA
5757,57,Home,W 103-97 ,240,38,89,0.427,29,59,0.492,9,30,0.3,18,24,0.75,103,38,86,0.442,33,70,0.471,5,16,0.313,16,18,0.889,97,2015-11-18,ATL,SAC
5758,58,@,L 103-108 (OT),265,35,88,0.398,26,58,0.448,9,30,0.3,24,29,0.828,103,32,92,0.348,18,48,0.375,14,44,0.318,30,35,0.857,108,2015-11-18,POR,HOU
5759,59,@,L 103-110 ,240,43,95,0.453,35,63,0.556,8,32,0.25,9,9,1.0,103,38,85,0.447,31,68,0.456,7,17,0.412,27,40,0.675,110,2015-11-18,NOP,OKC
5760,60,@,W 103-97 ,240,41,83,0.494,32,64,0.5,9,19,0.474,12,14,0.857,103,37,91,0.407,29,64,0.453,8,27,0.296,15,21,0.714,97,2015-11-18,CHI,PHO
5761,61,@,L 103-117 ,240,40,81,0.494,30,59,0.508,10,22,0.455,13,21,0.619,103,43,81,0.531,25,46,0.543,18,35,0.514,13,22,0.591,117,2015-11-23,ORL,CLE
5762,62,Home,W 103-99 ,240,40,79,0.506,29,54,0.537,11,25,0.44,12,22,0.545,103,36,82,0.439,22,53,0.415,14,29,0.483,13,16,0.813,99,2015-11-25,TOR,CLE
5763,63,Home,W 103-87 ,240,37,79,0.468,30,55,0.545,7,24,0.292,22,26,0.846,103,31,90,0.344,22,61,0.361,9,29,0.31,16,20,0.8,87,2015-11-27,OKC,DET
5764,64,Home,L 103-107 ,240,38,99,0.384,27,66,0.409,11,33,0.333,16,22,0.727,103,34,83,0.41,25,56,0.446,9,27,0.333,30,37,0.811,107,2015-11-29,LAL,IND
5765,65,Home,L 103-106 ,240,40,89,0.449,34,70,0.486,6,19,0.316,17,22,0.773,103,40,82,0.488,26,53,0.491,14,29,0.483,12,15,0.8,106,2015-11-30,UTA,GSW
5766,66,Home,W 103-91 ,240,37,79,0.468,23,47,0.489,14,32,0.438,15,23,0.652,103,33,89,0.371,25,55,0.455,8,34,0.235,17,24,0.708,91,2015-12-01,PHI,LAL
5767,67,@,W 103-91 ,240,32,76,0.421,25,56,0.446,7,20,0.35,32,39,0.821,103,30,79,0.38,24,52,0.462,6,27,0.222,25,39,0.641,91,2015-12-02,IND,LAC
5768,68,@,W 103-83 ,240,40,80,0.5,30,62,0.484,10,18,0.556,13,18,0.722,103,30,80,0.375,28,64,0.438,2,16,0.125,21,25,0.84,83,2015-12-03,SAS,MEM
5769,69,@,W 103-94 ,240,40,89,0.449,32,66,0.485,8,23,0.348,15,15,1.0,103,31,72,0.431,17,39,0.436,14,33,0.424,18,24,0.75,94,2015-12-03,ORL,UTA
5770,70,Home,W 103-101 ,240,37,82,0.451,25,51,0.49,12,31,0.387,17,25,0.68,103,40,90,0.444,34,70,0.486,6,20,0.3,15,18,0.833,101,2015-12-05,LAC,ORL
5771,71,Home,L 103-109 ,240,38,83,0.458,33,68,0.485,5,15,0.333,22,26,0.846,103,39,77,0.506,29,57,0.509,10,20,0.5,21,30,0.7,109,2015-12-05,MIN,POR
5772,72,@,W 103-101 ,240,41,92,0.446,34,75,0.453,7,17,0.412,14,17,0.824,103,41,90,0.456,35,69,0.507,6,21,0.286,13,18,0.722,101,2015-12-07,PHO,CHI
5773,73,Home,L 103-114 ,240,41,69,0.594,36,53,0.679,5,16,0.313,16,22,0.727,103,46,92,0.5,37,74,0.5,9,18,0.5,13,17,0.765,114,2015-12-07,MIA,WAS
5774,74,Home,L 103-109 ,240,39,89,0.438,34,64,0.531,5,25,0.2,20,24,0.833,103,40,83,0.482,28,50,0.56,12,33,0.364,17,25,0.68,109,2015-12-09,WAS,HOU
5775,75,@,W 103-78 ,240,36,74,0.486,26,54,0.481,10,20,0.5,21,22,0.955,103,30,80,0.375,25,56,0.446,5,24,0.208,13,16,0.813,78,2015-12-12,SAS,ATL
5776,76,Home,L 103-105 (OT),265,37,89,0.416,31,70,0.443,6,19,0.316,23,31,0.742,103,44,97,0.454,38,78,0.487,6,19,0.316,11,15,0.733,105,2015-12-14,DET,LAC
5777,77,@,L 103-128 ,240,41,91,0.451,36,69,0.522,5,22,0.227,16,18,0.889,103,46,88,0.523,31,56,0.554,15,32,0.469,21,27,0.778,128,2015-12-16,PHO,GSW
5778,78,Home,W 103-90 ,240,36,75,0.48,25,54,0.463,11,21,0.524,20,24,0.833,103,38,88,0.432,33,72,0.458,5,16,0.313,9,11,0.818,90,2015-12-16,LAC,MIL
5779,79,@,W 103-100 ,240,39,78,0.5,28,56,0.5,11,22,0.5,14,20,0.7,103,38,81,0.469,34,69,0.493,4,12,0.333,20,24,0.833,100,2015-12-20,ATL,ORL
5780,80,Home,W 103-99 ,240,35,74,0.473,23,48,0.479,12,26,0.462,21,27,0.778,103,40,92,0.435,29,63,0.46,11,29,0.379,8,11,0.727,99,2015-12-22,TOR,DAL
5781,81,Home,W 103-85 ,240,39,83,0.47,30,60,0.5,9,23,0.391,16,16,1.0,103,33,80,0.413,26,60,0.433,7,20,0.35,12,14,0.857,85,2015-12-23,GSW,UTA
5782,82,Home,W 103-93 ,240,38,84,0.452,28,62,0.452,10,22,0.455,17,26,0.654,103,38,79,0.481,34,65,0.523,4,14,0.286,13,15,0.867,93,2015-12-28,DAL,MIL
5783,83,@,L 103-122 ,240,37,95,0.389,24,64,0.375,13,31,0.419,16,28,0.571,103,43,89,0.483,23,47,0.489,20,42,0.476,16,24,0.667,122,2015-12-28,SAC,GSW
5784,84,@,L 103-110 ,240,37,87,0.425,25,60,0.417,12,27,0.444,17,19,0.895,103,41,87,0.471,29,55,0.527,12,32,0.375,16,20,0.8,110,2015-12-30,DEN,POR
5785,85,Home,W 103-91 ,240,43,92,0.467,35,66,0.53,8,26,0.308,9,10,0.9,103,40,85,0.471,35,65,0.538,5,20,0.25,6,8,0.75,91,2016-01-01,WAS,ORL
5786,86,@,L 103-121 ,240,37,74,0.5,28,52,0.538,9,22,0.409,20,33,0.606,103,45,86,0.523,32,62,0.516,13,24,0.542,18,19,0.947,121,2016-01-02,HOU,SAS
5787,87,@,W 103-94 ,240,41,92,0.446,35,71,0.493,6,21,0.286,15,19,0.789,103,32,85,0.376,26,57,0.456,6,28,0.214,24,27,0.889,94,2016-01-04,BOS,BRK
5788,88,Home,W 103-100 (OT),265,34,90,0.378,29,68,0.426,5,22,0.227,30,39,0.769,103,37,94,0.394,29,66,0.439,8,28,0.286,18,25,0.72,100,2016-01-04,MIA,IND
5789,89,Home,W 103-94 ,240,39,75,0.52,32,52,0.615,7,23,0.304,18,26,0.692,103,38,78,0.487,31,50,0.62,7,28,0.25,11,17,0.647,94,2016-01-07,HOU,UTA
5790,90,@,W 103-95 ,240,36,73,0.493,29,55,0.527,7,18,0.389,24,30,0.8,103,40,92,0.435,34,68,0.5,6,24,0.25,9,13,0.692,95,2016-01-08,MIA,PHO
5791,91,Home,W 103-89 ,240,43,92,0.467,35,65,0.538,8,27,0.296,9,14,0.643,103,38,82,0.463,33,73,0.452,5,9,0.556,8,10,0.8,89,2016-01-09,DET,BRK
5792,92,@,L 103-107 (OT),265,43,90,0.478,34,59,0.576,9,31,0.29,8,10,0.8,103,39,89,0.438,25,51,0.49,14,38,0.368,15,23,0.652,107,2016-01-10,IND,HOU
5793,93,@,L 103-111 ,240,41,91,0.451,34,72,0.472,7,19,0.368,14,16,0.875,103,41,86,0.477,34,63,0.54,7,23,0.304,22,30,0.733,111,2016-01-11,MIA,GSW
5794,94,Home,W 103-94 ,240,40,90,0.444,31,64,0.484,9,26,0.346,14,20,0.7,103,37,91,0.407,32,61,0.525,5,30,0.167,15,20,0.75,94,2016-01-13,BOS,IND
5795,95,Home,W 103-101 ,240,37,76,0.487,28,60,0.467,9,16,0.563,20,25,0.8,103,37,72,0.514,22,40,0.55,15,32,0.469,12,17,0.706,101,2016-01-14,MEM,DET
5796,96,Home,L 103-106 (OT),265,44,97,0.454,35,74,0.473,9,23,0.391,6,8,0.75,103,37,90,0.411,29,66,0.439,8,24,0.333,24,31,0.774,106,2016-01-14,ORL,TOR
5797,97,@,W 103-101 ,240,34,74,0.459,29,63,0.46,5,11,0.455,30,42,0.714,103,35,83,0.422,29,49,0.592,6,34,0.176,25,34,0.735,101,2016-01-14,SAC,UTA
5798,98,@,L 103-117 ,240,35,89,0.393,25,62,0.403,10,27,0.37,23,28,0.821,103,42,96,0.438,28,66,0.424,14,30,0.467,19,29,0.655,117,2016-01-15,PHO,BOS
5799,99,Home,L 103-110 ,240,38,96,0.396,25,57,0.439,13,39,0.333,14,19,0.737,103,36,76,0.474,23,51,0.451,13,25,0.52,25,33,0.758,110,2016-01-16,LAC,SAC
5800,0,Home,W 103-95 ,240,39,82,0.476,34,72,0.472,5,10,0.5,20,26,0.769,103,35,77,0.455,30,57,0.526,5,20,0.25,20,24,0.833,95,2016-01-16,MEM,NYK
5801,1,@,L 103-121 ,240,34,69,0.493,27,52,0.519,7,17,0.412,28,32,0.875,103,47,93,0.505,37,62,0.597,10,31,0.323,17,22,0.773,121,2016-01-23,LAL,POR
5802,2,@,L 103-113 ,240,39,83,0.47,33,64,0.516,6,19,0.316,19,28,0.679,103,39,81,0.481,28,53,0.528,11,28,0.393,24,36,0.667,113,2016-01-26,PHO,PHI
5803,3,@,L 103-111 ,240,36,84,0.429,29,63,0.46,7,21,0.333,24,32,0.75,103,41,96,0.427,32,68,0.471,9,28,0.321,20,24,0.833,111,2016-01-27,DEN,BOS
5804,4,Home,W 103-83 ,240,38,80,0.475,28,52,0.538,10,28,0.357,17,20,0.85,103,29,79,0.367,28,63,0.444,1,16,0.063,24,27,0.889,83,2016-01-28,MEM,MIL
5805,5,Home,W 103-93 ,240,37,85,0.435,29,65,0.446,8,20,0.4,21,29,0.724,103,38,87,0.437,31,69,0.449,7,18,0.389,10,20,0.5,93,2016-01-28,TOR,NYK
5806,6,Home,L 103-107 ,240,38,80,0.475,36,68,0.529,2,12,0.167,25,28,0.893,103,37,74,0.5,30,56,0.536,7,18,0.389,26,32,0.813,107,2016-01-29,MIL,MIA
5807,7,Home,W 103-90 ,240,40,76,0.526,30,51,0.588,10,25,0.4,13,16,0.813,103,35,75,0.467,33,65,0.508,2,10,0.2,18,26,0.692,90,2016-01-29,UTA,MIN
5808,8,@,L 103-117 ,240,40,81,0.494,34,63,0.54,6,18,0.333,17,21,0.81,103,45,82,0.549,36,59,0.61,9,23,0.391,18,21,0.857,117,2016-01-30,SAS,CLE
5809,9,@,L 103-105 ,240,40,84,0.476,31,64,0.484,9,20,0.45,14,23,0.609,103,43,93,0.462,32,66,0.485,11,27,0.407,8,10,0.8,105,2016-01-30,BRK,NOP
5810,10,Home,L 103-110 ,240,38,81,0.469,28,56,0.5,10,25,0.4,17,23,0.739,103,40,85,0.471,28,66,0.424,12,19,0.632,18,25,0.72,110,2016-02-04,POR,TOR
5811,11,Home,L 103-104 ,240,37,87,0.425,29,57,0.509,8,30,0.267,21,35,0.6,103,38,88,0.432,31,68,0.456,7,20,0.35,21,25,0.84,104,2016-02-05,CLE,BOS
5812,12,Home,W 103-98 ,240,38,81,0.469,28,52,0.538,10,29,0.345,17,22,0.773,103,35,76,0.461,30,61,0.492,5,15,0.333,23,26,0.885,98,2016-02-06,PHI,BRK
5813,13,@,W 103-89 ,240,39,70,0.557,28,50,0.56,11,20,0.55,14,17,0.824,103,36,80,0.45,28,52,0.538,8,28,0.286,9,17,0.529,89,2016-02-08,TOR,DET
5814,14,@,W 103-92 ,240,39,83,0.47,33,64,0.516,6,19,0.316,19,24,0.792,103,38,88,0.432,28,61,0.459,10,27,0.37,6,7,0.857,92,2016-02-10,DEN,DET
5815,15,@,L 103-116 ,240,37,77,0.481,26,43,0.605,11,34,0.324,18,34,0.529,103,41,89,0.461,33,61,0.541,8,28,0.286,26,34,0.765,116,2016-02-10,HOU,POR
5816,16,Home,W 103-89 ,240,42,86,0.488,35,68,0.515,7,18,0.389,12,21,0.571,103,31,77,0.403,27,62,0.435,4,15,0.267,23,29,0.793,89,2016-02-18,WAS,UTA
5817,17,@,W 103-95 ,240,42,83,0.506,37,66,0.561,5,17,0.294,14,16,0.875,103,36,84,0.429,31,72,0.431,5,12,0.417,18,25,0.72,95,2016-02-20,NYK,MIN
5818,18,@,L 103-129 ,240,37,77,0.481,25,49,0.51,12,28,0.429,17,27,0.63,103,41,85,0.482,28,51,0.549,13,34,0.382,34,36,0.944,129,2016-02-21,PHI,DAL
5819,19,@,L 103-114 ,240,37,76,0.487,27,47,0.574,10,29,0.345,19,27,0.704,103,45,91,0.495,32,59,0.542,13,32,0.406,11,17,0.647,114,2016-02-24,CHA,CLE
5820,20,Home,L 103-116 ,240,35,86,0.407,26,58,0.448,9,28,0.321,24,30,0.8,103,43,89,0.483,31,56,0.554,12,33,0.364,18,22,0.818,116,2016-02-24,DAL,OKC
5821,21,Home,W 103-88 ,240,37,89,0.416,30,55,0.545,7,34,0.206,22,24,0.917,103,32,88,0.364,27,68,0.397,5,20,0.25,19,22,0.864,88,2016-02-26,ATL,CHI
5822,22,@,W 103-94 ,240,40,94,0.426,33,71,0.465,7,23,0.304,16,17,0.941,103,35,82,0.427,27,57,0.474,8,25,0.32,16,21,0.762,94,2016-02-26,WAS,PHI
5823,23,@,W 103-95 ,240,38,87,0.437,33,66,0.5,5,21,0.238,22,27,0.815,103,39,94,0.415,32,72,0.444,7,22,0.318,10,12,0.833,95,2016-02-27,POR,CHI
5824,24,@,W 103-96 ,240,36,75,0.48,33,55,0.6,3,20,0.15,28,36,0.778,103,40,75,0.533,32,50,0.64,8,25,0.32,8,10,0.8,96,2016-02-29,MEM,DEN
5825,25,Home,W 103-98 ,240,40,98,0.408,31,66,0.47,9,32,0.281,14,21,0.667,103,39,98,0.398,29,63,0.46,10,35,0.286,10,11,0.909,98,2016-03-02,LAC,OKC
5826,26,@,L 103-120 ,240,37,80,0.463,27,57,0.474,10,23,0.435,19,27,0.704,103,42,82,0.512,32,52,0.615,10,30,0.333,26,34,0.765,120,2016-03-05,BOS,CLE
5827,27,@,L 103-123 ,240,35,78,0.449,24,47,0.511,11,31,0.355,22,23,0.957,103,44,84,0.524,32,62,0.516,12,22,0.545,23,28,0.821,123,2016-03-06,POR,DET
5828,28,Home,W 103-98 ,240,36,81,0.444,28,67,0.418,8,14,0.571,23,30,0.767,103,37,85,0.435,26,54,0.481,11,31,0.355,13,22,0.591,98,2016-03-06,MIA,PHI
5829,29,@,L 103-108 ,240,39,80,0.488,35,65,0.538,4,15,0.267,21,24,0.875,103,41,90,0.456,29,60,0.483,12,30,0.4,14,17,0.824,108,2016-03-07,MIN,CHO
5830,30,Home,L 103-106 ,240,36,80,0.45,29,51,0.569,7,29,0.241,24,29,0.828,103,41,86,0.477,35,66,0.53,6,20,0.3,18,22,0.818,106,2016-03-07,CLE,MEM
5831,31,@,L 103-118 ,240,36,76,0.474,27,46,0.587,9,30,0.3,22,27,0.815,103,42,83,0.506,32,58,0.552,10,25,0.4,24,29,0.828,118,2016-03-11,DET,CHO
5832,32,Home,W 103-92 ,240,40,81,0.494,36,68,0.529,4,13,0.308,19,24,0.792,103,35,89,0.393,29,60,0.483,6,29,0.207,16,21,0.762,92,2016-03-12,MIL,NOP
5833,33,Home,W 103-98 ,240,39,84,0.464,34,72,0.472,5,12,0.417,20,28,0.714,103,36,94,0.383,28,63,0.444,8,31,0.258,18,22,0.818,98,2016-03-15,IND,BOS
5834,34,Home,W 103-69 ,240,43,88,0.489,32,63,0.508,11,25,0.44,6,9,0.667,103,28,82,0.341,22,56,0.393,6,26,0.231,7,14,0.5,69,2016-03-17,UTA,PHO
5835,35,Home,L 103-109 ,240,37,82,0.451,26,60,0.433,11,22,0.5,18,22,0.818,103,38,76,0.5,25,48,0.521,13,28,0.464,20,27,0.741,109,2016-03-18,ORL,CLE
5836,36,@,L 103-115 ,240,42,80,0.525,37,66,0.561,5,14,0.357,14,21,0.667,103,46,94,0.489,36,70,0.514,10,24,0.417,13,21,0.619,115,2016-03-19,BRK,DET
5837,37,@,W 103-97 ,240,39,90,0.433,31,70,0.443,8,20,0.4,17,19,0.895,103,30,76,0.395,19,48,0.396,11,28,0.393,26,34,0.765,97,2016-03-21,MEM,PHO
5838,38,@,L 103-104 ,240,37,94,0.394,22,57,0.386,15,37,0.405,14,15,0.933,103,33,76,0.434,27,59,0.458,6,17,0.353,32,40,0.8,104,2016-03-23,PHI,DEN
5839,39,@,L 103-109 ,240,42,96,0.438,33,66,0.5,9,30,0.3,10,11,0.909,103,40,89,0.449,33,62,0.532,7,27,0.259,22,25,0.88,109,2016-03-23,DAL,POR
5840,40,@,W 103-96 (OT),265,39,89,0.438,27,54,0.5,12,35,0.343,13,18,0.722,103,37,92,0.402,28,60,0.467,9,32,0.281,13,29,0.448,96,2016-03-30,GSW,UTA
5841,41,@,W 103-100 ,240,37,77,0.481,26,53,0.491,11,24,0.458,18,22,0.818,103,36,90,0.4,27,65,0.415,9,25,0.36,19,22,0.864,100,2016-03-31,CHI,HOU
5842,42,@,L 103-112 ,240,34,76,0.447,25,50,0.5,9,26,0.346,26,27,0.963,103,45,83,0.542,29,54,0.537,16,29,0.552,6,13,0.462,112,2016-04-03,CHA,CLE
5843,43,Home,W 103-90 ,240,39,95,0.411,28,61,0.459,11,34,0.324,14,19,0.737,103,30,81,0.37,18,50,0.36,12,31,0.387,18,30,0.6,90,2016-04-05,ATL,PHO
5844,44,Home,W 103-81 ,240,40,78,0.513,33,58,0.569,7,20,0.35,16,26,0.615,103,26,83,0.313,20,63,0.317,6,20,0.3,23,25,0.92,81,2016-04-05,LAC,LAL
5845,45,@,L 103-121 ,240,39,92,0.424,32,75,0.427,7,17,0.412,18,24,0.75,103,48,95,0.505,40,67,0.597,8,28,0.286,17,20,0.85,121,2016-04-06,BRK,WAS
5846,46,Home,W 103-93 ,240,30,60,0.5,18,29,0.621,12,31,0.387,31,39,0.795,103,35,87,0.402,28,65,0.431,7,22,0.318,16,22,0.727,93,2016-04-08,DAL,MEM
5847,47,@,W 103-96 ,240,41,93,0.441,28,56,0.5,13,37,0.351,8,15,0.533,103,39,89,0.438,29,63,0.46,10,26,0.385,8,12,0.667,96,2016-04-13,TOR,BRK
5848,48,@,L 103-117 ,240,42,91,0.462,34,64,0.531,8,27,0.296,11,18,0.611,103,47,86,0.547,36,57,0.632,11,29,0.379,12,19,0.632,117,2016-04-13,ORL,CHO
5849,49,@,W 103-97 ,240,39,94,0.415,33,72,0.458,6,22,0.273,19,26,0.731,103,36,84,0.429,29,60,0.483,7,24,0.292,18,25,0.72,97,2016-10-26,OKC,PHI
5850,50,Home,W 103-94 ,240,38,87,0.437,28,54,0.519,10,33,0.303,17,20,0.85,103,37,98,0.378,30,74,0.405,7,24,0.292,13,20,0.65,94,2016-10-28,BRK,IND
5851,51,@,L 103-106 ,240,37,70,0.529,30,48,0.625,7,22,0.318,22,31,0.71,103,39,85,0.459,30,59,0.508,9,26,0.346,19,25,0.76,106,2016-10-29,MIN,SAC
5852,52,@,L 103-112 (OT),265,38,86,0.442,33,61,0.541,5,25,0.2,22,25,0.88,103,39,88,0.443,24,57,0.421,15,31,0.484,19,26,0.731,112,2016-10-30,WAS,MEM
5853,53,@,W 103-101 ,240,42,93,0.452,36,68,0.529,6,25,0.24,13,17,0.765,103,40,81,0.494,31,61,0.508,9,20,0.45,12,16,0.75,101,2016-11-01,ORL,PHI
5854,54,Home,L 103-113 ,240,42,72,0.583,39,62,0.629,3,10,0.3,16,24,0.667,103,43,77,0.558,33,52,0.635,10,25,0.4,17,25,0.68,113,2016-11-02,WAS,TOR
5855,55,Home,W 103-86 ,240,40,84,0.476,33,64,0.516,7,20,0.35,16,22,0.727,103,31,94,0.33,24,69,0.348,7,25,0.28,17,20,0.85,86,2016-11-05,DET,DEN
5856,56,Home,W 103-93 ,240,43,86,0.5,33,58,0.569,10,28,0.357,7,11,0.636,103,35,86,0.407,24,56,0.429,11,30,0.367,12,20,0.6,93,2016-11-16,IND,CLE
5857,57,@,L 103-105 ,240,40,92,0.435,26,52,0.5,14,40,0.35,9,14,0.643,103,40,84,0.476,28,59,0.475,12,25,0.48,13,14,0.929,105,2016-11-16,HOU,OKC
5858,58,@,L 103-107 ,240,38,86,0.442,32,64,0.5,6,22,0.273,21,26,0.808,103,45,96,0.469,36,67,0.537,9,29,0.31,8,8,1.0,107,2016-11-22,POR,NYK
5859,59,Home,L 103-109 ,240,42,91,0.462,30,57,0.526,12,34,0.353,7,9,0.778,103,38,81,0.469,27,57,0.474,11,24,0.458,22,25,0.88,109,2016-11-25,BOS,SAS
5860,60,Home,L 103-112 ,240,36,81,0.444,29,62,0.468,7,19,0.368,24,25,0.96,103,40,79,0.506,36,61,0.59,4,18,0.222,28,34,0.824,112,2016-11-28,MIN,UTA
5861,61,Home,L 103-112 ,240,36,91,0.396,30,72,0.417,6,19,0.316,25,28,0.893,103,46,92,0.5,38,70,0.543,8,22,0.364,12,18,0.667,112,2016-11-28,NYK,OKC
5862,62,Home,W 103-100 ,240,41,88,0.466,31,58,0.534,10,30,0.333,11,15,0.733,103,35,81,0.432,28,60,0.467,7,21,0.333,23,29,0.793,100,2016-12-03,MEM,LAL
5863,63,@,L 103-112 ,240,34,91,0.374,23,50,0.46,11,41,0.268,24,33,0.727,103,40,85,0.471,34,61,0.557,6,24,0.25,26,36,0.722,112,2016-12-03,BRK,MIL
5864,64,Home,L 103-114 ,240,38,89,0.427,27,64,0.422,11,25,0.44,16,27,0.593,103,48,98,0.49,41,73,0.562,7,25,0.28,11,16,0.688,114,2016-12-06,MIA,NYK
5865,65,Home,W 103-95 ,240,43,88,0.489,39,69,0.565,4,19,0.211,13,15,0.867,103,34,80,0.425,23,53,0.434,11,27,0.407,16,20,0.8,95,2016-12-07,ATL,MIA
5866,66,@,L 103-111 ,240,32,69,0.464,18,44,0.409,14,25,0.56,25,26,0.962,103,39,80,0.488,24,48,0.5,15,32,0.469,18,24,0.75,111,2016-12-09,IND,DAL
5867,67,@,W 103-100 ,240,36,84,0.429,26,55,0.473,10,29,0.345,21,25,0.84,103,35,87,0.402,28,59,0.475,7,28,0.25,23,27,0.852,100,2016-12-09,NYK,SAC
5868,68,Home,W 103-86 ,240,37,81,0.457,25,50,0.5,12,31,0.387,17,23,0.739,103,35,86,0.407,31,64,0.484,4,22,0.182,12,15,0.8,86,2016-12-13,CLE,MEM
5869,69,Home,W 103-90 ,240,45,96,0.469,36,64,0.563,9,32,0.281,4,8,0.5,103,38,93,0.409,33,72,0.458,5,21,0.238,9,19,0.474,90,2016-12-15,GSW,NYK
5870,70,Home,W 103-100 ,240,37,65,0.569,29,43,0.674,8,22,0.364,21,27,0.778,103,35,77,0.455,23,49,0.469,12,28,0.429,18,21,0.857,100,2016-12-16,UTA,DAL
5871,71,Home,W 103-91 ,240,37,84,0.44,32,66,0.485,5,18,0.278,24,28,0.857,103,38,96,0.396,31,74,0.419,7,22,0.318,8,10,0.8,91,2016-12-23,CHA,CHI
5872,72,@,L 103-113 ,240,37,88,0.42,28,58,0.483,9,30,0.3,20,29,0.69,103,41,85,0.482,29,54,0.537,12,31,0.387,19,21,0.905,113,2016-12-27,MEM,BOS
5873,73,@,L 103-105 ,240,42,94,0.447,35,69,0.507,7,25,0.28,12,17,0.706,103,42,81,0.519,32,53,0.604,10,28,0.357,11,14,0.786,105,2016-12-28,MIN,DEN
5874,74,Home,L 103-115 ,240,39,83,0.47,31,62,0.5,8,21,0.381,17,24,0.708,103,45,91,0.495,30,60,0.5,15,31,0.484,10,14,0.714,115,2017-01-02,NYK,ORL
5875,75,Home,W 103-95 ,240,36,81,0.444,28,55,0.509,8,26,0.308,23,29,0.793,103,38,92,0.413,31,68,0.456,7,24,0.292,12,21,0.571,95,2017-01-11,OKC,MEM
5876,76,@,W 103-101 ,240,36,83,0.434,19,39,0.487,17,44,0.386,14,19,0.737,103,36,84,0.429,25,54,0.463,11,30,0.367,18,21,0.857,101,2017-01-13,BOS,ATL
5877,77,@,L 103-109 ,240,36,90,0.4,27,51,0.529,9,39,0.231,22,28,0.786,103,42,90,0.467,33,61,0.541,9,29,0.31,16,24,0.667,109,2017-01-17,HOU,MIA
5878,78,@,L 103-118 ,240,37,85,0.435,33,66,0.5,4,19,0.211,25,31,0.806,103,43,85,0.506,24,43,0.558,19,42,0.452,13,19,0.684,118,2017-01-19,PHO,CLE
5879,79,Home,L 103-115 ,240,33,83,0.398,26,56,0.464,7,27,0.259,30,35,0.857,103,40,79,0.506,31,57,0.544,9,22,0.409,26,28,0.929,115,2017-01-22,TOR,PHO
5880,80,Home,L 103-109 ,240,38,86,0.442,31,60,0.517,7,26,0.269,20,25,0.8,103,35,76,0.461,27,54,0.5,8,22,0.364,31,35,0.886,109,2017-01-23,IND,NYK
5881,81,Home,W 103-93 ,240,35,76,0.461,25,50,0.5,10,26,0.385,23,31,0.742,103,35,85,0.412,28,63,0.444,7,22,0.318,16,21,0.762,93,2017-01-24,DEN,UTA
5882,82,Home,L 103-113 ,240,38,92,0.413,31,69,0.449,7,23,0.304,20,21,0.952,103,39,82,0.476,28,54,0.519,11,28,0.393,24,27,0.889,113,2017-01-25,CHA,GSW
5883,83,Home,W 103-95 ,240,39,83,0.47,33,57,0.579,6,26,0.231,19,24,0.792,103,39,92,0.424,32,69,0.464,7,23,0.304,10,12,0.833,95,2017-01-25,DAL,NYK
5884,84,Home,L 103-109 ,240,36,81,0.444,26,54,0.481,10,27,0.37,21,27,0.778,103,42,81,0.519,32,63,0.508,10,18,0.556,15,17,0.882,109,2017-01-26,MIN,IND
5885,85,@,L 103-119 ,240,33,85,0.388,21,57,0.368,12,28,0.429,25,29,0.862,103,48,93,0.516,35,63,0.556,13,30,0.433,10,14,0.714,119,2017-01-27,SAS,NOP
5886,86,@,L 103-116 ,240,46,89,0.517,42,77,0.545,4,12,0.333,7,12,0.583,103,42,80,0.525,28,52,0.538,14,28,0.5,18,23,0.783,116,2017-01-28,DET,MIA
5887,87,Home,L 103-105 ,240,38,85,0.447,28,58,0.483,10,27,0.37,17,22,0.773,103,32,77,0.416,20,48,0.417,12,29,0.414,29,35,0.829,105,2017-02-03,SAC,PHO
5888,88,@,W 103-95 ,240,40,87,0.46,35,68,0.515,5,19,0.263,18,20,0.9,103,32,76,0.421,19,42,0.452,13,34,0.382,18,21,0.857,95,2017-02-05,TOR,BRK
5889,89,Home,L 103-111 ,240,34,84,0.405,21,50,0.42,13,34,0.382,22,29,0.759,103,39,74,0.527,28,52,0.538,11,22,0.5,22,25,0.88,111,2017-02-08,PHI,SAS
5890,90,@,W 103-92 ,240,41,82,0.5,32,63,0.508,9,19,0.474,12,15,0.8,103,39,92,0.424,34,75,0.453,5,17,0.294,9,13,0.692,92,2017-02-10,SAS,DET
5891,91,Home,L 103-112 ,240,38,82,0.463,26,45,0.578,12,37,0.324,15,18,0.833,103,39,77,0.506,30,55,0.545,9,22,0.409,25,27,0.926,112,2017-02-13,BRK,MEM
5892,92,@,L 103-104 ,240,36,77,0.468,22,40,0.55,14,37,0.378,17,20,0.85,103,38,90,0.422,32,65,0.492,6,25,0.24,22,22,1.0,104,2017-02-16,BOS,CHI
5893,93,Home,L 103-112 ,240,34,86,0.395,27,64,0.422,7,22,0.318,28,39,0.718,103,41,81,0.506,32,62,0.516,9,19,0.474,21,27,0.778,112,2017-02-23,ORL,POR
5894,94,Home,W 103-99 ,240,36,78,0.462,23,47,0.489,13,31,0.419,18,23,0.783,103,37,91,0.407,27,58,0.466,10,33,0.303,15,22,0.682,99,2017-03-01,BOS,CLE
5895,95,Home,L 103-122 ,240,42,94,0.447,30,60,0.5,12,34,0.353,7,13,0.538,103,37,87,0.425,17,35,0.486,20,52,0.385,28,33,0.848,122,2017-03-01,LAC,HOU
5896,96,@,L 103-120 ,240,35,89,0.393,25,55,0.455,10,34,0.294,23,28,0.821,103,46,77,0.597,39,58,0.672,7,19,0.368,21,25,0.84,120,2017-03-02,CHA,PHO
5897,97,@,L 102-104 ,240,38,90,0.422,29,64,0.453,9,26,0.346,17,21,0.81,102,37,63,0.587,31,49,0.633,6,14,0.429,24,32,0.75,104,2011-12-29,DAL,OKC
5898,98,@,L 102-111 ,240,35,87,0.402,31,67,0.463,4,20,0.2,28,33,0.848,102,41,79,0.519,33,59,0.559,8,20,0.4,21,23,0.913,111,2011-12-29,DEN,POR
5899,99,Home,W 102-81 ,240,39,73,0.534,31,53,0.585,8,20,0.4,16,25,0.64,102,30,85,0.353,23,67,0.343,7,18,0.389,14,19,0.737,81,2011-12-30,MIL,WAS
5900,0,Home,W 102-99 ,240,35,79,0.443,29,63,0.46,6,16,0.375,26,33,0.788,102,37,77,0.481,33,64,0.516,4,13,0.308,21,29,0.724,99,2011-12-30,UTA,PHI
5901,1,Home,W 102-96 ,240,37,75,0.493,25,48,0.521,12,27,0.444,16,24,0.667,102,32,70,0.457,27,57,0.474,5,13,0.385,27,29,0.931,96,2012-01-01,ORL,TOR
5902,2,Home,W 102-91 ,240,39,87,0.448,31,64,0.484,8,23,0.348,16,21,0.762,102,36,72,0.5,29,55,0.527,7,17,0.412,12,20,0.6,91,2012-01-02,PHO,GSW
5903,3,@,W 102-96 (OT),265,42,95,0.442,35,75,0.467,7,20,0.35,11,16,0.688,102,40,87,0.46,33,69,0.478,7,18,0.389,9,13,0.692,96,2012-01-06,ATL,CHA
5904,4,Home,W 102-77 ,240,37,79,0.468,30,59,0.508,7,20,0.35,21,25,0.84,102,25,77,0.325,23,58,0.397,2,19,0.105,25,35,0.714,77,2012-01-06,PHO,POR
5905,5,Home,W 102-93 ,240,37,78,0.474,26,56,0.464,11,22,0.5,17,17,1.0,102,33,74,0.446,30,69,0.435,3,5,0.6,24,24,1.0,93,2012-01-12,MIL,DET
5906,6,Home,W 102-76 ,240,39,75,0.52,29,53,0.547,10,22,0.455,14,18,0.778,102,29,78,0.372,24,54,0.444,5,24,0.208,13,16,0.813,76,2012-01-13,DAL,MIL
5907,7,Home,W 102-94 ,240,35,85,0.412,26,64,0.406,9,21,0.429,23,30,0.767,102,35,77,0.455,30,65,0.462,5,12,0.417,19,25,0.76,94,2012-01-14,LAC,LAL
5908,8,Home,W 102-91 ,240,40,81,0.494,35,62,0.565,5,19,0.263,17,23,0.739,102,38,91,0.418,33,76,0.434,5,15,0.333,10,14,0.714,91,2012-01-15,SAS,PHO
5909,9,@,W 102-94 ,240,39,80,0.488,35,65,0.538,4,15,0.267,20,29,0.69,102,38,86,0.442,34,69,0.493,4,17,0.235,14,26,0.538,94,2012-01-16,CLE,CHA
5910,10,Home,W 102-86 ,240,47,87,0.54,44,77,0.571,3,10,0.3,5,9,0.556,102,33,78,0.423,32,66,0.485,1,12,0.083,19,25,0.76,86,2012-01-16,MEM,CHI
5911,11,@,W 102-93 ,240,36,71,0.507,19,36,0.528,17,35,0.486,13,22,0.591,102,30,73,0.411,25,53,0.472,5,20,0.25,28,33,0.848,93,2012-01-16,ORL,NYK
5912,12,@,L 102-105 ,240,37,77,0.481,33,58,0.569,4,19,0.211,24,30,0.8,102,33,86,0.384,25,65,0.385,8,21,0.381,31,43,0.721,105,2012-01-18,OKC,WAS
5913,13,@,L 102-105 ,240,42,94,0.447,35,72,0.486,7,22,0.318,11,15,0.733,102,44,79,0.557,38,57,0.667,6,22,0.273,11,12,0.917,105,2012-01-21,SAS,HOU
5914,14,Home,L 102-104 ,240,42,83,0.506,36,71,0.507,6,12,0.5,12,13,0.923,102,41,75,0.547,34,59,0.576,7,16,0.438,15,20,0.75,104,2012-01-23,NOP,SAS
5915,15,@,W 102-83 ,240,38,83,0.458,25,51,0.49,13,32,0.406,13,19,0.684,102,31,78,0.397,28,67,0.418,3,11,0.273,18,18,1.0,83,2012-01-24,ORL,IND
5916,16,@,W 102-99 ,240,40,76,0.526,34,65,0.523,6,11,0.545,16,21,0.762,102,39,83,0.47,35,72,0.486,4,11,0.364,17,29,0.586,99,2012-01-28,WAS,CHA
5917,17,Home,L 102-105 ,240,44,90,0.489,40,74,0.541,4,16,0.25,10,14,0.714,102,39,74,0.527,33,62,0.532,6,12,0.5,21,29,0.724,105,2012-02-02,NYK,CHI
5918,18,Home,W 102-94 ,240,34,80,0.425,25,54,0.463,9,26,0.346,25,36,0.694,102,33,90,0.367,26,72,0.361,7,18,0.389,21,27,0.778,94,2012-02-03,ORL,CLE
5919,19,Home,L 102-107 (OT),265,40,86,0.465,29,56,0.518,11,30,0.367,11,16,0.688,102,36,82,0.439,23,51,0.451,13,31,0.419,22,25,0.88,107,2012-02-06,ORL,LAC
5920,20,Home,W 102-89 ,240,35,83,0.422,18,41,0.439,17,42,0.405,15,21,0.714,102,36,76,0.474,31,61,0.508,5,15,0.333,12,17,0.706,89,2012-02-08,ORL,MIA
5921,21,Home,W 102-96 ,240,39,86,0.453,32,68,0.471,7,18,0.389,17,21,0.81,102,38,82,0.463,33,57,0.579,5,25,0.2,15,19,0.789,96,2012-02-13,GSW,PHO
5922,22,Home,W 102-89 ,240,36,85,0.424,24,55,0.436,12,30,0.4,18,22,0.818,102,33,80,0.413,27,59,0.458,6,21,0.286,17,25,0.68,89,2012-02-13,ORL,MIN
5923,23,Home,W 102-84 ,240,37,80,0.463,27,54,0.5,10,26,0.385,18,22,0.818,102,30,84,0.357,24,57,0.421,6,27,0.222,18,31,0.581,84,2012-02-15,DAL,DEN
5924,24,Home,W 102-84 ,240,35,83,0.422,24,62,0.387,11,21,0.524,21,28,0.75,102,30,76,0.395,25,54,0.463,5,22,0.227,19,28,0.679,84,2012-02-15,LAC,WAS
5925,25,Home,W 102-90 ,240,43,85,0.506,39,69,0.565,4,16,0.25,12,16,0.75,102,38,85,0.447,31,67,0.463,7,18,0.389,7,15,0.467,90,2012-02-15,MIN,CHA
5926,26,@,L 102-103 ,240,41,83,0.494,33,66,0.5,8,17,0.471,12,18,0.667,102,41,82,0.5,35,66,0.53,6,16,0.375,15,19,0.789,103,2012-02-17,DEN,MEM
5927,27,Home,W 102-90 ,240,34,80,0.425,27,60,0.45,7,20,0.35,27,32,0.844,102,35,78,0.449,32,60,0.533,3,18,0.167,17,25,0.68,90,2012-02-19,PHO,LAL
5928,28,Home,L 102-106 ,240,40,84,0.476,37,76,0.487,3,8,0.375,19,23,0.826,102,36,78,0.462,26,57,0.456,10,21,0.476,24,30,0.8,106,2012-02-20,UTA,SAS
5929,29,@,W 102-88 ,240,34,85,0.4,27,69,0.391,7,16,0.438,27,32,0.844,102,31,88,0.352,23,69,0.333,8,19,0.421,18,23,0.783,88,2012-02-22,IND,CHA
5930,30,Home,W 102-88 ,240,42,85,0.494,38,71,0.535,4,14,0.286,14,19,0.737,102,31,79,0.392,24,62,0.387,7,17,0.412,19,22,0.864,88,2012-02-23,MIA,NYK
5931,31,Home,W 102-78 ,240,37,84,0.44,32,73,0.438,5,11,0.455,23,32,0.719,102,29,85,0.341,26,63,0.413,3,22,0.136,17,24,0.708,78,2012-02-28,IND,GSW
5932,32,Home,W 102-96 ,240,40,87,0.46,37,71,0.521,3,16,0.188,19,28,0.679,102,39,96,0.406,35,81,0.432,4,15,0.267,14,16,0.875,96,2012-02-29,BOS,MIL
5933,33,@,W 102-95 ,240,34,75,0.453,19,39,0.487,15,36,0.417,19,27,0.704,102,37,90,0.411,31,74,0.419,6,16,0.375,15,19,0.789,95,2012-02-29,ORL,WAS
5934,34,Home,L 102-105 ,240,40,84,0.476,31,59,0.525,9,25,0.36,13,19,0.684,102,38,74,0.514,30,56,0.536,8,18,0.444,21,27,0.778,105,2012-03-01,ORL,OKC
5935,35,Home,W 102-72 ,240,39,82,0.476,29,62,0.468,10,20,0.5,14,21,0.667,102,31,83,0.373,28,67,0.418,3,16,0.188,7,10,0.7,72,2012-03-02,SAS,CHA
5936,36,@,W 102-99 ,240,38,81,0.469,34,70,0.486,4,11,0.364,22,32,0.688,102,38,72,0.528,32,56,0.571,6,16,0.375,17,20,0.85,99,2012-03-02,MEM,TOR
5937,37,Home,W 102-96 ,240,36,75,0.48,26,52,0.5,10,23,0.435,20,24,0.833,102,38,85,0.447,34,69,0.493,4,16,0.25,16,21,0.762,96,2012-03-03,DAL,UTA
5938,38,@,W 102-84 ,240,35,80,0.438,26,61,0.426,9,19,0.474,23,32,0.719,102,33,81,0.407,29,69,0.42,4,12,0.333,14,21,0.667,84,2012-03-03,IND,NOH
5939,39,Home,L 102-105 ,240,37,81,0.457,29,61,0.475,8,20,0.4,20,26,0.769,102,39,82,0.476,33,64,0.516,6,18,0.333,21,27,0.778,105,2012-03-09,MIN,LAL
5940,40,@,L 102-106 ,240,38,85,0.447,32,73,0.438,6,12,0.5,20,23,0.87,102,36,77,0.468,26,58,0.448,10,19,0.526,24,26,0.923,106,2012-03-14,MIA,CHI
5941,41,Home,W 102-88 ,240,40,83,0.482,28,56,0.5,12,27,0.444,10,13,0.769,102,38,78,0.487,33,67,0.493,5,11,0.455,7,9,0.778,88,2012-03-16,ATL,WAS
5942,42,@,W 102-88 ,240,32,77,0.416,25,53,0.472,7,24,0.292,31,40,0.775,102,32,79,0.405,28,60,0.467,4,19,0.211,20,27,0.741,88,2012-03-17,NYK,IND
5943,43,@,W 102-94 ,240,41,81,0.506,33,65,0.508,8,16,0.5,12,13,0.923,102,36,86,0.419,26,63,0.413,10,23,0.435,12,14,0.857,94,2012-03-17,NOP,NJN
5944,44,Home,W 102-89 ,240,35,72,0.486,27,58,0.466,8,14,0.571,24,26,0.923,102,37,85,0.435,31,63,0.492,6,22,0.273,9,20,0.45,89,2012-03-20,IND,LAC
5945,45,@,L 102-103 (OT),265,36,78,0.462,30,59,0.508,6,19,0.316,24,33,0.727,102,37,93,0.398,29,73,0.397,8,20,0.4,21,24,0.875,103,2012-03-21,CLE,ATL
5946,46,Home,L 102-103 ,240,43,106,0.406,39,91,0.429,4,15,0.267,12,21,0.571,102,43,91,0.473,40,74,0.541,3,17,0.176,14,17,0.824,103,2012-03-22,SAC,UTA
5947,47,@,L 102-121 ,240,36,78,0.462,30,60,0.5,6,18,0.333,24,32,0.75,102,48,81,0.593,41,66,0.621,7,15,0.467,18,29,0.621,121,2012-03-23,DEN,UTA
5948,48,Home,W 102-101 (OT),265,41,103,0.398,38,80,0.475,3,23,0.13,17,26,0.654,102,39,87,0.448,36,73,0.493,3,14,0.214,20,25,0.8,101,2012-03-24,CHI,TOR
5949,49,Home,W 102-89 ,240,39,88,0.443,34,72,0.472,5,16,0.313,19,22,0.864,102,35,79,0.443,32,65,0.492,3,14,0.214,16,22,0.727,89,2012-03-24,BRK,CHA
5950,50,@,W 102-96 ,240,44,86,0.512,38,73,0.521,6,13,0.462,8,10,0.8,102,31,73,0.425,24,55,0.436,7,18,0.389,27,30,0.9,96,2012-03-25,MEM,LAL
5951,51,@,W 102-95 ,240,33,73,0.452,31,61,0.508,2,12,0.167,34,45,0.756,102,33,79,0.418,29,67,0.433,4,12,0.333,25,35,0.714,95,2012-03-26,BOS,CHA
5952,52,@,W 102-87 ,240,43,79,0.544,36,68,0.529,7,11,0.636,9,14,0.643,102,33,74,0.446,23,46,0.5,10,28,0.357,11,15,0.733,87,2012-03-28,NOP,GSW
5953,53,@,W 102-93 ,240,42,91,0.462,37,79,0.468,5,12,0.417,13,17,0.765,102,35,84,0.417,31,73,0.425,4,11,0.364,19,23,0.826,93,2012-03-29,OKC,LAL
5954,54,@,W 102-100 ,240,35,81,0.432,27,61,0.443,8,20,0.4,24,30,0.8,102,40,76,0.526,33,61,0.541,7,15,0.467,13,16,0.813,100,2012-03-30,BRK,GSW
5955,55,Home,L 102-104 (OT),265,44,101,0.436,35,80,0.438,9,21,0.429,5,10,0.5,102,37,83,0.446,31,68,0.456,6,15,0.4,24,28,0.857,104,2012-04-01,HOU,IND
5956,56,@,W 102-97 ,240,41,84,0.488,37,69,0.536,4,15,0.267,16,21,0.762,102,35,81,0.432,23,59,0.39,12,22,0.545,15,18,0.833,97,2012-04-02,UTA,POR
5957,57,Home,W 102-95 ,240,43,76,0.566,40,65,0.615,3,11,0.273,13,19,0.684,102,33,72,0.458,23,48,0.479,10,24,0.417,19,24,0.792,95,2012-04-03,DET,ORL
5958,58,Home,W 102-83 ,240,37,90,0.411,31,70,0.443,6,20,0.3,22,26,0.846,102,28,79,0.354,21,58,0.362,7,21,0.333,20,22,0.909,83,2012-04-13,IND,CLE
5959,59,@,W 102-86 ,240,41,74,0.554,37,62,0.597,4,12,0.333,16,23,0.696,102,29,72,0.403,24,50,0.48,5,22,0.227,23,31,0.742,86,2012-04-15,TOR,ATL
5960,60,Home,L 102-105 ,240,40,94,0.426,32,65,0.492,8,29,0.276,14,17,0.824,102,38,80,0.475,29,62,0.468,9,18,0.5,20,29,0.69,105,2012-04-16,HOU,DEN
5961,61,@,W 102-97 ,240,37,89,0.416,24,65,0.369,13,24,0.542,15,18,0.833,102,34,76,0.447,29,62,0.468,5,14,0.357,24,32,0.75,97,2012-04-17,IND,PHI
5962,62,Home,W 102-98 ,240,38,70,0.543,35,63,0.556,3,7,0.429,23,27,0.852,102,36,78,0.462,30,54,0.556,6,24,0.25,20,30,0.667,98,2012-04-18,BOS,ORL
5963,63,Home,L 102-127 ,240,41,92,0.446,35,71,0.493,6,21,0.286,14,20,0.7,102,47,80,0.588,39,59,0.661,8,21,0.381,25,31,0.806,127,2012-04-18,SAC,SAS
5964,64,@,L 102-109 ,240,40,80,0.5,32,61,0.525,8,19,0.421,14,20,0.7,102,43,86,0.5,32,62,0.516,11,24,0.458,12,14,0.857,109,2012-04-24,LAC,ATL
5965,65,Home,W 102-95 ,240,33,82,0.402,19,44,0.432,14,38,0.368,22,28,0.786,102,31,70,0.443,26,53,0.491,5,17,0.294,28,32,0.875,95,2012-04-25,ORL,CHA
5966,66,Home,L 102-131 ,240,40,89,0.449,30,62,0.484,10,27,0.37,12,19,0.632,102,56,89,0.629,51,79,0.646,5,10,0.5,14,20,0.7,131,2012-04-26,MIN,DEN
5967,67,Home,L 102-109 ,240,40,85,0.471,33,63,0.524,7,22,0.318,15,17,0.882,102,38,90,0.422,30,60,0.5,8,30,0.267,25,29,0.862,109,2012-11-02,ATL,HOU
5968,68,Home,W 102-89 ,240,42,86,0.488,37,71,0.521,5,15,0.333,13,18,0.722,102,32,84,0.381,25,58,0.431,7,26,0.269,18,27,0.667,89,2012-11-02,ORL,DEN
5969,69,@,L 102-105 ,240,39,83,0.47,33,67,0.493,6,16,0.375,18,29,0.621,102,41,79,0.519,32,55,0.582,9,24,0.375,14,21,0.667,105,2012-11-03,CLE,MIL
5970,70,Home,W 102-97 ,240,36,85,0.424,28,63,0.444,8,22,0.364,22,28,0.786,102,35,75,0.467,28,62,0.452,7,13,0.538,20,25,0.8,97,2012-11-15,BRK,BOS
5971,71,@,L 102-114 ,240,45,92,0.489,40,78,0.513,5,14,0.357,7,15,0.467,102,42,89,0.472,34,68,0.5,8,21,0.381,22,28,0.786,114,2012-11-16,PHO,LAL
5972,72,Home,W 102-94 ,240,39,79,0.494,30,57,0.526,9,22,0.409,15,20,0.75,102,37,75,0.493,33,59,0.559,4,16,0.25,16,18,0.889,94,2012-11-18,POR,CHI
5973,73,Home,W 102-98 ,240,36,82,0.439,33,71,0.465,3,11,0.273,27,30,0.9,102,44,93,0.473,42,77,0.545,2,16,0.125,8,11,0.727,98,2012-11-19,CHA,MIL
5974,74,Home,W 102-91 ,240,37,92,0.402,28,71,0.394,9,21,0.429,19,23,0.826,102,30,86,0.349,23,65,0.354,7,21,0.333,24,31,0.774,91,2012-11-19,UTA,HOU
5975,75,@,W 102-80 ,240,37,83,0.446,23,47,0.489,14,36,0.389,14,19,0.737,102,29,69,0.42,21,51,0.412,8,18,0.444,14,21,0.667,80,2012-11-20,NYK,NOH
5976,76,Home,W 102-93 ,240,40,75,0.533,33,60,0.55,7,15,0.467,15,19,0.789,102,38,83,0.458,32,60,0.533,6,23,0.261,11,15,0.733,93,2012-11-21,GSW,BRK
5977,77,Home,W 102-91 ,240,40,84,0.476,35,65,0.538,5,19,0.263,17,30,0.567,102,35,80,0.438,28,63,0.444,7,17,0.412,14,18,0.778,91,2012-11-23,DEN,GSW
5978,78,@,L 102-104 ,240,40,80,0.5,30,63,0.476,10,17,0.588,12,16,0.75,102,36,83,0.434,33,68,0.485,3,15,0.2,29,33,0.879,104,2012-11-23,SAC,UTA
5979,79,Home,W 102-84 ,240,40,75,0.533,35,62,0.565,5,13,0.385,17,21,0.81,102,33,85,0.388,27,72,0.375,6,13,0.462,12,20,0.6,84,2012-11-25,DEN,NOH
5980,80,@,W 102-88 ,240,35,73,0.479,24,52,0.462,11,21,0.524,21,25,0.84,102,33,72,0.458,28,59,0.475,5,13,0.385,17,21,0.81,88,2012-11-28,NYK,MIL
5981,81,Home,W 102-89 ,240,40,78,0.513,33,58,0.569,7,20,0.35,15,19,0.789,102,33,75,0.44,27,47,0.574,6,28,0.214,17,27,0.63,89,2012-12-01,MIA,BRK
5982,82,@,W 102-94 ,240,40,92,0.435,32,69,0.464,8,23,0.348,14,16,0.875,102,37,81,0.457,30,64,0.469,7,17,0.412,13,18,0.722,94,2012-12-03,ORL,GSW
5983,83,Home,W 102-81 ,240,43,82,0.524,38,70,0.543,5,12,0.417,11,11,1.0,102,29,76,0.382,21,57,0.368,8,19,0.421,15,23,0.652,81,2012-12-03,NOP,MIL
5984,84,Home,L 102-109 ,240,37,87,0.425,26,54,0.481,11,33,0.333,17,23,0.739,102,46,90,0.511,37,71,0.521,9,19,0.474,8,10,0.8,109,2012-12-07,BRK,GSW
5985,85,Home,L 102-132 ,240,37,79,0.468,31,64,0.484,6,15,0.4,22,31,0.71,102,50,90,0.556,31,56,0.554,19,34,0.559,13,15,0.867,132,2012-12-08,CHA,SAS
5986,86,Home,W 102-83 ,240,36,79,0.456,30,60,0.5,6,19,0.316,24,34,0.706,102,30,77,0.39,20,51,0.392,10,26,0.385,13,17,0.765,83,2012-12-09,LAC,TOR
5987,87,Home,L 102-113 ,240,42,78,0.538,31,54,0.574,11,24,0.458,7,10,0.7,102,47,88,0.534,40,71,0.563,7,17,0.412,12,17,0.706,113,2012-12-14,NOP,MIN
5988,88,@,W 102-96 ,240,37,82,0.451,29,53,0.547,8,29,0.276,20,28,0.714,102,36,83,0.434,28,62,0.452,8,21,0.381,16,20,0.8,96,2012-12-14,LAL,WAS
5989,89,Home,W 102-72 ,240,40,79,0.506,32,52,0.615,8,27,0.296,14,21,0.667,102,27,72,0.375,20,52,0.385,7,20,0.35,11,15,0.733,72,2012-12-15,MIA,WAS
5990,90,@,L 102-103 ,240,40,82,0.488,31,58,0.534,9,24,0.375,13,17,0.765,102,37,85,0.435,24,50,0.48,13,35,0.371,16,23,0.696,103,2012-12-15,CLE,NYK
5991,91,Home,W 102-93 ,240,44,82,0.537,38,68,0.559,6,14,0.429,8,8,1.0,102,39,96,0.406,32,71,0.451,7,25,0.28,8,12,0.667,93,2012-12-17,ORL,MIN
5992,92,@,W 102-94 ,240,38,78,0.487,25,54,0.463,13,24,0.542,13,16,0.813,102,36,86,0.419,28,65,0.431,8,21,0.381,14,14,1.0,94,2012-12-28,ATL,CLE
5993,93,Home,W 102-79 ,240,41,77,0.532,33,54,0.611,8,23,0.348,12,17,0.706,102,31,70,0.443,27,48,0.563,4,22,0.182,13,16,0.813,79,2013-01-02,TOR,POR
5994,94,@,L 102-107 ,240,35,76,0.461,29,51,0.569,6,25,0.24,26,36,0.722,102,41,82,0.5,35,68,0.515,6,14,0.429,19,25,0.76,107,2013-01-04,LAL,LAC
5995,95,@,W 102-97 ,240,37,86,0.43,21,62,0.339,16,24,0.667,12,13,0.923,102,38,91,0.418,33,75,0.44,5,16,0.313,16,18,0.889,97,2013-01-05,POR,MIN
5996,96,@,W 102-96 ,240,39,74,0.527,33,56,0.589,6,18,0.333,18,20,0.9,102,31,76,0.408,17,44,0.386,14,32,0.438,20,26,0.769,96,2013-01-07,BOS,NYK
5997,97,Home,L 102-112 ,240,42,88,0.477,38,80,0.475,4,8,0.5,14,22,0.636,102,44,82,0.537,34,60,0.567,10,22,0.455,14,21,0.667,112,2013-01-09,CHA,UTA
5998,98,@,W 102-90 ,240,40,84,0.476,35,67,0.522,5,17,0.294,17,22,0.773,102,35,84,0.417,26,59,0.441,9,25,0.36,11,18,0.611,90,2013-01-14,OKC,PHO
5999,99,@,W 102-87 ,240,33,72,0.458,22,41,0.537,11,31,0.355,25,31,0.806,102,35,79,0.443,29,62,0.468,6,17,0.353,11,22,0.5,87,2013-01-17,NYK,DET
6000,0,@,L 102-110 ,240,42,95,0.442,34,79,0.43,8,16,0.5,10,13,0.769,102,41,79,0.519,34,63,0.54,7,16,0.438,21,33,0.636,110,2013-01-22,PHI,MIL
6001,1,@,L 102-106 ,240,38,81,0.469,28,64,0.438,10,17,0.588,16,23,0.696,102,43,80,0.538,35,55,0.636,8,25,0.32,12,23,0.522,106,2013-01-23,NOP,SAS
6002,2,Home,W 102-84 ,240,43,80,0.538,34,59,0.576,9,21,0.429,7,13,0.538,102,34,81,0.42,31,67,0.463,3,14,0.214,13,16,0.813,84,2013-01-25,LAL,UTA
6003,3,Home,W 102-101 ,240,37,73,0.507,32,62,0.516,5,11,0.455,23,26,0.885,102,37,77,0.481,27,57,0.474,10,20,0.5,17,23,0.739,101,2013-01-26,CHA,MIN
6004,4,@,L 102-109 ,240,39,93,0.419,26,65,0.4,13,28,0.464,11,11,1.0,102,41,101,0.406,28,71,0.394,13,30,0.433,14,20,0.7,109,2013-01-26,GSW,MIL
6005,5,Home,L 102-104 ,240,40,90,0.444,30,67,0.448,10,23,0.435,12,16,0.75,102,40,79,0.506,29,56,0.518,11,23,0.478,13,18,0.722,104,2013-01-27,ORL,DET
6006,6,Home,W 102-101 ,240,37,78,0.474,30,64,0.469,7,14,0.5,21,30,0.7,102,39,85,0.459,28,62,0.452,11,23,0.478,12,17,0.706,101,2013-01-28,DEN,IND
6007,7,Home,L 102-114 ,240,38,87,0.437,32,68,0.471,6,19,0.316,20,23,0.87,102,46,86,0.535,40,71,0.563,6,15,0.4,16,20,0.8,114,2013-01-28,TOR,GSW
6008,8,Home,W 102-78 ,240,38,69,0.551,29,53,0.547,9,16,0.563,17,21,0.81,102,30,73,0.411,26,54,0.481,4,19,0.211,14,17,0.824,78,2013-01-30,SAS,CHA
6009,9,Home,W 102-89 ,240,39,70,0.557,32,53,0.604,7,17,0.412,17,24,0.708,102,33,70,0.471,28,56,0.5,5,14,0.357,18,24,0.75,89,2013-02-01,IND,MIA
6010,10,@,W 102-88 ,240,41,80,0.513,31,52,0.596,10,28,0.357,10,16,0.625,102,33,74,0.446,26,51,0.51,7,23,0.304,15,18,0.833,88,2013-02-10,LAC,NYK
6011,11,Home,W 102-89 ,240,40,78,0.513,32,62,0.516,8,16,0.5,14,18,0.778,102,34,69,0.493,29,56,0.518,5,13,0.385,16,25,0.64,89,2013-02-10,TOR,NOH
6012,12,@,W 102-90 ,240,42,74,0.568,38,62,0.613,4,12,0.333,14,17,0.824,102,36,95,0.379,31,72,0.431,5,23,0.217,13,22,0.591,90,2013-02-11,WAS,MIL
6013,13,@,W 102-98 ,240,41,82,0.5,38,69,0.551,3,13,0.231,17,20,0.85,102,33,80,0.413,27,60,0.45,6,20,0.3,26,32,0.813,98,2013-02-19,PHO,POR
6014,14,Home,L 102-108 ,240,34,90,0.378,25,65,0.385,9,25,0.36,25,29,0.862,102,35,75,0.467,25,45,0.556,10,30,0.333,28,35,0.8,108,2013-02-19,SAC,SAS
6015,15,Home,L 102-103 ,240,41,89,0.461,37,77,0.481,4,12,0.333,16,20,0.8,102,39,91,0.429,25,63,0.397,14,28,0.5,11,14,0.786,103,2013-02-23,MIL,ATL
6016,16,Home,W 102-72 ,240,36,79,0.456,30,62,0.484,6,17,0.353,24,27,0.889,102,25,86,0.291,21,68,0.309,4,18,0.222,18,24,0.75,72,2013-02-24,OKC,CHI
6017,17,@,W 102-91 ,240,38,78,0.487,33,61,0.541,5,17,0.294,21,26,0.808,102,37,83,0.446,33,68,0.485,4,15,0.267,13,23,0.565,91,2013-02-27,ATL,UTA
6018,18,@,L 102-130 ,240,39,85,0.459,32,64,0.5,7,21,0.333,17,19,0.895,102,51,84,0.607,42,64,0.656,9,20,0.45,19,23,0.826,130,2013-03-01,SAC,SAS
6019,19,@,W 102-97 ,240,36,78,0.462,24,48,0.5,12,30,0.4,18,21,0.857,102,37,73,0.507,31,53,0.585,6,20,0.3,17,24,0.708,97,2013-03-04,NYK,CLE
6020,20,Home,L 102-105 ,240,37,80,0.463,29,59,0.492,8,21,0.381,20,26,0.769,102,43,87,0.494,36,66,0.545,7,21,0.333,12,16,0.75,105,2013-03-04,NOP,ORL
6021,21,Home,L 102-108 ,240,38,88,0.432,29,64,0.453,9,24,0.375,17,20,0.85,102,38,78,0.487,27,50,0.54,11,28,0.393,21,29,0.724,108,2013-03-06,NOP,LAL
6022,22,@,L 102-107 (OT),265,40,88,0.455,31,61,0.508,9,27,0.333,13,17,0.765,102,40,78,0.513,30,58,0.517,10,20,0.5,17,20,0.85,107,2013-03-08,ATL,BOS
6023,23,@,W 102-99 ,240,41,78,0.526,30,56,0.536,11,22,0.5,9,15,0.6,102,39,96,0.406,30,66,0.455,9,30,0.3,12,19,0.632,99,2013-03-08,DAL,DET
6024,24,Home,W 102-93 ,240,42,79,0.532,34,58,0.586,8,21,0.381,10,13,0.769,102,37,77,0.481,27,56,0.482,10,21,0.476,9,11,0.818,93,2013-03-08,MIA,PHI
6025,25,@,W 102-97 ,240,39,76,0.513,36,65,0.554,3,11,0.273,21,31,0.677,102,32,79,0.405,27,63,0.429,5,16,0.313,28,29,0.966,97,2013-03-12,MEM,POR
6026,26,@,L 102-113 ,240,42,96,0.438,32,65,0.492,10,31,0.323,8,8,1.0,102,41,72,0.569,29,44,0.659,12,28,0.429,19,29,0.655,113,2013-03-17,SAC,LAL
6027,27,Home,W 102-95 ,240,42,87,0.483,33,68,0.485,9,19,0.474,9,13,0.692,102,36,83,0.434,23,57,0.404,13,26,0.5,10,13,0.769,95,2013-03-19,MIL,POR
6028,28,Home,W 102-78 ,240,38,79,0.481,35,67,0.522,3,12,0.25,23,30,0.767,102,31,101,0.307,28,82,0.341,3,19,0.158,13,22,0.591,78,2013-03-22,IND,MIL
6029,29,@,W 102-100 ,240,35,76,0.461,31,62,0.5,4,14,0.286,28,31,0.903,102,41,99,0.414,35,78,0.449,6,21,0.286,12,17,0.706,100,2013-03-24,BRK,PHO
6030,30,@,L 102-109 (OT),265,38,85,0.447,28,52,0.538,10,33,0.303,16,25,0.64,102,40,82,0.488,34,59,0.576,6,23,0.261,23,27,0.852,109,2013-03-26,LAC,DAL
6031,31,@,L 102-111 ,240,34,73,0.466,24,47,0.511,10,26,0.385,24,31,0.774,102,38,77,0.494,29,58,0.5,9,19,0.474,26,30,0.867,111,2013-03-29,CHA,NYK
6032,32,@,L 102-104 ,240,41,81,0.506,33,62,0.532,8,19,0.421,12,21,0.571,102,39,74,0.527,33,59,0.559,6,15,0.4,20,21,0.952,104,2013-03-29,LAC,SAS
6033,33,Home,W 102-94 ,240,37,81,0.457,28,51,0.549,9,30,0.3,19,26,0.731,102,41,81,0.506,38,69,0.551,3,12,0.25,9,15,0.6,94,2013-04-01,ATL,CLE
6034,34,@,L 102-131 ,240,37,73,0.507,31,54,0.574,6,19,0.316,22,28,0.786,102,51,100,0.51,37,73,0.507,14,27,0.519,15,17,0.882,131,2013-04-01,CHA,MIL
6035,35,@,L 102-112 ,240,39,67,0.582,26,44,0.591,13,23,0.565,11,17,0.647,102,45,83,0.542,36,61,0.59,9,22,0.409,13,18,0.722,112,2013-04-01,POR,UTA
6036,36,@,W 102-90 ,240,37,71,0.521,23,44,0.523,14,27,0.519,14,20,0.7,102,30,60,0.5,22,40,0.55,8,20,0.4,22,27,0.815,90,2013-04-02,NYK,MIA
6037,37,Home,L 102-112 ,240,34,87,0.391,28,66,0.424,6,21,0.286,28,34,0.824,102,42,86,0.488,32,56,0.571,10,30,0.333,18,21,0.857,112,2013-04-03,SAC,HOU
6038,38,@,W 102-91 ,240,37,89,0.416,25,62,0.403,12,27,0.444,16,17,0.941,102,34,85,0.4,28,68,0.412,6,17,0.353,17,21,0.81,91,2013-04-10,PHO,DAL
6039,39,@,W 102-84 ,240,42,75,0.56,33,58,0.569,9,17,0.529,9,13,0.692,102,31,74,0.419,29,64,0.453,2,10,0.2,20,33,0.606,84,2013-04-15,CHI,ORL
6040,40,@,L 102-113 ,240,34,78,0.436,24,53,0.453,10,25,0.4,24,32,0.75,102,39,78,0.5,30,54,0.556,9,24,0.375,26,33,0.788,113,2013-10-30,WAS,DET
6041,41,Home,W 102-95 ,240,36,77,0.468,26,54,0.481,10,23,0.435,20,31,0.645,102,40,88,0.455,33,65,0.508,7,23,0.304,8,14,0.571,95,2013-11-01,ATL,TOR
6042,42,Home,L 102-109 ,240,41,94,0.436,32,68,0.471,9,26,0.346,11,17,0.647,102,48,94,0.511,42,71,0.592,6,23,0.261,7,14,0.5,109,2013-11-01,WAS,PHI
6043,43,@,W 102-94 ,240,40,86,0.465,36,70,0.514,4,16,0.25,18,20,0.9,102,35,83,0.422,26,64,0.406,9,19,0.474,15,20,0.75,94,2013-11-05,SAS,DEN
6044,44,@,W 102-97 ,240,30,71,0.423,22,50,0.44,8,21,0.381,34,42,0.81,102,35,82,0.427,27,54,0.5,8,28,0.286,19,23,0.826,97,2013-11-05,CHA,NYK
6045,45,Home,L 102-116 ,240,39,83,0.47,33,65,0.508,6,18,0.333,18,26,0.692,102,43,98,0.439,25,65,0.385,18,33,0.545,12,16,0.75,116,2013-11-06,PHI,WAS
6046,46,Home,W 102-97 ,240,38,71,0.535,33,55,0.6,5,16,0.313,21,33,0.636,102,36,73,0.493,28,49,0.571,8,24,0.333,17,21,0.81,97,2013-11-07,MIA,LAC
6047,47,Home,W 102-88 ,240,41,80,0.513,32,59,0.542,9,21,0.429,11,14,0.786,102,35,77,0.455,27,60,0.45,8,17,0.471,10,16,0.625,88,2013-11-16,GSW,UTA
6048,48,Home,L 102-106 ,240,34,86,0.395,27,63,0.429,7,23,0.304,27,32,0.844,102,39,81,0.481,34,69,0.493,5,12,0.417,23,30,0.767,106,2013-11-18,LAC,MEM
6049,49,@,W 102-98 ,240,40,81,0.494,28,57,0.491,12,24,0.5,10,16,0.625,102,34,90,0.378,29,68,0.426,5,22,0.227,25,31,0.806,98,2013-11-20,LAC,MIN
6050,50,Home,W 102-95 ,240,39,82,0.476,28,58,0.483,11,24,0.458,13,17,0.765,102,34,82,0.415,25,60,0.417,9,22,0.409,18,28,0.643,95,2013-11-22,LAL,GSW
6051,51,@,W 102-86 ,240,42,79,0.532,35,62,0.565,7,17,0.412,11,16,0.688,102,35,80,0.438,32,69,0.464,3,11,0.273,13,17,0.765,86,2013-11-22,SAS,MEM
6052,52,Home,W 102-100 ,240,35,79,0.443,24,47,0.511,11,32,0.344,21,30,0.7,102,35,87,0.402,28,66,0.424,7,21,0.333,23,25,0.92,100,2013-11-23,DEN,DAL
6053,53,@,L 102-103 ,240,37,88,0.42,32,71,0.451,5,17,0.294,23,30,0.767,102,33,68,0.485,22,43,0.512,11,25,0.44,26,45,0.578,103,2013-11-23,SAC,LAC
6054,54,Home,W 102-91 ,240,37,84,0.44,28,59,0.475,9,25,0.36,19,22,0.864,102,38,85,0.447,32,70,0.457,6,15,0.4,9,14,0.643,91,2013-11-25,POR,NYK
6055,55,@,W 102-101 ,240,40,88,0.455,33,69,0.478,7,19,0.368,15,21,0.714,102,41,87,0.471,32,68,0.471,9,19,0.474,10,13,0.769,101,2013-11-26,GSW,NOP
6056,56,@,W 102-100 ,240,39,77,0.506,35,63,0.556,4,14,0.286,20,22,0.909,102,34,78,0.436,23,52,0.442,11,26,0.423,21,22,0.955,100,2013-11-26,BRK,TOR
6057,57,Home,L 102-106 ,240,44,100,0.44,43,92,0.467,1,8,0.125,13,25,0.52,102,36,80,0.45,22,49,0.449,14,31,0.452,20,30,0.667,106,2013-11-29,DET,LAL
6058,58,@,L 102-106 ,240,39,88,0.443,30,66,0.455,9,22,0.409,15,17,0.882,102,36,76,0.474,31,63,0.492,5,13,0.385,29,33,0.879,106,2013-12-02,IND,POR
6059,59,Home,W 102-100 ,240,42,78,0.538,36,60,0.6,6,18,0.333,12,17,0.706,102,42,96,0.438,31,65,0.477,11,31,0.355,5,5,1.0,100,2013-12-02,SAS,ATL
6060,60,Home,L 102-112 (OT),265,36,89,0.404,28,70,0.4,8,19,0.421,22,30,0.733,102,39,94,0.415,36,79,0.456,3,15,0.2,31,38,0.816,112,2013-12-07,UTA,SAC
6061,61,Home,W 102-93 ,240,33,74,0.446,25,54,0.463,8,20,0.4,28,30,0.933,102,26,70,0.371,20,46,0.435,6,24,0.25,35,52,0.673,93,2013-12-12,BRK,LAC
6062,62,Home,W 102-93 ,240,37,85,0.435,30,61,0.492,7,24,0.292,21,28,0.75,102,37,85,0.435,30,61,0.492,7,24,0.292,12,19,0.632,93,2013-12-15,DEN,NOP
6063,63,@,L 102-106 ,240,34,80,0.425,23,58,0.397,11,22,0.5,23,33,0.697,102,35,79,0.443,22,52,0.423,13,27,0.481,23,34,0.676,106,2013-12-15,GSW,PHO
6064,64,@,W 102-101 ,240,39,72,0.542,28,54,0.519,11,18,0.611,13,17,0.765,102,33,79,0.418,22,49,0.449,11,30,0.367,24,31,0.774,101,2013-12-16,WAS,NYK
6065,65,Home,L 102-104 (OT),265,41,96,0.427,35,70,0.5,6,26,0.231,14,20,0.7,102,37,81,0.457,29,66,0.439,8,15,0.533,22,34,0.647,104,2013-12-18,TOR,CHA
6066,66,Home,L 102-104 ,240,42,90,0.467,34,59,0.576,8,31,0.258,10,11,0.909,102,40,89,0.449,29,62,0.468,11,27,0.407,13,19,0.684,104,2013-12-19,GSW,SAS
6067,67,Home,W 102-83 ,240,38,98,0.388,26,67,0.388,12,31,0.387,14,19,0.737,102,26,80,0.325,22,60,0.367,4,20,0.2,27,33,0.818,83,2013-12-21,GSW,LAL
6068,68,@,L 102-109 ,240,36,81,0.444,21,42,0.5,15,39,0.385,15,21,0.714,102,41,74,0.554,33,53,0.623,8,21,0.381,19,24,0.792,109,2013-12-29,ATL,ORL
6069,69,Home,L 102-114 ,240,36,91,0.396,31,66,0.47,5,25,0.2,25,35,0.714,102,43,92,0.467,34,69,0.493,9,23,0.391,19,28,0.679,114,2014-01-01,DEN,PHI
6070,70,Home,W 102-100 ,240,34,74,0.459,24,48,0.5,10,26,0.385,24,28,0.857,102,37,89,0.416,28,65,0.431,9,24,0.375,17,24,0.708,100,2014-01-03,HOU,NYK
6071,71,Home,W 102-97 ,240,38,81,0.469,35,70,0.5,3,11,0.273,23,27,0.852,102,39,77,0.506,32,55,0.582,7,22,0.318,12,21,0.571,97,2014-01-05,MIA,TOR
6072,72,Home,W 102-98 ,240,34,77,0.442,29,58,0.5,5,19,0.263,29,35,0.829,102,36,78,0.462,27,52,0.519,9,26,0.346,17,23,0.739,98,2014-01-08,BRK,GSW
6073,73,@,W 102-96 ,240,38,80,0.475,28,59,0.475,10,21,0.476,16,26,0.615,102,35,78,0.449,31,65,0.477,4,13,0.308,22,27,0.815,96,2014-01-08,WAS,NOP
6074,74,Home,W 102-92 ,240,44,82,0.537,35,58,0.603,9,24,0.375,5,10,0.5,102,37,68,0.544,30,47,0.638,7,21,0.333,11,21,0.524,92,2014-01-09,NYK,MIA
6075,75,Home,L 102-113 ,240,39,81,0.481,30,61,0.492,9,20,0.45,15,27,0.556,102,45,83,0.542,38,69,0.551,7,14,0.5,16,20,0.8,113,2014-01-10,UTA,CLE
6076,76,@,W 102-92 ,240,39,82,0.476,33,64,0.516,6,18,0.333,18,23,0.783,102,36,78,0.462,31,59,0.525,5,19,0.263,15,21,0.714,92,2014-01-11,NYK,PHI
6077,77,@,W 102-88 ,240,39,75,0.52,32,57,0.561,7,18,0.389,17,28,0.607,102,34,79,0.43,25,58,0.431,9,21,0.429,11,19,0.579,88,2014-01-13,WAS,CHI
6078,78,Home,W 102-100 (OT),265,39,102,0.382,32,81,0.395,7,21,0.333,17,24,0.708,102,35,83,0.422,27,58,0.466,8,25,0.32,22,26,0.846,100,2014-01-20,CHI,LAL
6079,79,@,W 102-97 ,240,38,83,0.458,34,63,0.54,4,20,0.2,22,28,0.786,102,33,81,0.407,28,58,0.483,5,23,0.217,26,33,0.788,97,2014-01-20,DAL,CLE
6080,80,@,W 102-94 ,240,41,91,0.451,33,72,0.458,8,19,0.421,12,15,0.8,102,35,86,0.407,25,56,0.446,10,30,0.333,14,20,0.7,94,2014-01-20,IND,GSW
6081,81,@,L 102-109 ,240,40,88,0.455,31,63,0.492,9,25,0.36,13,21,0.619,102,45,78,0.577,37,58,0.638,8,20,0.4,11,23,0.478,109,2014-01-23,LAL,MIA
6082,82,@,W 102-94 ,240,39,91,0.429,31,74,0.419,8,17,0.471,16,20,0.8,102,38,87,0.437,37,72,0.514,1,15,0.067,17,24,0.708,94,2014-01-30,PHO,IND
6083,83,@,L 102-113 ,240,39,87,0.448,29,66,0.439,10,21,0.476,14,24,0.583,102,43,83,0.518,36,67,0.537,7,16,0.438,20,25,0.8,113,2014-01-31,MIL,ORL
6084,84,Home,W 102-87 ,240,38,74,0.514,36,62,0.581,2,12,0.167,24,37,0.649,102,29,81,0.358,19,51,0.373,10,30,0.333,19,28,0.679,87,2014-02-01,LAC,UTA
6085,85,@,L 102-108 ,240,37,71,0.521,29,51,0.569,8,20,0.4,20,28,0.714,102,32,72,0.444,22,47,0.468,10,25,0.4,34,39,0.872,108,2014-02-03,PHI,BRK
6086,86,Home,W 102-96 ,240,39,85,0.459,32,65,0.492,7,20,0.35,17,21,0.81,102,34,83,0.41,28,65,0.431,6,18,0.333,22,29,0.759,96,2014-02-03,MIA,DET
6087,87,@,W 102-95 ,240,38,81,0.469,33,63,0.524,5,18,0.278,21,25,0.84,102,36,79,0.456,30,65,0.462,6,14,0.429,17,20,0.85,95,2014-02-03,SAS,NOP
6088,88,Home,W 102-87 ,240,40,83,0.482,29,61,0.475,11,22,0.5,11,15,0.733,102,32,77,0.416,28,63,0.444,4,14,0.286,19,20,0.95,87,2014-02-06,GSW,CHI
6089,89,@,L 102-103 ,240,37,73,0.507,27,51,0.529,10,22,0.455,18,19,0.947,102,38,80,0.475,33,68,0.485,5,12,0.417,22,26,0.846,103,2014-02-07,OKC,ORL
6090,90,@,W 102-91 ,240,37,82,0.451,27,59,0.458,10,23,0.435,18,20,0.9,102,33,92,0.359,22,65,0.338,11,27,0.407,14,15,0.933,91,2014-02-09,DAL,BOS
6091,91,@,W 102-86 ,240,42,88,0.477,35,68,0.515,7,20,0.35,11,14,0.786,102,31,72,0.431,25,56,0.446,6,16,0.375,18,25,0.72,86,2014-02-10,BOS,MIL
6092,92,@,W 102-98 ,240,41,79,0.519,35,66,0.53,6,13,0.462,14,17,0.824,102,39,80,0.488,33,64,0.516,6,16,0.375,14,19,0.737,98,2014-02-12,NOP,MIL
6093,93,Home,W 102-99 (OT),265,37,93,0.398,28,66,0.424,9,27,0.333,19,24,0.792,102,37,101,0.366,28,71,0.394,9,30,0.3,16,25,0.64,99,2014-02-20,GSW,HOU
6094,94,Home,W 102-96 ,240,42,87,0.483,37,72,0.514,5,15,0.333,13,15,0.867,102,31,80,0.388,24,56,0.429,7,24,0.292,27,43,0.628,96,2014-02-21,MEM,LAC
6095,95,Home,W 102-94 ,240,39,91,0.429,32,71,0.451,7,20,0.35,17,17,1.0,102,37,82,0.451,31,69,0.449,6,13,0.462,14,18,0.778,94,2014-02-21,POR,UTA
6096,96,Home,L 102-113 ,240,40,82,0.488,38,71,0.535,2,11,0.182,20,30,0.667,102,44,90,0.489,36,67,0.537,8,23,0.348,17,22,0.773,113,2014-02-22,DET,DAL
6097,97,Home,L 102-108 ,240,39,76,0.513,32,59,0.542,7,17,0.412,17,26,0.654,102,36,76,0.474,24,51,0.471,12,25,0.48,24,32,0.75,108,2014-02-23,LAL,BRK
6098,98,@,W 102-97 ,240,39,77,0.506,34,64,0.531,5,13,0.385,19,23,0.826,102,38,89,0.427,31,68,0.456,7,21,0.333,14,17,0.824,97,2014-03-01,IND,BOS
6099,99,Home,W 102-96 ,240,37,81,0.457,32,54,0.593,5,27,0.185,23,24,0.958,102,33,83,0.398,26,60,0.433,7,23,0.304,23,35,0.657,96,2014-03-01,POR,DEN
6100,0,Home,L 102-116 ,240,36,82,0.439,30,65,0.462,6,17,0.353,24,29,0.828,102,43,83,0.518,39,69,0.565,4,14,0.286,26,32,0.813,116,2014-03-05,MIL,SAC
6101,1,Home,W 102-78 ,240,35,79,0.443,22,50,0.44,13,29,0.448,19,21,0.905,102,29,88,0.33,25,61,0.41,4,27,0.148,16,19,0.842,78,2014-03-05,POR,ATL
6102,2,Home,W 102-97 ,240,36,74,0.486,23,45,0.511,13,29,0.448,17,20,0.85,102,37,89,0.416,34,70,0.486,3,19,0.158,20,26,0.769,97,2014-03-13,ATL,MIL
6103,3,@,L 102-131 ,240,37,94,0.394,24,67,0.358,13,27,0.481,15,25,0.6,102,45,89,0.506,32,59,0.542,13,30,0.433,28,30,0.933,131,2014-03-13,LAL,OKC
6104,4,Home,W 102-80 ,240,42,94,0.447,34,66,0.515,8,28,0.286,10,15,0.667,102,29,83,0.349,21,59,0.356,8,24,0.333,14,20,0.7,80,2014-03-16,LAC,CLE
6105,5,@,L 102-104 ,240,41,85,0.482,35,66,0.53,6,19,0.316,14,19,0.737,102,34,78,0.436,28,61,0.459,6,17,0.353,30,38,0.789,104,2014-03-16,SAC,MIN
6106,6,@,W 102-94 ,240,36,83,0.434,28,68,0.412,8,15,0.533,22,27,0.815,102,37,81,0.457,26,57,0.456,11,24,0.458,9,19,0.474,94,2014-03-19,CHI,PHI
6107,7,@,W 102-95 ,240,38,89,0.427,28,58,0.483,10,31,0.323,16,20,0.8,102,36,81,0.444,28,59,0.475,8,22,0.364,15,24,0.625,95,2014-03-20,OKC,CLE
6108,8,@,L 102-105 ,240,41,85,0.482,36,70,0.514,5,15,0.333,15,18,0.833,102,40,91,0.44,29,64,0.453,11,27,0.407,14,18,0.778,105,2014-03-23,WAS,DEN
6109,9,@,W 102-95 ,240,38,74,0.514,26,50,0.52,12,24,0.5,14,16,0.875,102,30,72,0.417,22,49,0.449,8,23,0.348,27,33,0.818,95,2014-03-24,PHO,ATL
6110,10,Home,W 102-100 ,240,36,70,0.514,32,57,0.561,4,13,0.308,26,33,0.788,102,35,88,0.398,21,56,0.375,14,32,0.438,16,26,0.615,100,2014-03-25,CLE,TOR
6111,11,Home,L 102-133 ,240,35,87,0.402,29,64,0.453,6,23,0.261,26,35,0.743,102,55,98,0.561,42,74,0.568,13,24,0.542,10,14,0.714,133,2014-03-28,DEN,SAS
6112,12,Home,W 102-95 ,240,36,71,0.507,30,57,0.526,6,14,0.429,24,32,0.75,102,33,68,0.485,26,47,0.553,7,21,0.333,22,27,0.815,95,2014-03-28,NOP,UTA
6113,13,Home,L 102-107 ,240,40,87,0.46,30,58,0.517,10,29,0.345,12,16,0.75,102,37,70,0.529,29,54,0.537,8,16,0.5,25,31,0.806,107,2014-03-30,BOS,CHI
6114,14,@,W 102-97 ,240,38,80,0.475,35,69,0.507,3,11,0.273,23,31,0.742,102,36,73,0.493,31,59,0.525,5,14,0.357,20,26,0.769,97,2014-03-31,SAC,NOP
6115,15,Home,W 102-88 ,240,43,81,0.531,38,65,0.585,5,16,0.313,11,16,0.688,102,40,95,0.421,36,84,0.429,4,11,0.364,4,6,0.667,88,2014-04-02,MIN,MEM
6116,16,@,L 102-107 ,240,37,96,0.385,25,68,0.368,12,28,0.429,16,20,0.8,102,42,86,0.488,37,71,0.521,5,15,0.333,18,27,0.667,107,2014-04-02,LAL,SAC
6117,17,Home,L 102-111 ,240,38,87,0.437,29,54,0.537,9,33,0.273,17,21,0.81,102,39,77,0.506,33,58,0.569,6,19,0.316,27,37,0.73,111,2014-04-04,BOS,PHI
6118,18,Home,W 102-90 ,240,31,84,0.369,24,62,0.387,7,22,0.318,33,42,0.786,102,31,68,0.456,29,60,0.483,2,8,0.25,26,35,0.743,90,2014-04-04,CHI,MIL
6119,19,Home,W 102-69 ,240,42,93,0.452,32,63,0.508,10,30,0.333,8,12,0.667,102,25,78,0.321,24,68,0.353,1,10,0.1,18,25,0.72,69,2014-04-04,GSW,SAC
6120,20,Home,W 102-94 ,240,40,84,0.476,30,62,0.484,10,22,0.455,12,16,0.75,102,33,78,0.423,27,67,0.403,6,11,0.545,22,28,0.786,94,2014-04-04,TOR,IND
6121,21,@,W 102-98 ,240,36,81,0.444,24,54,0.444,12,27,0.444,18,22,0.818,102,38,79,0.481,37,70,0.529,1,9,0.111,21,27,0.778,98,2014-04-05,TOR,MIL
6122,22,@,L 102-130 ,240,39,86,0.453,35,73,0.479,4,13,0.308,20,28,0.714,102,52,90,0.578,35,57,0.614,17,33,0.515,9,9,1.0,130,2014-04-06,UTA,GSW
6123,23,Home,W 102-91 ,240,34,61,0.557,22,34,0.647,12,27,0.444,22,30,0.733,102,33,88,0.375,18,46,0.391,15,42,0.357,10,13,0.769,91,2014-04-06,MIA,NYK
6124,24,@,W 102-95 ,240,37,86,0.43,31,69,0.449,6,17,0.353,22,32,0.688,102,34,89,0.382,25,54,0.463,9,35,0.257,18,24,0.75,95,2014-04-08,DET,ATL
6125,25,@,L 102-107 ,240,38,73,0.521,23,48,0.479,15,25,0.6,11,12,0.917,102,43,78,0.551,36,58,0.621,7,20,0.35,14,21,0.667,107,2014-04-09,MIA,MEM
6126,26,Home,L 102-104 ,240,38,87,0.437,34,71,0.479,4,16,0.25,22,29,0.759,102,41,85,0.482,30,61,0.492,11,24,0.458,11,19,0.579,104,2014-04-09,MIL,IND
6127,27,@,W 102-87 ,240,41,82,0.5,30,61,0.492,11,21,0.524,9,12,0.75,102,34,80,0.425,30,63,0.476,4,17,0.235,15,16,0.938,87,2014-04-09,CHI,MIN
6128,28,Home,W 102-97 ,240,38,72,0.528,29,52,0.558,9,20,0.45,17,23,0.739,102,36,84,0.429,29,56,0.518,7,28,0.25,18,19,0.947,97,2014-04-13,IND,OKC
6129,29,@,W 102-90 ,240,42,88,0.477,34,73,0.466,8,15,0.533,10,13,0.769,102,35,80,0.438,24,53,0.453,11,27,0.407,9,11,0.818,90,2014-04-13,MEM,LAL
6130,30,Home,L 102-118 ,240,39,84,0.464,32,54,0.593,7,30,0.233,17,23,0.739,102,50,88,0.568,44,70,0.629,6,18,0.333,12,17,0.706,118,2014-04-16,BOS,WAS
6131,31,@,L 102-109 ,240,40,80,0.5,27,58,0.466,13,22,0.591,9,17,0.529,102,37,90,0.411,29,64,0.453,8,26,0.308,27,33,0.818,109,2014-10-29,ATL,TOR
6132,32,@,L 102-120 ,240,36,83,0.434,22,48,0.458,14,35,0.4,16,18,0.889,102,47,85,0.553,39,64,0.609,8,21,0.381,18,23,0.783,120,2014-10-30,UTA,DAL
6133,33,Home,W 102-92 ,240,35,69,0.507,28,49,0.571,7,20,0.35,25,33,0.758,102,31,81,0.383,19,49,0.388,12,32,0.375,18,21,0.857,92,2014-11-01,ATL,IND
6134,34,@,W 102-90 ,240,42,87,0.483,35,61,0.574,7,26,0.269,11,13,0.846,102,32,76,0.421,31,59,0.525,1,17,0.059,25,35,0.714,90,2014-11-01,BRK,DET
6135,35,Home,W 102-91 ,240,37,80,0.463,31,60,0.517,6,20,0.3,22,31,0.71,102,35,80,0.438,28,54,0.519,7,26,0.269,14,20,0.7,91,2014-11-01,OKC,DEN
6136,36,@,L 102-107 ,240,37,79,0.468,33,63,0.524,4,16,0.25,24,39,0.615,102,35,70,0.5,26,46,0.565,9,24,0.375,28,38,0.737,107,2014-11-02,TOR,MIA
6137,37,@,W 102-91 ,240,40,80,0.5,31,63,0.492,9,17,0.529,13,17,0.765,102,32,69,0.464,24,48,0.5,8,21,0.381,19,21,0.905,91,2014-11-05,MEM,PHO
6138,38,Home,W 102-100 ,240,39,77,0.506,32,56,0.571,7,21,0.333,17,22,0.773,102,30,72,0.417,24,56,0.429,6,16,0.375,34,40,0.85,100,2014-11-05,UTA,CLE
6139,39,@,L 102-106 ,240,36,80,0.45,26,55,0.473,10,25,0.4,20,25,0.8,102,40,81,0.494,35,69,0.507,5,12,0.417,21,30,0.7,106,2014-11-08,POR,LAC
6140,40,Home,W 102-92 ,240,41,78,0.526,36,65,0.554,5,13,0.385,15,17,0.882,102,35,87,0.402,31,71,0.437,4,16,0.25,18,23,0.783,92,2014-11-08,MIA,MIN
6141,41,Home,W 102-91 ,240,39,88,0.443,32,68,0.471,7,20,0.35,17,20,0.85,102,34,80,0.425,27,66,0.409,7,14,0.5,16,25,0.64,91,2014-11-10,CHI,DET
6142,42,@,L 102-107 ,240,41,87,0.471,34,65,0.523,7,22,0.318,13,17,0.765,102,41,78,0.526,37,67,0.552,4,11,0.364,21,26,0.808,107,2014-11-11,LAL,MEM
6143,43,Home,W 102-100 ,240,40,93,0.43,32,68,0.471,8,25,0.32,14,16,0.875,102,35,75,0.467,28,59,0.475,7,16,0.438,23,27,0.852,100,2014-11-11,POR,CHO
6144,44,@,L 102-109 ,240,35,84,0.417,28,63,0.444,7,21,0.333,25,32,0.781,102,45,82,0.549,37,63,0.587,8,19,0.421,11,18,0.611,109,2014-11-12,LAL,NOP
6145,45,@,W 102-100 ,240,36,70,0.514,26,48,0.542,10,22,0.455,20,25,0.8,102,39,82,0.476,34,74,0.459,5,8,0.625,17,20,0.85,100,2014-11-14,UTA,NYK
6146,46,Home,W 102-93 ,240,38,76,0.5,31,57,0.544,7,19,0.368,19,23,0.826,102,38,85,0.447,33,66,0.5,5,19,0.263,12,19,0.632,93,2014-11-17,POR,NOP
6147,47,Home,L 102-105 ,240,37,84,0.44,27,62,0.435,10,22,0.455,18,21,0.857,102,34,82,0.415,22,54,0.407,12,28,0.429,25,29,0.862,105,2014-11-19,WAS,DAL
6148,48,Home,L 102-106 ,240,36,84,0.429,27,64,0.422,9,20,0.45,21,29,0.724,102,36,85,0.424,29,60,0.483,7,25,0.28,27,34,0.794,106,2014-11-25,WAS,ATL
6149,49,@,L 102-109 (OT),265,39,92,0.424,25,64,0.391,14,28,0.5,10,16,0.625,102,38,95,0.4,34,64,0.531,4,31,0.129,29,38,0.763,109,2014-11-26,NYK,DAL
6150,50,Home,W 102-89 ,240,42,94,0.447,30,59,0.508,12,35,0.343,6,15,0.4,102,31,71,0.437,26,55,0.473,5,16,0.313,22,28,0.786,89,2014-11-26,HOU,SAC
6151,51,Home,L 102-109 ,240,37,92,0.402,31,70,0.443,6,22,0.273,22,29,0.759,102,37,90,0.411,32,73,0.438,5,17,0.294,30,37,0.811,109,2014-11-28,BOS,CHI
6152,52,@,W 102-85 ,240,38,81,0.469,29,56,0.518,9,25,0.36,17,22,0.773,102,32,82,0.39,22,45,0.489,10,37,0.27,11,15,0.733,85,2014-11-28,LAC,HOU
6153,53,Home,L 102-106 ,240,38,91,0.418,24,58,0.414,14,33,0.424,12,16,0.75,102,40,86,0.465,29,60,0.483,11,26,0.423,15,22,0.682,106,2014-11-28,TOR,DAL
6154,54,@,W 102-84 ,240,34,69,0.493,27,45,0.6,7,24,0.292,27,34,0.794,102,32,86,0.372,30,72,0.417,2,14,0.143,18,24,0.75,84,2014-11-30,CHI,BRK
6155,55,@,L 102-109 (OT),265,37,102,0.363,29,75,0.387,8,27,0.296,20,29,0.69,102,37,93,0.398,24,63,0.381,13,30,0.433,22,27,0.815,109,2014-12-03,DET,BOS
6156,56,@,W 102-95 ,240,37,80,0.463,25,52,0.481,12,28,0.429,16,21,0.762,102,36,90,0.4,34,75,0.453,2,15,0.133,21,23,0.913,95,2014-12-03,CHI,CHO
6157,57,Home,L 102-112 ,240,36,64,0.563,30,48,0.625,6,16,0.375,24,32,0.75,102,40,74,0.541,28,49,0.571,12,25,0.48,20,23,0.87,112,2014-12-03,MIA,ATL
6158,58,@,L 102-103 ,240,37,79,0.468,27,57,0.474,10,22,0.455,18,22,0.818,102,42,88,0.477,38,70,0.543,4,18,0.222,15,18,0.833,103,2014-12-05,NYK,CHO
6159,59,Home,W 102-101 (OT),265,36,83,0.434,34,73,0.466,2,10,0.2,28,40,0.7,102,36,96,0.375,30,70,0.429,6,26,0.231,23,29,0.793,101,2014-12-05,SAC,IND
6160,60,Home,L 102-112 ,240,36,83,0.434,29,62,0.468,7,21,0.333,23,27,0.852,102,40,89,0.449,28,59,0.475,12,30,0.4,20,25,0.8,112,2014-12-06,CHI,GSW
6161,61,@,L 102-125 ,240,42,84,0.5,38,69,0.551,4,15,0.267,14,17,0.824,102,49,84,0.583,37,53,0.698,12,31,0.387,15,19,0.789,125,2014-12-07,MIL,DAL
6162,62,@,W 102-86 ,240,42,91,0.462,37,69,0.536,5,22,0.227,13,14,0.929,102,32,88,0.364,30,77,0.39,2,11,0.182,20,29,0.69,86,2014-12-08,GSW,MIN
6163,63,Home,W 102-82 ,240,38,85,0.447,30,62,0.484,8,23,0.348,18,27,0.667,102,30,82,0.366,23,60,0.383,7,22,0.318,15,21,0.714,82,2014-12-10,DEN,MIA
6164,64,Home,W 102-100 ,240,34,78,0.436,28,60,0.467,6,18,0.333,28,45,0.622,102,40,90,0.444,36,71,0.507,4,19,0.211,16,23,0.696,100,2014-12-17,LAC,IND
6165,65,@,L 102-106 ,240,43,81,0.531,35,57,0.614,8,24,0.333,8,15,0.533,102,37,81,0.457,25,55,0.455,12,26,0.462,20,27,0.741,106,2014-12-20,MIL,LAC
6166,66,Home,L 102-105 ,240,39,90,0.433,28,62,0.452,11,28,0.393,13,20,0.65,102,40,81,0.494,33,62,0.532,7,19,0.368,18,27,0.667,105,2014-12-22,DAL,ATL
6167,67,Home,W 102-96 ,240,43,91,0.473,37,68,0.544,6,23,0.261,10,14,0.714,102,36,82,0.439,29,57,0.509,7,25,0.28,17,22,0.773,96,2014-12-23,BRK,DEN
6168,68,@,W 102-91 ,240,44,86,0.512,37,70,0.529,7,16,0.438,7,10,0.7,102,36,80,0.45,32,58,0.552,4,22,0.182,15,19,0.789,91,2014-12-25,WAS,NYK
6169,69,Home,W 102-98 ,240,42,83,0.506,37,65,0.569,5,18,0.278,13,24,0.542,102,36,99,0.364,25,70,0.357,11,29,0.379,15,20,0.75,98,2014-12-26,DAL,LAL
6170,70,@,L 102-106 ,240,41,103,0.398,38,88,0.432,3,15,0.2,17,24,0.708,102,39,95,0.411,36,76,0.474,3,19,0.158,25,32,0.781,106,2014-12-26,MIN,DEN
6171,71,@,W 102-94 ,240,38,83,0.458,30,63,0.476,8,20,0.4,18,24,0.75,102,36,86,0.419,28,62,0.452,8,24,0.333,14,18,0.778,94,2014-12-27,ORL,CHO
6172,72,Home,L 102-116 ,240,37,87,0.425,33,70,0.471,4,17,0.235,24,34,0.706,102,43,88,0.489,33,65,0.508,10,23,0.435,20,32,0.625,116,2014-12-28,DEN,TOR
6173,73,@,W 102-101 ,240,41,77,0.532,30,52,0.577,11,25,0.44,9,13,0.692,102,33,63,0.524,26,49,0.531,7,14,0.5,28,40,0.7,101,2014-12-29,ORL,MIA
6174,74,Home,W 102-97 (OT),265,38,95,0.4,26,59,0.441,12,36,0.333,14,18,0.778,102,40,99,0.404,36,77,0.468,4,22,0.182,13,15,0.867,97,2014-12-30,POR,TOR
6175,75,Home,W 102-83 ,240,38,88,0.432,21,45,0.467,17,43,0.395,9,14,0.643,102,29,76,0.382,26,58,0.448,3,18,0.167,22,26,0.846,83,2014-12-31,HOU,CHO
6176,76,@,L 102-109 ,240,39,84,0.464,28,63,0.444,11,21,0.524,13,15,0.867,102,44,83,0.53,36,64,0.563,8,19,0.421,13,19,0.684,109,2015-01-02,WAS,OKC
6177,77,@,W 102-96 ,240,37,81,0.457,30,56,0.536,7,25,0.28,21,27,0.778,102,37,88,0.42,34,68,0.5,3,20,0.15,19,22,0.864,96,2015-01-06,PHO,MIL
6178,78,@,L 102-117 ,240,37,81,0.457,31,55,0.564,6,26,0.231,22,23,0.957,102,45,91,0.495,33,63,0.524,12,28,0.429,15,20,0.75,117,2015-01-07,IND,GSW
6179,79,Home,W 102-86 ,240,41,86,0.477,33,71,0.465,8,15,0.533,12,19,0.632,102,32,83,0.386,22,57,0.386,10,26,0.385,12,19,0.632,86,2015-01-09,WAS,CHI
6180,80,Home,L 102-109 ,240,39,76,0.513,31,52,0.596,8,24,0.333,16,23,0.696,102,37,78,0.474,28,48,0.583,9,30,0.3,26,36,0.722,109,2015-01-15,LAL,CLE
6181,81,@,W 102-80 ,240,37,81,0.457,33,69,0.478,4,12,0.333,24,31,0.774,102,31,73,0.425,27,56,0.482,4,17,0.235,14,16,0.875,80,2015-01-16,BRK,WAS
6182,82,Home,W 102-98 ,240,39,77,0.506,31,62,0.5,8,15,0.533,16,24,0.667,102,36,93,0.387,23,57,0.404,13,36,0.361,13,15,0.867,98,2015-01-17,MEM,POR
6183,83,Home,W 102-93 ,240,39,82,0.476,30,61,0.492,9,21,0.429,15,19,0.789,102,33,84,0.393,21,55,0.382,12,29,0.414,15,21,0.714,93,2015-01-19,LAC,BOS
6184,84,@,W 102-98 ,240,38,78,0.487,29,62,0.468,9,16,0.563,17,20,0.85,102,37,82,0.451,31,64,0.484,6,18,0.333,18,18,1.0,98,2015-01-23,CHI,DAL
6185,85,Home,W 102-98 ,240,38,80,0.475,31,61,0.508,7,19,0.368,19,22,0.864,102,40,83,0.482,32,62,0.516,8,21,0.381,10,15,0.667,98,2015-01-26,LAC,DEN
6186,86,Home,L 102-109 ,240,38,75,0.507,31,55,0.564,7,20,0.35,19,26,0.731,102,39,71,0.549,30,55,0.545,9,16,0.563,22,30,0.733,109,2015-01-27,MIA,MIL
6187,87,@,L 102-113 ,240,39,87,0.448,30,63,0.476,9,24,0.375,15,18,0.833,102,38,82,0.463,26,49,0.531,12,33,0.364,25,26,0.962,113,2015-01-28,BRK,ATL
6188,88,@,L 102-119 ,240,35,73,0.479,28,56,0.5,7,17,0.412,25,29,0.862,102,43,84,0.512,26,50,0.52,17,34,0.5,16,19,0.842,119,2015-01-28,SAC,TOR
6189,89,Home,W 102-100 ,240,41,83,0.494,29,56,0.518,12,27,0.444,8,18,0.444,102,42,89,0.472,34,66,0.515,8,23,0.348,8,25,0.32,100,2015-02-02,BRK,LAC
6190,90,@,W 102-101 ,240,36,83,0.434,33,72,0.458,3,11,0.273,27,34,0.794,102,42,84,0.5,36,68,0.529,6,16,0.375,11,18,0.611,101,2015-02-02,MEM,PHO
6191,91,@,L 102-103 ,240,39,85,0.459,33,72,0.458,6,13,0.462,18,26,0.692,102,36,76,0.474,29,53,0.547,7,23,0.304,24,34,0.706,103,2015-02-03,UTA,POR
6192,92,Home,W 102-101 ,240,37,72,0.514,31,61,0.508,6,11,0.545,22,27,0.815,102,39,80,0.488,32,64,0.5,7,16,0.438,16,24,0.667,101,2015-02-04,MIN,MIA
6193,93,@,W 102-91 ,240,45,85,0.529,40,70,0.571,5,15,0.333,7,11,0.636,102,37,97,0.381,30,72,0.417,7,25,0.28,10,13,0.769,91,2015-02-04,OKC,NOP
6194,94,Home,W 102-90 ,240,43,86,0.5,38,67,0.567,5,19,0.263,11,17,0.647,102,32,82,0.39,29,69,0.42,3,13,0.231,23,33,0.697,90,2015-02-07,UTA,SAC
6195,95,Home,L 102-103 ,240,36,77,0.468,28,63,0.444,8,14,0.571,22,28,0.786,102,37,84,0.44,30,65,0.462,7,19,0.368,22,25,0.88,103,2015-02-08,CHA,IND
6196,96,Home,W 102-86 ,240,35,86,0.407,25,56,0.446,10,30,0.333,22,23,0.957,102,34,93,0.366,27,77,0.351,7,16,0.438,11,11,1.0,86,2015-02-11,POR,LAL
6197,97,@,L 102-113 ,240,31,93,0.333,26,75,0.347,5,18,0.278,35,39,0.897,102,39,94,0.415,27,56,0.482,12,38,0.316,23,34,0.676,113,2015-02-23,MIN,HOU
6198,98,@,W 102-93 ,240,34,77,0.442,20,40,0.5,14,37,0.378,20,24,0.833,102,33,82,0.402,24,58,0.414,9,24,0.375,18,30,0.6,93,2015-02-24,CLE,DET
6199,99,Home,W 102-96 ,240,38,74,0.514,27,49,0.551,11,25,0.44,15,19,0.789,102,39,92,0.424,32,71,0.451,7,21,0.333,11,15,0.733,96,2015-02-25,NOP,BRK
6200,0,Home,W 102-90 ,240,39,80,0.488,33,64,0.516,6,16,0.375,18,25,0.72,102,34,84,0.405,30,68,0.441,4,16,0.25,18,23,0.783,90,2015-02-25,SAC,MEM
6201,1,Home,W 102-98 ,240,39,84,0.464,30,52,0.577,9,32,0.281,15,17,0.882,102,38,85,0.447,34,68,0.5,4,17,0.235,18,20,0.9,98,2015-02-27,HOU,BRK
6202,2,@,L 102-104 ,240,41,84,0.488,33,63,0.524,8,21,0.381,12,16,0.75,102,39,76,0.513,33,60,0.55,6,16,0.375,20,27,0.741,104,2015-02-27,MIA,NOP
6203,3,Home,W 102-93 ,240,38,79,0.481,32,63,0.508,6,16,0.375,20,22,0.909,102,35,74,0.473,25,53,0.472,10,21,0.476,13,16,0.813,93,2015-03-02,DAL,NOP
6204,4,Home,W 102-93 ,240,37,73,0.507,23,39,0.59,14,34,0.412,14,25,0.56,102,34,80,0.425,29,66,0.439,5,14,0.357,20,25,0.8,93,2015-03-04,GSW,MIL
6205,5,@,W 102-100 ,240,42,83,0.506,38,67,0.567,4,16,0.25,14,17,0.824,102,42,86,0.488,31,58,0.534,11,28,0.393,5,5,1.0,100,2015-03-04,MEM,HOU
6206,6,@,L 102-115 ,240,34,81,0.42,25,54,0.463,9,27,0.333,25,27,0.926,102,42,84,0.5,29,53,0.547,13,31,0.419,18,20,0.9,115,2015-03-11,ATL,DEN
6207,7,Home,W 102-92 ,240,34,79,0.43,22,46,0.478,12,33,0.364,22,31,0.71,102,35,79,0.443,30,56,0.536,5,23,0.217,17,24,0.708,92,2015-03-13,TOR,MIA
6208,8,Home,W 102-89 ,240,41,83,0.494,35,65,0.538,6,18,0.333,14,23,0.609,102,32,73,0.438,27,59,0.458,5,14,0.357,20,30,0.667,89,2015-03-15,PHO,NYK
6209,9,@,L 102-107 ,240,40,87,0.46,31,59,0.525,9,28,0.321,13,14,0.929,102,39,80,0.488,26,49,0.531,13,31,0.419,16,24,0.667,107,2015-03-18,ORL,DAL
6210,10,Home,L 102-117 ,240,41,87,0.471,31,53,0.585,10,34,0.294,10,12,0.833,102,46,92,0.5,38,77,0.494,8,15,0.533,17,24,0.708,117,2015-03-21,HOU,PHO
6211,11,Home,W 102-88 ,240,43,84,0.512,34,64,0.531,9,20,0.45,7,12,0.583,102,35,79,0.443,28,64,0.438,7,15,0.467,11,18,0.611,88,2015-03-27,NOP,SAC
6212,12,@,L 102-109 ,240,40,83,0.482,32,58,0.552,8,25,0.32,14,22,0.636,102,39,82,0.476,32,64,0.5,7,18,0.389,24,29,0.828,109,2015-03-29,DET,MIA
6213,13,Home,W 102-78 ,240,38,90,0.422,29,68,0.426,9,22,0.409,17,24,0.708,102,31,88,0.352,26,66,0.394,5,22,0.227,11,18,0.611,78,2015-04-01,CHA,DET
6214,14,@,W 102-86 ,240,38,77,0.494,34,55,0.618,4,22,0.182,22,27,0.815,102,29,84,0.345,22,67,0.328,7,17,0.412,21,26,0.808,86,2015-04-08,IND,NYK
6215,15,Home,W 102-92 ,240,35,72,0.486,31,56,0.554,4,16,0.25,28,36,0.778,102,40,96,0.417,36,81,0.444,4,15,0.267,8,13,0.615,92,2015-04-13,SAC,LAL
6216,16,Home,W 102-92 ,240,39,86,0.453,33,61,0.541,6,25,0.24,18,21,0.857,102,33,77,0.429,27,56,0.482,6,21,0.286,20,22,0.909,92,2015-10-30,CLE,MIA
6217,17,Home,W 102-75 ,240,40,86,0.465,31,64,0.484,9,22,0.409,13,13,1.0,102,31,77,0.403,26,61,0.426,5,16,0.313,8,15,0.533,75,2015-10-30,SAS,BRK
6218,18,Home,W 102-96 ,240,37,81,0.457,29,55,0.527,8,26,0.308,20,23,0.87,102,36,98,0.367,27,68,0.397,9,30,0.3,15,21,0.714,96,2015-11-02,LAC,PHO
6219,19,@,W 102-91 ,240,37,82,0.451,32,65,0.492,5,17,0.294,23,26,0.885,102,33,86,0.384,26,63,0.413,7,23,0.304,18,25,0.72,91,2015-11-03,TOR,DAL
6220,20,Home,W 102-99 ,240,42,87,0.483,34,64,0.531,8,23,0.348,10,14,0.714,102,37,81,0.457,30,59,0.508,7,22,0.318,18,20,0.9,99,2015-11-04,WAS,SAS
6221,21,@,L 102-108 ,240,41,79,0.519,31,56,0.554,10,23,0.435,10,15,0.667,102,45,88,0.511,35,62,0.565,10,26,0.385,8,12,0.667,108,2015-11-06,PHI,CLE
6222,22,@,W 102-93 (OT),265,39,96,0.406,32,80,0.4,7,16,0.438,17,27,0.63,102,33,93,0.355,22,61,0.361,11,32,0.344,16,23,0.696,93,2015-11-07,MIN,CHI
6223,23,@,W 102-91 ,240,38,79,0.481,32,62,0.516,6,17,0.353,20,31,0.645,102,32,77,0.416,28,53,0.528,4,24,0.167,23,32,0.719,91,2015-11-11,IND,BOS
6224,24,@,L 102-103 ,240,42,79,0.532,32,57,0.561,10,22,0.455,8,9,0.889,102,39,79,0.494,31,55,0.564,8,24,0.333,17,24,0.708,103,2015-11-11,MIL,DEN
6225,25,Home,W 102-97 ,240,37,84,0.44,33,68,0.485,4,16,0.25,24,31,0.774,102,36,95,0.379,21,62,0.339,15,33,0.455,10,12,0.833,97,2015-11-13,CHI,CHO
6226,26,Home,W 102-85 ,240,39,97,0.402,31,72,0.431,8,25,0.32,16,21,0.762,102,30,86,0.349,25,69,0.362,5,17,0.294,20,28,0.714,85,2015-11-13,OKC,PHI
6227,27,Home,W 102-93 ,240,32,76,0.421,22,49,0.449,10,27,0.37,28,31,0.903,102,34,87,0.391,26,62,0.419,8,25,0.32,17,23,0.739,93,2015-11-13,ORL,UTA
6228,28,Home,W 102-94 ,240,36,89,0.404,26,69,0.377,10,20,0.5,20,21,0.952,102,36,82,0.439,31,62,0.5,5,20,0.25,17,25,0.68,94,2015-11-17,NYK,CHO
6229,29,Home,L 102-106 ,240,38,92,0.413,30,66,0.455,8,26,0.308,18,24,0.75,102,37,72,0.514,30,52,0.577,7,20,0.35,25,35,0.714,106,2015-11-18,BOS,DAL
6230,30,Home,W 102-93 ,240,39,83,0.47,31,55,0.564,8,28,0.286,16,17,0.941,102,35,80,0.438,29,60,0.483,6,20,0.3,17,21,0.81,93,2015-11-20,DAL,UTA
6231,31,@,W 102-91 ,240,34,78,0.436,19,45,0.422,15,33,0.455,19,24,0.792,102,35,77,0.455,27,52,0.519,8,25,0.32,13,17,0.765,91,2015-11-20,TOR,LAL
6232,32,Home,W 102-91 ,240,38,90,0.422,30,65,0.462,8,25,0.32,18,24,0.75,102,38,86,0.442,31,62,0.5,7,24,0.292,8,16,0.5,91,2015-11-20,POR,LAC
6233,33,Home,L 102-107 ,240,35,81,0.432,23,53,0.434,12,28,0.429,20,28,0.714,102,34,80,0.425,22,55,0.4,12,25,0.48,27,34,0.794,107,2015-11-21,HOU,NYK
6234,34,@,W 102-93 ,240,39,80,0.488,36,64,0.563,3,16,0.188,21,23,0.913,102,30,71,0.423,20,37,0.541,10,34,0.294,23,27,0.852,93,2015-11-25,MEM,HOU
6235,35,@,W 102-91 ,240,39,77,0.506,33,64,0.516,6,13,0.462,18,25,0.72,102,38,75,0.507,34,63,0.54,4,12,0.333,11,17,0.647,91,2015-11-25,UTA,LAC
6236,36,Home,L 102-107 ,240,38,86,0.442,26,57,0.456,12,29,0.414,14,17,0.824,102,40,94,0.426,29,67,0.433,11,27,0.407,16,20,0.8,107,2015-11-29,TOR,PHO
6237,37,Home,W 102-87 ,240,33,85,0.388,25,66,0.379,8,19,0.421,28,56,0.5,102,33,87,0.379,28,64,0.438,5,23,0.217,16,27,0.593,87,2015-11-30,LAC,POR
6238,38,Home,W 102-95 ,240,34,82,0.415,27,59,0.458,7,23,0.304,27,39,0.692,102,39,87,0.448,35,69,0.507,4,18,0.222,13,14,0.929,95,2015-12-04,DET,MIL
6239,39,@,W 102-96 ,240,37,89,0.416,27,55,0.491,10,34,0.294,18,25,0.72,102,37,89,0.416,28,64,0.438,9,25,0.36,13,19,0.684,96,2015-12-05,CHA,CHI
6240,40,Home,W 102-93 ,240,34,74,0.459,25,49,0.51,9,25,0.36,25,32,0.781,102,34,83,0.41,27,64,0.422,7,19,0.368,18,20,0.9,93,2015-12-07,TOR,LAL
6241,41,@,L 102-107 ,240,42,101,0.416,38,80,0.475,4,21,0.19,14,14,1.0,102,37,85,0.435,29,64,0.453,8,21,0.381,25,30,0.833,107,2015-12-16,MIN,NYK
6242,42,Home,W 102-94 ,240,39,84,0.464,37,69,0.536,2,15,0.133,22,31,0.71,102,32,73,0.438,21,41,0.512,11,32,0.344,19,26,0.731,94,2015-12-18,ORL,POR
6243,43,Home,L 102-105 ,240,43,95,0.453,34,69,0.493,9,26,0.346,7,13,0.538,102,43,94,0.457,36,74,0.486,7,20,0.35,12,14,0.857,105,2015-12-21,CHI,BRK
6244,44,Home,W 102-95 ,240,33,71,0.465,26,43,0.605,7,28,0.25,29,41,0.707,102,29,83,0.349,17,42,0.405,12,41,0.293,25,31,0.806,95,2015-12-21,HOU,CHO
6245,45,@,W 102-89 ,240,36,85,0.424,29,56,0.518,7,29,0.241,23,26,0.885,102,29,81,0.358,21,53,0.396,8,28,0.286,23,32,0.719,89,2015-12-23,BOS,CHO
6246,46,@,W 102-88 ,240,40,80,0.5,31,54,0.574,9,26,0.346,13,14,0.929,102,35,75,0.467,31,63,0.492,4,12,0.333,14,18,0.778,88,2015-12-26,IND,MIN
6247,47,Home,W 102-100 (OT),265,37,86,0.43,31,68,0.456,6,18,0.333,22,27,0.815,102,37,97,0.381,30,75,0.4,7,22,0.318,19,24,0.792,100,2015-12-30,CHI,IND
6248,48,@,L 102-111 ,240,38,87,0.437,27,59,0.458,11,28,0.393,15,22,0.682,102,41,84,0.488,22,51,0.431,19,33,0.576,10,13,0.769,111,2016-01-06,CHA,PHO
6249,49,@,L 102-115 ,240,36,80,0.45,30,55,0.545,6,25,0.24,24,36,0.667,102,42,83,0.506,29,55,0.527,13,28,0.464,18,24,0.75,115,2016-01-21,LAC,CLE
6250,50,@,W 102-101 ,240,36,72,0.5,30,51,0.588,6,21,0.286,24,29,0.828,102,36,80,0.45,27,50,0.54,9,30,0.3,20,26,0.769,101,2016-01-21,MEM,DEN
6251,51,Home,W 102-98 ,240,38,94,0.404,23,50,0.46,15,44,0.341,11,16,0.688,102,39,85,0.459,36,71,0.507,3,14,0.214,17,22,0.773,98,2016-01-22,HOU,MIL
6252,52,@,L 102-108 (OT),265,40,86,0.465,30,58,0.517,10,28,0.357,12,14,0.857,102,43,100,0.43,37,82,0.451,6,18,0.333,16,25,0.64,108,2016-01-25,ORL,MEM
6253,53,@,W 102-98 ,240,45,83,0.542,42,74,0.568,3,9,0.333,9,10,0.9,102,36,71,0.507,27,53,0.509,9,18,0.5,17,23,0.739,98,2016-01-26,MIA,BRK
6254,54,Home,W 102-73 ,240,40,81,0.494,28,50,0.56,12,31,0.387,10,15,0.667,102,25,68,0.368,19,43,0.442,6,25,0.24,17,21,0.81,73,2016-01-27,UTA,CHO
6255,55,Home,W 102-84 ,240,36,84,0.429,29,64,0.453,7,20,0.35,23,26,0.885,102,35,85,0.412,28,59,0.475,7,26,0.269,7,12,0.583,84,2016-01-29,NYK,PHO
6256,56,@,L 102-115 ,240,38,85,0.447,32,68,0.471,6,17,0.353,20,27,0.741,102,44,84,0.524,28,49,0.571,16,35,0.457,11,16,0.688,115,2016-02-02,MIA,HOU
6257,57,Home,W 102-95 ,240,42,96,0.438,35,75,0.467,7,21,0.333,11,13,0.846,102,32,85,0.376,21,51,0.412,11,34,0.324,20,28,0.714,95,2016-02-03,BOS,DET
6258,58,Home,L 102-108 ,240,33,75,0.44,22,43,0.512,11,32,0.344,25,34,0.735,102,39,77,0.506,31,60,0.517,8,17,0.471,22,26,0.846,108,2016-02-03,LAC,MIN
6259,59,Home,L 102-107 ,240,42,88,0.477,36,68,0.529,6,20,0.3,12,19,0.632,102,40,88,0.455,29,67,0.433,11,21,0.524,16,21,0.762,107,2016-02-03,SAC,CHI
6260,60,Home,W 102-96 ,240,39,76,0.513,29,49,0.592,10,27,0.37,14,20,0.7,102,38,91,0.418,25,60,0.417,13,31,0.419,7,9,0.778,96,2016-02-05,ATL,IND
6261,61,@,L 102-106 ,240,34,86,0.395,24,56,0.429,10,30,0.333,24,27,0.889,102,39,88,0.443,31,64,0.484,8,24,0.333,20,25,0.8,106,2016-02-06,LAL,SAS
6262,62,Home,L 102-116 ,240,36,81,0.444,34,69,0.493,2,12,0.167,28,35,0.8,102,47,97,0.485,37,73,0.507,10,24,0.417,12,20,0.6,116,2016-02-08,MIN,NOP
6263,63,Home,L 102-105 ,240,38,91,0.418,31,66,0.47,7,25,0.28,19,29,0.655,102,41,82,0.5,32,58,0.552,9,24,0.375,14,21,0.667,105,2016-02-21,ORL,IND
6264,64,@,W 102-92 ,240,39,89,0.438,25,44,0.568,14,45,0.311,10,12,0.833,102,36,86,0.419,26,52,0.5,10,34,0.294,10,16,0.625,92,2016-02-22,GSW,ATL
6265,65,@,W 102-91 ,240,37,88,0.42,25,58,0.431,12,30,0.4,16,24,0.667,102,38,78,0.487,31,66,0.47,7,12,0.583,8,12,0.667,91,2016-02-27,DET,MIL
6266,66,Home,L 102-111 ,240,40,93,0.43,37,79,0.468,3,14,0.214,19,25,0.76,102,41,81,0.506,27,57,0.474,14,24,0.583,15,21,0.714,111,2016-02-28,IND,POR
6267,67,Home,W 102-89 ,240,39,97,0.402,32,76,0.421,7,21,0.333,17,22,0.773,102,38,99,0.384,32,80,0.4,6,19,0.316,7,11,0.636,89,2016-03-02,ORL,CHI
6268,68,@,W 102-84 ,240,35,78,0.449,30,64,0.469,5,14,0.357,27,39,0.692,102,35,101,0.347,28,74,0.378,7,27,0.259,7,14,0.5,84,2016-03-04,PHO,ORL
6269,69,Home,L 102-112 ,240,36,95,0.379,27,64,0.422,9,31,0.29,21,27,0.778,102,39,88,0.443,34,72,0.472,5,16,0.313,29,36,0.806,112,2016-03-04,PHI,MIA
6270,70,Home,W 102-89 ,240,42,79,0.532,38,63,0.603,4,16,0.25,14,18,0.778,102,36,92,0.391,30,66,0.455,6,26,0.231,11,15,0.733,89,2016-03-05,NYK,DET
6271,71,@,W 102-96 ,240,38,85,0.447,29,58,0.5,9,27,0.333,17,30,0.567,102,39,86,0.453,30,56,0.536,9,30,0.3,9,11,0.818,96,2016-03-09,DET,DAL
6272,72,@,W 102-98 ,240,40,88,0.455,35,62,0.565,5,26,0.192,17,25,0.68,102,34,91,0.374,26,60,0.433,8,31,0.258,22,28,0.786,98,2016-03-11,HOU,BOS
6273,73,@,L 102-118 ,240,40,86,0.465,34,65,0.523,6,21,0.286,16,20,0.8,102,46,94,0.489,35,70,0.5,11,24,0.458,15,15,1.0,118,2016-03-17,BRK,CHI
6274,74,@,L 102-113 ,240,31,66,0.47,19,36,0.528,12,30,0.4,28,39,0.718,102,40,82,0.488,36,67,0.537,4,15,0.267,29,36,0.806,113,2016-03-19,LAC,MEM
6275,75,Home,L 102-117 ,240,38,78,0.487,25,45,0.556,13,33,0.394,13,17,0.765,102,46,91,0.505,33,66,0.5,13,25,0.52,12,20,0.6,117,2016-03-21,ATL,WAS
6276,76,@,L 102-109 ,240,40,88,0.455,31,59,0.525,9,29,0.31,13,16,0.813,102,41,91,0.451,29,67,0.433,12,24,0.5,15,23,0.652,109,2016-03-21,SAC,CHI
6277,77,@,L 102-118 ,240,39,98,0.398,31,73,0.425,8,25,0.32,16,19,0.842,102,43,80,0.538,32,56,0.571,11,24,0.458,21,25,0.84,118,2016-03-23,ORL,DET
6278,78,@,W 102-99 ,240,35,84,0.417,27,55,0.491,8,29,0.276,24,27,0.889,102,37,85,0.435,30,54,0.556,7,31,0.226,18,21,0.857,99,2016-03-26,BOS,PHO
6279,79,@,W 102-100 ,240,36,85,0.424,31,63,0.492,5,22,0.227,25,28,0.893,102,40,106,0.377,31,84,0.369,9,22,0.409,11,15,0.733,100,2016-03-28,ATL,CHI
6280,80,Home,W 102-94 ,240,38,87,0.437,27,62,0.435,11,25,0.44,15,23,0.652,102,36,86,0.419,31,63,0.492,5,23,0.217,17,27,0.63,94,2016-03-29,GSW,WAS
6281,81,Home,W 102-100 (OT),265,37,102,0.363,31,82,0.378,6,20,0.3,22,29,0.759,102,41,86,0.477,38,69,0.551,3,17,0.176,15,26,0.577,100,2016-03-30,LAL,MIA
6282,82,Home,L 102-115 ,240,34,83,0.41,18,46,0.391,16,37,0.432,18,26,0.692,102,44,84,0.524,36,61,0.59,8,23,0.348,19,23,0.826,115,2016-04-02,PHI,IND
6283,83,Home,W 102-95 ,240,35,77,0.455,30,57,0.526,5,20,0.25,27,30,0.9,102,40,80,0.5,34,62,0.548,6,18,0.333,9,10,0.9,95,2016-04-02,SAS,TOR
6284,84,@,W 102-98 ,240,39,74,0.527,32,48,0.667,7,26,0.269,17,22,0.773,102,40,85,0.471,38,78,0.487,2,7,0.286,16,20,0.8,98,2016-04-03,CHI,MIL
6285,85,Home,L 102-124 ,240,37,88,0.42,27,58,0.466,10,30,0.333,18,27,0.667,102,46,87,0.529,31,54,0.574,15,33,0.455,17,24,0.708,124,2016-04-05,DEN,OKC
6286,86,Home,W 102-98 ,240,40,86,0.465,34,64,0.531,6,22,0.273,16,19,0.842,102,36,85,0.424,33,71,0.465,3,14,0.214,23,28,0.821,98,2016-04-08,DEN,SAS
6287,87,@,L 102-110 ,240,34,81,0.42,23,57,0.404,11,24,0.458,23,27,0.852,102,42,79,0.532,32,57,0.561,10,22,0.455,16,21,0.762,110,2016-04-08,LAL,NOP
6288,88,Home,L 102-109 ,240,32,91,0.352,18,54,0.333,14,37,0.378,24,36,0.667,102,43,91,0.473,39,75,0.52,4,16,0.25,19,30,0.633,109,2016-04-08,PHI,NYK
6289,89,@,W 102-99 (OT),265,37,83,0.446,24,54,0.444,13,29,0.448,15,19,0.789,102,36,82,0.439,25,51,0.49,11,31,0.355,16,23,0.696,99,2016-04-08,LAC,UTA
6290,90,@,L 102-105 ,240,36,83,0.434,17,43,0.395,19,40,0.475,11,18,0.611,102,40,89,0.449,32,65,0.492,8,24,0.333,17,21,0.81,105,2016-04-09,CLE,CHI
6291,91,Home,W 102-90 ,240,41,80,0.513,35,61,0.574,6,19,0.316,14,20,0.7,102,36,80,0.45,26,53,0.491,10,27,0.37,8,9,0.889,90,2016-04-12,IND,NYK
6292,92,Home,W 102-98 (OT),265,37,87,0.425,33,73,0.452,4,14,0.286,24,32,0.75,102,35,87,0.402,29,62,0.468,6,25,0.24,22,25,0.88,98,2016-04-12,SAS,OKC
6293,93,Home,W 102-98 ,240,36,80,0.45,25,56,0.446,11,24,0.458,19,27,0.704,102,36,86,0.419,30,68,0.441,6,18,0.333,20,29,0.69,98,2016-10-26,MEM,MIN
6294,94,Home,L 102-107 ,240,38,92,0.413,35,73,0.479,3,19,0.158,23,26,0.885,102,37,83,0.446,29,59,0.492,8,24,0.333,25,33,0.758,107,2016-10-26,NOP,DEN
6295,95,@,W 102-94 ,240,36,79,0.456,30,61,0.492,6,18,0.333,24,27,0.889,102,28,70,0.4,22,50,0.44,6,20,0.3,32,38,0.842,94,2016-10-27,SAS,SAC
6296,96,@,L 102-105 ,240,33,81,0.407,24,59,0.407,9,22,0.409,27,35,0.771,102,41,88,0.466,37,72,0.514,4,16,0.25,19,25,0.76,105,2016-10-31,DEN,TOR
6297,97,Home,W 102-89 ,240,41,89,0.461,33,76,0.434,8,13,0.615,12,21,0.571,102,35,86,0.407,28,64,0.438,7,22,0.318,12,15,0.8,89,2016-11-01,DET,NYK
6298,98,@,W 102-99 ,240,39,81,0.481,33,59,0.559,6,22,0.273,18,25,0.72,102,35,88,0.398,26,66,0.394,9,22,0.409,20,25,0.8,99,2016-11-03,DEN,MIN
6299,99,Home,W 102-94 ,240,38,84,0.452,28,54,0.519,10,30,0.333,16,23,0.696,102,38,80,0.475,31,62,0.5,7,18,0.389,11,17,0.647,94,2016-11-03,ORL,SAC
6300,0,@,W 102-101 ,240,37,91,0.407,23,53,0.434,14,38,0.368,14,18,0.778,102,40,87,0.46,26,49,0.531,14,38,0.368,7,12,0.583,101,2016-11-05,CLE,PHI
6301,1,Home,W 102-94 ,240,39,81,0.481,31,56,0.554,8,25,0.32,16,20,0.8,102,38,84,0.452,33,63,0.524,5,21,0.238,13,18,0.722,94,2016-11-08,SAC,NOP
6302,2,Home,L 102-112 ,240,31,74,0.419,19,40,0.475,12,34,0.353,28,31,0.903,102,43,83,0.518,32,57,0.561,11,26,0.423,15,22,0.682,112,2016-11-09,OKC,TOR
6303,3,@,W 102-91 ,240,40,81,0.494,34,61,0.557,6,20,0.3,16,19,0.842,102,38,81,0.469,33,64,0.516,5,17,0.294,10,19,0.526,91,2016-11-12,UTA,MIA
6304,4,@,W 102-96 ,240,36,76,0.474,28,55,0.509,8,21,0.381,22,26,0.846,102,35,73,0.479,27,45,0.6,8,28,0.286,18,22,0.818,96,2016-11-14,MEM,UTA
6305,5,@,L 102-105 ,240,42,85,0.494,34,62,0.548,8,23,0.348,10,12,0.833,102,42,93,0.452,33,68,0.485,9,25,0.36,12,19,0.632,105,2016-11-16,DET,NYK
6306,6,@,L 102-109 ,240,38,91,0.418,30,68,0.441,8,23,0.348,18,25,0.72,102,42,77,0.545,32,49,0.653,10,28,0.357,15,22,0.682,109,2016-11-16,WAS,PHI
6307,7,@,L 102-111 ,240,39,76,0.513,27,49,0.551,12,27,0.444,12,17,0.706,102,42,94,0.447,30,62,0.484,12,32,0.375,15,20,0.75,111,2016-11-19,UTA,HOU
6308,8,Home,W 102-95 ,240,36,77,0.468,25,50,0.5,11,27,0.407,19,23,0.826,102,33,77,0.429,24,47,0.511,9,30,0.3,20,24,0.833,95,2016-11-19,LAC,CHI
6309,9,Home,W 102-99 ,240,36,81,0.444,25,54,0.463,11,27,0.407,19,25,0.76,102,34,85,0.4,25,61,0.41,9,24,0.375,22,24,0.917,99,2016-11-20,SAC,TOR
6310,10,Home,L 102-115 ,240,38,78,0.487,24,36,0.667,14,42,0.333,12,12,1.0,102,43,88,0.489,31,65,0.477,12,23,0.522,17,21,0.81,115,2016-11-23,HOU,TOR
6311,11,@,L 102-107 ,240,37,98,0.378,25,66,0.379,12,32,0.375,16,20,0.8,102,35,80,0.438,27,58,0.466,8,22,0.364,29,42,0.69,107,2016-11-26,NYK,CHO
6312,12,@,L 102-115 ,240,41,89,0.461,31,54,0.574,10,35,0.286,10,12,0.833,102,45,81,0.556,34,59,0.576,11,22,0.5,14,17,0.824,115,2016-11-26,MIN,GSW
6313,13,Home,L 102-111 ,240,36,81,0.444,26,51,0.51,10,30,0.333,20,28,0.714,102,39,79,0.494,34,65,0.523,5,14,0.357,28,35,0.8,111,2016-12-04,LAC,IND
6314,14,@,W 102-99 ,240,37,80,0.463,27,49,0.551,10,31,0.323,18,28,0.643,102,34,77,0.442,27,55,0.491,7,22,0.318,24,32,0.75,99,2016-12-05,OKC,ATL
6315,15,Home,W 102-91 ,240,40,88,0.455,32,67,0.478,8,21,0.381,14,21,0.667,102,33,75,0.44,31,60,0.517,2,15,0.133,23,32,0.719,91,2016-12-06,DET,CHI
6316,16,@,W 102-99 ,240,36,92,0.391,25,50,0.5,11,42,0.262,19,30,0.633,102,34,81,0.42,27,53,0.509,7,28,0.25,24,31,0.774,99,2016-12-09,HOU,OKC
6317,17,Home,W 102-95 ,240,36,86,0.419,26,59,0.441,10,27,0.37,20,28,0.714,102,36,87,0.414,33,66,0.5,3,21,0.143,20,24,0.833,95,2016-12-15,NOP,IND
6318,18,@,W 102-98 ,240,36,83,0.434,29,58,0.5,7,25,0.28,23,29,0.793,102,38,93,0.409,32,66,0.485,6,27,0.222,16,25,0.64,98,2016-12-16,LAC,MIA
6319,19,@,W 102-100 ,240,36,77,0.468,24,54,0.444,12,23,0.522,18,25,0.72,102,35,92,0.38,29,54,0.537,6,38,0.158,24,27,0.889,100,2016-12-20,SAS,HOU
6320,20,@,L 102-119 ,240,39,90,0.433,28,51,0.549,11,39,0.282,13,20,0.65,102,47,86,0.547,31,50,0.62,16,36,0.444,9,13,0.692,119,2016-12-20,DEN,LAC
6321,21,@,L 102-113 ,240,36,77,0.468,27,55,0.491,9,22,0.409,21,29,0.724,102,43,87,0.494,28,60,0.467,15,27,0.556,12,19,0.632,113,2016-12-21,MIL,CLE
6322,22,Home,L 102-109 ,240,35,82,0.427,28,59,0.475,7,23,0.304,25,29,0.862,102,38,92,0.413,28,53,0.528,10,39,0.256,23,27,0.852,109,2016-12-22,IND,BOS
6323,23,@,L 102-111 ,240,37,85,0.435,27,56,0.482,10,29,0.345,18,22,0.818,102,40,84,0.476,32,59,0.542,8,25,0.32,23,30,0.767,111,2016-12-25,LAC,LAL
6324,24,Home,L 102-106 ,240,39,84,0.464,30,59,0.508,9,25,0.36,15,20,0.75,102,36,82,0.439,25,51,0.49,11,31,0.355,23,28,0.821,106,2016-12-26,LAC,DEN
6325,25,@,L 102-112 ,240,35,76,0.461,25,51,0.49,10,25,0.4,22,28,0.786,102,44,86,0.512,31,60,0.517,13,26,0.5,11,16,0.688,112,2016-12-26,MEM,ORL
6326,26,Home,W 102-100 ,240,39,87,0.448,32,62,0.516,7,25,0.28,17,21,0.81,102,39,79,0.494,30,54,0.556,9,25,0.36,13,18,0.722,100,2016-12-26,SAC,PHI
6327,27,@,L 102-107 ,240,40,85,0.471,34,64,0.531,6,21,0.286,16,23,0.696,102,40,79,0.506,28,50,0.56,12,29,0.414,15,20,0.75,107,2016-12-26,MIL,WAS
6328,28,@,W 102-100 ,240,38,75,0.507,29,49,0.592,9,26,0.346,17,24,0.708,102,39,83,0.47,35,67,0.522,4,16,0.25,18,22,0.818,100,2016-12-27,UTA,LAL
6329,29,Home,W 102-98 (OT),265,37,101,0.366,30,74,0.405,7,27,0.259,21,27,0.778,102,35,93,0.376,28,66,0.424,7,27,0.259,21,26,0.808,98,2016-12-28,ATL,NYK
6330,30,Home,W 102-98 ,240,40,87,0.46,30,58,0.517,10,29,0.345,12,21,0.571,102,37,94,0.394,26,57,0.456,11,37,0.297,13,18,0.722,98,2016-12-28,NOP,LAC
6331,31,Home,W 102-89 ,240,35,74,0.473,23,49,0.469,12,25,0.48,20,22,0.909,102,31,79,0.392,22,51,0.431,9,28,0.321,18,23,0.783,89,2016-12-28,POR,SAC
6332,32,@,L 102-116 ,240,30,77,0.39,20,46,0.435,10,31,0.323,32,35,0.914,102,42,82,0.512,25,49,0.51,17,33,0.515,15,28,0.536,116,2017-01-03,MEM,LAL
6333,33,Home,L 102-107 ,240,40,78,0.513,32,58,0.552,8,20,0.4,14,17,0.824,102,35,72,0.486,23,44,0.523,12,28,0.429,25,29,0.862,107,2017-01-04,SAC,MIA
6334,34,@,W 102-95 ,240,38,85,0.447,31,68,0.456,7,17,0.412,19,22,0.864,102,36,79,0.456,27,50,0.54,9,29,0.31,14,17,0.824,95,2017-01-05,PHO,DAL
6335,35,Home,W 102-85 ,240,36,89,0.404,23,55,0.418,13,34,0.382,17,20,0.85,102,30,75,0.4,26,54,0.481,4,21,0.19,21,25,0.84,85,2017-01-07,SAS,CHO
6336,36,Home,W 102-86 ,240,40,93,0.43,30,63,0.476,10,30,0.333,12,16,0.75,102,28,82,0.341,19,52,0.365,9,30,0.3,21,28,0.75,86,2017-01-11,POR,CLE
6337,37,Home,W 102-93 ,240,36,76,0.474,22,38,0.579,14,38,0.368,16,20,0.8,102,28,85,0.329,22,62,0.355,6,23,0.261,31,32,0.969,93,2017-01-13,PHI,CHO
6338,38,@,W 102-97 ,240,41,95,0.432,32,70,0.457,9,25,0.36,11,16,0.688,102,36,83,0.434,30,57,0.526,6,26,0.231,19,24,0.792,97,2017-01-15,DET,LAL
6339,39,Home,W 102-93 ,240,39,82,0.476,30,60,0.5,9,22,0.409,15,19,0.789,102,34,81,0.42,27,53,0.509,7,28,0.25,18,19,0.947,93,2017-01-20,ATL,CHI
6340,40,Home,W 102-99 ,240,34,83,0.41,28,66,0.424,6,17,0.353,28,33,0.848,102,37,84,0.44,28,58,0.483,9,26,0.346,16,21,0.762,99,2017-01-21,CHI,SAC
6341,41,@,L 102-105 ,240,41,88,0.466,33,58,0.569,8,30,0.267,12,20,0.6,102,38,86,0.442,25,56,0.446,13,30,0.433,16,27,0.593,105,2017-01-23,GSW,MIA
6342,42,Home,W 102-86 ,240,37,84,0.44,27,59,0.458,10,25,0.4,18,23,0.783,102,31,80,0.388,24,57,0.421,7,23,0.304,17,24,0.708,86,2017-01-27,TOR,MIL
6343,43,@,W 102-95 ,240,41,80,0.513,30,54,0.556,11,26,0.423,9,10,0.9,102,29,62,0.468,19,37,0.514,10,25,0.4,27,29,0.931,95,2017-01-28,MEM,UTA
6344,44,Home,W 102-86 ,240,38,89,0.427,32,68,0.471,6,21,0.286,20,27,0.741,102,30,88,0.341,21,63,0.333,9,25,0.36,17,23,0.739,86,2017-02-02,SAS,PHI
6345,45,@,L 102-114 ,240,40,83,0.482,37,64,0.578,3,19,0.158,19,22,0.864,102,38,80,0.475,25,54,0.463,13,26,0.5,25,33,0.758,114,2017-02-03,MEM,OKC
6346,46,Home,W 102-94 ,240,37,80,0.463,32,66,0.485,5,14,0.357,23,32,0.719,102,34,87,0.391,24,59,0.407,10,28,0.357,16,21,0.762,94,2017-02-03,ORL,TOR
6347,47,@,L 102-125 ,240,35,84,0.417,29,61,0.475,6,23,0.261,26,31,0.839,102,48,82,0.585,36,60,0.6,12,22,0.545,17,23,0.739,125,2017-02-04,PHI,MIA
6348,48,@,L 102-107 ,240,35,84,0.417,25,55,0.455,10,29,0.345,22,28,0.786,102,37,88,0.42,21,36,0.583,16,52,0.308,17,20,0.85,107,2017-02-05,LAC,BOS
6349,49,@,L 102-121 ,240,37,86,0.43,31,63,0.492,6,23,0.261,22,26,0.846,102,51,97,0.526,47,81,0.58,4,16,0.25,15,24,0.625,121,2017-02-08,LAL,DET
6350,50,Home,L 102-107 ,240,37,85,0.435,24,48,0.5,13,37,0.351,15,20,0.75,102,40,85,0.471,26,51,0.51,14,34,0.412,13,20,0.65,107,2017-02-11,CHA,LAC
6351,51,@,L 102-133 ,240,37,94,0.394,29,72,0.403,8,22,0.364,20,26,0.769,102,42,85,0.494,24,49,0.49,18,36,0.5,31,39,0.795,133,2017-02-11,PHO,HOU
6352,52,@,W 102-101 ,240,36,84,0.429,28,53,0.528,8,31,0.258,22,29,0.759,102,38,75,0.507,30,59,0.508,8,16,0.5,17,25,0.68,101,2017-02-12,DET,TOR
6353,53,Home,W 102-89 ,240,40,79,0.506,34,58,0.586,6,21,0.286,16,16,1.0,102,34,78,0.436,27,57,0.474,7,21,0.333,14,19,0.737,89,2017-02-13,MIL,DET
6354,54,Home,W 102-92 ,240,40,78,0.513,29,52,0.558,11,26,0.423,11,11,1.0,102,35,84,0.417,26,57,0.456,9,27,0.333,13,23,0.565,92,2017-02-24,IND,MEM
6355,55,@,W 102-92 ,240,34,72,0.472,23,48,0.479,11,24,0.458,23,32,0.719,102,37,87,0.425,29,65,0.446,8,22,0.364,10,13,0.769,92,2017-02-26,UTA,WAS
6356,56,Home,W 102-95 ,240,35,70,0.5,25,42,0.595,10,28,0.357,22,26,0.846,102,37,83,0.446,26,53,0.491,11,30,0.367,10,16,0.625,95,2017-02-27,CLE,MIL
6357,57,@,W 102-88 ,240,40,95,0.421,32,72,0.444,8,23,0.348,14,20,0.7,102,36,82,0.439,30,65,0.462,6,17,0.353,10,15,0.667,88,2017-02-27,MIN,SAC
6358,58,@,L 102-105 ,240,33,84,0.393,26,63,0.413,7,21,0.333,29,33,0.879,102,36,83,0.434,27,55,0.491,9,28,0.321,24,31,0.774,105,2017-03-03,NYK,PHI
6359,59,Home,L 102-112 ,240,36,80,0.45,27,50,0.54,9,30,0.3,21,25,0.84,102,41,90,0.456,25,63,0.397,16,27,0.593,14,17,0.824,112,2017-03-04,DEN,CHO
6360,60,@,L 102-116 ,240,34,83,0.41,24,48,0.5,10,35,0.286,24,29,0.828,102,39,73,0.534,30,53,0.566,9,20,0.45,29,47,0.617,116,2017-03-06,BOS,LAC
6361,61,Home,W 102-92 ,240,41,88,0.466,35,68,0.515,6,20,0.3,14,21,0.667,102,35,84,0.417,29,65,0.446,6,19,0.316,16,20,0.8,92,2017-03-09,OKC,SAS
6362,62,Home,W 101-79 ,240,38,85,0.447,35,67,0.522,3,18,0.167,22,28,0.786,101,31,82,0.378,28,66,0.424,3,16,0.188,14,22,0.636,79,2011-12-27,POR,SAC
6363,63,Home,W 101-83 ,240,32,75,0.427,23,52,0.442,9,23,0.391,28,35,0.8,101,30,77,0.39,24,61,0.393,6,16,0.375,17,22,0.773,83,2011-12-28,ATL,WAS
6364,64,Home,L 101-114 ,240,41,80,0.513,34,65,0.523,7,15,0.467,12,20,0.6,101,39,78,0.5,32,61,0.525,7,17,0.412,29,34,0.853,114,2011-12-30,LAC,CHI
6365,65,Home,L 101-103 ,240,39,83,0.47,28,54,0.519,11,29,0.379,12,20,0.6,101,46,93,0.495,43,79,0.544,3,14,0.214,8,14,0.571,103,2011-12-30,MIN,MIA
6366,66,@,L 101-115 ,240,40,90,0.444,36,76,0.474,4,14,0.286,17,19,0.895,101,45,90,0.5,35,69,0.507,10,21,0.476,15,26,0.577,115,2012-01-03,CHA,CLE
6367,67,@,W 101-93 ,240,41,86,0.477,37,70,0.529,4,16,0.25,15,18,0.833,101,35,79,0.443,32,69,0.464,3,10,0.3,20,25,0.8,93,2012-01-04,PHI,NOH
6368,68,Home,W 101-95 ,240,37,78,0.474,27,61,0.443,10,17,0.588,17,24,0.708,101,37,80,0.463,28,60,0.467,9,20,0.45,12,19,0.632,95,2012-01-04,SAS,GSW
6369,69,@,W 101-90 ,240,38,76,0.5,33,61,0.541,5,15,0.333,20,24,0.833,101,28,83,0.337,18,50,0.36,10,33,0.303,24,32,0.75,90,2012-01-07,MIA,NJN
6370,70,Home,L 101-106 ,240,36,77,0.468,25,55,0.455,11,22,0.5,18,21,0.857,101,42,78,0.538,33,57,0.579,9,21,0.429,13,19,0.684,106,2012-01-09,BRK,ATL
6371,71,Home,W 101-95 (OT),265,42,92,0.457,37,76,0.487,5,16,0.313,12,17,0.706,101,41,96,0.427,38,75,0.507,3,21,0.143,10,12,0.833,95,2012-01-11,SAS,HOU
6372,72,@,W 101-90 ,240,39,89,0.438,29,70,0.414,10,19,0.526,13,21,0.619,101,34,75,0.453,26,54,0.481,8,21,0.381,14,20,0.7,90,2012-01-12,CLE,PHO
6373,73,Home,W 101-91 ,240,37,80,0.463,29,59,0.492,8,21,0.381,19,35,0.543,101,33,78,0.423,25,54,0.463,8,24,0.333,17,26,0.654,91,2012-01-16,LAC,NJN
6374,74,@,W 101-98 ,240,36,81,0.444,30,66,0.455,6,15,0.4,23,33,0.697,101,33,71,0.465,22,50,0.44,11,21,0.524,21,28,0.75,98,2012-01-20,MIN,LAC
6375,75,Home,W 101-89 ,240,41,88,0.466,34,69,0.493,7,19,0.368,12,21,0.571,101,32,80,0.4,25,62,0.403,7,18,0.389,18,25,0.72,89,2012-01-23,POR,SAC
6376,76,@,W 101-98 ,240,37,71,0.521,32,56,0.571,5,15,0.333,22,25,0.88,101,36,72,0.5,29,50,0.58,7,22,0.318,19,25,0.76,98,2012-01-25,MIA,DET
6377,77,Home,W 101-93 ,240,41,79,0.519,30,59,0.508,11,20,0.55,8,14,0.571,101,34,83,0.41,26,62,0.419,8,21,0.381,17,20,0.85,93,2012-01-25,GSW,POR
6378,78,Home,W 101-91 ,240,34,64,0.531,29,51,0.569,5,13,0.385,28,33,0.848,101,35,75,0.467,34,68,0.5,1,7,0.143,20,21,0.952,91,2012-01-25,OKC,NOH
6379,79,@,L 101-116 ,240,39,84,0.464,34,72,0.472,5,12,0.417,18,22,0.818,101,45,82,0.549,34,63,0.54,11,19,0.579,15,22,0.682,116,2012-01-27,UTA,DAL
6380,80,Home,L 101-107 (OT),265,38,93,0.409,31,77,0.403,7,16,0.438,18,22,0.818,101,40,82,0.488,30,66,0.455,10,16,0.625,17,25,0.68,107,2012-01-27,DET,ATL
6381,81,Home,W 101-100 (OT),265,44,100,0.44,40,80,0.5,4,20,0.2,9,12,0.75,101,39,94,0.415,27,69,0.391,12,25,0.48,10,19,0.526,100,2012-01-29,DAL,SAS
6382,82,Home,L 101-106 ,240,40,104,0.385,35,83,0.422,5,21,0.238,16,23,0.696,101,40,79,0.506,32,60,0.533,8,19,0.421,18,23,0.783,106,2012-01-29,MIN,LAL
6383,83,@,L 101-119 ,240,36,79,0.456,33,67,0.493,3,12,0.25,26,34,0.765,101,45,96,0.469,37,72,0.514,8,24,0.333,21,25,0.84,119,2012-02-02,UTA,GSW
6384,84,Home,W 101-94 ,240,34,71,0.479,27,54,0.5,7,17,0.412,26,33,0.788,101,37,87,0.425,33,74,0.446,4,13,0.308,16,20,0.8,94,2012-02-03,OKC,MEM
6385,85,Home,L 101-109 ,240,37,85,0.435,28,61,0.459,9,24,0.375,18,27,0.667,101,41,79,0.519,28,54,0.519,13,25,0.52,14,22,0.636,109,2012-02-09,DEN,GSW
6386,86,@,L 101-106 ,240,37,77,0.481,30,59,0.508,7,18,0.389,20,26,0.769,101,40,99,0.404,33,79,0.418,7,20,0.35,19,26,0.731,106,2012-02-09,OKC,SAC
6387,87,@,W 101-87 ,240,35,74,0.473,31,54,0.574,4,20,0.2,27,32,0.844,101,38,80,0.475,35,71,0.493,3,9,0.333,8,13,0.615,87,2012-02-10,OKC,UTA
6388,88,@,W 101-99 ,240,38,80,0.475,28,59,0.475,10,21,0.476,15,18,0.833,101,37,69,0.536,31,52,0.596,6,17,0.353,19,27,0.704,99,2012-02-15,ATL,PHO
6389,89,Home,W 101-85 ,240,37,72,0.514,27,53,0.509,10,19,0.526,17,24,0.708,101,32,81,0.395,27,67,0.403,5,14,0.357,16,20,0.8,85,2012-02-19,HOU,UTA
6390,90,@,L 101-103 (OT),265,36,99,0.364,30,72,0.417,6,27,0.222,23,24,0.958,101,37,92,0.402,32,70,0.457,5,22,0.227,24,35,0.686,103,2012-02-20,MIN,DEN
6391,91,Home,W 101-93 ,240,36,80,0.45,28,54,0.519,8,26,0.308,21,24,0.875,101,33,91,0.363,26,77,0.338,7,14,0.5,20,23,0.87,93,2012-02-20,OKC,NOH
6392,92,Home,W 101-100 ,240,34,78,0.436,25,60,0.417,9,18,0.5,24,32,0.75,101,37,95,0.389,30,78,0.385,7,17,0.412,19,24,0.792,100,2012-02-21,CLE,DET
6393,93,Home,W 101-98 ,240,40,87,0.46,32,66,0.485,8,21,0.381,13,21,0.619,101,37,83,0.446,29,62,0.468,8,21,0.381,16,26,0.615,98,2012-03-03,WAS,CLE
6394,94,Home,L 101-104 ,240,31,80,0.388,29,66,0.439,2,14,0.143,37,39,0.949,101,33,68,0.485,28,51,0.549,5,17,0.294,33,44,0.75,104,2012-03-04,CHA,NJN
6395,95,@,W 101-96 ,240,38,83,0.458,30,64,0.469,8,19,0.421,17,22,0.773,101,31,70,0.443,26,55,0.473,5,15,0.333,29,40,0.725,96,2012-03-06,ATL,IND
6396,96,Home,W 101-100 ,240,33,72,0.458,23,47,0.489,10,25,0.4,25,31,0.806,101,35,76,0.461,24,54,0.444,11,22,0.5,19,27,0.704,100,2012-03-07,BRK,LAC
6397,97,@,L 101-106 ,240,32,81,0.395,24,60,0.4,8,21,0.381,29,37,0.784,101,43,92,0.467,36,66,0.545,7,26,0.269,13,19,0.684,106,2012-03-07,LAL,WAS
6398,98,Home,L 101-107 (OT),265,44,85,0.518,41,75,0.547,3,10,0.3,10,13,0.769,101,37,82,0.451,32,63,0.508,5,19,0.263,28,35,0.8,107,2012-03-14,NOP,LAL
6399,99,Home,W 101-96 ,240,38,84,0.452,29,59,0.492,9,25,0.36,16,21,0.762,101,35,84,0.417,27,63,0.429,8,21,0.381,18,20,0.9,96,2012-03-15,DAL,CHA
6400,0,@,L 101-109 ,240,40,78,0.513,32,63,0.508,8,15,0.533,13,18,0.722,101,41,83,0.494,31,63,0.492,10,20,0.5,17,22,0.773,109,2012-03-16,DET,PHO
6401,1,@,W 101-92 ,240,39,89,0.438,25,60,0.417,14,29,0.483,9,10,0.9,101,39,79,0.494,36,70,0.514,3,9,0.333,11,14,0.786,92,2012-03-21,GSW,NOH
6402,2,@,L 101-102 (OT),265,39,87,0.448,36,73,0.493,3,14,0.214,20,25,0.8,101,41,103,0.398,38,80,0.475,3,23,0.13,17,26,0.654,102,2012-03-24,TOR,CHI
6403,3,@,W 101-99 (OT),265,37,80,0.463,31,58,0.534,6,22,0.273,21,24,0.875,101,37,96,0.385,28,71,0.394,9,25,0.36,16,18,0.889,99,2012-03-24,DAL,HOU
6404,4,Home,W 101-85 ,240,36,72,0.5,31,56,0.554,5,16,0.313,24,33,0.727,101,33,78,0.423,24,63,0.381,9,15,0.6,10,14,0.714,85,2012-03-24,LAC,MEM
6405,5,Home,W 101-79 ,240,38,78,0.487,32,58,0.552,6,20,0.3,19,30,0.633,101,28,76,0.368,22,57,0.386,6,19,0.316,17,22,0.773,79,2012-03-24,NYK,DET
6406,6,Home,L 101-117 ,240,35,74,0.473,24,52,0.462,11,22,0.5,20,24,0.833,101,44,81,0.543,29,47,0.617,15,34,0.441,14,19,0.737,117,2012-03-26,TOR,ORL
6407,7,Home,L 101-104 ,240,39,91,0.429,33,72,0.458,6,19,0.316,17,18,0.944,101,36,86,0.419,31,66,0.47,5,20,0.25,27,34,0.794,104,2012-03-27,GSW,LAL
6408,8,@,L 101-108 ,240,42,84,0.5,35,61,0.574,7,23,0.304,10,17,0.588,101,44,88,0.5,39,77,0.506,5,11,0.455,15,16,0.938,108,2012-03-27,ATL,MIL
6409,9,Home,L 101-113 ,240,39,72,0.542,34,58,0.586,5,14,0.357,18,19,0.947,101,44,77,0.571,39,63,0.619,5,14,0.357,20,24,0.833,113,2012-03-30,TOR,MIA
6410,10,Home,L 101-104 ,240,37,88,0.42,29,56,0.518,8,32,0.25,19,25,0.76,101,40,72,0.556,32,53,0.604,8,19,0.421,16,21,0.762,104,2012-04-01,ORL,DEN
6411,11,Home,W 101-88 ,240,37,81,0.457,25,57,0.439,12,24,0.5,15,19,0.789,101,32,86,0.372,26,67,0.388,6,19,0.316,18,19,0.947,88,2012-04-04,POR,NJN
6412,12,Home,W 101-96 ,240,39,81,0.481,35,66,0.53,4,15,0.267,19,27,0.704,101,37,78,0.474,30,63,0.476,7,15,0.467,15,22,0.682,96,2012-04-06,ATL,DET
6413,13,Home,W 101-86 ,240,41,83,0.494,37,67,0.552,4,16,0.25,15,21,0.714,101,32,87,0.368,22,61,0.361,10,26,0.385,12,20,0.6,86,2012-04-15,DEN,HOU
6414,14,@,W 101-98 ,240,36,71,0.507,30,53,0.566,6,18,0.333,23,27,0.852,101,41,82,0.5,36,66,0.545,5,16,0.313,11,16,0.688,98,2012-04-16,MIA,NJN
6415,15,Home,W 101-74 ,240,44,78,0.564,39,63,0.619,5,15,0.333,8,11,0.727,101,28,75,0.373,22,52,0.423,6,23,0.261,12,17,0.706,74,2012-04-22,DEN,ORL
6416,16,@,L 101-109 ,240,37,80,0.463,26,56,0.464,11,24,0.458,16,22,0.727,101,38,81,0.469,33,68,0.485,5,13,0.385,28,36,0.778,109,2012-04-23,CLE,MEM
6417,17,Home,W 101-73 ,240,46,83,0.554,44,65,0.677,2,18,0.111,7,12,0.583,101,25,73,0.342,21,58,0.362,4,15,0.267,19,23,0.826,73,2012-04-23,WAS,CHA
6418,18,Home,L 101-106 ,240,39,79,0.494,29,55,0.527,10,24,0.417,13,15,0.867,101,40,90,0.444,32,67,0.478,8,23,0.348,18,30,0.6,106,2012-04-25,OKC,DEN
6419,19,Home,L 101-107 ,240,45,87,0.517,43,79,0.544,2,8,0.25,9,12,0.75,101,42,96,0.438,33,65,0.508,9,31,0.29,14,17,0.824,107,2012-04-26,GSW,SAS
6420,20,Home,W 101-92 ,240,38,74,0.514,33,59,0.559,5,15,0.333,20,29,0.69,101,33,86,0.384,31,72,0.431,2,14,0.143,24,30,0.8,92,2012-10-31,LAC,MEM
6421,21,Home,L 101-108 ,240,39,74,0.527,30,49,0.612,9,25,0.36,14,16,0.875,101,40,92,0.435,26,63,0.413,14,29,0.483,14,22,0.636,108,2012-11-05,LAC,CLE
6422,22,Home,W 101-79 ,240,41,87,0.471,33,69,0.478,8,18,0.444,11,13,0.846,101,27,79,0.342,21,59,0.356,6,20,0.3,19,22,0.864,79,2012-11-05,SAS,IND
6423,23,Home,W 101-77 ,240,36,90,0.4,28,62,0.452,8,28,0.286,21,28,0.75,101,29,86,0.337,22,61,0.361,7,25,0.28,12,20,0.6,77,2012-11-09,LAL,GSW
6424,24,@,W 101-91 ,240,40,78,0.513,34,63,0.54,6,15,0.4,15,19,0.789,101,34,78,0.436,30,60,0.5,4,18,0.222,19,22,0.864,91,2012-11-09,MIL,WAS
6425,25,Home,W 101-97 (OT),265,40,95,0.421,37,75,0.493,3,20,0.15,18,28,0.643,101,32,79,0.405,23,60,0.383,9,19,0.474,24,30,0.8,97,2012-11-10,CHA,DAL
6426,26,Home,L 101-107 (2OT),290,39,102,0.382,30,77,0.39,9,25,0.36,14,23,0.609,101,43,113,0.381,38,89,0.427,5,24,0.208,16,27,0.593,107,2012-11-10,GSW,DEN
6427,27,@,W 101-95 ,240,41,81,0.506,38,65,0.585,3,16,0.188,16,16,1.0,101,34,74,0.459,31,65,0.477,3,9,0.333,24,31,0.774,95,2012-11-12,BOS,CHI
6428,28,@,L 101-114 ,240,38,87,0.437,35,73,0.479,3,14,0.214,22,26,0.846,101,42,77,0.545,37,55,0.673,5,22,0.227,25,31,0.806,114,2012-11-13,CLE,BRK
6429,29,@,L 101-107 ,240,39,81,0.481,26,54,0.481,13,27,0.481,10,11,0.909,101,39,78,0.5,36,67,0.537,3,11,0.273,26,33,0.788,107,2012-11-14,WAS,DAL
6430,30,Home,W 101-80 ,240,37,75,0.493,32,59,0.542,5,16,0.313,22,30,0.733,101,30,89,0.337,28,75,0.373,2,14,0.143,18,22,0.818,80,2012-11-17,LAC,CHI
6431,31,Home,L 101-105 (OT),265,37,86,0.43,27,65,0.415,10,21,0.476,17,24,0.708,101,37,91,0.407,28,67,0.418,9,24,0.375,22,30,0.733,105,2012-11-19,DAL,GSW
6432,32,Home,W 101-100 (OT),265,40,92,0.435,31,67,0.463,9,25,0.36,12,21,0.571,101,38,89,0.427,31,69,0.449,7,20,0.35,17,24,0.708,100,2012-11-21,ATL,WAS
6433,33,@,W 101-94 ,240,35,79,0.443,26,58,0.448,9,21,0.429,22,26,0.846,101,34,89,0.382,24,61,0.393,10,28,0.357,16,25,0.64,94,2012-11-21,DEN,MIN
6434,34,@,W 101-91 ,240,42,78,0.538,31,56,0.554,11,22,0.5,6,14,0.429,101,31,83,0.373,23,61,0.377,8,22,0.364,21,26,0.808,91,2012-11-23,ATL,CHA
6435,35,@,L 101-104 ,240,39,83,0.47,35,72,0.486,4,11,0.364,19,20,0.95,101,39,81,0.481,30,62,0.484,9,19,0.474,17,23,0.739,104,2012-11-25,PHO,PHI
6436,36,@,L 101-108 ,240,36,85,0.424,30,66,0.455,6,19,0.316,23,31,0.742,101,42,80,0.525,33,65,0.508,9,15,0.6,15,22,0.682,108,2012-11-26,POR,DET
6437,37,@,L 101-117 ,240,42,86,0.488,34,63,0.54,8,23,0.348,9,12,0.75,101,44,83,0.53,31,57,0.544,13,26,0.5,16,21,0.762,117,2012-11-27,TOR,HOU
6438,38,Home,W 101-78 ,240,34,69,0.493,28,59,0.475,6,10,0.6,27,33,0.818,101,28,81,0.346,24,63,0.381,4,18,0.222,18,20,0.9,78,2012-11-28,CHI,DAL
6439,39,Home,W 101-95 ,240,37,81,0.457,33,62,0.532,4,19,0.211,23,26,0.885,101,31,82,0.378,25,60,0.417,6,22,0.273,27,35,0.771,95,2012-11-28,LAC,MIN
6440,40,Home,W 101-97 ,240,39,81,0.481,31,67,0.463,8,14,0.571,15,22,0.682,101,37,77,0.481,31,61,0.508,6,16,0.375,17,19,0.895,97,2012-11-30,TOR,PHO
6441,41,@,L 101-105 ,240,41,89,0.461,33,61,0.541,8,28,0.286,11,16,0.688,101,38,79,0.481,31,60,0.517,7,19,0.368,22,29,0.759,105,2012-12-04,MIA,WAS
6442,42,@,W 101-97 ,240,35,81,0.432,26,59,0.441,9,22,0.409,22,27,0.815,101,37,87,0.425,28,62,0.452,9,25,0.36,14,23,0.609,97,2012-12-08,GSW,WAS
6443,43,Home,W 101-92 ,240,39,67,0.582,30,46,0.652,9,21,0.429,14,22,0.636,101,32,75,0.427,23,47,0.489,9,28,0.321,19,20,0.95,92,2012-12-10,MIA,ATL
6444,44,@,W 101-94 ,240,37,80,0.463,31,63,0.492,6,17,0.353,21,34,0.618,101,34,81,0.42,29,68,0.426,5,13,0.385,21,31,0.677,94,2012-12-11,DEN,DET
6445,45,Home,W 101-89 ,240,37,76,0.487,27,49,0.551,10,27,0.37,17,23,0.739,101,34,85,0.4,26,65,0.4,8,20,0.4,13,17,0.765,89,2012-12-14,HOU,BOS
6446,46,Home,W 101-90 ,240,41,85,0.482,33,63,0.524,8,22,0.364,11,15,0.733,101,34,83,0.41,31,70,0.443,3,13,0.231,19,24,0.792,90,2012-12-17,PHO,SAC
6447,47,Home,W 101-100 ,240,35,88,0.398,25,57,0.439,10,31,0.323,21,27,0.778,101,38,95,0.4,28,71,0.394,10,24,0.417,14,22,0.636,100,2012-12-18,LAL,CHA
6448,48,Home,W 101-93 ,240,33,92,0.359,19,56,0.339,14,36,0.389,21,26,0.808,101,38,98,0.388,38,76,0.5,0,22,0.0,17,24,0.708,93,2012-12-20,POR,DEN
6449,49,Home,W 101-83 ,240,38,73,0.521,26,54,0.481,12,19,0.632,13,16,0.813,101,31,86,0.36,26,64,0.406,5,22,0.227,16,21,0.762,83,2012-12-29,GSW,BOS
6450,50,@,W 101-97 ,240,37,83,0.446,31,67,0.463,6,16,0.375,21,30,0.7,101,40,86,0.465,34,64,0.531,6,22,0.273,11,20,0.55,97,2013-01-03,MIN,DEN
6451,51,Home,L 101-115 ,240,39,87,0.448,33,73,0.452,6,14,0.429,17,23,0.739,101,45,83,0.542,32,50,0.64,13,33,0.394,12,19,0.632,115,2013-01-04,MIL,HOU
6452,52,Home,L 101-108 (OT),265,40,80,0.5,32,54,0.593,8,26,0.308,13,19,0.684,101,40,92,0.435,37,79,0.468,3,13,0.231,25,29,0.862,108,2013-01-06,DET,CHA
6453,53,Home,W 101-99 ,240,38,87,0.437,28,69,0.406,10,18,0.556,15,18,0.833,101,34,80,0.425,28,55,0.509,6,25,0.24,25,30,0.833,99,2013-01-07,WAS,OKC
6454,54,Home,L 101-116 ,240,39,98,0.398,33,70,0.471,6,28,0.214,17,22,0.773,101,44,87,0.506,35,58,0.603,9,29,0.31,19,28,0.679,116,2013-01-11,LAL,OKC
6455,55,Home,W 101-98 (OT),265,40,85,0.471,37,73,0.507,3,12,0.25,18,21,0.857,101,35,76,0.461,25,51,0.49,10,25,0.4,18,22,0.818,98,2013-01-11,MEM,SAS
6456,56,Home,L 101-108 ,240,37,90,0.411,26,68,0.382,11,22,0.5,16,23,0.696,101,39,68,0.574,34,57,0.596,5,11,0.455,25,34,0.735,108,2013-01-11,NYK,CHI
6457,57,Home,L 101-104 ,240,43,88,0.489,34,66,0.515,9,22,0.409,6,6,1.0,101,39,81,0.481,28,56,0.5,11,25,0.44,15,19,0.789,104,2013-01-12,LAC,ORL
6458,58,@,L 101-108 (OT),265,40,88,0.455,29,63,0.46,11,25,0.44,10,13,0.769,101,47,91,0.516,43,72,0.597,4,19,0.211,10,14,0.714,108,2013-01-18,TOR,PHI
6459,59,Home,W 101-77 ,240,47,90,0.522,43,81,0.531,4,9,0.444,3,8,0.375,101,29,71,0.408,26,54,0.481,3,17,0.176,16,25,0.64,77,2013-01-25,MEM,BRK
6460,60,@,L 101-114 ,240,39,88,0.443,36,74,0.486,3,14,0.214,20,33,0.606,101,48,83,0.578,40,66,0.606,8,17,0.471,10,17,0.588,114,2013-01-25,MIN,WAS
6461,61,@,L 101-102 ,240,37,77,0.481,27,57,0.474,10,20,0.5,17,23,0.739,101,37,73,0.507,32,62,0.516,5,11,0.455,23,26,0.885,102,2013-01-26,MIN,CHA
6462,62,Home,W 101-100 ,240,35,75,0.467,24,50,0.48,11,25,0.44,20,21,0.952,101,40,81,0.494,33,65,0.508,7,16,0.438,13,17,0.765,100,2013-01-26,POR,LAC
6463,63,@,L 101-102 ,240,39,85,0.459,28,62,0.452,11,23,0.478,12,17,0.706,101,37,78,0.474,30,64,0.469,7,14,0.5,21,30,0.7,102,2013-01-28,IND,DEN
6464,64,@,L 101-111 ,240,39,88,0.443,35,72,0.486,4,16,0.25,19,22,0.864,101,39,74,0.527,33,60,0.55,6,14,0.429,27,34,0.794,111,2013-02-04,CHI,IND
6465,65,Home,L 101-105 ,240,38,89,0.427,29,68,0.426,9,21,0.429,16,20,0.8,101,40,77,0.519,31,51,0.608,9,26,0.346,16,23,0.696,105,2013-02-11,DAL,ATL
6466,66,@,L 101-108 ,240,40,86,0.465,36,70,0.514,4,16,0.25,17,24,0.708,101,41,75,0.547,35,62,0.565,6,13,0.462,20,24,0.833,108,2013-02-12,SAC,MEM
6467,67,Home,W 101-77 ,240,41,95,0.432,35,76,0.461,6,19,0.316,13,19,0.684,101,26,82,0.317,21,66,0.318,5,16,0.313,20,28,0.714,77,2013-02-13,IND,CHA
6468,68,Home,L 101-125 ,240,38,75,0.507,32,55,0.582,6,20,0.3,19,27,0.704,101,46,89,0.517,30,59,0.508,16,30,0.533,17,22,0.773,125,2013-02-14,LAL,LAC
6469,69,@,L 101-115 ,240,39,83,0.47,34,66,0.515,5,17,0.294,18,24,0.75,101,39,78,0.5,29,57,0.509,10,21,0.476,27,33,0.818,115,2013-02-19,GSW,UTA
6470,70,@,L 101-107 (OT),265,37,95,0.389,33,73,0.452,4,22,0.182,23,32,0.719,101,39,94,0.415,34,73,0.466,5,21,0.238,24,30,0.8,107,2013-02-22,SAS,GSW
6471,71,@,W 101-98 ,240,40,81,0.494,35,64,0.547,5,17,0.294,16,19,0.842,101,39,78,0.5,30,57,0.526,9,21,0.429,11,15,0.733,98,2013-02-26,CLE,CHI
6472,72,@,W 101-97 ,240,37,76,0.487,25,56,0.446,12,20,0.6,15,18,0.833,101,40,87,0.46,35,73,0.479,5,14,0.357,12,15,0.8,97,2013-02-26,BRK,NOH
6473,73,Home,L 101-125 ,240,37,83,0.446,31,64,0.484,6,19,0.316,21,25,0.84,101,46,84,0.548,36,62,0.581,10,22,0.455,23,29,0.793,125,2013-02-27,ORL,SAC
6474,74,Home,L 101-105 (OT),265,35,81,0.432,29,64,0.453,6,17,0.353,25,35,0.714,101,44,95,0.463,41,83,0.494,3,12,0.25,14,21,0.667,105,2013-02-27,SAS,PHO
6475,75,Home,L 101-109 ,240,41,100,0.41,36,79,0.456,5,21,0.238,14,18,0.778,101,42,83,0.506,31,64,0.484,11,19,0.579,14,16,0.875,109,2013-03-05,PHI,BOS
6476,76,@,L 101-104 ,240,38,87,0.437,29,68,0.426,9,19,0.474,16,19,0.842,101,37,90,0.411,30,74,0.405,7,16,0.438,23,29,0.793,104,2013-03-06,UTA,CLE
6477,77,@,L 101-117 ,240,38,79,0.481,25,50,0.5,13,29,0.448,12,15,0.8,101,47,87,0.54,35,58,0.603,12,29,0.414,11,14,0.786,117,2013-03-06,MIL,LAC
6478,78,Home,W 101-83 ,240,40,74,0.541,32,60,0.533,8,14,0.571,13,18,0.722,101,33,90,0.367,24,70,0.343,9,20,0.45,8,8,1.0,83,2013-03-06,SAS,CHI
6479,79,@,L 101-112 ,240,40,76,0.526,35,59,0.593,5,17,0.294,16,24,0.667,101,41,86,0.477,34,67,0.507,7,19,0.368,23,24,0.958,112,2013-03-16,DET,POR
6480,80,Home,L 101-107 ,240,38,83,0.458,29,62,0.468,9,21,0.429,16,16,1.0,101,39,80,0.488,34,59,0.576,5,21,0.238,24,30,0.8,107,2013-03-17,DAL,OKC
6481,81,Home,W 101-100 ,240,43,86,0.5,38,70,0.543,5,16,0.313,10,13,0.769,101,38,90,0.422,26,62,0.419,12,28,0.429,12,14,0.857,100,2013-03-18,PHI,POR
6482,82,@,L 101-116 ,240,36,80,0.45,27,54,0.5,9,26,0.346,20,26,0.769,101,37,73,0.507,23,45,0.511,14,28,0.5,28,34,0.824,116,2013-03-19,LAC,SAC
6483,83,@,L 101-107 ,240,35,83,0.422,30,61,0.492,5,22,0.227,26,26,1.0,101,35,75,0.467,27,59,0.458,8,16,0.5,29,40,0.725,107,2013-03-20,TOR,CHA
6484,84,Home,W 101-72 ,240,41,78,0.526,35,58,0.603,6,20,0.3,13,19,0.684,101,29,79,0.367,23,59,0.39,6,20,0.3,8,10,0.8,72,2013-03-20,LAC,PHI
6485,85,Home,W 101-100 ,240,37,76,0.487,30,65,0.462,7,11,0.636,20,27,0.741,101,43,78,0.551,36,60,0.6,7,18,0.389,7,11,0.636,100,2013-03-21,DEN,PHI
6486,86,Home,W 101-98 ,240,40,75,0.533,34,57,0.596,6,18,0.333,15,18,0.833,101,41,98,0.418,40,79,0.506,1,19,0.053,15,18,0.833,98,2013-03-21,SAC,MIN
6487,87,Home,W 101-95 ,240,37,85,0.435,33,71,0.465,4,14,0.286,23,32,0.719,101,39,86,0.453,31,58,0.534,8,28,0.286,9,17,0.529,95,2013-03-23,DEN,SAC
6488,88,Home,W 101-92 ,240,37,75,0.493,27,55,0.491,10,20,0.5,17,22,0.773,101,36,88,0.409,29,71,0.408,7,17,0.412,13,16,0.813,92,2013-03-23,GSW,WAS
6489,89,Home,W 101-95 ,240,37,79,0.468,28,53,0.528,9,26,0.346,18,24,0.75,101,34,74,0.459,25,49,0.51,9,25,0.36,18,24,0.75,95,2013-03-23,LAC,BRK
6490,90,Home,W 101-97 ,240,40,85,0.471,32,63,0.508,8,22,0.364,13,18,0.722,101,37,77,0.481,30,57,0.526,7,20,0.35,16,23,0.696,97,2013-03-27,CHI,MIA
6491,91,@,L 101-108 ,240,33,70,0.471,27,49,0.551,6,21,0.286,29,35,0.829,101,38,74,0.514,25,43,0.581,13,31,0.419,19,22,0.864,108,2013-03-27,MEM,NYK
6492,92,Home,W 101-93 ,240,37,83,0.446,32,68,0.471,5,15,0.333,22,27,0.815,101,36,79,0.456,31,63,0.492,5,16,0.313,16,20,0.8,93,2013-03-29,MIN,OKC
6493,93,Home,W 101-81 ,240,36,81,0.444,28,57,0.491,8,24,0.333,21,33,0.636,101,34,81,0.42,27,62,0.435,7,19,0.368,6,12,0.5,81,2013-04-02,LAL,DAL
6494,94,@,L 101-126 ,240,35,77,0.455,28,60,0.467,7,17,0.412,24,25,0.96,101,52,93,0.559,43,72,0.597,9,21,0.429,13,18,0.722,126,2013-04-03,PHO,LAC
6495,95,@,W 101-90 ,240,37,80,0.463,28,64,0.438,9,16,0.563,18,24,0.75,101,34,73,0.466,29,56,0.518,5,17,0.294,17,27,0.63,90,2013-04-05,PHI,ATL
6496,96,Home,W 101-83 ,240,41,89,0.461,29,53,0.547,12,36,0.333,7,8,0.875,101,29,76,0.382,17,46,0.37,12,30,0.4,13,18,0.722,83,2013-04-05,NYK,MIL
6497,97,@,L 101-107 ,240,40,75,0.533,34,60,0.567,6,15,0.4,15,21,0.714,101,36,83,0.434,30,69,0.435,6,14,0.429,29,38,0.763,107,2013-04-06,DET,MIN
6498,98,@,W 101-98 ,240,37,72,0.514,30,54,0.556,7,18,0.389,20,24,0.833,101,37,86,0.43,27,69,0.391,10,17,0.588,14,20,0.7,98,2013-04-09,TOR,CHI
6499,99,Home,W 101-98 ,240,37,86,0.43,31,56,0.554,6,30,0.2,21,24,0.875,101,38,86,0.442,31,74,0.419,7,12,0.583,15,19,0.789,98,2013-04-09,HOU,PHO
6500,0,@,W 101-93 ,240,34,74,0.459,26,55,0.473,8,19,0.421,25,28,0.893,101,37,81,0.457,31,65,0.477,6,16,0.375,13,17,0.765,93,2013-04-10,BRK,BOS
6501,1,Home,L 101-124 ,240,37,88,0.42,30,67,0.448,7,21,0.333,20,22,0.909,101,49,91,0.538,41,69,0.594,8,22,0.364,18,19,0.947,124,2013-04-10,PHI,ATL
6502,2,@,W 101-91 ,240,40,79,0.506,30,51,0.588,10,28,0.357,11,17,0.647,101,34,79,0.43,28,57,0.491,6,22,0.273,17,24,0.708,91,2013-04-12,NYK,CLE
6503,3,@,L 101-109 ,240,41,85,0.482,35,62,0.565,6,23,0.261,13,13,1.0,101,39,71,0.549,27,48,0.563,12,23,0.522,19,28,0.679,109,2013-04-12,BOS,MIA
6504,4,@,L 101-108 ,240,39,89,0.438,28,69,0.406,11,20,0.55,12,15,0.8,101,42,77,0.545,36,60,0.6,6,17,0.353,18,21,0.857,108,2013-04-12,SAC,SAS
6505,5,@,L 101-106 ,240,41,77,0.532,37,66,0.561,4,11,0.364,15,20,0.75,101,43,92,0.467,36,77,0.468,7,15,0.467,13,27,0.481,106,2013-04-15,WAS,BRK
6506,6,@,L 101-109 ,240,39,87,0.448,33,65,0.508,6,22,0.273,17,21,0.81,101,41,83,0.494,32,58,0.552,9,25,0.36,18,22,0.818,109,2013-04-15,PHI,DET
6507,7,Home,W 101-94 ,240,40,76,0.526,29,56,0.518,11,20,0.55,10,16,0.625,101,39,93,0.419,31,78,0.397,8,15,0.533,8,15,0.533,94,2013-10-30,SAS,MEM
6508,8,@,W 101-98 ,240,33,81,0.407,27,62,0.435,6,19,0.316,29,33,0.879,101,36,79,0.456,30,57,0.526,6,22,0.273,20,30,0.667,98,2013-10-30,OKC,UTA
6509,9,Home,W 101-100 ,240,33,68,0.485,25,52,0.481,8,16,0.5,27,39,0.692,101,32,67,0.478,25,53,0.472,7,14,0.5,29,36,0.806,100,2013-11-01,BRK,MIA
6510,10,Home,L 101-110 ,240,36,79,0.456,30,62,0.484,6,17,0.353,23,32,0.719,101,35,70,0.5,23,46,0.5,12,24,0.5,28,34,0.824,110,2013-11-01,SAC,LAC
6511,11,Home,L 101-116 ,240,36,87,0.414,26,56,0.464,10,31,0.323,19,29,0.655,101,41,75,0.547,35,53,0.66,6,22,0.273,28,34,0.824,116,2013-11-05,POR,HOU
6512,12,@,W 101-91 ,240,42,90,0.467,30,64,0.469,12,26,0.462,5,9,0.556,101,31,76,0.408,27,60,0.45,4,16,0.25,25,30,0.833,91,2013-11-08,NYK,CHA
6513,13,Home,W 101-94 ,240,38,78,0.487,31,56,0.554,7,22,0.318,18,23,0.783,101,39,88,0.443,35,75,0.467,4,13,0.308,12,13,0.923,94,2013-11-10,PHO,NOP
6514,14,Home,L 101-113 ,240,36,77,0.468,29,60,0.483,7,17,0.412,22,30,0.733,101,37,86,0.43,27,65,0.415,10,21,0.476,29,35,0.829,113,2013-11-23,GSW,POR
6515,15,@,L 101-112 ,240,40,100,0.4,32,74,0.432,8,26,0.308,13,17,0.765,101,41,79,0.519,24,48,0.5,17,31,0.548,13,16,0.813,112,2013-11-23,MIN,HOU
6516,16,Home,W 101-99 ,240,37,78,0.474,31,53,0.585,6,25,0.24,21,26,0.808,101,34,73,0.466,24,50,0.48,10,23,0.435,21,29,0.724,99,2013-11-23,MIA,ORL
6517,17,Home,L 101-102 ,240,41,87,0.471,32,68,0.471,9,19,0.474,10,13,0.769,101,40,88,0.455,33,69,0.478,7,19,0.368,15,21,0.714,102,2013-11-26,NOP,GSW
6518,18,Home,L 101-112 ,240,40,83,0.482,35,63,0.556,5,20,0.25,16,20,0.8,101,41,75,0.547,33,50,0.66,8,25,0.32,22,25,0.88,112,2013-11-29,UTA,PHO
6519,19,@,L 101-108 ,240,36,81,0.444,29,64,0.453,7,17,0.412,22,26,0.846,101,38,78,0.487,26,54,0.481,12,24,0.5,20,30,0.667,108,2013-11-30,ATL,WAS
6520,20,@,W 101-81 ,240,38,80,0.475,27,60,0.45,11,20,0.55,14,18,0.778,101,29,77,0.377,26,64,0.406,3,13,0.231,20,26,0.769,81,2013-12-05,LAC,MEM
6521,21,@,W 101-92 ,240,38,86,0.442,34,68,0.5,4,18,0.222,21,28,0.75,101,31,87,0.356,22,61,0.361,9,26,0.346,21,27,0.778,92,2013-12-10,OKC,ATL
6522,22,Home,L 101-122 ,240,35,78,0.449,31,65,0.477,4,13,0.308,27,33,0.818,101,48,89,0.539,35,66,0.53,13,23,0.565,13,15,0.867,122,2013-12-11,SAC,UTA
6523,23,Home,W 101-99 (OT),265,38,89,0.427,31,68,0.456,7,21,0.333,18,24,0.75,101,42,100,0.42,38,86,0.442,4,14,0.286,11,18,0.611,99,2013-12-13,ATL,WAS
6524,24,@,W 101-93 ,240,35,79,0.443,23,53,0.434,12,26,0.462,19,25,0.76,101,37,83,0.446,32,68,0.471,5,15,0.333,14,20,0.7,93,2013-12-15,MIN,MEM
6525,25,Home,W 101-98 ,240,39,87,0.448,34,68,0.5,5,19,0.263,18,20,0.9,101,37,82,0.451,30,58,0.517,7,24,0.292,17,26,0.654,98,2013-12-15,OKC,ORL
6526,26,Home,W 101-97 ,240,38,86,0.442,31,65,0.477,7,21,0.333,18,23,0.783,101,37,98,0.378,29,69,0.42,8,29,0.276,15,26,0.577,97,2013-12-16,BOS,MIN
6527,27,@,W 101-96 ,240,38,88,0.432,31,68,0.456,7,20,0.35,18,28,0.643,101,35,81,0.432,29,64,0.453,6,17,0.353,20,27,0.741,96,2013-12-16,DET,IND
6528,28,Home,L 101-102 ,240,33,79,0.418,22,49,0.449,11,30,0.367,24,31,0.774,101,39,72,0.542,28,54,0.519,11,18,0.611,13,17,0.765,102,2013-12-16,NYK,WAS
6529,29,Home,L 101-107 (2OT),290,34,82,0.415,26,60,0.433,8,22,0.364,25,35,0.714,101,38,101,0.376,21,60,0.35,17,41,0.415,14,19,0.737,107,2013-12-18,MIL,NYK
6530,30,Home,L 101-108 ,240,38,82,0.463,31,67,0.463,7,15,0.467,18,24,0.75,101,41,87,0.471,34,69,0.493,7,18,0.389,19,24,0.792,108,2013-12-18,PHO,SAS
6531,31,@,W 101-95 ,240,41,80,0.513,32,53,0.604,9,27,0.333,10,17,0.588,101,33,79,0.418,19,43,0.442,14,36,0.389,15,26,0.577,95,2013-12-25,MIA,LAL
6532,32,@,L 101-115 ,240,37,95,0.389,26,66,0.394,11,29,0.379,16,22,0.727,101,44,95,0.463,35,62,0.565,9,33,0.273,18,23,0.783,115,2013-12-28,PHI,PHO
6533,33,Home,L 101-105 ,240,37,77,0.481,23,45,0.511,14,32,0.438,13,19,0.684,101,39,76,0.513,30,59,0.508,9,17,0.529,18,20,0.9,105,2014-01-02,SAS,NYK
6534,34,@,W 101-100 ,240,39,87,0.448,33,60,0.55,6,27,0.222,17,25,0.68,101,37,80,0.463,27,49,0.551,10,31,0.323,16,19,0.842,100,2014-01-03,GSW,ATL
6535,35,@,W 101-88 ,240,40,79,0.506,29,57,0.509,11,22,0.5,10,13,0.769,101,34,82,0.415,30,70,0.429,4,12,0.333,16,17,0.941,88,2014-01-03,TOR,WAS
6536,36,@,W 101-99 ,240,40,88,0.455,36,74,0.486,4,14,0.286,17,24,0.708,101,36,99,0.364,33,77,0.429,3,22,0.136,24,30,0.8,99,2014-01-04,PHI,POR
6537,37,Home,W 101-81 ,240,35,83,0.422,24,52,0.462,11,31,0.355,20,24,0.833,101,30,84,0.357,23,65,0.354,7,19,0.368,14,21,0.667,81,2014-01-06,LAC,ORL
6538,38,@,W 101-80 ,240,39,85,0.459,29,53,0.547,10,32,0.313,13,20,0.65,101,31,80,0.388,26,65,0.4,5,15,0.333,13,18,0.722,80,2014-01-07,GSW,MIL
6539,39,@,L 101-112 ,240,35,89,0.393,29,55,0.527,6,34,0.176,25,31,0.806,101,40,68,0.588,32,50,0.64,8,18,0.444,24,31,0.774,112,2014-01-07,OKC,UTA
6540,40,Home,W 101-88 ,240,37,90,0.411,23,59,0.39,14,31,0.452,13,18,0.722,101,30,85,0.353,24,61,0.393,6,24,0.25,22,27,0.815,88,2014-01-09,DEN,OKC
6541,41,Home,W 101-85 ,240,35,86,0.407,25,61,0.41,10,25,0.4,21,27,0.778,101,32,81,0.395,20,50,0.4,12,31,0.387,9,14,0.643,85,2014-01-11,OKC,MIL
6542,42,@,L 101-108 ,240,38,80,0.475,29,53,0.547,9,27,0.333,16,24,0.667,101,43,83,0.518,37,68,0.544,6,15,0.4,16,20,0.8,108,2014-01-12,ATL,MEM
6543,43,@,W 101-95 ,240,35,67,0.522,30,55,0.545,5,12,0.417,26,31,0.839,101,38,87,0.437,31,76,0.408,7,11,0.636,12,17,0.706,95,2014-01-13,SAS,NOP
6544,44,Home,L 101-111 ,240,38,82,0.463,28,57,0.491,10,25,0.4,15,21,0.714,101,39,74,0.527,32,59,0.542,7,15,0.467,26,35,0.743,111,2014-01-17,ORL,CHA
6545,45,@,W 101-86 ,240,38,80,0.475,30,57,0.526,8,23,0.348,17,20,0.85,101,31,84,0.369,29,64,0.453,2,20,0.1,22,37,0.595,86,2014-01-17,MIA,PHI
6546,46,Home,W 101-90 ,240,40,81,0.494,30,53,0.566,10,28,0.357,11,13,0.846,101,33,72,0.458,26,53,0.491,7,19,0.368,17,23,0.739,90,2014-01-21,BRK,ORL
6547,47,@,L 101-104 ,240,36,84,0.429,32,69,0.464,4,15,0.267,25,34,0.735,101,41,84,0.488,33,57,0.579,8,27,0.296,14,22,0.636,104,2014-01-22,DET,MIL
6548,48,@,W 101-83 ,240,43,80,0.538,38,67,0.567,5,13,0.385,10,13,0.769,101,32,75,0.427,27,48,0.563,5,27,0.185,14,19,0.737,83,2014-01-24,OKC,BOS
6549,49,Home,L 101-103 ,240,37,85,0.435,31,67,0.463,6,18,0.333,21,28,0.75,101,37,73,0.507,30,56,0.536,7,17,0.412,22,24,0.917,103,2014-01-24,DET,NOP
6550,50,@,W 101-95 ,240,39,86,0.453,33,70,0.471,6,16,0.375,17,23,0.739,101,34,71,0.479,27,49,0.551,7,22,0.318,20,25,0.8,95,2014-01-24,WAS,PHO
6551,51,@,L 101-104 ,240,39,91,0.429,32,71,0.451,7,20,0.35,16,18,0.889,101,38,81,0.469,28,57,0.491,10,24,0.417,18,22,0.818,104,2014-01-25,WAS,UTA
6552,52,@,L 101-113 ,240,38,76,0.5,32,54,0.593,6,22,0.273,19,23,0.826,101,43,74,0.581,35,55,0.636,8,19,0.421,19,20,0.95,113,2014-01-26,SAS,MIA
6553,53,@,W 101-98 ,240,33,78,0.423,28,64,0.438,5,14,0.357,30,42,0.714,101,39,100,0.39,30,72,0.417,9,28,0.321,11,13,0.846,98,2014-01-29,CHA,DEN
6554,54,Home,W 101-98 ,240,36,81,0.444,25,63,0.397,11,18,0.611,18,21,0.857,101,34,78,0.436,19,44,0.432,15,34,0.441,15,24,0.625,98,2014-02-03,MIL,NYK
6555,55,@,W 101-92 ,240,35,78,0.449,29,60,0.483,6,18,0.333,25,31,0.806,101,31,80,0.388,23,52,0.442,8,28,0.286,22,29,0.759,92,2014-02-04,CHI,PHO
6556,56,@,L 101-109 ,240,36,84,0.429,26,59,0.441,10,25,0.4,19,24,0.792,101,32,81,0.395,28,69,0.406,4,12,0.333,41,51,0.804,109,2014-02-05,TOR,SAC
6557,57,@,W 101-95 ,240,42,85,0.494,34,61,0.557,8,24,0.333,9,13,0.692,101,40,90,0.444,34,75,0.453,6,15,0.4,9,11,0.818,95,2014-02-08,HOU,MIL
6558,58,@,L 101-108 ,240,39,77,0.506,33,65,0.508,6,12,0.5,17,26,0.654,101,36,76,0.474,26,52,0.5,10,24,0.417,26,33,0.788,108,2014-02-10,NOP,TOR
6559,59,Home,L 101-106 (OT),265,41,90,0.456,32,66,0.485,9,24,0.375,10,14,0.714,101,40,85,0.471,30,62,0.484,10,23,0.435,16,19,0.842,106,2014-02-12,NYK,SAC
6560,60,Home,W 101-93 ,240,33,80,0.413,28,60,0.467,5,20,0.25,30,37,0.811,101,35,89,0.393,29,67,0.433,6,22,0.273,17,24,0.708,93,2014-02-19,CLE,ORL
6561,61,@,W 101-92 ,240,39,86,0.453,36,67,0.537,3,19,0.158,20,24,0.833,101,33,79,0.418,27,62,0.435,6,17,0.353,20,28,0.714,92,2014-02-19,GSW,SAC
6562,62,@,W 101-90 ,240,39,76,0.513,31,58,0.534,8,18,0.444,15,26,0.577,101,35,82,0.427,31,61,0.508,4,21,0.19,16,20,0.8,90,2014-02-20,DEN,MIL
6563,63,Home,W 101-92 ,240,40,83,0.482,33,61,0.541,7,22,0.318,14,19,0.737,101,38,97,0.392,34,75,0.453,4,22,0.182,12,17,0.706,92,2014-02-21,LAL,BOS
6564,64,Home,L 101-110 ,240,42,95,0.442,39,80,0.488,3,15,0.2,14,18,0.778,101,42,87,0.483,37,69,0.536,5,18,0.278,21,32,0.656,110,2014-02-25,PHO,MIN
6565,65,Home,W 101-93 ,240,41,93,0.441,33,69,0.478,8,24,0.333,11,13,0.846,101,34,77,0.442,26,52,0.5,8,25,0.32,17,24,0.708,93,2014-02-26,LAC,HOU
6566,66,@,W 101-90 ,240,39,94,0.415,30,76,0.395,9,18,0.5,14,16,0.875,101,32,87,0.368,27,65,0.415,5,22,0.227,21,28,0.75,90,2014-02-26,ORL,PHI
6567,67,Home,W 101-96 ,240,38,74,0.514,32,59,0.542,6,15,0.4,19,22,0.864,101,38,87,0.437,26,63,0.413,12,24,0.5,8,11,0.727,96,2014-02-27,IND,MIL
6568,68,Home,L 101-122 ,240,38,79,0.481,28,60,0.467,10,19,0.526,15,20,0.75,101,43,90,0.478,29,57,0.509,14,33,0.424,22,24,0.917,122,2014-03-04,CLE,SAS
6569,69,@,W 101-89 ,240,40,82,0.488,34,60,0.567,6,22,0.273,15,24,0.625,101,38,84,0.452,35,70,0.5,3,14,0.214,10,12,0.833,89,2014-03-05,HOU,ORL
6570,70,Home,W 101-92 ,240,36,77,0.468,27,48,0.563,9,29,0.31,20,22,0.909,101,37,86,0.43,34,69,0.493,3,17,0.176,15,20,0.75,92,2014-03-07,CHA,CLE
6571,71,@,L 101-114 ,240,38,94,0.404,34,81,0.42,4,13,0.308,21,30,0.7,101,41,91,0.451,35,71,0.493,6,20,0.3,26,33,0.788,114,2014-03-07,DET,MIN
6572,72,Home,W 101-97 ,240,34,70,0.486,23,50,0.46,11,20,0.55,22,31,0.71,101,35,71,0.493,29,48,0.604,6,23,0.261,21,24,0.875,97,2014-03-10,BRK,TOR
6573,73,@,L 101-112 ,240,39,74,0.527,34,59,0.576,5,15,0.333,18,29,0.621,101,41,85,0.482,33,65,0.508,8,20,0.4,22,30,0.733,112,2014-03-11,MIL,MIN
6574,74,Home,L 101-110 ,240,39,90,0.433,29,54,0.537,10,36,0.278,13,22,0.591,101,38,81,0.469,26,57,0.456,12,24,0.5,22,27,0.815,110,2014-03-12,PHO,CLE
6575,75,Home,W 101-87 ,240,37,88,0.42,29,68,0.426,8,20,0.4,19,25,0.76,101,34,78,0.436,25,56,0.446,9,22,0.409,10,24,0.417,87,2014-03-12,TOR,DET
6576,76,Home,L 101-108 ,240,40,85,0.471,35,59,0.593,5,26,0.192,16,21,0.762,101,42,79,0.532,29,58,0.5,13,21,0.619,11,12,0.917,108,2014-03-12,UTA,DAL
6577,77,Home,L 101-105 (OT),265,43,97,0.443,36,72,0.5,7,25,0.28,8,10,0.8,101,36,90,0.4,26,67,0.388,10,23,0.435,23,29,0.793,105,2014-03-14,ORL,WAS
6578,78,@,W 101-94 ,240,39,67,0.582,30,46,0.652,9,21,0.429,14,22,0.636,101,35,90,0.389,27,64,0.422,8,26,0.308,16,18,0.889,94,2014-03-14,IND,PHI
6579,79,Home,W 101-94 ,240,36,77,0.468,28,51,0.549,8,26,0.308,21,25,0.84,101,34,71,0.479,23,50,0.46,11,21,0.524,15,22,0.682,94,2014-03-15,WAS,BRK
6580,80,@,W 101-92 ,240,39,68,0.574,30,48,0.625,9,20,0.45,14,18,0.778,101,37,89,0.416,30,71,0.423,7,18,0.389,11,16,0.688,92,2014-03-16,CHA,MIL
6581,81,Home,W 101-96 ,240,39,77,0.506,26,49,0.531,13,28,0.464,10,12,0.833,101,40,81,0.494,36,64,0.563,4,17,0.235,12,15,0.8,96,2014-03-19,BOS,MIA
6582,82,Home,W 101-97 ,240,39,79,0.494,33,65,0.508,6,14,0.429,17,25,0.68,101,34,80,0.425,25,49,0.51,9,31,0.29,20,28,0.714,97,2014-03-29,WAS,ATL
6583,83,Home,W 101-94 ,240,39,79,0.494,34,61,0.557,5,18,0.278,18,24,0.75,101,34,93,0.366,27,77,0.351,7,16,0.438,19,28,0.679,94,2014-04-02,IND,DET
6584,84,Home,L 101-105 ,240,36,79,0.456,26,56,0.464,10,23,0.435,19,27,0.704,101,41,80,0.513,35,59,0.593,6,21,0.286,17,23,0.739,105,2014-04-05,PHI,BRK
6585,85,Home,L 101-107 ,240,36,86,0.419,28,59,0.475,8,27,0.296,21,34,0.618,101,38,90,0.422,33,69,0.478,5,21,0.238,26,32,0.813,107,2014-04-09,LAC,OKC
6586,86,Home,W 101-98 ,240,39,79,0.494,28,55,0.509,11,24,0.458,12,15,0.8,101,36,78,0.462,28,61,0.459,8,17,0.471,18,23,0.783,98,2014-04-12,DAL,PHO
6587,87,Home,W 101-94 ,240,35,84,0.417,28,62,0.452,7,22,0.318,24,29,0.828,101,34,79,0.43,32,66,0.485,2,13,0.154,24,32,0.75,94,2014-04-12,DEN,UTA
6588,88,@,L 101-117 ,240,35,82,0.427,31,73,0.425,4,9,0.444,27,33,0.818,101,41,81,0.506,32,62,0.516,9,19,0.474,26,36,0.722,117,2014-04-12,SAC,LAC
6589,89,Home,W 101-89 ,240,35,79,0.443,26,50,0.52,9,29,0.31,22,30,0.733,101,31,77,0.403,22,45,0.489,9,32,0.281,18,22,0.818,89,2014-04-14,NOP,OKC
6590,90,@,W 101-86 ,240,41,88,0.466,30,65,0.462,11,23,0.478,8,11,0.727,101,32,79,0.405,27,64,0.422,5,15,0.333,17,24,0.708,86,2014-04-16,IND,ORL
6591,91,Home,W 101-84 ,240,41,101,0.406,37,84,0.44,4,17,0.235,15,31,0.484,101,32,84,0.381,28,73,0.384,4,11,0.364,16,21,0.762,84,2014-10-28,NOP,ORL
6592,92,Home,W 101-100 ,240,37,70,0.529,23,42,0.548,14,28,0.5,13,16,0.813,101,38,78,0.487,30,57,0.526,8,21,0.381,16,19,0.842,100,2014-10-28,SAS,DAL
6593,93,@,L 101-105 ,240,39,86,0.453,33,74,0.446,6,12,0.5,17,23,0.739,101,43,82,0.524,39,67,0.582,4,15,0.267,15,20,0.75,105,2014-10-29,MIN,MEM
6594,94,@,L 101-107 ,240,36,77,0.468,26,50,0.52,10,27,0.37,19,24,0.792,101,41,81,0.506,31,58,0.534,10,23,0.435,15,17,0.882,107,2014-11-03,UTA,LAC
6595,95,Home,W 101-82 ,240,37,75,0.493,29,50,0.58,8,25,0.32,19,25,0.76,101,31,85,0.365,22,64,0.344,9,21,0.429,11,14,0.786,82,2014-11-04,POR,CLE
6596,96,Home,W 101-98 ,240,39,85,0.459,30,58,0.517,9,27,0.333,14,16,0.875,101,40,88,0.455,35,69,0.507,5,19,0.263,13,13,1.0,98,2014-11-07,BOS,IND
6597,97,Home,L 101-110 ,240,40,85,0.471,29,56,0.518,11,29,0.379,10,15,0.667,101,40,84,0.476,34,61,0.557,6,23,0.261,24,33,0.727,110,2014-11-07,DEN,CLE
6598,98,Home,L 101-106 ,240,42,92,0.457,34,74,0.459,8,18,0.444,9,15,0.6,101,42,81,0.519,35,62,0.565,7,19,0.368,15,20,0.75,106,2014-11-08,CHI,BOS
6599,99,Home,W 101-93 ,240,36,78,0.462,30,60,0.5,6,18,0.333,23,27,0.852,101,36,80,0.45,30,56,0.536,6,24,0.25,15,22,0.682,93,2014-11-09,OKC,SAC
6600,0,Home,L 101-113 ,240,36,81,0.444,30,69,0.435,6,12,0.5,23,30,0.767,101,43,89,0.483,30,61,0.492,13,28,0.464,14,19,0.737,113,2014-11-12,MIN,HOU
6601,1,Home,W 101-85 ,240,35,80,0.438,25,56,0.446,10,24,0.417,21,27,0.778,101,36,80,0.45,34,61,0.557,2,19,0.105,11,14,0.786,85,2014-11-14,ORL,MIL
6602,2,@,W 101-90 ,240,41,83,0.494,35,63,0.556,6,20,0.3,13,21,0.619,101,34,86,0.395,27,65,0.415,7,21,0.333,15,21,0.714,90,2014-11-19,BOS,PHI
6603,3,Home,W 101-88 ,240,41,82,0.5,35,59,0.593,6,23,0.261,13,19,0.684,101,35,82,0.427,29,65,0.446,6,17,0.353,12,19,0.632,88,2014-11-21,GSW,UTA
6604,4,Home,L 101-113 ,240,37,90,0.411,31,73,0.425,6,17,0.353,21,27,0.778,101,40,81,0.494,32,55,0.582,8,26,0.308,25,30,0.833,113,2014-11-22,MIN,SAC
6605,5,@,W 101-94 (OT),265,34,90,0.378,24,53,0.453,10,37,0.27,23,38,0.605,101,33,89,0.371,30,65,0.462,3,24,0.125,25,34,0.735,94,2014-11-23,DEN,LAL
6606,6,Home,L 101-106 ,240,38,87,0.437,32,68,0.471,6,19,0.316,19,23,0.826,101,42,99,0.424,35,73,0.479,7,26,0.269,15,16,0.938,106,2014-11-28,CHA,GSW
6607,7,@,L 101-127 ,240,35,82,0.427,33,70,0.471,2,12,0.167,29,40,0.725,101,41,80,0.513,26,46,0.565,15,34,0.441,30,36,0.833,127,2014-12-01,MIN,LAC
6608,8,Home,L 101-103 ,240,36,84,0.429,29,66,0.439,7,18,0.389,22,30,0.733,101,41,87,0.471,32,61,0.525,9,26,0.346,12,17,0.706,103,2014-12-01,UTA,DEN
6609,9,Home,L 101-107 ,240,37,80,0.463,32,68,0.471,5,12,0.417,22,26,0.846,101,40,84,0.476,26,59,0.441,14,25,0.56,13,16,0.813,107,2014-12-05,MEM,SAS
6610,10,@,L 101-102 (OT),265,36,96,0.375,30,70,0.429,6,26,0.231,23,29,0.793,101,36,83,0.434,34,73,0.466,2,10,0.2,28,40,0.7,102,2014-12-05,IND,SAC
6611,11,Home,L 101-108 (OT),265,34,87,0.391,28,64,0.438,6,23,0.261,27,35,0.771,101,40,87,0.46,33,64,0.516,7,23,0.304,21,30,0.7,108,2014-12-06,DET,PHI
6612,12,@,L 101-123 ,240,35,83,0.422,29,67,0.433,6,16,0.375,25,32,0.781,101,47,82,0.573,40,64,0.625,7,18,0.389,22,25,0.88,123,2014-12-06,MIN,SAS
6613,13,Home,W 101-93 ,240,36,88,0.409,28,71,0.394,8,17,0.471,21,26,0.808,101,34,93,0.366,23,66,0.348,11,27,0.407,14,21,0.667,93,2014-12-07,BOS,WAS
6614,14,Home,W 101-92 ,240,35,74,0.473,32,66,0.485,3,8,0.375,28,36,0.778,101,32,79,0.405,29,62,0.468,3,17,0.176,25,37,0.676,92,2014-12-08,SAC,UTA
6615,15,@,L 101-105 ,240,42,82,0.512,35,59,0.593,7,23,0.304,10,10,1.0,101,39,79,0.494,30,53,0.566,9,26,0.346,18,21,0.857,105,2014-12-09,TOR,CLE
6616,16,@,L 101-114 ,240,34,84,0.405,30,63,0.476,4,21,0.19,29,35,0.829,101,41,82,0.5,37,61,0.607,4,21,0.19,28,34,0.824,114,2014-12-09,MIL,OKC
6617,17,@,W 101-95 ,240,40,81,0.494,34,65,0.523,6,16,0.375,15,18,0.833,101,37,85,0.435,30,63,0.476,7,22,0.318,14,18,0.778,95,2014-12-12,NYK,BOS
6618,18,@,W 101-94 ,240,39,73,0.534,35,62,0.565,4,11,0.364,19,24,0.792,101,37,83,0.446,25,61,0.41,12,22,0.545,8,12,0.667,94,2014-12-19,UTA,ORL
6619,19,@,W 101-99 ,240,43,90,0.478,36,70,0.514,7,20,0.35,8,10,0.8,101,38,83,0.458,33,63,0.524,5,20,0.25,18,24,0.75,99,2014-12-21,NOP,OKC
6620,20,@,L 101-108 ,240,33,87,0.379,23,61,0.377,10,26,0.385,25,30,0.833,101,38,79,0.481,31,56,0.554,7,23,0.304,25,36,0.694,108,2014-12-21,LAL,SAC
6621,21,Home,L 101-108 ,240,39,82,0.476,31,61,0.508,8,21,0.381,15,20,0.75,101,36,82,0.439,28,61,0.459,8,21,0.381,28,36,0.778,108,2014-12-23,MIL,CHO
6622,22,Home,W 101-91 ,240,40,84,0.476,33,63,0.524,7,21,0.333,14,17,0.824,101,32,72,0.444,26,46,0.565,6,26,0.231,21,33,0.636,91,2014-12-25,MIA,CLE
6623,23,Home,W 101-88 ,240,45,90,0.5,40,77,0.519,5,13,0.385,6,10,0.6,101,32,79,0.405,26,55,0.473,6,24,0.25,18,24,0.75,88,2014-12-27,WAS,BOS
6624,24,Home,W 101-79 ,240,38,81,0.469,22,45,0.489,16,36,0.444,9,12,0.75,101,31,93,0.333,24,66,0.364,7,27,0.259,10,15,0.667,79,2014-12-28,POR,NYK
6625,25,Home,W 101-97 ,240,37,81,0.457,27,58,0.466,10,23,0.435,17,22,0.773,101,38,92,0.413,30,73,0.411,8,19,0.421,13,22,0.591,97,2014-12-29,LAC,UTA
6626,26,Home,L 101-102 ,240,33,63,0.524,26,49,0.531,7,14,0.5,28,40,0.7,101,41,77,0.532,30,52,0.577,11,25,0.44,9,13,0.692,102,2014-12-29,MIA,ORL
6627,27,@,L 101-109 ,240,37,84,0.44,24,53,0.453,13,31,0.419,14,21,0.667,101,40,79,0.506,30,50,0.6,10,29,0.345,19,26,0.731,109,2014-12-30,CLE,ATL
6628,28,@,L 101-106 ,240,37,92,0.402,32,78,0.41,5,14,0.357,22,27,0.815,101,38,91,0.418,30,76,0.395,8,15,0.533,22,25,0.88,106,2015-01-01,DEN,CHI
6629,29,Home,L 101-119 ,240,38,89,0.427,26,55,0.473,12,34,0.353,13,19,0.684,101,45,96,0.469,32,69,0.464,13,27,0.481,16,17,0.941,119,2015-01-02,BOS,DAL
6630,30,@,W 101-89 ,240,38,75,0.507,27,55,0.491,11,20,0.55,14,21,0.667,101,34,86,0.395,28,67,0.418,6,19,0.316,15,18,0.833,89,2015-01-03,UTA,MIN
6631,31,Home,W 101-92 ,240,43,78,0.551,39,62,0.629,4,16,0.25,11,18,0.611,101,40,82,0.488,36,68,0.529,4,14,0.286,8,13,0.615,92,2015-01-03,SAS,WAS
6632,32,Home,L 101-110 ,240,38,89,0.427,28,65,0.431,10,24,0.417,15,18,0.833,101,46,84,0.548,39,65,0.6,7,19,0.368,11,16,0.688,110,2015-01-05,MIN,DEN
6633,33,Home,L 101-105 ,240,35,81,0.432,31,58,0.534,4,23,0.174,27,34,0.794,101,35,74,0.473,28,61,0.459,7,13,0.538,28,30,0.933,105,2015-01-05,UTA,IND
6634,34,Home,W 101-91 ,240,39,76,0.513,31,60,0.517,8,16,0.5,15,21,0.714,101,34,82,0.415,23,56,0.411,11,26,0.423,12,16,0.75,91,2015-01-07,WAS,NYK
6635,35,Home,W 101-84 ,240,36,90,0.4,29,69,0.42,7,21,0.333,22,31,0.71,101,30,76,0.395,24,62,0.387,6,14,0.429,18,23,0.783,84,2015-01-09,LAL,ORL
6636,36,Home,L 101-110 ,240,39,80,0.488,34,62,0.548,5,18,0.278,18,30,0.6,101,41,87,0.471,31,67,0.463,10,20,0.5,18,19,0.947,110,2015-01-13,IND,MIN
6637,37,Home,W 101-93 ,240,37,75,0.493,31,63,0.492,6,12,0.5,21,24,0.875,101,38,96,0.396,29,67,0.433,9,29,0.31,8,12,0.667,93,2015-01-13,WAS,SAS
6638,38,@,L 101-112 ,240,35,81,0.432,24,52,0.462,11,29,0.379,20,28,0.714,101,41,86,0.477,25,50,0.5,16,36,0.444,14,19,0.737,112,2015-01-15,OKC,HOU
6639,39,@,W 101-99 ,240,32,71,0.451,18,40,0.45,14,31,0.452,23,28,0.821,101,42,92,0.457,37,79,0.468,5,13,0.385,10,12,0.833,99,2015-01-22,UTA,MIL
6640,40,@,L 101-126 ,240,34,82,0.415,30,65,0.462,4,17,0.235,29,34,0.853,101,45,94,0.479,28,54,0.519,17,40,0.425,19,22,0.864,126,2015-01-23,SAC,GSW
6641,41,Home,W 101-83 ,240,37,79,0.468,31,65,0.477,6,14,0.429,21,25,0.84,101,31,81,0.383,22,57,0.386,9,24,0.375,12,22,0.545,83,2015-01-24,MEM,PHI
6642,42,Home,W 101-86 ,240,41,81,0.506,30,64,0.469,11,17,0.647,8,10,0.8,101,31,86,0.36,25,61,0.41,6,25,0.24,18,25,0.72,86,2015-01-24,MIL,DET
6643,43,Home,W 101-95 ,240,35,83,0.422,30,61,0.492,5,22,0.227,26,30,0.867,101,39,82,0.476,31,65,0.477,8,17,0.471,9,13,0.692,95,2015-01-25,SAS,MIL
6644,44,Home,W 101-90 ,240,38,80,0.475,27,49,0.551,11,31,0.355,14,22,0.636,101,30,84,0.357,27,66,0.409,3,18,0.167,27,32,0.844,90,2015-01-30,CLE,SAC
6645,45,@,L 101-114 ,240,39,87,0.448,28,55,0.509,11,32,0.344,12,19,0.632,101,41,82,0.5,31,57,0.544,10,25,0.4,22,35,0.629,114,2015-01-31,HOU,DET
6646,46,Home,L 101-102 ,240,42,84,0.5,36,68,0.529,6,16,0.375,11,18,0.611,101,36,83,0.434,33,72,0.458,3,11,0.273,27,34,0.794,102,2015-02-02,PHO,MEM
6647,47,Home,W 101-90 ,240,38,92,0.413,30,65,0.462,8,27,0.296,17,23,0.739,101,31,89,0.348,23,64,0.359,8,25,0.32,20,26,0.769,90,2015-02-04,HOU,CHI
6648,48,@,L 101-102 ,240,39,80,0.488,32,64,0.5,7,16,0.438,16,24,0.667,101,37,72,0.514,31,61,0.508,6,11,0.545,22,27,0.815,102,2015-02-04,MIA,MIN
6649,49,@,W 101-78 ,240,41,96,0.427,29,62,0.468,12,34,0.353,7,10,0.7,101,29,79,0.367,26,58,0.448,3,21,0.143,17,22,0.773,78,2015-02-05,DAL,SAC
6650,50,@,L 101-111 (OT),265,37,89,0.416,27,57,0.474,10,32,0.313,17,24,0.708,101,43,105,0.41,29,69,0.42,14,36,0.389,11,16,0.688,111,2015-02-07,POR,DAL
6651,51,Home,L 101-112 ,240,37,79,0.468,27,48,0.563,10,31,0.323,17,22,0.773,101,39,76,0.513,34,64,0.531,5,12,0.417,29,34,0.853,112,2015-02-08,DET,MIN
6652,52,@,L 101-109 ,240,40,100,0.4,34,78,0.436,6,22,0.273,15,26,0.577,101,40,83,0.482,32,61,0.525,8,22,0.364,21,26,0.808,109,2015-02-20,BOS,SAC
6653,53,@,W 101-83 ,240,40,79,0.506,28,46,0.609,12,33,0.364,9,15,0.6,101,37,99,0.374,34,80,0.425,3,19,0.158,6,7,0.857,83,2015-02-22,CLE,NYK
6654,54,Home,W 101-93 ,240,40,85,0.471,34,67,0.507,6,18,0.333,15,22,0.682,101,34,87,0.391,30,70,0.429,4,17,0.235,21,29,0.724,93,2015-02-27,LAL,MIL
6655,55,@,W 101-97 ,240,38,64,0.594,34,53,0.642,4,11,0.364,21,29,0.724,101,34,88,0.386,27,69,0.391,7,19,0.368,22,27,0.815,97,2015-02-28,MEM,MIN
6656,56,@,W 101-74 ,240,41,92,0.446,37,73,0.507,4,19,0.211,15,17,0.882,101,25,84,0.298,20,68,0.294,5,16,0.313,19,24,0.792,74,2015-02-28,SAS,PHO
6657,57,Home,L 101-106 ,240,40,109,0.367,32,78,0.41,8,31,0.258,13,17,0.765,101,40,95,0.421,28,61,0.459,12,34,0.353,14,17,0.824,106,2015-03-01,BOS,GSW
6658,58,Home,L 101-108 ,240,40,90,0.444,31,65,0.477,9,25,0.36,12,18,0.667,101,40,97,0.412,29,65,0.446,11,32,0.344,17,23,0.739,108,2015-03-01,LAL,OKC
6659,59,Home,L 101-108 ,240,39,89,0.438,36,75,0.48,3,14,0.214,20,25,0.8,101,41,79,0.519,35,62,0.565,6,17,0.353,20,23,0.87,108,2015-03-08,DET,CHO
6660,60,@,W 101-91 ,240,42,84,0.5,37,70,0.529,5,14,0.357,12,17,0.706,101,35,80,0.438,25,58,0.431,10,22,0.455,11,14,0.786,91,2015-03-09,MEM,CHI
6661,61,@,W 101-94 ,240,36,77,0.468,27,59,0.458,9,18,0.5,20,26,0.769,101,38,90,0.422,33,72,0.458,5,18,0.278,13,21,0.619,94,2015-03-12,NYK,LAL
6662,62,Home,W 101-91 ,240,33,89,0.371,26,70,0.371,7,19,0.368,28,33,0.848,101,31,82,0.378,16,50,0.32,15,32,0.469,14,19,0.737,91,2015-03-13,CHA,CHI
6663,63,Home,L 101-112 ,240,34,76,0.447,26,54,0.481,8,22,0.364,25,36,0.694,101,41,77,0.532,33,59,0.559,8,18,0.444,22,32,0.688,112,2015-03-20,DAL,MEM
6664,64,Home,W 101-91 ,240,37,78,0.474,28,57,0.491,9,21,0.429,18,25,0.72,101,36,91,0.396,30,73,0.411,6,18,0.333,13,16,0.813,91,2015-03-20,SAC,CHO
6665,65,Home,W 101-89 ,240,38,81,0.469,33,58,0.569,5,23,0.217,20,23,0.87,101,35,88,0.398,30,68,0.441,5,20,0.25,14,20,0.7,89,2015-03-20,SAS,BOS
6666,66,Home,W 101-87 ,240,39,81,0.481,34,67,0.507,5,14,0.357,18,22,0.818,101,32,89,0.36,23,62,0.371,9,27,0.333,14,21,0.667,87,2015-03-22,LAL,PHI
6667,67,Home,W 101-94 ,240,42,87,0.483,35,65,0.538,7,22,0.318,10,13,0.769,101,36,85,0.424,28,57,0.491,8,28,0.286,14,18,0.778,94,2015-03-24,DAL,SAS
6668,68,@,W 101-99 (OT),265,39,92,0.424,33,66,0.5,6,26,0.231,17,18,0.944,101,33,78,0.423,27,56,0.482,6,22,0.273,27,30,0.9,99,2015-03-25,LAL,MIN
6669,69,Home,L 101-103 ,240,33,75,0.44,28,61,0.459,5,14,0.357,30,38,0.789,101,38,85,0.447,29,59,0.492,9,26,0.346,18,28,0.643,103,2015-03-25,WAS,IND
6670,70,Home,W 101-88 ,240,36,79,0.456,27,50,0.54,9,29,0.31,20,24,0.833,101,34,75,0.453,30,58,0.517,4,17,0.235,16,23,0.696,88,2015-03-30,ATL,MIL
6671,71,Home,L 101-108 ,240,37,84,0.44,29,58,0.5,8,26,0.308,19,27,0.704,101,34,77,0.442,23,46,0.5,11,31,0.355,29,40,0.725,108,2015-04-02,DAL,HOU
6672,72,Home,L 101-110 ,240,39,88,0.443,31,64,0.484,8,24,0.333,15,16,0.938,101,45,85,0.529,36,61,0.59,9,24,0.375,11,18,0.611,110,2015-04-03,BOS,MIL
6673,73,@,W 101-95 ,240,34,87,0.391,20,58,0.345,14,29,0.483,19,28,0.679,101,37,78,0.474,31,61,0.508,6,17,0.353,15,25,0.6,95,2015-04-03,NOP,SAC
6674,74,Home,W 101-87 ,240,43,93,0.462,36,77,0.468,7,16,0.438,8,12,0.667,101,31,84,0.369,24,63,0.381,7,21,0.333,18,20,0.9,87,2015-04-03,WAS,NYK
6675,75,Home,W 101-91 ,240,37,72,0.514,34,59,0.576,3,13,0.231,24,29,0.828,101,38,99,0.384,28,67,0.418,10,32,0.313,5,8,0.625,91,2015-04-05,NYK,PHI
6676,76,@,W 101-95 ,240,40,87,0.46,32,63,0.508,8,24,0.333,13,18,0.722,101,38,79,0.481,33,64,0.516,5,15,0.333,14,24,0.583,95,2015-04-05,UTA,SAC
6677,77,@,L 101-119 ,240,36,75,0.48,31,59,0.525,5,16,0.313,24,35,0.686,101,44,88,0.5,31,58,0.534,13,30,0.433,18,24,0.75,119,2015-04-08,LAL,DEN
6678,78,@,W 101-99 ,240,39,94,0.415,30,64,0.469,9,30,0.3,14,15,0.933,101,41,89,0.461,34,69,0.493,7,20,0.35,10,10,1.0,99,2015-04-10,TOR,ORL
6679,79,@,L 101-110 ,240,35,79,0.443,24,55,0.436,11,24,0.458,20,26,0.769,101,42,93,0.452,31,62,0.5,11,31,0.355,15,21,0.714,110,2015-04-11,MIN,GSW
6680,80,Home,W 101-90 ,240,39,96,0.406,35,75,0.467,4,21,0.19,19,27,0.704,101,38,83,0.458,30,60,0.5,8,23,0.348,6,9,0.667,90,2015-04-13,OKC,POR
6681,81,Home,L 101-112 ,240,39,80,0.488,28,54,0.519,11,26,0.423,12,20,0.6,101,42,87,0.483,27,49,0.551,15,38,0.395,13,18,0.722,112,2015-04-14,PHO,LAC
6682,82,Home,W 101-88 ,240,39,80,0.488,30,56,0.536,9,24,0.375,14,23,0.609,101,38,79,0.481,31,59,0.525,7,20,0.35,5,13,0.385,88,2015-04-15,BRK,ORL
6683,83,Home,L 101-105 ,240,38,83,0.458,33,54,0.611,5,29,0.172,20,25,0.8,101,39,89,0.438,27,58,0.466,12,31,0.387,15,20,0.75,105,2015-04-15,PHI,MIA
6684,84,Home,L 101-112 ,240,38,93,0.409,32,64,0.5,6,29,0.207,19,21,0.905,101,42,83,0.506,32,59,0.542,10,24,0.417,18,26,0.692,112,2015-10-29,NYK,ATL
6685,85,Home,W 101-91 ,240,34,80,0.425,25,57,0.439,9,23,0.391,24,28,0.857,101,38,79,0.481,35,66,0.53,3,13,0.231,12,18,0.667,91,2015-10-31,MEM,BRK
6686,86,@,W 101-90 ,240,39,94,0.415,28,62,0.452,11,32,0.344,12,16,0.75,101,33,79,0.418,25,49,0.51,8,30,0.267,16,28,0.571,90,2015-10-31,PHO,POR
6687,87,Home,L 101-106 ,240,34,79,0.43,31,66,0.47,3,13,0.231,30,39,0.769,101,41,89,0.461,32,59,0.542,9,30,0.3,15,20,0.75,106,2015-11-02,MIN,POR
6688,88,Home,W 101-87 ,240,37,76,0.487,29,54,0.537,8,22,0.364,19,24,0.792,101,36,83,0.434,31,62,0.5,5,21,0.238,10,13,0.769,87,2015-11-04,ATL,BRK
6689,89,Home,W 101-97 ,240,38,83,0.458,30,59,0.508,8,24,0.333,17,25,0.68,101,39,90,0.433,33,72,0.458,6,18,0.333,13,19,0.684,97,2015-11-08,CLE,IND
6690,90,Home,W 101-88 ,240,38,84,0.452,33,64,0.516,5,20,0.25,20,27,0.741,101,34,77,0.442,23,55,0.418,11,22,0.5,9,12,0.75,88,2015-11-10,MIA,LAL
6691,91,Home,L 101-125 ,240,38,97,0.392,33,73,0.452,5,24,0.208,20,26,0.769,101,44,86,0.512,29,63,0.46,15,23,0.652,22,29,0.759,125,2015-11-10,WAS,OKC
6692,92,Home,W 101-99 ,240,40,100,0.4,27,72,0.375,13,28,0.464,8,12,0.667,101,39,79,0.494,32,57,0.561,7,22,0.318,14,18,0.778,99,2015-11-11,ORL,LAL
6693,93,Home,L 101-113 ,240,39,88,0.443,30,66,0.455,9,22,0.409,14,23,0.609,101,46,82,0.561,39,67,0.582,7,15,0.467,14,18,0.778,113,2015-11-11,POR,SAS
6694,94,Home,W 101-92 ,240,37,74,0.5,28,58,0.483,9,16,0.563,18,24,0.75,101,34,89,0.382,25,57,0.439,9,32,0.281,15,20,0.75,92,2015-11-11,SAC,DET
6695,95,Home,W 101-100 ,240,36,86,0.419,30,70,0.429,6,16,0.375,23,27,0.852,101,33,69,0.478,25,47,0.532,8,22,0.364,26,29,0.897,100,2015-11-13,MEM,POR
6696,96,Home,W 101-96 ,240,37,79,0.468,30,60,0.5,7,19,0.368,20,26,0.769,101,33,74,0.446,26,47,0.553,7,27,0.259,23,35,0.657,96,2015-11-14,LAC,DET
6697,97,@,L 101-107 ,240,38,87,0.437,23,56,0.411,15,31,0.484,10,14,0.714,101,39,76,0.513,29,51,0.569,10,25,0.4,19,24,0.792,107,2015-11-15,TOR,SAC
6698,98,@,L 101-120 ,240,37,77,0.481,28,57,0.491,9,20,0.45,18,20,0.9,101,45,93,0.484,34,63,0.54,11,30,0.367,19,25,0.76,120,2015-11-16,LAL,PHO
6699,99,@,L 101-104 (OT),265,36,85,0.424,32,67,0.478,4,18,0.222,25,30,0.833,101,41,110,0.373,32,89,0.36,9,21,0.429,13,21,0.619,104,2015-11-18,MIN,ORL
6700,0,@,L 101-111 ,240,35,82,0.427,21,45,0.467,14,37,0.378,17,21,0.81,101,40,79,0.506,35,64,0.547,5,15,0.333,26,33,0.788,111,2015-11-22,BOS,BRK
6701,1,Home,W 101-87 ,240,39,83,0.47,31,57,0.544,8,26,0.308,15,15,1.0,101,31,87,0.356,21,55,0.382,10,32,0.313,15,18,0.833,87,2015-11-25,CHA,WAS
6702,2,Home,L 101-116 ,240,35,80,0.438,23,50,0.46,12,30,0.4,19,21,0.905,101,35,75,0.467,21,36,0.583,14,39,0.359,32,36,0.889,116,2015-11-27,MEM,ATL
6703,3,@,W 101-91 ,240,37,77,0.481,28,52,0.538,9,25,0.36,18,19,0.947,101,37,86,0.43,29,64,0.453,8,22,0.364,9,15,0.6,91,2015-11-27,MIN,SAC
6704,4,@,L 101-120 ,240,39,100,0.39,29,75,0.387,10,25,0.4,13,15,0.867,101,39,80,0.488,23,50,0.46,16,30,0.533,26,31,0.839,120,2015-11-28,SAC,GSW
6705,5,Home,W 101-87 ,240,38,82,0.463,29,64,0.453,9,18,0.5,16,21,0.762,101,29,69,0.42,24,52,0.462,5,17,0.294,24,30,0.8,87,2015-11-28,UTA,NOP
6706,6,@,L 101-108 ,240,36,88,0.409,29,63,0.46,7,25,0.28,22,25,0.88,101,36,87,0.414,28,60,0.467,8,27,0.296,28,39,0.718,108,2015-12-02,NOP,HOU
6707,7,@,L 101-103 ,240,40,90,0.444,34,70,0.486,6,20,0.3,15,18,0.833,101,37,82,0.451,25,51,0.49,12,31,0.387,17,25,0.68,103,2015-12-05,ORL,LAC
6708,8,Home,L 101-103 ,240,41,90,0.456,35,69,0.507,6,21,0.286,13,18,0.722,101,41,92,0.446,34,75,0.453,7,17,0.412,14,17,0.824,103,2015-12-07,CHI,PHO
6709,9,@,L 101-108 ,240,33,73,0.452,25,54,0.463,8,19,0.421,27,34,0.794,101,39,87,0.448,29,57,0.509,10,30,0.333,20,24,0.833,108,2015-12-13,MIN,PHO
6710,10,@,L 101-105 ,240,36,82,0.439,28,57,0.491,8,25,0.32,21,27,0.778,101,35,81,0.432,22,49,0.449,13,32,0.406,22,29,0.759,105,2015-12-14,NOP,POR
6711,11,Home,L 101-109 ,240,34,77,0.442,24,54,0.444,10,23,0.435,23,31,0.742,101,41,88,0.466,37,68,0.544,4,20,0.2,23,29,0.793,109,2015-12-18,BOS,ATL
6712,12,@,L 101-109 ,240,39,93,0.419,29,60,0.483,10,33,0.303,13,16,0.813,101,40,79,0.506,31,59,0.525,9,20,0.45,20,23,0.87,109,2015-12-19,CHA,WAS
6713,13,@,W 101-95 ,240,41,79,0.519,36,63,0.571,5,16,0.313,14,24,0.583,101,33,74,0.446,25,56,0.446,8,18,0.444,21,24,0.875,95,2015-12-20,MIL,PHO
6714,14,@,L 101-104 ,240,41,83,0.494,34,54,0.63,7,29,0.241,12,17,0.706,101,44,84,0.524,37,68,0.544,7,16,0.438,9,13,0.692,104,2015-12-23,HOU,ORL
6715,15,Home,L 101-108 ,240,43,79,0.544,34,60,0.567,9,19,0.474,6,13,0.462,101,38,77,0.494,28,57,0.491,10,20,0.5,22,23,0.957,108,2015-12-26,ORL,MIA
6716,16,Home,W 101-86 ,240,39,81,0.481,32,71,0.451,7,10,0.7,16,17,0.941,101,38,86,0.442,33,68,0.485,5,18,0.278,5,6,0.833,86,2015-12-26,SAS,DEN
6717,17,@,W 101-97 ,240,33,71,0.465,16,30,0.533,17,41,0.415,18,25,0.72,101,36,79,0.456,25,54,0.463,11,25,0.44,14,20,0.7,97,2015-12-28,CLE,PHO
6718,18,Home,W 101-95 ,240,37,72,0.514,32,55,0.582,5,17,0.294,22,28,0.786,101,39,82,0.476,36,71,0.507,3,11,0.273,14,24,0.583,95,2015-12-28,SAS,MIN
6719,19,@,L 101-111 ,240,38,86,0.442,31,65,0.477,7,21,0.333,18,19,0.947,101,45,87,0.517,30,53,0.566,15,34,0.441,6,6,1.0,111,2016-01-04,CHA,GSW
6720,20,Home,L 101-107 ,240,37,87,0.425,22,48,0.458,15,39,0.385,12,19,0.632,101,40,84,0.476,35,66,0.53,5,18,0.278,22,24,0.917,107,2016-01-05,ATL,NYK
6721,21,Home,W 101-92 ,240,39,94,0.415,30,72,0.417,9,22,0.409,14,17,0.824,101,35,98,0.357,30,73,0.411,5,25,0.2,17,22,0.773,92,2016-01-07,CHI,BOS
6722,22,Home,W 101-98 ,240,31,84,0.369,27,68,0.397,4,16,0.25,35,40,0.875,101,37,88,0.42,30,66,0.455,7,22,0.318,17,23,0.739,98,2016-01-10,MEM,BOS
6723,23,@,L 101-106 ,240,35,85,0.412,23,56,0.411,12,29,0.414,19,24,0.792,101,43,93,0.462,40,80,0.5,3,13,0.231,17,28,0.607,106,2016-01-12,CHI,MIL
6724,24,@,W 101-96 ,240,39,84,0.464,30,62,0.484,9,22,0.409,14,18,0.778,101,36,81,0.444,29,63,0.46,7,18,0.389,17,23,0.739,96,2016-01-12,OKC,MIN
6725,25,@,L 101-106 ,240,38,72,0.528,37,64,0.578,1,8,0.125,24,34,0.706,101,38,84,0.452,26,57,0.456,12,27,0.444,18,24,0.75,106,2016-01-13,MIL,WAS
6726,26,@,L 101-103 ,240,37,72,0.514,22,40,0.55,15,32,0.469,12,17,0.706,101,37,76,0.487,28,60,0.467,9,16,0.563,20,25,0.8,103,2016-01-14,DET,MEM
6727,27,Home,L 101-103 ,240,35,83,0.422,29,49,0.592,6,34,0.176,25,34,0.735,101,34,74,0.459,29,63,0.46,5,11,0.455,30,42,0.714,103,2016-01-14,UTA,SAC
6728,28,@,L 101-108 (OT),265,43,100,0.43,34,70,0.486,9,30,0.3,6,6,1.0,101,40,96,0.417,37,86,0.43,3,10,0.3,25,37,0.676,108,2016-01-15,ATL,MIL
6729,29,Home,L 101-111 ,240,42,95,0.442,37,69,0.536,5,26,0.192,12,20,0.6,101,44,84,0.524,35,63,0.556,9,21,0.429,14,20,0.7,111,2016-01-18,DET,CHI
6730,30,Home,W 101-99 ,240,35,75,0.467,27,56,0.482,8,19,0.421,23,30,0.767,101,36,74,0.486,30,55,0.545,6,19,0.316,21,23,0.913,99,2016-01-18,MEM,NOP
6731,31,Home,L 101-102 ,240,36,80,0.45,27,50,0.54,9,30,0.3,20,26,0.769,101,36,72,0.5,30,51,0.588,6,21,0.286,24,29,0.828,102,2016-01-21,DEN,MEM
6732,32,@,L 101-110 ,240,38,89,0.427,35,76,0.461,3,13,0.231,22,26,0.846,101,43,96,0.448,35,73,0.479,8,23,0.348,16,21,0.762,110,2016-01-22,CHI,BOS
6733,33,Home,W 101-81 ,240,35,75,0.467,22,50,0.44,13,25,0.52,18,21,0.857,101,33,81,0.407,29,64,0.453,4,17,0.235,11,17,0.647,81,2016-01-22,TOR,MIA
6734,34,@,L 101-104 ,240,40,84,0.476,29,55,0.527,11,29,0.379,10,19,0.526,101,36,78,0.462,28,56,0.5,8,22,0.364,24,29,0.828,104,2016-01-23,DET,DEN
6735,35,@,L 101-106 ,240,37,79,0.468,28,60,0.467,9,19,0.474,18,22,0.818,101,34,68,0.5,29,51,0.569,5,17,0.294,33,36,0.917,106,2016-01-23,MEM,MIN
6736,36,@,W 101-82 ,240,36,96,0.375,23,60,0.383,13,36,0.361,16,26,0.615,101,27,80,0.338,19,51,0.373,8,29,0.276,20,23,0.87,82,2016-01-31,CHA,LAL
6737,37,@,W 101-96 ,240,37,86,0.43,32,65,0.492,5,21,0.238,22,28,0.786,101,37,84,0.44,29,62,0.468,8,22,0.364,14,20,0.7,96,2016-02-07,DEN,NYK
6738,38,Home,L 101-119 ,240,40,70,0.571,36,58,0.621,4,12,0.333,17,24,0.708,101,47,89,0.528,41,75,0.547,6,14,0.429,19,26,0.731,119,2016-02-09,MIA,SAS
6739,39,@,W 101-98 ,240,39,88,0.443,30,66,0.455,9,22,0.409,14,22,0.636,101,42,96,0.438,37,70,0.529,5,26,0.192,9,10,0.9,98,2016-02-19,IND,OKC
6740,40,Home,L 101-121 ,240,34,73,0.466,28,52,0.538,6,21,0.286,27,34,0.794,101,47,97,0.485,37,65,0.569,10,32,0.313,17,20,0.85,121,2016-02-21,DEN,BOS
6741,41,Home,W 101-93 (OT),265,38,100,0.38,36,87,0.414,2,13,0.154,23,34,0.676,101,36,92,0.391,31,77,0.403,5,15,0.333,16,25,0.64,93,2016-02-22,MIA,IND
6742,42,@,L 101-108 ,240,28,76,0.368,16,47,0.34,12,29,0.414,33,43,0.767,101,44,86,0.512,39,70,0.557,5,16,0.313,15,25,0.6,108,2016-02-22,LAL,MIL
6743,43,Home,W 101-89 ,240,39,96,0.406,34,80,0.425,5,16,0.313,18,22,0.818,101,36,87,0.414,35,74,0.473,1,13,0.077,16,23,0.696,89,2016-02-27,BOS,MIA
6744,44,@,L 101-128 ,240,34,90,0.378,27,67,0.403,7,23,0.304,26,37,0.703,101,47,89,0.528,34,53,0.642,13,36,0.361,21,21,1.0,128,2016-02-28,MIN,DAL
6745,45,@,L 101-114 ,240,39,80,0.488,29,59,0.492,10,21,0.476,13,18,0.722,101,41,71,0.577,29,48,0.604,12,23,0.522,20,27,0.741,114,2016-02-28,TOR,DET
6746,46,@,L 101-107 ,240,39,89,0.438,34,71,0.479,5,18,0.278,18,27,0.667,101,41,83,0.494,30,57,0.526,11,26,0.423,14,21,0.667,107,2016-03-01,BRK,LAL
6747,47,Home,L 101-104 ,240,45,94,0.479,38,65,0.585,7,29,0.241,4,6,0.667,101,42,80,0.525,35,55,0.636,7,25,0.28,13,24,0.542,104,2016-03-03,DAL,SAC
6748,48,@,L 101-108 ,240,37,90,0.411,28,62,0.452,9,28,0.321,18,21,0.857,101,38,79,0.481,25,48,0.521,13,31,0.419,19,23,0.826,108,2016-03-04,IND,CHO
6749,49,@,L 101-116 ,240,42,87,0.483,35,65,0.538,7,22,0.318,10,14,0.714,101,43,83,0.518,29,59,0.492,14,24,0.583,16,20,0.8,116,2016-03-04,MIN,MIL
6750,50,@,L 101-109 ,240,39,86,0.453,28,64,0.438,11,22,0.5,12,13,0.923,101,44,93,0.473,38,76,0.5,6,17,0.353,15,19,0.789,109,2016-03-10,CHI,SAS
6751,51,Home,W 101-94 ,240,38,85,0.447,25,56,0.446,13,29,0.448,12,16,0.75,101,34,83,0.41,30,63,0.476,4,20,0.2,22,25,0.88,94,2016-03-11,LAC,NYK
6752,52,@,W 101-94 (OT),265,32,88,0.364,25,66,0.379,7,22,0.318,30,38,0.789,101,35,91,0.385,27,63,0.429,8,28,0.286,16,23,0.696,94,2016-03-17,TOR,IND
6753,53,@,W 101-93 ,240,38,87,0.437,29,69,0.42,9,18,0.5,16,23,0.696,101,35,83,0.422,26,51,0.51,9,32,0.281,14,20,0.7,93,2016-03-19,DEN,CHO
6754,54,@,L 101-122 ,240,40,76,0.526,30,52,0.577,10,24,0.417,11,13,0.846,101,46,84,0.548,35,65,0.538,11,19,0.579,19,23,0.826,122,2016-03-19,CLE,MIA
6755,55,Home,L 101-122 ,240,39,92,0.424,27,62,0.435,12,30,0.4,11,12,0.917,101,45,84,0.536,28,42,0.667,17,42,0.405,15,22,0.682,122,2016-03-23,WAS,ATL
6756,56,Home,W 101-90 ,240,41,97,0.423,36,65,0.554,5,32,0.156,14,17,0.824,101,35,84,0.417,32,71,0.451,3,13,0.231,17,26,0.654,90,2016-03-25,ATL,MIL
6757,57,@,L 101-104 ,240,38,85,0.447,31,52,0.596,7,33,0.212,18,27,0.667,101,41,87,0.471,32,61,0.525,9,26,0.346,13,20,0.65,104,2016-03-27,HOU,IND
6758,58,@,W 101-88 ,240,39,72,0.542,32,54,0.593,7,18,0.389,16,29,0.552,101,33,87,0.379,26,59,0.441,7,28,0.25,15,17,0.882,88,2016-03-27,WAS,LAL
6759,59,@,W 101-87 ,240,37,72,0.514,32,57,0.561,5,15,0.333,22,30,0.733,101,33,83,0.398,27,64,0.422,6,19,0.316,15,24,0.625,87,2016-03-28,SAS,MEM
6760,60,Home,W 101-95 ,240,40,90,0.444,27,61,0.443,13,29,0.448,8,9,0.889,101,36,83,0.434,26,56,0.464,10,27,0.37,13,17,0.765,95,2016-03-31,NOP,DEN
6761,61,@,W 101-86 ,240,39,81,0.481,29,54,0.537,10,27,0.37,13,17,0.765,101,33,78,0.423,25,51,0.49,8,27,0.296,12,19,0.632,86,2016-04-03,UTA,PHO
6762,62,@,L 101-112 ,240,39,80,0.488,32,64,0.5,7,16,0.438,16,23,0.696,101,45,83,0.542,33,58,0.569,12,25,0.48,10,11,0.909,112,2016-04-07,SAS,GSW
6763,63,Home,L 101-105 ,240,41,100,0.41,36,78,0.462,5,22,0.227,14,17,0.824,101,41,83,0.494,35,66,0.53,6,17,0.353,17,28,0.607,105,2016-04-11,PHO,SAC
6764,64,@,W 101-92 ,240,36,81,0.444,25,49,0.51,11,32,0.344,18,22,0.818,101,35,77,0.455,26,44,0.591,9,33,0.273,13,18,0.722,92,2016-04-11,DAL,UTA
6765,65,Home,W 101-96 ,240,41,85,0.482,35,60,0.583,6,25,0.24,13,15,0.867,101,39,83,0.47,30,53,0.566,9,30,0.3,9,15,0.6,96,2016-04-13,LAL,UTA
6766,66,@,L 101-118 ,240,43,88,0.489,36,70,0.514,7,18,0.389,8,9,0.889,101,45,86,0.523,36,65,0.554,9,21,0.429,19,21,0.905,118,2016-10-29,IND,CHI
6767,67,Home,L 101-103 ,240,40,81,0.494,31,61,0.508,9,20,0.45,12,16,0.75,101,42,93,0.452,36,68,0.529,6,25,0.24,13,17,0.765,103,2016-11-01,PHI,ORL
6768,68,@,L 101-109 ,240,37,88,0.42,28,63,0.444,9,25,0.36,18,21,0.857,101,41,76,0.539,28,49,0.571,13,27,0.481,14,17,0.824,109,2016-11-02,DET,BRK
6769,69,Home,L 101-102 ,240,40,87,0.46,26,49,0.531,14,38,0.368,7,12,0.583,101,37,91,0.407,23,53,0.434,14,38,0.368,14,18,0.778,102,2016-11-05,PHI,CLE
6770,70,@,W 101-99 ,240,37,78,0.474,27,48,0.563,10,30,0.333,17,22,0.773,101,33,84,0.393,26,61,0.426,7,23,0.304,26,30,0.867,99,2016-11-09,HOU,SAS
6771,71,Home,L 101-125 ,240,38,94,0.404,25,58,0.431,13,36,0.361,12,17,0.706,101,46,85,0.541,32,55,0.582,14,30,0.467,19,20,0.95,125,2016-11-10,DEN,GSW
6772,72,@,W 101-91 ,240,38,74,0.514,29,47,0.617,9,27,0.333,16,22,0.727,101,34,85,0.4,26,64,0.406,8,21,0.381,15,20,0.75,91,2016-11-10,LAL,SAC
6773,73,@,L 101-113 ,240,33,88,0.375,21,54,0.389,12,34,0.353,23,26,0.885,101,45,82,0.549,36,58,0.621,9,24,0.375,14,20,0.7,113,2016-11-18,POR,NOP
6774,74,Home,W 101-94 ,240,37,78,0.474,26,52,0.5,11,26,0.423,16,20,0.8,101,34,88,0.386,27,57,0.474,7,31,0.226,19,28,0.679,94,2016-11-21,PHI,MIA
6775,75,@,L 101-106 ,240,39,91,0.429,28,64,0.438,11,27,0.407,12,15,0.8,101,37,91,0.407,27,63,0.429,10,28,0.357,22,34,0.647,106,2016-11-21,PHO,WAS
6776,76,@,L 101-116 ,240,32,76,0.421,25,51,0.49,7,25,0.28,30,38,0.789,101,44,94,0.468,32,66,0.485,12,28,0.429,16,17,0.941,116,2016-11-23,OKC,SAC
6777,77,Home,W 101-95 (OT),265,35,85,0.412,25,60,0.417,10,25,0.4,21,26,0.808,101,38,93,0.409,35,72,0.486,3,21,0.143,16,26,0.615,95,2016-11-28,WAS,SAC
6778,78,@,L 101-118 ,240,32,75,0.427,18,36,0.5,14,39,0.359,23,31,0.742,101,46,86,0.535,39,67,0.582,7,19,0.368,19,23,0.826,118,2016-11-29,CLE,MIL
6779,79,@,L 101-120 ,240,37,91,0.407,26,61,0.426,11,30,0.367,16,22,0.727,101,41,74,0.554,26,46,0.565,15,28,0.536,23,27,0.852,120,2016-11-29,HOU,UTA
6780,80,Home,W 101-92 ,240,41,89,0.461,35,61,0.574,6,28,0.214,13,26,0.5,101,36,98,0.367,30,70,0.429,6,28,0.214,14,19,0.737,92,2016-12-04,OKC,NOP
6781,81,Home,L 101-109 ,240,37,89,0.416,24,53,0.453,13,36,0.361,14,18,0.778,101,40,79,0.506,37,61,0.607,3,18,0.167,26,28,0.929,109,2016-12-05,DAL,CHO
6782,82,Home,L 101-107 ,240,39,87,0.448,34,73,0.466,5,14,0.357,18,23,0.783,101,38,80,0.475,25,48,0.521,13,32,0.406,18,29,0.621,107,2016-12-05,LAL,UTA
6783,83,@,W 101-94 ,240,34,82,0.415,25,62,0.403,9,20,0.45,24,27,0.889,101,31,83,0.373,14,41,0.341,17,42,0.405,15,22,0.682,94,2016-12-09,TOR,BOS
6784,84,@,L 101-130 ,240,36,87,0.414,29,60,0.483,7,27,0.259,22,25,0.88,101,50,94,0.532,36,68,0.529,14,26,0.538,16,18,0.889,130,2016-12-10,BRK,SAS
6785,85,@,L 101-112 ,240,39,84,0.464,34,61,0.557,5,23,0.217,18,22,0.818,101,45,88,0.511,36,62,0.581,9,26,0.346,13,19,0.684,112,2016-12-12,WAS,MIA
6786,86,@,L 101-108 ,240,37,84,0.44,27,53,0.509,10,31,0.323,17,20,0.85,101,44,80,0.55,36,58,0.621,8,22,0.364,12,14,0.857,108,2016-12-14,BOS,SAS
6787,87,@,L 101-114 ,240,39,90,0.433,31,68,0.456,8,22,0.364,15,20,0.75,101,41,81,0.506,34,65,0.523,7,16,0.438,25,34,0.735,114,2016-12-17,PHO,OKC
6788,88,Home,L 101-117 ,240,38,86,0.442,25,51,0.49,13,35,0.371,12,16,0.75,101,47,104,0.452,35,67,0.522,12,37,0.324,11,14,0.786,117,2016-12-22,BRK,GSW
6789,89,@,L 101-106 ,240,37,92,0.402,31,73,0.425,6,19,0.316,21,25,0.84,101,39,83,0.47,28,55,0.509,11,28,0.393,17,22,0.773,106,2016-12-22,SAS,LAC
6790,90,Home,W 101-99 ,240,35,88,0.398,32,75,0.427,3,13,0.231,28,29,0.966,101,37,86,0.43,24,53,0.453,13,33,0.394,12,16,0.75,99,2016-12-28,CHI,BRK
6791,91,Home,L 101-120 ,240,42,86,0.488,33,52,0.635,9,34,0.265,8,10,0.8,101,46,84,0.548,36,60,0.6,10,24,0.417,18,19,0.947,120,2016-12-28,ORL,CHO
6792,92,@,W 101-89 ,240,38,77,0.494,24,46,0.522,14,31,0.452,11,14,0.786,101,32,68,0.471,25,49,0.51,7,19,0.368,18,25,0.72,89,2016-12-29,DAL,LAL
6793,93,@,L 101-111 ,240,35,84,0.417,29,61,0.475,6,23,0.261,25,31,0.806,101,39,81,0.481,32,62,0.516,7,19,0.368,26,30,0.867,111,2016-12-30,CHI,IND
6794,94,@,W 101-89 ,240,39,93,0.419,32,69,0.464,7,24,0.292,16,20,0.8,101,33,78,0.423,27,51,0.529,6,27,0.222,17,23,0.739,89,2017-01-02,UTA,BRK
6795,95,Home,W 101-91 ,240,37,86,0.43,25,47,0.532,12,39,0.308,15,21,0.714,101,38,87,0.437,32,61,0.525,6,26,0.231,9,12,0.75,91,2017-01-02,HOU,WAS
6796,96,Home,W 101-93 ,240,36,91,0.396,28,70,0.4,8,21,0.381,21,28,0.75,101,34,73,0.466,27,53,0.509,7,20,0.35,18,21,0.857,93,2017-01-05,TOR,UTA
6797,97,Home,L 101-107 ,240,37,80,0.463,28,57,0.491,9,23,0.391,18,20,0.9,101,41,84,0.488,31,52,0.596,10,32,0.313,15,18,0.833,107,2017-01-08,MIL,WAS
6798,98,Home,W 101-92 ,240,40,71,0.563,34,55,0.618,6,16,0.375,15,21,0.714,101,36,78,0.462,23,50,0.46,13,28,0.464,7,9,0.778,92,2017-01-09,MIN,DAL
6799,99,Home,W 101-99 ,240,42,83,0.506,31,61,0.508,11,22,0.5,6,9,0.667,101,35,88,0.398,25,61,0.41,10,27,0.37,19,21,0.905,99,2017-01-10,WAS,CHI
6800,0,Home,L 101-103 ,240,36,84,0.429,25,54,0.463,11,30,0.367,18,21,0.857,101,36,83,0.434,19,39,0.487,17,44,0.386,14,19,0.737,103,2017-01-13,ATL,BOS
6801,1,@,L 101-116 ,240,35,84,0.417,23,55,0.418,12,29,0.414,19,27,0.704,101,44,89,0.494,36,67,0.537,8,22,0.364,20,23,0.87,116,2017-01-15,NYK,TOR
6802,2,Home,L 101-106 ,240,40,81,0.494,35,59,0.593,5,22,0.227,16,17,0.941,101,41,89,0.461,33,66,0.5,8,23,0.348,16,24,0.667,106,2017-01-16,PHO,UTA
6803,3,@,L 101-120 ,240,37,88,0.42,29,62,0.468,8,26,0.308,19,25,0.76,101,42,86,0.488,29,63,0.46,13,23,0.565,23,25,0.92,120,2017-01-16,POR,WAS
6804,4,@,L 101-104 ,240,33,83,0.398,25,58,0.431,8,25,0.32,27,34,0.794,101,36,80,0.45,28,51,0.549,8,29,0.276,24,26,0.923,104,2017-01-18,MEM,WAS
6805,5,Home,L 101-104 ,240,42,87,0.483,38,65,0.585,4,22,0.182,13,24,0.542,101,40,84,0.476,35,68,0.515,5,16,0.313,19,25,0.76,104,2017-01-19,LAC,MIN
6806,6,Home,W 101-99 ,240,36,78,0.462,26,56,0.464,10,22,0.455,19,25,0.76,101,39,92,0.424,29,58,0.5,10,34,0.294,11,19,0.579,99,2017-01-25,MEM,TOR
6807,7,@,L 101-120 ,240,34,83,0.41,23,44,0.523,11,39,0.282,22,25,0.88,101,47,87,0.54,42,66,0.636,5,21,0.238,21,26,0.808,120,2017-01-29,HOU,IND
6808,8,Home,L 101-105 ,240,39,83,0.47,31,61,0.508,8,22,0.364,15,23,0.652,101,39,87,0.448,27,53,0.509,12,34,0.353,15,16,0.938,105,2017-01-29,SAS,DAL
6809,9,@,L 101-117 ,240,34,93,0.366,29,69,0.42,5,24,0.208,28,35,0.8,101,49,88,0.557,42,66,0.636,7,22,0.318,12,15,0.8,117,2017-01-31,NYK,WAS
6810,10,Home,L 101-102 ,240,38,75,0.507,30,59,0.508,8,16,0.5,17,25,0.68,101,36,84,0.429,28,53,0.528,8,31,0.258,22,29,0.759,102,2017-02-12,TOR,DET
6811,11,@,L 101-137 ,240,35,93,0.376,26,67,0.388,9,26,0.346,22,28,0.786,101,49,88,0.557,39,64,0.609,10,24,0.417,29,34,0.853,137,2017-02-15,LAL,PHO
6812,12,@,W 101-90 ,240,34,81,0.42,26,52,0.5,8,29,0.276,25,31,0.806,101,34,83,0.41,29,58,0.5,5,25,0.2,17,22,0.773,90,2017-03-01,NYK,ORL
6813,13,@,L 101-112 ,240,36,64,0.563,28,45,0.622,8,19,0.421,21,36,0.583,101,44,80,0.55,34,55,0.618,10,25,0.4,14,15,0.933,112,2017-03-03,LAC,MIL
6814,14,@,W 101-98 (OT),265,40,95,0.421,34,68,0.5,6,27,0.222,15,25,0.6,101,35,91,0.385,27,66,0.409,8,25,0.32,20,24,0.833,98,2017-03-03,SAS,NOP
6815,15,@,W 101-91 ,240,41,85,0.482,35,60,0.583,6,25,0.24,13,16,0.813,101,35,83,0.422,29,66,0.439,6,17,0.353,15,20,0.75,91,2017-03-04,LAC,CHI
6816,16,Home,W 101-94 ,240,38,87,0.437,32,60,0.533,6,27,0.222,19,23,0.826,101,35,75,0.467,28,54,0.519,7,21,0.333,17,20,0.85,94,2017-03-04,MIL,TOR
6817,17,@,L 101-108 ,240,37,80,0.463,30,59,0.508,7,21,0.333,20,21,0.952,101,37,85,0.435,20,44,0.455,17,41,0.415,17,24,0.708,108,2017-03-08,CHA,MIA
6818,18,@,L 101-106 ,240,39,84,0.464,28,45,0.622,11,39,0.282,12,19,0.632,101,41,87,0.471,32,61,0.525,9,26,0.346,15,19,0.789,106,2017-03-09,CLE,DET
6819,19,Home,L 100-104 ,240,39,87,0.448,36,65,0.554,3,22,0.136,19,26,0.731,100,35,78,0.449,30,62,0.484,5,16,0.313,29,31,0.935,104,2011-12-26,MIN,OKC
6820,20,Home,W 100-91 ,240,35,75,0.467,26,57,0.456,9,18,0.5,21,35,0.6,100,37,88,0.42,36,72,0.5,1,16,0.063,16,19,0.842,91,2011-12-26,SAC,LAL
6821,21,@,L 100-117 ,240,38,79,0.481,31,63,0.492,7,16,0.438,17,25,0.68,100,46,86,0.535,40,67,0.597,6,19,0.316,19,26,0.731,117,2011-12-28,UTA,DEN
6822,22,@,W 100-79 ,240,37,84,0.44,25,56,0.446,12,28,0.429,14,24,0.583,100,30,83,0.361,25,68,0.368,5,15,0.333,14,18,0.778,79,2011-12-30,ORL,CHA
6823,23,Home,W 100-92 ,240,38,83,0.458,28,63,0.444,10,20,0.5,14,21,0.667,100,35,83,0.422,32,72,0.444,3,11,0.273,19,23,0.826,92,2012-01-02,BOS,WAS
6824,24,Home,W 100-87 ,240,39,80,0.488,34,64,0.531,5,16,0.313,17,20,0.85,100,31,77,0.403,26,58,0.448,5,19,0.263,20,26,0.769,87,2012-01-02,DAL,OKC
6825,25,@,W 100-92 ,240,39,82,0.476,30,66,0.455,9,16,0.563,13,20,0.65,100,34,73,0.466,29,60,0.483,5,13,0.385,19,28,0.679,92,2012-01-02,ATL,MIA
6826,26,@,L 100-103 ,240,39,76,0.513,30,57,0.526,9,19,0.474,13,21,0.619,100,37,91,0.407,33,70,0.471,4,21,0.19,25,30,0.833,103,2012-01-05,MIL,SAC
6827,27,@,W 100-86 ,240,38,69,0.551,34,54,0.63,4,15,0.267,20,27,0.741,100,30,69,0.435,24,56,0.429,6,13,0.462,20,25,0.8,86,2012-01-10,DAL,DET
6828,28,@,W 100-95 ,240,34,74,0.459,28,59,0.475,6,15,0.4,26,32,0.813,100,39,85,0.459,34,73,0.466,5,12,0.417,12,20,0.6,95,2012-01-10,OKC,MEM
6829,29,Home,L 100-111 ,240,33,78,0.423,25,56,0.446,8,22,0.364,26,32,0.813,100,43,81,0.531,32,61,0.525,11,20,0.55,14,21,0.667,111,2012-01-10,MIN,CHI
6830,30,@,L 100-112 ,240,35,84,0.417,30,64,0.469,5,20,0.25,25,32,0.781,100,38,76,0.5,31,63,0.492,7,13,0.538,29,38,0.763,112,2012-01-14,GSW,CHA
6831,31,@,L 100-107 ,240,37,72,0.514,29,56,0.518,8,16,0.5,18,27,0.667,100,37,75,0.493,26,46,0.565,11,29,0.379,22,25,0.88,107,2012-01-18,GSW,NJN
6832,32,@,W 100-86 ,240,39,82,0.476,31,60,0.517,8,22,0.364,14,20,0.7,100,27,73,0.37,21,51,0.412,6,22,0.273,26,33,0.788,86,2012-01-20,MIL,NYK
6833,33,@,W 100-94 ,240,37,72,0.514,32,60,0.533,5,12,0.417,21,30,0.7,100,37,77,0.481,35,62,0.565,2,15,0.133,18,21,0.857,94,2012-01-22,BOS,WAS
6834,34,@,L 100-107 ,240,39,92,0.424,32,68,0.471,7,24,0.292,15,16,0.938,100,41,90,0.456,36,73,0.493,5,17,0.294,20,33,0.606,107,2012-01-27,MIL,CHI
6835,35,Home,W 100-89 ,240,40,80,0.5,35,61,0.574,5,19,0.263,15,16,0.938,100,36,82,0.439,30,63,0.476,6,19,0.316,11,17,0.647,89,2012-01-28,MIL,LAL
6836,36,@,L 100-101 (OT),265,39,94,0.415,27,69,0.391,12,25,0.48,10,19,0.526,100,44,100,0.44,40,80,0.5,4,20,0.2,9,12,0.75,101,2012-01-29,SAS,DAL
6837,37,@,L 100-112 ,240,38,78,0.487,29,56,0.518,9,22,0.409,15,23,0.652,100,45,80,0.563,32,55,0.582,13,25,0.52,9,15,0.6,112,2012-01-30,OKC,LAC
6838,38,Home,W 100-97 (OT),265,33,86,0.384,27,74,0.365,6,12,0.5,28,35,0.8,100,35,80,0.438,28,57,0.491,7,23,0.304,20,27,0.741,97,2012-01-31,MEM,DEN
6839,39,@,W 100-77 ,240,41,80,0.513,34,62,0.548,7,18,0.389,11,13,0.846,100,27,73,0.37,23,53,0.434,4,20,0.2,19,23,0.826,77,2012-01-31,ATL,TOR
6840,40,Home,W 100-64 ,240,39,75,0.52,27,51,0.529,12,24,0.5,10,12,0.833,100,25,73,0.342,19,59,0.322,6,14,0.429,8,18,0.444,64,2012-02-01,BOS,TOR
6841,41,Home,W 100-91 ,240,37,82,0.451,31,62,0.5,6,20,0.3,20,23,0.87,100,39,91,0.429,37,81,0.457,2,10,0.2,11,14,0.786,91,2012-02-04,MIN,HOU
6842,42,@,W 100-92 ,240,37,78,0.474,29,54,0.537,8,24,0.333,18,25,0.72,100,34,81,0.42,31,72,0.431,3,9,0.333,21,26,0.808,92,2012-02-06,SAC,NOH
6843,43,@,W 100-90 ,240,37,84,0.44,32,69,0.464,5,15,0.333,21,26,0.808,100,38,93,0.409,31,79,0.392,7,14,0.5,7,11,0.636,90,2012-02-08,SAS,PHI
6844,44,@,W 100-98 ,240,40,84,0.476,33,65,0.508,7,19,0.368,13,22,0.591,100,37,84,0.44,31,65,0.477,6,19,0.316,18,19,0.947,98,2012-02-11,NYK,MIN
6845,45,Home,L 100-105 ,240,37,72,0.514,26,45,0.578,11,27,0.407,15,15,1.0,100,41,88,0.466,35,73,0.479,6,15,0.4,17,20,0.85,105,2012-02-15,BRK,MEM
6846,46,Home,W 100-85 ,240,39,77,0.506,32,53,0.604,7,24,0.292,15,17,0.882,100,33,87,0.379,29,69,0.42,4,18,0.222,15,20,0.75,85,2012-02-15,NYK,SAC
6847,47,@,L 100-114 ,240,38,84,0.452,36,73,0.493,2,11,0.182,22,26,0.846,100,47,89,0.528,42,74,0.568,5,15,0.333,15,19,0.789,114,2012-02-17,WAS,UTA
6848,48,Home,L 100-103 (OT),265,36,89,0.404,28,63,0.444,8,26,0.308,20,23,0.87,100,40,92,0.435,28,64,0.438,12,28,0.429,11,21,0.524,103,2012-02-18,LAC,SAS
6849,49,@,W 100-92 ,240,32,82,0.39,17,51,0.333,15,31,0.484,21,29,0.724,100,34,85,0.4,29,64,0.453,5,21,0.238,19,26,0.731,92,2012-02-20,BRK,NYK
6850,50,@,L 100-101 ,240,37,95,0.389,30,78,0.385,7,17,0.412,19,24,0.792,100,34,78,0.436,25,60,0.417,9,18,0.5,24,32,0.75,101,2012-02-21,DET,CLE
6851,51,Home,W 100-98 ,240,31,77,0.403,20,55,0.364,11,22,0.5,27,38,0.711,100,39,85,0.459,38,78,0.487,1,7,0.143,19,24,0.792,98,2012-02-22,MIN,UTA
6852,52,Home,W 100-85 ,240,36,77,0.468,29,52,0.558,7,25,0.28,21,25,0.84,100,30,78,0.385,26,65,0.4,4,13,0.308,21,23,0.913,85,2012-02-23,OKC,LAL
6853,53,Home,L 100-108 ,240,37,79,0.468,28,59,0.475,9,20,0.45,17,23,0.739,100,44,92,0.478,32,69,0.464,12,23,0.522,8,8,1.0,108,2012-03-01,SAC,LAC
6854,54,Home,W 100-83 ,240,37,75,0.493,31,64,0.484,6,11,0.545,20,22,0.909,100,29,76,0.382,27,67,0.403,2,9,0.222,23,29,0.793,83,2012-03-03,MEM,DET
6855,55,Home,L 100-109 ,240,37,81,0.457,28,58,0.483,9,23,0.391,17,27,0.63,100,40,80,0.5,35,71,0.493,5,9,0.556,24,29,0.828,109,2012-03-05,CLE,UTA
6856,56,Home,L 100-120 ,240,36,85,0.424,28,63,0.444,8,22,0.364,20,36,0.556,100,45,83,0.542,30,60,0.5,15,23,0.652,15,16,0.938,120,2012-03-05,WAS,GSW
6857,57,Home,W 100-84 ,240,38,80,0.475,34,70,0.486,4,10,0.4,20,27,0.741,100,31,80,0.388,18,45,0.4,13,35,0.371,9,17,0.529,84,2012-03-06,CHA,ORL
6858,58,@,W 100-99 ,240,37,82,0.451,30,59,0.508,7,23,0.304,19,23,0.826,100,35,81,0.432,31,61,0.508,4,20,0.2,25,32,0.781,99,2012-03-07,CLE,DEN
6859,59,@,L 100-101 ,240,35,76,0.461,24,54,0.444,11,22,0.5,19,27,0.704,100,33,72,0.458,23,47,0.489,10,25,0.4,25,31,0.806,101,2012-03-07,LAC,NJN
6860,60,@,W 100-89 ,240,39,79,0.494,28,58,0.483,11,21,0.524,11,12,0.917,100,36,85,0.424,28,58,0.483,8,27,0.296,9,11,0.818,89,2012-03-16,POR,CHI
6861,61,@,L 100-115 ,240,32,81,0.395,24,62,0.387,8,19,0.421,28,34,0.824,100,41,81,0.506,30,56,0.536,11,25,0.44,22,28,0.786,115,2012-03-16,IND,NYK
6862,62,Home,L 100-105 ,240,34,81,0.42,28,58,0.483,6,23,0.261,26,31,0.839,100,41,89,0.461,36,74,0.486,5,15,0.333,18,27,0.667,105,2012-03-19,BRK,CLE
6863,63,@,L 100-116 ,240,39,88,0.443,32,66,0.485,7,22,0.318,15,20,0.75,100,45,95,0.474,38,76,0.5,7,19,0.368,19,25,0.76,116,2012-03-21,MIN,SAS
6864,64,@,W 100-91 ,240,43,89,0.483,36,72,0.5,7,17,0.412,7,10,0.7,100,36,90,0.4,33,75,0.44,3,15,0.2,16,20,0.8,91,2012-03-22,BOS,MIL
6865,65,@,L 100-117 ,240,41,81,0.506,38,66,0.576,3,15,0.2,15,22,0.682,100,45,99,0.455,33,64,0.516,12,35,0.343,15,15,1.0,117,2012-03-25,DEN,MIN
6866,66,Home,L 100-107 ,240,41,87,0.471,34,68,0.5,7,19,0.368,11,12,0.917,100,45,92,0.489,39,65,0.6,6,27,0.222,11,13,0.846,107,2012-03-27,PHO,SAS
6867,67,Home,W 100-84 ,240,40,82,0.488,33,66,0.5,7,16,0.438,13,15,0.867,100,35,77,0.455,29,57,0.509,6,20,0.3,8,13,0.615,84,2012-03-28,BRK,IND
6868,68,Home,W 100-90 ,240,37,73,0.507,33,54,0.611,4,19,0.211,22,26,0.846,100,31,70,0.443,25,53,0.472,6,17,0.353,22,33,0.667,90,2012-03-30,ATL,NYK
6869,69,Home,L 100-102 ,240,40,76,0.526,33,61,0.541,7,15,0.467,13,16,0.813,100,35,81,0.432,27,61,0.443,8,20,0.4,24,30,0.8,102,2012-03-30,GSW,NJN
6870,70,@,W 100-79 ,240,44,90,0.489,40,78,0.513,4,12,0.333,8,11,0.727,100,26,75,0.347,20,51,0.392,6,24,0.25,21,25,0.84,79,2012-03-30,BOS,MIN
6871,71,@,W 100-98 ,240,38,80,0.475,31,58,0.534,7,22,0.318,17,21,0.81,100,35,78,0.449,24,46,0.522,11,32,0.344,17,28,0.607,98,2012-03-30,DAL,ORL
6872,72,Home,L 100-109 ,240,39,85,0.459,38,75,0.507,1,10,0.1,21,32,0.656,100,40,90,0.444,35,68,0.515,5,22,0.227,24,28,0.857,109,2012-04-03,SAC,PHO
6873,73,Home,W 100-99 (OT),265,39,102,0.382,31,68,0.456,8,34,0.235,14,20,0.7,100,35,89,0.393,28,67,0.418,7,22,0.318,22,31,0.71,99,2012-04-08,NYK,CHI
6874,74,@,L 100-110 ,240,41,92,0.446,32,67,0.478,9,25,0.36,9,17,0.529,100,41,92,0.446,34,78,0.436,7,14,0.5,21,28,0.75,110,2012-04-10,SAC,DAL
6875,75,@,W 100-98 ,240,38,81,0.469,33,65,0.508,5,16,0.313,19,21,0.905,100,31,76,0.408,19,50,0.38,12,26,0.462,24,27,0.889,98,2012-04-11,LAC,OKC
6876,76,@,W 100-84 ,240,36,79,0.456,25,50,0.5,11,29,0.379,17,21,0.81,100,28,75,0.373,22,56,0.393,6,19,0.316,22,29,0.759,84,2012-04-15,ORL,CLE
6877,77,@,W 100-94 (OT),265,39,91,0.429,34,74,0.459,5,17,0.294,17,23,0.739,100,33,84,0.393,27,69,0.391,6,15,0.4,22,28,0.786,94,2012-04-15,CHI,DET
6878,78,@,L 100-113 ,240,40,80,0.5,31,62,0.5,9,18,0.5,11,15,0.733,100,48,90,0.533,37,72,0.514,11,18,0.611,6,6,1.0,113,2012-04-16,PHI,ORL
6879,79,@,W 100-68 ,240,40,83,0.482,31,64,0.484,9,19,0.474,11,19,0.579,100,25,84,0.298,24,76,0.316,1,8,0.125,17,23,0.739,68,2012-04-18,CHI,CHA
6880,80,Home,W 100-88 ,240,37,87,0.425,33,74,0.446,4,13,0.308,22,29,0.759,100,34,84,0.405,29,61,0.475,5,23,0.217,15,23,0.652,88,2012-04-24,UTA,PHO
6881,81,@,L 100-107 ,240,37,82,0.451,30,64,0.469,7,18,0.389,19,25,0.76,100,37,81,0.457,31,66,0.47,6,15,0.4,27,37,0.73,107,2012-11-03,TOR,BRK
6882,82,@,L 100-110 ,240,38,77,0.494,33,64,0.516,5,13,0.385,19,22,0.864,100,42,74,0.568,35,61,0.574,7,13,0.538,19,23,0.826,110,2012-11-03,UTA,SAS
6883,83,Home,W 100-84 ,240,39,77,0.506,28,50,0.56,11,27,0.407,11,18,0.611,100,34,79,0.43,26,62,0.419,8,17,0.471,8,10,0.8,84,2012-11-04,NYK,PHI
6884,84,Home,W 100-94 (OT),265,34,81,0.42,30,68,0.441,4,13,0.308,28,34,0.824,100,39,95,0.411,29,66,0.439,10,29,0.345,6,7,0.857,94,2012-11-07,BOS,WAS
6885,85,Home,L 100-106 ,240,37,76,0.487,33,66,0.5,4,10,0.4,22,31,0.71,100,40,82,0.488,33,69,0.478,7,13,0.538,19,23,0.826,106,2012-11-09,BOS,PHI
6886,86,@,L 100-110 ,240,41,76,0.539,34,60,0.567,7,16,0.438,11,18,0.611,100,43,94,0.457,36,82,0.439,7,12,0.583,17,21,0.81,110,2012-11-12,DEN,PHO
6887,87,Home,W 100-96 ,240,36,80,0.45,26,51,0.51,10,29,0.345,18,22,0.818,100,34,84,0.405,26,60,0.433,8,24,0.333,20,21,0.952,96,2012-11-14,HOU,NOH
6888,88,@,L 100-107 ,240,35,77,0.455,26,56,0.464,9,21,0.429,21,29,0.724,100,35,72,0.486,25,51,0.49,10,21,0.476,27,32,0.844,107,2012-11-14,MIA,LAC
6889,89,Home,L 100-104 ,240,38,87,0.437,30,58,0.517,8,29,0.276,16,21,0.762,100,39,86,0.453,28,60,0.467,11,26,0.423,15,23,0.652,104,2012-11-15,SAS,NYK
6890,90,@,L 100-126 ,240,39,78,0.5,35,67,0.522,4,11,0.364,18,26,0.692,100,47,88,0.534,31,61,0.508,16,27,0.593,16,20,0.8,126,2012-11-17,DEN,SAS
6891,91,@,L 100-101 (OT),265,38,89,0.427,31,69,0.449,7,20,0.35,17,24,0.708,100,40,92,0.435,31,67,0.463,9,25,0.36,12,21,0.571,101,2012-11-21,WAS,ATL
6892,92,Home,L 100-112 ,240,41,77,0.532,38,69,0.551,3,8,0.375,15,17,0.882,100,45,77,0.584,37,61,0.607,8,16,0.5,14,19,0.737,112,2012-11-21,BOS,SAS
6893,93,@,L 100-108 ,240,37,79,0.468,31,55,0.564,6,24,0.25,20,24,0.833,100,39,80,0.488,30,63,0.476,9,17,0.529,21,24,0.875,108,2012-11-23,OKC,BOS
6894,94,@,L 100-121 ,240,37,78,0.474,28,58,0.483,9,20,0.45,17,22,0.773,100,38,79,0.481,21,46,0.457,17,33,0.515,28,31,0.903,121,2012-11-25,DET,NYK
6895,95,Home,W 100-98 ,240,35,75,0.467,29,61,0.475,6,14,0.429,24,32,0.75,100,37,81,0.457,32,62,0.516,5,19,0.263,19,22,0.864,98,2012-11-27,PHI,DAL
6896,96,@,L 100-105 ,240,36,80,0.45,26,50,0.52,10,30,0.333,18,24,0.75,100,42,86,0.488,37,73,0.507,5,13,0.385,16,19,0.842,105,2012-11-29,SAS,MIA
6897,97,@,W 100-79 ,240,40,79,0.506,33,63,0.524,7,16,0.438,13,17,0.765,100,30,81,0.37,24,57,0.421,6,24,0.25,13,18,0.722,79,2012-12-01,OKC,NOH
6898,98,@,W 100-98 ,240,39,92,0.424,26,51,0.51,13,41,0.317,9,13,0.692,100,39,83,0.47,32,67,0.478,7,16,0.438,13,15,0.867,98,2012-12-05,NYK,CHA
6899,99,@,L 100-107 ,240,35,86,0.407,29,63,0.46,6,23,0.261,24,28,0.857,100,38,82,0.463,32,67,0.478,6,15,0.4,25,34,0.735,107,2012-12-05,TOR,SAC
6900,0,@,W 100-97 ,240,36,78,0.462,22,50,0.44,14,28,0.5,14,18,0.778,100,36,68,0.529,32,50,0.64,4,18,0.222,21,28,0.75,97,2012-12-11,NYK,BRK
6901,1,Home,W 100-94 ,240,37,84,0.44,26,57,0.456,11,27,0.407,15,26,0.577,100,31,75,0.413,24,48,0.5,7,27,0.259,25,40,0.625,94,2012-12-11,CLE,LAL
6902,2,@,W 100-94 ,240,37,85,0.435,28,62,0.452,9,23,0.391,17,25,0.68,100,35,82,0.427,30,66,0.455,5,16,0.313,19,24,0.792,94,2012-12-12,LAC,CHA
6903,3,Home,W 100-89 ,240,37,74,0.5,32,65,0.492,5,9,0.556,21,24,0.875,100,35,81,0.432,30,71,0.423,5,10,0.5,14,19,0.737,89,2012-12-18,CHI,BOS
6904,4,@,L 100-107 ,240,37,86,0.43,24,51,0.471,13,35,0.371,13,15,0.867,100,39,72,0.542,35,61,0.574,4,11,0.364,25,29,0.862,107,2012-12-18,PHI,DAL
6905,5,@,L 100-101 ,240,38,95,0.4,28,71,0.394,10,24,0.417,14,22,0.636,100,35,88,0.398,25,57,0.439,10,31,0.323,21,27,0.778,101,2012-12-18,CHA,LAL
6906,6,@,W 100-95 (OT),265,34,78,0.436,25,54,0.463,9,24,0.375,23,34,0.676,100,36,95,0.379,30,77,0.39,6,18,0.333,17,22,0.773,95,2012-12-18,ATL,WAS
6907,7,@,W 100-92 ,240,36,84,0.429,27,59,0.458,9,25,0.36,19,20,0.95,100,36,94,0.383,27,70,0.386,9,24,0.375,11,17,0.647,92,2012-12-19,OKC,ATL
6908,8,Home,W 100-86 ,240,38,83,0.458,27,54,0.5,11,29,0.379,13,17,0.765,100,35,78,0.449,25,53,0.472,10,25,0.4,6,9,0.667,86,2012-12-19,NYK,BRK
6909,9,Home,W 100-68 ,240,38,90,0.422,28,66,0.424,10,24,0.417,14,21,0.667,100,28,85,0.329,26,73,0.356,2,12,0.167,10,13,0.769,68,2012-12-21,DET,WAS
6910,10,@,L 100-115 ,240,33,90,0.367,25,69,0.362,8,21,0.381,26,35,0.743,100,44,85,0.518,30,58,0.517,14,27,0.519,13,16,0.813,115,2012-12-21,CHA,GSW
6911,11,@,L 100-112 ,240,40,80,0.5,37,67,0.552,3,13,0.231,17,24,0.708,100,45,93,0.484,34,68,0.5,11,25,0.44,11,19,0.579,112,2012-12-25,DEN,LAC
6912,12,Home,W 100-94 ,240,37,77,0.481,32,56,0.571,5,21,0.238,21,31,0.677,100,38,89,0.427,29,63,0.46,9,26,0.346,9,16,0.563,94,2012-12-25,LAL,NYK
6913,13,Home,W 100-80 ,240,34,71,0.479,26,52,0.5,8,19,0.421,24,29,0.828,100,33,78,0.423,26,60,0.433,7,18,0.389,7,12,0.583,80,2012-12-26,SAS,TOR
6914,14,@,L 100-109 ,240,38,80,0.475,33,65,0.508,5,15,0.333,19,22,0.864,100,44,80,0.55,34,60,0.567,10,20,0.5,11,14,0.786,109,2012-12-29,IND,ATL
6915,15,@,L 100-103 ,240,38,82,0.463,29,62,0.468,9,20,0.45,15,19,0.789,100,35,75,0.467,31,60,0.517,4,15,0.267,29,39,0.744,103,2012-12-29,CLE,BRK
6916,16,Home,L 100-105 ,240,36,84,0.429,26,47,0.553,10,37,0.27,18,24,0.75,100,41,81,0.506,30,48,0.625,11,33,0.333,12,18,0.667,105,2013-01-01,NYK,POR
6917,17,Home,W 100-83 ,240,39,82,0.476,27,55,0.491,12,27,0.444,10,16,0.625,100,28,77,0.364,19,43,0.442,9,34,0.265,18,21,0.857,83,2013-01-03,NYK,SAS
6918,18,Home,W 100-94 ,240,31,78,0.397,21,59,0.356,10,19,0.526,28,36,0.778,100,35,81,0.432,29,62,0.468,6,19,0.316,18,20,0.9,94,2013-01-07,UTA,DAL
6919,19,@,L 100-107 ,240,37,84,0.44,29,52,0.558,8,32,0.25,18,22,0.818,100,43,87,0.494,37,69,0.536,6,18,0.333,15,19,0.789,107,2013-01-12,HOU,PHI
6920,20,Home,W 100-87 ,240,35,81,0.432,24,51,0.471,11,30,0.367,19,25,0.76,100,33,82,0.402,29,59,0.492,4,23,0.174,17,22,0.773,87,2013-01-13,NYK,NOH
6921,21,Home,W 100-89 ,240,39,80,0.488,31,59,0.525,8,21,0.381,14,20,0.7,100,33,79,0.418,27,64,0.422,6,15,0.4,17,24,0.708,89,2013-01-14,BOS,CHA
6922,22,@,L 100-105 ,240,33,84,0.393,22,57,0.386,11,27,0.407,23,30,0.767,100,33,86,0.384,28,64,0.438,5,22,0.227,34,43,0.791,105,2013-01-16,HOU,DAL
6923,23,@,W 100-99 (OT),265,36,75,0.48,31,60,0.517,5,15,0.333,23,32,0.719,100,38,91,0.418,35,77,0.455,3,14,0.214,20,28,0.714,99,2013-01-18,CHI,BOS
6924,24,Home,L 100-106 ,240,37,79,0.468,26,48,0.542,11,31,0.355,15,21,0.714,100,37,79,0.468,33,67,0.493,4,12,0.333,28,38,0.737,106,2013-01-18,ORL,CHA
6925,25,@,W 100-94 ,240,29,74,0.392,19,45,0.422,10,29,0.345,32,41,0.78,100,34,81,0.42,28,66,0.424,6,15,0.4,20,24,0.833,94,2013-01-21,HOU,CHA
6926,26,Home,W 100-80 ,240,44,78,0.564,42,67,0.627,2,11,0.182,10,12,0.833,100,30,80,0.375,24,57,0.421,6,23,0.261,14,17,0.824,80,2013-01-23,POR,IND
6927,27,@,W 100-82 ,240,34,71,0.479,23,50,0.46,11,21,0.524,21,26,0.808,100,31,80,0.388,28,60,0.467,3,20,0.15,17,20,0.85,82,2013-01-25,HOU,NOH
6928,28,@,L 100-101 ,240,40,81,0.494,33,65,0.508,7,16,0.438,13,17,0.765,100,35,75,0.467,24,50,0.48,11,25,0.44,20,21,0.952,101,2013-01-26,LAC,POR
6929,29,Home,W 100-98 (2OT),290,36,88,0.409,31,68,0.456,5,20,0.25,23,27,0.852,100,39,96,0.406,34,73,0.466,5,23,0.217,15,20,0.75,98,2013-01-27,BOS,MIA
6930,30,Home,L 100-103 ,240,45,83,0.542,41,74,0.554,4,9,0.444,6,9,0.667,100,40,73,0.548,32,60,0.533,8,13,0.615,15,19,0.789,103,2013-01-28,PHI,MEM
6931,31,Home,W 100-97 ,240,36,84,0.429,29,64,0.453,7,20,0.35,21,25,0.84,100,36,81,0.444,28,56,0.5,8,25,0.32,17,24,0.708,97,2013-01-31,GSW,DAL
6932,32,Home,L 100-111 ,240,41,89,0.461,31,67,0.463,10,22,0.455,8,18,0.444,100,39,92,0.424,27,60,0.45,12,32,0.375,21,25,0.84,111,2013-02-01,MIN,LAL
6933,33,@,W 100-85 ,240,40,75,0.533,37,63,0.587,3,12,0.25,17,23,0.739,100,28,75,0.373,24,57,0.421,4,18,0.222,25,32,0.781,85,2013-02-03,MIA,TOR
6934,34,@,W 100-98 ,240,41,70,0.586,34,52,0.654,7,18,0.389,11,16,0.688,100,40,85,0.471,37,72,0.514,3,13,0.231,15,19,0.789,98,2013-02-04,POR,MIN
6935,35,Home,W 100-86 ,240,39,81,0.481,34,71,0.479,5,10,0.5,17,26,0.654,100,29,82,0.354,23,63,0.365,6,19,0.316,22,29,0.759,86,2013-02-06,UTA,MIL
6936,36,Home,L 100-111 ,240,35,74,0.473,22,50,0.44,13,24,0.542,17,23,0.739,100,45,86,0.523,36,70,0.514,9,16,0.563,12,18,0.667,111,2013-02-08,ATL,NOH
6937,37,@,W 100-93 ,240,36,80,0.45,28,54,0.519,8,26,0.308,20,25,0.8,100,38,89,0.427,34,75,0.453,4,14,0.286,13,19,0.684,93,2013-02-08,LAL,CHA
6938,38,@,W 100-98 (OT),265,42,96,0.438,40,87,0.46,2,9,0.222,14,19,0.737,100,35,78,0.449,26,56,0.464,9,22,0.409,19,28,0.679,98,2013-02-08,TOR,IND
6939,39,@,W 100-94 ,240,38,81,0.469,30,55,0.545,8,26,0.308,16,20,0.8,100,37,80,0.463,36,67,0.537,1,13,0.077,19,27,0.704,94,2013-02-08,NYK,MIN
6940,40,Home,L 100-105 ,240,34,86,0.395,27,69,0.391,7,17,0.412,25,28,0.893,100,41,83,0.494,33,66,0.5,8,17,0.471,15,19,0.789,105,2013-02-09,MIL,DET
6941,41,@,W 100-92 ,240,39,75,0.52,31,61,0.508,8,14,0.571,14,17,0.824,100,40,79,0.506,35,61,0.574,5,18,0.278,7,11,0.636,92,2013-02-11,MIN,CLE
6942,42,@,L 100-123 ,240,33,80,0.413,29,64,0.453,4,16,0.25,30,36,0.833,100,43,92,0.467,30,58,0.517,13,34,0.382,24,26,0.923,123,2013-02-13,SAC,DAL
6943,43,Home,L 100-110 ,240,32,73,0.438,29,60,0.483,3,13,0.231,33,34,0.971,100,41,88,0.466,30,59,0.508,11,29,0.379,17,22,0.773,110,2013-02-14,OKC,MIA
6944,44,@,L 100-105 ,240,37,76,0.487,30,61,0.492,7,15,0.467,19,22,0.864,100,38,77,0.494,33,63,0.524,5,14,0.357,24,34,0.706,105,2013-02-20,NOP,CLE
6945,45,Home,L 100-104 ,240,37,91,0.407,32,74,0.432,5,17,0.294,21,24,0.875,100,40,84,0.476,32,64,0.5,8,20,0.4,16,19,0.842,104,2013-02-22,NOP,DAL
6946,46,Home,W 100-98 ,240,35,80,0.438,28,62,0.452,7,18,0.389,23,28,0.821,100,35,75,0.467,25,47,0.532,10,28,0.357,18,23,0.783,98,2013-02-22,TOR,NYK
6947,47,@,W 100-99 ,240,37,81,0.457,30,64,0.469,7,17,0.412,19,23,0.826,100,37,85,0.435,36,74,0.486,1,11,0.091,24,31,0.774,99,2013-02-24,GSW,MIN
6948,48,Home,W 100-95 ,240,35,81,0.432,28,61,0.459,7,20,0.35,23,31,0.742,100,39,78,0.5,32,59,0.542,7,19,0.368,10,16,0.625,95,2013-03-01,NOP,DET
6949,49,@,W 100-77 ,240,42,92,0.457,34,71,0.479,8,21,0.381,8,10,0.8,100,32,88,0.364,30,70,0.429,2,18,0.111,11,14,0.786,77,2013-03-10,DAL,MIN
6950,50,Home,W 100-96 ,240,33,84,0.393,25,61,0.41,8,23,0.348,26,34,0.765,100,36,86,0.419,29,65,0.446,7,21,0.333,17,27,0.63,96,2013-03-10,TOR,CLE
6951,51,Home,W 100-74 ,240,35,77,0.455,29,60,0.483,6,17,0.353,24,30,0.8,100,27,66,0.409,23,53,0.434,4,13,0.308,16,25,0.64,74,2013-03-12,CHA,BOS
6952,52,@,L 100-108 ,240,39,81,0.481,33,57,0.579,6,24,0.25,16,20,0.8,100,36,74,0.486,25,43,0.581,11,31,0.355,25,31,0.806,108,2013-03-15,MIN,HOU
6953,53,@,L 100-101 ,240,38,90,0.422,26,62,0.419,12,28,0.429,12,14,0.857,100,43,86,0.5,38,70,0.543,5,16,0.313,10,13,0.769,101,2013-03-18,POR,PHI
6954,54,Home,W 100-93 ,240,34,76,0.447,28,53,0.528,6,23,0.261,26,32,0.813,100,36,79,0.456,31,62,0.5,5,17,0.294,16,20,0.8,93,2013-03-20,HOU,UTA
6955,55,@,L 100-101 ,240,43,78,0.551,36,60,0.6,7,18,0.389,7,11,0.636,100,37,76,0.487,30,65,0.462,7,11,0.636,20,27,0.741,101,2013-03-21,PHI,DEN
6956,56,Home,L 100-103 ,240,39,81,0.481,28,58,0.483,11,23,0.478,11,17,0.647,100,40,87,0.46,29,61,0.475,11,26,0.423,12,16,0.75,103,2013-03-22,LAL,WAS
6957,57,Home,L 100-102 ,240,41,99,0.414,35,78,0.449,6,21,0.286,12,17,0.706,100,35,76,0.461,31,62,0.5,4,14,0.286,28,31,0.903,102,2013-03-24,PHO,BRK
6958,58,Home,W 100-94 ,240,40,84,0.476,32,61,0.525,8,23,0.348,12,15,0.8,100,36,80,0.45,29,59,0.492,7,21,0.333,15,25,0.6,94,2013-03-25,IND,ATL
6959,59,@,W 100-85 ,240,39,90,0.433,31,62,0.5,8,28,0.286,14,18,0.778,100,31,69,0.449,25,49,0.51,6,20,0.3,17,22,0.773,85,2013-03-26,NYK,BOS
6960,60,@,W 100-91 ,240,35,78,0.449,29,60,0.483,6,18,0.333,24,28,0.857,100,32,83,0.386,26,62,0.419,6,21,0.286,21,26,0.808,91,2013-03-27,IND,HOU
6961,61,Home,W 100-92 ,240,42,89,0.472,34,73,0.466,8,16,0.5,8,9,0.889,100,37,89,0.416,31,65,0.477,6,24,0.25,12,13,0.923,92,2013-03-27,PHI,MIL
6962,62,Home,W 100-99 ,240,35,76,0.461,25,61,0.41,10,15,0.667,20,27,0.741,100,42,88,0.477,42,78,0.538,0,10,0.0,15,17,0.882,99,2013-03-27,SAS,DEN
6963,63,Home,W 100-98 ,240,40,79,0.506,34,61,0.557,6,18,0.333,14,18,0.778,100,38,80,0.475,26,59,0.441,12,21,0.571,10,18,0.556,98,2013-03-30,DAL,CHI
6964,64,Home,W 100-92 ,240,38,73,0.521,33,57,0.579,5,16,0.313,19,27,0.704,100,38,76,0.5,36,68,0.529,2,8,0.25,14,23,0.609,92,2013-03-30,PHI,CHA
6965,65,@,L 100-110 ,240,42,81,0.519,35,65,0.538,7,16,0.438,9,14,0.643,100,40,83,0.482,35,65,0.538,5,18,0.278,25,27,0.926,110,2013-04-01,BOS,MIN
6966,66,Home,W 100-88 ,240,38,82,0.463,26,58,0.448,12,24,0.5,12,13,0.923,100,33,83,0.398,25,62,0.403,8,21,0.381,14,17,0.824,88,2013-04-04,OKC,SAS
6967,67,Home,W 100-83 ,240,36,76,0.474,30,57,0.526,6,19,0.316,22,29,0.759,100,30,83,0.361,27,73,0.37,3,10,0.3,20,23,0.87,83,2013-04-06,MIL,TOR
6968,68,@,L 100-107 ,240,36,78,0.462,28,56,0.5,8,22,0.364,20,21,0.952,100,42,72,0.583,34,59,0.576,8,13,0.615,15,17,0.882,107,2013-04-12,MIN,UTA
6969,69,@,L 100-121 ,240,39,100,0.39,31,75,0.413,8,25,0.32,14,17,0.824,100,45,83,0.542,32,56,0.571,13,27,0.481,18,24,0.75,121,2013-04-14,SAC,HOU
6970,70,@,L 100-101 ,240,32,67,0.478,25,53,0.472,7,14,0.5,29,36,0.806,100,33,68,0.485,25,52,0.481,8,16,0.5,27,39,0.692,101,2013-11-01,MIA,BRK
6971,71,Home,W 100-81 ,240,33,77,0.429,25,57,0.439,8,20,0.4,26,33,0.788,100,29,83,0.349,22,52,0.423,7,31,0.226,16,19,0.842,81,2013-11-01,MIN,OKC
6972,72,Home,L 100-109 ,240,40,89,0.449,31,57,0.544,9,32,0.281,11,13,0.846,100,35,79,0.443,25,52,0.481,10,27,0.37,29,38,0.763,109,2013-11-03,NYK,MIN
6973,73,Home,L 100-105 ,240,35,80,0.438,25,49,0.51,10,31,0.323,20,21,0.952,100,39,81,0.481,31,59,0.525,8,22,0.364,19,26,0.731,105,2013-11-05,SAC,ATL
6974,74,@,W 100-81 ,240,36,80,0.45,31,63,0.492,5,17,0.294,23,27,0.852,100,31,77,0.403,28,60,0.467,3,17,0.176,16,23,0.696,81,2013-11-11,DEN,UTA
6975,75,@,W 100-98 (OT),265,38,87,0.437,36,75,0.48,2,12,0.167,22,29,0.759,100,34,79,0.43,24,51,0.471,10,28,0.357,20,25,0.8,98,2013-11-15,BRK,PHO
6976,76,Home,L 100-108 ,240,37,70,0.529,33,55,0.6,4,15,0.267,22,28,0.786,100,43,84,0.512,33,57,0.579,10,27,0.37,12,18,0.667,108,2013-11-16,ORL,DAL
6977,77,@,L 100-104 ,240,37,85,0.435,27,57,0.474,10,28,0.357,16,24,0.667,100,41,85,0.482,34,70,0.486,7,15,0.467,15,15,1.0,104,2013-11-19,MIN,WAS
6978,78,@,L 100-104 ,240,41,77,0.532,33,54,0.611,8,23,0.348,10,16,0.625,100,36,88,0.409,30,71,0.423,6,17,0.353,26,33,0.788,104,2013-11-22,CLE,NOP
6979,79,@,L 100-102 ,240,35,87,0.402,28,66,0.424,7,21,0.333,23,25,0.92,100,35,79,0.443,24,47,0.511,11,32,0.344,21,30,0.7,102,2013-11-23,DAL,DEN
6980,80,Home,W 100-86 ,240,40,87,0.46,32,61,0.525,8,26,0.308,12,15,0.8,100,35,84,0.417,27,60,0.45,8,24,0.333,8,15,0.533,86,2013-11-24,LAL,SAC
6981,81,Home,L 100-102 ,240,34,78,0.436,23,52,0.442,11,26,0.423,21,22,0.955,100,39,77,0.506,35,63,0.556,4,14,0.286,20,22,0.909,102,2013-11-26,TOR,BRK
6982,82,@,W 100-93 ,240,36,80,0.45,33,71,0.465,3,9,0.333,25,31,0.806,100,38,89,0.427,31,69,0.449,7,20,0.35,10,13,0.769,93,2013-11-27,MEM,BOS
6983,83,@,W 100-92 (OT),265,37,74,0.5,27,48,0.563,10,26,0.385,16,22,0.727,100,37,85,0.435,27,60,0.45,10,25,0.4,8,10,0.8,92,2013-11-27,WAS,MIL
6984,84,@,L 100-115 ,240,38,88,0.432,31,65,0.477,7,23,0.304,17,19,0.895,100,41,89,0.461,31,61,0.508,10,28,0.357,23,39,0.59,115,2013-12-01,PHI,DET
6985,85,Home,L 100-105 ,240,36,82,0.439,32,67,0.478,4,15,0.267,24,31,0.774,100,39,89,0.438,31,63,0.492,8,26,0.308,19,26,0.731,105,2013-12-01,LAC,IND
6986,86,@,L 100-102 ,240,42,96,0.438,31,65,0.477,11,31,0.355,5,5,1.0,100,42,78,0.538,36,60,0.6,6,18,0.333,12,17,0.706,102,2013-12-02,ATL,SAS
6987,87,@,L 100-108 ,240,37,78,0.474,29,60,0.483,8,18,0.444,18,21,0.857,100,38,77,0.494,27,53,0.509,11,24,0.458,21,27,0.778,108,2013-12-03,MIL,BOS
6988,88,@,W 100-97 ,240,37,86,0.43,26,62,0.419,11,24,0.458,15,22,0.682,100,38,94,0.404,31,72,0.431,7,22,0.318,14,15,0.933,97,2013-12-04,DAL,NOP
6989,89,Home,L 100-106 ,240,37,86,0.43,27,64,0.422,10,22,0.455,16,22,0.727,100,41,86,0.477,29,54,0.537,12,32,0.375,12,18,0.667,106,2013-12-06,SAC,LAL
6990,90,Home,L 100-111 ,240,41,91,0.451,28,65,0.431,13,26,0.5,5,6,0.833,100,38,71,0.535,29,52,0.558,9,19,0.474,26,28,0.929,111,2013-12-07,SAS,IND
6991,91,Home,L 100-116 ,240,34,81,0.42,28,66,0.424,6,15,0.4,26,34,0.765,100,40,71,0.563,31,53,0.585,9,18,0.5,27,33,0.818,116,2013-12-11,MEM,OKC
6992,92,Home,L 100-109 ,240,37,85,0.435,26,55,0.473,11,30,0.367,15,16,0.938,100,42,87,0.483,34,66,0.515,8,21,0.381,17,20,0.85,109,2013-12-13,ORL,CLE
6993,93,@,L 100-108 ,240,37,84,0.44,28,61,0.459,9,23,0.391,17,21,0.81,100,39,82,0.476,29,57,0.509,10,25,0.4,20,24,0.833,108,2013-12-13,PHI,TOR
6994,94,@,W 100-84 ,240,41,88,0.466,33,68,0.485,8,20,0.4,10,12,0.833,100,35,89,0.393,29,69,0.42,6,20,0.3,8,11,0.727,84,2013-12-14,SAS,UTA
6995,95,@,L 100-114 ,240,39,82,0.476,34,61,0.557,5,21,0.238,17,21,0.81,100,45,92,0.489,34,65,0.523,11,27,0.407,13,15,0.867,114,2013-12-16,LAL,ATL
6996,96,Home,W 100-84 ,240,37,69,0.536,27,54,0.5,10,15,0.667,16,24,0.667,100,36,90,0.4,32,72,0.444,4,18,0.222,8,9,0.889,84,2013-12-21,CHI,CLE
6997,97,Home,L 100-105 ,240,39,82,0.476,31,62,0.5,8,20,0.4,14,23,0.609,100,39,79,0.494,27,56,0.482,12,23,0.522,15,23,0.652,105,2013-12-21,ORL,SAC
6998,98,Home,L 100-113 ,240,35,82,0.427,26,63,0.413,9,19,0.474,21,26,0.808,100,43,88,0.489,31,61,0.508,12,27,0.444,15,18,0.833,113,2013-12-21,SAS,OKC
6999,99,Home,L 100-113 ,240,31,74,0.419,24,57,0.421,7,17,0.412,31,42,0.738,100,41,83,0.494,33,66,0.5,8,17,0.471,23,27,0.852,113,2013-12-23,SAC,NOP
7000,0,Home,W 100-92 ,240,31,71,0.437,26,47,0.553,5,24,0.208,33,40,0.825,100,38,93,0.409,33,75,0.44,5,18,0.278,11,20,0.55,92,2013-12-26,HOU,MEM
7001,1,@,L 100-103 ,240,37,79,0.468,28,61,0.459,9,18,0.5,17,24,0.708,100,38,83,0.458,29,58,0.5,9,25,0.36,18,25,0.72,103,2013-12-28,CLE,BOS
7002,2,@,L 100-115 ,240,39,80,0.488,32,59,0.542,7,21,0.333,15,20,0.75,100,36,80,0.45,21,48,0.438,15,32,0.469,28,34,0.824,115,2013-12-28,NYK,TOR
7003,3,@,W 100-98 ,240,41,86,0.477,35,62,0.565,6,24,0.25,12,14,0.857,100,36,79,0.456,30,56,0.536,6,23,0.261,20,23,0.87,98,2013-12-30,DAL,MIN
7004,4,Home,L 100-101 ,240,37,80,0.463,27,49,0.551,10,31,0.323,16,19,0.842,100,39,87,0.448,33,60,0.55,6,27,0.222,17,25,0.68,101,2014-01-03,ATL,GSW
7005,5,@,L 100-102 ,240,37,89,0.416,28,65,0.431,9,24,0.375,17,24,0.708,100,34,74,0.459,24,48,0.5,10,26,0.385,24,28,0.857,102,2014-01-03,NYK,HOU
7006,6,@,L 100-116 ,240,37,68,0.544,27,47,0.574,10,21,0.476,16,20,0.8,100,41,85,0.482,29,58,0.5,12,27,0.444,22,25,0.88,116,2014-01-04,MIL,PHO
7007,7,Home,L 100-103 ,240,35,77,0.455,27,57,0.474,8,20,0.4,22,29,0.759,100,37,72,0.514,33,59,0.559,4,13,0.308,25,41,0.61,103,2014-01-15,NOP,HOU
7008,8,Home,L 100-109 ,240,38,84,0.452,30,64,0.469,8,20,0.4,16,20,0.8,100,41,86,0.477,33,70,0.471,8,16,0.5,19,20,0.95,109,2014-01-17,SAS,POR
7009,9,Home,W 100-95 ,240,32,65,0.492,23,49,0.469,9,16,0.563,27,33,0.818,100,39,95,0.411,29,66,0.439,10,29,0.345,7,10,0.7,95,2014-01-20,CHA,TOR
7010,10,@,L 100-102 (OT),265,35,83,0.422,27,58,0.466,8,25,0.32,22,26,0.846,100,39,102,0.382,32,81,0.395,7,21,0.333,17,24,0.708,102,2014-01-20,LAL,CHI
7011,11,@,L 100-124 ,240,38,75,0.507,33,60,0.55,5,15,0.333,19,28,0.679,100,45,83,0.542,34,67,0.507,11,16,0.688,23,32,0.719,124,2014-01-22,IND,PHO
7012,12,Home,W 100-92 ,240,37,81,0.457,32,69,0.464,5,12,0.417,21,27,0.778,100,36,77,0.468,33,62,0.532,3,15,0.2,17,19,0.895,92,2014-01-26,NOP,ORL
7013,13,@,W 100-89 ,240,39,74,0.527,35,61,0.574,4,13,0.308,18,23,0.783,100,33,80,0.413,27,65,0.415,6,15,0.4,17,27,0.63,89,2014-01-28,NOP,CLE
7014,14,@,W 100-90 ,240,37,85,0.435,29,64,0.453,8,21,0.381,18,20,0.9,100,36,80,0.45,28,59,0.475,8,21,0.381,10,14,0.714,90,2014-01-31,TOR,DEN
7015,15,Home,L 100-110 ,240,36,93,0.387,30,67,0.448,6,26,0.231,22,27,0.815,100,46,88,0.523,44,77,0.571,2,11,0.182,16,22,0.727,110,2014-01-31,LAL,CHA
7016,16,Home,W 100-90 ,240,37,84,0.44,30,67,0.448,7,17,0.412,19,22,0.864,100,37,81,0.457,32,62,0.516,5,19,0.263,11,12,0.917,90,2014-02-03,WAS,POR
7017,17,@,L 100-110 ,240,36,95,0.379,29,79,0.367,7,16,0.438,21,31,0.677,100,39,84,0.464,29,61,0.475,10,23,0.435,22,26,0.846,110,2014-02-05,MIL,DEN
7018,18,@,L 100-105 ,240,38,84,0.452,24,54,0.444,14,30,0.467,10,14,0.714,100,40,86,0.465,35,72,0.486,5,14,0.357,20,22,0.909,105,2014-02-05,ATL,NOP
7019,19,Home,L 100-104 ,240,39,89,0.438,33,73,0.452,6,16,0.375,16,22,0.727,100,36,77,0.468,28,56,0.5,8,21,0.381,24,28,0.857,104,2014-02-08,CHA,SAS
7020,20,@,L 100-112 ,240,38,86,0.442,29,62,0.468,9,24,0.375,15,20,0.75,100,40,73,0.548,28,46,0.609,12,27,0.444,20,27,0.741,112,2014-02-09,NYK,OKC
7021,21,@,L 100-109 ,240,43,82,0.524,38,65,0.585,5,17,0.294,9,11,0.818,100,43,90,0.478,38,74,0.514,5,16,0.313,18,26,0.692,109,2014-02-10,SAS,DET
7022,22,Home,W 100-85 ,240,43,85,0.506,35,65,0.538,8,20,0.4,6,13,0.462,100,35,80,0.438,25,57,0.439,10,23,0.435,5,9,0.556,85,2014-02-11,CHI,ATL
7023,23,@,L 100-105 ,240,37,80,0.463,29,61,0.475,8,19,0.421,18,23,0.783,100,37,87,0.425,34,71,0.479,3,16,0.188,28,32,0.875,105,2014-02-12,PHI,UTA
7024,24,@,L 100-104 ,240,40,80,0.5,29,55,0.527,11,25,0.44,9,16,0.563,100,35,82,0.427,23,56,0.411,12,26,0.462,22,30,0.733,104,2014-02-18,ORL,MIL
7025,25,Home,W 100-94 ,240,36,82,0.439,25,54,0.463,11,28,0.393,17,26,0.654,100,34,87,0.391,29,70,0.414,5,17,0.294,21,28,0.75,94,2014-02-19,PHO,BOS
7026,26,Home,L 100-110 ,240,35,83,0.422,26,56,0.464,9,27,0.333,21,32,0.656,100,36,80,0.45,27,62,0.435,9,18,0.5,29,40,0.725,110,2014-02-22,MIL,IND
7027,27,@,W 100-95 ,240,28,76,0.368,16,45,0.356,12,31,0.387,32,38,0.842,100,37,103,0.359,33,83,0.398,4,20,0.2,17,26,0.654,95,2014-02-25,POR,DEN
7028,28,@,W 100-91 ,240,36,71,0.507,27,52,0.519,9,19,0.474,19,28,0.679,100,34,85,0.4,23,54,0.426,11,31,0.355,12,17,0.706,91,2014-02-28,CHI,DAL
7029,29,@,L 100-110 ,240,36,92,0.391,31,71,0.437,5,21,0.238,23,25,0.92,100,38,93,0.409,32,68,0.471,6,25,0.24,28,33,0.848,110,2014-03-17,LAC,DEN
7030,30,@,W 100-96 ,240,34,75,0.453,22,45,0.489,12,30,0.4,20,31,0.645,100,37,72,0.514,30,50,0.6,7,22,0.318,15,22,0.682,96,2014-03-18,MIA,CLE
7031,31,Home,L 100-107 ,240,36,67,0.537,32,54,0.593,4,13,0.308,24,32,0.75,100,36,86,0.419,27,64,0.422,9,22,0.409,26,32,0.813,107,2014-03-19,NOP,TOR
7032,32,Home,L 100-106 ,240,35,77,0.455,23,50,0.46,12,27,0.444,18,19,0.947,100,42,69,0.609,33,51,0.647,9,18,0.5,13,17,0.765,106,2014-03-23,NYK,CLE
7033,33,@,W 100-89 ,240,39,82,0.476,27,55,0.491,12,27,0.444,10,18,0.556,100,32,86,0.372,28,65,0.431,4,21,0.19,21,25,0.84,89,2014-03-24,HOU,CHA
7034,34,@,L 100-102 ,240,35,88,0.398,21,56,0.375,14,32,0.438,16,26,0.615,100,36,70,0.514,32,57,0.561,4,13,0.308,26,33,0.788,102,2014-03-25,TOR,CLE
7035,35,@,W 100-85 ,240,37,80,0.463,27,54,0.5,10,26,0.385,16,21,0.762,100,34,84,0.405,30,62,0.484,4,22,0.182,13,17,0.765,85,2014-03-27,POR,ATL
7036,36,Home,W 100-93 ,240,40,81,0.494,31,61,0.508,9,20,0.45,11,14,0.786,100,41,81,0.506,39,69,0.565,2,12,0.167,9,16,0.563,93,2014-03-28,GSW,MEM
7037,37,@,L 100-103 ,240,42,81,0.519,39,71,0.549,3,10,0.3,13,19,0.684,100,34,70,0.486,27,47,0.574,7,23,0.304,28,35,0.8,103,2014-03-29,SAC,DAL
7038,38,Home,W 100-94 ,240,34,78,0.436,31,57,0.544,3,21,0.143,29,34,0.853,100,38,79,0.481,29,62,0.468,9,17,0.529,9,13,0.692,94,2014-03-31,CHA,WAS
7039,39,Home,W 100-92 ,240,32,83,0.386,30,72,0.417,2,11,0.182,34,38,0.895,100,29,80,0.363,22,57,0.386,7,23,0.304,27,32,0.844,92,2014-04-04,MEM,DEN
7040,40,Home,W 100-96 ,240,33,64,0.516,29,53,0.547,4,11,0.364,30,35,0.857,100,34,73,0.466,26,54,0.481,8,19,0.421,20,29,0.69,96,2014-04-04,UTA,NOP
7041,41,Home,W 100-92 ,240,43,79,0.544,34,62,0.548,9,17,0.529,5,9,0.556,100,36,77,0.468,35,63,0.556,1,14,0.071,19,28,0.679,92,2014-04-05,ORL,MIN
7042,42,Home,W 100-94 ,240,41,87,0.471,36,65,0.554,5,22,0.227,13,15,0.867,100,38,90,0.422,34,78,0.436,4,12,0.333,14,18,0.778,94,2014-04-06,POR,NOP
7043,43,@,L 100-122 ,240,34,96,0.354,25,68,0.368,9,28,0.321,23,32,0.719,100,53,93,0.57,42,67,0.627,11,26,0.423,5,9,0.556,122,2014-04-09,DET,CLE
7044,44,Home,W 100-99 ,240,38,75,0.507,31,52,0.596,7,23,0.304,17,22,0.773,100,39,91,0.429,34,80,0.425,5,11,0.455,16,22,0.727,99,2014-04-09,POR,SAC
7045,45,Home,L 100-109 ,240,39,83,0.47,34,71,0.479,5,12,0.417,17,21,0.81,100,38,88,0.432,22,54,0.407,16,34,0.471,17,22,0.773,109,2014-04-10,DAL,SAS
7046,46,@,W 100-99 ,240,39,104,0.375,29,70,0.414,10,34,0.294,12,19,0.632,100,40,88,0.455,34,65,0.523,6,23,0.261,13,15,0.867,99,2014-04-10,DEN,GSW
7047,47,Home,L 100-108 ,240,30,76,0.395,15,43,0.349,15,33,0.455,25,31,0.806,100,35,73,0.479,29,49,0.592,6,24,0.25,32,36,0.889,108,2014-04-11,TOR,NYK
7048,48,Home,W 100-89 ,240,37,81,0.457,28,56,0.5,9,25,0.36,17,21,0.81,100,29,74,0.392,23,52,0.442,6,22,0.273,25,32,0.781,89,2014-04-13,NYK,CHI
7049,49,@,L 100-110 ,240,38,73,0.521,32,63,0.508,6,10,0.6,18,26,0.692,100,38,81,0.469,24,49,0.49,14,32,0.438,20,26,0.769,110,2014-04-14,MIL,TOR
7050,50,@,W 100-87 ,240,38,74,0.514,28,51,0.549,10,23,0.435,14,16,0.875,100,30,73,0.411,20,43,0.465,10,30,0.333,17,22,0.773,87,2014-04-16,PHI,MIA
7051,51,@,L 100-105 ,240,35,81,0.432,21,51,0.412,14,30,0.467,16,24,0.667,100,43,82,0.524,37,70,0.529,6,12,0.5,13,20,0.65,105,2014-04-16,HOU,NOP
7052,52,Home,L 100-113 ,240,41,99,0.414,31,69,0.449,10,30,0.333,8,10,0.8,100,45,91,0.495,34,64,0.531,11,27,0.407,12,17,0.706,113,2014-04-16,SAS,LAL
7053,53,@,L 100-101 ,240,38,78,0.487,30,57,0.526,8,21,0.381,16,19,0.842,100,37,70,0.529,23,42,0.548,14,28,0.5,13,16,0.813,101,2014-10-28,DAL,SAS
7054,54,Home,W 100-91 ,240,38,81,0.469,33,63,0.524,5,18,0.278,19,19,1.0,100,37,80,0.463,31,59,0.525,6,21,0.286,11,13,0.846,91,2014-11-04,NOP,CHO
7055,55,Home,W 100-88 ,240,32,81,0.395,24,50,0.48,8,31,0.258,28,33,0.848,100,34,65,0.523,28,44,0.636,6,21,0.286,14,25,0.56,88,2014-11-04,TOR,OKC
7056,56,@,L 100-102 ,240,30,72,0.417,24,56,0.429,6,16,0.375,34,40,0.85,100,39,77,0.506,32,56,0.571,7,21,0.333,17,22,0.773,102,2014-11-05,CLE,UTA
7057,57,@,W 100-99 ,240,40,85,0.471,32,64,0.5,8,21,0.381,12,14,0.857,100,36,80,0.45,31,62,0.5,5,18,0.278,22,29,0.759,99,2014-11-08,NOP,SAS
7058,58,@,L 100-116 ,240,36,91,0.396,31,78,0.397,5,13,0.385,23,30,0.767,100,45,100,0.45,29,69,0.42,16,31,0.516,10,14,0.714,116,2014-11-09,DEN,POR
7059,59,Home,L 100-113 ,240,38,70,0.543,31,50,0.62,7,20,0.35,17,20,0.85,100,46,93,0.495,36,68,0.529,10,25,0.4,11,15,0.733,113,2014-11-11,GSW,SAS
7060,60,@,L 100-102 ,240,35,75,0.467,28,59,0.475,7,16,0.438,23,27,0.852,100,40,93,0.43,32,68,0.471,8,25,0.32,14,16,0.875,102,2014-11-11,CHA,POR
7061,61,@,L 100-104 ,240,39,81,0.481,27,56,0.482,12,25,0.48,10,16,0.625,100,35,77,0.455,26,56,0.464,9,21,0.429,25,30,0.833,104,2014-11-11,ORL,TOR
7062,62,Home,W 100-97 ,240,39,76,0.513,30,56,0.536,9,20,0.45,13,18,0.722,100,43,86,0.5,38,63,0.603,5,23,0.217,6,12,0.5,97,2014-11-12,ATL,UTA
7063,63,@,W 100-93 ,240,37,77,0.481,33,62,0.532,4,15,0.267,22,32,0.688,100,35,89,0.393,27,64,0.422,8,25,0.32,15,21,0.714,93,2014-11-13,CHI,TOR
7064,64,Home,L 100-102 ,240,39,82,0.476,34,74,0.459,5,8,0.625,17,20,0.85,100,36,70,0.514,26,48,0.542,10,22,0.455,20,25,0.8,102,2014-11-14,NYK,UTA
7065,65,Home,W 100-75 ,240,36,81,0.444,26,55,0.473,10,26,0.385,18,21,0.857,100,27,83,0.325,23,57,0.404,4,26,0.154,17,24,0.708,75,2014-11-17,SAS,PHI
7066,66,Home,L 100-106 ,240,38,86,0.442,34,75,0.453,4,11,0.364,20,29,0.69,100,39,79,0.494,30,55,0.545,9,24,0.375,19,24,0.792,106,2014-11-18,SAC,NOP
7067,67,@,L 100-107 ,240,36,79,0.456,26,56,0.464,10,23,0.435,18,25,0.72,100,40,82,0.488,30,53,0.566,10,29,0.345,17,22,0.773,107,2014-11-19,OKC,DEN
7068,68,Home,L 100-105 ,240,42,91,0.462,35,71,0.493,7,20,0.35,9,15,0.6,100,39,82,0.476,35,66,0.53,4,16,0.25,23,32,0.719,105,2014-11-21,CHA,ORL
7069,69,@,L 100-117 ,240,38,88,0.432,29,61,0.475,9,27,0.333,15,21,0.714,100,48,91,0.527,40,75,0.533,8,16,0.5,13,14,0.929,117,2014-11-21,BOS,MEM
7070,70,Home,L 100-111 ,240,36,84,0.429,31,69,0.449,5,15,0.333,23,26,0.885,100,43,93,0.462,35,75,0.467,8,18,0.444,17,22,0.773,111,2014-11-22,MIL,WAS
7071,71,Home,L 100-111 ,240,40,80,0.5,32,56,0.571,8,24,0.333,12,21,0.571,100,37,77,0.481,24,51,0.471,13,26,0.5,24,36,0.667,111,2014-11-24,DAL,IND
7072,72,@,L 100-104 ,240,39,84,0.464,25,51,0.49,14,33,0.424,8,11,0.727,100,37,82,0.451,33,65,0.508,4,17,0.235,26,32,0.813,104,2014-11-24,PHO,TOR
7073,73,@,L 100-106 ,240,40,87,0.46,30,66,0.455,10,21,0.476,10,18,0.556,100,41,74,0.554,36,59,0.61,5,15,0.333,19,29,0.655,106,2014-11-26,IND,SAS
7074,74,Home,W 100-91 ,240,38,76,0.5,33,59,0.559,5,17,0.294,19,22,0.864,100,36,89,0.404,29,65,0.446,7,24,0.292,12,16,0.75,91,2014-11-28,ATL,NOP
7075,75,Home,W 100-95 ,240,33,81,0.407,22,54,0.407,11,27,0.407,23,31,0.742,100,34,93,0.366,27,65,0.415,7,28,0.25,20,26,0.769,95,2014-12-06,HOU,PHO
7076,76,@,L 100-120 ,240,38,80,0.475,30,57,0.526,8,23,0.348,16,25,0.64,100,43,78,0.551,26,46,0.565,17,32,0.531,17,24,0.708,120,2014-12-06,NOP,LAC
7077,77,Home,W 100-96 ,240,40,80,0.5,36,66,0.545,4,14,0.286,16,22,0.727,100,39,84,0.464,35,64,0.547,4,20,0.2,14,23,0.609,96,2014-12-09,UTA,SAS
7078,78,@,W 100-95 ,240,36,72,0.5,29,52,0.558,7,20,0.35,21,31,0.677,100,34,77,0.442,26,49,0.531,8,28,0.286,19,22,0.864,95,2014-12-12,MIA,UTA
7079,79,Home,W 100-99 ,240,37,74,0.5,27,53,0.509,10,21,0.476,16,21,0.762,100,35,84,0.417,27,57,0.474,8,27,0.296,21,24,0.875,99,2014-12-13,ORL,ATL
7080,80,@,W 100-94 ,240,34,81,0.42,29,64,0.453,5,17,0.294,27,34,0.794,100,38,90,0.422,35,80,0.438,3,10,0.3,15,20,0.75,94,2014-12-14,LAL,MIN
7081,81,@,L 100-102 ,240,40,90,0.444,36,71,0.507,4,19,0.211,16,23,0.696,100,34,78,0.436,28,60,0.467,6,18,0.333,28,45,0.622,102,2014-12-17,IND,LAC
7082,82,Home,L 100-110 ,240,41,94,0.436,33,69,0.478,8,25,0.32,10,15,0.667,100,42,88,0.477,34,61,0.557,8,27,0.296,18,24,0.75,110,2014-12-19,DET,TOR
7083,83,Home,W 100-84 ,240,37,78,0.474,31,57,0.544,6,21,0.286,20,26,0.769,100,33,83,0.398,27,60,0.45,6,23,0.261,12,15,0.8,84,2014-12-21,MIA,BOS
7084,84,@,W 100-96 ,240,42,84,0.5,36,65,0.554,6,19,0.316,10,14,0.714,100,36,77,0.468,31,66,0.47,5,11,0.455,19,24,0.792,96,2014-12-21,IND,MIN
7085,85,Home,W 100-95 ,240,39,83,0.47,32,65,0.492,7,18,0.389,15,23,0.652,100,33,85,0.388,26,62,0.419,7,23,0.304,22,29,0.759,95,2014-12-23,ORL,BOS
7086,86,Home,W 100-86 ,240,34,87,0.391,25,55,0.455,9,32,0.281,23,31,0.742,100,34,80,0.425,28,52,0.538,6,28,0.214,12,22,0.545,86,2014-12-25,LAC,GSW
7087,87,@,L 100-107 ,240,41,88,0.466,37,74,0.5,4,14,0.286,14,16,0.875,100,41,89,0.461,35,69,0.507,6,20,0.3,19,22,0.864,107,2014-12-27,NOP,CHI
7088,88,Home,W 100-94 ,240,38,79,0.481,31,60,0.517,7,19,0.368,17,22,0.773,100,38,82,0.463,30,65,0.462,8,17,0.471,10,14,0.714,94,2014-12-30,UTA,MIN
7089,89,@,W 100-98 ,240,41,72,0.569,34,52,0.654,7,20,0.35,11,18,0.611,100,37,88,0.42,26,66,0.394,11,22,0.5,13,20,0.65,98,2015-01-02,BRK,ORL
7090,90,Home,W 100-95 ,240,38,89,0.427,27,66,0.409,11,23,0.478,13,18,0.722,100,37,83,0.446,30,57,0.526,7,26,0.269,14,21,0.667,95,2015-01-09,SAS,PHO
7091,91,@,L 100-120 ,240,38,86,0.442,26,56,0.464,12,30,0.4,12,17,0.706,100,46,88,0.523,33,57,0.579,13,31,0.419,15,21,0.714,120,2015-01-10,DAL,LAC
7092,92,@,L 100-108 ,240,31,75,0.413,25,60,0.417,6,15,0.4,32,37,0.865,100,37,88,0.42,29,64,0.453,8,24,0.333,26,31,0.839,108,2015-01-12,NOP,BOS
7093,93,@,L 100-107 ,240,36,82,0.439,23,47,0.489,13,35,0.371,15,20,0.75,100,40,76,0.526,33,56,0.589,7,20,0.35,20,27,0.741,107,2015-01-13,CLE,PHO
7094,94,@,W 100-94 ,240,37,88,0.42,29,65,0.446,8,23,0.348,18,19,0.947,100,35,87,0.402,29,61,0.475,6,26,0.231,18,20,0.9,94,2015-01-14,LAC,POR
7095,95,Home,W 100-84 ,240,38,82,0.463,28,53,0.528,10,29,0.345,14,22,0.636,100,31,80,0.388,28,61,0.459,3,19,0.158,19,31,0.613,84,2015-01-14,TOR,PHI
7096,96,@,L 100-115 ,240,34,75,0.453,26,58,0.448,8,17,0.471,24,35,0.686,100,43,86,0.5,30,54,0.556,13,32,0.406,16,22,0.727,115,2015-01-19,LAL,PHO
7097,97,Home,L 100-103 ,240,39,84,0.464,34,66,0.515,5,18,0.278,17,24,0.708,100,37,79,0.468,32,59,0.542,5,20,0.25,24,30,0.8,103,2015-01-21,SAC,BRK
7098,98,@,W 100-99 ,240,37,75,0.493,28,54,0.519,9,21,0.429,17,27,0.63,100,37,89,0.416,31,68,0.456,6,21,0.286,19,26,0.731,99,2015-01-23,BOS,DEN
7099,99,@,L 100-112 ,240,37,71,0.521,31,55,0.564,6,16,0.375,20,25,0.8,100,45,80,0.563,35,52,0.673,10,28,0.357,12,18,0.667,112,2015-01-25,MIN,ATL
7100,0,Home,L 100-120 ,240,34,80,0.425,24,51,0.471,10,29,0.345,22,27,0.815,100,43,87,0.494,33,64,0.516,10,23,0.435,24,36,0.667,120,2015-01-25,PHO,LAC
7101,1,Home,W 100-92 ,240,40,91,0.44,32,74,0.432,8,17,0.471,12,17,0.706,100,34,85,0.4,29,63,0.46,5,22,0.227,19,22,0.864,92,2015-01-28,NYK,OKC
7102,2,Home,L 100-115 ,240,37,82,0.451,32,64,0.5,5,18,0.278,21,30,0.7,100,45,87,0.517,33,62,0.532,12,25,0.48,13,18,0.722,115,2015-01-29,ORL,MIL
7103,3,@,L 100-110 ,240,37,86,0.43,29,59,0.492,8,27,0.296,18,25,0.72,100,42,94,0.447,33,69,0.478,9,25,0.36,17,28,0.607,110,2015-01-30,GSW,UTA
7104,4,@,L 100-102 ,240,42,89,0.472,34,66,0.515,8,23,0.348,8,25,0.32,100,41,83,0.494,29,56,0.518,12,27,0.444,8,18,0.444,102,2015-02-02,LAC,BRK
7105,5,Home,W 100-94 ,240,39,84,0.464,29,53,0.547,10,31,0.323,12,18,0.667,100,34,82,0.415,31,69,0.449,3,13,0.231,23,26,0.885,94,2015-02-02,DAL,MIN
7106,6,@,L 100-115 ,240,40,89,0.449,33,67,0.493,7,22,0.318,13,17,0.765,100,43,86,0.5,34,63,0.54,9,23,0.391,20,23,0.87,115,2015-02-02,ATL,NOP
7107,7,@,L 100-104 ,240,33,80,0.413,29,56,0.518,4,24,0.167,30,33,0.909,100,40,99,0.404,28,71,0.394,12,28,0.429,12,17,0.706,104,2015-02-04,DEN,BOS
7108,8,@,W 100-90 ,240,38,80,0.475,32,67,0.478,6,13,0.462,18,22,0.818,100,33,73,0.452,26,50,0.52,7,23,0.304,17,26,0.654,90,2015-02-04,MEM,UTA
7109,9,Home,W 100-93 ,240,38,84,0.452,24,57,0.421,14,27,0.519,10,14,0.714,100,37,80,0.463,30,60,0.5,7,20,0.35,12,18,0.667,93,2015-02-06,PHO,UTA
7110,10,@,W 100-96 ,240,39,93,0.419,30,72,0.417,9,21,0.429,13,19,0.684,100,33,79,0.418,20,57,0.351,13,22,0.591,17,20,0.85,96,2015-02-09,UTA,NOP
7111,11,@,L 100-111 ,240,36,87,0.414,24,50,0.48,12,37,0.324,16,26,0.615,100,44,93,0.473,35,69,0.507,9,24,0.375,14,18,0.778,111,2015-02-20,HOU,DAL
7112,12,Home,W 100-91 ,240,38,84,0.452,32,62,0.516,6,22,0.273,18,33,0.545,100,33,78,0.423,28,62,0.452,5,16,0.313,20,22,0.909,91,2015-02-20,DET,CHI
7113,13,Home,W 100-97 ,240,40,78,0.513,30,56,0.536,10,22,0.455,10,16,0.625,100,35,84,0.417,30,61,0.492,5,23,0.217,22,31,0.71,97,2015-02-23,NOP,TOR
7114,14,@,W 100-97 ,240,40,89,0.449,38,78,0.487,2,11,0.182,18,21,0.857,100,34,73,0.466,27,61,0.443,7,12,0.583,22,34,0.647,97,2015-02-25,LAL,UTA
7115,15,Home,L 100-102 ,240,42,86,0.488,31,58,0.534,11,28,0.393,5,5,1.0,100,42,83,0.506,38,67,0.567,4,16,0.25,14,17,0.824,102,2015-03-04,HOU,MEM
7116,16,Home,W 100-94 ,240,32,79,0.405,29,63,0.46,3,16,0.188,33,43,0.767,100,38,88,0.432,31,70,0.443,7,18,0.389,11,17,0.647,94,2015-03-04,MIA,LAL
7117,17,@,W 100-85 ,240,42,92,0.457,34,72,0.472,8,20,0.4,8,10,0.8,100,32,82,0.39,29,64,0.453,3,18,0.167,18,25,0.72,85,2015-03-04,DEN,MIN
7118,18,Home,L 100-105 ,240,41,87,0.471,36,67,0.537,5,20,0.25,13,15,0.867,100,37,79,0.468,29,58,0.5,8,21,0.381,23,27,0.852,105,2015-03-04,ORL,PHO
7119,19,Home,L 100-108 (OT),265,34,97,0.351,26,75,0.347,8,22,0.364,24,29,0.828,100,39,91,0.429,36,65,0.554,3,26,0.115,27,35,0.771,108,2015-03-06,BRK,PHO
7120,20,Home,L 100-114 ,240,38,92,0.413,29,62,0.468,9,30,0.3,15,19,0.789,100,40,86,0.465,30,58,0.517,10,28,0.357,24,32,0.75,114,2015-03-07,DEN,HOU
7121,21,@,W 100-93 ,240,38,78,0.487,29,52,0.558,9,26,0.346,15,22,0.682,100,38,82,0.463,36,68,0.529,2,14,0.143,15,21,0.714,93,2015-03-08,DAL,LAL
7122,22,@,W 100-90 ,240,39,87,0.448,33,62,0.532,6,25,0.24,16,17,0.941,100,29,69,0.42,25,52,0.481,4,17,0.235,28,34,0.824,90,2015-03-09,BOS,MIA
7123,23,@,L 100-105 ,240,38,91,0.418,27,60,0.45,11,31,0.355,13,23,0.565,100,42,92,0.457,32,59,0.542,10,33,0.303,11,14,0.786,105,2015-03-11,HOU,POR
7124,24,@,W 100-98 ,240,32,86,0.372,25,56,0.446,7,30,0.233,29,36,0.806,100,36,82,0.439,24,56,0.429,12,26,0.462,14,24,0.583,98,2015-03-15,HOU,LAC
7125,25,@,L 100-109 ,240,37,83,0.446,28,54,0.519,9,29,0.31,17,24,0.708,100,40,87,0.46,32,66,0.485,8,21,0.381,21,30,0.7,109,2015-03-15,CHI,OKC
7126,26,@,L 100-104 (OT),265,36,94,0.383,33,80,0.413,3,14,0.214,25,30,0.833,100,41,91,0.451,38,77,0.494,3,14,0.214,19,27,0.704,104,2015-03-17,SAS,NYK
7127,27,@,L 100-105 ,240,42,87,0.483,36,70,0.514,6,17,0.353,10,15,0.667,100,35,79,0.443,23,50,0.46,12,29,0.414,23,27,0.852,105,2015-03-18,MIN,TOR
7128,28,@,L 100-107 ,240,38,75,0.507,26,53,0.491,12,22,0.545,12,16,0.75,100,42,91,0.462,35,68,0.515,7,23,0.304,16,23,0.696,107,2015-03-22,NOP,LAC
7129,29,Home,L 100-119 ,240,41,85,0.482,37,68,0.544,4,17,0.235,14,17,0.824,100,42,90,0.467,30,62,0.484,12,28,0.429,23,30,0.767,119,2015-03-22,ORL,DEN
7130,30,Home,L 100-110 ,240,40,90,0.444,32,66,0.485,8,24,0.333,12,19,0.632,100,31,65,0.477,18,41,0.439,13,24,0.542,35,37,0.946,110,2015-03-23,IND,HOU
7131,31,@,L 100-115 ,240,37,86,0.43,22,56,0.393,15,30,0.5,11,14,0.786,100,42,80,0.525,30,54,0.556,12,26,0.462,19,22,0.864,115,2015-03-28,ATL,CHO
7132,32,Home,W 100-87 ,240,39,86,0.453,33,59,0.559,6,27,0.222,16,18,0.889,100,34,81,0.42,28,66,0.424,6,15,0.4,13,23,0.565,87,2015-04-01,BOS,IND
7133,33,@,W 100-98 ,240,41,81,0.506,32,65,0.492,9,16,0.563,9,12,0.75,100,37,81,0.457,26,58,0.448,11,23,0.478,13,15,0.867,98,2015-04-01,BRK,NYK
7134,34,Home,W 100-92 ,240,38,80,0.475,34,59,0.576,4,21,0.19,20,28,0.714,100,36,88,0.409,32,71,0.451,4,17,0.235,16,26,0.615,92,2015-04-03,MEM,OKC
7135,35,@,L 100-105 ,240,35,84,0.417,26,59,0.441,9,25,0.36,21,27,0.778,100,39,81,0.481,32,57,0.561,7,24,0.292,20,30,0.667,105,2015-04-07,LAL,LAC
7136,36,@,L 100-105 ,240,39,91,0.429,34,73,0.466,5,18,0.278,17,21,0.81,100,40,81,0.494,37,66,0.561,3,15,0.2,22,28,0.786,105,2015-04-07,CHA,MIA
7137,37,@,L 100-103 ,240,42,95,0.442,33,73,0.452,9,22,0.409,7,10,0.7,100,36,83,0.434,27,64,0.422,9,19,0.474,22,30,0.733,103,2015-04-07,GSW,NOP
7138,38,@,W 100-90 ,240,35,85,0.412,26,50,0.52,9,35,0.257,21,26,0.808,100,34,83,0.41,21,51,0.412,13,32,0.406,9,17,0.529,90,2015-04-13,HOU,CHO
7139,39,Home,W 100-93 ,240,39,83,0.47,36,73,0.493,3,10,0.3,19,23,0.826,100,35,85,0.412,29,64,0.453,6,21,0.286,17,28,0.607,93,2015-04-13,MIA,ORL
7140,40,@,W 100-88 ,240,37,84,0.44,31,63,0.492,6,21,0.286,20,24,0.833,100,31,78,0.397,27,64,0.422,4,14,0.286,22,28,0.786,88,2015-04-13,NOP,MIN
7141,41,Home,L 100-105 ,240,41,89,0.461,34,68,0.5,7,21,0.333,11,16,0.688,100,42,85,0.494,29,55,0.527,13,30,0.433,8,14,0.571,105,2015-04-15,MIL,BOS
7142,42,Home,L 100-115 ,240,39,93,0.419,39,84,0.464,0,9,0.0,22,28,0.786,100,42,78,0.538,28,50,0.56,14,28,0.5,17,20,0.85,115,2015-10-28,BRK,CHI
7143,43,Home,L 100-107 ,240,38,85,0.447,31,61,0.508,7,24,0.292,17,23,0.739,100,42,81,0.519,34,59,0.576,8,22,0.364,15,20,0.75,107,2015-11-02,PHI,CLE
7144,44,Home,W 100-98 ,240,35,91,0.385,27,68,0.397,8,23,0.348,22,29,0.759,100,35,83,0.422,25,56,0.446,10,27,0.37,18,22,0.818,98,2015-11-04,IND,BOS
7145,45,@,W 100-92 ,240,37,74,0.5,29,52,0.558,8,22,0.364,18,36,0.5,100,37,92,0.402,27,62,0.435,10,30,0.333,8,13,0.615,92,2015-11-06,DET,PHO
7146,46,@,W 100-84 ,240,36,75,0.48,25,48,0.521,11,27,0.407,17,23,0.739,100,24,70,0.343,21,55,0.382,3,15,0.2,33,36,0.917,84,2015-11-11,GSW,MEM
7147,47,@,L 100-101 ,240,33,69,0.478,25,47,0.532,8,22,0.364,26,29,0.897,100,36,86,0.419,30,70,0.429,6,16,0.375,23,27,0.852,101,2015-11-13,POR,MEM
7148,48,Home,W 100-81 ,240,34,77,0.442,25,56,0.446,9,21,0.429,23,27,0.852,100,30,82,0.366,23,59,0.39,7,23,0.304,14,20,0.7,81,2015-11-13,TOR,NOP
7149,49,@,W 100-85 ,240,39,82,0.476,30,59,0.508,9,23,0.391,13,20,0.65,100,28,77,0.364,22,52,0.423,6,25,0.24,23,29,0.793,85,2015-11-15,BOS,OKC
7150,50,@,L 100-115 ,240,38,73,0.521,35,65,0.538,3,8,0.375,21,26,0.808,100,40,71,0.563,29,47,0.617,11,24,0.458,24,30,0.8,115,2015-11-19,MIL,CLE
7151,51,Home,W 100-95 ,240,36,78,0.462,33,66,0.5,3,12,0.25,25,27,0.926,100,32,78,0.41,22,47,0.468,10,31,0.323,21,27,0.778,95,2015-11-23,MIN,PHI
7152,52,Home,W 100-91 ,240,34,86,0.395,29,70,0.414,5,16,0.313,27,32,0.844,100,31,83,0.373,22,56,0.393,9,27,0.333,20,25,0.8,91,2015-11-25,ORL,NYK
7153,53,@,L 100-106 ,240,37,93,0.398,30,74,0.405,7,19,0.368,19,22,0.864,100,39,90,0.433,29,62,0.468,10,28,0.357,18,20,0.9,106,2015-11-30,OKC,ATL
7154,54,Home,W 100-87 ,240,37,74,0.5,27,48,0.563,10,26,0.385,16,20,0.8,100,32,86,0.372,19,59,0.322,13,27,0.481,10,13,0.769,87,2015-12-04,ATL,LAL
7155,55,@,W 100-96 ,240,39,84,0.464,27,58,0.466,12,26,0.462,10,18,0.556,100,37,81,0.457,29,52,0.558,8,29,0.276,14,20,0.7,96,2015-12-04,HOU,DAL
7156,56,@,L 100-105 ,240,40,79,0.506,29,53,0.547,11,26,0.423,9,16,0.563,100,40,79,0.506,31,58,0.534,9,21,0.429,16,20,0.8,105,2015-12-08,POR,CLE
7157,57,@,L 100-105 ,240,39,91,0.429,33,70,0.471,6,21,0.286,16,23,0.696,100,38,92,0.413,33,69,0.478,5,23,0.217,24,28,0.857,105,2015-12-09,CHI,BOS
7158,58,Home,W 100-91 ,240,37,74,0.5,31,60,0.517,6,14,0.429,20,27,0.741,100,34,87,0.391,30,56,0.536,4,31,0.129,19,22,0.864,91,2015-12-10,BRK,PHI
7159,59,Home,L 100-105 ,240,35,79,0.443,30,60,0.5,5,19,0.263,25,30,0.833,100,43,86,0.5,35,62,0.565,8,24,0.333,11,18,0.611,105,2015-12-12,BRK,LAC
7160,60,Home,W 100-97 ,240,37,77,0.481,30,55,0.545,7,22,0.318,19,23,0.826,100,40,77,0.519,33,58,0.569,7,19,0.368,10,14,0.714,97,2015-12-13,MIA,MEM
7161,61,@,W 100-88 ,240,40,89,0.449,33,73,0.452,7,16,0.438,13,15,0.867,100,33,84,0.393,25,51,0.49,8,33,0.242,14,15,0.933,88,2015-12-14,MIA,ATL
7162,62,Home,L 100-112 ,240,36,77,0.468,32,67,0.478,4,10,0.4,24,31,0.774,100,41,73,0.562,31,55,0.564,10,18,0.556,20,27,0.741,112,2015-12-15,MIN,DEN
7163,63,@,L 100-104 ,240,35,74,0.473,29,54,0.537,6,20,0.3,24,28,0.857,100,41,88,0.466,29,59,0.492,12,29,0.414,10,13,0.769,104,2015-12-17,OKC,CLE
7164,64,@,W 100-85 ,240,38,80,0.475,35,68,0.515,3,12,0.25,21,24,0.875,100,32,78,0.41,27,57,0.474,5,21,0.238,16,20,0.8,85,2015-12-20,MIN,BRK
7165,65,Home,L 100-103 ,240,38,81,0.469,34,69,0.493,4,12,0.333,20,24,0.833,100,39,78,0.5,28,56,0.5,11,22,0.5,14,20,0.7,103,2015-12-20,ORL,ATL
7166,66,@,W 100-99 ,240,40,85,0.471,36,68,0.529,4,17,0.235,16,20,0.8,100,41,87,0.471,34,65,0.523,7,22,0.318,10,14,0.714,99,2015-12-21,OKC,LAC
7167,67,@,L 100-107 ,240,38,89,0.427,31,68,0.456,7,21,0.333,17,33,0.515,100,43,89,0.483,37,69,0.536,6,20,0.3,15,20,0.75,107,2015-12-23,DET,ATL
7168,68,@,L 100-113 ,240,37,81,0.457,30,61,0.492,7,20,0.35,19,29,0.655,100,51,85,0.6,46,73,0.63,5,12,0.417,6,8,0.75,113,2015-12-23,PHI,MIL
7169,69,Home,W 100-91 ,240,37,82,0.451,26,57,0.456,11,25,0.44,15,19,0.789,100,33,72,0.458,30,55,0.545,3,17,0.176,22,32,0.688,91,2015-12-23,WAS,MEM
7170,70,Home,W 100-91 ,240,36,85,0.424,28,65,0.431,8,20,0.4,20,29,0.69,100,33,89,0.371,29,70,0.414,4,19,0.211,21,24,0.875,91,2015-12-27,BOS,NYK
7171,71,@,L 100-102 (OT),265,37,97,0.381,30,75,0.4,7,22,0.318,19,24,0.792,100,37,86,0.43,31,68,0.456,6,18,0.333,22,27,0.815,102,2015-12-30,IND,CHI
7172,72,Home,W 100-93 ,240,36,82,0.439,27,56,0.482,9,26,0.346,19,21,0.905,100,35,83,0.422,32,63,0.508,3,20,0.15,20,22,0.909,93,2015-12-30,ORL,BRK
7173,73,@,W 100-97 ,240,38,93,0.409,35,75,0.467,3,18,0.167,21,22,0.955,100,34,88,0.386,27,56,0.482,7,32,0.219,22,28,0.786,97,2016-01-02,BRK,BOS
7174,74,@,L 100-122 ,240,36,73,0.493,28,54,0.519,8,19,0.421,20,29,0.69,100,41,74,0.554,24,41,0.585,17,33,0.515,23,26,0.885,122,2016-01-04,TOR,CLE
7175,75,@,L 100-103 (OT),265,37,94,0.394,29,66,0.439,8,28,0.286,18,25,0.72,100,34,90,0.378,29,68,0.426,5,22,0.227,30,39,0.769,103,2016-01-04,IND,MIA
7176,76,@,W 100-91 ,240,37,87,0.425,30,59,0.508,7,28,0.25,19,22,0.864,100,34,92,0.37,27,62,0.435,7,30,0.233,16,20,0.8,91,2016-01-06,DAL,NOP
7177,77,Home,W 100-99 ,240,41,93,0.441,37,80,0.463,4,13,0.308,14,17,0.824,100,38,91,0.418,29,70,0.414,9,21,0.429,14,17,0.824,99,2016-01-08,SAS,NYK
7178,78,Home,W 100-88 ,240,39,84,0.464,32,60,0.533,7,24,0.292,15,18,0.833,100,32,80,0.4,29,67,0.433,3,13,0.231,21,30,0.7,88,2016-01-10,NYK,MIL
7179,79,Home,L 100-114 ,240,34,81,0.42,25,59,0.424,9,22,0.409,23,27,0.852,100,48,99,0.485,39,75,0.52,9,24,0.375,9,10,0.9,114,2016-01-11,CHI,WAS
7180,80,@,L 100-112 ,240,39,76,0.513,34,62,0.548,5,14,0.357,17,19,0.895,100,43,85,0.506,30,61,0.492,13,24,0.542,13,18,0.722,112,2016-01-18,BRK,TOR
7181,81,@,L 100-107 ,240,33,80,0.413,20,56,0.357,13,24,0.542,21,29,0.724,100,38,77,0.494,33,64,0.516,5,13,0.385,26,31,0.839,107,2016-01-26,ORL,MIL
7182,82,Home,L 100-105 ,240,40,82,0.488,33,66,0.5,7,16,0.438,13,15,0.867,100,42,98,0.429,32,68,0.471,10,30,0.333,11,16,0.688,105,2016-02-01,BRK,DET
7183,83,Home,L 100-114 ,240,36,81,0.444,29,58,0.5,7,23,0.304,21,31,0.677,100,44,88,0.5,32,64,0.5,12,24,0.5,14,17,0.824,114,2016-02-03,BRK,IND
7184,84,@,W 100-93 ,240,37,81,0.457,28,56,0.5,9,25,0.36,17,33,0.515,100,33,83,0.398,26,66,0.394,7,17,0.412,20,29,0.69,93,2016-02-07,LAC,MIA
7185,85,@,L 100-120 ,240,36,82,0.439,27,59,0.458,9,23,0.391,19,29,0.655,100,45,94,0.479,29,59,0.492,16,35,0.457,14,19,0.737,120,2016-02-08,SAC,CLE
7186,86,Home,W 100-96 ,240,39,82,0.476,31,63,0.492,8,19,0.421,14,21,0.667,100,33,70,0.471,26,49,0.531,7,21,0.333,23,30,0.767,96,2016-02-10,NOP,UTA
7187,87,Home,L 100-116 ,240,30,82,0.366,19,47,0.404,11,35,0.314,29,35,0.829,100,37,78,0.474,30,54,0.556,7,24,0.292,35,56,0.625,116,2016-02-19,PHO,HOU
7188,88,Home,W 100-95 ,240,37,84,0.44,31,66,0.47,6,18,0.333,20,29,0.69,100,38,101,0.376,31,77,0.403,7,24,0.292,12,17,0.706,95,2016-02-29,BOS,UTA
7189,89,Home,W 100-96 ,240,35,83,0.422,26,54,0.481,9,29,0.31,21,25,0.84,100,37,80,0.463,29,62,0.468,8,18,0.444,14,15,0.933,96,2016-02-29,CLE,IND
7190,90,Home,W 100-95 ,240,36,81,0.444,33,46,0.717,3,35,0.086,25,38,0.658,100,36,90,0.4,22,53,0.415,14,37,0.378,9,13,0.692,95,2016-03-02,HOU,NOP
7191,91,@,L 100-108 ,240,35,87,0.402,26,52,0.5,9,35,0.257,21,30,0.7,100,36,79,0.456,27,58,0.466,9,21,0.429,27,34,0.794,108,2016-03-05,HOU,CHI
7192,92,@,W 100-99 ,240,37,83,0.446,30,62,0.484,7,21,0.333,19,20,0.95,100,39,89,0.438,33,74,0.446,6,15,0.4,15,24,0.625,99,2016-03-05,IND,WAS
7193,93,Home,L 100-109 ,240,32,80,0.4,22,58,0.379,10,22,0.455,26,33,0.788,100,37,71,0.521,25,43,0.581,12,28,0.429,23,30,0.767,109,2016-03-06,MEM,PHO
7194,94,Home,W 100-90 ,240,39,78,0.5,29,53,0.547,10,25,0.4,12,15,0.8,100,36,91,0.396,29,73,0.397,7,18,0.389,11,17,0.647,90,2016-03-07,CHI,MIL
7195,95,Home,L 100-107 ,240,35,88,0.398,27,63,0.429,8,25,0.32,22,25,0.88,100,41,79,0.519,37,64,0.578,4,15,0.267,21,34,0.618,107,2016-03-11,SAC,ORL
7196,96,@,L 100-116 ,240,36,86,0.419,29,65,0.446,7,21,0.333,21,29,0.724,100,42,80,0.525,34,56,0.607,8,24,0.333,24,29,0.828,116,2016-03-12,WAS,DEN
7197,97,Home,L 100-109 ,240,39,70,0.557,27,43,0.628,12,27,0.444,10,13,0.769,100,45,89,0.506,39,75,0.52,6,14,0.429,13,21,0.619,109,2016-03-13,BRK,MIL
7198,98,@,L 100-105 ,240,40,83,0.482,32,61,0.525,8,22,0.364,12,18,0.667,100,35,81,0.432,29,61,0.475,6,20,0.3,29,45,0.644,105,2016-03-20,ORL,TOR
7199,99,Home,L 100-105 ,240,34,74,0.459,26,56,0.464,8,18,0.444,24,27,0.889,100,39,82,0.476,29,54,0.537,10,28,0.357,17,21,0.81,105,2016-03-22,BRK,CHO
7200,0,@,L 100-107 ,240,40,80,0.5,36,65,0.554,4,15,0.267,16,23,0.696,100,39,77,0.506,33,58,0.569,6,19,0.316,23,24,0.958,107,2016-03-22,MEM,LAL
7201,1,Home,L 100-102 ,240,40,106,0.377,31,84,0.369,9,22,0.409,11,15,0.733,100,36,85,0.424,31,63,0.492,5,22,0.227,25,28,0.893,102,2016-03-28,CHI,ATL
7202,2,Home,L 100-119 ,240,38,93,0.409,30,69,0.435,8,24,0.333,16,23,0.696,100,41,86,0.477,30,60,0.5,11,26,0.423,26,32,0.813,119,2016-03-28,TOR,OKC
7203,3,Home,L 100-106 ,240,31,86,0.36,17,46,0.37,14,40,0.35,24,28,0.857,100,38,79,0.481,29,54,0.537,9,25,0.36,21,42,0.5,106,2016-03-29,CLE,HOU
7204,4,@,W 100-85 ,240,38,87,0.437,31,62,0.5,7,25,0.28,17,18,0.944,100,30,96,0.313,14,52,0.269,16,44,0.364,9,10,0.9,85,2016-03-29,CHA,PHI
7205,5,@,L 100-102 (OT),265,41,86,0.477,38,69,0.551,3,17,0.176,15,26,0.577,100,37,102,0.363,31,82,0.378,6,20,0.3,22,29,0.759,102,2016-03-30,MIA,LAL
7206,6,Home,W 100-92 ,240,36,75,0.48,24,51,0.471,12,24,0.5,16,22,0.727,100,36,80,0.45,28,63,0.444,8,17,0.471,12,18,0.667,92,2016-03-30,SAS,NOP
7207,7,Home,L 100-103 ,240,36,90,0.4,27,65,0.415,9,25,0.36,19,22,0.864,100,37,77,0.481,26,53,0.491,11,24,0.458,18,22,0.818,103,2016-03-31,HOU,CHI
7208,8,Home,W 100-91 ,240,36,84,0.429,29,57,0.509,7,27,0.259,21,27,0.778,100,33,90,0.367,23,51,0.451,10,39,0.256,15,21,0.714,91,2016-04-01,CHA,PHI
7209,9,Home,L 100-107 ,240,37,90,0.411,31,69,0.449,6,21,0.286,20,29,0.69,100,41,91,0.451,33,61,0.541,8,30,0.267,17,22,0.773,107,2016-04-03,LAL,BOS
7210,10,@,W 100-99 ,240,39,87,0.448,29,51,0.569,10,36,0.278,12,13,0.923,100,37,96,0.385,30,75,0.4,7,21,0.333,18,20,0.9,99,2016-04-09,GSW,MEM
7211,11,Home,L 100-121 ,240,39,95,0.411,32,74,0.432,7,21,0.333,15,20,0.75,100,43,83,0.518,33,58,0.569,10,25,0.4,25,31,0.806,121,2016-04-09,NOP,PHO
7212,12,@,W 100-84 ,240,36,79,0.456,24,48,0.5,12,31,0.387,16,21,0.762,100,32,80,0.4,26,53,0.491,6,27,0.222,14,19,0.737,84,2016-04-10,UTA,DEN
7213,13,Home,L 100-114 ,240,34,89,0.382,26,65,0.4,8,24,0.333,24,29,0.828,100,41,81,0.506,27,49,0.551,14,32,0.438,18,22,0.818,114,2016-04-11,BOS,CHO
7214,14,Home,L 100-129 ,240,40,85,0.471,33,52,0.635,7,33,0.212,13,18,0.722,100,47,98,0.48,35,74,0.473,12,24,0.5,23,26,0.885,129,2016-10-25,GSW,SAS
7215,15,Home,L 100-106 ,240,37,90,0.411,29,67,0.433,8,23,0.348,18,25,0.72,100,35,83,0.422,27,54,0.5,8,29,0.276,28,33,0.848,106,2016-10-30,PHO,GSW
7216,16,@,L 100-107 ,240,35,81,0.432,28,61,0.459,7,20,0.35,23,31,0.742,100,41,87,0.471,27,55,0.491,14,32,0.438,11,17,0.647,107,2016-11-02,CHI,BOS
7217,17,@,W 100-86 ,240,37,83,0.446,31,63,0.492,6,20,0.3,20,22,0.909,100,30,80,0.375,19,54,0.352,11,26,0.423,15,24,0.625,86,2016-11-04,SAS,UTA
7218,18,@,W 100-94 ,240,32,71,0.451,18,38,0.474,14,33,0.424,22,27,0.815,100,31,81,0.383,25,55,0.455,6,26,0.231,26,32,0.813,94,2016-11-06,POR,MEM
7219,19,@,L 100-122 ,240,40,94,0.426,31,61,0.508,9,33,0.273,11,15,0.733,100,41,84,0.488,29,52,0.558,12,32,0.375,28,32,0.875,122,2016-11-07,IND,CHO
7220,20,@,L 100-107 ,240,32,89,0.36,23,67,0.343,9,22,0.409,27,32,0.844,100,38,84,0.452,30,62,0.484,8,22,0.364,23,30,0.767,107,2016-11-09,DET,PHO
7221,21,Home,L 100-106 ,240,34,89,0.382,19,42,0.452,15,47,0.319,17,21,0.81,100,41,76,0.539,36,58,0.621,5,18,0.278,19,24,0.792,106,2016-11-12,HOU,SAS
7222,22,Home,W 100-93 ,240,39,92,0.424,25,54,0.463,14,38,0.368,8,15,0.533,100,36,95,0.379,25,66,0.379,11,29,0.379,10,12,0.833,93,2016-11-13,CLE,CHO
7223,23,@,L 100-107 ,240,39,98,0.398,31,66,0.47,8,32,0.25,14,18,0.778,100,35,72,0.486,25,40,0.625,10,32,0.313,27,31,0.871,107,2016-11-16,MIL,ATL
7224,24,Home,W 100-96 ,240,37,90,0.411,27,61,0.443,10,29,0.345,16,24,0.667,100,39,84,0.464,32,56,0.571,7,28,0.25,11,17,0.647,96,2016-11-18,CHA,ATL
7225,25,Home,L 100-112 ,240,42,88,0.477,36,66,0.545,6,22,0.273,10,14,0.714,100,40,75,0.533,31,51,0.608,9,24,0.375,23,29,0.793,112,2016-11-26,WAS,SAS
7226,26,@,L 100-105 ,240,36,86,0.419,29,57,0.509,7,29,0.241,21,30,0.7,100,37,85,0.435,25,50,0.5,12,35,0.343,19,24,0.792,105,2016-11-28,ATL,GSW
7227,27,@,L 100-103 ,240,35,81,0.432,28,60,0.467,7,21,0.333,23,29,0.793,100,41,88,0.466,31,58,0.534,10,30,0.333,11,15,0.733,103,2016-12-03,LAL,MEM
7228,28,Home,L 100-103 ,240,35,87,0.402,28,59,0.475,7,28,0.25,23,27,0.852,100,36,84,0.429,26,55,0.473,10,29,0.345,21,25,0.84,103,2016-12-09,SAC,NYK
7229,29,@,L 100-105 ,240,42,91,0.462,37,71,0.521,5,20,0.25,11,18,0.611,100,38,84,0.452,37,76,0.487,1,8,0.125,28,31,0.903,105,2016-12-10,MIA,CHI
7230,30,@,L 100-122 ,240,42,89,0.472,38,65,0.585,4,24,0.167,12,17,0.706,100,42,81,0.519,28,56,0.5,14,25,0.56,24,28,0.857,122,2016-12-12,MIL,TOR
7231,31,@,L 100-122 ,240,40,98,0.408,31,71,0.437,9,27,0.333,11,20,0.55,100,42,94,0.447,18,33,0.545,24,61,0.393,14,19,0.737,122,2016-12-16,NOP,HOU
7232,32,@,W 100-89 ,240,36,79,0.456,27,49,0.551,9,30,0.3,19,22,0.864,100,32,88,0.364,26,57,0.456,6,31,0.194,19,24,0.792,89,2016-12-16,LAL,PHI
7233,33,@,L 100-103 ,240,35,77,0.455,23,49,0.469,12,28,0.429,18,21,0.857,100,37,65,0.569,29,43,0.674,8,22,0.364,21,27,0.778,103,2016-12-16,DAL,UTA
7234,34,@,L 100-113 ,240,41,89,0.461,31,63,0.492,10,26,0.385,8,14,0.571,100,42,86,0.488,31,64,0.484,11,22,0.5,18,22,0.818,113,2016-12-18,NOP,SAS
7235,35,Home,L 100-102 ,240,35,92,0.38,29,54,0.537,6,38,0.158,24,27,0.889,100,36,77,0.468,24,54,0.444,12,23,0.522,18,25,0.72,102,2016-12-20,HOU,SAS
7236,36,@,L 100-112 ,240,39,83,0.47,35,71,0.493,4,12,0.333,18,23,0.783,100,42,82,0.512,34,58,0.586,8,24,0.333,20,24,0.833,112,2016-12-25,MIN,OKC
7237,37,@,L 100-119 ,240,39,86,0.453,32,68,0.471,7,18,0.389,15,20,0.75,100,48,85,0.565,39,67,0.582,9,18,0.5,14,19,0.737,119,2016-12-25,CHI,SAS
7238,38,@,L 100-102 ,240,39,79,0.494,30,54,0.556,9,25,0.36,13,18,0.722,100,39,87,0.448,32,62,0.516,7,25,0.28,17,21,0.81,102,2016-12-26,PHI,SAC
7239,39,Home,L 100-102 ,240,39,83,0.47,35,67,0.522,4,16,0.25,18,22,0.818,100,38,75,0.507,29,49,0.592,9,26,0.346,17,24,0.708,102,2016-12-27,LAL,UTA
7240,40,Home,W 100-83 ,240,35,73,0.479,20,47,0.426,15,26,0.577,15,28,0.536,100,35,87,0.402,29,63,0.46,6,24,0.25,7,8,0.875,83,2016-12-29,UTA,PHI
7241,41,@,L 100-127 ,240,38,92,0.413,30,60,0.5,8,32,0.25,16,27,0.593,100,48,96,0.5,38,68,0.559,10,28,0.357,21,29,0.724,127,2017-01-06,MIA,LAL
7242,42,@,W 100-93 ,240,39,86,0.453,24,37,0.649,15,49,0.306,7,12,0.583,100,38,91,0.418,30,68,0.441,8,23,0.348,9,13,0.692,93,2017-01-06,HOU,ORL
7243,43,Home,W 100-94 ,240,32,73,0.438,19,50,0.38,13,23,0.565,23,29,0.793,100,36,82,0.439,24,55,0.436,12,27,0.444,10,16,0.625,94,2017-01-10,SAC,DET
7244,44,Home,W 100-92 ,240,38,79,0.481,25,45,0.556,13,34,0.382,11,19,0.579,100,31,85,0.365,22,54,0.407,9,31,0.29,21,25,0.84,92,2017-01-10,UTA,CLE
7245,45,@,L 100-121 ,240,38,90,0.422,30,62,0.484,8,28,0.286,16,19,0.842,100,46,85,0.541,36,64,0.563,10,21,0.476,19,27,0.704,121,2017-01-18,OKC,GSW
7246,46,Home,L 100-106 ,240,35,72,0.486,26,51,0.51,9,21,0.429,21,27,0.778,100,39,75,0.52,32,54,0.593,7,21,0.333,21,25,0.84,106,2017-01-18,SAC,IND
7247,47,@,L 100-109 ,240,39,77,0.506,29,57,0.509,10,20,0.5,12,17,0.706,100,39,84,0.464,33,60,0.55,6,24,0.25,25,32,0.781,109,2017-01-21,IND,UTA
7248,48,@,W 100-92 ,240,35,77,0.455,28,55,0.509,7,22,0.318,23,30,0.767,100,35,85,0.412,28,63,0.444,7,22,0.318,15,20,0.75,92,2017-01-24,CHI,ORL
7249,49,@,W 100-88 ,240,41,89,0.461,32,65,0.492,9,24,0.375,9,11,0.818,100,33,79,0.418,30,66,0.455,3,13,0.231,19,25,0.76,88,2017-01-27,MIA,CHI
7250,50,Home,L 100-128 ,240,38,100,0.38,28,63,0.444,10,37,0.27,14,17,0.824,100,49,81,0.605,43,66,0.652,6,15,0.4,24,30,0.8,128,2017-02-01,OKC,CHI
7251,51,Home,L 100-116 ,240,35,73,0.479,25,51,0.49,10,22,0.455,20,24,0.833,100,35,73,0.479,18,42,0.429,17,31,0.548,29,37,0.784,116,2017-02-11,IND,MIL
7252,52,@,L 100-116 ,240,39,88,0.443,27,53,0.509,12,35,0.343,10,14,0.714,100,46,88,0.523,39,74,0.527,7,14,0.5,17,19,0.895,116,2017-02-23,DEN,SAC
7253,53,Home,W 100-96 ,240,39,76,0.513,33,56,0.589,6,20,0.3,16,18,0.889,100,40,83,0.482,35,69,0.507,5,14,0.357,11,16,0.688,96,2017-02-26,MIL,PHO
7254,54,Home,W 100-95 ,240,36,64,0.563,26,43,0.605,10,21,0.476,18,24,0.75,100,35,77,0.455,21,44,0.477,14,33,0.424,11,13,0.846,95,2017-03-01,ATL,DAL
7255,55,Home,L 100-109 ,240,35,81,0.432,24,59,0.407,11,22,0.5,19,22,0.864,100,34,74,0.459,23,46,0.5,11,28,0.393,30,36,0.833,109,2017-03-01,SAC,BRK
7256,56,Home,W 100-99 ,240,35,74,0.473,26,45,0.578,9,29,0.31,21,24,0.875,100,37,81,0.457,30,58,0.517,7,23,0.304,18,25,0.72,99,2017-03-01,SAS,IND
7257,57,@,L 100-104 ,240,38,82,0.463,29,54,0.537,9,28,0.321,15,22,0.682,100,39,82,0.476,34,55,0.618,5,27,0.185,21,27,0.778,104,2017-03-03,MEM,DAL
7258,58,Home,W 100-88 ,240,35,86,0.407,24,55,0.436,11,31,0.355,19,21,0.905,100,37,81,0.457,25,51,0.49,12,30,0.4,2,3,0.667,88,2017-03-06,CHA,IND
7259,59,Home,W 99-91 ,240,36,77,0.468,32,62,0.516,4,15,0.267,23,31,0.742,99,34,82,0.415,26,58,0.448,8,24,0.333,15,22,0.682,91,2011-12-26,GSW,CHI
7260,60,Home,W 99-82 ,240,38,73,0.521,29,57,0.509,9,16,0.563,14,22,0.636,99,21,67,0.313,15,45,0.333,6,22,0.273,34,41,0.829,82,2011-12-29,LAL,NYK
7261,61,Home,W 99-86 ,240,32,72,0.444,25,47,0.532,7,25,0.28,28,38,0.737,99,33,72,0.458,27,58,0.466,6,14,0.429,14,18,0.778,86,2011-12-30,DAL,TOR
7262,62,@,L 99-102 ,240,37,77,0.481,33,64,0.516,4,13,0.308,21,29,0.724,99,35,79,0.443,29,63,0.46,6,16,0.375,26,33,0.788,102,2011-12-30,PHI,UTA
7263,63,Home,W 99-90 ,240,33,71,0.465,31,53,0.585,2,18,0.111,31,37,0.838,99,35,88,0.398,31,65,0.477,4,23,0.174,16,24,0.667,90,2012-01-01,DEN,LAL
7264,64,Home,W 99-82 ,240,36,85,0.424,26,63,0.413,10,22,0.455,17,24,0.708,99,29,77,0.377,22,53,0.415,7,24,0.292,17,21,0.81,82,2012-01-01,MIN,DAL
7265,65,@,L 99-108 ,240,41,96,0.427,30,65,0.462,11,31,0.355,6,7,0.857,99,41,78,0.526,36,64,0.563,5,14,0.357,21,27,0.778,108,2012-01-03,HOU,LAL
7266,66,@,W 99-83 ,240,40,76,0.526,35,64,0.547,5,12,0.417,14,21,0.667,99,36,88,0.409,35,82,0.427,1,6,0.167,10,12,0.833,83,2012-01-04,CHI,DET
7267,67,@,W 99-96 ,240,39,89,0.438,33,71,0.465,6,18,0.333,15,21,0.714,99,41,85,0.482,35,71,0.493,6,14,0.429,8,13,0.615,96,2012-01-06,NYK,WAS
7268,68,Home,W 99-77 ,240,39,77,0.506,37,68,0.544,2,9,0.222,19,26,0.731,99,29,89,0.326,24,73,0.329,5,16,0.313,14,21,0.667,77,2012-01-07,IND,CHA
7269,69,Home,W 99-83 ,240,39,80,0.488,37,63,0.587,2,17,0.118,19,23,0.826,99,34,80,0.425,27,60,0.45,7,20,0.35,8,12,0.667,83,2012-01-10,LAL,PHO
7270,70,Home,W 99-83 ,240,38,74,0.514,32,57,0.561,6,17,0.353,17,25,0.68,99,34,84,0.405,29,66,0.439,5,18,0.278,10,14,0.714,83,2012-01-13,SAS,POR
7271,71,Home,W 99-60 ,240,37,81,0.457,30,65,0.462,7,16,0.438,18,25,0.72,99,22,86,0.256,20,65,0.308,2,21,0.095,14,18,0.778,60,2012-01-14,DAL,SAC
7272,72,@,L 99-108 ,240,35,75,0.467,31,65,0.477,4,10,0.4,25,31,0.806,99,35,78,0.449,30,68,0.441,5,10,0.5,33,41,0.805,108,2012-01-14,NOP,MEM
7273,73,@,W 99-91 ,240,38,73,0.521,35,58,0.603,3,15,0.2,20,27,0.741,99,31,74,0.419,24,55,0.436,7,19,0.368,22,26,0.846,91,2012-01-15,GSW,DET
7274,74,Home,W 99-86 ,240,37,80,0.463,27,54,0.5,10,26,0.385,15,19,0.789,99,35,79,0.443,31,62,0.5,4,17,0.235,12,20,0.6,86,2012-01-16,MIN,SAC
7275,75,Home,W 99-79 ,240,41,77,0.532,34,61,0.557,7,16,0.438,10,14,0.714,99,28,82,0.341,24,68,0.353,4,14,0.286,19,27,0.704,79,2012-01-23,OKC,DET
7276,76,@,W 99-96 ,240,34,82,0.415,26,67,0.388,8,15,0.533,23,25,0.92,99,39,82,0.476,34,66,0.515,5,16,0.313,13,17,0.765,96,2012-01-24,TOR,PHO
7277,77,Home,L 99-105 ,240,38,93,0.409,30,62,0.484,8,31,0.258,15,20,0.75,99,39,91,0.429,25,62,0.403,14,29,0.483,13,17,0.765,105,2012-01-25,HOU,MIL
7278,78,@,W 99-96 ,240,36,79,0.456,25,51,0.49,11,28,0.393,16,21,0.762,99,38,81,0.469,32,62,0.516,6,19,0.316,14,24,0.583,96,2012-01-27,BRK,CLE
7279,79,Home,W 99-89 ,240,37,80,0.463,35,70,0.5,2,10,0.2,23,26,0.885,99,30,84,0.357,12,41,0.293,18,43,0.419,11,14,0.786,89,2012-01-27,MIA,NYK
7280,80,Home,L 99-102 ,240,39,83,0.47,35,72,0.486,4,11,0.364,17,29,0.586,99,40,76,0.526,34,65,0.523,6,11,0.545,16,21,0.762,102,2012-01-28,CHA,WAS
7281,81,Home,L 99-122 ,240,35,80,0.438,23,59,0.39,12,21,0.571,17,20,0.85,99,48,87,0.552,34,60,0.567,14,27,0.519,12,18,0.667,122,2012-01-30,PHO,DAL
7282,82,@,L 99-106 ,240,35,74,0.473,23,45,0.511,12,29,0.414,17,23,0.739,99,38,73,0.521,34,62,0.548,4,11,0.364,26,36,0.722,106,2012-01-31,BRK,IND
7283,83,Home,L 99-109 ,240,34,91,0.374,31,74,0.419,3,17,0.176,28,37,0.757,99,38,84,0.452,31,69,0.449,7,15,0.467,26,34,0.765,109,2012-02-01,MIN,IND
7284,84,Home,W 99-96 ,240,38,79,0.481,30,56,0.536,8,23,0.348,15,25,0.6,99,40,82,0.488,35,64,0.547,5,18,0.278,11,14,0.786,96,2012-02-01,BRK,DET
7285,85,Home,W 99-91 ,240,35,76,0.461,28,58,0.483,7,18,0.389,22,31,0.71,99,36,79,0.456,27,57,0.474,9,22,0.409,10,13,0.769,91,2012-02-01,SAS,HOU
7286,86,Home,W 99-81 ,240,39,89,0.438,35,74,0.473,4,15,0.267,17,17,1.0,99,34,83,0.41,30,64,0.469,4,19,0.211,9,14,0.643,81,2012-02-03,HOU,PHO
7287,87,@,W 99-79 ,240,40,77,0.519,32,64,0.5,8,13,0.615,11,20,0.55,99,32,81,0.395,27,69,0.391,5,12,0.417,10,14,0.714,79,2012-02-03,MIA,PHI
7288,88,Home,W 99-92 ,240,37,83,0.446,35,69,0.507,2,14,0.143,23,26,0.885,99,30,72,0.417,20,46,0.435,10,26,0.385,22,26,0.846,92,2012-02-04,NYK,NJN
7289,89,@,W 99-90 ,240,41,79,0.519,30,55,0.545,11,24,0.458,6,7,0.857,99,33,84,0.393,27,60,0.45,6,24,0.25,18,21,0.857,90,2012-02-06,PHO,ATL
7290,90,@,W 99-90 ,240,35,81,0.432,25,62,0.403,10,19,0.526,19,24,0.792,99,34,78,0.436,31,56,0.554,3,22,0.136,19,33,0.576,90,2012-02-06,HOU,DEN
7291,91,Home,W 99-88 ,240,35,73,0.479,26,45,0.578,9,28,0.321,20,31,0.645,99,33,76,0.434,31,65,0.477,2,11,0.182,20,26,0.769,88,2012-02-06,NYK,UTA
7292,92,@,L 99-104 ,240,37,78,0.474,33,68,0.485,4,10,0.4,21,23,0.913,99,41,87,0.471,37,73,0.507,4,14,0.286,18,22,0.818,104,2012-02-07,UTA,IND
7293,93,Home,W 99-92 ,240,36,71,0.507,29,53,0.547,7,18,0.389,20,26,0.769,99,32,78,0.41,29,63,0.46,3,15,0.2,25,29,0.862,92,2012-02-08,CLE,LAC
7294,94,@,W 99-92 ,240,39,73,0.534,37,64,0.578,2,9,0.222,19,29,0.655,99,33,78,0.423,23,51,0.451,10,27,0.37,16,20,0.8,92,2012-02-08,DET,NJN
7295,95,Home,L 99-105 ,240,37,90,0.411,28,66,0.424,9,24,0.375,16,17,0.941,99,33,72,0.458,21,47,0.447,12,25,0.48,27,37,0.73,105,2012-02-08,TOR,MIL
7296,96,@,W 99-84 ,240,35,79,0.443,29,65,0.446,6,14,0.429,23,30,0.767,99,31,84,0.369,28,70,0.4,3,14,0.214,19,25,0.76,84,2012-02-11,PHI,CLE
7297,97,@,W 99-94 ,240,35,81,0.432,20,44,0.455,15,37,0.405,14,21,0.667,99,39,93,0.419,30,71,0.423,9,22,0.409,7,7,1.0,94,2012-02-11,ORL,MIL
7298,98,@,W 99-95 ,240,36,83,0.434,30,69,0.435,6,14,0.429,21,32,0.656,99,39,84,0.464,36,71,0.507,3,13,0.231,14,25,0.56,95,2012-02-14,SAS,DET
7299,99,Home,L 99-101 ,240,37,69,0.536,31,52,0.596,6,17,0.353,19,27,0.704,99,38,80,0.475,28,59,0.475,10,21,0.476,15,18,0.833,101,2012-02-15,PHO,ATL
7300,0,@,L 99-111 ,240,41,90,0.456,33,64,0.516,8,26,0.308,9,13,0.692,99,44,83,0.53,39,72,0.542,5,11,0.455,18,24,0.75,111,2012-02-17,PHO,LAL
7301,1,Home,W 99-82 ,240,38,80,0.475,30,58,0.517,8,22,0.364,15,24,0.625,99,32,81,0.395,24,52,0.462,8,29,0.276,10,18,0.556,82,2012-02-22,NYK,ATL
7302,2,Home,L 99-114 ,240,37,83,0.446,30,64,0.469,7,19,0.368,18,21,0.857,99,41,86,0.477,28,59,0.475,13,27,0.481,19,23,0.826,114,2012-02-23,DEN,SAS
7303,3,Home,W 99-95 ,240,41,90,0.456,38,72,0.528,3,18,0.167,14,20,0.7,99,36,89,0.404,32,80,0.4,4,9,0.444,19,22,0.864,95,2012-02-28,CHI,NOH
7304,4,Home,W 99-94 ,240,39,86,0.453,31,63,0.492,8,23,0.348,13,15,0.867,99,32,85,0.376,26,67,0.388,6,18,0.333,24,28,0.857,94,2012-03-02,ATL,MIL
7305,5,Home,L 99-102 ,240,38,72,0.528,32,56,0.571,6,16,0.375,17,20,0.85,99,38,81,0.469,34,70,0.486,4,11,0.364,22,32,0.688,102,2012-03-02,TOR,MEM
7306,6,Home,W 99-98 ,240,38,90,0.422,35,80,0.438,3,10,0.3,20,27,0.741,99,37,75,0.493,29,58,0.5,8,17,0.471,16,22,0.727,98,2012-03-02,UTA,MIA
7307,7,@,W 99-94 ,240,36,86,0.419,30,69,0.435,6,17,0.353,21,28,0.75,99,32,72,0.444,22,45,0.489,10,27,0.37,20,27,0.741,94,2012-03-04,DEN,SAS
7308,8,@,W 99-93 ,240,39,87,0.448,38,80,0.475,1,7,0.143,20,24,0.833,99,32,68,0.471,29,61,0.475,3,7,0.429,26,37,0.703,93,2012-03-07,UTA,CHA
7309,9,Home,L 99-100 ,240,35,81,0.432,31,61,0.508,4,20,0.2,25,32,0.781,99,37,82,0.451,30,59,0.508,7,23,0.304,19,23,0.826,100,2012-03-07,DEN,CLE
7310,10,Home,W 99-98 ,240,38,76,0.5,30,53,0.566,8,23,0.348,15,23,0.652,99,42,77,0.545,39,68,0.574,3,9,0.333,11,12,0.917,98,2012-03-07,SAC,NOH
7311,11,@,W 99-94 ,240,32,76,0.421,21,50,0.42,11,26,0.423,24,31,0.774,99,35,86,0.407,30,64,0.469,5,22,0.227,19,26,0.731,94,2012-03-08,ORL,CHI
7312,12,Home,L 99-110 ,240,39,82,0.476,34,66,0.515,5,16,0.313,16,25,0.64,99,40,78,0.513,36,61,0.59,4,17,0.235,26,27,0.963,110,2012-03-10,WAS,POR
7313,13,Home,L 99-106 ,240,38,82,0.463,28,53,0.528,10,29,0.345,13,17,0.765,99,42,82,0.512,35,61,0.574,7,21,0.333,15,23,0.652,106,2012-03-11,SAC,ATL
7314,14,Home,L 99-105 ,240,40,86,0.465,36,73,0.493,4,13,0.308,15,19,0.789,99,35,73,0.479,29,55,0.527,6,18,0.333,29,35,0.829,105,2012-03-11,TOR,MIL
7315,15,@,L 99-104 ,240,37,80,0.463,34,69,0.493,3,11,0.273,22,31,0.71,99,40,93,0.43,35,79,0.443,5,14,0.357,19,28,0.679,104,2012-03-12,NYK,CHI
7316,16,Home,L 99-105 ,240,37,76,0.487,33,59,0.559,4,17,0.235,21,29,0.724,99,43,92,0.467,33,67,0.493,10,25,0.4,9,11,0.818,105,2012-03-12,BRK,MIL
7317,17,@,W 99-89 ,240,39,75,0.52,33,57,0.579,6,18,0.333,15,17,0.882,99,34,75,0.453,30,61,0.492,4,14,0.286,17,19,0.895,89,2012-03-15,WAS,NOH
7318,18,@,L 99-106 ,240,39,79,0.494,28,55,0.509,11,24,0.458,10,18,0.556,99,37,79,0.468,26,55,0.473,11,24,0.458,21,25,0.84,106,2012-03-17,SAS,DAL
7319,19,Home,W 99-92 (OT),265,42,101,0.416,40,88,0.455,2,13,0.154,13,16,0.813,99,33,80,0.413,27,55,0.491,6,25,0.24,20,25,0.8,92,2012-03-17,UTA,GSW
7320,20,Home,L 99-103 ,240,33,73,0.452,31,60,0.517,2,13,0.154,31,40,0.775,99,43,91,0.473,41,81,0.506,2,10,0.2,15,22,0.682,103,2012-03-18,LAL,UTA
7321,21,Home,W 99-86 ,240,40,85,0.471,33,65,0.508,7,20,0.35,12,19,0.632,99,35,82,0.427,34,71,0.479,1,11,0.091,15,22,0.682,86,2012-03-18,PHO,HOU
7322,22,@,L 99-115 ,240,38,92,0.413,32,67,0.478,6,25,0.24,17,17,1.0,99,44,96,0.458,36,68,0.529,8,28,0.286,19,21,0.905,115,2012-03-18,MIN,SAC
7323,23,Home,W 99-95 ,240,36,76,0.474,35,67,0.522,1,9,0.111,26,35,0.743,99,36,80,0.45,30,65,0.462,6,15,0.4,17,24,0.708,95,2012-03-20,MIA,PHO
7324,24,Home,W 99-86 ,240,41,92,0.446,38,82,0.463,3,10,0.3,14,18,0.778,99,36,74,0.486,32,64,0.5,4,10,0.4,10,13,0.769,86,2012-03-23,PHI,BOS
7325,25,Home,L 99-101 (OT),265,37,96,0.385,28,71,0.394,9,25,0.36,16,18,0.889,99,37,80,0.463,31,58,0.534,6,22,0.273,21,24,0.875,101,2012-03-24,HOU,DAL
7326,26,Home,W 99-93 ,240,39,80,0.488,27,52,0.519,12,28,0.429,9,13,0.692,99,33,71,0.465,26,58,0.448,7,13,0.538,20,21,0.952,93,2012-03-29,POR,NOH
7327,27,@,W 99-88 ,240,38,73,0.521,36,56,0.643,2,17,0.118,21,29,0.724,99,36,98,0.367,30,76,0.395,6,22,0.273,10,11,0.909,88,2012-03-30,DEN,CHA
7328,28,@,W 99-95 ,240,37,88,0.42,33,73,0.452,4,15,0.267,21,28,0.75,99,34,82,0.415,29,65,0.446,5,17,0.294,22,28,0.786,95,2012-03-31,MEM,MIL
7329,29,Home,L 99-111 ,240,39,90,0.433,36,73,0.493,3,17,0.176,18,23,0.783,99,43,92,0.467,33,64,0.516,10,28,0.357,15,20,0.75,111,2012-03-31,SAC,NJN
7330,30,Home,W 99-92 ,240,37,77,0.481,33,60,0.55,4,17,0.235,21,23,0.913,99,34,71,0.479,26,51,0.51,8,20,0.4,16,20,0.8,92,2012-04-01,TOR,WAS
7331,31,@,W 99-93 ,240,42,89,0.472,38,76,0.5,4,13,0.308,11,14,0.786,99,40,83,0.482,35,66,0.53,5,17,0.294,8,17,0.471,93,2012-04-02,HOU,CHI
7332,32,Home,W 99-93 ,240,35,75,0.467,32,62,0.516,3,13,0.231,26,32,0.813,99,38,83,0.458,35,73,0.479,3,10,0.3,14,17,0.824,93,2012-04-03,MIA,PHI
7333,33,@,W 99-78 ,240,39,77,0.506,30,56,0.536,9,21,0.429,12,12,1.0,99,34,79,0.43,31,67,0.463,3,12,0.25,7,8,0.875,78,2012-04-04,TOR,PHI
7334,34,Home,W 99-94 ,240,36,68,0.529,32,58,0.552,4,10,0.4,23,39,0.59,99,33,78,0.423,26,57,0.456,7,21,0.333,21,29,0.724,94,2012-04-05,DET,WAS
7335,35,@,W 99-97 (OT),265,41,94,0.436,33,73,0.452,8,21,0.381,9,11,0.818,99,42,93,0.452,35,69,0.507,7,24,0.292,6,8,0.75,97,2012-04-06,POR,DAL
7336,36,@,L 99-105 ,240,34,82,0.415,26,60,0.433,8,22,0.364,23,29,0.793,99,37,92,0.402,26,65,0.4,11,27,0.407,20,31,0.645,105,2012-04-06,PHO,DEN
7337,37,Home,W 99-90 ,240,40,82,0.488,36,69,0.522,4,13,0.308,15,19,0.789,99,33,81,0.407,23,56,0.411,10,25,0.4,14,18,0.778,90,2012-04-07,NOP,MIN
7338,38,@,L 99-100 (OT),265,35,89,0.393,28,67,0.418,7,22,0.318,22,31,0.71,99,39,102,0.382,31,68,0.456,8,34,0.235,14,20,0.7,100,2012-04-08,CHI,NYK
7339,39,Home,L 99-105 ,240,37,84,0.44,28,61,0.459,9,23,0.391,16,26,0.615,99,37,92,0.402,30,73,0.411,7,19,0.368,24,26,0.923,105,2012-04-14,MIL,IND
7340,40,Home,L 99-120 ,240,38,93,0.409,30,73,0.411,8,20,0.4,15,17,0.882,99,36,92,0.391,24,65,0.369,12,27,0.444,36,43,0.837,120,2012-04-16,GSW,SAS
7341,41,@,W 99-87 ,240,37,79,0.468,33,63,0.524,4,16,0.25,21,28,0.75,99,38,90,0.422,34,71,0.479,4,19,0.211,7,10,0.7,87,2012-04-18,LAL,GSW
7342,42,@,L 99-105 (OT),265,37,89,0.416,26,58,0.448,11,31,0.355,14,25,0.56,99,41,87,0.471,37,67,0.552,4,20,0.2,19,24,0.792,105,2012-04-19,HOU,NOH
7343,43,Home,W 99-96 ,240,40,84,0.476,30,58,0.517,10,26,0.385,9,15,0.6,99,36,73,0.493,31,57,0.544,5,16,0.313,19,22,0.864,96,2012-04-21,HOU,GSW
7344,44,Home,W 99-93 ,240,36,77,0.468,27,53,0.509,9,24,0.375,18,24,0.75,99,34,70,0.486,23,45,0.511,11,25,0.44,14,25,0.56,93,2012-04-25,NYK,LAC
7345,45,@,W 99-91 ,240,40,85,0.471,35,70,0.5,5,15,0.333,14,18,0.778,99,38,77,0.494,35,64,0.547,3,13,0.231,12,31,0.387,91,2012-10-30,DAL,LAL
7346,46,@,W 99-95 ,240,38,80,0.475,32,60,0.533,6,20,0.3,17,26,0.654,99,35,80,0.438,31,63,0.492,4,17,0.235,21,23,0.913,95,2012-10-31,SAS,NOH
7347,47,@,W 99-88 ,240,40,86,0.465,32,68,0.471,8,18,0.444,11,12,0.917,99,33,74,0.446,28,60,0.467,5,14,0.357,17,21,0.81,88,2012-11-02,MIL,BOS
7348,48,@,L 99-126 ,240,39,91,0.429,36,74,0.486,3,17,0.176,18,24,0.75,99,49,80,0.613,33,55,0.6,16,25,0.64,12,15,0.8,126,2012-11-03,CHA,DAL
7349,49,@,L 99-124 ,240,35,88,0.398,28,67,0.418,7,21,0.333,22,29,0.759,99,47,86,0.547,32,60,0.533,15,26,0.577,15,19,0.789,124,2012-11-05,PHO,MIA
7350,50,Home,W 99-93 ,240,40,84,0.476,38,78,0.487,2,6,0.333,17,24,0.708,99,36,86,0.419,28,67,0.418,8,19,0.421,13,17,0.765,93,2012-11-06,CHI,ORL
7351,51,@,L 99-107 ,240,40,83,0.482,33,62,0.532,7,21,0.333,12,18,0.667,99,43,83,0.518,35,61,0.574,8,22,0.364,13,21,0.619,107,2012-11-09,CHA,NOH
7352,52,@,W 99-89 ,240,41,84,0.488,32,60,0.533,9,24,0.375,8,11,0.727,99,37,75,0.493,32,61,0.525,5,14,0.357,10,17,0.588,89,2012-11-13,NYK,ORL
7353,53,Home,W 99-85 ,240,38,91,0.418,35,75,0.467,3,16,0.188,20,25,0.8,99,30,80,0.375,25,60,0.417,5,20,0.25,20,31,0.645,85,2012-11-14,MIL,IND
7354,54,Home,W 99-93 ,240,40,87,0.46,30,69,0.435,10,18,0.556,9,10,0.9,99,36,81,0.444,29,59,0.492,7,22,0.318,14,18,0.778,93,2012-11-16,PHI,UTA
7355,55,@,W 99-90 ,240,36,75,0.48,31,58,0.534,5,17,0.294,22,25,0.88,99,37,80,0.463,31,62,0.5,6,18,0.333,10,19,0.526,90,2012-11-18,BRK,SAC
7356,56,Home,W 99-95 (OT),265,37,89,0.416,30,60,0.5,7,29,0.241,18,24,0.75,99,36,99,0.364,32,84,0.381,4,15,0.267,19,22,0.864,95,2012-12-01,SAS,MEM
7357,57,@,L 99-106 ,240,39,80,0.488,31,57,0.544,8,23,0.348,13,19,0.684,99,40,90,0.444,28,61,0.459,12,29,0.414,14,17,0.824,106,2012-12-02,PHO,NYK
7358,58,Home,W 99-92 ,240,36,80,0.45,27,54,0.5,9,26,0.346,18,19,0.947,99,34,79,0.43,28,57,0.491,6,22,0.273,18,22,0.818,92,2012-12-05,IND,POR
7359,59,@,L 99-110 ,240,35,84,0.417,30,72,0.417,5,12,0.417,24,29,0.828,99,40,85,0.471,34,64,0.531,6,21,0.286,24,28,0.857,110,2012-12-05,MIL,SAS
7360,60,@,L 99-131 ,240,33,82,0.402,26,58,0.448,7,24,0.292,26,31,0.839,99,45,91,0.495,32,68,0.471,13,23,0.565,28,35,0.8,131,2012-12-07,TOR,UTA
7361,61,@,L 99-117 ,240,36,78,0.462,27,54,0.5,9,24,0.375,18,20,0.9,99,48,93,0.516,41,70,0.586,7,23,0.304,14,24,0.583,117,2012-12-08,PHO,LAC
7362,62,@,W 99-80 ,240,36,86,0.419,27,67,0.403,9,19,0.474,18,22,0.818,99,29,75,0.387,21,54,0.389,8,21,0.381,14,18,0.778,80,2012-12-08,SAC,POR
7363,63,Home,W 99-93 ,240,34,76,0.447,25,52,0.481,9,24,0.375,22,30,0.733,99,35,89,0.393,28,64,0.438,7,25,0.28,16,20,0.8,93,2012-12-12,HOU,WAS
7364,64,Home,W 99-96 ,240,41,84,0.488,33,65,0.508,8,19,0.421,9,15,0.6,99,37,87,0.425,29,68,0.426,8,19,0.421,14,18,0.778,96,2012-12-12,UTA,SAS
7365,65,Home,W 99-94 ,240,36,69,0.522,32,59,0.542,4,10,0.4,23,26,0.885,99,39,94,0.415,32,75,0.427,7,19,0.368,9,10,0.9,94,2012-12-14,DEN,MEM
7366,66,Home,W 99-85 ,240,41,86,0.477,32,65,0.492,9,21,0.429,8,11,0.727,99,34,92,0.37,27,72,0.375,7,20,0.35,10,11,0.909,85,2012-12-14,ORL,GSW
7367,67,Home,W 99-84 ,240,38,83,0.458,32,70,0.457,6,13,0.462,17,22,0.773,99,33,82,0.402,30,71,0.423,3,11,0.273,15,21,0.714,84,2012-12-14,PHO,UTA
7368,68,@,W 99-86 ,240,38,85,0.447,34,74,0.459,4,11,0.364,19,24,0.792,99,31,74,0.419,26,57,0.456,5,17,0.294,19,24,0.792,86,2012-12-15,MEM,UTA
7369,69,Home,L 99-113 ,240,36,70,0.514,29,54,0.537,7,16,0.438,20,30,0.667,99,39,75,0.52,27,51,0.529,12,24,0.5,23,27,0.852,113,2012-12-18,CLE,TOR
7370,70,Home,W 99-93 ,240,37,84,0.44,28,64,0.438,9,20,0.45,16,23,0.696,99,33,82,0.402,28,62,0.452,5,20,0.25,22,26,0.846,93,2012-12-20,MIN,OKC
7371,71,@,W 99-94 (OT),265,36,83,0.434,31,67,0.463,5,16,0.313,22,36,0.611,99,36,94,0.383,31,70,0.443,5,24,0.208,17,20,0.85,94,2012-12-21,MIL,BOS
7372,72,@,W 99-89 ,240,39,80,0.488,34,64,0.531,5,16,0.313,16,25,0.64,99,32,80,0.4,27,64,0.422,5,16,0.313,20,26,0.769,89,2012-12-21,IND,CLE
7373,73,Home,W 99-80 ,240,44,86,0.512,36,67,0.537,8,19,0.421,3,7,0.429,99,31,79,0.392,22,54,0.407,9,25,0.36,9,12,0.75,80,2012-12-21,PHI,ATL
7374,74,Home,W 99-94 ,240,39,76,0.513,35,58,0.603,4,18,0.222,17,23,0.739,99,39,86,0.453,37,70,0.529,2,16,0.125,14,16,0.875,94,2012-12-21,SAS,NOH
7375,75,@,W 99-89 ,240,37,71,0.521,28,55,0.509,9,16,0.563,16,23,0.696,99,35,90,0.389,30,75,0.4,5,15,0.333,14,17,0.824,89,2012-12-26,PHI,MEM
7376,76,@,W 99-97 ,240,40,88,0.455,31,66,0.47,9,22,0.409,10,14,0.714,99,38,83,0.458,30,62,0.484,8,21,0.381,13,16,0.813,97,2012-12-26,NYK,PHO
7377,77,@,L 99-109 ,240,39,77,0.506,30,48,0.625,9,29,0.31,12,16,0.75,99,43,74,0.581,31,55,0.564,12,19,0.632,11,17,0.647,109,2012-12-28,MIA,DET
7378,78,Home,L 99-103 ,240,37,94,0.394,34,72,0.472,3,22,0.136,22,33,0.667,99,41,86,0.477,33,64,0.516,8,22,0.364,13,20,0.65,103,2013-01-01,LAL,PHI
7379,79,@,W 99-96 (OT),265,39,86,0.453,31,65,0.477,8,21,0.381,13,16,0.813,99,39,85,0.459,32,66,0.485,7,19,0.368,11,13,0.846,96,2013-01-05,NOP,DAL
7380,80,Home,W 99-71 ,240,38,82,0.463,30,61,0.492,8,21,0.381,15,16,0.938,99,29,81,0.358,23,60,0.383,6,21,0.286,7,14,0.5,71,2013-01-06,MIA,WAS
7381,81,@,L 99-101 ,240,34,80,0.425,28,55,0.509,6,25,0.24,25,30,0.833,99,38,87,0.437,28,69,0.406,10,18,0.556,15,18,0.833,101,2013-01-07,OKC,WAS
7382,82,@,L 99-108 ,240,37,90,0.411,33,70,0.471,4,20,0.2,21,26,0.808,99,42,91,0.462,33,74,0.446,9,17,0.529,15,19,0.789,108,2013-01-08,PHO,MIL
7383,83,Home,W 99-83 ,240,37,81,0.457,25,58,0.431,12,23,0.522,13,20,0.65,99,37,84,0.44,30,62,0.484,7,22,0.318,2,5,0.4,83,2013-01-09,CLE,ATL
7384,84,Home,W 99-93 ,240,38,79,0.481,28,55,0.509,10,24,0.417,13,21,0.619,99,36,84,0.429,30,66,0.455,6,18,0.333,15,18,0.833,93,2013-01-09,LAC,DAL
7385,85,Home,W 99-79 ,240,34,75,0.453,28,62,0.452,6,13,0.462,25,32,0.781,99,31,79,0.392,24,65,0.369,7,14,0.5,10,16,0.625,79,2013-01-11,BRK,PHO
7386,86,Home,W 99-78 ,240,39,86,0.453,27,59,0.458,12,27,0.444,9,11,0.818,99,28,75,0.373,25,63,0.397,3,12,0.25,19,22,0.864,78,2013-01-11,TOR,CHA
7387,87,Home,L 99-128 ,240,38,87,0.437,29,69,0.42,9,18,0.5,14,19,0.737,99,45,80,0.563,28,43,0.651,17,37,0.459,21,24,0.875,128,2013-01-12,SAC,MIA
7388,88,@,W 99-73 ,240,35,76,0.461,30,62,0.484,5,14,0.357,24,32,0.75,99,27,89,0.303,21,69,0.304,6,20,0.3,13,17,0.765,73,2013-01-14,LAC,MEM
7389,89,Home,L 99-111 ,240,39,82,0.476,28,61,0.459,11,21,0.524,10,13,0.769,99,44,83,0.53,34,65,0.523,10,18,0.556,13,18,0.722,111,2013-01-15,PHI,NOH
7390,90,@,W 99-90 ,240,40,83,0.482,38,70,0.543,2,13,0.154,17,23,0.739,99,31,72,0.431,21,50,0.42,10,22,0.455,18,28,0.643,90,2013-01-17,MIA,LAL
7391,91,Home,L 99-100 (OT),265,38,91,0.418,35,77,0.455,3,14,0.214,20,28,0.714,99,36,75,0.48,31,60,0.517,5,15,0.333,23,32,0.719,100,2013-01-18,BOS,CHI
7392,92,@,L 99-106 ,240,38,83,0.458,27,53,0.509,11,30,0.367,12,22,0.545,99,39,75,0.52,27,53,0.509,12,22,0.545,16,18,0.889,106,2013-01-21,LAC,GSW
7393,93,@,L 99-104 ,240,36,78,0.462,31,62,0.5,5,16,0.313,22,27,0.815,99,37,84,0.44,31,61,0.508,6,23,0.261,24,27,0.889,104,2013-01-23,OKC,GSW
7394,94,@,L 99-108 ,240,41,81,0.506,35,69,0.507,6,12,0.5,11,14,0.786,99,41,83,0.494,34,59,0.576,7,24,0.292,19,23,0.826,108,2013-01-26,PHO,SAS
7395,95,@,W 99-98 ,240,37,78,0.474,31,67,0.463,6,11,0.545,19,22,0.864,99,40,82,0.488,35,65,0.538,5,17,0.294,13,18,0.722,98,2013-01-26,CLE,TOR
7396,96,Home,W 99-81 ,240,39,73,0.534,34,57,0.596,5,16,0.313,16,20,0.8,99,29,73,0.397,23,56,0.411,6,17,0.353,17,26,0.654,81,2013-01-30,BOS,SAC
7397,97,@,L 99-104 ,240,37,78,0.474,29,56,0.518,8,22,0.364,17,28,0.607,99,34,68,0.5,30,56,0.536,4,12,0.333,32,46,0.696,104,2013-01-30,NOP,UTA
7398,98,@,L 99-117 ,240,35,88,0.398,29,68,0.426,6,20,0.3,23,26,0.885,99,45,83,0.542,41,69,0.594,4,14,0.286,23,43,0.535,117,2013-02-01,CLE,DET
7399,99,Home,L 99-109 ,240,38,89,0.427,34,74,0.459,4,15,0.267,19,25,0.76,99,40,88,0.455,32,67,0.478,8,21,0.381,21,25,0.84,109,2013-02-01,PHO,DAL
7400,0,@,L 99-105 ,240,39,90,0.433,31,71,0.437,8,19,0.421,13,16,0.813,99,38,75,0.507,28,57,0.491,10,18,0.556,19,28,0.679,105,2013-02-02,UTA,POR
7401,1,Home,W 99-94 ,240,41,81,0.506,40,69,0.58,1,12,0.083,16,24,0.667,99,34,80,0.425,26,55,0.473,8,25,0.32,18,20,0.9,94,2013-02-04,MIA,CHA
7402,2,Home,W 99-85 ,240,36,79,0.456,22,45,0.489,14,34,0.412,13,16,0.813,99,38,90,0.422,35,77,0.455,3,13,0.231,6,12,0.5,85,2013-02-04,NYK,DET
7403,3,@,L 99-105 ,240,36,84,0.429,26,54,0.481,10,30,0.333,17,19,0.895,99,41,86,0.477,31,66,0.47,10,20,0.5,13,19,0.684,105,2013-02-06,POR,DAL
7404,4,@,W 99-95 ,240,35,73,0.479,31,54,0.574,4,19,0.211,25,30,0.833,99,34,82,0.415,30,64,0.469,4,18,0.222,23,26,0.885,95,2013-02-06,BOS,TOR
7405,5,Home,W 99-93 ,240,36,79,0.456,28,59,0.475,8,20,0.4,19,23,0.826,99,36,74,0.486,30,57,0.526,6,17,0.353,15,20,0.75,93,2013-02-08,MEM,GSW
7406,6,Home,W 99-63 ,240,41,87,0.471,36,75,0.48,5,12,0.417,12,18,0.667,99,24,74,0.324,22,57,0.386,2,17,0.118,13,13,1.0,63,2013-02-13,NOP,POR
7407,7,Home,L 99-105 ,240,36,89,0.404,25,64,0.391,11,25,0.44,16,21,0.762,99,40,81,0.494,32,64,0.5,8,17,0.471,17,23,0.739,105,2013-02-20,CHA,DET
7408,8,@,L 99-113 ,240,39,82,0.476,30,62,0.484,9,20,0.45,12,20,0.6,99,42,83,0.506,35,61,0.574,7,22,0.318,22,31,0.71,113,2013-02-20,BOS,LAL
7409,9,Home,L 99-113 ,240,37,82,0.451,35,71,0.493,2,11,0.182,23,30,0.767,99,44,83,0.53,37,64,0.578,7,19,0.368,18,22,0.818,113,2013-02-23,CHA,DEN
7410,10,Home,L 99-103 ,240,39,87,0.448,31,69,0.449,8,18,0.444,13,19,0.684,99,34,72,0.472,21,47,0.447,13,25,0.52,22,31,0.71,103,2013-02-24,DAL,LAL
7411,11,Home,L 99-100 ,240,37,85,0.435,36,74,0.486,1,11,0.091,24,31,0.774,99,37,81,0.457,30,64,0.469,7,17,0.412,19,23,0.826,100,2013-02-24,MIN,GSW
7412,12,Home,W 99-93 ,240,32,75,0.427,24,42,0.571,8,33,0.242,27,35,0.771,99,36,85,0.424,32,72,0.444,4,13,0.308,17,20,0.85,93,2013-02-24,NYK,PHI
7413,13,@,W 99-91 ,240,39,80,0.488,35,57,0.614,4,23,0.174,17,21,0.81,99,32,75,0.427,23,50,0.46,9,25,0.36,18,25,0.72,91,2013-02-28,LAC,IND
7414,14,Home,W 99-98 ,240,38,78,0.487,28,57,0.491,10,21,0.476,13,18,0.722,99,41,82,0.5,33,60,0.55,8,22,0.364,8,15,0.533,98,2013-03-03,LAL,ATL
7415,15,@,W 99-93 ,240,39,84,0.464,31,64,0.484,8,20,0.4,13,19,0.684,99,32,74,0.432,24,45,0.533,8,29,0.276,21,26,0.808,93,2013-03-03,MIA,NYK
7416,16,@,W 99-78 ,240,34,67,0.507,21,40,0.525,13,27,0.481,18,22,0.818,99,32,84,0.381,28,66,0.424,4,18,0.222,10,15,0.667,78,2013-03-06,BRK,CHA
7417,17,Home,L 99-102 ,240,39,96,0.406,30,66,0.455,9,30,0.3,12,19,0.632,99,41,78,0.526,30,56,0.536,11,22,0.5,9,15,0.6,102,2013-03-08,DET,DAL
7418,18,Home,W 99-91 ,240,41,83,0.494,29,56,0.518,12,27,0.444,5,7,0.714,99,40,86,0.465,35,74,0.473,5,12,0.417,6,10,0.6,91,2013-03-10,ORL,PHI
7419,19,@,W 99-93 ,240,33,78,0.423,20,52,0.385,13,26,0.5,20,30,0.667,99,37,99,0.374,25,72,0.347,12,27,0.444,7,9,0.778,93,2013-03-15,LAL,IND
7420,20,Home,W 99-76 ,240,42,87,0.483,34,67,0.507,8,20,0.4,7,15,0.467,99,29,87,0.333,24,65,0.369,5,22,0.227,13,16,0.813,76,2013-03-18,PHO,LAL
7421,21,@,W 99-89 ,240,41,84,0.488,31,63,0.492,10,21,0.476,7,10,0.7,99,39,89,0.438,35,75,0.467,4,14,0.286,7,11,0.636,89,2013-03-21,POR,CHI
7422,22,@,W 99-94 ,240,38,71,0.535,28,49,0.571,10,22,0.455,13,24,0.542,99,36,79,0.456,25,47,0.532,11,32,0.344,11,14,0.786,94,2013-03-22,NYK,TOR
7423,23,Home,L 99-104 ,240,42,92,0.457,37,71,0.521,5,21,0.238,10,18,0.556,99,39,78,0.5,29,52,0.558,10,26,0.385,16,21,0.762,104,2013-03-24,MIL,ATL
7424,24,@,L 99-100 ,240,42,88,0.477,42,78,0.538,0,10,0.0,15,17,0.882,99,35,76,0.461,25,61,0.41,10,15,0.667,20,27,0.741,100,2013-03-27,DEN,SAS
7425,25,@,W 99-82 ,240,44,82,0.537,40,69,0.58,4,13,0.308,7,9,0.778,99,31,76,0.408,26,58,0.448,5,18,0.278,15,23,0.652,82,2013-03-29,TOR,DET
7426,26,Home,L 99-109 ,240,37,98,0.378,25,69,0.362,12,29,0.414,13,15,0.867,99,40,75,0.533,36,59,0.61,4,16,0.25,25,32,0.781,109,2013-03-30,MIL,OKC
7427,27,@,W 99-86 ,240,37,73,0.507,31,63,0.492,6,10,0.6,19,27,0.704,99,29,67,0.433,24,51,0.471,5,16,0.313,23,34,0.676,86,2013-03-30,MEM,MIN
7428,28,Home,W 99-97 ,240,36,80,0.45,33,65,0.508,3,15,0.2,24,29,0.828,99,35,83,0.422,30,71,0.423,5,12,0.417,22,25,0.88,97,2013-04-06,SAS,ATL
7429,29,Home,W 99-85 ,240,39,73,0.534,30,55,0.545,9,18,0.5,12,17,0.706,99,33,73,0.452,30,58,0.517,3,15,0.2,16,25,0.64,85,2013-04-07,DET,CHI
7430,30,Home,W 99-94 ,240,32,79,0.405,28,63,0.444,4,16,0.25,31,46,0.674,99,39,85,0.459,36,75,0.48,3,10,0.3,13,15,0.867,94,2013-04-09,IND,CLE
7431,31,@,L 99-120 ,240,35,77,0.455,27,57,0.474,8,20,0.4,21,30,0.7,99,45,80,0.563,25,44,0.568,20,36,0.556,10,14,0.714,120,2013-04-09,WAS,NYK
7432,32,@,L 99-103 ,240,37,78,0.474,36,65,0.554,1,13,0.077,24,32,0.75,99,39,81,0.481,31,57,0.544,8,24,0.333,17,23,0.739,103,2013-04-17,DET,BRK
7433,33,Home,W 99-87 ,240,42,82,0.512,36,66,0.545,6,16,0.375,9,11,0.818,99,31,84,0.369,27,73,0.37,4,11,0.364,21,28,0.75,87,2013-04-17,DAL,NOH
7434,34,Home,W 99-95 (OT),265,33,90,0.367,23,58,0.397,10,32,0.313,23,34,0.676,99,35,84,0.417,27,51,0.529,8,33,0.242,17,24,0.708,95,2013-04-17,LAL,HOU
7435,35,@,W 99-88 ,240,40,93,0.43,31,72,0.431,9,21,0.429,10,13,0.769,99,35,82,0.427,29,70,0.414,6,12,0.5,12,14,0.857,88,2013-04-17,GSW,POR
7436,36,@,L 99-111 ,240,37,87,0.425,34,71,0.479,3,16,0.188,22,26,0.846,99,32,80,0.4,25,61,0.41,7,19,0.368,40,46,0.87,111,2013-11-02,MEM,DAL
7437,37,@,W 99-91 ,240,38,73,0.521,29,52,0.558,9,21,0.429,14,23,0.609,99,33,87,0.379,28,62,0.452,5,25,0.2,20,25,0.8,91,2013-11-05,IND,DET
7438,38,@,W 99-84 ,240,38,78,0.487,34,65,0.523,4,13,0.308,19,21,0.905,99,34,71,0.479,30,56,0.536,4,15,0.267,12,14,0.857,84,2013-11-06,NOP,MEM
7439,39,Home,W 99-96 ,240,41,85,0.482,35,69,0.507,6,16,0.375,11,15,0.733,99,42,85,0.494,35,66,0.53,7,19,0.368,5,9,0.556,96,2013-11-06,SAS,PHO
7440,40,@,W 99-98 ,240,36,92,0.391,20,57,0.351,16,35,0.457,11,15,0.733,99,29,77,0.377,22,50,0.44,7,27,0.259,33,52,0.635,98,2013-11-07,LAL,HOU
7441,41,@,L 99-111 ,240,37,94,0.394,29,73,0.397,8,21,0.381,17,26,0.654,99,40,100,0.4,34,79,0.43,6,21,0.286,25,37,0.676,111,2013-11-13,LAL,DEN
7442,42,@,L 99-114 ,240,42,87,0.483,34,64,0.531,8,23,0.348,7,17,0.412,99,47,90,0.522,37,65,0.569,10,25,0.4,10,10,1.0,114,2013-11-17,DET,LAL
7443,43,@,L 99-101 ,240,34,73,0.466,24,50,0.48,10,23,0.435,21,29,0.724,99,37,78,0.474,31,53,0.585,6,25,0.24,21,26,0.808,101,2013-11-23,ORL,MIA
7444,44,@,W 99-94 ,240,34,85,0.4,21,55,0.382,13,30,0.433,18,22,0.818,99,31,83,0.373,20,53,0.377,11,30,0.367,21,26,0.808,94,2013-11-27,LAL,BRK
7445,45,@,W 99-74 ,240,32,84,0.381,22,59,0.373,10,25,0.4,25,32,0.781,99,26,83,0.313,23,74,0.311,3,9,0.333,19,28,0.679,74,2013-11-27,IND,CHA
7446,46,@,L 99-103 ,240,32,76,0.421,23,53,0.434,9,23,0.391,26,34,0.765,99,44,99,0.444,37,81,0.457,7,18,0.389,8,10,0.8,103,2013-11-27,GSW,DAL
7447,47,@,W 99-79 ,240,42,79,0.532,36,62,0.581,6,17,0.353,9,12,0.75,99,34,77,0.442,32,65,0.492,2,12,0.167,9,19,0.474,79,2013-11-27,CHI,DET
7448,48,Home,W 99-98 ,240,36,69,0.522,28,51,0.549,8,18,0.444,19,25,0.76,99,35,76,0.461,31,61,0.508,4,15,0.267,24,28,0.857,98,2013-12-01,MIA,CHA
7449,49,Home,L 99-103 ,240,34,76,0.447,21,41,0.512,13,35,0.371,18,21,0.857,99,38,77,0.494,28,56,0.5,10,21,0.476,17,23,0.739,103,2013-12-01,NYK,NOP
7450,50,@,L 99-106 ,240,39,74,0.527,30,54,0.556,9,20,0.45,12,14,0.857,99,37,96,0.385,30,76,0.395,7,20,0.35,25,29,0.862,106,2013-12-11,PHI,MIN
7451,51,@,L 99-101 (OT),265,42,100,0.42,38,86,0.442,4,14,0.286,11,18,0.611,99,38,89,0.427,31,68,0.456,7,21,0.333,18,24,0.75,101,2013-12-13,WAS,ATL
7452,52,@,L 99-103 ,240,36,79,0.456,24,56,0.429,12,23,0.522,15,20,0.75,99,39,83,0.47,36,73,0.493,3,10,0.3,22,31,0.71,103,2013-12-13,BRK,DET
7453,53,Home,W 99-94 ,240,36,76,0.474,28,55,0.509,8,21,0.381,19,25,0.76,99,39,83,0.47,35,71,0.493,4,12,0.333,12,17,0.706,94,2013-12-13,IND,CHA
7454,54,@,W 99-77 ,240,40,83,0.482,35,68,0.515,5,15,0.333,14,18,0.778,99,31,86,0.36,25,68,0.368,6,18,0.333,9,12,0.75,77,2013-12-14,TOR,CHI
7455,55,Home,L 99-103 ,240,35,85,0.412,31,68,0.456,4,17,0.235,25,29,0.862,99,35,88,0.398,23,54,0.426,12,34,0.353,21,31,0.677,103,2013-12-20,DEN,PHO
7456,56,Home,L 99-106 ,240,42,87,0.483,38,67,0.567,4,20,0.2,11,18,0.611,99,41,87,0.471,33,66,0.5,8,21,0.381,16,22,0.727,106,2013-12-21,BOS,WAS
7457,57,@,L 99-112 ,240,37,81,0.457,30,60,0.5,7,21,0.333,18,25,0.72,99,41,91,0.451,32,68,0.471,9,23,0.391,21,27,0.778,112,2013-12-23,TOR,SAS
7458,58,@,L 99-120 ,240,33,70,0.471,23,48,0.479,10,22,0.455,23,28,0.821,99,47,91,0.516,39,72,0.542,8,19,0.421,18,25,0.72,120,2013-12-28,DEN,MEM
7459,59,Home,L 99-106 ,240,36,82,0.439,30,62,0.484,6,20,0.3,21,35,0.6,99,39,78,0.5,32,59,0.542,7,19,0.368,21,27,0.778,106,2013-12-30,DET,WAS
7460,60,@,W 99-91 ,240,44,92,0.478,41,78,0.526,3,14,0.214,8,14,0.571,99,37,90,0.411,29,60,0.483,8,30,0.267,9,16,0.563,91,2014-01-02,MEM,PHO
7461,61,@,L 99-110 ,240,38,86,0.442,30,60,0.5,8,26,0.308,15,23,0.652,99,42,81,0.519,32,57,0.561,10,24,0.417,16,21,0.762,110,2014-01-03,UTA,LAL
7462,62,Home,W 99-82 ,240,39,83,0.47,32,61,0.525,7,22,0.318,14,19,0.737,99,31,68,0.456,28,59,0.475,3,9,0.333,17,26,0.654,82,2014-01-04,IND,NOP
7463,63,Home,L 99-101 ,240,36,99,0.364,33,77,0.429,3,22,0.136,24,30,0.8,99,40,88,0.455,36,74,0.486,4,14,0.286,17,24,0.708,101,2014-01-04,POR,PHI
7464,64,@,L 99-113 ,240,36,88,0.409,29,64,0.453,7,24,0.292,20,25,0.8,99,39,86,0.453,32,58,0.552,7,28,0.25,28,50,0.56,113,2014-01-08,LAL,HOU
7465,65,Home,W 99-97 ,240,38,92,0.413,30,66,0.455,8,26,0.308,15,21,0.714,99,38,85,0.447,31,66,0.47,7,19,0.368,14,16,0.875,97,2014-01-10,GSW,BOS
7466,66,@,L 99-104 ,240,38,92,0.413,27,62,0.435,11,30,0.367,12,16,0.75,99,42,86,0.488,36,71,0.507,6,15,0.4,14,23,0.609,104,2014-01-10,PHO,MEM
7467,67,@,L 99-107 ,240,37,88,0.42,33,70,0.471,4,18,0.222,21,31,0.677,99,37,84,0.44,32,66,0.485,5,18,0.278,28,35,0.8,107,2014-01-20,PHI,WAS
7468,68,Home,W 99-81 ,240,41,88,0.466,34,69,0.493,7,19,0.368,10,14,0.714,99,30,81,0.37,21,49,0.429,9,32,0.281,12,17,0.706,81,2014-01-25,MEM,HOU
7469,69,@,W 99-90 ,240,34,82,0.415,25,55,0.455,9,27,0.333,22,28,0.786,99,34,86,0.395,29,70,0.414,5,16,0.313,17,24,0.708,90,2014-01-26,PHO,CLE
7470,70,@,L 99-106 ,240,37,90,0.411,32,68,0.471,5,22,0.227,20,26,0.769,99,32,80,0.4,25,60,0.417,7,20,0.35,35,53,0.66,106,2014-01-27,SAC,UTA
7471,71,@,W 99-89 ,240,41,75,0.547,37,61,0.607,4,14,0.286,13,16,0.813,99,38,79,0.481,33,58,0.569,5,21,0.238,8,8,1.0,89,2014-01-29,MEM,SAC
7472,72,Home,L 99-125 ,240,32,87,0.368,26,65,0.4,6,22,0.273,29,37,0.784,99,45,89,0.506,37,73,0.507,8,16,0.5,27,34,0.794,125,2014-01-31,PHI,ATL
7473,73,Home,W 99-90 ,240,38,79,0.481,32,69,0.464,6,10,0.6,17,22,0.773,99,30,76,0.395,21,53,0.396,9,23,0.391,21,25,0.84,90,2014-02-01,MEM,MIL
7474,74,Home,W 99-70 ,240,36,69,0.522,34,61,0.557,2,8,0.25,25,34,0.735,99,22,78,0.282,18,58,0.31,4,20,0.2,22,34,0.647,70,2014-02-03,SAC,CHI
7475,75,@,L 99-109 ,240,33,79,0.418,23,58,0.397,10,21,0.476,23,26,0.885,99,37,83,0.446,29,66,0.439,8,17,0.471,27,38,0.711,109,2014-02-04,LAL,MIN
7476,76,Home,W 99-89 ,240,40,88,0.455,31,66,0.47,9,22,0.409,10,15,0.667,99,31,87,0.356,26,72,0.361,5,15,0.333,22,24,0.917,89,2014-02-07,BOS,SAC
7477,77,@,L 99-109 ,240,34,74,0.459,26,48,0.542,8,26,0.308,23,33,0.697,99,41,86,0.477,29,65,0.446,12,21,0.571,15,23,0.652,109,2014-02-11,SAC,CLE
7478,78,Home,L 99-105 ,240,37,82,0.451,28,58,0.483,9,24,0.375,16,17,0.941,99,41,82,0.5,32,59,0.542,9,23,0.391,14,20,0.7,105,2014-02-19,UTA,BRK
7479,79,@,L 99-102 (OT),265,37,101,0.366,28,71,0.394,9,30,0.3,16,25,0.64,99,37,93,0.398,28,66,0.424,9,27,0.333,19,24,0.792,102,2014-02-20,HOU,GSW
7480,80,@,W 99-93 ,240,35,79,0.443,25,47,0.532,10,32,0.313,19,24,0.792,99,34,84,0.405,29,67,0.433,5,17,0.294,20,24,0.833,93,2014-02-25,TOR,CLE
7481,81,Home,W 99-79 ,240,43,88,0.489,39,73,0.534,4,15,0.267,9,12,0.75,99,28,80,0.35,14,51,0.275,14,29,0.483,9,14,0.643,79,2014-02-28,CLE,UTA
7482,82,@,L 99-116 ,240,30,68,0.441,22,46,0.478,8,22,0.364,31,40,0.775,99,41,82,0.5,33,60,0.55,8,22,0.364,26,30,0.867,116,2014-03-02,CHA,OKC
7483,83,Home,W 99-87 ,240,34,73,0.466,24,52,0.462,10,21,0.476,21,28,0.75,99,30,72,0.417,25,53,0.472,5,19,0.263,22,37,0.595,87,2014-03-07,TOR,SAC
7484,84,Home,W 99-90 ,240,40,80,0.5,30,59,0.508,10,21,0.476,9,9,1.0,99,36,89,0.404,24,58,0.414,12,31,0.387,6,9,0.667,90,2014-03-10,MIA,WAS
7485,85,Home,W 99-89 ,240,38,87,0.437,31,69,0.449,7,18,0.389,16,19,0.842,99,34,84,0.405,31,69,0.449,3,15,0.2,18,30,0.6,89,2014-03-11,DET,SAC
7486,86,@,L 99-109 ,240,35,86,0.407,28,69,0.406,7,17,0.412,22,29,0.759,99,47,84,0.56,41,72,0.569,6,12,0.5,9,13,0.692,109,2014-03-11,POR,MEM
7487,87,Home,W 99-86 ,240,36,71,0.507,27,54,0.5,9,17,0.529,18,22,0.818,99,33,74,0.446,31,66,0.47,2,8,0.25,18,27,0.667,86,2014-03-14,TOR,MEM
7488,88,Home,W 99-90 ,240,31,81,0.383,25,63,0.397,6,18,0.333,31,38,0.816,99,35,81,0.432,26,58,0.448,9,23,0.391,11,20,0.55,90,2014-03-17,IND,PHI
7489,89,@,L 99-104 ,240,40,85,0.471,31,58,0.534,9,27,0.333,10,12,0.833,99,37,75,0.493,28,55,0.509,9,20,0.45,21,35,0.6,104,2014-03-19,CHA,BRK
7490,90,@,W 99-79 ,240,36,93,0.387,31,68,0.456,5,25,0.2,22,27,0.815,99,32,80,0.4,28,66,0.424,4,14,0.286,11,18,0.611,79,2014-03-21,SAS,SAC
7491,91,@,W 99-90 ,240,35,89,0.393,25,61,0.41,10,28,0.357,19,25,0.76,99,31,77,0.403,28,62,0.452,3,15,0.2,25,29,0.862,90,2014-03-22,SAS,GSW
7492,92,@,W 99-90 ,240,36,80,0.45,25,57,0.439,11,23,0.478,16,18,0.889,99,32,79,0.405,23,57,0.404,9,22,0.409,17,22,0.773,90,2014-03-26,TOR,BOS
7493,93,Home,L 99-107 ,240,33,69,0.478,27,52,0.519,6,17,0.353,27,35,0.771,99,40,73,0.548,25,47,0.532,15,26,0.577,12,13,0.923,107,2014-03-26,SAC,NYK
7494,94,@,W 99-93 ,240,37,75,0.493,23,47,0.489,14,28,0.5,11,12,0.917,99,37,81,0.457,31,62,0.5,6,19,0.316,13,21,0.619,93,2014-03-26,PHO,WAS
7495,95,@,L 99-114 ,240,39,83,0.47,36,71,0.507,3,12,0.25,18,27,0.667,99,43,86,0.5,31,53,0.585,12,33,0.364,16,22,0.727,114,2014-03-30,MIN,BRK
7496,96,@,L 99-115 ,240,35,91,0.385,27,55,0.491,8,36,0.222,21,28,0.75,99,44,83,0.53,39,65,0.6,5,18,0.278,22,24,0.917,115,2014-03-30,PHO,LAL
7497,97,@,L 99-100 ,240,39,91,0.429,34,80,0.425,5,11,0.455,16,22,0.727,99,38,75,0.507,31,52,0.596,7,23,0.304,17,22,0.773,100,2014-04-09,SAC,POR
7498,98,Home,L 99-100 ,240,40,88,0.455,34,65,0.523,6,23,0.261,13,15,0.867,99,39,104,0.375,29,70,0.414,10,34,0.294,12,19,0.632,100,2014-04-10,GSW,DEN
7499,99,Home,L 99-111 ,240,40,86,0.465,34,73,0.466,6,13,0.462,13,16,0.813,99,40,87,0.46,29,65,0.446,11,22,0.5,20,24,0.833,111,2014-04-11,UTA,POR
7500,0,Home,L 99-111 ,240,37,90,0.411,32,72,0.444,5,18,0.278,20,30,0.667,99,42,90,0.467,30,60,0.5,12,30,0.4,15,18,0.833,111,2014-04-12,CLE,BOS
7501,1,Home,L 99-104 ,240,37,86,0.43,33,67,0.493,4,19,0.211,21,30,0.7,99,40,86,0.465,32,66,0.485,8,20,0.4,16,22,0.727,104,2014-04-16,SAC,PHO
7502,2,@,L 99-119 ,240,37,86,0.43,33,73,0.452,4,13,0.308,21,25,0.84,99,45,82,0.549,29,50,0.58,16,32,0.5,13,18,0.722,119,2014-10-29,LAL,PHO
7503,3,@,L 99-110 ,240,37,90,0.411,29,71,0.408,8,19,0.421,17,21,0.81,99,38,74,0.514,24,50,0.48,14,24,0.583,20,26,0.769,110,2014-11-07,NYK,BRK
7504,4,Home,L 99-100 ,240,36,80,0.45,31,62,0.5,5,18,0.278,22,29,0.759,99,40,85,0.471,32,64,0.5,8,21,0.381,12,14,0.857,100,2014-11-08,SAS,NOP
7505,5,@,L 99-107 ,240,39,89,0.438,36,73,0.493,3,16,0.188,18,20,0.9,99,41,90,0.456,30,56,0.536,11,34,0.324,14,21,0.667,107,2014-11-13,BRK,GSW
7506,6,@,W 99-90 ,240,37,77,0.481,30,59,0.508,7,18,0.389,18,25,0.72,99,35,83,0.422,31,66,0.47,4,17,0.235,16,23,0.696,90,2014-11-15,IND,CHI
7507,7,@,L 99-115 ,240,34,69,0.493,25,53,0.472,9,16,0.563,22,28,0.786,99,44,89,0.494,33,67,0.493,11,22,0.5,16,22,0.727,115,2014-11-19,NYK,MIN
7508,8,Home,W 99-89 ,240,38,80,0.475,33,56,0.589,5,24,0.208,18,26,0.692,99,31,83,0.373,27,62,0.435,4,21,0.19,23,24,0.958,89,2014-11-21,ATL,DET
7509,9,@,W 99-92 ,240,37,71,0.521,25,45,0.556,12,26,0.462,13,18,0.722,99,35,78,0.449,32,62,0.516,3,16,0.188,19,27,0.704,92,2014-11-22,MIA,ORL
7510,10,Home,W 99-87 ,240,41,79,0.519,33,58,0.569,8,21,0.381,9,11,0.818,99,34,91,0.374,25,64,0.391,9,27,0.333,10,10,1.0,87,2014-11-22,SAS,BRK
7511,11,@,W 99-89 ,240,37,77,0.481,32,63,0.508,5,14,0.357,20,24,0.833,99,33,79,0.418,30,62,0.484,3,17,0.176,20,29,0.69,89,2014-11-25,SAC,NOP
7512,12,@,W 99-93 ,240,36,80,0.45,31,58,0.534,5,22,0.227,22,25,0.88,99,33,81,0.407,25,62,0.403,8,19,0.421,19,24,0.792,93,2014-11-26,MEM,LAL
7513,13,@,W 99-91 ,240,35,71,0.493,27,47,0.574,8,24,0.333,21,28,0.75,99,34,85,0.4,25,61,0.41,9,24,0.375,14,17,0.824,91,2014-11-26,BRK,PHI
7514,14,Home,L 99-112 ,240,39,97,0.402,31,69,0.449,8,28,0.286,13,18,0.722,99,45,84,0.536,39,71,0.549,6,13,0.462,16,26,0.615,112,2014-11-28,POR,MEM
7515,15,@,L 99-116 ,240,41,85,0.482,37,72,0.514,4,13,0.308,13,17,0.765,99,43,86,0.5,31,61,0.508,12,25,0.48,18,26,0.692,116,2014-12-02,IND,PHO
7516,16,Home,L 99-103 ,240,41,79,0.519,36,60,0.6,5,19,0.263,12,14,0.857,99,36,85,0.424,26,57,0.456,10,28,0.357,21,29,0.724,103,2014-12-07,NYK,POR
7517,17,@,L 99-100 ,240,35,84,0.417,27,57,0.474,8,27,0.296,21,24,0.875,99,37,74,0.5,27,53,0.509,10,21,0.476,16,21,0.762,100,2014-12-13,ATL,ORL
7518,18,@,W 99-91 ,240,34,74,0.459,29,58,0.5,5,16,0.313,26,35,0.743,99,34,83,0.41,26,67,0.388,8,16,0.5,15,21,0.714,91,2014-12-14,SAS,DEN
7519,19,@,W 99-90 ,240,38,82,0.463,33,64,0.516,5,18,0.278,18,22,0.818,99,33,86,0.384,27,61,0.443,6,25,0.24,18,23,0.783,90,2014-12-18,NOP,HOU
7520,20,Home,W 99-93 ,240,37,86,0.43,28,60,0.467,9,26,0.346,16,20,0.8,99,32,77,0.416,29,64,0.453,3,13,0.231,26,26,1.0,93,2014-12-20,DAL,SAS
7521,21,@,W 99-90 ,240,35,78,0.449,25,53,0.472,10,25,0.4,19,23,0.826,99,35,88,0.398,28,66,0.424,7,22,0.318,13,16,0.813,90,2014-12-20,PHO,NYK
7522,22,Home,L 99-101 ,240,38,83,0.458,33,63,0.524,5,20,0.25,18,24,0.75,99,43,90,0.478,36,70,0.514,7,20,0.35,8,10,0.8,101,2014-12-21,OKC,NOP
7523,23,@,W 99-91 ,240,39,85,0.459,34,68,0.5,5,17,0.294,16,24,0.667,99,38,89,0.427,33,80,0.413,5,9,0.556,10,16,0.625,91,2014-12-23,CHI,WAS
7524,24,@,L 99-107 ,240,37,76,0.487,28,56,0.5,9,20,0.45,16,20,0.8,99,36,80,0.45,28,59,0.475,8,21,0.381,27,39,0.692,107,2014-12-29,SAC,BRK
7525,25,Home,W 99-78 ,240,36,82,0.439,21,48,0.438,15,34,0.441,12,20,0.6,99,32,84,0.381,28,67,0.418,4,17,0.235,10,15,0.667,78,2014-12-31,LAC,NYK
7526,26,Home,W 99-83 ,240,40,95,0.421,32,68,0.471,8,27,0.296,11,15,0.733,99,29,77,0.377,26,63,0.413,3,14,0.214,22,30,0.733,83,2015-01-08,POR,MIA
7527,27,Home,W 99-94 ,240,42,91,0.462,35,70,0.5,7,21,0.333,8,9,0.889,99,36,74,0.486,29,53,0.547,7,21,0.333,15,22,0.682,94,2015-01-09,OKC,UTA
7528,28,Home,L 99-113 ,240,39,84,0.464,34,63,0.54,5,21,0.238,16,18,0.889,99,41,86,0.477,25,46,0.543,16,40,0.4,15,20,0.75,113,2015-01-12,BRK,HOU
7529,29,Home,L 99-105 ,240,34,79,0.43,21,52,0.404,13,27,0.481,18,24,0.75,99,40,78,0.513,35,63,0.556,5,15,0.333,20,25,0.8,105,2015-01-14,CHI,WAS
7530,30,@,L 99-110 ,240,42,91,0.462,34,69,0.493,8,22,0.364,7,12,0.583,99,48,87,0.552,43,72,0.597,5,15,0.333,9,11,0.818,110,2015-01-16,MIN,PHO
7531,31,@,W 99-90 ,240,40,77,0.519,35,61,0.574,5,16,0.313,14,27,0.519,99,36,82,0.439,32,65,0.492,4,17,0.235,14,18,0.778,90,2015-01-17,WAS,BRK
7532,32,Home,L 99-107 ,240,37,80,0.463,28,54,0.519,9,26,0.346,16,20,0.8,99,40,84,0.476,29,58,0.5,11,26,0.423,16,21,0.762,107,2015-01-17,CHI,ATL
7533,33,Home,L 99-127 ,240,35,88,0.398,27,65,0.415,8,23,0.348,21,27,0.778,99,48,83,0.578,39,58,0.672,9,25,0.36,22,32,0.688,127,2015-01-18,ORL,OKC
7534,34,Home,W 99-92 ,240,38,78,0.487,28,55,0.509,10,23,0.435,13,17,0.765,99,35,84,0.417,27,57,0.474,8,27,0.296,14,20,0.7,92,2015-01-19,NYK,NOP
7535,35,Home,L 99-109 ,240,37,79,0.468,32,65,0.492,5,14,0.357,20,29,0.69,99,38,84,0.452,27,57,0.474,11,27,0.407,22,27,0.815,109,2015-01-20,DEN,SAS
7536,36,Home,L 99-101 ,240,42,92,0.457,37,79,0.468,5,13,0.385,10,12,0.833,99,32,71,0.451,18,40,0.45,14,31,0.452,23,28,0.821,101,2015-01-22,MIL,UTA
7537,37,Home,L 99-100 ,240,37,89,0.416,31,68,0.456,6,21,0.286,19,26,0.731,99,37,75,0.493,28,54,0.519,9,21,0.429,17,27,0.63,100,2015-01-23,DEN,BOS
7538,38,Home,W 99-85 ,240,36,84,0.429,29,60,0.483,7,24,0.292,20,27,0.741,99,33,83,0.398,28,70,0.4,5,13,0.385,14,20,0.7,85,2015-01-23,SAS,LAL
7539,39,@,W 99-87 ,240,35,87,0.402,22,43,0.512,13,44,0.295,16,21,0.762,99,34,79,0.43,33,66,0.5,1,13,0.077,18,25,0.72,87,2015-01-25,HOU,LAL
7540,40,Home,L 99-106 ,240,38,78,0.487,32,61,0.525,6,17,0.353,17,23,0.739,99,43,83,0.518,35,63,0.556,8,20,0.4,12,18,0.667,106,2015-01-25,ORL,IND
7541,41,Home,W 99-74 ,240,39,86,0.453,32,70,0.457,7,16,0.438,14,19,0.737,99,28,81,0.346,26,66,0.394,2,15,0.133,16,21,0.762,74,2015-01-26,NOP,PHI
7542,42,@,W 99-90 ,240,35,74,0.473,27,55,0.491,8,19,0.421,21,23,0.913,99,35,82,0.427,26,58,0.448,9,24,0.375,11,19,0.579,90,2015-01-26,BOS,UTA
7543,43,Home,W 99-94 ,240,34,85,0.4,19,48,0.396,15,37,0.405,16,18,0.889,99,35,80,0.438,25,49,0.51,10,31,0.323,14,17,0.824,94,2015-01-28,CLE,POR
7544,44,Home,W 99-94 ,240,36,88,0.409,22,53,0.415,14,35,0.4,13,15,0.867,99,35,82,0.427,25,57,0.439,10,25,0.4,14,16,0.875,94,2015-01-28,HOU,DAL
7545,45,Home,W 99-69 ,240,39,88,0.443,36,72,0.5,3,16,0.188,18,27,0.667,99,29,87,0.333,27,61,0.443,2,26,0.077,9,10,0.9,69,2015-01-29,MEM,DEN
7546,46,@,L 99-105 ,240,39,87,0.448,28,57,0.491,11,30,0.367,10,11,0.909,99,40,84,0.476,29,61,0.475,11,23,0.478,14,22,0.636,105,2015-01-30,POR,ATL
7547,47,Home,W 99-93 ,240,39,90,0.433,33,68,0.485,6,22,0.273,15,17,0.882,99,36,87,0.414,32,69,0.464,4,18,0.222,17,27,0.63,93,2015-01-30,PHO,CHI
7548,48,@,W 99-94 ,240,34,80,0.425,29,65,0.446,5,15,0.333,26,29,0.897,99,33,80,0.413,28,55,0.509,5,25,0.2,23,25,0.92,94,2015-01-31,SAC,IND
7549,49,@,L 99-103 ,240,40,89,0.449,29,54,0.537,11,35,0.314,8,12,0.667,99,37,79,0.468,29,58,0.5,8,21,0.381,21,26,0.808,103,2015-02-06,CLE,IND
7550,50,@,L 99-110 ,240,39,81,0.481,33,62,0.532,6,19,0.316,15,20,0.75,99,41,84,0.488,24,51,0.471,17,33,0.515,11,18,0.611,110,2015-02-20,SAS,GSW
7551,51,@,L 99-126 ,240,30,88,0.341,26,72,0.361,4,16,0.25,35,46,0.761,99,46,95,0.484,32,60,0.533,14,35,0.4,20,28,0.714,126,2015-02-21,SAC,LAC
7552,52,Home,W 99-92 ,240,38,79,0.481,30,60,0.5,8,19,0.421,15,18,0.833,99,38,84,0.452,29,58,0.5,9,26,0.346,7,11,0.636,92,2015-02-24,DAL,TOR
7553,53,@,L 99-110 ,240,39,92,0.424,28,63,0.444,11,29,0.379,10,19,0.526,99,36,77,0.468,27,49,0.551,9,28,0.321,29,35,0.829,110,2015-02-26,GSW,CLE
7554,54,Home,W 99-95 ,240,37,78,0.474,30,58,0.517,7,20,0.35,18,25,0.72,99,38,79,0.481,30,53,0.566,8,26,0.308,11,21,0.524,95,2015-02-28,WAS,DET
7555,55,@,W 99-92 ,240,36,74,0.486,31,52,0.596,5,22,0.227,22,30,0.733,99,37,92,0.402,28,59,0.475,9,33,0.273,9,17,0.529,92,2015-03-01,NOP,DEN
7556,56,Home,L 99-110 ,240,39,86,0.453,36,74,0.486,3,12,0.25,18,23,0.783,99,41,83,0.494,31,59,0.525,10,24,0.417,18,20,0.9,110,2015-03-01,SAC,POR
7557,57,Home,W 99-97 ,240,38,82,0.463,31,59,0.525,7,23,0.304,16,18,0.889,99,37,79,0.468,27,52,0.519,10,27,0.37,13,19,0.684,97,2015-03-06,WAS,MIA
7558,58,@,L 99-129 ,240,41,82,0.5,29,50,0.58,12,32,0.375,5,12,0.417,99,51,84,0.607,35,56,0.625,16,28,0.571,11,16,0.688,129,2015-03-13,LAC,DAL
7559,59,@,L 99-113 ,240,34,78,0.436,31,66,0.47,3,12,0.25,28,31,0.903,99,44,101,0.436,33,77,0.429,11,24,0.458,14,14,1.0,113,2015-03-13,MIN,OKC
7560,60,@,L 99-118 ,240,41,91,0.451,34,66,0.515,7,25,0.28,10,12,0.833,99,46,80,0.575,35,59,0.593,11,21,0.524,15,17,0.882,118,2015-03-13,DET,POR
7561,61,Home,W 99-92 ,240,35,77,0.455,26,53,0.491,9,24,0.375,20,28,0.714,99,32,79,0.405,27,65,0.415,5,14,0.357,23,29,0.793,92,2015-03-17,LAC,CHO
7562,62,@,L 99-113 ,240,37,86,0.43,31,67,0.463,6,19,0.316,19,23,0.826,99,45,86,0.523,33,63,0.524,12,23,0.522,11,17,0.647,113,2015-03-20,WAS,LAC
7563,63,@,W 99-85 ,240,35,84,0.417,21,50,0.42,14,34,0.412,15,22,0.682,99,29,84,0.345,21,55,0.382,8,29,0.276,19,27,0.704,85,2015-03-25,PHI,DEN
7564,64,Home,L 99-101 (OT),265,33,78,0.423,27,56,0.482,6,22,0.273,27,30,0.9,99,39,92,0.424,33,66,0.5,6,26,0.231,17,18,0.944,101,2015-03-25,MIN,LAL
7565,65,Home,L 99-108 ,240,38,87,0.437,32,62,0.516,6,25,0.24,17,26,0.654,99,40,81,0.494,32,60,0.533,8,21,0.381,20,23,0.87,108,2015-03-25,PHO,SAC
7566,66,Home,W 99-86 ,240,37,72,0.514,31,54,0.574,6,18,0.333,19,24,0.792,99,32,82,0.39,21,47,0.447,11,35,0.314,11,15,0.733,86,2015-03-27,ATL,MIA
7567,67,@,L 99-107 ,240,42,91,0.462,36,73,0.493,6,18,0.333,9,11,0.818,99,42,87,0.483,34,59,0.576,8,28,0.286,15,21,0.714,107,2015-03-29,LAL,BRK
7568,68,@,L 99-104 ,240,40,90,0.444,34,75,0.453,6,15,0.4,13,19,0.684,99,38,76,0.5,28,59,0.475,10,17,0.588,18,26,0.692,104,2015-03-29,DAL,IND
7569,69,@,W 99-91 ,240,34,80,0.425,25,51,0.49,9,29,0.31,22,33,0.667,99,29,75,0.387,25,60,0.417,4,15,0.267,29,37,0.784,91,2015-03-29,HOU,WAS
7570,70,Home,W 99-96 ,240,35,78,0.449,27,56,0.482,8,22,0.364,21,27,0.778,99,35,84,0.417,27,57,0.474,8,27,0.296,18,31,0.581,96,2015-03-30,TOR,HOU
7571,71,Home,L 99-113 ,240,41,77,0.532,36,63,0.571,5,14,0.357,12,19,0.632,99,42,76,0.553,29,46,0.63,13,30,0.433,16,23,0.696,113,2015-04-01,MIN,TOR
7572,72,@,L 99-131 ,240,39,80,0.488,29,57,0.509,10,23,0.435,11,17,0.647,99,49,82,0.598,32,49,0.653,17,33,0.515,16,19,0.842,131,2015-04-04,BRK,ATL
7573,73,Home,W 99-98 ,240,36,73,0.493,24,47,0.511,12,26,0.462,15,23,0.652,99,37,77,0.481,32,57,0.561,5,20,0.25,19,26,0.731,98,2015-04-04,DET,MIA
7574,74,Home,W 99-90 ,240,36,84,0.429,30,68,0.441,6,16,0.375,21,23,0.913,99,39,85,0.459,32,69,0.464,7,16,0.438,5,10,0.5,90,2015-04-04,POR,NOP
7575,75,Home,W 99-94 ,240,35,83,0.422,19,46,0.413,16,37,0.432,13,22,0.591,99,34,76,0.447,23,49,0.469,11,27,0.407,15,21,0.714,94,2015-04-05,CLE,CHI
7576,76,Home,L 99-104 ,240,42,84,0.5,36,66,0.545,6,18,0.333,9,13,0.692,99,36,74,0.486,25,40,0.625,11,34,0.324,21,26,0.808,104,2015-04-08,MIL,CLE
7577,77,@,W 99-90 ,240,38,84,0.452,30,62,0.484,8,22,0.364,15,21,0.714,99,32,77,0.416,23,43,0.535,9,34,0.265,17,25,0.68,90,2015-04-10,BOS,CLE
7578,78,@,W 99-91 ,240,37,76,0.487,31,59,0.525,6,17,0.353,19,29,0.655,99,34,72,0.472,29,59,0.492,5,13,0.385,18,24,0.75,91,2015-04-10,MIL,NYK
7579,79,Home,L 99-101 ,240,41,89,0.461,34,69,0.493,7,20,0.35,10,10,1.0,99,39,94,0.415,30,64,0.469,9,30,0.3,14,15,0.933,101,2015-04-10,ORL,TOR
7580,80,@,L 99-108 ,240,36,87,0.414,27,58,0.466,9,29,0.31,18,24,0.75,99,39,85,0.459,30,64,0.469,9,21,0.429,21,27,0.778,108,2015-04-12,ATL,WAS
7581,81,Home,W 99-95 (2OT),290,40,105,0.381,31,75,0.413,9,30,0.3,10,17,0.588,99,37,104,0.356,30,80,0.375,7,24,0.292,14,17,0.824,95,2015-04-14,IND,WAS
7582,82,Home,L 99-122 ,240,36,94,0.383,29,70,0.414,7,24,0.292,20,25,0.8,99,46,84,0.548,38,67,0.567,8,17,0.471,22,41,0.537,122,2015-04-15,LAL,SAC
7583,83,@,L 99-106 ,240,32,86,0.372,23,63,0.365,9,23,0.391,26,31,0.839,99,36,80,0.45,29,62,0.468,7,18,0.389,27,39,0.692,106,2015-10-28,IND,TOR
7584,84,@,W 99-71 ,240,36,88,0.409,29,75,0.387,7,13,0.538,20,25,0.8,99,19,63,0.302,13,48,0.271,6,15,0.4,27,37,0.73,71,2015-10-30,UTA,PHI
7585,85,@,L 99-102 ,240,37,81,0.457,30,59,0.508,7,22,0.318,18,20,0.9,99,42,87,0.483,34,64,0.531,8,23,0.348,10,14,0.714,102,2015-11-04,SAS,WAS
7586,86,@,W 99-92 ,240,35,81,0.432,32,67,0.478,3,14,0.214,26,29,0.897,99,33,81,0.407,29,57,0.509,4,24,0.167,22,28,0.786,92,2015-11-06,MIL,NYK
7587,87,@,L 99-114 ,240,38,78,0.487,30,54,0.556,8,24,0.333,15,17,0.882,99,43,92,0.467,30,59,0.508,13,33,0.394,15,15,1.0,114,2015-11-07,WAS,ATL
7588,88,Home,W 99-95 ,240,33,84,0.393,24,57,0.421,9,27,0.333,24,29,0.828,99,36,94,0.383,27,67,0.403,9,27,0.333,14,23,0.609,95,2015-11-08,NYK,LAL
7589,89,@,W 99-83 ,240,38,86,0.442,31,56,0.554,7,30,0.233,16,19,0.842,99,30,73,0.411,24,56,0.429,6,17,0.353,17,23,0.739,83,2015-11-10,BOS,MIL
7590,90,@,L 99-101 ,240,39,79,0.494,32,57,0.561,7,22,0.318,14,18,0.778,99,40,100,0.4,27,72,0.375,13,28,0.464,8,12,0.667,101,2015-11-11,LAL,ORL
7591,91,@,L 99-107 (OT),265,41,98,0.418,39,80,0.488,2,18,0.111,15,16,0.938,99,43,97,0.443,31,63,0.492,12,34,0.353,9,10,0.9,107,2015-11-14,BRK,GSW
7592,92,@,L 99-108 ,240,38,87,0.437,34,69,0.493,4,18,0.222,19,24,0.792,99,39,83,0.47,27,54,0.5,12,29,0.414,18,26,0.692,108,2015-11-14,ORL,WAS
7593,93,@,L 99-104 ,240,38,80,0.475,27,47,0.574,11,33,0.333,12,20,0.6,99,36,84,0.429,29,63,0.46,7,21,0.333,25,31,0.806,104,2015-11-17,CLE,DET
7594,94,Home,W 99-95 ,240,34,82,0.415,25,61,0.41,9,21,0.429,22,29,0.759,99,31,82,0.378,23,51,0.451,8,31,0.258,25,35,0.714,95,2015-11-25,MIN,ATL
7595,95,@,L 99-110 ,240,43,94,0.457,40,81,0.494,3,13,0.231,10,12,0.833,99,41,78,0.526,31,54,0.574,10,24,0.417,18,21,0.857,110,2015-11-25,BRK,OKC
7596,96,@,L 99-103 ,240,36,82,0.439,22,53,0.415,14,29,0.483,13,16,0.813,99,40,79,0.506,29,54,0.537,11,25,0.44,12,22,0.545,103,2015-11-25,CLE,TOR
7597,97,@,L 99-107 ,240,37,82,0.451,29,66,0.439,8,16,0.5,17,21,0.81,99,39,75,0.52,31,53,0.585,8,22,0.364,21,33,0.636,107,2015-11-29,MIN,LAC
7598,98,Home,W 99-90 ,240,36,89,0.404,30,72,0.417,6,17,0.353,21,27,0.778,99,36,93,0.387,31,78,0.397,5,15,0.333,13,22,0.591,90,2015-12-02,CHI,DEN
7599,99,Home,L 99-116 ,240,35,94,0.372,26,63,0.413,9,31,0.29,20,30,0.667,99,46,88,0.523,30,54,0.556,16,34,0.471,8,11,0.727,116,2015-12-02,CHA,GSW
7600,0,Home,W 99-87 ,240,38,88,0.432,34,69,0.493,4,19,0.211,19,22,0.864,99,32,86,0.372,23,56,0.411,9,30,0.3,14,24,0.583,87,2015-12-02,NYK,PHI
7601,1,Home,W 99-84 ,240,37,68,0.544,30,52,0.577,7,16,0.438,18,29,0.621,99,31,85,0.365,25,57,0.439,6,28,0.214,16,24,0.667,84,2015-12-05,MIA,CLE
7602,2,Home,W 99-81 ,240,40,81,0.494,29,54,0.537,11,27,0.407,8,17,0.471,99,29,75,0.387,23,54,0.426,6,21,0.286,17,24,0.708,81,2015-12-09,CHA,MIA
7603,3,Home,W 99-97 ,240,42,93,0.452,39,77,0.506,3,16,0.188,12,16,0.75,99,33,83,0.398,24,54,0.444,9,29,0.31,22,28,0.786,97,2015-12-10,SAC,NYK
7604,4,Home,L 99-123 ,240,32,80,0.4,25,60,0.417,7,20,0.35,28,37,0.757,99,39,78,0.5,21,41,0.512,18,37,0.486,27,30,0.9,123,2015-12-11,MEM,CHO
7605,5,@,L 99-109 (OT),265,35,97,0.361,26,58,0.448,9,39,0.231,20,28,0.714,99,37,85,0.435,27,56,0.482,10,29,0.345,25,31,0.806,109,2015-12-17,TOR,CHO
7606,6,Home,W 99-95 ,240,39,82,0.476,33,64,0.516,6,18,0.333,15,16,0.938,99,38,81,0.469,31,58,0.534,7,23,0.304,12,17,0.706,95,2015-12-18,MIN,SAC
7607,7,@,L 99-113 ,240,36,79,0.456,34,66,0.515,2,13,0.154,25,32,0.781,99,46,89,0.517,34,64,0.531,12,25,0.48,9,16,0.563,113,2015-12-21,MIN,BOS
7608,8,Home,L 99-100 ,240,41,87,0.471,34,65,0.523,7,22,0.318,10,14,0.714,99,40,85,0.471,36,68,0.529,4,17,0.235,16,20,0.8,100,2015-12-21,LAC,OKC
7609,9,Home,L 99-107 ,240,39,76,0.513,32,52,0.615,7,24,0.292,14,16,0.875,99,44,86,0.512,34,64,0.531,10,22,0.455,9,11,0.818,107,2015-12-21,NYK,ORL
7610,10,@,L 99-113 ,240,37,91,0.407,30,69,0.435,7,22,0.318,18,22,0.818,99,42,83,0.506,28,59,0.475,14,24,0.583,15,17,0.882,113,2015-12-21,SAC,WAS
7611,11,@,L 99-103 ,240,40,92,0.435,29,63,0.46,11,29,0.379,8,11,0.727,99,35,74,0.473,23,48,0.479,12,26,0.462,21,27,0.778,103,2015-12-22,DAL,TOR
7612,12,@,W 99-93 ,240,39,84,0.464,35,61,0.574,4,23,0.174,17,23,0.739,99,35,91,0.385,29,66,0.439,6,25,0.24,17,25,0.68,93,2015-12-26,BOS,DET
7613,13,Home,W 99-90 (OT),265,38,87,0.437,34,72,0.472,4,15,0.267,19,20,0.95,99,35,79,0.443,24,50,0.48,11,29,0.379,9,18,0.5,90,2015-12-29,MEM,MIA
7614,14,@,L 99-130 ,240,41,89,0.461,32,66,0.485,9,23,0.391,8,17,0.471,99,49,81,0.605,37,58,0.638,12,23,0.522,20,25,0.8,130,2016-01-02,PHI,LAC
7615,15,@,L 99-109 ,240,39,73,0.534,37,68,0.544,2,5,0.4,19,24,0.792,99,48,87,0.552,44,67,0.657,4,20,0.2,9,14,0.643,109,2016-01-04,MIN,PHI
7616,16,@,W 99-94 ,240,33,74,0.446,23,47,0.489,10,27,0.37,23,36,0.639,99,34,91,0.374,28,63,0.444,6,28,0.214,20,27,0.741,94,2016-01-06,DET,BOS
7617,17,Home,L 99-125 ,240,36,79,0.456,29,63,0.46,7,16,0.438,20,26,0.769,99,43,81,0.531,30,54,0.556,13,27,0.481,26,29,0.897,125,2016-01-08,MIN,CLE
7618,18,@,L 99-100 ,240,38,91,0.418,29,70,0.414,9,21,0.429,14,17,0.824,99,41,93,0.441,37,80,0.463,4,13,0.308,14,17,0.824,100,2016-01-08,NYK,SAS
7619,19,Home,L 99-105 ,240,38,74,0.514,33,60,0.55,5,14,0.357,18,24,0.75,99,42,76,0.553,29,53,0.547,13,23,0.565,8,10,0.8,105,2016-01-09,ORL,WAS
7620,20,Home,L 99-109 ,240,38,91,0.418,32,68,0.471,6,23,0.261,17,26,0.654,99,41,85,0.482,36,71,0.507,5,14,0.357,22,27,0.815,109,2016-01-12,DET,SAS
7621,21,Home,W 99-85 ,240,39,88,0.443,28,62,0.452,11,26,0.423,10,15,0.667,99,31,76,0.408,23,57,0.404,8,19,0.421,15,22,0.682,85,2016-01-13,POR,UTA
7622,22,Home,W 99-95 ,240,38,83,0.458,33,66,0.5,5,17,0.294,18,22,0.818,99,38,82,0.463,28,56,0.5,10,26,0.385,9,11,0.818,95,2016-01-14,SAS,CLE
7623,23,Home,W 99-74 ,240,40,88,0.455,33,66,0.5,7,22,0.318,12,12,1.0,99,30,72,0.417,26,58,0.448,4,14,0.286,10,11,0.909,74,2016-01-17,OKC,MIA
7624,24,@,L 99-101 ,240,36,74,0.486,30,55,0.545,6,19,0.316,21,23,0.913,99,35,75,0.467,27,56,0.482,8,19,0.421,23,30,0.767,101,2016-01-18,NOP,MEM
7625,25,@,L 99-114 ,240,36,76,0.474,33,62,0.532,3,14,0.214,24,31,0.774,99,42,83,0.506,32,60,0.533,10,23,0.435,20,23,0.87,114,2016-01-19,MIN,NOP
7626,26,@,L 99-115 ,240,38,91,0.418,31,61,0.508,7,30,0.233,16,20,0.8,99,46,86,0.535,41,74,0.554,5,12,0.417,18,18,1.0,115,2016-01-21,DET,NOP
7627,27,@,L 99-116 ,240,39,74,0.527,33,59,0.559,6,15,0.4,15,18,0.833,99,43,94,0.457,26,63,0.413,17,31,0.548,13,17,0.765,116,2016-01-23,MIL,NOP
7628,28,@,L 99-130 ,240,28,73,0.384,20,43,0.465,8,30,0.267,35,52,0.673,99,50,90,0.556,38,67,0.567,12,23,0.522,18,21,0.857,130,2016-01-27,HOU,SAS
7629,29,@,W 99-96 ,240,39,81,0.481,32,61,0.525,7,20,0.35,14,20,0.7,99,39,85,0.459,35,65,0.538,4,20,0.2,14,26,0.538,96,2016-02-04,LAL,NOP
7630,30,Home,W 99-84 ,240,39,90,0.433,25,49,0.51,14,41,0.341,7,7,1.0,99,34,87,0.391,29,64,0.453,5,23,0.217,11,16,0.688,84,2016-02-06,CLE,NOP
7631,31,Home,W 99-92 ,240,36,82,0.439,32,68,0.471,4,14,0.286,23,32,0.719,99,34,88,0.386,28,56,0.5,6,32,0.188,18,24,0.75,92,2016-02-11,MIL,WAS
7632,32,Home,W 99-97 ,240,37,73,0.507,31,56,0.554,6,17,0.353,19,26,0.731,99,35,74,0.473,23,50,0.46,12,24,0.5,15,21,0.714,97,2016-02-26,TOR,CLE
7633,33,@,L 99-113 ,240,32,80,0.4,23,51,0.451,9,29,0.31,26,30,0.867,99,39,79,0.494,28,48,0.583,11,31,0.355,24,34,0.706,113,2016-02-28,CLE,WAS
7634,34,Home,L 99-104 ,240,34,76,0.447,31,62,0.5,3,14,0.214,28,32,0.875,99,38,80,0.475,28,60,0.467,10,20,0.5,18,26,0.692,104,2016-03-02,MIL,IND
7635,35,Home,L 99-119 ,240,34,85,0.4,21,52,0.404,13,33,0.394,18,26,0.692,99,40,81,0.494,30,56,0.536,10,25,0.4,29,35,0.829,119,2016-03-02,PHI,CHO
7636,36,Home,L 99-100 ,240,39,89,0.438,33,74,0.446,6,15,0.4,15,24,0.625,99,37,83,0.446,30,62,0.484,7,21,0.333,19,20,0.95,100,2016-03-05,WAS,IND
7637,37,Home,W 99-91 ,240,32,78,0.41,25,62,0.403,7,16,0.438,28,30,0.933,99,34,96,0.354,30,68,0.441,4,28,0.143,19,22,0.864,91,2016-03-07,IND,SAS
7638,38,@,L 99-104 ,240,42,82,0.512,36,70,0.514,6,12,0.5,9,9,1.0,99,37,78,0.474,27,55,0.491,10,23,0.435,20,25,0.8,104,2016-03-08,BRK,TOR
7639,39,@,W 99-96 ,240,37,86,0.43,30,65,0.462,7,21,0.333,18,21,0.857,99,36,84,0.429,30,57,0.526,6,27,0.222,18,25,0.72,96,2016-03-11,MIN,OKC
7640,40,Home,L 99-108 ,240,38,81,0.469,29,60,0.483,9,21,0.429,14,21,0.667,99,39,82,0.476,27,54,0.5,12,28,0.429,18,22,0.818,108,2016-03-13,SAC,UTA
7641,41,@,L 99-107 ,240,35,83,0.422,24,58,0.414,11,25,0.44,18,21,0.857,99,40,100,0.4,29,63,0.46,11,37,0.297,16,21,0.762,107,2016-03-16,ORL,CHO
7642,42,Home,W 99-98 ,240,39,88,0.443,29,51,0.569,10,37,0.27,11,13,0.846,99,37,79,0.468,30,57,0.526,7,22,0.318,17,19,0.895,98,2016-03-16,CLE,DAL
7643,43,@,W 99-94 ,240,40,90,0.444,34,63,0.54,6,27,0.222,13,19,0.684,99,35,91,0.385,29,58,0.5,6,33,0.182,18,26,0.692,94,2016-03-17,WAS,PHI
7644,44,Home,W 99-89 ,240,39,87,0.448,31,58,0.534,8,29,0.276,13,17,0.765,99,32,81,0.395,22,60,0.367,10,21,0.476,15,17,0.882,89,2016-03-19,WAS,NYK
7645,45,Home,L 99-113 ,240,34,87,0.391,27,71,0.38,7,16,0.438,24,30,0.8,99,44,88,0.5,41,69,0.594,3,19,0.158,22,27,0.815,113,2016-03-22,NOP,MIA
7646,46,Home,L 99-102 ,240,37,85,0.435,30,54,0.556,7,31,0.226,18,21,0.857,99,35,84,0.417,27,55,0.491,8,29,0.276,24,27,0.889,102,2016-03-26,PHO,BOS
7647,47,@,L 99-110 ,240,41,77,0.532,38,66,0.576,3,11,0.273,14,18,0.778,99,48,84,0.571,43,68,0.632,5,16,0.313,9,12,0.75,110,2016-03-28,BRK,MIA
7648,48,Home,W 99-91 ,240,32,75,0.427,24,56,0.429,8,19,0.421,27,37,0.73,99,36,89,0.404,26,58,0.448,10,31,0.323,9,13,0.692,91,2016-03-28,NOP,NYK
7649,49,@,W 99-79 ,240,37,84,0.44,28,53,0.528,9,31,0.29,16,18,0.889,99,30,87,0.345,22,64,0.344,8,23,0.348,11,17,0.647,79,2016-03-30,LAC,MIN
7650,50,@,W 99-95 ,240,30,71,0.423,18,43,0.419,12,28,0.429,27,29,0.931,99,37,91,0.407,30,72,0.417,7,19,0.368,14,17,0.824,95,2016-04-01,TOR,MEM
7651,51,Home,L 99-106 ,240,36,93,0.387,29,70,0.414,7,23,0.304,20,26,0.769,99,38,86,0.442,28,60,0.467,10,26,0.385,20,25,0.8,106,2016-04-01,PHO,WAS
7652,52,@,L 99-113 ,240,39,92,0.424,29,67,0.433,10,25,0.4,11,20,0.55,99,41,83,0.494,27,46,0.587,14,37,0.378,17,20,0.85,113,2016-04-08,BRK,CHO
7653,53,@,L 99-112 ,240,38,86,0.442,32,67,0.478,6,19,0.316,17,23,0.739,99,36,77,0.468,22,45,0.489,14,32,0.438,26,29,0.897,112,2016-04-08,WAS,DET
7654,54,Home,L 99-102 (OT),265,36,82,0.439,25,51,0.49,11,31,0.355,16,23,0.696,99,37,83,0.446,24,54,0.444,13,29,0.448,15,19,0.789,102,2016-04-08,UTA,LAC
7655,55,Home,L 99-100 ,240,37,96,0.385,30,75,0.4,7,21,0.333,18,20,0.9,99,39,87,0.448,29,51,0.569,10,36,0.278,12,13,0.923,100,2016-04-09,MEM,GSW
7656,56,@,W 99-93 ,240,38,78,0.487,31,58,0.534,7,20,0.35,16,22,0.727,99,34,84,0.405,29,66,0.439,5,18,0.278,20,30,0.667,93,2016-04-12,MIA,DET
7657,57,@,L 99-107 ,240,40,94,0.426,33,69,0.478,7,25,0.28,12,18,0.667,99,39,89,0.438,28,53,0.528,11,36,0.306,18,22,0.818,107,2016-04-13,DEN,POR
7658,58,@,L 99-114 ,240,40,94,0.426,34,74,0.459,6,20,0.3,13,18,0.722,99,44,88,0.5,32,62,0.516,12,26,0.462,14,18,0.778,114,2016-10-27,WAS,ATL
7659,59,@,L 99-105 ,240,38,76,0.5,30,53,0.566,8,23,0.348,15,24,0.625,99,36,92,0.391,25,67,0.373,11,25,0.44,22,30,0.733,105,2016-10-27,BOS,CHI
7660,60,@,L 99-105 ,240,38,84,0.452,30,56,0.536,8,28,0.286,15,26,0.577,99,36,88,0.409,25,51,0.49,11,37,0.297,22,30,0.733,105,2016-10-29,ORL,CLE
7661,61,Home,L 99-106 ,240,37,80,0.463,30,60,0.5,7,20,0.35,18,26,0.692,99,37,82,0.451,27,64,0.422,10,18,0.556,22,26,0.846,106,2016-10-30,MIA,SAS
7662,62,Home,L 99-118 ,240,37,85,0.435,29,65,0.446,8,20,0.4,17,25,0.68,99,42,89,0.472,27,49,0.551,15,40,0.375,19,27,0.704,118,2016-11-02,NYK,HOU
7663,63,Home,L 99-102 ,240,35,88,0.398,26,66,0.394,9,22,0.409,20,25,0.8,99,39,81,0.481,33,59,0.559,6,22,0.273,18,25,0.72,102,2016-11-03,MIN,DEN
7664,64,@,W 99-95 ,240,36,86,0.419,26,56,0.464,10,30,0.333,17,24,0.708,99,35,87,0.402,26,51,0.51,9,36,0.25,16,21,0.762,95,2016-11-04,CHA,BRK
7665,65,@,W 99-88 ,240,32,85,0.376,24,58,0.414,8,27,0.296,27,33,0.818,99,31,84,0.369,22,58,0.379,9,26,0.346,17,22,0.773,88,2016-11-04,LAC,MEM
7666,66,Home,L 99-101 ,240,33,84,0.393,26,61,0.426,7,23,0.304,26,30,0.867,99,37,78,0.474,27,48,0.563,10,30,0.333,17,22,0.773,101,2016-11-09,SAS,HOU
7667,67,Home,L 99-105 ,240,36,86,0.419,30,59,0.508,6,27,0.222,21,28,0.75,99,35,80,0.438,27,55,0.491,8,25,0.32,27,33,0.818,105,2016-11-12,IND,BOS
7668,68,Home,L 99-126 ,240,39,90,0.433,33,70,0.471,6,20,0.3,15,19,0.789,99,52,94,0.553,36,64,0.563,16,30,0.533,6,7,0.857,126,2016-11-12,NOP,LAL
7669,69,@,L 99-125 ,240,33,71,0.465,25,47,0.532,8,24,0.333,25,30,0.833,99,42,80,0.525,29,53,0.547,13,27,0.481,28,42,0.667,125,2016-11-13,LAL,MIN
7670,70,@,L 99-102 ,240,34,85,0.4,25,61,0.41,9,24,0.375,22,24,0.917,99,36,81,0.444,25,54,0.463,11,27,0.407,19,25,0.76,102,2016-11-20,TOR,SAC
7671,71,@,W 99-96 ,240,35,78,0.449,25,47,0.532,10,31,0.323,19,27,0.704,99,36,87,0.414,29,70,0.414,7,17,0.412,17,24,0.708,96,2016-11-21,HOU,DET
7672,72,@,W 99-93 ,240,38,84,0.452,26,46,0.565,12,38,0.316,11,14,0.786,99,36,86,0.419,32,62,0.516,4,24,0.167,17,25,0.68,93,2016-11-21,BOS,MIN
7673,73,Home,L 99-104 (2OT),290,35,93,0.376,23,57,0.404,12,36,0.333,17,23,0.739,99,38,99,0.384,28,70,0.4,10,29,0.345,18,24,0.75,104,2016-11-23,PHI,MEM
7674,74,Home,L 99-105 ,240,40,79,0.506,28,50,0.56,12,29,0.414,7,12,0.583,99,38,82,0.463,24,50,0.48,14,32,0.438,15,19,0.789,105,2016-11-25,MIL,TOR
7675,75,Home,W 99-92 ,240,36,89,0.404,27,65,0.415,9,24,0.375,18,24,0.75,99,38,86,0.442,32,64,0.5,6,22,0.273,10,15,0.667,92,2016-12-03,POR,MIA
7676,76,Home,L 99-102 ,240,34,77,0.442,27,55,0.491,7,22,0.318,24,32,0.75,99,37,80,0.463,27,49,0.551,10,31,0.323,18,28,0.643,102,2016-12-05,ATL,OKC
7677,77,@,W 99-88 ,240,39,91,0.429,27,51,0.529,12,40,0.3,9,13,0.692,99,33,84,0.393,26,59,0.441,7,25,0.28,15,22,0.682,88,2016-12-08,PHI,NOP
7678,78,Home,L 99-106 ,240,37,89,0.416,27,51,0.529,10,38,0.263,15,21,0.714,99,39,80,0.488,27,51,0.529,12,29,0.414,16,23,0.696,106,2016-12-08,UTA,GSW
7679,79,Home,L 99-102 ,240,34,81,0.42,27,53,0.509,7,28,0.25,24,31,0.774,99,36,92,0.391,25,50,0.5,11,42,0.262,19,30,0.633,102,2016-12-09,OKC,HOU
7680,80,Home,W 99-96 ,240,41,83,0.494,38,62,0.613,3,21,0.143,14,27,0.519,99,40,90,0.444,29,58,0.5,11,32,0.344,5,8,0.625,96,2016-12-11,OKC,BOS
7681,81,@,W 99-94 ,240,38,86,0.442,32,65,0.492,6,21,0.286,17,22,0.773,99,38,87,0.437,34,72,0.472,4,15,0.267,14,19,0.737,94,2016-12-13,MIN,CHI
7682,82,Home,L 99-107 ,240,40,86,0.465,30,60,0.5,10,26,0.385,9,16,0.563,99,43,88,0.489,31,61,0.508,12,27,0.444,9,13,0.692,107,2016-12-17,ATL,CHO
7683,83,Home,W 99-79 ,240,34,77,0.442,21,44,0.477,13,33,0.394,18,22,0.818,99,30,76,0.395,22,45,0.489,8,31,0.258,11,17,0.647,79,2016-12-18,DAL,SAC
7684,84,@,L 99-119 ,240,38,85,0.447,30,55,0.545,8,30,0.267,15,18,0.833,99,45,99,0.455,37,64,0.578,8,35,0.229,21,24,0.875,119,2016-12-23,BRK,CLE
7685,85,@,L 99-101 ,240,37,86,0.43,24,53,0.453,13,33,0.394,12,16,0.75,99,35,88,0.398,32,75,0.427,3,13,0.231,28,29,0.966,101,2016-12-28,BRK,CHI
7686,86,Home,W 99-91 ,240,37,83,0.446,28,62,0.452,9,21,0.429,16,23,0.696,99,30,75,0.4,23,48,0.479,7,27,0.259,24,29,0.828,91,2016-12-29,PHO,TOR
7687,87,@,L 99-108 ,240,39,93,0.419,31,61,0.508,8,32,0.25,13,15,0.867,99,42,84,0.5,31,51,0.608,11,33,0.333,13,15,0.867,108,2016-12-30,DAL,GSW
7688,88,@,L 99-116 ,240,40,74,0.541,32,56,0.571,8,18,0.444,11,17,0.647,99,43,77,0.558,30,52,0.577,13,25,0.52,17,21,0.81,116,2016-12-30,MIL,MIN
7689,89,Home,W 99-90 ,240,36,77,0.468,27,54,0.5,9,23,0.391,18,22,0.818,99,36,91,0.396,30,68,0.441,6,23,0.261,12,16,0.75,90,2017-01-03,PHO,MIA
7690,90,Home,L 99-127 ,240,39,86,0.453,32,61,0.525,7,25,0.28,14,17,0.824,99,51,90,0.567,39,66,0.591,12,24,0.5,13,17,0.765,127,2017-01-05,DEN,SAS
7691,91,@,W 99-94 ,240,38,90,0.422,29,67,0.433,9,23,0.391,14,17,0.824,99,34,93,0.366,19,58,0.328,15,35,0.429,11,14,0.786,94,2017-01-05,ATL,NOP
7692,92,@,L 99-101 ,240,35,88,0.398,25,61,0.41,10,27,0.37,19,21,0.905,99,42,83,0.506,31,61,0.508,11,22,0.5,6,9,0.667,101,2017-01-10,CHI,WAS
7693,93,@,L 99-107 ,240,39,84,0.464,32,61,0.525,7,23,0.304,14,21,0.667,99,43,101,0.426,35,81,0.432,8,20,0.4,13,23,0.565,107,2017-01-14,NOP,CHI
7694,94,@,W 99-98 ,240,37,78,0.474,26,50,0.52,11,28,0.393,14,18,0.778,99,37,82,0.451,31,68,0.456,6,14,0.429,18,22,0.818,98,2017-01-17,DAL,CHI
7695,95,Home,W 99-95 ,240,35,73,0.479,26,53,0.491,9,20,0.45,20,29,0.69,99,37,82,0.451,23,46,0.5,14,36,0.389,7,11,0.636,95,2017-01-19,MIA,DAL
7696,96,@,L 99-102 ,240,37,84,0.44,28,58,0.483,9,26,0.346,16,21,0.762,99,34,83,0.41,28,66,0.424,6,17,0.353,28,33,0.848,102,2017-01-21,SAC,CHI
7697,97,Home,L 99-109 ,240,35,90,0.389,27,58,0.466,8,32,0.25,21,25,0.84,99,43,80,0.538,33,55,0.6,10,25,0.4,13,17,0.765,109,2017-01-23,CHA,WAS
7698,98,@,L 99-101 ,240,39,92,0.424,29,58,0.5,10,34,0.294,11,19,0.579,99,36,78,0.462,26,56,0.464,10,22,0.455,19,25,0.76,101,2017-01-25,TOR,MEM
7699,99,Home,L 99-119 ,240,32,80,0.4,23,55,0.418,9,25,0.36,26,35,0.743,99,45,92,0.489,31,62,0.5,14,30,0.467,15,20,0.75,119,2017-02-01,DEN,MEM
7700,0,Home,L 99-107 ,240,35,84,0.417,25,58,0.431,10,26,0.385,19,24,0.792,99,32,77,0.416,22,49,0.449,10,28,0.357,33,39,0.846,107,2017-02-04,MIN,MEM
7701,1,@,L 99-105 ,240,35,87,0.402,25,59,0.424,10,28,0.357,19,21,0.905,99,40,98,0.408,36,80,0.45,4,18,0.222,21,28,0.75,105,2017-02-05,POR,OKC
7702,2,Home,L 99-108 ,240,35,81,0.432,27,61,0.443,8,20,0.4,21,28,0.75,99,41,92,0.446,34,69,0.493,7,23,0.304,19,21,0.905,108,2017-02-10,BRK,MIA
7703,3,@,L 99-105 ,240,34,82,0.415,21,51,0.412,13,31,0.419,18,21,0.857,99,35,78,0.449,24,47,0.511,11,31,0.355,24,27,0.889,105,2017-02-12,NOP,SAC
7704,4,Home,L 99-105 ,240,34,78,0.436,23,47,0.489,11,31,0.355,20,26,0.769,99,41,86,0.477,29,53,0.547,12,33,0.364,11,17,0.647,105,2017-02-13,CHA,PHI
7705,5,Home,L 99-112 ,240,38,94,0.404,27,60,0.45,11,34,0.324,12,18,0.667,99,41,86,0.477,35,68,0.515,6,18,0.333,24,28,0.857,112,2017-02-15,DEN,MIN
7706,6,Home,W 99-84 ,240,37,79,0.468,23,42,0.548,14,37,0.378,11,12,0.917,99,32,79,0.405,25,53,0.472,7,26,0.269,13,19,0.684,84,2017-02-15,LAC,ATL
7707,7,Home,L 99-129 ,240,36,86,0.419,30,55,0.545,6,31,0.194,21,26,0.808,99,45,91,0.495,25,40,0.625,20,51,0.392,19,24,0.792,129,2017-02-23,NOP,HOU
7708,8,Home,L 99-117 ,240,37,80,0.463,23,43,0.535,14,37,0.378,11,15,0.733,99,46,93,0.495,31,63,0.492,15,30,0.5,10,16,0.625,117,2017-02-25,CLE,CHI
7709,9,@,W 99-85 ,240,34,85,0.4,20,47,0.426,14,38,0.368,17,18,0.944,99,31,79,0.392,20,51,0.392,11,28,0.393,12,15,0.8,85,2017-02-25,CHA,SAC
7710,10,@,L 99-103 ,240,37,91,0.407,27,58,0.466,10,33,0.303,15,22,0.682,99,36,78,0.462,23,47,0.489,13,31,0.419,18,23,0.783,103,2017-03-01,CLE,BOS
7711,11,@,L 99-100 ,240,37,81,0.457,30,58,0.517,7,23,0.304,18,25,0.72,99,35,74,0.473,26,45,0.578,9,29,0.31,21,24,0.875,100,2017-03-01,IND,SAS
7712,12,@,L 99-110 ,240,35,91,0.385,27,63,0.429,8,28,0.286,21,25,0.84,99,45,90,0.5,40,73,0.548,5,17,0.294,15,19,0.789,110,2017-03-03,MIA,ORL
7713,13,@,W 99-86 ,240,37,84,0.44,27,55,0.491,10,29,0.345,15,19,0.789,99,37,84,0.44,31,54,0.574,6,30,0.2,6,9,0.667,86,2017-03-08,BOS,GSW
7714,14,Home,W 98-95 ,240,40,94,0.426,38,78,0.487,2,16,0.125,16,20,0.8,98,28,70,0.4,22,56,0.393,6,14,0.429,33,45,0.733,95,2011-12-27,MIL,MIN
7715,15,@,W 98-95 ,240,29,77,0.377,19,52,0.365,10,25,0.4,30,38,0.789,98,34,87,0.391,32,71,0.451,2,16,0.125,25,33,0.758,95,2011-12-28,OKC,MEM
7716,16,Home,L 98-108 ,240,35,83,0.422,27,66,0.409,8,17,0.471,20,34,0.588,98,43,80,0.538,37,68,0.544,6,12,0.5,16,21,0.762,108,2011-12-29,SAC,CHI
7717,17,@,L 98-105 ,240,38,82,0.463,29,62,0.468,9,20,0.45,13,14,0.929,98,37,77,0.481,33,62,0.532,4,15,0.267,27,38,0.711,105,2011-12-30,BRK,ATL
7718,18,Home,W 98-91 (OT),265,36,94,0.383,34,84,0.405,2,10,0.2,24,32,0.75,98,34,88,0.386,29,63,0.46,5,25,0.2,18,31,0.581,91,2011-12-30,IND,CLE
7719,19,Home,W 98-82 ,240,38,78,0.487,22,52,0.423,16,26,0.615,6,11,0.545,98,27,71,0.38,20,49,0.408,7,22,0.318,21,28,0.75,82,2012-01-01,CLE,NJN
7720,20,Home,W 98-89 ,240,38,91,0.418,30,69,0.435,8,22,0.364,14,21,0.667,98,37,82,0.451,32,65,0.492,5,17,0.294,10,15,0.667,89,2012-01-04,DAL,PHO
7721,21,@,W 98-87 ,240,37,80,0.463,29,63,0.46,8,17,0.471,16,22,0.727,98,31,79,0.392,27,59,0.458,4,20,0.2,21,31,0.677,87,2012-01-06,CLE,MIN
7722,22,@,W 98-95 ,240,36,85,0.424,29,64,0.453,7,21,0.333,19,22,0.864,98,38,87,0.437,33,73,0.452,5,14,0.357,14,15,0.933,95,2012-01-07,OKC,HOU
7723,23,Home,W 98-78 ,240,38,92,0.413,32,69,0.464,6,23,0.261,16,18,0.889,98,29,79,0.367,26,55,0.473,3,24,0.125,17,24,0.708,78,2012-01-08,POR,CLE
7724,24,@,W 98-91 ,240,30,81,0.37,23,57,0.404,7,24,0.292,31,34,0.912,98,34,80,0.425,28,60,0.467,6,20,0.3,17,21,0.81,91,2012-01-11,SAC,TOR
7725,25,@,W 98-81 ,240,40,82,0.488,33,68,0.485,7,14,0.5,11,16,0.688,98,33,74,0.446,32,66,0.485,1,8,0.125,14,16,0.875,81,2012-01-13,DET,CHA
7726,26,@,L 98-120 ,240,38,80,0.475,28,55,0.509,10,25,0.4,12,17,0.706,98,46,79,0.582,30,53,0.566,16,26,0.615,12,19,0.632,120,2012-01-17,SAS,MIA
7727,27,Home,W 98-87 ,240,38,85,0.447,29,67,0.433,9,18,0.5,13,18,0.722,98,34,81,0.42,28,61,0.459,6,20,0.3,13,16,0.813,87,2012-01-19,MIA,LAL
7728,28,@,W 98-81 ,240,39,68,0.574,34,59,0.576,5,9,0.556,15,20,0.75,98,29,66,0.439,25,56,0.446,4,10,0.4,19,26,0.731,81,2012-01-20,MEM,DET
7729,29,Home,L 98-101 ,240,33,71,0.465,22,50,0.44,11,21,0.524,21,28,0.75,98,36,81,0.444,30,66,0.455,6,15,0.4,23,33,0.697,101,2012-01-20,LAC,MIN
7730,30,@,L 98-108 ,240,37,83,0.446,29,62,0.468,8,21,0.381,16,21,0.762,98,41,79,0.519,36,64,0.563,5,15,0.333,21,29,0.724,108,2012-01-21,MIN,UTA
7731,31,@,W 98-96 ,240,36,77,0.468,26,59,0.441,10,18,0.556,16,19,0.842,98,36,86,0.419,34,77,0.442,2,9,0.222,22,33,0.667,96,2012-01-22,IND,LAL
7732,32,Home,L 98-101 ,240,36,72,0.5,29,50,0.58,7,22,0.318,19,25,0.76,98,37,71,0.521,32,56,0.571,5,15,0.333,22,25,0.88,101,2012-01-25,DET,MIA
7733,33,Home,W 98-91 ,240,35,72,0.486,26,50,0.52,9,22,0.409,19,27,0.704,98,30,84,0.357,24,66,0.364,6,18,0.333,25,31,0.806,91,2012-01-26,LAC,MEM
7734,34,@,W 98-88 ,240,34,75,0.453,28,55,0.509,6,20,0.3,24,31,0.774,98,37,92,0.402,34,78,0.436,3,14,0.214,11,13,0.846,88,2012-01-30,CHI,WAS
7735,35,Home,W 98-82 ,240,40,84,0.476,36,73,0.493,4,11,0.364,14,19,0.737,98,32,74,0.432,25,57,0.439,7,17,0.412,11,16,0.688,82,2012-02-01,PHI,CHI
7736,36,@,W 98-87 ,240,37,87,0.425,25,62,0.403,12,25,0.48,12,16,0.75,98,35,83,0.422,29,67,0.433,6,16,0.375,11,13,0.846,87,2012-02-03,IND,DAL
7737,37,@,W 98-87 ,240,44,88,0.5,40,79,0.506,4,9,0.444,6,9,0.667,98,32,74,0.432,27,59,0.458,5,15,0.333,18,27,0.667,87,2012-02-04,PHI,ATL
7738,38,Home,W 98-80 ,240,36,73,0.493,29,53,0.547,7,20,0.35,19,21,0.905,98,32,87,0.368,29,73,0.397,3,14,0.214,13,16,0.813,80,2012-02-05,BOS,MEM
7739,39,Home,W 98-92 ,240,34,73,0.466,33,64,0.516,1,9,0.111,29,37,0.784,98,30,78,0.385,24,62,0.387,6,16,0.375,26,37,0.703,92,2012-02-10,MEM,IND
7740,40,Home,L 98-100 ,240,37,84,0.44,31,65,0.477,6,19,0.316,18,19,0.947,98,40,84,0.476,33,65,0.508,7,19,0.368,13,22,0.591,100,2012-02-11,MIN,NYK
7741,41,@,W 98-84 ,240,39,78,0.5,31,55,0.564,8,23,0.348,12,15,0.8,98,27,77,0.351,19,56,0.339,8,21,0.381,22,28,0.786,84,2012-02-11,PHO,SAC
7742,42,@,W 98-77 ,240,37,79,0.468,31,64,0.484,6,15,0.4,18,21,0.857,98,29,89,0.326,28,78,0.359,1,11,0.091,18,19,0.947,77,2012-02-12,WAS,DET
7743,43,@,W 98-88 ,240,42,83,0.506,37,70,0.529,5,13,0.385,9,13,0.692,98,34,78,0.436,32,68,0.471,2,10,0.2,18,23,0.783,88,2012-02-12,UTA,MEM
7744,44,@,W 98-89 ,240,36,83,0.434,30,65,0.462,6,18,0.333,20,24,0.833,98,30,73,0.411,23,56,0.411,7,17,0.412,22,30,0.733,89,2012-02-13,PHI,CHA
7745,45,@,W 98-88 ,240,35,74,0.473,31,62,0.5,4,12,0.333,24,29,0.828,98,34,77,0.442,33,71,0.465,1,6,0.167,19,32,0.594,88,2012-02-15,DET,BOS
7746,46,Home,W 98-87 ,240,36,77,0.468,26,50,0.52,10,27,0.37,16,23,0.696,98,32,87,0.368,27,71,0.38,5,16,0.313,18,27,0.667,87,2012-02-15,CLE,IND
7747,47,Home,L 98-111 ,240,40,85,0.471,30,65,0.462,10,20,0.5,8,10,0.8,98,43,77,0.558,38,62,0.613,5,15,0.333,20,23,0.87,111,2012-02-17,HOU,MIN
7748,48,@,W 98-91 ,240,37,74,0.5,31,59,0.525,6,15,0.4,18,23,0.783,98,35,84,0.417,33,68,0.485,2,16,0.125,19,28,0.679,91,2012-02-17,CHA,TOR
7749,49,@,L 98-100 ,240,39,85,0.459,38,78,0.487,1,7,0.143,19,24,0.792,98,31,77,0.403,20,55,0.364,11,22,0.5,27,38,0.711,100,2012-02-22,UTA,MIN
7750,50,@,L 98-99 ,240,37,75,0.493,29,58,0.5,8,17,0.471,16,22,0.727,98,38,90,0.422,35,80,0.438,3,10,0.3,20,27,0.741,99,2012-03-02,MIA,UTA
7751,51,@,L 98-114 ,240,37,79,0.468,31,63,0.492,6,16,0.375,18,27,0.667,98,42,81,0.519,28,54,0.519,14,27,0.519,16,27,0.593,114,2012-03-03,MIL,ORL
7752,52,@,L 98-101 ,240,37,83,0.446,29,62,0.468,8,21,0.381,16,26,0.615,98,40,87,0.46,32,66,0.485,8,21,0.381,13,21,0.619,101,2012-03-03,CLE,WAS
7753,53,@,L 98-99 ,240,42,77,0.545,39,68,0.574,3,9,0.333,11,12,0.917,98,38,76,0.5,30,53,0.566,8,23,0.348,15,23,0.652,99,2012-03-07,NOP,SAC
7754,54,@,L 98-116 ,240,29,70,0.414,26,59,0.441,3,11,0.273,37,44,0.841,98,45,76,0.592,39,64,0.609,6,12,0.5,20,24,0.833,116,2012-03-07,HOU,TOR
7755,55,Home,W 98-91 ,240,41,86,0.477,37,75,0.493,4,11,0.364,12,15,0.8,98,36,86,0.419,31,72,0.431,5,14,0.357,14,19,0.737,91,2012-03-10,PHO,MEM
7756,56,@,L 98-107 ,240,35,80,0.438,33,68,0.485,2,12,0.167,26,38,0.684,98,44,87,0.506,38,65,0.585,6,22,0.273,13,15,0.867,107,2012-03-13,WAS,DAL
7757,57,@,L 98-104 (OT),265,40,91,0.44,32,68,0.471,8,23,0.348,10,11,0.909,98,36,73,0.493,25,45,0.556,11,28,0.393,21,37,0.568,104,2012-03-13,MIA,ORL
7758,58,Home,W 98-84 ,240,38,79,0.481,31,62,0.5,7,17,0.412,15,17,0.882,98,31,81,0.383,30,71,0.423,1,10,0.1,21,25,0.84,84,2012-03-14,BRK,TOR
7759,59,Home,L 98-120 ,240,35,79,0.443,25,57,0.439,10,22,0.455,18,20,0.9,98,45,93,0.484,35,71,0.493,10,22,0.455,20,22,0.909,120,2012-03-16,GSW,MIL
7760,60,Home,W 98-91 ,240,34,74,0.459,27,54,0.5,7,20,0.35,23,31,0.742,98,36,76,0.474,33,61,0.541,3,15,0.2,16,17,0.941,91,2012-03-17,DEN,BOS
7761,61,@,W 98-77 ,240,38,81,0.469,29,65,0.446,9,16,0.563,13,20,0.65,98,32,80,0.4,27,63,0.429,5,17,0.294,8,9,0.889,77,2012-03-28,CHI,ATL
7762,62,Home,W 98-89 ,240,38,73,0.521,31,59,0.525,7,14,0.5,15,20,0.75,98,35,94,0.372,34,79,0.43,1,15,0.067,18,26,0.692,89,2012-03-30,HOU,MEM
7763,63,Home,W 98-97 ,240,39,75,0.52,31,54,0.574,8,21,0.381,12,19,0.632,98,39,78,0.5,31,59,0.525,8,19,0.421,11,15,0.733,97,2012-03-30,LAC,POR
7764,64,Home,L 98-100 ,240,35,78,0.449,24,46,0.522,11,32,0.344,17,28,0.607,98,38,80,0.475,31,58,0.534,7,22,0.318,17,21,0.81,100,2012-03-30,ORL,DAL
7765,65,Home,L 98-112 ,240,36,81,0.444,29,63,0.46,7,18,0.389,19,20,0.95,98,43,83,0.518,39,73,0.534,4,10,0.4,22,29,0.759,112,2012-04-02,WAS,MIL
7766,66,Home,W 98-94 ,240,37,80,0.463,28,63,0.444,9,17,0.529,15,24,0.625,98,38,82,0.463,31,64,0.484,7,18,0.389,11,16,0.688,94,2012-04-03,MEM,GSW
7767,67,Home,W 98-93 ,240,31,83,0.373,21,59,0.356,10,24,0.417,26,29,0.897,98,35,81,0.432,30,64,0.469,5,17,0.294,18,20,0.9,93,2012-04-04,MIA,OKC
7768,68,@,L 98-107 ,240,39,95,0.411,31,69,0.449,8,26,0.308,12,13,0.923,98,48,84,0.571,46,73,0.63,2,11,0.182,9,17,0.529,107,2012-04-04,CLE,MIL
7769,69,@,L 98-103 ,240,34,77,0.442,28,58,0.483,6,19,0.316,24,31,0.774,98,35,85,0.412,29,66,0.439,6,19,0.316,27,34,0.794,103,2012-04-06,OKC,IND
7770,70,@,L 98-110 ,240,38,84,0.452,33,72,0.458,5,12,0.417,17,22,0.773,98,45,80,0.563,38,62,0.613,7,18,0.389,13,19,0.684,110,2012-04-06,WAS,NJN
7771,71,@,L 98-104 ,240,39,86,0.453,30,64,0.469,9,22,0.409,11,12,0.917,98,38,79,0.481,32,63,0.508,6,16,0.375,22,25,0.88,104,2012-04-06,GSW,UTA
7772,72,Home,W 98-75 ,240,36,83,0.434,29,60,0.483,7,23,0.304,19,29,0.655,98,28,75,0.373,25,56,0.446,3,19,0.158,16,23,0.696,75,2012-04-08,MIA,DET
7773,73,@,L 98-103 ,240,36,75,0.48,26,55,0.473,10,20,0.5,16,24,0.667,98,36,71,0.507,29,55,0.527,7,16,0.438,24,31,0.774,103,2012-04-09,TOR,IND
7774,74,Home,W 98-86 ,240,39,90,0.433,30,70,0.429,9,20,0.45,11,16,0.688,98,31,73,0.425,24,52,0.462,7,21,0.333,17,21,0.81,86,2012-04-10,CHI,NYK
7775,75,Home,L 98-104 (OT),265,40,88,0.455,37,67,0.552,3,21,0.143,15,19,0.789,98,36,77,0.468,28,57,0.491,8,20,0.4,24,32,0.75,104,2012-04-11,CLE,IND
7776,76,Home,L 98-100 ,240,31,76,0.408,19,50,0.38,12,26,0.462,24,27,0.889,98,38,81,0.469,33,65,0.508,5,16,0.313,19,21,0.905,100,2012-04-11,OKC,LAC
7777,77,@,W 98-84 ,240,40,89,0.449,29,66,0.439,11,23,0.478,7,12,0.583,98,33,81,0.407,20,57,0.351,13,24,0.542,5,9,0.556,84,2012-04-11,LAL,SAS
7778,78,@,L 98-103 ,240,40,83,0.482,35,72,0.486,5,11,0.455,13,17,0.765,98,34,70,0.486,27,57,0.474,7,13,0.538,28,34,0.824,103,2012-04-14,UTA,MEM
7779,79,@,W 98-89 ,240,34,66,0.515,31,58,0.534,3,8,0.375,27,33,0.818,98,38,87,0.437,34,73,0.466,4,14,0.286,9,12,0.75,89,2012-04-14,CLE,WAS
7780,80,Home,L 98-101 ,240,41,82,0.5,36,66,0.545,5,16,0.313,11,16,0.688,98,36,71,0.507,30,53,0.566,6,18,0.333,23,27,0.852,101,2012-04-16,BRK,MIA
7781,81,@,L 98-102 ,240,36,78,0.462,30,54,0.556,6,24,0.25,20,30,0.667,98,38,70,0.543,35,63,0.556,3,7,0.429,23,27,0.852,102,2012-04-18,ORL,BOS
7782,82,Home,L 98-104 ,240,36,73,0.493,31,55,0.564,5,18,0.278,21,26,0.808,98,38,78,0.487,24,54,0.444,14,24,0.583,14,20,0.7,104,2012-04-18,DEN,LAC
7783,83,Home,W 98-90 ,240,36,79,0.456,30,60,0.5,6,19,0.316,20,27,0.741,98,35,83,0.422,23,50,0.46,12,33,0.364,8,15,0.533,90,2012-04-20,CLE,NYK
7784,84,@,L 98-107 ,240,35,71,0.493,32,59,0.542,3,12,0.25,25,34,0.735,98,33,77,0.429,26,49,0.531,7,28,0.25,34,43,0.791,107,2012-04-22,NOP,LAC
7785,85,@,L 98-114 ,240,37,88,0.42,32,66,0.485,5,22,0.227,19,28,0.679,98,42,77,0.545,34,57,0.596,8,20,0.4,22,29,0.759,114,2012-04-22,CLE,SAS
7786,86,Home,W 98-67 ,240,37,88,0.42,27,69,0.391,10,19,0.526,14,18,0.778,98,25,83,0.301,19,65,0.292,6,18,0.333,11,16,0.688,67,2012-04-26,TOR,NJN
7787,87,@,L 98-106 (2OT),290,37,102,0.363,29,80,0.363,8,22,0.364,16,20,0.8,98,39,99,0.394,35,77,0.455,4,22,0.182,24,27,0.889,106,2012-11-03,SAC,IND
7788,88,Home,W 98-93 ,240,36,72,0.5,32,62,0.516,4,10,0.4,22,29,0.759,98,33,82,0.402,26,67,0.388,7,15,0.467,20,28,0.714,93,2012-11-14,BOS,UTA
7789,89,@,W 98-93 ,240,36,77,0.468,23,50,0.46,13,27,0.481,13,16,0.813,98,37,88,0.42,31,68,0.456,6,20,0.3,13,19,0.684,93,2012-11-15,MIA,DEN
7790,90,Home,L 98-106 ,240,34,79,0.43,27,61,0.443,7,18,0.389,23,29,0.793,98,43,85,0.506,41,70,0.586,2,15,0.133,18,26,0.692,106,2012-11-16,MIN,GSW
7791,91,@,L 98-102 ,240,44,93,0.473,42,77,0.545,2,16,0.125,8,11,0.727,98,36,82,0.439,33,71,0.465,3,11,0.273,27,30,0.9,102,2012-11-19,MIL,CHA
7792,92,@,L 98-106 ,240,37,82,0.451,33,66,0.5,4,16,0.25,20,29,0.69,98,40,85,0.471,31,61,0.508,9,24,0.375,17,19,0.895,106,2012-11-20,TOR,PHI
7793,93,Home,W 98-97 ,240,36,86,0.419,33,67,0.493,3,19,0.158,23,28,0.821,98,37,80,0.463,28,57,0.491,9,23,0.391,14,20,0.7,97,2012-11-21,CHA,TOR
7794,94,@,L 98-106 ,240,33,74,0.446,21,47,0.447,12,27,0.444,20,24,0.833,98,38,75,0.507,32,64,0.5,6,11,0.545,24,30,0.8,106,2012-11-23,LAL,MEM
7795,95,Home,W 98-85 ,240,39,92,0.424,34,75,0.453,5,17,0.294,15,21,0.714,98,34,78,0.436,27,61,0.443,7,17,0.412,10,13,0.769,85,2012-11-25,BRK,POR
7796,96,Home,L 98-105 ,240,37,79,0.468,19,42,0.452,18,37,0.486,6,11,0.545,98,36,71,0.507,21,46,0.457,15,25,0.6,18,23,0.783,105,2012-11-26,LAC,NOH
7797,97,@,L 98-100 ,240,37,81,0.457,32,62,0.516,5,19,0.263,19,22,0.864,98,35,75,0.467,29,61,0.475,6,14,0.429,24,32,0.75,100,2012-11-27,DAL,PHI
7798,98,@,L 98-120 ,240,36,87,0.414,28,66,0.424,8,21,0.381,18,30,0.6,98,47,87,0.54,38,65,0.585,9,22,0.409,17,22,0.773,120,2012-11-28,HOU,OKC
7799,99,Home,L 98-104 ,240,39,83,0.47,31,66,0.47,8,17,0.471,12,18,0.667,98,44,86,0.512,36,69,0.522,8,17,0.471,8,10,0.8,104,2012-11-30,CHA,PHI
7800,0,@,W 98-86 ,240,38,83,0.458,27,63,0.429,11,20,0.55,11,13,0.846,98,35,78,0.449,34,67,0.507,1,11,0.091,15,19,0.789,86,2012-11-30,BRK,ORL
7801,1,@,L 98-108 (OT),265,38,82,0.463,32,68,0.471,6,14,0.429,16,22,0.727,98,40,85,0.471,36,66,0.545,4,19,0.211,24,31,0.774,108,2012-12-04,PHO,MEM
7802,2,Home,L 98-100 ,240,39,83,0.47,32,67,0.478,7,16,0.438,13,15,0.867,98,39,92,0.424,26,51,0.51,13,41,0.317,9,13,0.692,100,2012-12-05,CHA,NYK
7803,3,@,W 98-90 ,240,40,77,0.519,35,62,0.565,5,15,0.333,13,18,0.722,98,36,78,0.462,31,58,0.534,5,20,0.25,13,18,0.722,90,2012-12-09,ORL,PHO
7804,4,Home,W 98-85 ,240,39,96,0.406,33,79,0.418,6,17,0.353,14,24,0.583,98,32,86,0.372,29,67,0.433,3,19,0.158,18,21,0.857,85,2012-12-12,MIL,SAC
7805,5,Home,W 98-90 ,240,40,88,0.455,33,61,0.541,7,27,0.259,11,12,0.917,98,33,72,0.458,27,53,0.509,6,19,0.316,18,25,0.72,90,2012-12-13,POR,SAS
7806,6,Home,L 98-107 ,240,36,78,0.462,32,66,0.485,4,12,0.333,22,29,0.759,98,43,79,0.544,38,62,0.613,5,17,0.294,16,19,0.842,107,2012-12-15,CHA,ORL
7807,7,Home,L 98-111 ,240,41,83,0.494,31,58,0.534,10,25,0.4,6,11,0.545,98,39,80,0.488,25,46,0.543,14,34,0.412,19,24,0.792,111,2012-12-16,PHI,LAL
7808,8,Home,W 98-93 ,240,37,86,0.43,31,72,0.431,6,14,0.429,18,26,0.692,98,32,80,0.4,30,72,0.417,2,8,0.25,27,34,0.794,93,2012-12-18,MIL,IND
7809,9,@,W 98-95 ,240,35,82,0.427,24,58,0.414,11,24,0.458,17,23,0.739,98,39,79,0.494,35,69,0.507,4,10,0.4,13,20,0.65,95,2012-12-29,NOP,CHA
7810,10,Home,W 98-91 ,240,36,82,0.439,32,66,0.485,4,16,0.25,22,31,0.71,98,37,85,0.435,32,61,0.525,5,24,0.208,12,16,0.75,91,2013-01-11,DEN,CLE
7811,11,@,L 98-101 (OT),265,35,76,0.461,25,51,0.49,10,25,0.4,18,22,0.818,98,40,85,0.471,37,73,0.507,3,12,0.25,18,21,0.857,101,2013-01-11,SAS,MEM
7812,12,@,L 98-113 ,240,35,85,0.412,29,65,0.446,6,20,0.3,22,29,0.759,98,46,77,0.597,40,64,0.625,6,13,0.462,15,16,0.938,113,2013-01-14,MIN,DAL
7813,13,@,W 98-94 ,240,39,92,0.424,33,76,0.434,6,16,0.375,14,20,0.7,98,34,89,0.382,30,75,0.4,4,14,0.286,22,29,0.759,94,2013-01-17,MIL,PHO
7814,14,@,W 98-93 ,240,41,86,0.477,33,62,0.532,8,24,0.333,8,11,0.727,98,35,85,0.412,27,64,0.422,8,21,0.381,15,22,0.682,93,2013-01-19,SAS,ATL
7815,15,@,L 98-109 ,240,34,83,0.41,28,62,0.452,6,21,0.286,24,30,0.8,98,45,90,0.5,39,74,0.527,6,16,0.375,13,17,0.765,109,2013-01-19,CLE,UTA
7816,16,@,W 98-95 ,240,39,84,0.464,31,65,0.477,8,19,0.421,12,17,0.706,98,37,81,0.457,30,57,0.526,7,24,0.292,14,18,0.778,95,2013-01-21,WAS,POR
7817,17,Home,L 98-99 ,240,40,82,0.488,35,65,0.538,5,17,0.294,13,18,0.722,98,37,78,0.474,31,67,0.463,6,11,0.545,19,22,0.864,99,2013-01-26,TOR,CLE
7818,18,@,L 98-100 (2OT),290,39,96,0.406,34,73,0.466,5,23,0.217,15,20,0.75,98,36,88,0.409,31,68,0.456,5,20,0.25,23,27,0.852,100,2013-01-27,MIA,BOS
7819,19,Home,W 98-79 ,240,36,81,0.444,29,67,0.433,7,14,0.5,19,21,0.905,98,32,88,0.364,29,70,0.414,3,18,0.167,12,27,0.444,79,2013-01-30,IND,DET
7820,20,@,L 98-113 ,240,38,72,0.528,34,59,0.576,4,13,0.308,18,21,0.857,98,44,84,0.524,37,62,0.597,7,22,0.318,18,22,0.818,113,2013-02-01,NOP,DEN
7821,21,Home,W 98-73 ,240,38,81,0.469,26,55,0.473,12,26,0.462,10,17,0.588,98,25,72,0.347,22,53,0.415,3,19,0.158,20,31,0.645,73,2013-02-01,TOR,LAC
7822,22,@,L 98-107 ,240,41,94,0.436,36,75,0.48,5,19,0.263,11,22,0.5,98,42,90,0.467,33,66,0.5,9,24,0.375,14,20,0.7,107,2013-02-02,ORL,MIL
7823,23,@,W 98-97 ,240,39,83,0.47,33,63,0.524,6,20,0.3,14,22,0.636,98,41,92,0.446,36,78,0.462,5,14,0.357,10,15,0.667,97,2013-02-03,LAL,DET
7824,24,Home,L 98-100 ,240,40,85,0.471,37,72,0.514,3,13,0.231,15,19,0.789,98,41,70,0.586,34,52,0.654,7,18,0.389,11,16,0.688,100,2013-02-04,MIN,POR
7825,25,Home,W 98-91 (OT),265,38,72,0.528,31,60,0.517,7,12,0.583,15,18,0.833,98,35,87,0.402,32,67,0.478,3,20,0.15,18,25,0.72,91,2013-02-04,UTA,SAC
7826,26,Home,W 98-90 ,240,37,84,0.44,30,72,0.417,7,12,0.583,17,27,0.63,98,37,79,0.468,33,62,0.532,4,17,0.235,12,15,0.8,90,2013-02-04,WAS,LAC
7827,27,@,L 98-119 ,240,38,93,0.409,28,73,0.384,10,20,0.5,12,16,0.75,98,48,95,0.505,40,72,0.556,8,23,0.348,15,20,0.75,119,2013-02-06,GSW,OKC
7828,28,Home,L 98-100 (OT),265,35,78,0.449,26,56,0.464,9,22,0.409,19,28,0.679,98,42,96,0.438,40,87,0.46,2,9,0.222,14,19,0.737,100,2013-02-08,IND,TOR
7829,29,Home,L 98-102 ,240,33,80,0.413,27,60,0.45,6,20,0.3,26,32,0.813,98,41,82,0.5,38,69,0.551,3,13,0.231,17,20,0.85,102,2013-02-19,POR,PHO
7830,30,@,L 98-108 ,240,40,84,0.476,31,67,0.463,9,17,0.529,9,14,0.643,98,42,87,0.483,32,67,0.478,10,20,0.5,14,17,0.824,108,2013-02-20,PHO,GSW
7831,31,@,L 98-100 ,240,35,75,0.467,25,47,0.532,10,28,0.357,18,23,0.783,98,35,80,0.438,28,62,0.452,7,18,0.389,23,28,0.821,100,2013-02-22,NYK,TOR
7832,32,Home,L 98-101 ,240,39,78,0.5,30,57,0.526,9,21,0.429,11,15,0.733,98,40,81,0.494,35,64,0.547,5,17,0.294,16,19,0.842,101,2013-02-26,CHI,CLE
7833,33,@,W 98-84 ,240,41,76,0.539,36,63,0.571,5,13,0.385,11,16,0.688,98,32,81,0.395,25,60,0.417,7,21,0.333,13,18,0.722,84,2013-02-26,ORL,PHI
7834,34,@,W 98-90 ,240,39,78,0.5,30,57,0.526,9,21,0.429,11,14,0.786,98,36,78,0.462,29,55,0.527,7,23,0.304,11,14,0.786,90,2013-03-01,DAL,BRK
7835,35,Home,W 98-91 ,240,34,73,0.466,24,54,0.444,10,19,0.526,20,27,0.741,98,33,77,0.429,29,64,0.453,4,13,0.308,21,27,0.778,91,2013-03-01,MIA,MEM
7836,36,Home,W 98-68 ,240,38,78,0.487,33,62,0.532,5,16,0.313,17,23,0.739,98,28,81,0.346,23,63,0.365,5,18,0.278,7,12,0.583,68,2013-03-01,UTA,CHA
7837,37,@,L 98-99 ,240,41,82,0.5,33,60,0.55,8,22,0.364,8,15,0.533,98,38,78,0.487,28,57,0.491,10,21,0.476,13,18,0.722,99,2013-03-03,ATL,LAL
7838,38,@,W 98-71 ,240,37,77,0.481,26,53,0.491,11,24,0.458,13,15,0.867,98,28,74,0.378,21,51,0.412,7,23,0.304,8,15,0.533,71,2013-03-06,TOR,PHO
7839,39,Home,W 98-96 ,240,40,86,0.465,29,66,0.439,11,20,0.55,7,9,0.778,98,37,76,0.487,26,51,0.51,11,25,0.44,11,12,0.917,96,2013-03-10,NOP,POR
7840,40,@,L 98-108 ,240,40,78,0.513,35,62,0.565,5,16,0.313,13,15,0.867,98,40,80,0.5,35,64,0.547,5,16,0.313,23,31,0.742,108,2013-03-12,NOP,BRK
7841,41,Home,W 98-81 ,240,35,82,0.427,29,62,0.468,6,20,0.3,22,30,0.733,98,33,78,0.423,28,56,0.5,5,22,0.227,10,14,0.714,81,2013-03-12,MIA,ATL
7842,42,@,W 98-94 ,240,35,75,0.467,30,55,0.545,5,20,0.25,23,27,0.852,98,40,85,0.471,33,67,0.493,7,18,0.389,7,12,0.583,94,2013-03-13,MIA,PHI
7843,43,Home,W 98-91 ,240,39,79,0.494,33,66,0.5,6,13,0.462,14,19,0.737,98,34,88,0.386,28,72,0.389,6,16,0.375,17,21,0.81,91,2013-03-16,PHI,IND
7844,44,Home,W 98-90 ,240,38,79,0.481,30,61,0.492,8,18,0.444,14,17,0.824,98,37,99,0.374,29,80,0.363,8,19,0.421,8,11,0.727,90,2013-03-20,ATL,MIL
7845,45,@,W 98-95 ,240,32,72,0.444,20,43,0.465,12,29,0.414,22,30,0.733,98,37,81,0.457,30,60,0.5,7,21,0.333,14,17,0.824,95,2013-03-20,MIA,CLE
7846,46,@,L 98-101 ,240,41,98,0.418,40,79,0.506,1,19,0.053,15,18,0.833,98,40,75,0.533,34,57,0.596,6,18,0.333,15,18,0.833,101,2013-03-21,MIN,SAC
7847,47,Home,L 98-105 ,240,41,90,0.456,36,66,0.545,5,24,0.208,11,13,0.846,98,41,90,0.456,30,62,0.484,11,28,0.393,12,21,0.571,105,2013-03-27,GSW,SAC
7848,48,@,L 98-100 ,240,38,80,0.475,26,59,0.441,12,21,0.571,10,18,0.556,98,40,79,0.506,34,61,0.557,6,18,0.333,14,18,0.778,100,2013-03-30,CHI,DAL
7849,49,@,L 98-125 ,240,33,86,0.384,25,63,0.397,8,23,0.348,24,29,0.828,98,47,87,0.54,38,67,0.567,9,20,0.45,22,27,0.815,125,2013-03-30,POR,GSW
7850,50,Home,W 98-81 ,240,35,80,0.438,26,56,0.464,9,24,0.375,19,27,0.704,98,31,78,0.397,24,56,0.429,7,22,0.318,12,14,0.857,81,2013-03-30,HOU,LAC
7851,51,Home,L 98-103 ,240,39,86,0.453,32,62,0.516,7,24,0.292,13,16,0.813,98,38,82,0.463,28,52,0.538,10,30,0.333,17,26,0.654,103,2013-03-30,SAC,LAL
7852,52,Home,L 98-108 ,240,41,81,0.506,33,60,0.55,8,21,0.381,8,10,0.8,98,43,77,0.558,36,62,0.581,7,15,0.467,15,21,0.714,108,2013-04-01,TOR,DET
7853,53,Home,W 98-93 ,240,36,71,0.507,29,51,0.569,7,20,0.35,19,22,0.864,98,34,93,0.366,30,69,0.435,4,24,0.167,21,30,0.7,93,2013-04-03,BOS,DET
7854,54,Home,W 98-88 ,240,36,78,0.462,29,59,0.492,7,19,0.368,19,22,0.864,98,33,83,0.398,29,68,0.426,4,15,0.267,18,23,0.783,88,2013-04-03,GSW,NOH
7855,55,Home,L 98-107 ,240,42,96,0.438,34,73,0.466,8,23,0.348,6,9,0.667,98,44,84,0.524,36,71,0.507,8,13,0.615,11,16,0.688,107,2013-04-03,MIL,MIN
7856,56,Home,W 98-84 ,240,40,90,0.444,30,61,0.492,10,29,0.345,8,13,0.615,98,35,90,0.389,29,73,0.397,6,17,0.353,8,9,0.889,84,2013-04-03,SAS,ORL
7857,57,Home,L 98-116 ,240,38,91,0.418,36,71,0.507,2,20,0.1,20,24,0.833,98,39,76,0.513,27,48,0.563,12,28,0.429,26,35,0.743,116,2013-04-05,POR,HOU
7858,58,Home,L 98-101 ,240,37,86,0.43,27,69,0.391,10,17,0.588,14,20,0.7,98,37,72,0.514,30,54,0.556,7,18,0.389,20,24,0.833,101,2013-04-09,CHI,TOR
7859,59,@,L 98-101 ,240,38,86,0.442,31,74,0.419,7,12,0.583,15,19,0.789,98,37,86,0.43,31,56,0.554,6,30,0.2,21,24,0.875,101,2013-04-09,PHO,HOU
7860,60,Home,L 98-103 ,240,36,80,0.45,25,57,0.439,11,23,0.478,15,21,0.714,98,33,75,0.44,16,34,0.471,17,41,0.415,20,23,0.87,103,2013-04-10,WAS,MIA
7861,61,@,L 98-105 ,240,39,80,0.488,31,57,0.544,8,23,0.348,12,18,0.667,98,37,73,0.507,29,53,0.547,8,20,0.4,23,30,0.767,105,2013-04-17,CLE,CHA
7862,62,@,L 98-118 ,240,40,104,0.385,33,79,0.418,7,25,0.28,11,17,0.647,98,49,93,0.527,45,77,0.584,4,16,0.25,16,20,0.8,118,2013-04-17,PHO,DEN
7863,63,Home,W 98-92 ,240,39,91,0.429,30,67,0.448,9,24,0.375,11,16,0.688,98,37,90,0.411,35,69,0.507,2,21,0.095,16,17,0.941,92,2013-04-17,NYK,ATL
7864,64,Home,W 98-94 ,240,35,84,0.417,30,69,0.435,5,15,0.333,23,34,0.676,98,33,82,0.402,24,58,0.414,9,24,0.375,19,24,0.792,94,2013-10-30,CLE,BRK
7865,65,Home,L 98-101 ,240,36,79,0.456,30,57,0.526,6,22,0.273,20,30,0.667,98,33,81,0.407,27,62,0.435,6,19,0.316,29,33,0.879,101,2013-10-30,UTA,OKC
7866,66,Home,L 98-105 ,240,34,76,0.447,30,60,0.5,4,16,0.25,26,38,0.684,98,35,84,0.417,29,69,0.42,6,15,0.4,29,34,0.853,105,2013-11-01,BOS,MIL
7867,67,Home,L 98-113 ,240,36,99,0.364,30,81,0.37,6,18,0.333,20,34,0.588,98,44,103,0.427,30,81,0.37,14,22,0.636,11,15,0.733,113,2013-11-01,DEN,POR
7868,68,Home,W 98-87 ,240,39,76,0.513,28,49,0.571,11,27,0.407,9,12,0.75,98,30,87,0.345,24,61,0.393,6,26,0.231,21,24,0.875,87,2013-11-02,GSW,SAC
7869,69,Home,L 98-104 ,240,37,85,0.435,27,67,0.403,10,18,0.556,14,19,0.737,98,39,78,0.5,27,53,0.509,12,25,0.48,14,22,0.636,104,2013-11-05,NOP,PHO
7870,70,Home,W 98-90 ,240,40,82,0.488,35,66,0.53,5,16,0.313,13,17,0.765,98,36,95,0.379,33,76,0.434,3,19,0.158,15,21,0.714,90,2013-11-06,ORL,LAC
7871,71,Home,L 98-99 ,240,29,77,0.377,22,50,0.44,7,27,0.259,33,52,0.635,98,36,92,0.391,20,57,0.351,16,35,0.457,11,15,0.733,99,2013-11-07,HOU,LAL
7872,72,Home,L 98-100 (OT),265,34,79,0.43,24,51,0.471,10,28,0.357,20,25,0.8,98,38,87,0.437,36,75,0.48,2,12,0.167,22,29,0.759,100,2013-11-15,PHO,BRK
7873,73,@,L 98-135 ,240,35,83,0.422,29,64,0.453,6,19,0.316,22,31,0.71,98,52,86,0.605,39,58,0.672,13,28,0.464,18,27,0.667,135,2013-11-16,PHI,NOP
7874,74,Home,L 98-108 ,240,31,85,0.365,28,72,0.389,3,13,0.231,33,35,0.943,98,41,76,0.539,33,58,0.569,8,18,0.444,18,21,0.857,108,2013-11-18,BRK,POR
7875,75,@,W 98-87 ,240,32,79,0.405,20,57,0.351,12,22,0.545,22,30,0.733,98,32,81,0.395,25,66,0.379,7,15,0.467,16,19,0.842,87,2013-11-18,GSW,UTA
7876,76,@,W 98-91 ,240,38,84,0.452,30,65,0.462,8,19,0.421,14,14,1.0,98,32,77,0.416,23,54,0.426,9,23,0.391,18,21,0.857,91,2013-11-20,WAS,CLE
7877,77,Home,L 98-102 ,240,34,90,0.378,29,68,0.426,5,22,0.227,25,31,0.806,98,40,81,0.494,28,57,0.491,12,24,0.5,10,16,0.625,102,2013-11-20,MIN,LAC
7878,78,@,L 98-105 ,240,37,83,0.446,29,59,0.492,8,24,0.333,16,20,0.8,98,40,79,0.506,35,64,0.547,5,15,0.333,20,33,0.606,105,2013-11-20,UTA,NOP
7879,79,Home,L 98-108 ,240,34,76,0.447,27,56,0.482,7,20,0.35,23,31,0.742,98,36,86,0.419,22,57,0.386,14,29,0.483,22,28,0.786,108,2013-11-20,PHI,TOR
7880,80,@,W 98-91 ,240,33,70,0.471,23,47,0.489,10,23,0.435,22,38,0.579,98,32,77,0.416,29,63,0.46,3,14,0.214,24,33,0.727,91,2013-11-22,PHO,CHA
7881,81,Home,W 98-95 ,240,36,88,0.409,24,62,0.387,12,26,0.462,14,15,0.933,98,32,83,0.386,27,69,0.391,5,14,0.357,26,29,0.897,95,2013-11-22,POR,CHI
7882,82,@,L 98-106 ,240,35,102,0.343,31,77,0.403,4,25,0.16,24,32,0.75,98,35,76,0.461,30,58,0.517,5,18,0.278,31,38,0.816,106,2013-11-23,PHI,IND
7883,83,Home,W 98-89 ,240,37,76,0.487,30,57,0.526,7,19,0.368,17,22,0.773,98,36,82,0.439,25,53,0.472,11,29,0.379,6,15,0.4,89,2013-11-23,WAS,NYK
7884,84,Home,W 98-84 ,240,40,80,0.5,32,65,0.492,8,15,0.533,10,17,0.588,98,29,88,0.33,26,69,0.377,3,19,0.158,23,28,0.821,84,2013-11-25,IND,MIN
7885,85,Home,L 98-104 (OT),265,42,91,0.462,36,68,0.529,6,23,0.261,8,10,0.8,98,37,83,0.446,31,63,0.492,6,20,0.3,24,37,0.649,104,2013-11-29,SAC,LAC
7886,86,@,L 98-99 ,240,35,76,0.461,31,61,0.508,4,15,0.267,24,28,0.857,98,36,69,0.522,28,51,0.549,8,18,0.444,19,25,0.76,99,2013-12-01,CHA,MIA
7887,87,Home,L 98-112 ,240,35,87,0.402,27,65,0.415,8,22,0.364,20,26,0.769,98,44,87,0.506,34,64,0.531,10,23,0.435,14,19,0.737,112,2013-12-01,TOR,DEN
7888,88,Home,W 98-80 ,240,33,73,0.452,24,60,0.4,9,13,0.692,23,29,0.793,98,30,77,0.39,27,62,0.435,3,15,0.2,17,19,0.895,80,2013-12-02,WAS,ORL
7889,89,Home,W 98-88 ,240,37,91,0.407,32,77,0.416,5,14,0.357,19,24,0.792,98,36,92,0.391,30,69,0.435,6,23,0.261,10,13,0.769,88,2013-12-04,CLE,DEN
7890,90,Home,L 98-105 ,240,36,91,0.396,27,64,0.422,9,27,0.333,17,22,0.773,98,33,86,0.384,26,65,0.4,7,21,0.333,32,42,0.762,105,2013-12-04,MIL,DET
7891,91,@,L 98-106 ,240,34,77,0.442,28,60,0.467,6,17,0.353,24,29,0.828,98,43,83,0.518,37,63,0.587,6,20,0.3,14,18,0.778,106,2013-12-06,DEN,BOS
7892,92,@,L 98-130 ,240,39,93,0.419,35,82,0.427,4,11,0.364,16,19,0.842,98,46,83,0.554,29,60,0.483,17,23,0.739,21,24,0.875,130,2013-12-06,UTA,POR
7893,93,Home,W 98-88 ,240,32,76,0.421,22,43,0.512,10,33,0.303,24,42,0.571,98,32,93,0.344,24,64,0.375,8,29,0.276,16,28,0.571,88,2013-12-08,HOU,ORL
7894,94,@,L 98-104 ,240,40,80,0.5,34,65,0.523,6,15,0.4,12,17,0.706,98,39,76,0.513,30,54,0.556,9,22,0.409,17,20,0.85,104,2013-12-13,MEM,NOP
7895,95,@,L 98-101 ,240,37,82,0.451,30,58,0.517,7,24,0.292,17,26,0.654,98,39,87,0.448,34,68,0.5,5,19,0.263,18,20,0.9,101,2013-12-15,ORL,OKC
7896,96,Home,L 98-104 ,240,28,76,0.368,21,53,0.396,7,23,0.304,35,36,0.972,98,36,91,0.396,28,71,0.394,8,20,0.4,24,29,0.828,104,2013-12-22,OKC,TOR
7897,97,Home,L 98-103 ,240,37,89,0.416,29,64,0.453,8,25,0.32,16,22,0.727,98,39,86,0.453,29,65,0.446,10,21,0.476,15,19,0.789,103,2013-12-23,ORL,NYK
7898,98,Home,L 98-111 ,240,37,91,0.407,32,71,0.451,5,20,0.25,19,23,0.826,98,45,86,0.523,33,62,0.532,12,24,0.5,9,18,0.5,111,2013-12-25,SAS,HOU
7899,99,@,L 98-120 ,240,38,83,0.458,30,62,0.484,8,21,0.381,14,17,0.824,98,42,85,0.494,37,70,0.529,5,15,0.333,31,38,0.816,120,2013-12-27,WAS,MIN
7900,0,@,L 98-107 ,240,41,93,0.441,31,71,0.437,10,22,0.455,6,8,0.75,98,38,77,0.494,32,51,0.627,6,26,0.231,25,32,0.781,107,2013-12-28,NOP,HOU
7901,1,Home,W 98-90 ,240,35,77,0.455,32,63,0.508,3,14,0.214,25,32,0.781,98,32,76,0.421,25,57,0.439,7,19,0.368,19,21,0.905,90,2013-12-28,LAC,UTA
7902,2,Home,L 98-100 ,240,36,79,0.456,30,56,0.536,6,23,0.261,20,23,0.87,98,41,86,0.477,35,62,0.565,6,24,0.25,12,14,0.857,100,2013-12-30,MIN,DAL
7903,3,@,W 98-94 ,240,36,91,0.396,28,58,0.483,8,33,0.242,18,21,0.857,98,36,82,0.439,33,68,0.485,3,14,0.214,19,26,0.731,94,2013-12-31,POR,OKC
7904,4,@,L 98-129 ,240,35,91,0.385,31,73,0.425,4,18,0.222,24,32,0.75,98,43,83,0.518,29,52,0.558,14,31,0.452,29,38,0.763,129,2014-01-07,BOS,DEN
7905,5,@,L 98-102 ,240,36,78,0.462,27,52,0.519,9,26,0.346,17,23,0.739,98,34,77,0.442,29,58,0.5,5,19,0.263,29,35,0.829,102,2014-01-08,GSW,BRK
7906,6,Home,W 98-96 (OT),265,35,81,0.432,28,61,0.459,7,20,0.35,21,27,0.778,98,33,93,0.355,26,63,0.413,7,30,0.233,23,28,0.821,96,2014-01-13,NYK,PHO
7907,7,@,L 98-108 ,240,39,81,0.481,33,64,0.516,6,17,0.353,14,18,0.778,98,38,75,0.507,32,61,0.525,6,14,0.429,26,33,0.788,108,2014-01-14,NYK,CHA
7908,8,Home,W 98-72 ,240,36,83,0.434,30,66,0.455,6,17,0.353,20,34,0.588,98,21,73,0.288,14,48,0.292,7,25,0.28,23,29,0.793,72,2014-01-18,MIN,UTA
7909,9,Home,L 98-104 ,240,37,76,0.487,29,55,0.527,8,21,0.381,16,29,0.552,98,40,81,0.494,34,60,0.567,6,21,0.286,18,31,0.581,104,2014-01-18,WAS,DET
7910,10,@,W 98-87 ,240,37,70,0.529,27,49,0.551,10,21,0.476,14,18,0.778,98,33,88,0.375,25,69,0.362,8,19,0.421,13,18,0.722,87,2014-01-22,CHI,CLE
7911,11,@,L 98-119 ,240,34,86,0.395,22,56,0.393,12,30,0.4,18,30,0.6,98,43,90,0.478,35,59,0.593,8,31,0.258,25,40,0.625,119,2014-01-22,SAC,HOU
7912,12,@,W 98-81 ,240,43,83,0.518,37,70,0.529,6,13,0.462,6,10,0.6,98,30,87,0.345,26,63,0.413,4,24,0.167,17,22,0.773,81,2014-01-28,MEM,POR
7913,13,Home,L 98-101 ,240,39,100,0.39,30,72,0.417,9,28,0.321,11,13,0.846,98,33,78,0.423,28,64,0.438,5,14,0.357,30,42,0.714,101,2014-01-29,DEN,CHA
7914,14,Home,W 98-83 ,240,37,87,0.425,23,56,0.411,14,31,0.452,10,13,0.769,98,28,84,0.333,22,65,0.338,6,19,0.316,21,26,0.808,83,2014-01-29,TOR,ORL
7915,15,Home,W 98-79 ,240,38,90,0.422,30,65,0.462,8,25,0.32,14,17,0.824,98,33,83,0.398,26,67,0.388,7,16,0.438,6,10,0.6,79,2014-02-03,IND,ORL
7916,16,@,L 98-101 ,240,34,78,0.436,19,44,0.432,15,34,0.441,15,24,0.625,98,36,81,0.444,25,63,0.397,11,18,0.611,18,21,0.857,101,2014-02-03,NYK,MIL
7917,17,@,L 98-112 ,240,39,85,0.459,33,65,0.508,6,20,0.3,14,23,0.609,98,44,89,0.494,38,71,0.535,6,18,0.333,18,20,0.9,112,2014-02-05,DET,ORL
7918,18,Home,W 98-91 ,240,39,81,0.481,31,66,0.47,8,15,0.533,12,16,0.75,98,28,75,0.373,24,57,0.421,4,18,0.222,31,37,0.838,91,2014-02-07,NOP,MIN
7919,19,Home,L 98-112 ,240,37,87,0.425,22,55,0.4,15,32,0.469,9,17,0.529,98,45,89,0.506,37,71,0.521,8,18,0.444,14,20,0.7,112,2014-02-07,PHI,LAL
7920,20,@,W 98-95 ,240,40,83,0.482,33,69,0.478,7,14,0.5,11,12,0.917,98,32,85,0.376,25,62,0.403,7,23,0.304,24,27,0.889,95,2014-02-11,OKC,POR
7921,21,Home,L 98-102 ,240,39,80,0.488,33,64,0.516,6,16,0.375,14,19,0.737,98,41,79,0.519,35,66,0.53,6,13,0.462,14,17,0.824,102,2014-02-12,MIL,NOP
7922,22,@,L 98-108 ,240,37,77,0.481,25,51,0.49,12,26,0.462,12,19,0.632,98,39,79,0.494,30,56,0.536,9,23,0.391,21,26,0.808,108,2014-02-18,ATL,IND
7923,23,Home,W 98-93 ,240,37,75,0.493,31,63,0.492,6,12,0.5,18,24,0.75,98,35,85,0.412,29,58,0.5,6,27,0.222,17,20,0.85,93,2014-02-18,MEM,NYK
7924,24,@,L 98-116 ,240,38,90,0.422,30,72,0.417,8,18,0.444,14,20,0.7,98,42,82,0.512,34,62,0.548,8,20,0.4,24,31,0.774,116,2014-02-19,DET,CHA
7925,25,@,W 98-91 ,240,37,83,0.446,27,62,0.435,10,21,0.476,14,20,0.7,98,35,75,0.467,28,54,0.519,7,21,0.333,14,21,0.667,91,2014-02-19,NYK,NOP
7926,26,Home,W 98-91 ,240,40,93,0.43,33,72,0.458,7,21,0.333,11,13,0.846,98,32,82,0.39,26,62,0.419,6,20,0.3,21,29,0.724,91,2014-02-21,TOR,CLE
7927,27,@,L 98-107 ,240,39,89,0.438,29,61,0.475,10,28,0.357,10,16,0.625,98,32,74,0.432,16,43,0.372,16,31,0.516,27,33,0.818,107,2014-02-22,NYK,ATL
7928,28,@,L 98-105 ,240,34,87,0.391,28,66,0.424,6,21,0.286,24,36,0.667,98,38,73,0.521,33,64,0.516,5,9,0.556,24,28,0.857,105,2014-02-22,BOS,SAC
7929,29,@,L 98-110 ,240,37,84,0.44,33,69,0.478,4,15,0.267,20,21,0.952,98,44,80,0.55,38,63,0.603,6,17,0.353,16,21,0.762,110,2014-02-24,BOS,UTA
7930,30,@,L 98-118 ,240,39,90,0.433,31,67,0.463,8,23,0.348,12,20,0.6,98,47,101,0.465,42,85,0.494,5,16,0.313,19,25,0.76,118,2014-02-25,LAL,IND
7931,31,@,L 98-112 ,240,36,83,0.434,32,65,0.492,4,18,0.222,22,29,0.759,98,43,74,0.581,37,58,0.638,6,16,0.375,20,24,0.833,112,2014-03-01,ORL,MIA
7932,32,Home,L 98-107 ,240,34,74,0.459,29,62,0.468,5,12,0.417,25,31,0.806,98,37,83,0.446,27,58,0.466,10,25,0.4,23,31,0.742,107,2014-03-01,MIL,BRK
7933,33,@,L 98-104 ,240,37,88,0.42,29,65,0.446,8,23,0.348,16,20,0.8,98,38,79,0.481,30,57,0.526,8,22,0.364,20,23,0.87,104,2014-03-02,GSW,TOR
7934,34,@,W 98-96 ,240,37,84,0.44,27,64,0.422,10,20,0.5,14,21,0.667,98,36,86,0.419,33,70,0.471,3,16,0.188,21,22,0.955,96,2014-03-04,GSW,IND
7935,35,@,L 98-103 ,240,38,83,0.458,31,57,0.544,7,26,0.269,15,21,0.714,98,37,79,0.468,33,66,0.5,4,13,0.308,25,34,0.735,103,2014-03-07,POR,DAL
7936,36,@,L 98-105 ,240,36,83,0.434,31,59,0.525,5,24,0.208,21,31,0.677,98,37,81,0.457,29,61,0.475,8,20,0.4,23,28,0.821,105,2014-03-10,DEN,CHA
7937,37,@,L 98-105 ,240,42,88,0.477,33,65,0.508,9,23,0.391,5,8,0.625,98,38,84,0.452,30,57,0.526,8,27,0.296,21,25,0.84,105,2014-03-10,ORL,MIL
7938,38,@,L 98-106 ,240,33,79,0.418,24,54,0.444,9,25,0.36,23,34,0.676,98,34,80,0.425,23,51,0.451,11,29,0.379,27,34,0.794,106,2014-03-11,HOU,OKC
7939,39,@,L 98-111 ,240,36,82,0.439,28,61,0.459,8,21,0.381,18,25,0.72,98,43,88,0.489,35,70,0.5,8,18,0.444,17,24,0.708,111,2014-03-12,GSW,LAC
7940,40,Home,L 98-115 ,240,33,84,0.393,25,61,0.41,8,23,0.348,24,28,0.857,98,34,74,0.459,27,56,0.482,7,18,0.389,40,50,0.8,115,2014-03-12,PHI,SAC
7941,41,@,W 98-85 ,240,38,78,0.487,33,60,0.55,5,18,0.278,17,22,0.773,98,35,82,0.427,26,57,0.456,9,25,0.36,6,9,0.667,85,2014-03-12,CHA,WAS
7942,42,@,L 98-114 ,240,35,83,0.422,26,56,0.464,9,27,0.333,19,23,0.826,98,44,78,0.564,35,61,0.574,9,17,0.529,17,24,0.708,114,2014-03-21,BOS,BRK
7943,43,Home,W 98-92 ,240,33,73,0.452,25,48,0.521,8,25,0.32,24,35,0.686,98,39,90,0.433,35,74,0.473,4,16,0.25,10,26,0.385,92,2014-03-21,PHO,DET
7944,44,@,L 98-106 ,240,41,85,0.482,36,72,0.5,5,13,0.385,11,16,0.688,98,38,78,0.487,30,60,0.5,8,18,0.444,22,27,0.815,106,2014-03-24,MIL,LAC
7945,45,Home,W 98-96 ,240,38,90,0.422,35,78,0.449,3,12,0.25,19,25,0.76,98,33,80,0.413,20,50,0.4,13,30,0.433,17,28,0.607,96,2014-03-26,NOP,LAC
7946,46,@,L 98-120 ,240,35,90,0.389,21,54,0.389,14,36,0.389,14,22,0.636,98,44,90,0.489,35,64,0.547,9,26,0.346,23,34,0.676,120,2014-03-27,PHI,HOU
7947,47,@,L 98-123 ,240,33,85,0.388,27,64,0.422,6,21,0.286,26,32,0.813,98,48,92,0.522,36,71,0.507,12,21,0.571,15,19,0.789,123,2014-03-29,DET,PHI
7948,48,@,W 98-93 ,240,33,73,0.452,27,54,0.5,6,19,0.316,26,27,0.963,98,38,69,0.551,31,50,0.62,7,19,0.368,10,14,0.714,93,2014-03-30,TOR,ORL
7949,49,@,L 98-105 ,240,41,89,0.461,36,72,0.5,5,17,0.294,11,18,0.611,98,39,75,0.52,34,60,0.567,5,15,0.333,22,25,0.88,105,2014-03-30,MEM,POR
7950,50,Home,L 98-119 ,240,35,79,0.443,24,51,0.471,11,28,0.393,17,20,0.85,98,45,78,0.577,36,60,0.6,9,18,0.5,20,24,0.833,119,2014-04-02,ORL,CLE
7951,51,@,L 98-117 ,240,36,91,0.396,31,70,0.443,5,21,0.238,21,25,0.84,98,48,82,0.585,35,53,0.66,13,29,0.448,8,10,0.8,117,2014-04-04,CLE,ATL
7952,52,Home,L 98-102 ,240,38,79,0.481,37,70,0.529,1,9,0.111,21,27,0.778,98,36,81,0.444,24,54,0.444,12,27,0.444,18,22,0.818,102,2014-04-05,MIL,TOR
7953,53,@,L 98-106 ,240,40,86,0.465,35,69,0.507,5,17,0.294,13,23,0.565,98,40,81,0.494,35,62,0.565,5,19,0.263,21,23,0.913,106,2014-04-11,DET,CHI
7954,54,Home,W 98-86 ,240,35,75,0.467,29,59,0.492,6,16,0.375,22,28,0.786,98,31,65,0.477,23,51,0.451,8,14,0.571,16,19,0.842,86,2014-04-11,MIA,IND
7955,55,Home,W 98-85 ,240,36,78,0.462,26,56,0.464,10,22,0.455,16,19,0.842,98,35,73,0.479,29,48,0.604,6,25,0.24,9,19,0.474,85,2014-04-12,ATL,MIA
7956,56,@,L 98-101 ,240,36,78,0.462,28,61,0.459,8,17,0.471,18,23,0.783,98,39,79,0.494,28,55,0.509,11,24,0.458,12,15,0.8,101,2014-04-12,PHO,DAL
7957,57,@,L 98-104 ,240,39,89,0.438,35,72,0.486,4,17,0.235,16,18,0.889,98,38,85,0.447,34,63,0.54,4,22,0.182,24,29,0.828,104,2014-04-14,SAS,HOU
7958,58,Home,L 98-109 ,240,33,75,0.44,23,50,0.46,10,25,0.4,22,31,0.71,98,32,67,0.478,21,46,0.457,11,21,0.524,34,40,0.85,109,2014-04-15,BRK,NYK
7959,59,Home,L 98-105 ,240,37,72,0.514,31,57,0.544,6,15,0.4,18,24,0.75,98,39,80,0.488,32,67,0.478,7,13,0.538,20,26,0.769,105,2014-10-30,ORL,WAS
7960,60,@,W 98-92 ,240,34,68,0.5,31,58,0.534,3,10,0.3,27,33,0.818,98,33,88,0.375,24,57,0.421,9,31,0.29,17,21,0.81,92,2014-11-02,SAC,LAC
7961,61,Home,W 98-90 ,240,35,75,0.467,28,60,0.467,7,15,0.467,21,27,0.778,98,38,88,0.432,32,74,0.432,6,14,0.429,8,14,0.571,90,2014-11-04,CHI,ORL
7962,62,@,W 98-83 ,240,39,80,0.488,31,62,0.5,8,18,0.444,12,19,0.632,98,30,81,0.37,22,66,0.333,8,15,0.533,15,19,0.789,83,2014-11-04,WAS,NYK
7963,63,@,W 98-91 ,240,37,90,0.411,30,73,0.411,7,17,0.412,17,22,0.773,98,36,82,0.439,28,61,0.459,8,21,0.381,11,17,0.647,91,2014-11-05,MIN,BRK
7964,64,Home,W 98-95 ,240,32,87,0.368,21,64,0.328,11,23,0.478,23,33,0.697,98,39,90,0.433,30,70,0.429,9,20,0.45,8,10,0.8,95,2014-11-05,DET,NYK
7965,65,Home,W 98-81 ,240,34,72,0.472,24,45,0.533,10,27,0.37,20,33,0.606,98,31,90,0.344,29,70,0.414,2,20,0.1,17,19,0.895,81,2014-11-06,HOU,SAS
7966,66,@,L 98-101 ,240,40,88,0.455,35,69,0.507,5,19,0.263,13,13,1.0,98,39,85,0.459,30,58,0.517,9,27,0.333,14,16,0.875,101,2014-11-07,IND,BOS
7967,67,Home,W 98-95 ,240,37,75,0.493,26,52,0.5,11,23,0.478,13,24,0.542,98,36,77,0.468,31,57,0.544,5,20,0.25,18,23,0.783,95,2014-11-07,DET,MIL
7968,68,@,W 98-87 ,240,39,87,0.448,30,59,0.508,9,28,0.321,11,17,0.647,98,30,86,0.349,20,44,0.455,10,42,0.238,17,21,0.81,87,2014-11-08,GSW,HOU
7969,69,@,L 98-106 ,240,32,72,0.444,23,53,0.434,9,19,0.474,25,32,0.781,98,38,80,0.475,28,53,0.528,10,27,0.37,20,24,0.833,106,2014-11-11,SAC,DAL
7970,70,Home,W 98-93 ,240,42,84,0.5,39,74,0.527,3,10,0.3,11,16,0.688,98,37,78,0.474,30,61,0.492,7,17,0.412,12,18,0.667,93,2014-11-15,WAS,ORL
7971,71,Home,W 98-81 ,240,35,81,0.432,25,57,0.439,10,24,0.417,18,26,0.692,98,30,84,0.357,22,61,0.361,8,23,0.348,13,19,0.684,81,2014-11-18,UTA,OKC
7972,72,@,W 98-92 ,240,37,91,0.407,32,71,0.451,5,20,0.25,19,23,0.826,98,30,74,0.405,15,36,0.417,15,38,0.395,17,23,0.739,92,2014-11-19,LAL,HOU
7973,73,Home,W 98-86 ,240,39,90,0.433,29,68,0.426,10,22,0.455,10,13,0.769,98,36,78,0.462,29,58,0.5,7,20,0.35,7,17,0.412,86,2014-11-25,MIL,DET
7974,74,Home,L 98-104 ,240,35,78,0.449,25,51,0.49,10,27,0.37,18,24,0.75,98,37,78,0.474,25,50,0.5,12,28,0.429,18,19,0.947,104,2014-11-26,DET,LAC
7975,75,Home,W 98-83 ,240,41,94,0.436,37,78,0.474,4,16,0.25,12,14,0.857,98,31,70,0.443,24,52,0.462,7,18,0.389,14,16,0.875,83,2014-11-28,IND,ORL
7976,76,Home,W 98-97 ,240,38,82,0.463,30,55,0.545,8,27,0.296,14,18,0.778,98,39,87,0.448,33,70,0.471,6,17,0.353,13,14,0.929,97,2014-12-02,GSW,ORL
7977,77,@,W 98-93 ,240,39,89,0.438,33,72,0.458,6,17,0.353,14,20,0.7,98,35,81,0.432,24,53,0.453,11,28,0.393,12,14,0.857,93,2014-12-02,BRK,NYK
7978,78,@,W 98-75 ,240,35,81,0.432,22,47,0.468,13,34,0.382,15,24,0.625,98,30,80,0.375,27,62,0.435,3,18,0.167,12,19,0.632,75,2014-12-05,ATL,BRK
7979,79,@,W 98-93 ,240,37,74,0.5,30,57,0.526,7,17,0.412,17,20,0.85,98,36,79,0.456,28,63,0.444,8,16,0.5,13,21,0.619,93,2014-12-05,ORL,UTA
7980,80,@,W 98-86 ,240,41,84,0.488,32,63,0.508,9,21,0.429,7,8,0.875,98,34,97,0.351,29,75,0.387,5,22,0.227,13,16,0.813,86,2014-12-09,POR,DET
7981,81,Home,W 98-95 ,240,38,96,0.396,33,71,0.465,5,25,0.2,17,25,0.68,98,32,70,0.457,25,55,0.455,7,15,0.467,24,37,0.649,95,2014-12-09,LAL,SAC
7982,82,Home,L 98-105 ,240,36,89,0.404,31,64,0.484,5,25,0.2,21,30,0.7,98,37,83,0.446,27,51,0.529,10,32,0.313,21,27,0.778,105,2014-12-13,DAL,GSW
7983,83,@,L 98-105 ,240,39,95,0.411,30,64,0.469,9,31,0.29,11,12,0.917,98,42,92,0.457,37,78,0.474,5,14,0.357,16,19,0.842,105,2014-12-16,GSW,MEM
7984,84,Home,L 98-127 ,240,37,82,0.451,29,52,0.558,8,30,0.267,16,21,0.762,98,49,76,0.645,33,48,0.688,16,28,0.571,13,16,0.813,127,2014-12-17,CLE,ATL
7985,85,@,L 98-114 ,240,42,93,0.452,36,81,0.444,6,12,0.5,8,16,0.5,98,48,85,0.565,40,62,0.645,8,23,0.348,10,14,0.714,114,2014-12-19,MIN,BOS
7986,86,@,L 98-102 ,240,36,99,0.364,25,70,0.357,11,29,0.379,15,20,0.75,98,42,83,0.506,37,65,0.569,5,18,0.278,13,24,0.542,102,2014-12-26,LAL,DAL
7987,87,Home,W 98-75 ,240,36,88,0.409,28,61,0.459,8,27,0.296,18,21,0.857,98,25,87,0.287,20,63,0.317,5,24,0.208,20,26,0.769,75,2014-12-26,OKC,CHO
7988,88,@,W 98-89 ,240,33,80,0.413,25,50,0.5,8,30,0.267,24,26,0.923,98,36,73,0.493,27,52,0.519,9,21,0.429,8,12,0.667,89,2014-12-26,CLE,ORL
7989,89,Home,L 98-110 ,240,37,81,0.457,25,56,0.446,12,25,0.48,12,15,0.8,98,41,86,0.477,28,52,0.538,13,34,0.382,15,19,0.789,110,2014-12-27,LAC,TOR
7990,90,Home,L 98-100 ,240,37,88,0.42,26,66,0.394,11,22,0.5,13,20,0.65,98,41,72,0.569,34,52,0.654,7,20,0.35,11,18,0.611,100,2015-01-02,ORL,BRK
7991,91,@,W 98-92 ,240,33,81,0.407,27,58,0.466,6,23,0.261,26,30,0.867,98,32,86,0.372,22,55,0.4,10,31,0.323,18,24,0.75,92,2015-01-02,ATL,UTA
7992,92,@,W 98-90 ,240,35,78,0.449,31,62,0.5,4,16,0.25,24,32,0.75,98,33,87,0.379,29,68,0.426,4,19,0.211,20,21,0.952,90,2015-01-03,CHA,ORL
7993,93,Home,L 98-107 ,240,33,74,0.446,26,49,0.531,7,25,0.28,25,33,0.758,98,36,81,0.444,23,54,0.426,13,27,0.481,22,33,0.667,107,2015-01-05,LAC,ATL
7994,94,Home,W 98-94 ,240,33,83,0.398,22,57,0.386,11,26,0.423,21,24,0.875,98,37,88,0.42,33,74,0.446,4,14,0.286,16,20,0.8,94,2015-01-05,POR,LAL
7995,95,Home,W 98-94 ,240,37,86,0.43,33,72,0.458,4,14,0.286,20,26,0.769,98,36,80,0.45,30,62,0.484,6,18,0.333,16,24,0.667,94,2015-01-07,CHA,NOP
7996,96,Home,W 98-84 ,240,39,75,0.52,27,56,0.482,12,19,0.632,8,10,0.8,98,32,79,0.405,26,57,0.456,6,22,0.273,14,17,0.824,84,2015-01-09,MIL,MIN
7997,97,Home,W 98-93 ,240,34,80,0.425,23,47,0.489,11,33,0.333,19,26,0.731,98,37,88,0.42,28,57,0.491,9,31,0.29,10,10,1.0,93,2015-01-10,DET,BRK
7998,98,@,W 98-93 ,240,37,85,0.435,29,64,0.453,8,21,0.381,16,20,0.8,98,33,86,0.384,29,73,0.397,4,13,0.308,23,35,0.657,93,2015-01-14,SAS,CHO
7999,99,@,W 98-96 ,240,32,85,0.376,19,54,0.352,13,31,0.419,21,24,0.875,98,40,89,0.449,34,71,0.479,6,18,0.333,10,12,0.833,96,2015-01-16,DET,IND
8000,0,@,L 98-102 ,240,36,93,0.387,23,57,0.404,13,36,0.361,13,15,0.867,98,39,77,0.506,31,62,0.5,8,15,0.533,16,24,0.667,102,2015-01-17,POR,MEM
8001,1,@,L 98-110 ,240,39,85,0.459,33,58,0.569,6,27,0.222,14,18,0.778,98,37,72,0.514,25,41,0.61,12,31,0.387,24,33,0.727,110,2015-01-19,IND,HOU
8002,2,Home,W 98-94 ,240,35,88,0.398,24,52,0.462,11,36,0.306,17,26,0.654,98,34,76,0.447,30,64,0.469,4,12,0.333,22,30,0.733,94,2015-01-19,POR,SAC
8003,3,@,W 98-75 ,240,39,76,0.513,28,49,0.571,11,27,0.407,9,14,0.643,98,31,89,0.348,29,74,0.392,2,15,0.133,11,15,0.733,75,2015-01-21,DAL,MIN
8004,4,@,W 98-91 ,240,37,91,0.407,30,71,0.423,7,20,0.35,17,20,0.85,98,29,79,0.367,21,56,0.375,8,23,0.348,25,32,0.781,91,2015-01-21,NYK,PHI
8005,5,Home,L 98-102 ,240,37,82,0.451,31,64,0.484,6,18,0.333,18,18,1.0,98,38,78,0.487,29,62,0.468,9,16,0.563,17,20,0.85,102,2015-01-23,DAL,CHI
8006,6,@,L 98-108 ,240,37,94,0.394,27,64,0.422,10,30,0.333,14,18,0.778,98,36,82,0.439,20,46,0.435,16,36,0.444,20,29,0.69,108,2015-01-25,OKC,CLE
8007,7,@,L 98-102 ,240,40,83,0.482,32,62,0.516,8,21,0.381,10,15,0.667,98,38,80,0.475,31,61,0.508,7,19,0.368,19,22,0.864,102,2015-01-26,DEN,LAC
8008,8,@,W 98-92 ,240,38,78,0.487,34,62,0.548,4,16,0.25,18,27,0.667,98,37,87,0.425,32,67,0.478,5,20,0.25,13,16,0.813,92,2015-01-27,WAS,LAL
8009,9,@,L 98-110 ,240,42,91,0.462,35,68,0.515,7,23,0.304,7,9,0.778,98,38,77,0.494,32,61,0.525,6,16,0.375,28,32,0.875,110,2015-01-28,BOS,MIN
8010,10,@,L 98-106 ,240,37,88,0.42,29,70,0.414,8,18,0.444,16,23,0.696,98,40,88,0.455,29,59,0.492,11,29,0.379,15,18,0.833,106,2015-01-28,WAS,PHO
8011,11,@,L 98-105 ,240,33,85,0.388,21,54,0.389,12,31,0.387,20,28,0.714,98,31,70,0.443,20,43,0.465,11,27,0.407,32,42,0.762,105,2015-02-03,DEN,PHI
8012,12,Home,W 98-88 ,240,37,82,0.451,33,58,0.569,4,24,0.167,20,26,0.769,98,33,85,0.388,28,63,0.444,5,22,0.227,17,22,0.773,88,2015-02-06,DET,DEN
8013,13,Home,W 98-85 ,240,40,83,0.482,29,54,0.537,11,29,0.379,7,9,0.778,98,36,80,0.45,31,64,0.484,5,16,0.313,8,9,0.889,85,2015-02-06,SAS,MIA
8014,14,Home,L 98-109 ,240,31,82,0.378,18,47,0.383,13,35,0.371,23,34,0.676,98,40,76,0.526,31,47,0.66,9,29,0.31,20,23,0.87,109,2015-02-08,HOU,POR
8015,15,@,W 98-97 ,240,37,77,0.481,29,55,0.527,8,22,0.364,16,18,0.889,98,39,83,0.47,30,58,0.517,9,25,0.36,10,13,0.769,97,2015-02-08,CHI,ORL
8016,16,Home,L 98-115 ,240,33,81,0.407,23,47,0.489,10,34,0.294,22,30,0.733,98,41,92,0.446,32,65,0.492,9,27,0.333,24,29,0.828,115,2015-02-09,DAL,LAC
8017,17,@,L 98-113 ,240,37,85,0.435,29,54,0.537,8,31,0.258,16,22,0.727,98,42,92,0.457,33,69,0.478,9,23,0.391,20,26,0.769,113,2015-02-12,CLE,CHI
8018,18,Home,W 98-76 ,240,35,84,0.417,29,55,0.527,6,29,0.207,22,31,0.71,98,25,77,0.325,21,59,0.356,4,18,0.222,22,28,0.786,76,2015-02-21,HOU,TOR
8019,19,@,L 98-104 ,240,34,89,0.382,25,63,0.397,9,26,0.346,21,22,0.955,98,39,81,0.481,31,62,0.5,8,19,0.421,18,23,0.783,104,2015-02-22,GSW,IND
8020,20,@,L 98-103 ,240,36,78,0.462,23,44,0.523,13,34,0.382,13,17,0.765,98,39,82,0.476,33,59,0.559,6,23,0.261,19,26,0.731,103,2015-02-22,PHI,ORL
8021,21,@,W 98-92 ,240,42,89,0.472,39,80,0.488,3,9,0.333,11,13,0.846,98,33,82,0.402,20,49,0.408,13,33,0.394,13,16,0.813,92,2015-02-22,MEM,POR
8022,22,@,W 98-86 ,240,39,84,0.464,35,70,0.5,4,14,0.286,16,21,0.762,98,34,77,0.442,31,60,0.517,3,17,0.176,15,23,0.652,86,2015-02-25,CHA,CHI
8023,23,@,L 98-106 ,240,37,82,0.451,27,61,0.443,10,21,0.476,14,17,0.824,98,40,96,0.417,26,61,0.426,14,35,0.4,12,15,0.8,106,2015-02-27,CHA,BOS
8024,24,@,L 98-102 ,240,38,85,0.447,34,68,0.5,4,17,0.235,18,20,0.9,98,39,84,0.464,30,52,0.577,9,32,0.281,15,17,0.882,102,2015-02-27,BRK,HOU
8025,25,@,L 98-103 ,240,34,81,0.42,26,52,0.5,8,29,0.276,22,28,0.786,98,33,75,0.44,26,56,0.464,7,19,0.368,30,38,0.789,103,2015-02-28,TOR,NYK
8026,26,@,W 98-83 ,240,40,80,0.5,32,62,0.516,8,18,0.444,10,14,0.714,98,31,85,0.365,25,70,0.357,6,15,0.4,15,20,0.75,83,2015-03-01,CHA,ORL
8027,27,@,L 98-115 ,240,33,78,0.423,26,47,0.553,7,31,0.226,25,38,0.658,98,43,82,0.524,36,68,0.529,7,14,0.5,22,30,0.733,115,2015-03-02,PHO,MIA
8028,28,@,W 98-93 (OT),265,34,87,0.391,26,55,0.473,8,32,0.25,22,29,0.759,98,37,96,0.385,26,65,0.4,11,31,0.355,8,18,0.444,93,2015-03-04,POR,LAC
8029,29,Home,W 98-84 ,240,34,80,0.425,28,60,0.467,6,20,0.3,24,33,0.727,98,31,86,0.36,26,63,0.413,5,23,0.217,17,19,0.895,84,2015-03-06,IND,CHI
8030,30,Home,L 98-104 ,240,38,80,0.475,30,59,0.508,8,21,0.381,14,15,0.933,98,36,79,0.456,26,56,0.464,10,23,0.435,22,25,0.88,104,2015-03-06,NOP,BOS
8031,31,@,L 98-106 ,240,40,83,0.482,32,58,0.552,8,25,0.32,10,14,0.714,98,40,80,0.5,30,58,0.517,10,22,0.455,16,23,0.696,106,2015-03-08,LAC,GSW
8032,32,@,L 98-103 ,240,35,89,0.393,20,55,0.364,15,34,0.441,13,16,0.813,98,38,87,0.437,31,65,0.477,7,22,0.318,20,30,0.667,103,2015-03-08,BOS,ORL
8033,33,@,W 98-80 ,240,35,83,0.422,22,52,0.423,13,31,0.419,15,19,0.789,98,29,77,0.377,25,66,0.379,4,11,0.364,18,23,0.783,80,2015-03-09,GSW,PHO
8034,34,@,L 98-105 ,240,42,98,0.429,38,86,0.442,4,12,0.333,10,12,0.833,98,44,84,0.524,37,64,0.578,7,20,0.35,10,13,0.769,105,2015-03-11,DET,GSW
8035,35,@,L 98-104 ,240,32,73,0.438,26,56,0.464,6,17,0.353,28,39,0.718,98,37,81,0.457,31,60,0.517,6,21,0.286,24,38,0.632,104,2015-03-11,BRK,MIA
8036,36,Home,L 98-100 ,240,36,82,0.439,24,56,0.429,12,26,0.462,14,24,0.583,98,32,86,0.372,25,56,0.446,7,30,0.233,29,36,0.806,100,2015-03-15,LAC,HOU
8037,37,Home,L 98-117 ,240,38,88,0.432,36,69,0.522,2,19,0.105,20,25,0.8,98,39,82,0.476,27,59,0.458,12,23,0.522,27,33,0.818,117,2015-03-16,IND,TOR
8038,38,Home,L 98-109 ,240,41,74,0.554,37,63,0.587,4,11,0.364,12,16,0.75,98,45,89,0.506,39,71,0.549,6,18,0.333,13,16,0.813,109,2015-03-22,MIN,CHO
8039,39,Home,W 98-92 ,240,39,76,0.513,33,55,0.6,6,21,0.286,14,23,0.609,98,37,96,0.385,32,77,0.416,5,19,0.263,13,22,0.591,92,2015-03-22,PHO,DAL
8040,40,Home,W 98-86 ,240,37,82,0.451,34,66,0.515,3,16,0.188,21,29,0.724,98,28,81,0.346,20,61,0.328,8,20,0.4,22,28,0.786,86,2015-03-23,CHI,CHO
8041,41,@,L 98-106 ,240,37,81,0.457,29,51,0.569,8,30,0.267,16,20,0.8,98,40,86,0.465,31,63,0.492,9,23,0.391,17,19,0.895,106,2015-03-27,CLE,BRK
8042,42,Home,L 98-119 ,240,36,86,0.419,25,55,0.455,11,31,0.355,15,27,0.556,98,44,82,0.537,32,53,0.604,12,29,0.414,19,31,0.613,119,2015-03-27,PHI,LAC
8043,43,Home,L 98-100 ,240,37,81,0.457,26,58,0.448,11,23,0.478,13,15,0.867,98,41,81,0.506,32,65,0.492,9,16,0.563,9,12,0.75,100,2015-04-01,NYK,BRK
8044,44,Home,W 98-84 ,240,37,77,0.481,28,54,0.519,9,23,0.391,15,24,0.625,98,33,95,0.347,26,62,0.419,7,33,0.212,11,12,0.917,84,2015-04-01,UTA,DEN
8045,45,@,L 98-99 ,240,37,77,0.481,32,57,0.561,5,20,0.25,19,26,0.731,98,36,73,0.493,24,47,0.511,12,26,0.462,15,23,0.652,99,2015-04-04,MIA,DET
8046,46,@,L 98-110 ,240,39,84,0.464,29,59,0.492,10,25,0.4,10,16,0.625,98,48,95,0.505,41,74,0.554,7,21,0.333,7,9,0.778,110,2015-04-08,HOU,SAS
8047,47,@,L 98-106 ,240,32,74,0.432,29,59,0.492,3,15,0.2,31,34,0.912,98,41,83,0.494,32,60,0.533,9,23,0.391,15,24,0.625,106,2015-04-10,MIN,LAL
8048,48,@,L 98-114 ,240,38,91,0.418,31,66,0.47,7,25,0.28,15,18,0.833,98,39,86,0.453,30,61,0.492,9,25,0.36,27,34,0.794,114,2015-04-15,POR,DAL
8049,49,Home,W 98-94 (OT),265,39,104,0.375,33,76,0.434,6,28,0.214,14,28,0.5,98,34,84,0.405,27,62,0.435,7,22,0.318,19,26,0.731,94,2015-10-30,DET,CHI
8050,50,@,W 98-92 ,240,37,90,0.411,30,69,0.435,7,21,0.333,17,22,0.773,98,38,86,0.442,33,58,0.569,5,28,0.179,11,16,0.688,92,2015-11-03,ATL,MIA
8051,51,@,L 98-100 ,240,35,83,0.422,25,56,0.446,10,27,0.37,18,22,0.818,98,35,91,0.385,27,68,0.397,8,23,0.348,22,29,0.759,100,2015-11-04,BOS,IND
8052,52,Home,L 98-103 ,240,39,82,0.476,31,59,0.525,8,23,0.348,12,14,0.857,98,33,79,0.418,28,65,0.431,5,14,0.357,32,39,0.821,103,2015-11-04,OKC,TOR
8053,53,@,L 98-104 ,240,38,84,0.452,33,71,0.465,5,13,0.385,17,20,0.85,98,40,90,0.444,33,72,0.458,7,18,0.389,17,21,0.81,104,2015-11-05,OKC,CHI
8054,54,@,L 98-118 ,240,36,88,0.409,28,63,0.444,8,25,0.32,18,23,0.783,98,44,97,0.454,32,67,0.478,12,30,0.4,18,23,0.783,118,2015-11-06,WAS,BOS
8055,55,Home,L 98-104 ,240,40,93,0.43,37,74,0.5,3,19,0.158,15,20,0.75,98,33,78,0.423,26,55,0.473,7,23,0.304,31,40,0.775,104,2015-11-06,BRK,LAL
8056,56,@,L 98-107 ,240,39,86,0.453,30,58,0.517,9,28,0.321,11,13,0.846,98,40,84,0.476,31,60,0.517,9,24,0.375,18,22,0.818,107,2015-11-07,NOP,DAL
8057,57,@,L 98-106 ,240,37,83,0.446,23,54,0.426,14,29,0.483,10,15,0.667,98,42,86,0.488,32,60,0.533,10,26,0.385,12,16,0.75,106,2015-11-11,NOP,ATL
8058,58,Home,L 98-106 ,240,42,98,0.429,34,64,0.531,8,34,0.235,6,12,0.5,98,42,98,0.429,34,81,0.42,8,17,0.471,14,17,0.824,106,2015-11-11,HOU,BRK
8059,59,@,L 98-107 ,240,33,77,0.429,24,48,0.5,9,29,0.31,23,31,0.742,98,37,81,0.457,28,61,0.459,9,20,0.45,24,32,0.75,107,2015-11-13,HOU,DEN
8060,60,Home,L 98-110 ,240,32,84,0.381,23,50,0.46,9,34,0.265,25,32,0.781,98,43,89,0.483,35,61,0.574,8,28,0.286,16,21,0.762,110,2015-11-14,HOU,DAL
8061,61,Home,L 98-115 ,240,41,83,0.494,34,60,0.567,7,23,0.304,9,11,0.818,98,45,85,0.529,30,55,0.545,15,30,0.5,10,13,0.769,115,2015-11-17,NOP,DEN
8062,62,@,L 98-109 ,240,38,98,0.388,33,83,0.398,5,15,0.333,17,18,0.944,98,42,86,0.488,33,68,0.485,9,18,0.5,16,20,0.8,109,2015-11-18,DEN,SAS
8063,63,Home,W 98-84 ,240,42,82,0.512,33,62,0.532,9,20,0.45,5,10,0.5,98,34,73,0.466,27,54,0.5,7,19,0.368,9,10,0.9,84,2015-11-23,SAS,PHO
8064,64,@,L 98-112 ,240,36,84,0.429,27,47,0.574,9,37,0.243,17,22,0.773,98,36,79,0.456,27,48,0.563,9,31,0.29,31,44,0.705,112,2015-11-30,DAL,SAC
8065,65,Home,L 98-114 ,240,39,89,0.438,34,72,0.472,5,17,0.294,15,23,0.652,98,44,86,0.512,30,53,0.566,14,33,0.424,12,23,0.522,114,2015-12-06,BRK,GSW
8066,66,Home,W 98-95 ,240,35,86,0.407,29,64,0.453,6,22,0.273,22,31,0.71,98,35,88,0.398,28,64,0.438,7,24,0.292,18,30,0.6,95,2015-12-06,OKC,SAC
8067,67,@,W 98-95 ,240,39,81,0.481,33,61,0.541,6,20,0.3,14,18,0.778,98,36,100,0.36,29,69,0.42,7,31,0.226,16,19,0.842,95,2015-12-09,ATL,DAL
8068,68,Home,W 98-94 ,240,33,78,0.423,25,58,0.431,8,20,0.4,24,29,0.828,98,40,89,0.449,34,73,0.466,6,16,0.375,8,11,0.727,94,2015-12-12,CHI,NOP
8069,69,@,W 98-93 ,240,40,96,0.417,31,71,0.437,9,25,0.36,9,10,0.9,98,36,88,0.409,25,53,0.472,11,35,0.314,10,10,1.0,93,2015-12-12,BOS,CHO
8070,70,@,L 98-104 (OT),265,39,94,0.415,31,72,0.431,8,22,0.364,12,20,0.6,98,35,79,0.443,28,58,0.483,7,21,0.333,27,30,0.9,104,2015-12-13,UTA,OKC
8071,71,Home,L 98-104 ,240,42,89,0.472,38,73,0.521,4,16,0.25,10,14,0.714,98,40,75,0.533,33,54,0.611,7,21,0.333,17,24,0.708,104,2015-12-16,BRK,MIA
8072,72,Home,W 98-85 ,240,38,86,0.442,29,62,0.468,9,24,0.375,13,19,0.684,98,32,76,0.421,27,57,0.474,5,19,0.263,16,28,0.571,85,2015-12-16,CHI,MEM
8073,73,@,L 98-113 ,240,36,79,0.456,22,45,0.489,14,34,0.412,12,15,0.8,98,43,77,0.558,29,53,0.547,14,24,0.583,13,15,0.867,113,2015-12-16,CHA,ORL
8074,74,@,L 98-117 ,240,39,81,0.481,32,57,0.561,7,24,0.292,13,17,0.765,98,47,88,0.534,39,63,0.619,8,25,0.32,15,18,0.833,117,2015-12-26,NYK,ATL
8075,75,Home,W 98-92 ,240,28,69,0.406,14,37,0.378,14,32,0.438,28,32,0.875,98,37,90,0.411,30,71,0.423,7,19,0.368,11,21,0.524,92,2015-12-26,CHA,MEM
8076,76,@,W 98-94 ,240,38,92,0.413,28,59,0.475,10,33,0.303,12,16,0.75,98,30,76,0.395,21,52,0.404,9,24,0.375,25,31,0.806,94,2015-12-27,POR,SAC
8077,77,@,L 98-108 ,240,35,85,0.412,26,56,0.464,9,29,0.31,19,23,0.826,98,43,89,0.483,37,64,0.578,6,25,0.24,16,22,0.727,108,2015-12-28,LAL,CHO
8078,78,Home,L 98-105 ,240,36,83,0.434,26,57,0.456,10,26,0.385,16,19,0.842,98,40,83,0.482,34,63,0.54,6,20,0.3,19,24,0.792,105,2016-01-02,DAL,NOP
8079,79,Home,L 98-123 ,240,37,77,0.481,34,65,0.523,3,12,0.25,21,30,0.7,98,49,90,0.544,40,70,0.571,9,20,0.45,16,20,0.8,123,2016-01-04,MIL,SAS
8080,80,@,W 98-90 ,240,39,70,0.557,36,62,0.581,3,8,0.375,17,18,0.944,98,37,82,0.451,35,65,0.538,2,17,0.118,14,15,0.933,90,2016-01-06,NYK,MIA
8081,81,Home,L 98-109 ,240,38,86,0.442,29,60,0.483,9,26,0.346,13,23,0.565,98,42,83,0.506,31,60,0.517,11,23,0.478,14,17,0.824,109,2016-01-06,POR,LAC
8082,82,@,L 98-123 ,240,37,79,0.468,30,61,0.492,7,18,0.389,17,18,0.944,98,52,86,0.605,43,65,0.662,9,21,0.429,10,13,0.769,123,2016-01-06,UTA,SAS
8083,83,Home,L 98-126 ,240,39,86,0.453,34,68,0.5,5,18,0.278,15,25,0.6,98,49,92,0.533,36,60,0.6,13,32,0.406,15,19,0.789,126,2016-01-07,PHI,ATL
8084,84,Home,W 98-83 ,240,39,71,0.549,30,51,0.588,9,20,0.45,11,18,0.611,98,34,82,0.415,28,63,0.444,6,19,0.316,9,17,0.529,83,2016-01-09,UTA,MIA
8085,85,@,L 98-101 ,240,37,88,0.42,30,66,0.455,7,22,0.318,17,23,0.739,98,31,84,0.369,27,68,0.397,4,16,0.25,35,40,0.875,101,2016-01-10,BOS,MEM
8086,86,@,L 98-116 ,240,40,90,0.444,36,67,0.537,4,23,0.174,14,24,0.583,98,43,86,0.5,30,53,0.566,13,33,0.394,17,20,0.85,116,2016-01-14,LAL,GSW
8087,87,@,W 98-95 ,240,40,81,0.494,36,69,0.522,4,12,0.333,14,19,0.737,98,32,78,0.41,26,60,0.433,6,18,0.333,25,26,0.962,95,2016-01-15,MIA,DEN
8088,88,Home,W 98-81 ,240,41,80,0.513,32,61,0.525,9,19,0.474,7,10,0.7,98,30,87,0.345,24,65,0.369,6,22,0.273,15,20,0.75,81,2016-01-18,ATL,ORL
8089,89,Home,L 98-132 ,240,37,77,0.481,30,58,0.517,7,19,0.368,17,25,0.68,98,46,85,0.541,27,45,0.6,19,40,0.475,21,27,0.778,132,2016-01-18,CLE,GSW
8090,90,Home,L 98-108 ,240,37,77,0.481,28,56,0.5,9,21,0.429,15,20,0.75,98,43,84,0.512,26,53,0.491,17,31,0.548,5,11,0.455,108,2016-01-18,WAS,POR
8091,91,Home,L 98-104 ,240,41,94,0.436,32,63,0.508,9,31,0.29,7,11,0.636,98,39,87,0.448,29,63,0.46,10,24,0.417,16,23,0.696,104,2016-01-20,POR,ATL
8092,92,@,L 98-102 ,240,39,85,0.459,36,71,0.507,3,14,0.214,17,22,0.773,98,38,94,0.404,23,50,0.46,15,44,0.341,11,16,0.688,102,2016-01-22,MIL,HOU
8093,93,Home,W 98-95 ,240,34,85,0.4,24,61,0.393,10,24,0.417,20,26,0.769,98,34,84,0.405,22,50,0.44,12,34,0.353,15,18,0.833,95,2016-01-23,PHO,ATL
8094,94,Home,L 98-102 ,240,36,71,0.507,27,53,0.509,9,18,0.5,17,23,0.739,98,45,83,0.542,42,74,0.568,3,9,0.333,9,10,0.9,102,2016-01-26,BRK,MIA
8095,95,@,L 98-114 ,240,40,86,0.465,33,60,0.55,7,26,0.269,11,15,0.733,98,43,83,0.518,36,61,0.59,7,22,0.318,21,27,0.778,114,2016-02-01,WAS,OKC
8096,96,@,W 98-95 ,240,43,94,0.457,43,85,0.506,0,9,0.0,12,18,0.667,98,36,81,0.444,26,55,0.473,10,26,0.385,13,15,0.867,95,2016-02-05,MIA,CHO
8097,97,@,L 98-103 ,240,35,76,0.461,30,61,0.492,5,15,0.333,23,26,0.885,98,38,81,0.469,28,52,0.538,10,29,0.345,17,22,0.773,103,2016-02-06,BRK,PHI
8098,98,@,W 98-89 ,240,34,78,0.436,29,62,0.468,5,16,0.313,25,31,0.806,98,30,80,0.375,21,56,0.375,9,24,0.375,20,26,0.769,89,2016-02-06,UTA,PHO
8099,99,@,W 98-92 (OT),265,35,95,0.368,30,73,0.411,5,22,0.227,23,31,0.742,98,34,90,0.378,28,65,0.431,6,25,0.24,18,21,0.857,92,2016-02-08,LAC,PHI
8100,0,@,W 98-96 ,240,38,89,0.427,30,69,0.435,8,20,0.4,14,15,0.933,98,37,91,0.407,29,71,0.408,8,20,0.4,14,16,0.875,96,2016-02-10,SAS,ORL
8101,1,@,L 98-109 ,240,36,82,0.439,26,56,0.464,10,26,0.385,16,18,0.889,98,42,86,0.488,34,69,0.493,8,17,0.471,17,20,0.85,109,2016-02-19,NYK,BRK
8102,2,@,W 98-95 ,240,37,86,0.43,28,55,0.509,9,31,0.29,15,18,0.833,98,36,81,0.444,29,62,0.468,7,19,0.368,16,21,0.762,95,2016-02-19,CHA,MIL
8103,3,Home,L 98-101 ,240,42,96,0.438,37,70,0.529,5,26,0.192,9,10,0.9,98,39,88,0.443,30,66,0.455,9,22,0.409,14,22,0.636,101,2016-02-19,OKC,IND
8104,4,Home,W 98-86 ,240,36,78,0.462,29,56,0.518,7,22,0.318,19,26,0.731,98,35,82,0.427,28,59,0.475,7,23,0.304,9,17,0.529,86,2016-02-19,WAS,DET
8105,5,Home,W 98-85 ,240,33,81,0.407,26,53,0.491,7,28,0.25,25,31,0.806,98,28,76,0.368,25,56,0.446,3,20,0.15,26,32,0.813,85,2016-02-21,TOR,MEM
8106,6,@,W 98-96 ,240,40,84,0.476,33,69,0.478,7,15,0.467,11,17,0.647,98,37,89,0.416,32,69,0.464,5,20,0.25,17,25,0.68,96,2016-02-27,BRK,UTA
8107,7,@,W 98-81 ,240,40,84,0.476,39,76,0.513,1,8,0.125,17,21,0.81,98,32,87,0.368,26,72,0.361,6,15,0.4,11,12,0.917,81,2016-02-28,MIA,NYK
8108,8,@,L 98-103 ,240,39,98,0.398,29,63,0.46,10,35,0.286,10,11,0.909,98,40,98,0.408,31,66,0.47,9,32,0.281,14,21,0.667,103,2016-03-02,OKC,LAC
8109,9,@,L 98-104 ,240,39,82,0.476,30,56,0.536,9,26,0.346,11,20,0.55,98,35,79,0.443,30,61,0.492,5,18,0.278,29,33,0.879,104,2016-03-02,SAC,MEM
8110,10,Home,L 98-104 ,240,32,75,0.427,27,61,0.443,5,14,0.357,29,34,0.853,98,42,84,0.5,31,55,0.564,11,29,0.379,9,13,0.692,104,2016-03-02,MIN,WAS
8111,11,@,L 98-103 ,240,37,85,0.435,26,54,0.481,11,31,0.355,13,22,0.591,98,36,81,0.444,28,67,0.418,8,14,0.571,23,30,0.767,103,2016-03-06,PHI,MIA
8112,12,@,L 98-107 ,240,37,76,0.487,32,57,0.561,5,19,0.263,19,27,0.704,98,40,81,0.494,31,54,0.574,9,27,0.333,18,23,0.783,107,2016-03-08,ORL,LAL
8113,13,@,L 98-116 ,240,33,89,0.371,27,61,0.443,6,28,0.214,26,33,0.788,98,44,91,0.484,31,63,0.492,13,28,0.464,15,19,0.789,116,2016-03-10,PHO,DEN
8114,14,Home,L 98-102 ,240,34,91,0.374,26,60,0.433,8,31,0.258,22,28,0.786,98,40,88,0.455,35,62,0.565,5,26,0.192,17,25,0.68,102,2016-03-11,BOS,HOU
8115,15,@,L 98-103 ,240,36,94,0.383,28,63,0.444,8,31,0.258,18,22,0.818,98,39,84,0.464,34,72,0.472,5,12,0.417,20,28,0.714,103,2016-03-15,BOS,IND
8116,16,Home,L 98-106 ,240,37,84,0.44,32,58,0.552,5,26,0.192,19,26,0.731,98,38,79,0.481,34,61,0.557,4,18,0.222,26,33,0.788,106,2016-03-15,LAL,SAC
8117,17,@,L 98-99 ,240,37,79,0.468,30,57,0.526,7,22,0.318,17,19,0.895,98,39,88,0.443,29,51,0.569,10,37,0.27,11,13,0.846,99,2016-03-16,DAL,CLE
8118,18,@,L 98-116 ,240,39,87,0.448,33,65,0.508,6,22,0.273,14,17,0.824,98,40,80,0.5,28,54,0.519,12,26,0.462,24,28,0.857,116,2016-03-17,DEN,ATL
8119,19,@,L 98-114 ,240,36,85,0.424,28,57,0.491,8,28,0.286,18,27,0.667,98,39,87,0.448,24,53,0.453,15,34,0.441,21,28,0.75,114,2016-03-23,LAC,GSW
8120,20,@,W 98-96 ,240,37,87,0.425,27,61,0.443,10,26,0.385,14,16,0.875,98,39,90,0.433,36,71,0.507,3,19,0.158,15,17,0.882,96,2016-03-29,CHI,IND
8121,21,@,W 98-89 ,240,39,85,0.459,31,61,0.508,8,24,0.333,12,14,0.857,98,31,81,0.383,18,48,0.375,13,33,0.394,14,24,0.583,89,2016-04-01,DAL,DET
8122,22,Home,W 98-85 ,240,38,72,0.528,30,50,0.6,8,22,0.364,14,23,0.609,98,35,79,0.443,26,56,0.464,9,23,0.391,6,10,0.6,85,2016-04-01,UTA,MIN
8123,23,Home,L 98-102 ,240,40,85,0.471,38,78,0.487,2,7,0.286,16,20,0.8,98,39,74,0.527,32,48,0.667,7,26,0.269,17,22,0.773,102,2016-04-03,MIL,CHI
8124,24,@,L 98-106 ,240,35,78,0.449,32,64,0.5,3,14,0.214,25,28,0.893,98,44,92,0.478,40,78,0.513,4,14,0.286,14,17,0.824,106,2016-04-07,CHI,MIA
8125,25,@,L 98-102 ,240,36,85,0.424,33,71,0.465,3,14,0.214,23,28,0.821,98,40,86,0.465,34,64,0.531,6,22,0.273,16,19,0.842,102,2016-04-08,SAS,DEN
8126,26,@,L 98-111 ,240,37,83,0.446,29,56,0.518,8,27,0.296,16,20,0.8,98,37,68,0.544,27,46,0.587,10,22,0.455,27,38,0.711,111,2016-04-08,IND,TOR
8127,27,Home,W 98-91 ,240,37,76,0.487,28,58,0.483,9,18,0.5,15,37,0.405,98,30,74,0.405,22,44,0.5,8,30,0.267,23,33,0.697,91,2016-04-10,LAC,DAL
8128,28,@,L 98-113 ,240,28,81,0.346,16,48,0.333,12,33,0.364,30,35,0.857,98,42,80,0.525,33,59,0.559,9,21,0.429,20,28,0.714,113,2016-04-10,CHA,WAS
8129,29,@,L 98-107 ,240,41,78,0.526,38,63,0.603,3,15,0.2,13,19,0.684,98,41,84,0.488,34,61,0.557,7,23,0.304,18,28,0.643,107,2016-04-11,MIL,ORL
8130,30,@,L 98-102 (OT),265,35,87,0.402,29,62,0.468,6,25,0.24,22,25,0.88,98,37,87,0.425,33,73,0.452,4,14,0.286,24,32,0.75,102,2016-04-12,OKC,SAS
8131,31,@,L 98-122 ,240,35,77,0.455,20,42,0.476,15,35,0.429,13,25,0.52,98,48,95,0.505,38,70,0.543,10,25,0.4,16,19,0.842,122,2016-04-12,PHI,TOR
8132,32,Home,W 98-88 ,240,37,86,0.43,32,72,0.444,5,14,0.357,19,22,0.864,98,38,88,0.432,36,69,0.522,2,19,0.105,10,12,0.833,88,2016-04-13,BOS,MIA
8133,33,@,L 98-109 ,240,32,81,0.395,21,52,0.404,11,29,0.379,23,31,0.742,98,42,88,0.477,33,60,0.55,9,28,0.321,16,30,0.533,109,2016-04-13,ATL,WAS
8134,34,@,L 98-102 ,240,36,86,0.419,30,68,0.441,6,18,0.333,20,29,0.69,98,36,80,0.45,25,56,0.446,11,24,0.458,19,27,0.704,102,2016-10-26,MIN,MEM
8135,35,Home,L 98-106 ,240,35,80,0.438,27,51,0.529,8,29,0.276,20,24,0.833,98,33,70,0.471,18,38,0.474,15,32,0.469,25,31,0.806,106,2016-10-28,DAL,HOU
8136,36,Home,L 98-104 ,240,32,79,0.405,23,47,0.489,9,32,0.281,25,33,0.758,98,39,81,0.481,24,50,0.48,15,31,0.484,11,17,0.647,104,2016-10-29,CHA,BOS
8137,37,Home,W 98-79 ,240,35,83,0.422,25,59,0.424,10,24,0.417,18,23,0.783,98,32,86,0.372,28,64,0.438,4,22,0.182,11,15,0.733,79,2016-10-29,SAS,NOP
8138,38,Home,W 98-83 ,240,39,88,0.443,34,68,0.5,5,20,0.25,15,20,0.75,98,34,87,0.391,30,70,0.429,4,17,0.235,11,14,0.786,83,2016-10-30,DET,MIL
8139,39,@,L 98-116 ,240,35,84,0.417,30,69,0.435,5,15,0.333,23,31,0.742,98,40,80,0.5,34,64,0.531,6,16,0.375,30,38,0.789,116,2016-10-31,PHO,LAC
8140,40,@,L 98-104 ,240,38,82,0.463,30,48,0.625,8,34,0.235,14,18,0.778,98,38,82,0.463,30,56,0.536,8,26,0.308,20,29,0.69,104,2016-11-09,UTA,CHO
8141,41,@,W 98-95 ,240,37,89,0.416,31,73,0.425,6,16,0.375,18,20,0.9,98,36,88,0.409,23,59,0.39,13,29,0.448,10,15,0.667,95,2016-11-10,CHI,MIA
8142,42,@,W 98-85 ,240,34,85,0.4,27,63,0.429,7,22,0.318,23,25,0.92,98,32,79,0.405,26,53,0.491,6,26,0.231,15,21,0.714,85,2016-11-25,MIN,PHO
8143,43,Home,L 98-106 ,240,38,91,0.418,31,69,0.449,7,22,0.318,15,24,0.625,98,41,93,0.441,32,69,0.464,9,24,0.375,15,26,0.577,106,2016-11-30,DEN,MIA
8144,44,@,L 98-105 ,240,37,83,0.446,24,59,0.407,13,24,0.542,11,14,0.786,98,35,78,0.449,26,53,0.491,9,25,0.36,26,28,0.929,105,2016-12-03,DEN,UTA
8145,45,@,W 98-92 ,240,42,79,0.532,35,56,0.625,7,23,0.304,7,14,0.5,98,38,86,0.442,28,59,0.475,10,27,0.37,6,13,0.462,92,2016-12-04,ORL,DET
8146,46,@,L 98-106 ,240,31,97,0.32,22,69,0.319,9,28,0.321,27,31,0.871,98,39,88,0.443,28,59,0.475,11,29,0.379,17,24,0.708,106,2016-12-04,SAC,NYK
8147,47,Home,L 98-106 ,240,35,86,0.407,24,55,0.436,11,31,0.355,17,23,0.739,98,35,76,0.461,25,49,0.51,10,27,0.37,26,34,0.765,106,2016-12-05,PHI,DEN
8148,48,Home,L 98-115 ,240,36,92,0.391,28,66,0.424,8,26,0.308,18,24,0.75,98,42,89,0.472,35,58,0.603,7,31,0.226,24,29,0.828,115,2016-12-07,LAC,GSW
8149,49,@,L 98-132 ,240,39,92,0.424,28,60,0.467,11,32,0.344,9,11,0.818,98,50,85,0.588,28,43,0.651,22,42,0.524,10,16,0.625,132,2016-12-14,SAC,HOU
8150,50,Home,L 98-102 ,240,38,93,0.409,32,66,0.485,6,27,0.222,16,25,0.64,98,36,83,0.434,29,58,0.5,7,25,0.28,23,29,0.793,102,2016-12-16,MIA,LAC
8151,51,@,W 98-86 ,240,35,82,0.427,23,52,0.442,12,30,0.4,16,19,0.842,98,26,72,0.361,20,49,0.408,6,23,0.261,28,37,0.757,86,2016-12-21,MEM,DET
8152,52,Home,L 98-104 ,240,35,79,0.443,25,52,0.481,10,27,0.37,18,21,0.857,98,43,81,0.531,35,60,0.583,8,21,0.381,10,15,0.667,104,2016-12-23,UTA,TOR
8153,53,@,L 98-102 (OT),265,35,93,0.376,28,66,0.424,7,27,0.259,21,26,0.808,98,37,101,0.366,30,74,0.405,7,27,0.259,21,27,0.778,102,2016-12-28,NYK,ATL
8154,54,@,L 98-102 ,240,37,94,0.394,26,57,0.456,11,37,0.297,13,18,0.722,98,40,87,0.46,30,58,0.517,10,29,0.345,12,21,0.571,102,2016-12-28,LAC,NOP
8155,55,@,L 98-119 ,240,36,74,0.486,29,58,0.5,7,16,0.438,19,24,0.792,98,47,87,0.54,42,70,0.6,5,17,0.294,20,25,0.8,119,2016-12-28,PHO,SAS
8156,56,@,L 98-105 ,240,35,84,0.417,26,53,0.491,9,31,0.29,19,21,0.905,98,39,88,0.443,31,62,0.5,8,26,0.308,19,25,0.76,105,2016-12-30,DET,ATL
8157,57,Home,L 98-112 ,240,31,72,0.431,20,44,0.455,11,28,0.393,25,28,0.893,98,44,87,0.506,27,52,0.519,17,35,0.486,7,9,0.778,112,2016-12-31,SAC,MEM
8158,58,Home,L 98-107 ,240,35,77,0.455,21,51,0.412,14,26,0.538,14,18,0.778,98,42,86,0.488,33,64,0.516,9,22,0.409,14,22,0.636,107,2017-01-01,MIA,DET
8159,59,@,L 98-109 ,240,39,102,0.382,37,87,0.425,2,15,0.133,18,22,0.818,98,37,80,0.463,30,64,0.469,7,16,0.438,28,38,0.737,109,2017-01-02,PHO,LAC
8160,60,Home,W 98-94 ,240,38,79,0.481,31,60,0.517,7,19,0.368,15,24,0.625,98,36,78,0.462,27,51,0.529,9,27,0.333,13,19,0.684,94,2017-01-02,MIL,OKC
8161,61,Home,L 98-106 ,240,36,87,0.414,27,57,0.474,9,30,0.3,17,22,0.773,98,39,84,0.464,26,53,0.491,13,31,0.419,15,21,0.714,106,2017-01-06,SAC,LAC
8162,62,Home,W 98-86 ,240,36,86,0.419,27,56,0.482,9,30,0.3,17,25,0.68,98,31,84,0.369,24,57,0.421,7,27,0.259,17,21,0.81,86,2017-01-08,LAC,MIA
8163,63,Home,W 98-97 ,240,37,95,0.389,30,67,0.448,7,28,0.25,17,21,0.81,98,42,86,0.488,38,64,0.594,4,22,0.182,9,10,0.9,97,2017-01-11,PHI,NYK
8164,64,@,L 98-111 ,240,39,79,0.494,33,60,0.55,6,19,0.316,14,18,0.778,98,42,80,0.525,29,54,0.537,13,26,0.5,14,18,0.778,111,2017-01-15,MIL,ATL
8165,65,Home,W 98-87 ,240,36,77,0.468,24,48,0.5,12,29,0.414,14,19,0.737,98,35,80,0.438,30,59,0.508,5,21,0.238,12,18,0.667,87,2017-01-15,DAL,MIN
8166,66,@,L 98-108 ,240,38,86,0.442,30,61,0.492,8,25,0.32,14,17,0.824,98,42,84,0.5,27,45,0.6,15,39,0.385,9,10,0.9,108,2017-01-16,CHA,BOS
8167,67,Home,W 98-95 ,240,41,81,0.506,36,62,0.581,5,19,0.263,11,16,0.688,98,36,83,0.434,26,58,0.448,10,25,0.4,13,18,0.722,95,2017-01-16,IND,NOP
8168,68,@,L 98-120 ,240,36,85,0.424,26,55,0.473,10,30,0.333,16,19,0.842,98,45,82,0.549,33,54,0.611,12,28,0.429,18,22,0.818,120,2017-01-16,OKC,LAC
8169,69,Home,L 98-99 ,240,37,82,0.451,31,68,0.456,6,14,0.429,18,22,0.818,98,37,78,0.474,26,50,0.52,11,28,0.393,14,18,0.778,99,2017-01-17,CHI,DAL
8170,70,@,L 98-118 ,240,39,88,0.443,28,56,0.5,11,32,0.344,9,11,0.818,98,46,93,0.495,31,57,0.544,15,36,0.417,11,15,0.733,118,2017-01-18,ORL,NOP
8171,71,@,L 98-123 ,240,40,96,0.417,30,64,0.469,10,32,0.313,8,8,1.0,98,46,87,0.529,36,63,0.571,10,24,0.417,21,26,0.808,123,2017-01-21,LAC,DEN
8172,72,Home,L 98-118 ,240,42,96,0.438,35,68,0.515,7,28,0.25,7,16,0.438,98,42,89,0.472,23,47,0.489,19,42,0.452,15,19,0.789,118,2017-01-22,ORL,GSW
8173,73,@,L 98-105 ,240,37,94,0.394,26,65,0.4,11,29,0.379,13,14,0.929,98,43,90,0.478,39,75,0.52,4,15,0.267,15,20,0.75,105,2017-01-25,LAL,POR
8174,74,@,L 98-109 ,240,38,84,0.452,27,58,0.466,11,26,0.423,11,13,0.846,98,37,72,0.514,28,50,0.56,9,22,0.409,26,36,0.722,109,2017-01-26,DAL,OKC
8175,75,@,L 98-128 ,240,38,87,0.437,29,62,0.468,9,25,0.36,13,18,0.722,98,50,89,0.562,34,55,0.618,16,34,0.471,12,15,0.8,128,2017-01-27,ORL,BOS
8176,76,@,L 98-144 ,240,36,82,0.439,24,54,0.444,12,28,0.429,14,22,0.636,98,57,92,0.62,40,58,0.69,17,34,0.5,13,16,0.813,144,2017-01-28,LAC,GSW
8177,77,@,L 98-115 ,240,33,83,0.398,22,52,0.423,11,31,0.355,21,25,0.84,98,42,93,0.452,31,62,0.5,11,31,0.355,20,23,0.87,115,2017-01-31,CHA,POR
8178,78,@,L 98-118 ,240,41,82,0.5,36,61,0.59,5,21,0.238,11,14,0.786,98,48,88,0.545,38,62,0.613,10,26,0.385,12,17,0.706,118,2017-02-01,NOP,DET
8179,79,@,W 98-88 ,240,33,69,0.478,24,49,0.49,9,20,0.45,23,26,0.885,98,31,77,0.403,25,53,0.472,6,24,0.25,20,28,0.714,88,2017-02-01,IND,ORL
8180,80,@,L 98-105 ,240,35,82,0.427,22,49,0.449,13,33,0.394,15,18,0.833,98,38,81,0.469,25,48,0.521,13,33,0.394,16,24,0.667,105,2017-02-04,CHA,UTA
8181,81,Home,L 98-111 ,240,35,77,0.455,26,50,0.52,9,27,0.333,19,25,0.76,98,40,81,0.494,24,47,0.511,16,34,0.471,15,18,0.833,111,2017-02-13,DAL,BOS
8182,82,@,L 98-120 ,240,34,96,0.354,27,62,0.435,7,34,0.206,23,30,0.767,98,42,73,0.575,29,53,0.547,13,20,0.65,23,28,0.821,120,2017-02-13,OKC,WAS
8183,83,Home,W 98-91 ,240,36,82,0.439,30,63,0.476,6,19,0.316,20,22,0.909,98,35,92,0.38,25,55,0.455,10,37,0.27,11,11,1.0,91,2017-02-15,DET,DAL
8184,84,Home,L 98-111 ,240,40,81,0.494,36,63,0.571,4,18,0.222,14,18,0.778,98,43,83,0.518,28,54,0.519,15,29,0.517,10,15,0.667,111,2017-02-16,IND,WAS
8185,85,Home,L 98-105 ,240,37,84,0.44,26,50,0.52,11,34,0.324,13,17,0.765,98,36,80,0.45,25,47,0.532,11,33,0.333,22,25,0.88,105,2017-02-26,DEN,MEM
8186,86,Home,L 98-104 ,240,35,81,0.432,23,48,0.479,12,33,0.364,16,35,0.457,98,34,85,0.4,22,50,0.44,12,35,0.343,24,30,0.8,104,2017-02-26,DET,BOS
8187,87,Home,L 98-119 ,240,40,87,0.46,33,65,0.508,7,22,0.318,11,18,0.611,98,49,94,0.521,39,73,0.534,10,21,0.476,11,13,0.846,119,2017-02-26,LAL,SAS
8188,88,Home,L 98-114 ,240,34,87,0.391,24,53,0.453,10,34,0.294,20,25,0.8,98,46,95,0.484,40,70,0.571,6,25,0.24,16,20,0.8,114,2017-02-27,BOS,ATL
8189,89,@,L 98-125 ,240,37,85,0.435,31,68,0.456,6,17,0.353,18,22,0.818,98,49,90,0.544,36,60,0.6,13,30,0.433,14,21,0.667,125,2017-03-01,PHI,MIA
8190,90,Home,L 98-110 ,240,38,83,0.458,29,65,0.446,9,18,0.5,13,15,0.867,98,41,84,0.488,31,51,0.608,10,33,0.303,18,20,0.9,110,2017-03-01,MIL,DEN
8191,91,Home,L 98-101 (OT),265,35,91,0.385,27,66,0.409,8,25,0.32,20,24,0.833,98,40,95,0.421,34,68,0.5,6,27,0.222,15,25,0.6,101,2017-03-03,NOP,SAS
8192,92,Home,L 98-106 ,240,35,78,0.449,26,51,0.51,9,27,0.333,19,29,0.655,98,39,91,0.429,23,56,0.411,16,35,0.457,12,14,0.857,106,2017-03-06,CLE,MIA
8193,93,Home,L 98-112 ,240,39,89,0.438,31,59,0.525,8,30,0.267,12,19,0.632,98,41,83,0.494,27,50,0.54,14,33,0.424,16,20,0.8,112,2017-03-06,PHI,MIL
8194,94,@,L 98-115 ,240,39,89,0.438,32,63,0.508,7,26,0.269,13,22,0.591,98,44,88,0.5,33,65,0.508,11,23,0.478,16,19,0.842,115,2017-03-08,DET,IND
8195,95,Home,W 98-91 ,240,37,89,0.416,30,64,0.469,7,25,0.28,17,21,0.81,98,36,81,0.444,24,53,0.453,12,28,0.429,7,11,0.636,91,2017-03-08,ORL,CHI
8196,96,Home,L 98-114 ,240,37,83,0.446,30,63,0.476,7,20,0.35,17,22,0.773,98,40,78,0.513,29,48,0.604,11,30,0.367,23,28,0.821,114,2017-03-09,MEM,LAC
8197,97,Home,W 97-89 ,240,34,72,0.472,24,53,0.453,10,19,0.526,19,26,0.731,97,30,81,0.37,22,53,0.415,8,28,0.286,21,26,0.808,89,2011-12-25,OKC,ORL
8198,98,Home,W 97-78 ,240,36,79,0.456,32,67,0.478,4,12,0.333,21,25,0.84,97,29,78,0.372,22,61,0.361,7,17,0.412,13,18,0.722,78,2011-12-28,NOP,BOS
8199,99,@,L 97-107 ,240,35,88,0.398,27,62,0.435,8,26,0.308,19,23,0.826,97,41,77,0.532,32,55,0.582,9,22,0.409,16,18,0.889,107,2011-12-31,PHO,OKC
8200,0,Home,W 97-90 ,240,37,77,0.481,34,66,0.515,3,11,0.273,20,29,0.69,97,38,77,0.494,34,63,0.54,4,14,0.286,10,19,0.526,90,2012-01-06,LAL,GSW
8201,1,@,W 97-83 ,240,38,86,0.442,30,72,0.417,8,14,0.571,13,17,0.765,97,30,75,0.4,23,55,0.418,7,20,0.35,16,21,0.762,83,2012-01-06,CHI,ORL
8202,2,@,W 97-85 ,240,31,80,0.388,16,49,0.327,15,31,0.484,20,27,0.741,97,33,73,0.452,27,56,0.482,6,17,0.353,13,19,0.684,85,2012-01-06,BRK,TOR
8203,3,Home,W 97-62 ,240,36,83,0.434,31,62,0.5,5,21,0.238,20,27,0.741,97,27,85,0.318,26,73,0.356,1,12,0.083,7,12,0.583,62,2012-01-07,PHI,TOR
8204,4,Home,L 97-104 ,240,38,73,0.521,35,53,0.66,3,20,0.15,18,24,0.75,97,37,87,0.425,27,55,0.491,10,32,0.313,20,31,0.645,104,2012-01-08,SAC,ORL
8205,5,Home,W 97-87 ,240,34,77,0.442,31,58,0.534,3,19,0.158,26,28,0.929,97,27,80,0.338,20,56,0.357,7,24,0.292,26,33,0.788,87,2012-01-09,TOR,MIN
8206,6,@,L 97-105 ,240,37,83,0.446,31,60,0.517,6,23,0.261,17,24,0.708,97,37,72,0.514,32,58,0.552,5,14,0.357,26,32,0.813,105,2012-01-10,LAC,POR
8207,7,Home,W 97-92 ,240,37,76,0.487,32,62,0.516,5,14,0.357,18,23,0.783,97,32,85,0.376,24,61,0.393,8,24,0.333,20,25,0.8,92,2012-01-13,LAL,CLE
8208,8,Home,W 97-83 ,240,35,94,0.372,30,78,0.385,5,16,0.313,22,23,0.957,97,32,83,0.386,27,68,0.397,5,15,0.333,14,18,0.778,83,2012-01-14,IND,BOS
8209,9,@,W 97-88 ,240,36,80,0.45,29,61,0.475,7,19,0.368,18,19,0.947,97,34,87,0.391,28,73,0.384,6,14,0.429,14,16,0.875,88,2012-01-16,OKC,BOS
8210,10,@,L 97-118 ,240,38,74,0.514,33,63,0.524,5,11,0.455,16,19,0.842,97,47,88,0.534,42,78,0.538,5,10,0.5,19,24,0.792,118,2012-01-17,PHO,CHI
8211,11,Home,W 97-80 ,240,40,81,0.494,32,62,0.516,8,19,0.421,9,12,0.75,97,34,83,0.41,30,70,0.429,4,13,0.308,8,9,0.889,80,2012-01-17,HOU,DET
8212,12,Home,W 97-87 ,240,38,86,0.442,31,59,0.525,7,27,0.259,14,15,0.933,97,37,79,0.468,32,65,0.492,5,14,0.357,8,15,0.533,87,2012-01-22,BRK,CHA
8213,13,@,W 97-92 ,240,38,83,0.458,35,72,0.486,3,11,0.273,18,21,0.857,97,37,92,0.402,32,75,0.427,5,17,0.294,13,17,0.765,92,2012-01-23,ATL,MIL
8214,14,Home,W 97-84 ,240,31,72,0.431,26,50,0.52,5,22,0.227,30,36,0.833,97,34,90,0.378,31,76,0.408,3,14,0.214,13,17,0.765,84,2012-01-24,POR,MEM
8215,15,@,W 97-90 (OT),265,37,82,0.451,25,55,0.455,12,27,0.444,11,14,0.786,97,35,79,0.443,30,65,0.462,5,14,0.357,15,19,0.789,90,2012-01-25,BRK,PHI
8216,16,Home,W 97-84 ,240,38,77,0.494,34,65,0.523,4,12,0.333,17,22,0.773,97,34,89,0.382,29,63,0.46,5,26,0.192,11,15,0.733,84,2012-01-28,HOU,NYK
8217,17,Home,W 97-93 ,240,32,78,0.41,29,70,0.414,3,8,0.375,30,40,0.75,97,35,81,0.432,32,70,0.457,3,11,0.273,20,28,0.714,93,2012-01-29,MIA,CHI
8218,18,@,L 97-100 (OT),265,35,80,0.438,28,57,0.491,7,23,0.304,20,27,0.741,97,33,86,0.384,27,74,0.365,6,12,0.5,28,35,0.8,100,2012-01-31,DEN,MEM
8219,19,@,L 97-105 ,240,34,73,0.466,25,53,0.472,9,20,0.45,20,24,0.833,97,39,88,0.443,29,65,0.446,10,23,0.435,17,25,0.68,105,2012-02-01,MIA,MIL
8220,20,@,L 97-117 ,240,35,79,0.443,30,57,0.526,5,22,0.227,22,24,0.917,97,46,86,0.535,31,53,0.585,15,33,0.455,10,12,0.833,117,2012-02-04,DEN,POR
8221,21,Home,W 97-87 ,240,35,76,0.461,26,55,0.473,9,21,0.429,18,24,0.75,97,33,75,0.44,28,61,0.459,5,14,0.357,16,23,0.696,87,2012-02-08,ATL,IND
8222,22,Home,L 97-104 ,240,32,79,0.405,26,56,0.464,6,23,0.261,27,31,0.871,97,39,90,0.433,30,69,0.435,9,21,0.429,17,23,0.739,104,2012-02-10,MIN,DAL
8223,23,Home,W 97-94 (2OT),290,39,84,0.464,33,65,0.508,6,19,0.316,13,19,0.684,97,36,97,0.371,33,77,0.429,3,20,0.15,19,21,0.905,94,2012-02-11,DAL,POR
8224,24,@,L 97-106 ,240,31,75,0.413,20,46,0.435,11,29,0.379,24,33,0.727,97,40,79,0.506,27,55,0.491,13,24,0.542,13,18,0.722,106,2012-02-12,HOU,GSW
8225,25,@,W 97-85 ,240,34,85,0.4,24,63,0.381,10,22,0.455,19,25,0.76,97,33,84,0.393,30,71,0.423,3,13,0.231,16,27,0.593,85,2012-02-18,BRK,CHI
8226,26,Home,W 97-77 ,240,38,81,0.469,29,59,0.492,9,22,0.409,12,16,0.75,97,30,73,0.411,23,46,0.5,7,27,0.259,10,13,0.769,77,2012-02-18,POR,ATL
8227,27,@,L 97-104 ,240,36,81,0.444,24,48,0.5,12,33,0.364,13,17,0.765,97,40,86,0.465,28,57,0.491,12,29,0.414,12,18,0.667,104,2012-02-19,DAL,NYK
8228,28,@,L 97-104 ,240,33,77,0.429,22,51,0.431,11,26,0.423,20,27,0.741,97,38,83,0.458,29,60,0.483,9,23,0.391,19,24,0.792,104,2012-02-20,LAC,GSW
8229,29,Home,W 97-93 ,240,35,74,0.473,28,52,0.538,7,22,0.318,20,25,0.8,97,38,79,0.481,35,66,0.53,3,13,0.231,14,18,0.778,93,2012-02-20,HOU,MEM
8230,30,@,L 97-137 ,240,32,84,0.381,24,64,0.375,8,20,0.4,25,32,0.781,97,51,86,0.593,36,58,0.621,15,28,0.536,20,24,0.833,137,2012-02-21,SAS,POR
8231,31,@,W 97-68 ,240,42,84,0.5,37,71,0.521,5,13,0.385,8,9,0.889,97,25,79,0.316,23,69,0.333,2,10,0.2,16,20,0.8,68,2012-02-28,PHI,DET
8232,32,Home,L 97-109 ,240,40,85,0.471,38,74,0.514,2,11,0.182,15,22,0.682,97,40,78,0.513,30,56,0.536,10,22,0.455,19,27,0.704,109,2012-02-28,LAC,MIN
8233,33,Home,W 97-92 ,240,40,88,0.455,37,75,0.493,3,13,0.231,14,17,0.824,97,37,83,0.446,26,54,0.481,11,29,0.379,7,10,0.7,92,2012-03-02,NOP,DAL
8234,34,Home,W 97-90 ,240,37,85,0.435,29,68,0.426,8,17,0.471,15,22,0.682,97,30,73,0.411,24,50,0.48,6,23,0.261,24,29,0.828,90,2012-03-03,ATL,OKC
8235,35,Home,W 97-93 ,240,35,88,0.398,28,68,0.412,7,20,0.35,20,23,0.87,97,35,94,0.372,28,75,0.373,7,19,0.368,16,23,0.696,93,2012-03-05,MIL,PHI
8236,36,Home,W 97-92 (OT),265,35,81,0.432,31,67,0.463,4,14,0.286,23,31,0.742,97,32,83,0.386,27,64,0.422,5,19,0.263,23,29,0.793,92,2012-03-06,BOS,HOU
8237,37,@,L 97-110 ,240,33,72,0.458,29,61,0.475,4,11,0.364,27,32,0.844,97,41,73,0.562,35,50,0.7,6,23,0.261,22,32,0.688,110,2012-03-09,NOP,DEN
8238,38,@,L 97-110 ,240,39,86,0.453,33,64,0.516,6,22,0.273,13,18,0.722,97,43,85,0.506,32,58,0.552,11,27,0.407,13,13,1.0,110,2012-03-09,DAL,SAC
8239,39,@,L 97-111 ,240,40,85,0.471,40,82,0.488,0,3,0.0,17,22,0.773,97,43,77,0.558,36,59,0.61,7,18,0.389,18,24,0.75,111,2012-03-10,UTA,CHI
8240,40,@,W 97-93 ,240,36,70,0.514,28,55,0.509,8,15,0.533,17,21,0.81,97,34,79,0.43,28,60,0.467,6,19,0.316,19,35,0.543,93,2012-03-11,GSW,LAC
8241,41,Home,W 97-94 ,240,36,71,0.507,28,55,0.509,8,16,0.5,17,26,0.654,97,39,83,0.47,33,66,0.5,6,17,0.353,10,12,0.833,94,2012-03-11,LAL,BOS
8242,42,@,L 97-112 ,240,39,87,0.448,31,70,0.443,8,17,0.471,11,14,0.786,97,47,87,0.54,39,65,0.6,8,22,0.364,10,19,0.526,112,2012-03-12,WAS,SAS
8243,43,Home,W 97-92 ,240,33,80,0.413,23,58,0.397,10,22,0.455,21,27,0.778,97,37,92,0.402,33,70,0.471,4,22,0.182,14,20,0.7,92,2012-03-16,LAL,MIN
8244,44,Home,W 97-92 ,240,34,85,0.4,32,78,0.41,2,7,0.286,27,37,0.73,97,37,78,0.474,31,60,0.517,6,18,0.333,12,19,0.632,92,2012-03-18,MEM,WAS
8245,45,@,W 97-93 ,240,35,74,0.473,26,53,0.491,9,21,0.429,18,23,0.783,97,34,80,0.425,24,54,0.444,10,26,0.385,15,20,0.75,93,2012-03-19,MIN,GSW
8246,46,Home,W 97-90 ,240,38,80,0.475,33,70,0.471,5,10,0.5,16,22,0.727,97,30,71,0.423,22,52,0.423,8,19,0.421,22,30,0.733,90,2012-03-20,UTA,OKC
8247,47,Home,W 97-90 ,240,34,59,0.576,32,54,0.593,2,5,0.4,27,34,0.794,97,35,90,0.389,30,63,0.476,5,27,0.185,15,24,0.625,90,2012-03-22,NOP,LAC
8248,48,Home,W 97-93 ,240,31,73,0.425,21,48,0.438,10,25,0.4,25,25,1.0,97,37,81,0.457,34,73,0.466,3,8,0.375,16,23,0.696,93,2012-03-22,POR,MEM
8249,49,Home,W 97-85 ,240,37,74,0.5,29,48,0.604,8,26,0.308,15,21,0.714,97,31,62,0.5,29,51,0.569,2,11,0.182,21,31,0.677,85,2012-03-26,LAC,NOH
8250,50,@,L 97-98 ,240,39,78,0.5,31,59,0.525,8,19,0.421,11,15,0.733,97,39,75,0.52,31,54,0.574,8,21,0.381,12,19,0.632,98,2012-03-30,POR,LAC
8251,51,Home,W 97-76 ,240,42,87,0.483,35,70,0.5,7,17,0.412,6,6,1.0,97,30,82,0.366,27,68,0.397,3,14,0.214,13,17,0.765,76,2012-03-30,WAS,PHI
8252,52,Home,L 97-102 ,240,35,81,0.432,23,59,0.39,12,22,0.545,15,18,0.833,97,41,84,0.488,37,69,0.536,4,15,0.267,16,21,0.762,102,2012-04-02,POR,UTA
8253,53,@,W 97-94 ,240,41,86,0.477,37,70,0.529,4,16,0.25,11,16,0.688,97,37,87,0.425,28,56,0.5,9,31,0.29,11,16,0.688,94,2012-04-04,GSW,MIN
8254,54,Home,L 97-99 (OT),265,42,93,0.452,35,69,0.507,7,24,0.292,6,8,0.75,97,41,94,0.436,33,73,0.452,8,21,0.381,9,11,0.818,99,2012-04-06,DAL,POR
8255,55,@,W 97-82 ,240,38,82,0.463,30,65,0.462,8,17,0.471,13,17,0.765,97,33,82,0.402,29,64,0.453,4,18,0.222,12,16,0.75,82,2012-04-06,MEM,MIA
8256,56,@,L 97-112 ,240,37,80,0.463,29,55,0.527,8,25,0.32,15,20,0.75,97,46,88,0.523,38,67,0.567,8,21,0.381,12,16,0.75,112,2012-04-07,DEN,GSW
8257,57,@,L 97-107 ,240,36,85,0.424,32,66,0.485,4,19,0.211,21,27,0.778,97,37,76,0.487,30,56,0.536,7,20,0.35,26,31,0.839,107,2012-04-12,MEM,SAS
8258,58,Home,L 97-113 ,240,37,78,0.474,34,68,0.5,3,10,0.3,20,24,0.833,97,45,87,0.517,40,72,0.556,5,15,0.333,18,22,0.818,113,2012-04-13,DET,MIL
8259,59,@,L 97-103 ,240,41,92,0.446,36,75,0.48,5,17,0.294,10,15,0.667,97,38,75,0.507,31,60,0.517,7,15,0.467,20,29,0.69,103,2012-04-13,DEN,LAL
8260,60,@,W 97-94 ,240,40,83,0.482,31,63,0.492,9,20,0.45,8,10,0.8,97,35,83,0.422,29,58,0.5,6,25,0.24,18,23,0.783,94,2012-04-13,DAL,POR
8261,61,Home,L 97-102 ,240,34,76,0.447,29,62,0.468,5,14,0.357,24,32,0.75,97,37,89,0.416,24,65,0.369,13,24,0.542,15,18,0.833,102,2012-04-17,PHI,IND
8262,62,Home,L 97-109 ,240,34,83,0.41,28,63,0.444,6,20,0.3,23,32,0.719,97,36,80,0.45,30,64,0.469,6,16,0.375,31,34,0.912,109,2012-04-18,PHO,OKC
8263,63,Home,W 97-92 ,240,37,72,0.514,28,55,0.509,9,17,0.529,14,17,0.824,97,39,81,0.481,34,69,0.493,5,12,0.417,9,14,0.643,92,2012-04-20,ATL,BOS
8264,64,@,L 97-121 ,240,33,76,0.434,27,62,0.435,6,14,0.429,25,30,0.833,97,47,77,0.61,37,62,0.597,10,15,0.667,17,18,0.944,121,2012-04-20,LAL,SAS
8265,65,Home,W 97-88 ,240,35,85,0.412,30,69,0.435,5,16,0.313,22,24,0.917,97,35,76,0.461,28,56,0.5,7,20,0.35,11,13,0.846,88,2012-04-22,MIA,HOU
8266,66,@,L 97-103 ,240,38,83,0.458,30,67,0.448,8,16,0.5,13,22,0.591,97,35,92,0.38,31,77,0.403,4,15,0.267,29,38,0.763,103,2012-04-23,DET,IND
8267,67,@,L 97-109 ,240,35,78,0.449,29,66,0.439,6,12,0.5,21,25,0.84,97,41,92,0.446,31,62,0.5,10,30,0.333,17,22,0.773,109,2012-11-06,DET,DEN
8268,68,@,W 97-91 ,240,36,73,0.493,31,60,0.517,5,13,0.385,20,21,0.952,97,35,84,0.417,30,69,0.435,5,15,0.333,16,18,0.889,91,2012-11-08,OKC,CHI
8269,69,@,W 97-86 ,240,35,72,0.486,30,54,0.556,5,18,0.278,22,26,0.846,97,32,91,0.352,29,75,0.387,3,16,0.188,19,26,0.731,86,2012-11-09,SAS,SAC
8270,70,@,L 97-101 (OT),265,32,79,0.405,23,60,0.383,9,19,0.474,24,30,0.8,97,40,95,0.421,37,75,0.493,3,20,0.15,18,28,0.643,101,2012-11-10,DAL,CHA
8271,71,Home,L 97-107 ,240,35,72,0.486,29,59,0.492,6,13,0.462,21,26,0.808,97,44,93,0.473,37,76,0.487,7,17,0.412,12,14,0.857,107,2012-11-14,OKC,MEM
8272,72,@,L 97-102 ,240,35,75,0.467,28,62,0.452,7,13,0.538,20,25,0.8,97,36,85,0.424,28,63,0.444,8,22,0.364,22,28,0.786,102,2012-11-15,BOS,BRK
8273,73,@,W 97-88 ,240,38,71,0.535,30,52,0.577,8,19,0.421,13,19,0.684,97,34,79,0.43,29,61,0.475,5,18,0.278,15,21,0.714,88,2012-11-17,MIA,PHO
8274,74,Home,W 97-86 ,240,38,80,0.475,31,62,0.5,7,18,0.389,14,23,0.609,97,32,80,0.4,28,67,0.418,4,13,0.308,18,21,0.857,86,2012-11-18,TOR,ORL
8275,75,@,W 97-92 ,240,36,81,0.444,31,66,0.47,5,15,0.333,20,28,0.714,97,36,78,0.462,30,61,0.492,6,17,0.353,14,17,0.824,92,2012-11-19,DEN,MEM
8276,76,@,L 97-98 ,240,37,80,0.463,28,57,0.491,9,23,0.391,14,20,0.7,97,36,86,0.419,33,67,0.493,3,19,0.158,23,28,0.821,98,2012-11-21,TOR,CHA
8277,77,@,L 97-113 ,240,29,65,0.446,17,39,0.436,12,26,0.462,27,39,0.692,97,44,81,0.543,37,66,0.561,7,15,0.467,18,22,0.818,113,2012-11-21,LAL,SAC
8278,78,Home,L 97-104 ,240,38,92,0.413,31,76,0.408,7,16,0.438,14,21,0.667,97,41,83,0.494,39,66,0.591,2,17,0.118,20,22,0.909,104,2012-11-23,IND,SAS
8279,79,@,L 97-108 ,240,32,79,0.405,21,54,0.389,11,25,0.44,22,30,0.733,97,40,74,0.541,34,58,0.586,6,16,0.375,22,32,0.688,108,2012-11-24,UTA,SAC
8280,80,@,W 97-89 ,240,38,83,0.458,32,61,0.525,6,22,0.273,15,18,0.833,97,37,84,0.44,31,67,0.463,6,17,0.353,9,14,0.643,89,2012-11-27,MIN,SAC
8281,81,@,W 97-92 ,240,37,85,0.435,28,59,0.475,9,26,0.346,14,19,0.737,97,32,75,0.427,26,58,0.448,6,17,0.353,22,25,0.88,92,2012-11-30,IND,SAC
8282,82,@,L 97-101 ,240,37,77,0.481,31,61,0.508,6,16,0.375,17,19,0.895,97,39,81,0.481,31,67,0.463,8,14,0.571,15,22,0.682,101,2012-11-30,PHO,TOR
8283,83,Home,L 97-104 ,240,35,79,0.443,29,58,0.5,6,21,0.286,21,31,0.677,97,34,75,0.453,25,51,0.49,9,24,0.375,27,34,0.794,104,2012-12-05,DET,GSW
8284,84,@,W 97-94 ,240,37,78,0.474,33,66,0.5,4,12,0.333,19,24,0.792,97,34,85,0.4,26,64,0.406,8,21,0.381,18,25,0.72,94,2012-12-06,DAL,PHO
8285,85,Home,L 97-104 ,240,39,91,0.429,33,64,0.516,6,27,0.222,13,17,0.765,97,35,75,0.467,26,60,0.433,9,15,0.6,25,33,0.758,104,2012-12-08,CLE,DET
8286,86,Home,L 97-101 ,240,37,87,0.425,28,62,0.452,9,25,0.36,14,23,0.609,97,35,81,0.432,26,59,0.441,9,22,0.409,22,27,0.815,101,2012-12-08,WAS,GSW
8287,87,@,W 97-88 ,240,33,71,0.465,26,55,0.473,7,16,0.438,24,30,0.8,97,32,79,0.405,25,54,0.463,7,25,0.28,17,23,0.739,88,2012-12-09,MIL,BRK
8288,88,@,L 97-104 ,240,32,81,0.395,27,63,0.429,5,18,0.278,28,33,0.848,97,44,82,0.537,40,71,0.563,4,11,0.364,12,23,0.522,104,2012-12-10,DET,PHI
8289,89,Home,L 97-100 ,240,36,68,0.529,32,50,0.64,4,18,0.222,21,28,0.75,97,36,78,0.462,22,50,0.44,14,28,0.5,14,18,0.778,100,2012-12-11,BRK,NYK
8290,90,@,W 97-95 ,240,38,82,0.463,29,58,0.5,9,24,0.375,12,14,0.857,97,38,80,0.475,31,58,0.534,7,22,0.318,12,15,0.8,95,2012-12-12,GSW,MIA
8291,91,Home,L 97-122 ,240,31,91,0.341,25,67,0.373,6,24,0.25,29,34,0.853,97,46,85,0.541,38,67,0.567,8,18,0.444,22,29,0.759,122,2012-12-16,SAC,DEN
8292,92,Home,W 97-91 ,240,35,72,0.486,25,43,0.581,10,29,0.345,17,22,0.773,97,35,84,0.417,32,72,0.444,3,12,0.25,18,30,0.6,91,2012-12-19,TOR,DET
8293,93,Home,W 97-85 ,240,37,87,0.425,30,64,0.469,7,23,0.304,16,24,0.667,97,33,79,0.418,25,57,0.439,8,22,0.364,11,16,0.688,85,2012-12-21,LAC,SAC
8294,94,@,W 97-93 ,240,36,83,0.434,29,65,0.446,7,18,0.389,18,25,0.72,97,38,76,0.5,29,56,0.518,9,20,0.45,8,15,0.533,93,2012-12-23,UTA,ORL
8295,95,Home,L 97-120 ,240,37,83,0.446,31,63,0.492,6,20,0.3,17,20,0.85,97,46,82,0.561,38,62,0.613,8,20,0.4,20,24,0.833,120,2012-12-25,CHI,HOU
8296,96,@,L 97-103 ,240,30,71,0.423,25,55,0.455,5,16,0.313,32,38,0.842,97,38,80,0.475,30,52,0.577,8,28,0.286,19,19,1.0,103,2012-12-25,OKC,MIA
8297,97,@,W 97-94 ,240,38,76,0.5,36,64,0.563,2,12,0.167,19,20,0.95,97,36,79,0.456,25,49,0.51,11,30,0.367,11,13,0.846,94,2012-12-26,NOP,ORL
8298,98,Home,L 97-99 ,240,38,83,0.458,30,62,0.484,8,21,0.381,13,16,0.813,97,40,88,0.455,31,66,0.47,9,22,0.409,10,14,0.714,99,2012-12-26,PHO,NYK
8299,99,Home,W 97-81 ,240,34,76,0.447,25,49,0.51,9,27,0.333,20,26,0.769,97,28,73,0.384,25,63,0.397,3,10,0.3,22,32,0.688,81,2012-12-28,BRK,CHA
8300,0,Home,W 97-91 ,240,34,77,0.442,26,61,0.426,8,16,0.5,21,29,0.724,97,38,82,0.463,36,68,0.529,2,14,0.143,13,16,0.813,91,2012-12-28,IND,PHO
8301,1,Home,L 97-104 (OT),265,37,82,0.451,32,69,0.464,5,13,0.385,18,24,0.75,97,37,85,0.435,32,61,0.525,5,24,0.208,25,32,0.781,104,2012-12-28,NOP,TOR
8302,2,@,L 97-105 ,240,39,86,0.453,29,58,0.5,10,28,0.357,9,11,0.818,97,42,88,0.477,36,68,0.529,6,20,0.3,15,17,0.882,105,2012-12-28,ORL,WAS
8303,3,@,L 97-103 ,240,36,86,0.419,27,60,0.45,9,26,0.346,16,21,0.762,97,39,75,0.52,31,55,0.564,8,20,0.4,17,22,0.773,103,2013-01-01,SAC,DET
8304,4,@,W 97-94 ,240,38,88,0.432,35,72,0.486,3,16,0.188,18,23,0.783,97,34,87,0.391,29,66,0.439,5,21,0.238,21,24,0.875,94,2013-01-02,SAC,CLE
8305,5,Home,L 97-101 ,240,40,86,0.465,34,64,0.531,6,22,0.273,11,20,0.55,97,37,83,0.446,31,67,0.463,6,16,0.375,21,30,0.7,101,2013-01-03,DEN,MIN
8306,6,Home,L 97-102 ,240,38,91,0.418,33,75,0.44,5,16,0.313,16,18,0.889,97,37,86,0.43,21,62,0.339,16,24,0.667,12,13,0.923,102,2013-01-05,MIN,POR
8307,7,@,L 97-103 ,240,35,92,0.38,20,49,0.408,15,43,0.349,12,19,0.632,97,41,86,0.477,35,71,0.493,6,15,0.4,15,18,0.833,103,2013-01-11,POR,GSW
8308,8,@,W 97-81 ,240,36,73,0.493,30,59,0.508,6,14,0.429,19,25,0.76,97,32,88,0.364,30,77,0.39,2,11,0.182,15,21,0.714,81,2013-01-12,PHO,CHI
8309,9,Home,W 97-86 ,240,33,81,0.407,27,67,0.403,6,14,0.429,25,31,0.806,97,35,83,0.422,29,59,0.492,6,24,0.25,10,12,0.833,86,2013-01-13,BRK,IND
8310,10,Home,W 97-58 ,240,33,79,0.418,27,65,0.415,6,14,0.429,25,33,0.758,97,24,82,0.293,22,68,0.324,2,14,0.143,8,10,0.8,58,2013-01-14,CHI,ATL
8311,11,@,L 97-104 ,240,39,72,0.542,30,49,0.612,9,23,0.391,10,16,0.625,97,36,76,0.474,28,58,0.483,8,18,0.444,24,28,0.857,104,2013-01-14,MIA,UTA
8312,12,@,L 97-117 ,240,33,73,0.452,31,58,0.534,2,15,0.133,29,37,0.784,97,44,85,0.518,35,66,0.53,9,19,0.474,20,26,0.769,117,2013-01-16,DEN,OKC
8313,13,Home,W 97-86 ,240,40,86,0.465,28,65,0.431,12,21,0.571,5,5,1.0,97,37,85,0.435,35,68,0.515,2,17,0.118,10,12,0.833,86,2013-01-16,ORL,IND
8314,14,@,W 97-93 ,240,37,81,0.457,32,63,0.508,5,18,0.278,18,21,0.857,97,31,72,0.431,26,57,0.456,5,15,0.333,26,38,0.684,93,2013-01-19,SAC,CHA
8315,15,Home,L 97-109 ,240,39,84,0.464,35,68,0.515,4,16,0.25,15,21,0.714,97,41,78,0.526,26,51,0.51,15,27,0.556,12,14,0.857,109,2013-01-22,LAC,OKC
8316,16,@,W 97-95 ,240,39,78,0.5,35,62,0.565,4,16,0.25,15,19,0.789,97,35,81,0.432,27,63,0.429,8,18,0.444,17,20,0.85,95,2013-01-24,TOR,ORL
8317,17,Home,W 97-80 ,240,38,75,0.507,32,56,0.571,6,19,0.316,15,22,0.682,97,28,81,0.346,24,54,0.444,4,27,0.148,20,23,0.87,80,2013-01-26,PHI,NYK
8318,18,Home,W 97-77 ,240,37,74,0.5,24,45,0.533,13,29,0.448,10,12,0.833,97,32,79,0.405,26,52,0.5,6,27,0.222,7,9,0.778,77,2013-01-28,BRK,ORL
8319,19,@,L 97-113 ,240,38,77,0.494,31,51,0.608,7,26,0.269,14,16,0.875,97,47,82,0.573,33,48,0.688,14,34,0.412,5,8,0.625,113,2013-01-30,ORL,NYK
8320,20,@,L 97-100 ,240,36,81,0.444,28,56,0.5,8,25,0.32,17,24,0.708,97,36,84,0.429,29,64,0.453,7,20,0.35,21,25,0.84,100,2013-01-31,DAL,GSW
8321,21,Home,W 97-84 ,240,42,84,0.5,38,66,0.576,4,18,0.222,9,14,0.643,97,36,95,0.379,33,76,0.434,3,19,0.158,9,9,1.0,84,2013-02-01,BOS,ORL
8322,22,Home,L 97-98 ,240,41,92,0.446,36,78,0.462,5,14,0.357,10,15,0.667,97,39,83,0.47,33,63,0.524,6,20,0.3,14,22,0.636,98,2013-02-03,DET,LAL
8323,23,@,L 97-107 ,240,35,70,0.5,28,58,0.483,7,12,0.583,20,26,0.769,97,44,80,0.55,38,64,0.594,6,16,0.375,13,14,0.929,107,2013-02-10,LAL,MIA
8324,24,@,W 97-69 ,240,34,76,0.447,25,59,0.424,9,17,0.529,20,27,0.741,97,30,91,0.33,26,77,0.338,4,14,0.286,5,5,1.0,69,2013-02-10,OKC,PHO
8325,25,@,W 97-93 ,240,38,87,0.437,36,76,0.474,2,11,0.182,19,25,0.76,97,29,85,0.341,24,63,0.381,5,22,0.227,30,38,0.789,93,2013-02-13,UTA,MIN
8326,26,Home,W 97-90 ,240,33,77,0.429,26,57,0.456,7,20,0.35,24,36,0.667,97,35,79,0.443,28,59,0.475,7,20,0.35,13,16,0.813,90,2013-02-19,DEN,BOS
8327,27,@,W 97-94 ,240,34,85,0.4,25,59,0.424,9,26,0.346,20,26,0.769,97,35,75,0.467,29,61,0.475,6,14,0.429,18,31,0.581,94,2013-02-20,BRK,MIL
8328,28,@,W 97-87 ,240,32,72,0.444,27,55,0.491,5,17,0.294,28,35,0.8,97,30,81,0.37,27,72,0.375,3,9,0.333,24,33,0.727,87,2013-02-24,SAS,PHO
8329,29,@,L 97-108 ,240,33,76,0.434,21,55,0.382,12,21,0.571,19,24,0.792,97,41,84,0.488,35,63,0.556,6,21,0.286,20,27,0.741,108,2013-02-26,GSW,IND
8330,30,Home,L 97-101 ,240,40,87,0.46,35,73,0.479,5,14,0.357,12,15,0.8,97,37,76,0.487,25,56,0.446,12,20,0.6,15,18,0.833,101,2013-02-26,NOP,BRK
8331,31,@,L 97-104 ,240,36,86,0.419,26,60,0.433,10,26,0.385,15,19,0.789,97,44,85,0.518,32,67,0.478,12,18,0.667,4,9,0.444,104,2013-03-02,GSW,PHI
8332,32,Home,W 97-92 ,240,33,71,0.465,27,58,0.466,6,13,0.462,25,33,0.758,97,35,81,0.432,27,62,0.435,8,19,0.421,14,18,0.778,92,2013-03-03,IND,CHI
8333,33,Home,L 97-102 ,240,37,73,0.507,31,53,0.585,6,20,0.3,17,24,0.708,97,36,78,0.462,24,48,0.5,12,30,0.4,18,21,0.857,102,2013-03-04,CLE,NYK
8334,34,@,W 97-81 ,240,38,74,0.514,33,53,0.623,5,21,0.238,16,19,0.842,97,33,88,0.375,28,68,0.412,5,20,0.25,10,15,0.667,81,2013-03-04,MIA,MIN
8335,35,Home,W 97-96 ,240,32,74,0.432,26,46,0.565,6,28,0.214,27,31,0.871,97,40,89,0.449,34,61,0.557,6,28,0.214,10,12,0.833,96,2013-03-06,MIA,ORL
8336,36,@,L 97-129 ,240,30,64,0.469,19,41,0.463,11,23,0.478,26,42,0.619,97,50,80,0.625,36,52,0.692,14,28,0.5,15,25,0.6,129,2013-03-10,DET,LAC
8337,37,@,L 97-106 ,240,40,81,0.494,34,62,0.548,6,19,0.316,11,16,0.688,97,40,76,0.526,32,61,0.525,8,15,0.533,18,27,0.667,106,2013-03-11,BRK,PHI
8338,38,Home,L 97-106 ,240,37,93,0.398,27,61,0.443,10,32,0.313,13,17,0.765,97,34,73,0.466,25,48,0.521,9,25,0.36,29,47,0.617,106,2013-03-12,ORL,LAL
8339,39,Home,L 97-102 ,240,32,79,0.405,27,63,0.429,5,16,0.313,28,29,0.966,97,39,76,0.513,36,65,0.554,3,11,0.273,21,31,0.677,102,2013-03-12,POR,MEM
8340,40,@,L 97-105 ,240,40,89,0.449,35,72,0.486,5,17,0.294,12,14,0.857,97,41,72,0.569,33,54,0.611,8,18,0.444,15,25,0.6,105,2013-03-13,DET,GSW
8341,41,Home,W 97-95 ,240,36,64,0.563,31,49,0.633,5,15,0.333,20,27,0.741,97,39,85,0.459,34,72,0.472,5,13,0.385,12,16,0.75,95,2013-03-17,MIN,NOH
8342,42,@,W 97-89 ,240,34,80,0.425,29,59,0.492,5,21,0.238,24,33,0.727,97,38,92,0.413,33,76,0.434,5,16,0.313,8,10,0.8,89,2013-03-22,OKC,ORL
8343,43,@,L 97-104 (OT),265,41,96,0.427,33,79,0.418,8,17,0.471,7,12,0.583,97,39,84,0.464,31,64,0.484,8,20,0.4,18,24,0.75,104,2013-03-22,UTA,SAS
8344,44,Home,L 97-104 ,240,39,78,0.5,33,66,0.5,6,12,0.5,13,19,0.684,97,41,89,0.461,31,63,0.492,10,26,0.385,12,17,0.706,104,2013-03-24,MIN,CHI
8345,45,@,L 97-101 ,240,37,77,0.481,30,57,0.526,7,20,0.35,16,23,0.696,97,40,85,0.471,32,63,0.508,8,22,0.364,13,18,0.722,101,2013-03-27,MIA,CHI
8346,46,@,W 97-87 ,240,42,86,0.488,35,68,0.515,7,18,0.389,6,10,0.6,97,37,86,0.43,33,68,0.485,4,18,0.222,9,15,0.6,87,2013-03-29,PHI,CLE
8347,47,Home,W 97-92 ,240,37,86,0.43,32,71,0.451,5,15,0.333,18,22,0.818,97,30,81,0.37,26,61,0.426,4,20,0.2,28,32,0.875,92,2013-03-29,ORL,WAS
8348,48,Home,W 97-88 ,240,34,78,0.436,28,57,0.491,6,21,0.286,23,31,0.742,97,34,87,0.391,30,74,0.405,4,13,0.308,16,27,0.593,88,2013-03-30,ATL,ORL
8349,49,@,W 97-91 ,240,36,89,0.404,33,76,0.434,3,13,0.231,22,26,0.846,97,36,89,0.404,30,67,0.448,6,22,0.273,13,22,0.591,91,2013-04-05,CLE,BOS
8350,50,@,W 97-75 ,240,37,78,0.474,33,66,0.5,4,12,0.333,19,23,0.826,97,27,72,0.375,25,51,0.49,2,21,0.095,19,24,0.792,75,2013-04-05,OKC,IND
8351,51,@,L 97-99 ,240,35,83,0.422,30,71,0.423,5,12,0.417,22,25,0.88,97,36,80,0.45,33,65,0.508,3,15,0.2,24,29,0.828,99,2013-04-06,ATL,SAS
8352,52,@,W 97-90 ,240,40,88,0.455,29,63,0.46,11,25,0.44,6,7,0.857,97,35,74,0.473,28,57,0.491,7,17,0.412,13,18,0.722,90,2013-04-07,UTA,GSW
8353,53,Home,L 97-116 ,240,37,84,0.44,30,68,0.441,7,16,0.438,16,26,0.615,97,42,83,0.506,30,56,0.536,12,27,0.444,20,23,0.87,116,2013-04-11,GSW,OKC
8354,54,Home,W 97-88 ,240,34,72,0.472,32,64,0.5,2,8,0.25,27,33,0.818,97,34,77,0.442,25,59,0.424,9,18,0.5,11,14,0.786,88,2013-04-12,TOR,CHI
8355,55,@,W 97-86 ,240,40,93,0.43,33,71,0.465,7,22,0.318,10,11,0.909,97,36,87,0.414,35,74,0.473,1,13,0.077,13,21,0.619,86,2013-04-12,PHI,WAS
8356,56,Home,L 97-103 ,240,34,76,0.447,25,57,0.439,9,19,0.474,20,25,0.8,97,38,80,0.475,31,59,0.525,7,21,0.333,20,25,0.8,103,2013-04-15,DAL,MEM
8357,57,Home,W 97-87 ,240,34,71,0.479,27,54,0.5,7,17,0.412,22,32,0.688,97,36,93,0.387,27,74,0.365,9,19,0.474,6,10,0.6,87,2013-10-29,IND,ORL
8358,58,@,W 97-90 ,240,31,78,0.397,24,55,0.436,7,23,0.304,28,38,0.737,97,37,84,0.44,31,67,0.463,6,17,0.353,10,18,0.556,90,2013-11-02,TOR,MIL
8359,59,Home,L 97-102 ,240,35,82,0.427,27,54,0.5,8,28,0.286,19,23,0.826,97,30,71,0.423,22,50,0.44,8,21,0.381,34,42,0.81,102,2013-11-05,NYK,CHA
8360,60,Home,W 97-87 ,240,40,89,0.449,33,69,0.478,7,20,0.35,10,14,0.714,97,37,80,0.463,36,70,0.514,1,10,0.1,12,18,0.667,87,2013-11-06,BOS,UTA
8361,61,Home,W 97-80 ,240,36,86,0.419,29,68,0.426,7,18,0.389,18,21,0.857,97,26,73,0.356,21,58,0.362,5,15,0.333,23,27,0.852,80,2013-11-06,IND,CHI
8362,62,@,L 97-102 ,240,36,73,0.493,28,49,0.571,8,24,0.333,17,21,0.81,97,38,71,0.535,33,55,0.6,5,16,0.313,21,33,0.636,102,2013-11-07,LAC,MIA
8363,63,Home,W 97-73 ,240,38,72,0.528,35,64,0.547,3,8,0.375,18,25,0.72,97,25,85,0.294,18,65,0.277,7,20,0.35,16,25,0.64,73,2013-11-08,CHI,UTA
8364,64,@,W 97-90 ,240,38,85,0.447,32,62,0.516,6,23,0.261,15,24,0.625,97,34,80,0.425,24,55,0.436,10,25,0.4,12,17,0.706,90,2013-11-15,DET,SAC
8365,65,@,W 97-81 ,240,35,69,0.507,29,54,0.537,6,15,0.4,21,23,0.913,97,29,83,0.349,21,56,0.375,8,27,0.296,15,20,0.75,81,2013-11-16,MIA,CHA
8366,66,@,W 97-86 ,240,40,72,0.556,36,59,0.61,4,13,0.308,13,18,0.722,97,33,87,0.379,26,64,0.406,7,23,0.304,13,17,0.765,86,2013-11-17,MEM,SAC
8367,67,Home,W 97-94 ,240,34,78,0.436,25,49,0.51,9,29,0.31,20,26,0.769,97,38,99,0.384,32,78,0.41,6,21,0.286,12,22,0.545,94,2013-11-18,DAL,PHI
8368,68,Home,W 97-87 ,240,38,84,0.452,29,63,0.46,9,21,0.429,12,22,0.545,97,38,98,0.388,35,88,0.398,3,10,0.3,8,14,0.571,87,2013-11-21,DEN,CHI
8369,69,@,W 97-82 ,240,38,81,0.469,32,64,0.5,6,17,0.353,15,18,0.833,97,35,69,0.507,30,58,0.517,5,11,0.455,7,9,0.778,82,2013-11-22,IND,BOS
8370,70,Home,L 97-109 ,240,35,77,0.455,21,51,0.412,14,26,0.538,13,18,0.722,97,38,80,0.475,33,63,0.524,5,17,0.294,28,40,0.7,109,2013-11-24,BRK,DET
8371,71,Home,W 97-95 ,240,31,71,0.437,22,47,0.468,9,24,0.375,26,34,0.765,97,34,83,0.41,28,61,0.459,6,22,0.273,21,25,0.84,95,2013-11-29,DEN,NYK
8372,72,Home,W 97-93 ,240,37,78,0.474,30,63,0.476,7,15,0.467,16,19,0.842,97,39,82,0.476,33,67,0.493,6,15,0.4,9,15,0.6,93,2013-11-30,CLE,CHI
8373,73,@,W 97-88 ,240,34,73,0.466,25,55,0.455,9,18,0.5,20,26,0.769,97,36,77,0.468,29,62,0.468,7,15,0.467,9,12,0.75,88,2013-11-30,BRK,MEM
8374,74,Home,L 97-107 ,240,36,82,0.439,27,54,0.5,9,28,0.321,16,23,0.696,97,41,80,0.513,34,64,0.531,7,16,0.438,18,26,0.692,107,2013-12-03,MIA,DET
8375,75,@,W 97-95 ,240,36,83,0.434,29,63,0.46,7,20,0.35,18,20,0.9,97,35,89,0.393,25,60,0.417,10,29,0.345,15,19,0.789,95,2013-12-03,OKC,SAC
8376,76,@,L 97-107 ,240,39,83,0.47,35,64,0.547,4,19,0.211,15,20,0.75,97,42,82,0.512,30,59,0.508,12,23,0.522,11,16,0.688,107,2013-12-04,LAC,ATL
8377,77,@,W 97-88 ,240,36,79,0.456,25,55,0.455,11,24,0.458,14,19,0.737,97,31,88,0.352,22,57,0.386,9,31,0.29,17,19,0.895,88,2013-12-04,PHO,HOU
8378,78,Home,L 97-100 ,240,38,94,0.404,31,72,0.431,7,22,0.318,14,15,0.933,97,37,86,0.43,26,62,0.419,11,24,0.458,15,22,0.682,100,2013-12-04,NOP,DAL
8379,79,@,L 97-106 ,240,35,87,0.402,30,68,0.441,5,19,0.263,22,25,0.88,97,37,82,0.451,28,59,0.475,9,23,0.391,23,32,0.719,106,2013-12-06,TOR,PHO
8380,80,@,L 97-112 ,240,37,95,0.389,32,68,0.471,5,27,0.185,18,20,0.9,97,38,81,0.469,29,56,0.518,9,25,0.36,27,34,0.794,112,2013-12-09,DAL,SAC
8381,81,@,L 97-122 ,240,36,87,0.414,29,62,0.468,7,25,0.28,18,31,0.581,97,47,99,0.475,39,74,0.527,8,25,0.32,20,23,0.87,122,2013-12-13,LAL,OKC
8382,82,Home,L 97-113 ,240,40,81,0.494,37,67,0.552,3,14,0.214,14,20,0.7,97,39,69,0.565,30,48,0.625,9,21,0.429,26,31,0.839,113,2013-12-14,WAS,LAC
8383,83,@,L 97-101 ,240,37,98,0.378,29,69,0.42,8,29,0.276,15,26,0.577,97,38,86,0.442,31,65,0.477,7,21,0.333,18,23,0.783,101,2013-12-16,MIN,BOS
8384,84,Home,W 97-94 ,240,37,77,0.481,32,56,0.571,5,21,0.238,18,22,0.818,97,32,73,0.438,27,59,0.458,5,14,0.357,25,28,0.893,94,2013-12-18,MIA,IND
8385,85,Home,L 97-114 ,240,40,89,0.449,39,77,0.506,1,12,0.083,16,26,0.615,97,44,79,0.557,35,56,0.625,9,23,0.391,17,23,0.739,114,2013-12-21,DET,HOU
8386,86,@,W 97-94 ,240,34,67,0.507,23,44,0.523,11,23,0.478,18,28,0.643,97,38,81,0.469,30,61,0.492,8,20,0.4,10,11,0.909,94,2013-12-30,MIA,DEN
8387,87,@,L 97-102 ,240,39,77,0.506,32,55,0.582,7,22,0.318,12,21,0.571,97,38,81,0.469,35,70,0.5,3,11,0.273,23,27,0.852,102,2014-01-05,TOR,MIA
8388,88,@,W 97-83 ,240,40,85,0.471,35,68,0.515,5,17,0.294,12,15,0.8,97,31,72,0.431,25,56,0.446,6,16,0.375,15,24,0.625,83,2014-01-07,WAS,CHA
8389,89,@,L 97-110 ,240,34,81,0.42,23,50,0.46,11,31,0.355,18,26,0.692,97,48,90,0.533,43,73,0.589,5,17,0.294,9,15,0.6,110,2014-01-07,LAL,DAL
8390,90,Home,W 97-87 ,240,34,75,0.453,24,52,0.462,10,23,0.435,19,22,0.864,97,35,87,0.402,26,60,0.433,9,27,0.333,8,9,0.889,87,2014-01-08,ATL,IND
8391,91,@,L 97-99 ,240,38,85,0.447,31,66,0.47,7,19,0.368,14,16,0.875,97,38,92,0.413,30,66,0.455,8,26,0.308,15,21,0.714,99,2014-01-10,BOS,GSW
8392,92,@,L 97-103 ,240,37,79,0.468,33,68,0.485,4,11,0.364,19,20,0.95,97,38,81,0.469,32,67,0.478,6,14,0.429,21,26,0.808,103,2014-01-11,CHA,CHI
8393,93,@,L 97-114 ,240,37,84,0.44,30,59,0.508,7,25,0.28,16,17,0.941,97,41,75,0.547,31,53,0.585,10,22,0.455,22,26,0.846,114,2014-01-15,MIA,WAS
8394,94,@,W 97-87 ,240,37,84,0.44,31,62,0.5,6,22,0.273,17,19,0.895,97,32,83,0.386,30,72,0.417,2,11,0.182,21,28,0.75,87,2014-01-18,GSW,NOP
8395,95,Home,L 97-102 ,240,33,81,0.407,28,58,0.483,5,23,0.217,26,33,0.788,97,38,83,0.458,34,63,0.54,4,20,0.2,22,28,0.786,102,2014-01-20,CLE,DAL
8396,96,Home,L 97-114 ,240,33,69,0.478,28,58,0.483,5,11,0.455,26,38,0.684,97,42,82,0.512,33,61,0.541,9,21,0.429,21,31,0.677,114,2014-01-21,NOP,SAC
8397,97,@,L 97-105 ,240,40,86,0.465,33,67,0.493,7,19,0.368,10,16,0.625,97,42,87,0.483,32,72,0.444,10,15,0.667,11,17,0.647,105,2014-01-21,POR,OKC
8398,98,Home,L 97-112 ,240,41,87,0.471,36,70,0.514,5,17,0.294,10,12,0.833,97,41,90,0.456,33,69,0.478,8,21,0.381,22,24,0.917,112,2014-01-21,UTA,MIN
8399,99,Home,W 97-90 ,240,33,75,0.44,28,57,0.491,5,18,0.278,26,47,0.553,97,35,82,0.427,29,59,0.492,6,23,0.261,14,21,0.667,90,2014-01-28,HOU,SAS
8400,0,Home,W 97-96 ,240,31,73,0.425,28,58,0.483,3,15,0.2,32,37,0.865,97,34,77,0.442,27,54,0.5,7,23,0.304,21,23,0.913,96,2014-02-01,IND,BRK
8401,1,@,L 97-106 ,240,37,78,0.474,31,58,0.534,6,20,0.3,17,23,0.739,97,44,91,0.484,34,64,0.531,10,27,0.37,8,11,0.727,106,2014-02-05,MIN,OKC
8402,2,Home,L 97-103 ,240,35,76,0.461,23,48,0.479,12,28,0.429,15,17,0.882,97,36,76,0.474,27,49,0.551,9,27,0.333,22,30,0.733,103,2014-02-11,PHO,MIA
8403,3,Home,L 97-114 ,240,33,73,0.452,27,57,0.474,6,16,0.375,25,30,0.833,97,46,89,0.517,33,65,0.508,13,24,0.542,9,11,0.818,114,2014-02-19,ATL,WAS
8404,4,@,L 97-108 ,240,37,94,0.394,28,66,0.424,9,28,0.321,14,20,0.7,97,40,83,0.482,27,55,0.491,13,28,0.464,15,16,0.938,108,2014-02-23,MIN,POR
8405,5,Home,L 97-102 ,240,38,89,0.427,31,68,0.456,7,21,0.333,14,17,0.824,97,39,77,0.506,34,64,0.531,5,13,0.385,19,23,0.826,102,2014-03-01,BOS,IND
8406,6,Home,L 97-108 ,240,37,82,0.451,30,60,0.5,7,22,0.318,16,21,0.762,97,37,81,0.457,32,60,0.533,5,21,0.238,29,38,0.763,108,2014-03-01,SAC,MIN
8407,7,@,L 97-111 ,240,39,86,0.453,31,52,0.596,8,34,0.235,11,13,0.846,97,43,80,0.538,37,61,0.607,6,19,0.316,19,24,0.792,111,2014-03-07,ATL,GSW
8408,8,Home,L 97-107 ,240,36,87,0.414,27,64,0.422,9,23,0.391,16,18,0.889,97,38,88,0.432,24,57,0.421,14,31,0.452,17,23,0.739,107,2014-03-08,CLE,NYK
8409,9,@,L 97-101 ,240,35,71,0.493,29,48,0.604,6,23,0.261,21,24,0.875,97,34,70,0.486,23,50,0.46,11,20,0.55,22,31,0.71,101,2014-03-10,TOR,BRK
8410,10,@,L 97-102 ,240,37,89,0.416,34,70,0.486,3,19,0.158,20,26,0.769,97,36,74,0.486,23,45,0.511,13,29,0.448,17,20,0.85,102,2014-03-13,MIL,ATL
8411,11,Home,W 97-92 ,240,33,81,0.407,19,49,0.388,14,32,0.438,17,29,0.586,97,34,83,0.41,26,58,0.448,8,25,0.32,16,25,0.64,92,2014-03-15,ATL,DEN
8412,12,@,W 97-83 ,240,39,85,0.459,26,51,0.51,13,34,0.382,6,7,0.857,97,30,85,0.353,21,60,0.35,9,25,0.36,14,16,0.875,83,2014-03-17,ATL,CHA
8413,13,@,W 97-85 ,240,31,75,0.413,18,50,0.36,13,25,0.52,22,28,0.786,97,29,84,0.345,24,62,0.387,5,22,0.227,22,31,0.71,85,2014-03-17,OKC,CHI
8414,14,@,W 97-96 ,240,37,85,0.435,28,59,0.475,9,26,0.346,14,24,0.583,97,39,84,0.464,28,58,0.483,11,26,0.423,7,13,0.538,96,2014-03-26,CLE,DET
8415,15,@,L 97-108 ,240,37,87,0.425,27,63,0.429,10,24,0.417,13,16,0.813,97,39,71,0.549,25,42,0.595,14,29,0.483,16,21,0.762,108,2014-03-28,CLE,BRK
8416,16,@,L 97-101 ,240,34,80,0.425,25,49,0.51,9,31,0.29,20,28,0.714,97,39,79,0.494,33,65,0.508,6,14,0.429,17,25,0.68,101,2014-03-29,ATL,WAS
8417,17,Home,L 97-102 ,240,36,73,0.493,31,59,0.525,5,14,0.357,20,26,0.769,97,38,80,0.475,35,69,0.507,3,11,0.273,23,31,0.742,102,2014-03-31,NOP,SAC
8418,18,@,L 97-120 ,240,36,86,0.419,29,55,0.527,7,31,0.226,18,23,0.783,97,47,83,0.566,37,64,0.578,10,19,0.526,16,26,0.615,120,2014-04-06,LAL,LAC
8419,19,@,L 97-105 ,240,37,84,0.44,25,58,0.431,12,26,0.462,11,14,0.786,97,40,76,0.526,31,53,0.585,9,23,0.391,16,22,0.727,105,2014-04-09,BOS,ATL
8420,20,Home,W 97-88 ,240,34,73,0.466,22,44,0.5,12,29,0.414,17,23,0.739,97,35,74,0.473,27,54,0.5,8,20,0.4,10,14,0.714,88,2014-04-13,BRK,ORL
8421,21,@,L 97-102 ,240,36,84,0.429,29,56,0.518,7,28,0.25,18,19,0.947,97,38,72,0.528,29,52,0.558,9,20,0.45,17,23,0.739,102,2014-04-13,OKC,IND
8422,22,@,W 97-91 ,240,40,77,0.519,34,62,0.548,6,15,0.4,11,15,0.733,97,38,80,0.475,33,54,0.611,5,26,0.192,10,14,0.714,91,2014-04-14,MEM,PHO
8423,23,Home,W 97-91 ,240,37,76,0.487,33,66,0.5,4,10,0.4,19,28,0.679,97,38,91,0.418,31,70,0.443,7,21,0.333,8,13,0.615,91,2014-10-30,MIN,DET
8424,24,@,W 97-89 ,240,35,79,0.443,28,60,0.467,7,19,0.368,20,27,0.741,97,34,74,0.459,26,53,0.491,8,21,0.381,13,16,0.813,89,2014-10-31,MEM,IND
8425,25,@,L 97-108 ,240,34,80,0.425,25,58,0.431,9,22,0.409,20,24,0.833,97,40,73,0.548,36,60,0.6,4,13,0.308,24,33,0.727,108,2014-11-01,MIL,WAS
8426,26,@,W 97-90 ,240,39,81,0.481,37,70,0.529,2,11,0.182,17,23,0.739,97,33,77,0.429,25,53,0.472,8,24,0.333,16,25,0.64,90,2014-11-08,WAS,IND
8427,27,@,W 97-96 ,240,33,72,0.458,27,57,0.474,6,15,0.4,25,35,0.714,97,36,93,0.387,30,70,0.429,6,23,0.261,18,25,0.72,96,2014-11-09,UTA,DET
8428,28,Home,W 97-86 ,240,39,90,0.433,33,75,0.44,6,15,0.4,13,15,0.867,97,32,74,0.432,26,53,0.491,6,21,0.286,16,21,0.762,86,2014-11-10,IND,UTA
8429,29,@,L 97-100 ,240,43,86,0.5,38,63,0.603,5,23,0.217,6,12,0.5,97,39,76,0.513,30,56,0.536,9,20,0.45,13,18,0.722,100,2014-11-12,UTA,ATL
8430,30,@,W 97-95 ,240,33,70,0.471,27,58,0.466,6,12,0.5,25,32,0.781,97,37,86,0.43,29,63,0.46,8,23,0.348,13,14,0.929,95,2014-11-12,ORL,NYK
8431,31,Home,W 97-87 ,240,33,78,0.423,22,52,0.423,11,26,0.423,20,27,0.741,97,35,89,0.393,34,70,0.486,1,19,0.053,16,17,0.941,87,2014-11-15,POR,BRK
8432,32,Home,L 97-106 ,240,34,79,0.43,24,50,0.48,10,29,0.345,19,23,0.826,97,41,85,0.482,29,54,0.537,12,31,0.387,12,15,0.8,106,2014-11-17,CLE,DEN
8433,33,@,L 97-117 ,240,31,78,0.397,26,62,0.419,5,16,0.313,30,34,0.882,97,43,82,0.524,32,58,0.552,11,24,0.458,20,25,0.8,117,2014-11-21,NOP,DEN
8434,34,@,W 97-95 ,240,36,72,0.5,27,52,0.519,9,20,0.45,16,23,0.696,97,42,86,0.488,39,77,0.506,3,9,0.333,8,10,0.8,95,2014-11-24,CHI,UTA
8435,35,Home,L 97-114 ,240,33,85,0.388,23,62,0.371,10,23,0.435,21,27,0.778,97,43,75,0.573,30,47,0.638,13,28,0.464,15,23,0.652,114,2014-11-25,MIA,GSW
8436,36,Home,L 97-105 ,240,41,94,0.436,36,79,0.456,5,15,0.333,10,15,0.667,97,39,92,0.424,27,65,0.415,12,27,0.444,15,20,0.75,105,2014-11-26,CHA,POR
8437,37,Home,W 97-82 ,240,40,83,0.482,28,57,0.491,12,26,0.462,5,10,0.5,97,31,70,0.443,28,54,0.519,3,16,0.188,17,28,0.607,82,2014-11-26,OKC,UTA
8438,38,@,L 97-122 ,240,33,85,0.388,25,62,0.403,8,23,0.348,23,29,0.793,97,41,88,0.466,33,67,0.493,8,21,0.381,32,36,0.889,122,2014-11-28,PHO,DEN
8439,39,@,L 97-109 ,240,35,89,0.393,28,67,0.418,7,22,0.318,20,26,0.769,97,41,78,0.526,34,62,0.548,7,16,0.438,20,32,0.625,109,2014-11-29,IND,CLE
8440,40,@,W 97-85 ,240,38,79,0.481,35,66,0.53,3,13,0.231,18,28,0.643,97,33,70,0.471,32,59,0.542,1,11,0.091,18,27,0.667,85,2014-11-30,MEM,SAC
8441,41,@,L 97-98 ,240,39,87,0.448,33,70,0.471,6,17,0.353,13,14,0.929,97,38,82,0.463,30,55,0.545,8,27,0.296,14,18,0.778,98,2014-12-02,ORL,GSW
8442,42,Home,L 97-103 ,240,37,77,0.481,20,42,0.476,17,35,0.486,6,9,0.667,97,43,80,0.538,34,63,0.54,9,17,0.529,8,12,0.667,103,2014-12-09,PHO,MIA
8443,43,Home,W 97-88 ,240,38,83,0.458,29,59,0.492,9,24,0.375,12,17,0.706,97,38,83,0.458,33,67,0.493,5,16,0.313,7,14,0.5,88,2014-12-15,CLE,CHO
8444,44,@,L 97-104 ,240,37,77,0.481,30,58,0.517,7,19,0.368,16,22,0.727,97,41,87,0.471,34,64,0.531,7,23,0.304,15,29,0.517,104,2014-12-17,MIL,POR
8445,45,@,L 97-103 ,240,38,82,0.463,32,73,0.438,6,9,0.667,15,19,0.789,97,34,75,0.453,22,52,0.423,12,23,0.522,23,30,0.767,103,2014-12-18,NYK,CHI
8446,46,Home,L 97-103 ,240,37,94,0.394,35,81,0.432,2,13,0.154,21,24,0.875,97,32,73,0.438,22,47,0.468,10,26,0.385,29,33,0.879,103,2014-12-19,MEM,CHI
8447,47,Home,L 97-104 ,240,34,86,0.395,19,43,0.442,15,43,0.349,14,18,0.778,97,38,74,0.514,28,48,0.583,10,26,0.385,18,24,0.75,104,2014-12-20,HOU,ATL
8448,48,@,W 97-91 ,240,34,75,0.453,25,56,0.446,9,19,0.474,20,27,0.741,97,38,86,0.442,31,63,0.492,7,23,0.304,8,9,0.889,91,2014-12-22,UTA,MEM
8449,49,Home,W 97-90 ,240,35,84,0.417,29,67,0.433,6,17,0.353,21,24,0.875,97,37,75,0.493,31,61,0.508,6,14,0.429,10,14,0.714,90,2014-12-26,NOP,SAS
8450,50,@,L 97-110 ,240,34,77,0.442,26,58,0.448,8,19,0.421,21,36,0.583,97,41,88,0.466,30,60,0.5,11,28,0.393,17,21,0.81,110,2014-12-27,MIN,GSW
8451,51,@,L 97-101 ,240,38,92,0.413,30,73,0.411,8,19,0.421,13,22,0.591,97,37,81,0.457,27,58,0.466,10,23,0.435,17,22,0.773,101,2014-12-29,UTA,LAC
8452,52,@,L 97-102 (OT),265,40,99,0.404,36,77,0.468,4,22,0.182,13,15,0.867,97,38,95,0.4,26,59,0.441,12,36,0.333,14,18,0.778,102,2014-12-30,TOR,POR
8453,53,@,W 97-81 ,240,38,76,0.5,25,43,0.581,13,33,0.394,8,14,0.571,97,32,91,0.352,22,67,0.328,10,24,0.417,7,14,0.5,81,2015-01-02,DET,NYK
8454,54,@,W 97-77 ,240,37,78,0.474,32,62,0.516,5,16,0.313,18,24,0.75,97,28,84,0.333,22,64,0.344,6,20,0.3,15,20,0.75,77,2015-01-07,UTA,CHI
8455,55,@,W 97-77 ,240,41,76,0.539,33,59,0.559,8,17,0.471,7,11,0.636,97,25,83,0.301,23,58,0.397,2,25,0.08,25,29,0.862,77,2015-01-07,MIL,PHI
8456,56,Home,W 97-82 ,240,33,77,0.429,20,43,0.465,13,34,0.382,18,21,0.857,97,29,70,0.414,24,53,0.453,5,17,0.294,19,21,0.905,82,2015-01-10,HOU,UTA
8457,57,Home,W 97-89 ,240,33,79,0.418,25,54,0.463,8,25,0.32,23,29,0.793,97,34,83,0.41,25,58,0.431,9,25,0.36,12,25,0.48,89,2015-01-16,DAL,DEN
8458,58,Home,W 97-84 ,240,35,78,0.449,23,51,0.451,12,27,0.444,15,22,0.682,97,31,78,0.397,19,45,0.422,12,33,0.364,10,14,0.714,84,2015-02-02,CLE,PHI
8459,59,@,L 97-104 ,240,38,90,0.422,32,67,0.478,6,23,0.261,15,18,0.833,97,37,75,0.493,29,55,0.527,8,20,0.4,22,26,0.846,104,2015-02-02,ORL,OKC
8460,60,Home,L 97-108 ,240,41,83,0.494,34,63,0.54,7,20,0.35,8,11,0.727,97,42,77,0.545,36,53,0.679,6,24,0.25,18,23,0.783,108,2015-02-03,NYK,BOS
8461,61,@,L 97-103 (OT),265,39,97,0.402,28,71,0.394,11,26,0.423,8,13,0.615,97,43,83,0.518,38,68,0.559,5,15,0.333,12,14,0.857,103,2015-02-06,LAL,ORL
8462,62,Home,L 97-98 ,240,39,83,0.47,30,58,0.517,9,25,0.36,10,13,0.769,97,37,77,0.481,29,55,0.527,8,22,0.364,16,18,0.889,98,2015-02-08,ORL,CHI
8463,63,@,L 97-103 ,240,38,76,0.5,29,51,0.569,9,25,0.36,12,19,0.632,97,37,89,0.416,30,71,0.423,7,18,0.389,22,25,0.88,103,2015-02-09,BRK,MIL
8464,64,@,W 97-86 ,240,35,87,0.402,26,57,0.456,9,30,0.3,18,21,0.857,97,32,72,0.444,28,56,0.5,4,16,0.25,18,18,1.0,86,2015-02-22,ATL,MIL
8465,65,@,L 97-100 ,240,35,84,0.417,30,61,0.492,5,23,0.217,22,31,0.71,97,40,78,0.513,30,56,0.536,10,22,0.455,10,16,0.625,100,2015-02-23,TOR,NOP
8466,66,Home,W 97-77 ,240,35,81,0.432,31,68,0.456,4,13,0.308,23,28,0.821,97,33,87,0.379,29,69,0.42,4,18,0.222,7,8,0.875,77,2015-02-25,MIN,WAS
8467,67,Home,L 97-100 ,240,34,73,0.466,27,61,0.443,7,12,0.583,22,34,0.647,97,40,89,0.449,38,78,0.487,2,11,0.182,18,21,0.857,100,2015-02-25,UTA,LAL
8468,68,@,W 97-79 ,240,36,78,0.462,27,52,0.519,9,26,0.346,16,28,0.571,97,33,87,0.379,30,75,0.4,3,12,0.25,10,15,0.667,79,2015-02-27,LAC,MEM
8469,69,Home,L 97-101 ,240,34,88,0.386,27,69,0.391,7,19,0.368,22,27,0.815,97,38,64,0.594,34,53,0.642,4,11,0.364,21,29,0.724,101,2015-02-28,MIN,MEM
8470,70,Home,W 97-92 ,240,33,78,0.423,24,49,0.49,9,29,0.31,22,30,0.733,97,35,84,0.417,27,62,0.435,8,22,0.364,14,19,0.737,92,2015-03-03,CHI,WAS
8471,71,@,L 97-106 ,240,29,69,0.42,16,31,0.516,13,38,0.342,26,33,0.788,97,43,84,0.512,37,63,0.587,6,21,0.286,14,17,0.824,106,2015-03-06,CLE,ATL
8472,72,Home,W 97-90 ,240,34,77,0.442,33,66,0.5,1,11,0.091,28,33,0.848,97,39,84,0.464,34,72,0.472,5,12,0.417,7,9,0.778,90,2015-03-06,MEM,LAL
8473,73,@,L 97-99 ,240,37,79,0.468,27,52,0.519,10,27,0.37,13,19,0.684,97,38,82,0.463,31,59,0.525,7,23,0.304,16,18,0.889,99,2015-03-06,MIA,WAS
8474,74,Home,W 97-91 ,240,39,79,0.494,31,61,0.508,8,18,0.444,11,16,0.688,97,34,85,0.4,24,67,0.358,10,18,0.556,13,13,1.0,91,2015-03-11,MIL,ORL
8475,75,@,L 97-106 ,240,36,81,0.444,35,68,0.515,1,13,0.077,24,26,0.923,97,45,90,0.5,39,66,0.591,6,24,0.25,10,13,0.769,106,2015-03-11,MIN,PHO
8476,76,@,L 97-113 ,240,35,77,0.455,29,58,0.5,6,19,0.316,21,28,0.75,97,43,81,0.531,30,55,0.545,13,26,0.5,14,17,0.824,113,2015-03-14,SAC,WAS
8477,77,@,L 97-123 ,240,38,86,0.442,31,71,0.437,7,15,0.467,14,18,0.778,97,49,84,0.583,37,62,0.597,12,22,0.545,13,15,0.867,123,2015-03-15,MIN,SAS
8478,78,Home,L 97-113 ,240,37,78,0.474,32,60,0.533,5,18,0.278,18,23,0.783,97,45,86,0.523,32,57,0.561,13,29,0.448,10,16,0.625,113,2015-03-15,TOR,POR
8479,79,@,L 97-105 ,240,36,89,0.404,28,61,0.459,8,28,0.286,17,20,0.85,97,41,82,0.5,34,70,0.486,7,12,0.583,16,26,0.615,105,2015-03-16,POR,WAS
8480,80,Home,W 97-81 ,240,37,88,0.42,26,58,0.448,11,30,0.367,12,15,0.8,97,25,69,0.362,17,53,0.321,8,16,0.5,23,26,0.885,81,2015-03-20,PHI,NYK
8481,81,Home,W 97-86 ,240,37,89,0.416,26,71,0.366,11,18,0.611,12,16,0.75,97,33,76,0.434,27,54,0.5,6,22,0.273,14,15,0.933,86,2015-03-21,MEM,POR
8482,82,Home,L 97-105 (OT),265,38,105,0.362,30,78,0.385,8,27,0.296,13,17,0.765,97,39,89,0.438,30,63,0.476,9,26,0.346,18,30,0.6,105,2015-03-22,BOS,DET
8483,83,Home,L 97-111 ,240,43,82,0.524,40,67,0.597,3,15,0.2,8,8,1.0,97,42,90,0.467,35,72,0.486,7,18,0.389,20,27,0.741,111,2015-03-27,ORL,DET
8484,84,Home,L 97-109 ,240,37,82,0.451,32,60,0.533,5,22,0.227,18,24,0.75,97,40,86,0.465,30,60,0.5,10,26,0.385,19,26,0.731,109,2015-03-29,PHO,OKC
8485,85,Home,W 97-83 ,240,38,83,0.458,30,60,0.5,8,23,0.348,13,17,0.765,97,33,81,0.407,28,65,0.431,5,16,0.313,12,20,0.6,83,2015-03-30,MEM,SAC
8486,86,@,W 97-84 ,240,40,92,0.435,34,71,0.479,6,21,0.286,11,17,0.647,97,29,64,0.453,28,53,0.528,1,11,0.091,25,32,0.781,84,2015-04-03,ORL,MIN
8487,87,@,W 97-90 ,240,40,86,0.465,32,65,0.492,8,21,0.381,9,13,0.692,97,39,89,0.438,34,73,0.466,5,16,0.313,7,13,0.538,90,2015-04-04,ORL,MIL
8488,88,@,L 97-109 ,240,38,83,0.458,29,58,0.5,9,25,0.36,12,20,0.6,97,43,85,0.506,26,53,0.491,17,32,0.531,6,12,0.5,109,2015-04-13,DET,CLE
8489,89,Home,L 97-107 ,240,32,81,0.395,26,53,0.491,6,28,0.214,27,34,0.794,97,40,81,0.494,36,72,0.5,4,9,0.444,23,36,0.639,107,2015-04-13,PHI,MIL
8490,90,Home,W 97-95 ,240,37,87,0.425,30,68,0.441,7,19,0.368,16,23,0.696,97,38,94,0.404,29,65,0.446,9,29,0.31,10,17,0.588,95,2015-10-27,CHI,CLE
8491,91,Home,L 97-122 ,240,30,86,0.349,21,68,0.309,9,18,0.5,28,31,0.903,97,42,93,0.452,33,70,0.471,9,23,0.391,29,35,0.829,122,2015-10-28,MIL,NYK
8492,92,Home,W 97-94 ,240,36,83,0.434,28,60,0.467,8,23,0.348,17,22,0.773,97,36,88,0.409,24,58,0.414,12,30,0.4,10,13,0.769,94,2015-10-30,ATL,CHO
8493,93,@,W 97-76 ,240,39,88,0.443,33,73,0.452,6,15,0.4,13,18,0.722,97,28,70,0.4,24,53,0.453,4,17,0.235,16,21,0.762,76,2015-10-31,UTA,IND
8494,94,@,L 97-118 ,240,40,84,0.476,29,60,0.483,11,24,0.458,6,12,0.5,97,45,83,0.542,31,60,0.517,14,23,0.609,14,22,0.636,118,2015-11-04,SAC,PHO
8495,95,Home,L 97-105 ,240,36,80,0.45,25,47,0.532,11,33,0.333,14,26,0.538,97,39,83,0.47,33,70,0.471,6,13,0.462,21,24,0.875,105,2015-11-07,PHI,ORL
8496,96,@,L 97-101 ,240,39,90,0.433,33,72,0.458,6,18,0.333,13,19,0.684,97,38,83,0.458,30,59,0.508,8,24,0.333,17,25,0.68,101,2015-11-08,IND,CLE
8497,97,Home,W 97-84 ,240,34,77,0.442,23,52,0.442,11,25,0.44,18,22,0.818,97,31,78,0.397,21,45,0.467,10,33,0.303,12,17,0.706,84,2015-11-09,IND,ORL
8498,98,@,L 97-102 ,240,36,95,0.379,21,62,0.339,15,33,0.455,10,12,0.833,97,37,84,0.44,33,68,0.485,4,16,0.25,24,31,0.774,102,2015-11-13,CHA,CHI
8499,99,@,W 97-96 ,240,39,76,0.513,32,55,0.582,7,21,0.333,12,17,0.706,97,37,76,0.487,29,54,0.537,8,22,0.364,14,17,0.824,96,2015-11-15,UTA,ATL
8500,0,Home,W 97-85 ,240,31,75,0.413,25,56,0.446,6,19,0.316,29,39,0.744,97,35,96,0.365,28,69,0.406,7,27,0.259,8,15,0.533,85,2015-11-15,LAL,DET
8501,1,@,L 97-103 ,240,38,86,0.442,33,70,0.471,5,16,0.313,16,18,0.889,97,38,89,0.427,29,59,0.492,9,30,0.3,18,24,0.75,103,2015-11-18,SAC,ATL
8502,2,Home,L 97-103 ,240,37,91,0.407,29,64,0.453,8,27,0.296,15,21,0.714,97,41,83,0.494,32,64,0.5,9,19,0.474,12,14,0.857,103,2015-11-18,PHO,CHI
8503,3,@,L 97-109 ,240,32,86,0.372,21,58,0.362,11,28,0.393,22,25,0.88,97,41,85,0.482,30,56,0.536,11,29,0.379,16,19,0.842,109,2015-11-21,ATL,CLE
8504,4,@,W 97-95 ,240,38,78,0.487,31,59,0.525,7,19,0.368,14,20,0.7,97,36,79,0.456,28,53,0.528,8,26,0.308,15,21,0.714,95,2015-11-21,WAS,DET
8505,5,@,W 97-91 ,240,31,81,0.383,24,61,0.393,7,20,0.35,28,31,0.903,97,38,92,0.413,29,61,0.475,9,31,0.29,6,8,0.75,91,2015-11-21,SAC,ORL
8506,6,@,L 97-121 ,240,34,82,0.415,25,61,0.41,9,21,0.429,20,26,0.769,97,45,80,0.563,33,56,0.589,12,24,0.5,19,22,0.864,121,2015-11-24,BOS,ATL
8507,7,@,W 97-78 ,240,33,76,0.434,26,59,0.441,7,17,0.412,24,28,0.857,97,32,85,0.376,29,71,0.408,3,14,0.214,11,15,0.733,78,2015-11-27,MIA,NYK
8508,8,@,W 97-85 ,240,39,83,0.47,32,55,0.582,7,28,0.25,12,16,0.75,97,28,83,0.337,19,53,0.358,9,30,0.3,20,23,0.87,85,2015-12-01,WAS,CLE
8509,9,Home,W 97-95 ,240,40,81,0.494,37,68,0.544,3,13,0.231,14,24,0.583,97,35,79,0.443,31,63,0.492,4,16,0.25,21,24,0.875,95,2015-12-03,MIA,OKC
8510,10,Home,L 97-114 ,240,29,77,0.377,22,56,0.393,7,21,0.333,32,41,0.78,97,40,84,0.476,26,51,0.51,14,33,0.424,20,24,0.833,114,2015-12-03,SAC,BOS
8511,11,Home,L 97-104 ,240,40,84,0.476,31,59,0.525,9,25,0.36,8,9,0.889,97,37,82,0.451,24,51,0.471,13,31,0.419,17,20,0.85,104,2015-12-07,NYK,DAL
8512,12,Home,W 97-94 ,240,37,64,0.578,34,54,0.63,3,10,0.3,20,22,0.909,97,34,76,0.447,27,51,0.529,7,25,0.28,19,24,0.792,94,2015-12-09,TOR,SAS
8513,13,@,L 97-99 ,240,33,83,0.398,24,54,0.444,9,29,0.31,22,28,0.786,97,42,93,0.452,39,77,0.506,3,16,0.188,12,16,0.75,99,2015-12-10,NYK,SAC
8514,14,@,L 97-126 ,240,35,88,0.398,25,56,0.446,10,32,0.313,17,20,0.85,97,47,90,0.522,32,57,0.561,15,33,0.455,17,28,0.607,126,2015-12-12,LAL,HOU
8515,15,@,L 97-100 ,240,40,77,0.519,33,58,0.569,7,19,0.368,10,14,0.714,97,37,77,0.481,30,55,0.545,7,22,0.318,19,23,0.826,100,2015-12-13,MEM,MIA
8516,16,@,L 97-107 ,240,34,82,0.415,22,43,0.512,12,39,0.308,17,23,0.739,97,38,75,0.507,27,51,0.529,11,24,0.458,20,29,0.69,107,2015-12-15,HOU,SAC
8517,17,Home,W 97-88 ,240,34,78,0.436,24,49,0.49,10,29,0.345,19,21,0.905,97,30,80,0.375,24,63,0.381,6,17,0.353,22,24,0.917,88,2015-12-18,DAL,MEM
8518,18,@,L 97-104 ,240,36,86,0.419,28,70,0.4,8,16,0.5,17,17,1.0,97,37,89,0.416,30,61,0.492,7,28,0.25,23,26,0.885,104,2015-12-18,BRK,IND
8519,19,Home,L 97-107 ,240,37,77,0.481,31,53,0.585,6,24,0.25,17,30,0.567,97,40,85,0.471,34,66,0.515,6,19,0.316,21,28,0.75,107,2015-12-18,PHI,NYK
8520,20,Home,W 97-88 ,240,34,73,0.466,24,48,0.5,10,25,0.4,19,25,0.76,97,31,79,0.392,25,51,0.49,6,28,0.214,20,25,0.8,88,2015-12-18,UTA,DEN
8521,21,@,L 97-107 ,240,34,86,0.395,23,48,0.479,11,38,0.289,18,29,0.621,97,34,76,0.447,26,51,0.51,8,25,0.32,31,49,0.633,107,2015-12-19,LAC,HOU
8522,22,@,L 97-106 ,240,38,81,0.469,33,57,0.579,5,24,0.208,16,22,0.727,97,37,77,0.481,28,48,0.583,9,29,0.31,23,28,0.821,106,2015-12-21,POR,ATL
8523,23,@,L 97-104 ,240,38,88,0.432,32,68,0.471,6,20,0.3,15,24,0.625,97,40,87,0.46,32,66,0.485,8,21,0.381,16,24,0.667,104,2015-12-28,TOR,CHI
8524,24,Home,L 97-101 ,240,36,79,0.456,25,54,0.463,11,25,0.44,14,20,0.7,97,33,71,0.465,16,30,0.533,17,41,0.415,18,25,0.72,101,2015-12-28,PHO,CLE
8525,25,Home,L 97-100 ,240,34,88,0.386,27,56,0.482,7,32,0.219,22,28,0.786,97,38,93,0.409,35,75,0.467,3,18,0.167,21,22,0.955,100,2016-01-02,BOS,BRK
8526,26,Home,W 97-77 ,240,38,84,0.452,30,62,0.484,8,22,0.364,13,17,0.765,97,32,89,0.36,26,62,0.419,6,27,0.222,7,9,0.778,77,2016-01-03,LAL,PHO
8527,27,@,L 97-111 ,240,37,84,0.44,29,58,0.5,8,26,0.308,15,20,0.75,97,44,88,0.5,33,62,0.532,11,26,0.423,12,14,0.857,111,2016-01-03,ATL,NYK
8528,28,@,W 97-75 ,240,39,86,0.453,30,63,0.476,9,23,0.391,10,12,0.833,97,31,91,0.341,27,61,0.443,4,30,0.133,9,13,0.692,75,2016-01-03,MIA,WAS
8529,29,@,W 97-88 ,240,34,75,0.453,29,61,0.475,5,14,0.357,24,26,0.923,97,33,84,0.393,25,59,0.424,8,25,0.32,14,15,0.933,88,2016-01-08,TOR,WAS
8530,30,Home,W 97-83 ,240,40,91,0.44,32,60,0.533,8,31,0.258,9,10,0.9,97,31,84,0.369,24,61,0.393,7,23,0.304,14,19,0.737,83,2016-01-09,LAC,CHO
8531,31,@,L 97-116 ,240,36,89,0.404,28,64,0.438,8,25,0.32,17,27,0.63,97,41,79,0.519,31,55,0.564,10,24,0.417,24,31,0.774,116,2016-01-12,PHO,IND
8532,32,Home,L 97-109 ,240,41,84,0.488,35,61,0.574,6,23,0.261,9,14,0.643,97,42,100,0.42,26,67,0.388,16,33,0.485,9,11,0.818,109,2016-01-13,SAC,NOP
8533,33,@,W 97-94 ,240,34,83,0.41,30,63,0.476,4,20,0.2,25,34,0.735,97,28,81,0.346,17,46,0.37,11,35,0.314,27,29,0.931,94,2016-01-19,IND,PHO
8534,34,Home,W 97-84 ,240,28,82,0.341,19,51,0.373,9,31,0.29,32,37,0.865,97,29,77,0.377,22,53,0.415,7,24,0.292,19,32,0.594,84,2016-01-23,CHA,NYK
8535,35,@,L 97-108 ,240,36,86,0.419,29,67,0.433,7,19,0.368,18,25,0.72,97,38,85,0.447,33,69,0.478,5,16,0.313,27,36,0.75,108,2016-01-23,IND,SAC
8536,36,@,L 97-112 ,240,36,86,0.419,29,67,0.433,7,19,0.368,18,32,0.563,97,44,90,0.489,35,60,0.583,9,30,0.3,15,19,0.789,112,2016-01-26,SAC,POR
8537,37,@,L 97-110 ,240,39,82,0.476,32,63,0.508,7,19,0.368,12,17,0.706,97,39,91,0.429,34,70,0.486,5,21,0.238,27,38,0.711,110,2016-01-27,PHI,DET
8538,38,@,L 97-112 ,240,31,85,0.365,24,59,0.407,7,26,0.269,28,38,0.737,97,42,80,0.525,28,45,0.622,14,35,0.4,14,19,0.737,112,2016-02-01,DAL,ATL
8539,39,@,W 97-89 ,240,40,90,0.444,37,71,0.521,3,19,0.158,14,17,0.824,97,31,82,0.378,25,62,0.403,6,20,0.3,21,28,0.75,89,2016-02-02,BOS,NYK
8540,40,Home,L 97-104 ,240,37,79,0.468,25,48,0.521,12,31,0.387,11,15,0.733,97,35,74,0.473,26,47,0.553,9,27,0.333,25,32,0.781,104,2016-02-02,PHO,TOR
8541,41,@,L 97-106 ,240,38,83,0.458,28,55,0.509,10,28,0.357,11,14,0.786,97,39,79,0.494,30,52,0.577,9,27,0.333,19,23,0.826,106,2016-02-03,CLE,CHO
8542,42,@,L 97-110 ,240,41,90,0.456,38,71,0.535,3,19,0.158,12,14,0.857,97,42,81,0.519,33,66,0.5,9,15,0.6,17,18,0.944,110,2016-02-03,NOP,SAS
8543,43,@,L 97-99 ,240,35,74,0.473,23,50,0.46,12,24,0.5,15,21,0.714,97,37,73,0.507,31,56,0.554,6,17,0.353,19,26,0.731,99,2016-02-26,CLE,TOR
8544,44,Home,W 97-81 ,240,43,84,0.512,40,70,0.571,3,14,0.214,8,9,0.889,97,31,78,0.397,25,59,0.424,6,19,0.316,13,23,0.565,81,2016-03-02,SAS,DET
8545,45,Home,L 97-107 ,240,34,79,0.43,22,47,0.468,12,32,0.375,17,28,0.607,97,40,89,0.449,30,62,0.484,10,27,0.37,17,20,0.85,107,2016-03-05,LAC,ATL
8546,46,Home,L 97-128 ,240,39,89,0.438,30,60,0.5,9,29,0.31,10,15,0.667,97,46,82,0.561,30,58,0.517,16,24,0.667,20,24,0.833,128,2016-03-09,PHO,NYK
8547,47,Home,L 97-111 ,240,35,89,0.393,25,60,0.417,10,29,0.345,17,27,0.63,97,45,89,0.506,38,67,0.567,7,22,0.318,14,18,0.778,111,2016-03-18,PHI,OKC
8548,48,@,L 97-109 ,240,33,84,0.393,28,61,0.459,5,23,0.217,26,31,0.839,97,44,88,0.5,30,50,0.6,14,38,0.368,7,12,0.583,109,2016-03-19,HOU,ATL
8549,49,Home,L 97-103 ,240,30,76,0.395,19,48,0.396,11,28,0.393,26,34,0.765,97,39,90,0.433,31,70,0.443,8,20,0.4,17,19,0.895,103,2016-03-21,PHO,MEM
8550,50,@,L 97-108 ,240,36,84,0.429,30,66,0.455,6,18,0.333,19,28,0.679,97,40,80,0.5,35,65,0.538,5,15,0.333,23,33,0.697,108,2016-03-25,ORL,MIA
8551,51,@,W 97-88 ,240,36,88,0.409,25,56,0.446,11,32,0.344,14,15,0.933,97,31,70,0.443,22,46,0.478,9,24,0.375,17,19,0.895,88,2016-03-28,DAL,DEN
8552,52,@,L 97-105 ,240,37,83,0.446,23,50,0.46,14,33,0.424,9,13,0.692,97,36,80,0.45,25,57,0.439,11,23,0.478,22,28,0.786,105,2016-03-30,ATL,TOR
8553,53,@,L 97-104 ,240,34,78,0.436,25,54,0.463,9,24,0.375,20,23,0.87,97,36,87,0.414,26,53,0.491,10,34,0.294,22,27,0.815,104,2016-04-06,NOP,BOS
8554,54,Home,L 97-111 ,240,37,78,0.474,27,52,0.519,10,26,0.385,13,15,0.867,97,42,90,0.467,30,64,0.469,12,26,0.462,15,17,0.882,111,2016-04-06,NYK,CHO
8555,55,Home,L 97-105 ,240,36,85,0.424,30,68,0.441,6,17,0.353,19,21,0.905,97,36,80,0.45,25,59,0.424,11,21,0.524,22,31,0.71,105,2016-04-07,SAC,MIN
8556,56,@,W 97-92 ,240,39,90,0.433,28,66,0.424,11,24,0.458,8,10,0.8,97,37,87,0.425,30,64,0.469,7,23,0.304,11,13,0.846,92,2016-04-13,IND,MIL
8557,57,Home,L 97-103 ,240,36,84,0.429,29,60,0.483,7,24,0.292,18,25,0.72,97,39,94,0.415,33,72,0.458,6,22,0.273,19,26,0.731,103,2016-10-26,PHI,OKC
8558,58,@,W 97-91 ,240,35,92,0.38,28,70,0.4,7,22,0.318,20,24,0.833,97,32,86,0.372,18,52,0.346,14,34,0.412,13,20,0.65,91,2016-10-28,CHA,MIA
8559,59,Home,W 97-81 ,240,35,77,0.455,23,52,0.442,12,25,0.48,15,26,0.577,97,33,77,0.429,26,51,0.51,7,26,0.269,8,10,0.8,81,2016-11-02,UTA,DAL
8560,60,@,L 97-117 ,240,39,86,0.453,34,54,0.63,5,32,0.156,14,20,0.7,97,45,95,0.474,37,65,0.569,8,30,0.267,19,21,0.905,117,2016-11-04,GSW,LAL
8561,61,@,L 97-112 ,240,37,85,0.435,25,49,0.51,12,36,0.333,11,13,0.846,97,45,85,0.529,37,65,0.569,8,20,0.4,14,24,0.583,112,2016-11-05,HOU,ATL
8562,62,Home,W 97-85 ,240,37,85,0.435,28,57,0.491,9,28,0.321,14,17,0.824,97,31,84,0.369,27,67,0.403,4,17,0.235,19,22,0.864,85,2016-11-07,OKC,MIA
8563,63,Home,L 97-109 ,240,38,78,0.487,28,52,0.538,10,26,0.385,11,14,0.786,97,43,82,0.524,33,59,0.559,10,23,0.435,13,15,0.867,109,2016-11-08,LAL,DAL
8564,64,@,L 97-108 ,240,35,73,0.479,28,52,0.538,7,21,0.333,20,26,0.769,97,47,90,0.522,38,71,0.535,9,19,0.474,5,7,0.714,108,2016-11-25,LAC,DET
8565,65,@,L 97-118 ,240,36,79,0.456,25,45,0.556,11,34,0.324,14,23,0.609,97,48,87,0.552,37,61,0.607,11,26,0.423,11,16,0.688,118,2016-11-25,BRK,IND
8566,66,Home,W 97-87 ,240,35,74,0.473,30,56,0.536,5,18,0.278,22,31,0.71,97,32,86,0.372,23,55,0.418,9,31,0.29,14,18,0.778,87,2016-12-01,CHA,DAL
8567,67,Home,W 97-92 ,240,36,88,0.409,25,60,0.417,11,28,0.393,14,15,0.933,97,33,88,0.375,27,62,0.435,6,26,0.231,20,25,0.8,92,2016-12-02,BOS,SAC
8568,68,@,W 97-96 ,240,40,93,0.43,32,65,0.492,8,28,0.286,9,14,0.643,97,30,73,0.411,24,49,0.49,6,24,0.25,30,34,0.882,96,2016-12-05,SAS,MIL
8569,69,@,W 97-79 ,240,38,68,0.559,31,51,0.608,7,17,0.412,14,17,0.824,97,32,82,0.39,27,63,0.429,5,19,0.263,10,14,0.714,79,2016-12-11,PHI,DET
8570,70,@,L 97-107 ,240,35,91,0.385,29,64,0.453,6,27,0.222,21,34,0.618,97,33,86,0.384,22,51,0.431,11,35,0.314,30,40,0.75,107,2016-12-14,LAL,BRK
8571,71,@,L 97-108 ,240,35,74,0.473,30,55,0.545,5,19,0.263,22,29,0.759,97,45,95,0.474,34,75,0.453,11,20,0.55,7,13,0.538,108,2016-12-15,CHI,MIL
8572,72,Home,L 97-107 ,240,38,95,0.4,32,74,0.432,6,21,0.286,15,19,0.789,97,43,82,0.524,40,64,0.625,3,18,0.167,18,25,0.72,107,2016-12-21,CHI,WAS
8573,73,@,W 97-82 ,240,30,74,0.405,19,52,0.365,11,22,0.5,26,32,0.813,97,32,82,0.39,23,46,0.5,9,36,0.25,9,10,0.9,82,2017-01-07,ATL,DAL
8574,74,Home,L 97-117 ,240,35,87,0.402,25,58,0.431,10,29,0.345,17,23,0.739,97,44,92,0.478,37,69,0.536,7,23,0.304,22,38,0.579,117,2017-01-10,BRK,ATL
8575,75,@,L 97-98 ,240,42,86,0.488,38,64,0.594,4,22,0.182,9,10,0.9,97,37,95,0.389,30,67,0.448,7,28,0.25,17,21,0.81,98,2017-01-11,NYK,PHI
8576,76,@,L 97-113 ,240,36,80,0.45,26,59,0.441,10,21,0.476,15,27,0.556,97,48,92,0.522,38,64,0.594,10,28,0.357,7,8,0.875,113,2017-01-14,LAL,LAC
8577,77,Home,L 97-102 ,240,36,83,0.434,30,57,0.526,6,26,0.231,19,24,0.792,97,41,95,0.432,32,70,0.457,9,25,0.36,11,16,0.688,102,2017-01-15,LAL,DET
8578,78,@,L 97-109 ,240,33,79,0.418,27,61,0.443,6,18,0.333,25,32,0.781,97,41,77,0.532,28,47,0.596,13,30,0.433,14,22,0.636,109,2017-01-21,MIL,MIA
8579,79,@,W 97-95 ,240,36,83,0.434,30,63,0.476,6,20,0.3,19,25,0.76,97,36,84,0.429,31,63,0.492,5,21,0.238,18,26,0.692,95,2017-01-23,OKC,UTA
8580,80,@,L 97-104 ,240,35,75,0.467,23,43,0.535,12,32,0.375,15,21,0.714,97,39,86,0.453,30,54,0.556,9,32,0.281,17,18,0.944,104,2017-01-30,CLE,DAL
8581,81,@,L 97-125 ,240,41,94,0.436,34,73,0.466,7,21,0.333,8,10,0.8,97,48,89,0.539,33,52,0.635,15,37,0.405,14,22,0.636,125,2017-02-01,MIN,CLE
8582,82,Home,L 97-106 ,240,32,86,0.372,21,58,0.362,11,28,0.393,22,23,0.957,97,37,86,0.43,29,66,0.439,8,20,0.4,24,31,0.774,106,2017-02-03,BRK,IND
8583,83,@,L 97-121 ,240,41,92,0.446,31,66,0.47,10,26,0.385,5,10,0.5,97,45,79,0.57,35,58,0.603,10,21,0.476,21,26,0.808,121,2017-02-04,DEN,SAS
8584,84,@,L 97-115 ,240,37,86,0.43,32,67,0.478,5,19,0.263,18,22,0.818,97,48,95,0.505,40,76,0.526,8,19,0.421,11,13,0.846,115,2017-02-10,CHI,PHO
8585,85,@,W 97-96 ,240,36,73,0.493,29,49,0.592,7,24,0.292,18,25,0.72,97,38,83,0.458,26,54,0.481,12,29,0.414,8,15,0.533,96,2017-02-14,SAC,LAL
8586,86,Home,L 97-105 ,240,35,79,0.443,28,56,0.5,7,23,0.304,20,24,0.833,97,35,82,0.427,26,56,0.464,9,26,0.346,26,30,0.867,105,2017-02-24,LAC,SAS
8587,87,Home,W 97-84 ,240,41,78,0.526,36,65,0.554,5,13,0.385,10,14,0.714,97,35,83,0.422,27,50,0.54,8,33,0.242,6,9,0.667,84,2017-02-24,MIN,DAL
8588,88,@,L 97-107 ,240,33,78,0.423,21,40,0.525,12,38,0.316,19,22,0.864,97,40,81,0.494,35,66,0.53,5,15,0.333,22,29,0.759,107,2017-02-24,BOS,TOR
8589,89,@,L 97-112 ,240,36,89,0.404,29,59,0.492,7,30,0.233,18,24,0.75,97,38,74,0.514,26,48,0.542,12,26,0.462,24,34,0.706,112,2017-03-03,BRK,UTA
8590,90,Home,W 97-90 (OT),265,38,94,0.404,32,70,0.457,6,24,0.25,15,24,0.625,97,35,89,0.393,31,73,0.425,4,16,0.25,16,22,0.727,90,2017-03-04,SAS,MIN
8591,91,@,W 97-96 ,240,35,78,0.449,20,45,0.444,15,33,0.455,12,21,0.571,97,34,77,0.442,25,50,0.5,9,27,0.333,19,31,0.613,96,2017-03-05,IND,ATL
8592,92,Home,L 97-105 ,240,38,83,0.458,28,55,0.509,10,28,0.357,11,15,0.733,97,36,89,0.404,27,65,0.415,9,24,0.375,24,35,0.686,105,2017-03-05,LAL,NOP
8593,93,Home,W 96-95 ,240,38,86,0.442,34,67,0.507,4,19,0.211,16,21,0.762,96,34,84,0.405,26,61,0.426,8,23,0.348,19,23,0.826,95,2011-12-26,CHA,MIL
8594,94,Home,L 96-104 ,240,35,85,0.412,29,65,0.446,6,20,0.3,20,28,0.714,96,42,79,0.532,33,58,0.569,9,21,0.429,11,13,0.846,104,2011-12-26,CLE,TOR
8595,95,Home,W 96-71 ,240,30,71,0.423,24,55,0.436,6,16,0.375,30,37,0.811,96,29,90,0.322,28,77,0.364,1,13,0.077,12,17,0.706,71,2011-12-27,LAL,UTA
8596,96,@,W 96-95 ,240,36,78,0.462,35,72,0.486,1,6,0.167,23,28,0.821,96,39,82,0.476,32,64,0.5,7,18,0.389,10,16,0.625,95,2011-12-28,MIA,CHA
8597,97,Home,W 96-85 ,240,35,67,0.522,28,51,0.549,7,16,0.438,19,19,1.0,96,34,79,0.43,31,63,0.492,3,16,0.188,14,15,0.933,85,2011-12-30,BOS,DET
8598,98,Home,W 96-88 ,240,39,82,0.476,31,67,0.463,8,15,0.533,10,13,0.769,96,30,76,0.395,25,61,0.41,5,15,0.333,23,28,0.821,88,2011-12-31,DET,IND
8599,99,@,L 96-102 ,240,32,70,0.457,27,57,0.474,5,13,0.385,27,29,0.931,96,37,75,0.493,25,48,0.521,12,27,0.444,16,24,0.667,102,2012-01-01,TOR,ORL
8600,0,Home,W 96-80 ,240,35,85,0.412,27,62,0.435,8,23,0.348,18,21,0.857,96,36,89,0.404,36,74,0.486,0,15,0.0,8,16,0.5,80,2012-01-01,SAC,NOH
8601,1,@,L 96-106 ,240,36,82,0.439,29,62,0.468,7,20,0.35,17,21,0.81,96,41,71,0.577,29,50,0.58,12,21,0.571,12,15,0.8,106,2012-01-02,SAS,MIN
8602,2,@,L 96-113 ,240,34,83,0.41,25,59,0.424,9,24,0.375,19,23,0.826,96,50,91,0.549,48,83,0.578,2,8,0.25,11,16,0.688,113,2012-01-03,SAC,MEM
8603,3,@,L 96-107 ,240,37,79,0.468,37,68,0.544,0,11,0.0,22,27,0.815,96,41,89,0.461,36,77,0.468,5,12,0.417,20,26,0.769,107,2012-01-05,LAL,POR
8604,4,Home,L 96-102 (OT),265,40,87,0.46,33,69,0.478,7,18,0.389,9,13,0.692,96,42,95,0.442,35,75,0.467,7,20,0.35,11,16,0.688,102,2012-01-06,CHA,ATL
8605,5,@,W 96-88 ,240,37,79,0.468,32,58,0.552,5,21,0.238,17,22,0.773,96,36,77,0.468,28,60,0.467,8,17,0.471,8,10,0.8,88,2012-01-06,DEN,NOH
8606,6,Home,W 96-73 ,240,39,85,0.459,34,67,0.507,5,18,0.278,13,16,0.813,96,31,86,0.36,31,76,0.408,0,10,0.0,11,14,0.786,73,2012-01-06,PHI,DET
8607,7,Home,L 96-99 ,240,41,85,0.482,35,71,0.493,6,14,0.429,8,13,0.615,96,39,89,0.438,33,71,0.465,6,18,0.333,15,21,0.714,99,2012-01-06,WAS,NYK
8608,8,Home,W 96-81 ,240,32,74,0.432,24,55,0.436,8,19,0.421,24,29,0.828,96,26,64,0.406,20,53,0.377,6,11,0.545,23,28,0.821,81,2012-01-07,DAL,NOH
8609,9,@,L 96-108 ,240,35,84,0.417,28,72,0.389,7,12,0.583,19,25,0.76,96,38,75,0.507,31,56,0.554,7,19,0.368,25,29,0.862,108,2012-01-08,SAS,OKC
8610,10,Home,W 96-86 ,240,38,76,0.5,32,59,0.542,6,17,0.353,14,19,0.737,96,30,82,0.366,26,69,0.377,4,13,0.308,22,30,0.733,86,2012-01-09,PHI,IND
8611,11,Home,W 96-84 ,240,39,85,0.459,33,71,0.465,6,14,0.429,12,16,0.75,96,30,80,0.375,25,67,0.373,5,13,0.385,19,27,0.704,84,2012-01-11,IND,ATL
8612,12,Home,L 96-106 ,240,32,75,0.427,26,59,0.441,6,16,0.375,26,39,0.667,96,44,85,0.518,40,73,0.548,4,12,0.333,14,20,0.7,106,2012-01-15,DEN,UTA
8613,13,Home,W 96-89 ,240,36,78,0.462,29,56,0.518,7,22,0.318,17,26,0.654,96,36,77,0.468,31,60,0.517,5,17,0.294,12,17,0.706,89,2012-01-17,ORL,CHA
8614,14,Home,W 96-73 ,240,34,71,0.479,28,55,0.509,6,16,0.375,22,32,0.688,96,26,69,0.377,22,54,0.407,4,15,0.267,17,20,0.85,73,2012-01-18,BOS,TOR
8615,15,Home,L 96-98 ,240,36,86,0.419,34,77,0.442,2,9,0.222,22,33,0.667,96,36,77,0.468,26,59,0.441,10,18,0.556,16,19,0.842,98,2012-01-22,LAL,IND
8616,16,Home,L 96-99 ,240,39,82,0.476,34,66,0.515,5,16,0.313,13,17,0.765,96,34,82,0.415,26,67,0.388,8,15,0.533,23,25,0.92,99,2012-01-24,PHO,TOR
8617,17,Home,W 96-91 ,240,32,66,0.485,24,50,0.48,8,16,0.5,24,32,0.75,96,37,87,0.425,29,64,0.453,8,23,0.348,9,14,0.643,91,2012-01-25,LAL,LAC
8618,18,Home,L 96-99 ,240,38,81,0.469,32,62,0.516,6,19,0.316,14,24,0.583,96,36,79,0.456,25,51,0.49,11,28,0.393,16,21,0.762,99,2012-01-27,CLE,NJN
8619,19,Home,W 96-81 ,240,32,70,0.457,24,43,0.558,8,27,0.296,24,32,0.75,96,32,82,0.39,25,63,0.397,7,19,0.368,10,14,0.714,81,2012-01-27,DEN,TOR
8620,20,Home,W 96-93 ,240,35,79,0.443,28,61,0.459,7,18,0.389,19,23,0.826,96,37,80,0.463,31,67,0.463,6,13,0.462,13,14,0.929,93,2012-01-28,UTA,SAC
8621,21,@,L 96-99 ,240,40,82,0.488,35,64,0.547,5,18,0.278,11,14,0.786,96,38,79,0.481,30,56,0.536,8,23,0.348,15,25,0.6,99,2012-02-01,DET,NJN
8622,22,@,W 96-77 ,240,41,85,0.482,39,78,0.5,2,7,0.286,12,19,0.632,96,33,75,0.44,28,60,0.467,5,15,0.333,6,9,0.667,77,2012-02-02,MEM,ATL
8623,23,@,L 96-107 ,240,36,77,0.468,29,56,0.518,7,21,0.333,17,28,0.607,96,37,88,0.42,25,65,0.385,12,23,0.522,21,25,0.84,107,2012-02-04,OKC,SAS
8624,24,Home,W 96-87 ,240,39,87,0.448,35,75,0.467,4,12,0.333,14,20,0.7,96,29,75,0.387,25,61,0.41,4,14,0.286,25,30,0.833,87,2012-02-04,UTA,LAL
8625,25,Home,L 96-103 ,240,35,74,0.473,28,56,0.5,7,18,0.389,19,22,0.864,96,41,78,0.526,31,55,0.564,10,23,0.435,11,19,0.579,103,2012-02-08,POR,HOU
8626,26,@,W 96-89 ,240,42,86,0.488,34,70,0.486,8,16,0.5,4,6,0.667,96,35,74,0.473,26,47,0.553,9,27,0.333,10,16,0.625,89,2012-02-09,HOU,PHO
8627,27,Home,W 96-92 ,240,35,79,0.443,29,61,0.475,6,18,0.333,20,28,0.714,96,33,74,0.446,23,47,0.489,10,27,0.37,16,25,0.64,92,2012-02-13,DAL,LAC
8628,28,@,L 96-102 ,240,38,82,0.463,33,57,0.579,5,25,0.2,15,19,0.789,96,39,86,0.453,32,68,0.471,7,18,0.389,17,21,0.81,102,2012-02-13,PHO,GSW
8629,29,Home,L 96-114 ,240,33,84,0.393,24,61,0.393,9,23,0.391,21,25,0.84,96,43,83,0.518,36,69,0.522,7,14,0.5,21,25,0.84,114,2012-02-13,MIL,MIA
8630,30,Home,W 96-95 ,240,37,87,0.425,29,69,0.42,8,18,0.444,14,18,0.778,96,36,83,0.434,29,60,0.483,7,23,0.304,16,18,0.889,95,2012-02-15,HOU,OKC
8631,31,Home,W 96-81 ,240,31,82,0.378,26,73,0.356,5,9,0.556,29,46,0.63,96,32,72,0.444,26,56,0.464,6,16,0.375,11,15,0.733,81,2012-02-19,DET,BOS
8632,32,@,W 96-91 ,240,35,76,0.461,27,56,0.482,8,20,0.4,18,31,0.581,96,36,90,0.4,28,58,0.483,8,32,0.25,11,16,0.688,91,2012-02-22,LAL,DAL
8633,33,@,L 96-103 ,240,40,85,0.471,35,72,0.486,5,13,0.385,11,22,0.5,96,37,84,0.44,32,64,0.5,5,20,0.25,24,29,0.828,103,2012-02-28,UTA,SAC
8634,34,@,L 96-102 ,240,39,96,0.406,35,81,0.432,4,15,0.267,14,16,0.875,96,40,87,0.46,37,71,0.521,3,16,0.188,19,28,0.679,102,2012-02-29,MIL,BOS
8635,35,Home,W 96-85 ,240,39,80,0.488,37,68,0.544,2,12,0.167,16,19,0.842,96,35,79,0.443,31,56,0.554,4,23,0.174,11,14,0.786,85,2012-02-29,MEM,DAL
8636,36,@,W 96-89 ,240,37,88,0.42,30,73,0.411,7,15,0.467,15,21,0.714,96,37,86,0.43,29,66,0.439,8,20,0.4,7,12,0.583,89,2012-02-29,CHI,SAS
8637,37,@,L 96-102 ,240,38,85,0.447,34,69,0.493,4,16,0.25,16,21,0.762,96,36,75,0.48,26,52,0.5,10,23,0.435,20,24,0.833,102,2012-03-03,UTA,DAL
8638,38,@,W 96-91 ,240,39,82,0.476,32,66,0.485,7,16,0.438,11,16,0.688,96,38,97,0.392,37,86,0.43,1,11,0.091,14,17,0.824,91,2012-03-04,CHI,PHI
8639,39,Home,W 96-88 ,240,40,88,0.455,35,76,0.461,5,12,0.417,11,16,0.688,96,38,99,0.384,36,86,0.419,2,13,0.154,10,14,0.714,88,2012-03-04,PHO,SAC
8640,40,Home,L 96-101 ,240,31,70,0.443,26,55,0.473,5,15,0.333,29,40,0.725,96,38,83,0.458,30,64,0.469,8,19,0.421,17,22,0.773,101,2012-03-06,IND,ATL
8641,41,Home,W 96-94 ,240,37,76,0.487,34,62,0.548,3,14,0.214,19,27,0.704,96,38,87,0.437,30,65,0.462,8,22,0.364,10,13,0.769,94,2012-03-08,PHO,DAL
8642,42,@,W 96-90 ,240,38,91,0.418,33,74,0.446,5,17,0.294,15,24,0.625,96,37,76,0.487,31,52,0.596,6,24,0.25,10,17,0.588,90,2012-03-09,CLE,OKC
8643,43,@,W 96-88 ,240,37,74,0.5,29,55,0.527,8,19,0.421,14,21,0.667,96,29,76,0.382,26,61,0.426,3,15,0.2,27,33,0.818,88,2012-03-13,TOR,CLE
8644,44,Home,W 96-82 ,240,38,70,0.543,28,50,0.56,10,20,0.5,10,17,0.588,96,29,68,0.426,21,43,0.488,8,25,0.32,16,20,0.8,82,2012-03-14,LAC,ATL
8645,45,@,L 96-101 ,240,35,84,0.417,27,63,0.429,8,21,0.381,18,20,0.9,96,38,84,0.452,29,59,0.492,9,25,0.36,16,21,0.762,101,2012-03-15,CHA,DAL
8646,46,@,L 96-103 ,240,36,82,0.439,28,62,0.452,8,20,0.4,16,19,0.842,96,40,85,0.471,34,66,0.515,6,19,0.316,17,26,0.654,103,2012-03-23,POR,LAL
8647,47,Home,W 96-79 ,240,38,83,0.458,37,70,0.529,1,13,0.077,19,26,0.731,96,32,85,0.376,27,57,0.474,5,28,0.179,10,18,0.556,79,2012-03-23,TOR,NYK
8648,48,Home,L 96-102 ,240,31,73,0.425,24,55,0.436,7,18,0.389,27,30,0.9,96,44,86,0.512,38,73,0.521,6,13,0.462,8,10,0.8,102,2012-03-25,LAL,MEM
8649,49,@,L 96-105 ,240,33,80,0.413,28,60,0.467,5,20,0.25,25,30,0.833,96,35,86,0.407,23,64,0.359,12,22,0.545,23,33,0.697,105,2012-03-28,DEN,TOR
8650,50,@,L 96-105 ,240,35,77,0.455,31,65,0.477,4,12,0.333,22,31,0.71,96,39,72,0.542,29,51,0.569,10,21,0.476,17,24,0.708,105,2012-03-31,UTA,LAC
8651,51,Home,L 96-109 ,240,39,84,0.464,33,66,0.5,6,18,0.333,12,19,0.632,96,44,76,0.579,40,65,0.615,4,11,0.364,17,19,0.895,109,2012-04-04,WAS,IND
8652,52,@,W 96-80 ,240,38,78,0.487,25,53,0.472,13,25,0.52,7,15,0.467,96,30,72,0.417,21,48,0.438,9,24,0.375,11,16,0.688,80,2012-04-05,NYK,ORL
8653,53,@,L 96-101 ,240,37,78,0.474,30,63,0.476,7,15,0.467,15,22,0.682,96,39,81,0.481,35,66,0.53,4,15,0.267,19,27,0.704,101,2012-04-06,DET,ATL
8654,54,Home,L 96-116 ,240,38,81,0.469,35,74,0.473,3,7,0.429,17,24,0.708,96,43,82,0.524,34,62,0.548,9,20,0.45,21,23,0.913,116,2012-04-07,CHA,ATL
8655,55,@,L 96-105 ,240,36,83,0.434,29,61,0.475,7,22,0.318,17,23,0.739,96,38,68,0.559,34,59,0.576,4,9,0.444,25,36,0.694,105,2012-04-11,SAC,NOH
8656,56,Home,W 96-86 (OT),265,37,86,0.43,26,64,0.406,11,22,0.5,11,19,0.579,96,36,82,0.439,32,71,0.451,4,11,0.364,10,16,0.625,86,2012-04-12,CHI,MIA
8657,57,Home,W 96-85 ,240,38,69,0.551,32,56,0.571,6,13,0.462,14,21,0.667,96,33,73,0.452,31,62,0.5,2,11,0.182,17,21,0.81,85,2012-04-13,NOP,UTA
8658,58,Home,W 96-72 ,240,40,76,0.526,33,59,0.559,7,17,0.412,9,15,0.6,96,30,72,0.417,29,56,0.518,1,16,0.063,11,15,0.733,72,2012-04-18,MIA,TOR
8659,59,@,L 96-99 ,240,36,73,0.493,31,57,0.544,5,16,0.313,19,22,0.864,96,40,84,0.476,30,58,0.517,10,26,0.385,9,15,0.6,99,2012-04-21,GSW,HOU
8660,60,@,W 96-85 ,240,40,91,0.44,36,75,0.48,4,16,0.25,12,16,0.75,96,34,77,0.442,30,60,0.5,4,17,0.235,13,18,0.722,85,2012-04-25,WAS,CLE
8661,61,@,L 96-113 ,240,41,91,0.451,34,76,0.447,7,15,0.467,7,9,0.778,96,47,92,0.511,41,77,0.532,6,15,0.4,13,18,0.722,113,2012-04-26,LAL,SAC
8662,62,Home,W 96-94 ,240,35,83,0.422,29,64,0.453,6,19,0.316,20,27,0.741,96,36,80,0.45,30,55,0.545,6,25,0.24,16,19,0.842,94,2012-04-26,UTA,POR
8663,63,Home,L 96-105 ,240,35,79,0.443,29,63,0.46,6,16,0.375,20,26,0.769,96,39,79,0.494,29,52,0.558,10,27,0.37,17,23,0.739,105,2012-10-31,DET,HOU
8664,64,Home,L 96-107 ,240,35,73,0.479,22,50,0.44,13,23,0.565,13,18,0.722,96,44,88,0.5,37,68,0.544,7,20,0.35,12,15,0.8,107,2012-11-05,BRK,MIN
8665,65,@,L 96-106 ,240,36,86,0.419,25,54,0.463,11,32,0.344,13,21,0.619,96,42,78,0.538,37,60,0.617,5,18,0.278,17,23,0.739,106,2012-11-07,CLE,GSW
8666,66,Home,W 96-94 ,240,35,70,0.5,33,61,0.541,2,9,0.222,24,28,0.857,96,37,84,0.44,32,66,0.485,5,18,0.278,15,17,0.882,94,2012-11-09,MIN,IND
8667,67,Home,W 96-82 ,240,33,82,0.402,24,56,0.429,9,26,0.346,21,26,0.808,96,32,80,0.4,25,60,0.417,7,20,0.35,11,16,0.688,82,2012-11-10,HOU,DET
8668,68,@,W 96-92 ,240,32,72,0.444,27,57,0.474,5,15,0.333,27,34,0.794,96,35,88,0.398,32,69,0.464,3,19,0.158,19,26,0.731,92,2012-11-10,BOS,MIL
8669,69,Home,L 96-105 ,240,37,85,0.435,27,61,0.443,10,24,0.417,12,16,0.75,96,41,80,0.513,34,60,0.567,7,20,0.35,16,18,0.889,105,2012-11-12,PHI,MIL
8670,70,@,L 96-100 ,240,34,84,0.405,26,60,0.433,8,24,0.333,20,21,0.952,96,36,80,0.45,26,51,0.51,10,29,0.345,18,22,0.818,100,2012-11-14,NOP,HOU
8671,71,Home,L 96-112 ,240,39,85,0.459,31,65,0.477,8,20,0.4,10,14,0.714,96,42,76,0.553,34,61,0.557,8,15,0.533,20,27,0.741,112,2012-11-16,SAC,ATL
8672,72,@,W 96-89 ,240,34,70,0.486,31,51,0.608,3,19,0.158,25,29,0.862,96,31,87,0.356,27,70,0.386,4,17,0.235,23,31,0.742,89,2012-11-19,IND,WAS
8673,73,Home,W 96-85 ,240,33,78,0.423,27,57,0.474,6,21,0.286,24,29,0.828,96,33,86,0.384,28,59,0.475,5,27,0.185,14,19,0.737,85,2012-11-24,GSW,MIN
8674,74,Home,W 96-89 (OT),265,37,91,0.407,28,63,0.444,9,28,0.321,13,19,0.684,96,33,85,0.388,27,64,0.422,6,21,0.286,17,24,0.708,89,2012-11-26,BRK,NYK
8675,75,@,W 96-84 ,240,31,63,0.492,25,52,0.481,6,11,0.545,28,38,0.737,96,31,73,0.425,26,52,0.5,5,21,0.238,17,21,0.81,84,2012-11-28,UTA,NOH
8676,76,Home,W 96-78 ,240,36,73,0.493,30,57,0.526,6,16,0.375,18,20,0.9,96,24,69,0.348,21,54,0.389,3,15,0.2,27,37,0.73,78,2012-11-30,BOS,POR
8677,77,@,W 96-89 ,240,36,72,0.5,28,55,0.509,8,17,0.471,16,22,0.727,96,36,75,0.48,28,59,0.475,8,16,0.5,9,12,0.75,89,2012-12-07,MEM,NOH
8678,78,Home,L 96-104 ,240,31,83,0.373,22,57,0.386,9,26,0.346,25,32,0.781,96,38,84,0.452,30,64,0.469,8,20,0.4,20,23,0.87,104,2012-12-10,CHA,GSW
8679,79,@,L 96-119 ,240,37,84,0.44,25,57,0.439,12,27,0.444,10,16,0.625,96,48,87,0.552,41,67,0.612,7,20,0.35,16,21,0.762,119,2012-12-10,SAC,DAL
8680,80,Home,W 96-81 ,240,34,83,0.41,29,65,0.446,5,18,0.278,23,28,0.821,96,27,81,0.333,18,59,0.305,9,22,0.409,18,25,0.72,81,2012-12-12,IND,CLE
8681,81,@,W 96-89 ,240,34,78,0.436,30,67,0.448,4,11,0.364,24,26,0.923,96,41,91,0.451,39,77,0.506,2,14,0.143,5,11,0.455,89,2012-12-12,CHI,PHI
8682,82,@,L 96-99 ,240,37,87,0.425,29,68,0.426,8,19,0.421,14,18,0.778,96,41,84,0.488,33,65,0.508,8,19,0.421,9,15,0.6,99,2012-12-12,SAS,UTA
8683,83,Home,L 96-102 ,240,36,83,0.434,28,62,0.452,8,21,0.381,16,20,0.8,96,37,82,0.451,29,53,0.547,8,29,0.276,20,28,0.714,102,2012-12-14,WAS,LAL
8684,84,@,L 96-103 ,240,32,78,0.41,25,55,0.455,7,23,0.304,25,32,0.781,96,39,85,0.459,31,55,0.564,8,30,0.267,17,20,0.85,103,2012-12-16,HOU,TOR
8685,85,Home,L 96-109 ,240,39,90,0.433,30,59,0.508,9,31,0.29,9,16,0.563,96,40,78,0.513,30,49,0.612,10,29,0.345,19,24,0.792,109,2012-12-17,NYK,HOU
8686,86,@,L 96-103 ,240,35,75,0.467,26,48,0.542,9,27,0.333,17,17,1.0,96,34,78,0.436,28,60,0.467,6,18,0.333,29,34,0.853,103,2012-12-18,NOP,GSW
8687,87,@,L 96-121 ,240,42,79,0.532,40,66,0.606,2,13,0.154,10,14,0.714,96,44,82,0.537,32,54,0.593,12,28,0.429,21,26,0.808,121,2012-12-22,MEM,HOU
8688,88,Home,W 96-93 ,240,33,69,0.478,26,49,0.531,7,20,0.35,23,28,0.821,96,40,89,0.449,35,70,0.5,5,19,0.263,8,11,0.727,93,2012-12-22,POR,PHO
8689,89,@,W 96-87 ,240,36,88,0.409,28,69,0.406,8,19,0.421,16,20,0.8,96,29,77,0.377,25,56,0.446,4,21,0.19,25,32,0.781,87,2012-12-22,DET,WAS
8690,90,@,L 96-108 ,240,37,85,0.435,30,61,0.492,7,24,0.292,15,17,0.882,96,45,81,0.556,36,62,0.581,9,19,0.474,9,11,0.818,108,2012-12-23,POR,SAC
8691,91,Home,W 96-89 ,240,34,80,0.425,27,63,0.429,7,17,0.412,21,26,0.808,96,35,87,0.402,30,67,0.448,5,20,0.25,14,23,0.609,89,2012-12-28,GSW,PHI
8692,92,Home,W 96-94 ,240,39,82,0.476,33,64,0.516,6,18,0.333,12,15,0.8,96,36,77,0.468,26,54,0.481,10,23,0.435,12,17,0.706,94,2012-12-30,DET,MIL
8693,93,@,L 96-107 ,240,33,80,0.413,28,67,0.418,5,13,0.385,25,34,0.735,96,39,78,0.5,31,60,0.517,8,18,0.444,21,29,0.724,107,2012-12-30,UTA,LAC
8694,94,@,L 96-118 ,240,36,86,0.419,29,64,0.453,7,22,0.318,17,19,0.895,96,44,82,0.537,34,62,0.548,10,20,0.5,20,25,0.8,118,2012-12-30,BOS,SAC
8695,95,@,L 96-114 ,240,37,78,0.474,29,54,0.537,8,24,0.333,14,17,0.824,96,44,87,0.506,39,72,0.542,5,15,0.333,21,24,0.875,114,2012-12-31,PHO,OKC
8696,96,@,W 96-94 ,240,36,77,0.468,31,65,0.477,5,12,0.417,19,25,0.76,96,37,78,0.474,28,54,0.519,9,24,0.375,11,14,0.786,94,2013-01-02,CHI,ORL
8697,97,@,W 96-89 ,240,36,80,0.45,31,66,0.47,5,14,0.357,19,24,0.792,96,30,65,0.462,25,45,0.556,5,20,0.25,24,31,0.774,89,2013-01-04,CHI,MIA
8698,98,Home,L 96-105 ,240,30,79,0.38,19,46,0.413,11,33,0.333,25,37,0.676,96,40,76,0.526,36,64,0.563,4,12,0.333,21,30,0.7,105,2013-01-04,TOR,SAC
8699,99,Home,L 96-99 (OT),265,39,85,0.459,32,66,0.485,7,19,0.368,11,13,0.846,96,39,86,0.453,31,65,0.477,8,21,0.381,13,16,0.813,99,2013-01-05,DAL,NOH
8700,0,Home,L 96-102 ,240,31,76,0.408,17,44,0.386,14,32,0.438,20,26,0.769,96,39,74,0.527,33,56,0.589,6,18,0.333,18,20,0.9,102,2013-01-07,NYK,BOS
8701,1,Home,L 96-104 ,240,39,95,0.411,35,85,0.412,4,10,0.4,14,20,0.7,96,39,84,0.464,29,62,0.468,10,22,0.455,16,21,0.762,104,2013-01-09,CHI,MIL
8702,2,Home,W 96-88 ,240,38,89,0.427,27,61,0.443,11,28,0.393,9,12,0.75,96,36,78,0.462,33,71,0.465,3,7,0.429,13,16,0.813,88,2013-01-12,IND,CHA
8703,3,Home,L 96-107 ,240,36,85,0.424,33,72,0.458,3,13,0.231,21,27,0.778,96,40,77,0.519,32,58,0.552,8,19,0.421,19,23,0.826,107,2013-01-13,TOR,MIL
8704,4,@,L 96-104 ,240,36,74,0.486,31,60,0.517,5,14,0.357,19,26,0.731,96,41,71,0.577,31,55,0.564,10,16,0.625,12,21,0.571,104,2013-01-21,MIN,ATL
8705,5,Home,L 96-106 ,240,38,79,0.481,33,68,0.485,5,11,0.455,15,24,0.625,96,43,90,0.478,37,71,0.521,6,19,0.316,14,16,0.875,106,2013-01-23,SAC,PHO
8706,6,Home,W 96-83 ,240,42,82,0.512,36,65,0.554,6,17,0.353,6,9,0.667,96,29,66,0.439,26,51,0.51,3,15,0.2,22,29,0.759,83,2013-01-27,LAC,POR
8707,7,@,L 96-105 ,240,36,81,0.444,32,65,0.492,4,16,0.25,20,26,0.769,96,41,74,0.554,34,57,0.596,7,17,0.412,16,29,0.552,105,2013-01-27,OKC,LAL
8708,8,@,W 96-94 ,240,36,82,0.439,27,59,0.458,9,23,0.391,15,25,0.6,96,37,77,0.481,34,66,0.515,3,11,0.273,17,21,0.81,94,2013-01-28,SAC,WAS
8709,9,@,W 96-90 ,240,35,76,0.461,32,67,0.478,3,9,0.333,23,36,0.639,96,33,76,0.434,28,57,0.491,5,19,0.263,19,27,0.704,90,2013-01-30,LAC,MIN
8710,10,Home,W 96-86 ,240,32,76,0.421,19,41,0.463,13,35,0.371,19,26,0.731,96,33,83,0.398,25,63,0.397,8,20,0.4,12,17,0.706,86,2013-02-01,NYK,MIL
8711,11,Home,W 96-86 ,240,38,78,0.487,33,58,0.569,5,20,0.25,15,16,0.938,96,36,88,0.409,30,66,0.455,6,22,0.273,8,17,0.471,86,2013-02-02,SAS,WAS
8712,12,@,W 96-90 ,240,37,73,0.507,33,63,0.524,4,10,0.4,18,22,0.818,96,36,82,0.439,33,73,0.452,3,9,0.333,15,17,0.882,90,2013-02-05,PHO,MEM
8713,13,@,L 96-106 ,240,34,84,0.405,25,56,0.446,9,28,0.321,19,23,0.826,96,42,79,0.532,31,59,0.525,11,20,0.55,11,14,0.786,106,2013-02-06,NYK,WAS
8714,14,@,L 96-128 ,240,38,91,0.418,28,64,0.438,10,27,0.37,10,14,0.714,96,50,86,0.581,41,67,0.612,9,19,0.474,19,23,0.826,128,2013-02-07,CHI,DEN
8715,15,@,L 96-127 ,240,39,83,0.47,32,65,0.492,7,18,0.389,11,15,0.733,96,50,87,0.575,36,66,0.545,14,21,0.667,13,18,0.722,127,2013-02-08,PHO,OKC
8716,16,@,W 96-95 ,240,38,84,0.452,33,65,0.508,5,19,0.263,15,18,0.833,96,40,97,0.412,38,86,0.442,2,11,0.182,13,15,0.867,95,2013-02-13,SAS,CLE
8717,17,Home,W 96-85 ,240,35,79,0.443,26,61,0.426,9,18,0.5,17,25,0.68,96,34,70,0.486,31,59,0.525,3,11,0.273,14,22,0.636,85,2013-02-13,DET,WAS
8718,18,@,L 96-106 ,240,36,82,0.439,31,58,0.534,5,24,0.208,19,22,0.864,96,37,75,0.493,24,43,0.558,13,32,0.406,19,26,0.731,106,2013-02-13,HOU,LAC
8719,19,@,W 96-87 ,240,39,84,0.464,34,71,0.479,5,13,0.385,13,17,0.765,96,35,84,0.417,31,67,0.463,4,17,0.235,13,20,0.65,87,2013-02-19,CHI,NOH
8720,20,@,W 96-88 ,240,35,78,0.449,27,58,0.466,8,20,0.4,18,20,0.9,96,30,78,0.385,24,63,0.381,6,15,0.4,22,27,0.815,88,2013-02-19,TOR,WAS
8721,21,@,L 96-111 ,240,39,85,0.459,34,69,0.493,5,16,0.313,13,22,0.591,96,42,88,0.477,31,59,0.525,11,29,0.379,16,18,0.889,111,2013-02-20,ORL,DAL
8722,22,Home,L 96-106 ,240,40,91,0.44,30,61,0.492,10,30,0.333,6,11,0.545,96,41,77,0.532,25,47,0.532,16,30,0.533,8,12,0.667,106,2013-02-22,BRK,HOU
8723,23,@,W 96-95 ,240,39,72,0.542,30,57,0.526,9,15,0.6,9,16,0.563,96,40,84,0.476,32,65,0.492,8,19,0.421,7,10,0.7,95,2013-02-27,DET,WAS
8724,24,@,W 96-88 ,240,35,81,0.432,27,53,0.509,8,28,0.286,18,21,0.857,96,31,74,0.419,24,58,0.414,7,16,0.438,19,29,0.655,88,2013-03-01,NYK,WAS
8725,25,Home,W 96-85 ,240,38,73,0.521,32,58,0.552,6,15,0.4,14,14,1.0,96,32,72,0.444,27,57,0.474,5,15,0.333,16,23,0.696,85,2013-03-02,CHI,BRK
8726,26,@,L 96-107 ,240,37,86,0.43,31,69,0.449,6,17,0.353,16,21,0.762,96,43,80,0.538,32,56,0.571,11,24,0.458,10,17,0.588,107,2013-03-06,PHI,ATL
8727,27,@,L 96-97 ,240,40,89,0.449,34,61,0.557,6,28,0.214,10,12,0.833,96,32,74,0.432,26,46,0.565,6,28,0.214,27,31,0.871,97,2013-03-06,ORL,MIA
8728,28,Home,W 96-85 ,240,38,81,0.469,34,68,0.5,4,13,0.308,16,20,0.8,96,34,79,0.43,32,67,0.478,2,12,0.167,15,17,0.882,85,2013-03-09,MEM,NOH
8729,29,@,L 96-98 ,240,37,76,0.487,26,51,0.51,11,25,0.44,11,12,0.917,96,40,86,0.465,29,66,0.439,11,20,0.55,7,9,0.778,98,2013-03-10,POR,NOH
8730,30,@,L 96-100 ,240,36,86,0.419,29,65,0.446,7,21,0.333,17,27,0.63,96,33,84,0.393,25,61,0.41,8,23,0.348,26,34,0.765,100,2013-03-10,CLE,TOR
8731,31,Home,W 96-92 ,240,37,79,0.468,29,57,0.509,8,22,0.364,14,21,0.667,96,36,92,0.391,28,63,0.444,8,29,0.276,12,16,0.75,92,2013-03-13,ATL,LAL
8732,32,@,W 96-85 ,240,37,68,0.544,31,56,0.554,6,12,0.5,16,21,0.762,96,31,72,0.431,25,46,0.543,6,26,0.231,17,18,0.944,85,2013-03-13,MEM,LAC
8733,33,Home,W 96-86 ,240,41,82,0.5,34,61,0.557,7,21,0.333,7,11,0.636,96,34,78,0.436,27,62,0.435,7,16,0.438,11,18,0.611,86,2013-03-15,DAL,CLE
8734,34,Home,W 96-87 ,240,36,72,0.5,27,52,0.519,9,20,0.45,15,19,0.789,96,35,80,0.438,32,61,0.525,3,19,0.158,14,19,0.737,87,2013-03-15,WAS,NOH
8735,35,Home,L 96-113 ,240,40,80,0.5,33,61,0.541,7,19,0.368,9,15,0.6,96,45,89,0.506,38,68,0.559,7,21,0.333,16,21,0.762,113,2013-03-20,DAL,BRK
8736,36,Home,W 96-95 ,240,32,80,0.4,23,54,0.426,9,26,0.346,23,27,0.852,96,33,78,0.423,23,56,0.411,10,22,0.455,19,21,0.905,95,2013-03-24,HOU,SAS
8737,37,Home,L 96-113 ,240,39,84,0.464,33,64,0.516,6,20,0.3,12,18,0.667,96,41,73,0.562,34,55,0.618,7,18,0.389,24,32,0.75,113,2013-04-03,UTA,DEN
8738,38,@,L 96-105 ,240,36,80,0.45,29,59,0.492,7,21,0.333,17,23,0.739,96,39,80,0.488,34,59,0.576,5,21,0.238,22,30,0.733,105,2013-04-06,CHA,BRK
8739,39,@,L 96-107 ,240,39,88,0.443,29,62,0.468,10,26,0.385,8,12,0.667,96,43,77,0.558,39,66,0.591,4,11,0.364,17,21,0.81,107,2013-04-07,WAS,BOS
8740,40,@,W 96-91 ,240,42,90,0.467,39,77,0.506,3,13,0.231,9,12,0.75,96,37,80,0.463,33,58,0.569,4,22,0.182,13,16,0.813,91,2013-04-07,DAL,POR
8741,41,@,L 96-104 ,240,37,84,0.44,32,64,0.5,5,20,0.25,17,18,0.944,96,40,79,0.506,33,54,0.611,7,25,0.28,17,22,0.773,104,2013-04-09,NOP,LAL
8742,42,Home,W 96-86 ,240,39,86,0.453,33,71,0.465,6,15,0.4,12,21,0.571,96,35,87,0.402,31,66,0.47,4,21,0.19,12,17,0.706,86,2013-04-10,DEN,SAS
8743,43,@,W 96-93 ,240,35,78,0.449,28,52,0.538,7,26,0.269,19,28,0.679,96,35,83,0.422,29,64,0.453,6,19,0.316,17,32,0.531,93,2013-04-12,LAC,NOH
8744,44,@,W 96-95 ,240,33,66,0.5,20,38,0.526,13,28,0.464,17,27,0.63,96,39,86,0.453,34,73,0.466,5,13,0.385,12,19,0.632,95,2013-04-15,MIA,CLE
8745,45,@,W 96-80 ,240,36,77,0.468,33,67,0.493,3,10,0.3,21,23,0.913,96,32,75,0.427,30,58,0.517,2,17,0.118,14,18,0.778,80,2013-04-15,UTA,MIN
8746,46,Home,L 96-113 ,240,35,88,0.398,26,60,0.433,9,28,0.321,17,23,0.739,96,40,78,0.513,30,51,0.588,10,27,0.37,23,27,0.852,113,2013-04-16,ATL,TOR
8747,47,Home,W 96-83 ,240,36,76,0.474,27,51,0.529,9,25,0.36,15,24,0.625,96,33,90,0.367,29,80,0.363,4,10,0.4,13,20,0.65,83,2013-10-30,HOU,CHA
8748,48,@,L 96-103 ,240,32,80,0.4,18,43,0.419,14,37,0.378,18,22,0.818,96,35,82,0.427,33,64,0.516,2,18,0.111,31,37,0.838,103,2013-11-03,PHO,OKC
8749,49,@,L 96-99 ,240,42,85,0.494,35,66,0.53,7,19,0.368,5,9,0.556,96,41,85,0.482,35,69,0.507,6,16,0.375,11,15,0.733,99,2013-11-06,PHO,SAS
8750,50,Home,W 96-85 ,240,38,87,0.437,35,78,0.449,3,9,0.333,17,22,0.773,96,31,80,0.388,25,61,0.41,6,19,0.316,17,26,0.654,85,2013-11-08,NOP,LAL
8751,51,@,W 96-91 ,240,37,80,0.463,30,66,0.455,7,14,0.5,15,20,0.75,96,35,76,0.461,27,57,0.474,8,19,0.421,13,16,0.813,91,2013-11-09,IND,BRK
8752,52,@,W 96-85 ,240,36,82,0.439,27,62,0.435,9,20,0.45,15,22,0.682,96,36,78,0.462,33,66,0.5,3,12,0.25,10,14,0.714,85,2013-11-09,POR,SAC
8753,53,Home,W 96-81 ,240,34,83,0.41,30,67,0.448,4,16,0.25,24,26,0.923,96,31,75,0.413,26,61,0.426,5,14,0.357,14,20,0.7,81,2013-11-11,CHI,CLE
8754,54,Home,L 96-109 ,240,37,81,0.457,30,63,0.476,7,18,0.389,15,19,0.789,96,40,82,0.488,31,56,0.554,9,26,0.346,20,22,0.909,109,2013-11-15,BOS,POR
8755,55,@,W 96-80 ,240,36,80,0.45,29,64,0.453,7,16,0.438,17,19,0.895,96,29,82,0.354,24,61,0.393,5,21,0.238,17,22,0.773,80,2013-11-15,CHI,TOR
8756,56,Home,L 96-103 (OT),265,37,93,0.398,31,68,0.456,6,25,0.24,16,22,0.727,96,36,81,0.444,26,60,0.433,10,21,0.476,21,22,0.955,103,2013-11-16,WAS,CLE
8757,57,Home,L 96-103 (OT),265,37,100,0.37,29,70,0.414,8,30,0.267,14,17,0.824,96,33,87,0.379,24,57,0.421,9,30,0.3,28,36,0.778,103,2013-11-20,NYK,IND
8758,58,@,W 96-89 ,240,37,85,0.435,29,62,0.468,8,23,0.348,14,21,0.667,96,36,84,0.429,33,71,0.465,3,13,0.231,14,22,0.636,89,2013-11-22,ATL,DET
8759,59,Home,W 96-88 ,240,37,78,0.474,32,60,0.533,5,18,0.278,17,23,0.739,96,36,86,0.419,30,69,0.435,6,17,0.353,10,13,0.769,88,2013-11-22,TOR,WAS
8760,60,@,W 96-72 ,240,38,77,0.494,33,63,0.524,5,14,0.357,15,27,0.556,96,30,85,0.353,25,67,0.373,5,18,0.278,7,9,0.778,72,2013-11-23,CHA,MIL
8761,61,@,L 96-126 ,240,39,83,0.47,35,70,0.5,4,13,0.308,14,20,0.7,96,46,80,0.575,30,56,0.536,16,24,0.667,18,23,0.783,126,2013-11-23,CLE,SAS
8762,62,Home,L 96-104 ,240,39,84,0.464,33,63,0.524,6,21,0.286,12,14,0.857,96,46,95,0.484,35,66,0.53,11,29,0.379,1,3,0.333,104,2013-11-24,ORL,PHO
8763,63,@,W 96-86 ,240,35,80,0.438,26,60,0.433,9,20,0.45,17,21,0.81,96,33,74,0.446,30,65,0.462,3,9,0.333,17,20,0.85,86,2013-11-25,BOS,CHA
8764,64,Home,L 96-110 ,240,38,82,0.463,33,63,0.524,5,19,0.263,15,19,0.789,96,41,75,0.547,33,55,0.6,8,20,0.4,20,28,0.714,110,2013-11-25,DAL,DEN
8765,65,@,L 96-104 ,240,35,80,0.438,24,58,0.414,11,22,0.5,15,21,0.714,96,39,70,0.557,36,58,0.621,3,12,0.25,23,28,0.821,104,2013-12-10,BOS,BRK
8766,66,@,W 96-88 ,240,34,76,0.447,28,59,0.475,6,17,0.353,22,34,0.647,96,33,80,0.413,27,63,0.429,6,17,0.353,16,19,0.842,88,2013-12-11,LAC,BOS
8767,67,Home,L 96-101 ,240,35,81,0.432,29,64,0.453,6,17,0.353,20,27,0.741,96,38,88,0.432,31,68,0.456,7,20,0.35,18,28,0.643,101,2013-12-16,IND,DET
8768,68,@,W 96-92 ,240,37,75,0.493,30,53,0.566,7,22,0.318,15,19,0.789,96,37,91,0.407,32,75,0.427,5,16,0.313,13,17,0.765,92,2013-12-17,LAL,MEM
8769,69,Home,W 96-87 ,240,36,81,0.444,29,65,0.446,7,16,0.438,17,17,1.0,96,36,76,0.474,32,54,0.593,4,22,0.182,11,14,0.786,87,2014-01-02,UTA,MIL
8770,70,@,L 96-119 ,240,35,80,0.438,24,57,0.421,11,23,0.478,15,24,0.625,96,43,83,0.518,34,64,0.531,9,19,0.474,24,31,0.774,119,2014-01-05,BOS,OKC
8771,71,Home,L 96-112 ,240,37,86,0.43,31,66,0.47,6,20,0.3,16,16,1.0,96,43,85,0.506,34,63,0.54,9,22,0.409,17,20,0.85,112,2014-01-05,WAS,GSW
8772,72,Home,L 96-102 ,240,35,78,0.449,31,65,0.477,4,13,0.308,22,27,0.815,96,38,80,0.475,28,59,0.475,10,21,0.476,16,26,0.615,102,2014-01-08,NOP,WAS
8773,73,Home,W 96-80 ,240,32,79,0.405,21,54,0.389,11,25,0.44,21,28,0.75,96,30,75,0.4,22,50,0.44,8,25,0.32,12,18,0.667,80,2014-01-11,TOR,BRK
8774,74,@,L 96-98 (OT),265,33,93,0.355,26,63,0.413,7,30,0.233,23,28,0.821,96,35,81,0.432,28,61,0.459,7,20,0.35,21,27,0.778,98,2014-01-13,PHO,NYK
8775,75,@,L 96-108 ,240,39,89,0.438,33,66,0.5,6,23,0.261,12,18,0.667,96,42,88,0.477,31,61,0.508,11,27,0.407,13,17,0.765,108,2014-01-15,CLE,POR
8776,76,Home,W 96-93 ,240,40,79,0.506,34,68,0.5,6,11,0.545,10,13,0.769,96,35,76,0.461,26,52,0.5,9,24,0.375,14,16,0.875,93,2014-01-17,WAS,CHI
8777,77,Home,L 96-104 (OT),265,36,75,0.48,29,58,0.5,7,17,0.412,17,23,0.739,96,39,79,0.494,32,58,0.552,7,21,0.333,19,29,0.655,104,2014-01-18,CHA,MIA
8778,78,@,L 96-125 ,240,37,76,0.487,27,52,0.519,10,24,0.417,12,14,0.857,96,50,90,0.556,36,63,0.571,14,27,0.519,11,11,1.0,125,2014-01-24,CHA,NYK
8779,79,@,L 96-109 ,240,37,88,0.42,32,76,0.421,5,12,0.417,17,27,0.63,96,40,83,0.482,32,63,0.508,8,20,0.4,21,37,0.568,109,2014-01-25,IND,DEN
8780,80,@,W 96-86 ,240,37,83,0.446,33,71,0.465,4,12,0.333,18,23,0.783,96,33,71,0.465,28,58,0.483,5,13,0.385,15,16,0.938,86,2014-01-29,CHI,SAS
8781,81,@,L 96-113 ,240,38,89,0.427,33,68,0.485,5,21,0.238,15,23,0.652,96,41,92,0.446,34,67,0.507,7,25,0.28,24,40,0.6,113,2014-02-01,PHI,DET
8782,82,@,L 96-97 ,240,34,77,0.442,27,54,0.5,7,23,0.304,21,23,0.913,96,31,73,0.425,28,58,0.483,3,15,0.2,32,37,0.865,97,2014-02-01,BRK,IND
8783,83,Home,W 96-81 ,240,41,89,0.461,33,65,0.508,8,24,0.333,6,9,0.667,96,31,78,0.397,27,54,0.5,4,24,0.167,15,17,0.882,81,2014-02-01,WAS,OKC
8784,84,Home,W 96-89 ,240,41,82,0.5,37,68,0.544,4,14,0.286,10,12,0.833,96,33,80,0.413,28,66,0.424,5,14,0.357,18,22,0.818,89,2014-02-02,BOS,ORL
8785,85,@,L 96-102 ,240,34,83,0.41,28,65,0.431,6,18,0.333,22,29,0.759,96,39,85,0.459,32,65,0.492,7,20,0.35,17,21,0.81,102,2014-02-03,DET,MIA
8786,86,Home,L 96-110 ,240,37,69,0.536,31,53,0.585,6,16,0.375,16,22,0.727,96,42,78,0.538,34,60,0.567,8,18,0.444,18,25,0.72,110,2014-02-05,MEM,DAL
8787,87,@,W 96-79 ,240,37,85,0.435,31,68,0.456,6,17,0.353,16,25,0.64,96,33,85,0.388,29,69,0.42,4,16,0.25,9,13,0.692,79,2014-02-11,UTA,LAL
8788,88,Home,L 96-108 ,240,39,98,0.398,34,82,0.415,5,16,0.313,13,23,0.565,96,39,75,0.52,32,58,0.552,7,17,0.412,23,37,0.622,108,2014-02-18,DET,CHA
8789,89,@,L 96-102 ,240,31,80,0.388,24,56,0.429,7,24,0.292,27,43,0.628,96,42,87,0.483,37,72,0.514,5,15,0.333,13,15,0.867,102,2014-02-21,LAC,MEM
8790,90,@,W 96-83 ,240,41,96,0.427,33,76,0.434,8,20,0.4,6,10,0.6,96,30,78,0.385,28,60,0.467,2,18,0.111,21,26,0.808,83,2014-02-23,WAS,CLE
8791,91,Home,L 96-104 ,240,40,99,0.404,36,86,0.419,4,13,0.308,12,18,0.667,96,38,82,0.463,25,51,0.49,13,31,0.419,15,22,0.682,104,2014-02-24,DET,GSW
8792,92,@,L 96-101 ,240,38,87,0.437,26,63,0.413,12,24,0.5,8,11,0.727,96,38,74,0.514,32,59,0.542,6,15,0.4,19,22,0.864,101,2014-02-27,MIL,IND
8793,93,@,L 96-110 ,240,39,79,0.494,32,61,0.525,7,18,0.389,11,15,0.733,96,44,81,0.543,35,62,0.565,9,19,0.474,13,18,0.722,110,2014-03-01,CLE,MEM
8794,94,@,L 96-102 ,240,33,83,0.398,26,60,0.433,7,23,0.304,23,35,0.657,96,37,81,0.457,32,54,0.593,5,27,0.185,23,24,0.958,102,2014-03-01,DEN,POR
8795,95,Home,W 96-80 ,240,34,73,0.466,27,48,0.563,7,25,0.28,21,28,0.75,96,30,65,0.462,26,52,0.5,4,13,0.308,16,23,0.696,80,2014-03-03,BRK,CHI
8796,96,Home,W 96-85 ,240,35,83,0.422,31,71,0.437,4,12,0.333,22,30,0.733,96,32,83,0.386,22,55,0.4,10,28,0.357,11,14,0.786,85,2014-03-03,DET,NYK
8797,97,Home,W 96-89 ,240,32,68,0.471,31,61,0.508,1,7,0.143,31,41,0.756,96,32,75,0.427,26,55,0.473,6,20,0.3,19,28,0.679,89,2014-03-03,SAC,NOP
8798,98,Home,L 96-98 ,240,36,86,0.419,33,70,0.471,3,16,0.188,21,22,0.955,96,37,84,0.44,27,64,0.422,10,20,0.5,14,21,0.667,98,2014-03-04,IND,GSW
8799,99,Home,L 96-104 ,240,39,86,0.453,32,67,0.478,7,19,0.368,11,19,0.579,96,40,78,0.513,32,58,0.552,8,20,0.4,16,22,0.727,104,2014-03-04,PHO,LAC
8800,0,Home,L 96-104 ,240,32,75,0.427,24,57,0.421,8,18,0.444,24,28,0.857,96,40,79,0.506,28,58,0.483,12,21,0.571,12,15,0.8,104,2014-03-11,CHI,SAS
8801,1,@,W 96-95 ,240,34,78,0.436,22,49,0.449,12,29,0.414,16,19,0.842,96,33,68,0.485,24,41,0.585,9,27,0.333,20,26,0.769,95,2014-03-12,BRK,MIA
8802,2,@,W 96-87 ,240,37,76,0.487,28,53,0.528,9,23,0.391,13,20,0.65,96,35,77,0.455,28,63,0.444,7,14,0.5,10,13,0.769,87,2014-03-14,LAC,UTA
8803,3,Home,L 96-100 ,240,37,72,0.514,30,50,0.6,7,22,0.318,15,22,0.682,96,34,75,0.453,22,45,0.489,12,30,0.4,20,31,0.645,100,2014-03-18,CLE,MIA
8804,4,@,L 96-101 ,240,40,81,0.494,36,64,0.563,4,17,0.235,12,15,0.8,96,39,77,0.506,26,49,0.531,13,28,0.464,10,12,0.833,101,2014-03-19,MIA,BOS
8805,5,Home,W 96-86 ,240,36,81,0.444,34,70,0.486,2,11,0.182,22,25,0.88,96,37,84,0.44,30,66,0.455,7,18,0.389,5,10,0.5,86,2014-03-19,MEM,UTA
8806,6,Home,W 96-86 ,240,34,80,0.425,26,56,0.464,8,24,0.333,20,28,0.714,96,33,76,0.434,28,56,0.5,5,20,0.25,15,20,0.75,86,2014-03-23,TOR,ATL
8807,7,@,L 96-117 ,240,30,77,0.39,21,49,0.429,9,28,0.321,27,40,0.675,96,45,89,0.506,34,67,0.507,11,22,0.5,16,21,0.762,117,2014-03-24,DEN,OKC
8808,8,@,L 96-127 ,240,36,74,0.486,32,59,0.542,4,15,0.267,20,27,0.741,96,48,83,0.578,30,55,0.545,18,28,0.643,13,15,0.867,127,2014-03-25,NYK,LAL
8809,9,Home,L 96-97 ,240,39,84,0.464,28,58,0.483,11,26,0.423,7,13,0.538,96,37,85,0.435,28,59,0.475,9,26,0.346,14,24,0.583,97,2014-03-26,DET,CLE
8810,10,@,L 96-98 ,240,33,80,0.413,20,50,0.4,13,30,0.433,17,28,0.607,96,38,90,0.422,35,78,0.449,3,12,0.25,19,25,0.76,98,2014-03-26,LAC,NOP
8811,11,Home,W 96-80 ,240,37,78,0.474,28,57,0.491,9,21,0.429,13,20,0.65,96,32,81,0.395,29,69,0.42,3,12,0.25,13,16,0.813,80,2014-03-29,SAS,NOP
8812,12,@,L 96-116 ,240,36,86,0.419,30,65,0.462,6,21,0.286,18,24,0.75,96,41,74,0.554,30,56,0.536,11,18,0.611,23,26,0.885,116,2014-03-30,UTA,OKC
8813,13,@,L 96-105 ,240,32,84,0.381,22,49,0.449,10,35,0.286,22,28,0.786,96,44,83,0.53,38,58,0.655,6,25,0.24,11,17,0.647,105,2014-04-01,HOU,BRK
8814,14,Home,W 96-77 ,240,39,77,0.506,30,51,0.588,9,26,0.346,9,14,0.643,96,32,73,0.438,28,55,0.509,4,18,0.222,9,9,1.0,77,2014-04-02,MIA,MIL
8815,15,@,L 96-100 ,240,34,73,0.466,26,54,0.481,8,19,0.421,20,29,0.69,96,33,64,0.516,29,53,0.547,4,11,0.364,30,35,0.857,100,2014-04-04,NOP,UTA
8816,16,@,W 96-94 (OT),265,34,91,0.374,25,65,0.385,9,26,0.346,19,27,0.704,96,35,96,0.365,28,74,0.378,7,22,0.318,17,21,0.81,94,2014-04-05,CHA,CLE
8817,17,@,W 96-78 ,240,35,79,0.443,26,56,0.464,9,23,0.391,17,21,0.81,96,34,86,0.395,31,70,0.443,3,16,0.188,7,12,0.583,78,2014-04-05,CHI,WAS
8818,18,@,W 96-86 ,240,35,82,0.427,33,63,0.524,2,19,0.105,24,33,0.727,96,32,77,0.416,28,58,0.483,4,19,0.211,18,24,0.75,86,2014-04-11,WAS,ORL
8819,19,Home,L 96-114 ,240,35,67,0.522,28,44,0.636,7,23,0.304,19,26,0.731,96,41,83,0.494,29,59,0.492,12,24,0.5,20,29,0.69,114,2014-11-01,PHI,MIA
8820,20,Home,W 96-93 ,240,39,78,0.5,31,62,0.5,8,16,0.5,10,17,0.588,96,33,70,0.471,27,55,0.491,6,15,0.4,21,29,0.724,93,2014-11-02,NYK,CHO
8821,21,Home,W 96-89 ,240,35,82,0.427,30,64,0.469,5,18,0.278,21,29,0.724,96,30,77,0.39,26,55,0.473,4,22,0.182,25,31,0.806,89,2014-11-05,CHA,MIA
8822,22,Home,W 96-94 (OT),265,34,91,0.374,27,74,0.365,7,17,0.412,21,23,0.913,96,35,90,0.389,27,63,0.429,8,27,0.296,16,20,0.8,94,2014-11-05,WAS,IND
8823,23,@,L 96-103 ,240,40,84,0.476,32,63,0.508,8,21,0.381,8,11,0.727,96,33,81,0.407,24,59,0.407,9,22,0.409,28,36,0.778,103,2014-11-08,NYK,ATL
8824,24,@,L 96-104 ,240,39,75,0.52,31,60,0.517,8,15,0.533,10,16,0.625,96,40,83,0.482,36,69,0.522,4,14,0.286,20,23,0.87,104,2014-11-09,ORL,BRK
8825,25,Home,L 96-105 ,240,35,83,0.422,26,54,0.481,9,29,0.31,17,24,0.708,96,42,76,0.553,33,53,0.623,9,23,0.391,12,20,0.6,105,2014-11-09,DAL,MIA
8826,26,Home,L 96-97 ,240,36,93,0.387,30,70,0.429,6,23,0.261,18,25,0.72,96,33,72,0.458,27,57,0.474,6,15,0.4,25,35,0.714,97,2014-11-09,DET,UTA
8827,27,@,W 96-89 (OT),265,38,89,0.427,27,58,0.466,11,31,0.355,9,15,0.6,96,38,96,0.396,26,60,0.433,12,36,0.333,1,6,0.167,89,2014-11-14,DET,OKC
8828,28,Home,W 96-92 ,240,38,83,0.458,29,57,0.509,9,26,0.346,11,13,0.846,96,35,80,0.438,32,70,0.457,3,10,0.3,19,26,0.731,92,2014-11-19,TOR,MEM
8829,29,Home,L 96-122 ,240,36,78,0.462,32,55,0.582,4,23,0.174,20,33,0.606,96,44,86,0.512,31,55,0.564,13,31,0.419,21,23,0.913,122,2014-11-21,PHI,PHO
8830,30,Home,L 96-111 ,240,36,87,0.414,30,67,0.448,6,20,0.3,18,24,0.75,96,44,85,0.518,32,59,0.542,12,26,0.462,11,19,0.579,111,2014-11-26,ORL,GSW
8831,31,Home,L 96-112 ,240,34,75,0.453,27,54,0.5,7,21,0.333,21,33,0.636,96,45,80,0.563,34,52,0.654,11,28,0.393,11,15,0.733,112,2014-11-29,UTA,LAC
8832,32,Home,L 96-106 ,240,33,90,0.367,27,69,0.391,6,21,0.286,24,31,0.774,96,39,81,0.481,29,64,0.453,10,17,0.588,18,24,0.75,106,2014-12-02,DET,LAL
8833,33,@,L 96-105 ,240,39,76,0.513,37,63,0.587,2,13,0.154,16,27,0.593,96,41,93,0.441,31,65,0.477,10,28,0.357,13,20,0.65,105,2014-12-03,MEM,HOU
8834,34,@,L 96-113 ,240,38,92,0.413,32,76,0.421,6,16,0.375,14,19,0.737,96,46,90,0.511,38,70,0.543,8,20,0.4,13,22,0.591,113,2014-12-05,LAL,BOS
8835,35,Home,L 96-105 ,240,35,79,0.443,31,64,0.484,4,15,0.267,22,28,0.786,96,42,83,0.506,33,57,0.579,9,26,0.346,12,14,0.857,105,2014-12-06,SAC,ORL
8836,36,Home,W 96-84 ,240,36,87,0.414,26,60,0.433,10,27,0.37,14,19,0.737,96,34,93,0.366,28,58,0.483,6,35,0.171,10,13,0.769,84,2014-12-07,ATL,DEN
8837,37,@,W 96-94 ,240,39,87,0.448,33,66,0.5,6,21,0.286,12,17,0.706,96,34,76,0.447,27,53,0.509,7,23,0.304,19,28,0.679,94,2014-12-07,OKC,DET
8838,38,@,L 96-100 ,240,39,84,0.464,35,64,0.547,4,20,0.2,14,23,0.609,96,40,80,0.5,36,66,0.545,4,14,0.286,16,22,0.727,100,2014-12-09,SAS,UTA
8839,39,Home,W 96-87 ,240,35,84,0.417,32,70,0.457,3,14,0.214,23,29,0.793,96,38,87,0.437,33,64,0.516,5,23,0.217,6,10,0.6,87,2014-12-10,CHA,BOS
8840,40,Home,L 96-103 ,240,35,89,0.393,26,62,0.419,9,27,0.333,17,22,0.773,96,42,88,0.477,35,64,0.547,7,24,0.292,12,14,0.857,103,2014-12-10,IND,LAC
8841,41,@,L 96-104 ,240,32,75,0.427,26,55,0.473,6,20,0.3,26,31,0.839,96,39,80,0.488,30,64,0.469,9,16,0.563,17,21,0.81,104,2014-12-12,LAC,WAS
8842,42,@,L 96-108 ,240,36,96,0.375,29,68,0.426,7,28,0.25,17,26,0.654,96,39,88,0.443,29,54,0.537,10,34,0.294,20,34,0.588,108,2014-12-13,DEN,HOU
8843,43,@,W 96-94 ,240,35,73,0.479,27,57,0.474,8,16,0.5,18,22,0.818,96,30,75,0.4,18,37,0.486,12,38,0.316,22,27,0.815,94,2014-12-15,MIL,PHO
8844,44,Home,L 96-100 ,240,36,77,0.468,31,66,0.47,5,11,0.455,19,24,0.792,96,42,84,0.5,36,65,0.554,6,19,0.316,10,14,0.714,100,2014-12-21,MIN,IND
8845,45,@,W 96-88 ,240,35,82,0.427,29,59,0.492,6,23,0.261,20,25,0.8,96,35,84,0.417,28,61,0.459,7,23,0.304,11,20,0.55,88,2014-12-21,PHI,ORL
8846,46,@,L 96-102 ,240,36,82,0.439,29,57,0.509,7,25,0.28,17,22,0.773,96,43,91,0.473,37,68,0.544,6,23,0.261,10,14,0.714,102,2014-12-23,DEN,BRK
8847,47,Home,W 96-84 ,240,39,78,0.5,34,63,0.54,5,15,0.333,13,18,0.722,96,33,83,0.398,29,63,0.46,4,20,0.2,14,19,0.737,84,2014-12-23,IND,NOP
8848,48,@,W 96-82 ,240,36,83,0.434,30,69,0.435,6,14,0.429,18,21,0.857,96,33,86,0.384,25,61,0.41,8,25,0.32,8,15,0.533,82,2014-12-30,BRK,CHI
8849,49,@,W 96-80 ,240,40,90,0.444,29,65,0.446,11,25,0.44,5,10,0.5,96,29,85,0.341,21,54,0.389,8,31,0.258,14,16,0.875,80,2014-12-31,MIL,CLE
8850,50,@,L 96-112 ,240,37,87,0.425,30,61,0.492,7,26,0.269,15,25,0.6,96,42,84,0.5,28,52,0.538,14,32,0.438,14,16,0.875,112,2015-01-02,PHI,PHO
8851,51,@,W 96-88 (OT),265,37,94,0.394,27,67,0.403,10,27,0.37,12,19,0.632,96,33,84,0.393,30,59,0.508,3,25,0.12,19,23,0.826,88,2015-01-05,DAL,BRK
8852,52,Home,L 96-102 ,240,37,88,0.42,34,68,0.5,3,20,0.15,19,22,0.864,96,37,81,0.457,30,56,0.536,7,25,0.28,21,27,0.778,102,2015-01-06,MIL,PHO
8853,53,Home,W 96-86 ,240,32,72,0.444,19,47,0.404,13,25,0.52,19,23,0.826,96,35,79,0.443,30,62,0.484,5,17,0.294,11,11,1.0,86,2015-01-07,ATL,MEM
8854,54,Home,L 96-120 ,240,37,80,0.463,26,54,0.481,11,26,0.423,11,21,0.524,96,41,77,0.532,25,41,0.61,16,36,0.444,22,32,0.688,120,2015-01-08,NYK,HOU
8855,55,@,L 96-109 ,240,39,83,0.47,33,65,0.508,6,18,0.333,12,20,0.6,96,41,91,0.451,28,61,0.459,13,30,0.433,14,19,0.737,109,2015-01-10,BOS,TOR
8856,56,Home,L 96-98 ,240,40,89,0.449,34,71,0.479,6,18,0.333,10,12,0.833,96,32,85,0.376,19,54,0.352,13,31,0.419,21,24,0.875,98,2015-01-16,IND,DET
8857,57,Home,L 96-106 ,240,36,79,0.456,27,55,0.491,9,24,0.375,15,20,0.75,96,40,87,0.46,37,73,0.507,3,14,0.214,23,29,0.793,106,2015-01-16,ORL,MEM
8858,58,Home,W 96-81 ,240,36,80,0.45,29,58,0.5,7,22,0.318,17,27,0.63,96,29,75,0.387,25,58,0.431,4,17,0.235,19,29,0.655,81,2015-01-16,PHI,NOP
8859,59,@,L 96-110 ,240,37,74,0.5,31,55,0.564,6,19,0.316,16,20,0.8,96,42,94,0.447,31,65,0.477,11,29,0.379,15,17,0.882,110,2015-01-16,POR,SAS
8860,60,Home,W 96-80 ,240,38,83,0.458,35,67,0.522,3,16,0.188,17,21,0.81,96,28,77,0.364,22,57,0.386,6,20,0.3,18,21,0.857,80,2015-01-21,NOP,LAL
8861,61,@,L 96-103 ,240,40,82,0.488,35,67,0.522,5,15,0.333,11,14,0.786,96,35,87,0.402,22,56,0.393,13,31,0.419,20,20,1.0,103,2015-01-24,WAS,POR
8862,62,@,W 96-84 ,240,38,84,0.452,37,71,0.521,1,13,0.077,19,23,0.826,96,31,87,0.356,24,63,0.381,7,24,0.292,15,19,0.789,84,2015-01-25,MIA,CHI
8863,63,Home,L 96-121 ,240,35,79,0.443,28,63,0.444,7,16,0.438,19,24,0.792,96,46,91,0.505,36,68,0.529,10,23,0.435,19,26,0.731,121,2015-02-03,SAC,GSW
8864,64,@,L 96-105 ,240,34,77,0.442,30,61,0.492,4,16,0.25,24,30,0.8,96,38,80,0.475,27,55,0.491,11,25,0.44,18,27,0.667,105,2015-02-04,WAS,ATL
8865,65,@,L 96-107 ,240,35,79,0.443,24,54,0.444,11,25,0.44,15,31,0.484,96,39,86,0.453,29,59,0.492,10,27,0.37,19,25,0.76,107,2015-02-06,PHI,BOS
8866,66,Home,W 96-93 ,240,37,75,0.493,29,55,0.527,8,20,0.4,14,19,0.737,96,36,86,0.419,29,57,0.509,7,29,0.241,14,20,0.7,93,2015-02-07,MIL,BOS
8867,67,Home,L 96-100 ,240,33,79,0.418,20,57,0.351,13,22,0.591,17,20,0.85,96,39,93,0.419,30,72,0.417,9,21,0.429,13,19,0.684,100,2015-02-09,NOP,UTA
8868,68,Home,W 96-80 ,240,33,77,0.429,26,52,0.5,7,25,0.28,23,27,0.852,96,33,83,0.398,29,61,0.475,4,22,0.182,10,15,0.667,80,2015-02-09,WAS,ORL
8869,69,Home,L 96-106 ,240,37,85,0.435,31,67,0.463,6,18,0.333,16,27,0.593,96,43,79,0.544,39,63,0.619,4,16,0.25,16,23,0.696,106,2015-02-10,LAL,DEN
8870,70,Home,L 96-110 ,240,31,81,0.383,19,47,0.404,12,34,0.353,22,33,0.667,96,39,91,0.429,31,67,0.463,8,24,0.333,24,32,0.75,110,2015-02-25,DEN,PHO
8871,71,@,L 96-102 ,240,39,92,0.424,32,71,0.451,7,21,0.333,11,15,0.733,96,38,74,0.514,27,49,0.551,11,25,0.44,15,19,0.789,102,2015-02-25,BRK,NOP
8872,72,Home,W 96-89 ,240,37,96,0.385,28,65,0.431,9,31,0.29,13,16,0.813,96,33,77,0.429,31,63,0.492,2,14,0.143,21,31,0.677,89,2015-02-27,CHI,MIN
8873,73,Home,L 96-107 ,240,38,79,0.481,37,75,0.493,1,4,0.25,19,23,0.826,96,35,88,0.398,27,65,0.415,8,23,0.348,29,32,0.906,107,2015-02-27,SAC,SAS
8874,74,@,W 96-86 ,240,38,87,0.437,31,60,0.517,7,27,0.259,13,24,0.542,96,27,87,0.31,17,61,0.279,10,26,0.385,22,30,0.733,86,2015-03-01,LAC,CHI
8875,75,@,L 96-104 ,240,39,90,0.433,25,49,0.51,14,41,0.341,4,9,0.444,96,39,86,0.453,31,57,0.544,8,29,0.276,18,21,0.857,104,2015-03-03,HOU,ATL
8876,76,@,W 96-87 ,240,39,83,0.47,31,65,0.477,8,18,0.444,10,12,0.833,96,32,78,0.41,22,52,0.423,10,26,0.385,13,21,0.619,87,2015-03-13,ATL,PHO
8877,77,Home,W 96-83 ,240,37,78,0.474,29,64,0.453,8,14,0.571,14,16,0.875,96,30,72,0.417,25,53,0.472,5,19,0.263,18,27,0.667,83,2015-03-14,MEM,MIL
8878,78,@,L 96-112 ,240,33,77,0.429,22,55,0.4,11,22,0.5,19,22,0.864,96,44,88,0.5,39,69,0.565,5,19,0.263,19,23,0.826,112,2015-03-20,NOP,GSW
8879,79,@,W 96-92 ,240,29,69,0.42,25,49,0.51,4,20,0.2,34,43,0.791,96,38,87,0.437,31,63,0.492,7,24,0.292,9,14,0.643,92,2015-03-27,BOS,NYK
8880,80,@,L 96-99 ,240,35,84,0.417,27,57,0.474,8,27,0.296,18,31,0.581,96,35,78,0.449,27,56,0.482,8,22,0.364,21,27,0.778,99,2015-03-30,HOU,TOR
8881,81,@,L 96-106 ,240,39,87,0.448,28,61,0.459,11,26,0.423,7,9,0.778,96,41,91,0.451,35,77,0.455,6,14,0.429,18,23,0.783,106,2015-04-06,POR,BRK
8882,82,Home,W 96-69 ,240,41,83,0.494,37,58,0.638,4,25,0.16,10,14,0.714,96,26,83,0.313,22,63,0.349,4,20,0.2,13,18,0.722,69,2015-04-07,ATL,PHO
8883,83,Home,W 96-73 ,240,41,83,0.494,35,63,0.556,6,20,0.3,8,12,0.667,96,27,83,0.325,24,65,0.369,3,18,0.167,16,22,0.727,73,2015-04-12,MIL,BRK
8884,84,Home,L 96-103 ,240,36,79,0.456,30,60,0.5,6,19,0.316,18,22,0.818,96,38,73,0.521,29,50,0.58,9,23,0.391,18,26,0.692,103,2015-11-02,BRK,MIL
8885,85,@,L 96-102 ,240,36,98,0.367,27,68,0.397,9,30,0.3,15,21,0.714,96,37,81,0.457,29,55,0.527,8,26,0.308,20,23,0.87,102,2015-11-02,PHO,LAC
8886,86,Home,W 96-86 ,240,33,83,0.398,26,56,0.464,7,27,0.259,23,32,0.719,96,33,84,0.393,25,60,0.417,8,24,0.333,12,15,0.8,86,2015-11-04,CLE,NYK
8887,87,@,W 96-84 ,240,37,85,0.435,26,61,0.426,11,24,0.458,11,17,0.647,96,28,72,0.389,23,52,0.442,5,20,0.25,23,34,0.676,84,2015-11-05,UTA,DEN
8888,88,@,W 96-84 ,240,37,76,0.487,33,62,0.532,4,14,0.286,18,25,0.72,96,30,85,0.353,26,73,0.356,4,12,0.333,20,22,0.909,84,2015-11-05,MIA,MIN
8889,89,@,L 96-115 ,240,37,77,0.481,30,57,0.526,7,20,0.35,15,21,0.714,96,44,87,0.506,29,57,0.509,15,30,0.5,12,20,0.6,115,2015-11-05,MEM,POR
8890,90,Home,W 96-76 ,240,35,83,0.422,27,63,0.429,8,20,0.4,18,25,0.72,96,28,71,0.394,25,52,0.481,3,19,0.158,17,22,0.773,76,2015-11-08,MIA,TOR
8891,91,@,L 96-101 ,240,33,74,0.446,26,47,0.553,7,27,0.259,23,35,0.657,96,37,79,0.468,30,60,0.5,7,19,0.368,20,26,0.769,101,2015-11-14,DET,LAC
8892,92,Home,L 96-97 ,240,37,76,0.487,29,54,0.537,8,22,0.364,14,17,0.824,96,39,76,0.513,32,55,0.582,7,21,0.333,12,17,0.706,97,2015-11-15,ATL,UTA
8893,93,Home,W 96-95 ,240,35,86,0.407,29,71,0.408,6,15,0.4,20,32,0.625,96,35,87,0.402,26,66,0.394,9,21,0.429,16,24,0.667,95,2015-11-16,CHI,IND
8894,94,Home,W 96-84 ,240,36,85,0.424,28,61,0.459,8,24,0.333,16,19,0.842,96,28,74,0.378,22,45,0.489,6,29,0.207,22,37,0.595,84,2015-11-20,MEM,HOU
8895,95,@,W 96-86 ,240,40,87,0.46,34,59,0.576,6,28,0.214,10,13,0.769,96,33,77,0.429,30,64,0.469,3,13,0.231,17,25,0.68,86,2015-11-20,DET,MIN
8896,96,Home,W 96-91 ,240,30,69,0.435,25,51,0.49,5,18,0.278,31,45,0.689,96,31,82,0.378,21,51,0.412,10,31,0.323,19,24,0.792,91,2015-11-21,MIA,PHI
8897,97,@,L 96-110 ,240,30,77,0.39,19,43,0.442,11,34,0.324,25,28,0.893,96,37,86,0.43,30,65,0.462,7,21,0.333,29,37,0.784,110,2015-11-24,DAL,MEM
8898,98,@,L 96-108 ,240,36,82,0.439,29,59,0.492,7,23,0.304,17,23,0.739,96,38,78,0.487,26,48,0.542,12,30,0.4,20,26,0.769,108,2015-11-28,LAL,POR
8899,99,@,W 96-93 ,240,38,86,0.442,33,69,0.478,5,17,0.294,15,20,0.75,96,29,77,0.377,25,58,0.431,4,19,0.211,31,38,0.816,93,2015-12-01,ORL,MIN
8900,0,@,W 96-86 ,240,36,79,0.456,30,54,0.556,6,25,0.24,18,24,0.75,96,33,90,0.367,25,63,0.397,8,27,0.296,12,16,0.75,86,2015-12-02,TOR,ATL
8901,1,Home,L 96-100 ,240,37,81,0.457,29,52,0.558,8,29,0.276,14,20,0.7,96,39,84,0.464,27,58,0.466,12,26,0.462,10,18,0.556,100,2015-12-04,DAL,HOU
8902,2,Home,L 96-102 ,240,37,89,0.416,28,64,0.438,9,25,0.36,13,19,0.684,96,37,89,0.416,27,55,0.491,10,34,0.294,18,25,0.72,102,2015-12-05,CHI,CHO
8903,3,Home,W 96-83 ,240,36,86,0.419,30,58,0.517,6,28,0.214,18,20,0.9,96,35,81,0.432,30,61,0.492,5,20,0.25,8,13,0.615,83,2015-12-11,IND,MIA
8904,4,Home,L 96-106 ,240,36,83,0.434,23,48,0.479,13,35,0.371,11,18,0.611,96,45,96,0.469,33,62,0.532,12,34,0.353,4,7,0.571,106,2015-12-11,PHO,POR
8905,5,@,L 96-118 ,240,41,82,0.5,38,66,0.576,3,16,0.188,11,18,0.611,96,45,90,0.5,32,61,0.525,13,29,0.448,15,19,0.789,118,2015-12-12,IND,DET
8906,6,Home,W 96-76 ,240,32,78,0.41,25,56,0.446,7,22,0.318,25,34,0.735,96,28,84,0.333,18,56,0.321,10,28,0.357,10,14,0.714,76,2015-12-13,TOR,PHI
8907,7,@,L 96-115 ,240,38,92,0.413,27,61,0.443,11,31,0.355,9,13,0.692,96,43,85,0.506,35,63,0.556,8,22,0.364,21,26,0.808,115,2015-12-14,PHI,CHI
8908,8,Home,W 96-84 ,240,37,83,0.446,32,64,0.5,5,19,0.263,17,21,0.81,96,30,77,0.39,25,49,0.51,5,28,0.179,19,25,0.76,84,2015-12-19,MEM,IND
8909,9,Home,L 96-104 ,240,36,87,0.414,23,62,0.371,13,25,0.52,11,17,0.647,96,42,91,0.462,28,56,0.5,14,35,0.4,6,13,0.462,104,2015-12-23,PHO,DEN
8910,10,Home,L 96-105 ,240,37,96,0.385,31,72,0.431,6,24,0.25,16,23,0.696,96,40,92,0.435,33,74,0.446,7,18,0.389,18,20,0.9,105,2015-12-25,OKC,CHI
8911,11,Home,L 96-111 ,240,43,89,0.483,38,72,0.528,5,17,0.294,5,16,0.313,96,42,84,0.5,30,57,0.526,12,27,0.444,15,22,0.682,111,2015-12-26,BRK,WAS
8912,12,@,L 96-112 ,240,32,84,0.381,24,55,0.436,8,29,0.276,24,32,0.75,96,45,80,0.563,39,64,0.609,6,16,0.375,16,22,0.727,112,2015-12-27,LAL,MEM
8913,13,@,L 96-108 ,240,37,89,0.416,27,62,0.435,10,27,0.37,12,17,0.706,96,43,79,0.544,35,63,0.556,8,16,0.5,14,17,0.824,108,2015-12-29,DET,NYK
8914,14,@,L 96-109 ,240,35,78,0.449,19,42,0.452,16,36,0.444,10,14,0.714,96,43,86,0.5,28,53,0.528,15,33,0.455,8,11,0.727,109,2015-12-31,POR,UTA
8915,15,Home,W 96-95 ,240,37,80,0.463,33,71,0.465,4,9,0.444,18,29,0.621,96,35,84,0.417,21,40,0.525,14,44,0.318,11,16,0.688,95,2016-01-08,MIL,DAL
8916,16,Home,L 96-101 ,240,36,81,0.444,29,63,0.46,7,18,0.389,17,23,0.739,96,39,84,0.464,30,62,0.484,9,22,0.409,14,18,0.778,101,2016-01-12,MIN,OKC
8917,17,@,W 96-87 ,240,36,74,0.486,27,55,0.491,9,19,0.474,15,21,0.714,96,33,84,0.393,29,67,0.433,4,17,0.235,17,26,0.654,87,2016-01-20,PHI,ORL
8918,18,@,W 96-83 ,240,38,87,0.437,31,70,0.443,7,17,0.412,13,15,0.867,96,35,94,0.372,31,70,0.443,4,24,0.167,9,22,0.409,83,2016-01-23,CHI,CLE
8919,19,Home,W 96-93 ,240,32,76,0.421,26,49,0.531,6,27,0.222,26,30,0.867,96,35,80,0.438,31,64,0.484,4,16,0.25,19,28,0.679,93,2016-01-31,POR,MIN
8920,20,@,L 96-105 (OT),265,39,90,0.433,34,69,0.493,5,21,0.238,13,20,0.65,96,38,85,0.447,31,67,0.463,7,18,0.389,22,33,0.667,105,2016-02-01,CHI,UTA
8921,21,Home,L 96-99 ,240,39,85,0.459,35,65,0.538,4,20,0.2,14,26,0.538,96,39,81,0.481,32,61,0.525,7,20,0.35,14,20,0.7,99,2016-02-04,NOP,LAL
8922,22,@,L 96-102 ,240,38,91,0.418,25,60,0.417,13,31,0.419,7,9,0.778,96,39,76,0.513,29,49,0.592,10,27,0.37,14,20,0.7,102,2016-02-05,IND,ATL
8923,23,@,W 96-79 ,240,35,87,0.402,24,52,0.462,11,35,0.314,15,23,0.652,96,25,77,0.325,18,41,0.439,7,36,0.194,22,30,0.733,79,2016-02-06,POR,HOU
8924,24,Home,L 96-101 ,240,37,84,0.44,29,62,0.468,8,22,0.364,14,20,0.7,96,37,86,0.43,32,65,0.492,5,21,0.238,22,28,0.786,101,2016-02-07,NYK,DEN
8925,25,Home,W 96-94 ,240,39,85,0.459,32,60,0.533,7,25,0.28,11,12,0.917,96,35,91,0.385,22,63,0.349,13,28,0.464,11,15,0.733,94,2016-02-07,ORL,ATL
8926,26,@,L 96-100 ,240,33,70,0.471,26,49,0.531,7,21,0.333,23,30,0.767,96,39,82,0.476,31,63,0.492,8,19,0.421,14,21,0.667,100,2016-02-10,UTA,NOP
8927,27,Home,L 96-98 ,240,37,91,0.407,29,71,0.408,8,20,0.4,14,16,0.875,96,38,89,0.427,30,69,0.435,8,20,0.4,14,15,0.933,98,2016-02-10,ORL,SAS
8928,28,Home,L 96-104 ,240,35,81,0.432,30,59,0.508,5,22,0.227,21,24,0.875,96,40,79,0.506,30,52,0.577,10,27,0.37,14,15,0.933,104,2016-02-21,BRK,CHO
8929,29,@,W 96-88 ,240,37,80,0.463,29,55,0.527,8,25,0.32,14,21,0.667,96,34,79,0.43,26,53,0.491,8,26,0.308,12,13,0.923,88,2016-02-22,DET,CLE
8930,30,@,W 96-78 ,240,38,79,0.481,29,61,0.475,9,18,0.5,11,12,0.917,96,33,77,0.429,30,60,0.5,3,17,0.176,9,12,0.75,78,2016-02-25,SAS,UTA
8931,31,@,W 96-95 ,240,36,83,0.434,25,55,0.455,11,28,0.393,13,19,0.684,96,35,85,0.412,31,66,0.47,4,19,0.211,21,24,0.875,95,2016-02-26,CHA,IND
8932,32,Home,L 96-98 ,240,37,89,0.416,32,69,0.464,5,20,0.25,17,25,0.68,96,40,84,0.476,33,69,0.478,7,15,0.467,11,17,0.647,98,2016-02-27,UTA,BRK
8933,33,@,L 96-100 ,240,37,80,0.463,29,62,0.468,8,18,0.444,14,15,0.933,96,35,83,0.422,26,54,0.481,9,29,0.31,21,25,0.84,100,2016-02-29,IND,CLE
8934,34,Home,L 96-103 ,240,40,75,0.533,32,50,0.64,8,25,0.32,8,10,0.8,96,36,75,0.48,33,55,0.6,3,20,0.15,28,36,0.778,103,2016-02-29,DEN,MEM
8935,35,Home,L 96-104 ,240,34,90,0.378,31,71,0.437,3,19,0.158,25,30,0.833,96,32,76,0.421,25,51,0.49,7,25,0.28,33,43,0.767,104,2016-03-06,MIL,OKC
8936,36,@,L 96-116 ,240,32,84,0.381,25,58,0.431,7,26,0.269,25,31,0.806,96,41,87,0.471,26,55,0.473,15,32,0.469,19,24,0.792,116,2016-03-09,MEM,BOS
8937,37,Home,L 96-102 ,240,39,86,0.453,30,56,0.536,9,30,0.3,9,11,0.818,96,38,85,0.447,29,58,0.5,9,27,0.333,17,30,0.567,102,2016-03-09,DAL,DET
8938,38,@,L 96-104 ,240,35,82,0.427,28,59,0.475,7,23,0.304,19,27,0.704,96,38,82,0.463,31,58,0.534,7,24,0.292,21,29,0.724,104,2016-03-10,ATL,TOR
8939,39,Home,L 96-118 ,240,38,81,0.469,30,60,0.5,8,21,0.381,12,15,0.8,96,47,91,0.516,37,73,0.507,10,18,0.556,14,20,0.7,118,2016-03-11,CHI,MIA
8940,40,Home,L 96-99 ,240,36,84,0.429,30,57,0.526,6,27,0.222,18,25,0.72,96,37,86,0.43,30,65,0.462,7,21,0.333,18,21,0.857,99,2016-03-11,OKC,MIN
8941,41,Home,L 96-107 ,240,32,76,0.421,22,46,0.478,10,30,0.333,22,34,0.647,96,42,87,0.483,33,57,0.579,9,30,0.3,14,18,0.778,107,2016-03-14,CHA,DAL
8942,42,@,L 96-117 ,240,35,87,0.402,29,67,0.433,6,20,0.3,20,23,0.87,96,43,88,0.489,30,67,0.448,13,21,0.619,18,24,0.75,117,2016-03-16,CHI,WAS
8943,43,Home,W 96-86 ,240,37,75,0.493,32,56,0.571,5,19,0.263,17,25,0.68,96,34,92,0.37,31,79,0.392,3,13,0.231,15,17,0.882,86,2016-03-17,MIL,MEM
8944,44,@,L 96-107 ,240,39,93,0.419,34,74,0.459,5,19,0.263,13,19,0.684,96,40,85,0.471,33,63,0.524,7,22,0.318,20,24,0.833,107,2016-03-21,ORL,BOS
8945,45,Home,W 96-94 ,240,37,82,0.451,33,63,0.524,4,19,0.211,18,28,0.643,96,32,80,0.4,26,56,0.464,6,24,0.25,24,32,0.75,94,2016-03-24,LAC,POR
8946,46,Home,L 96-98 ,240,39,90,0.433,36,71,0.507,3,19,0.158,15,17,0.882,96,37,87,0.425,27,61,0.443,10,26,0.385,14,16,0.875,98,2016-03-29,IND,CHI
8947,47,Home,L 96-103 (OT),265,37,92,0.402,28,60,0.467,9,32,0.281,13,29,0.448,96,39,89,0.438,27,54,0.5,12,35,0.343,13,18,0.722,103,2016-03-30,UTA,GSW
8948,48,Home,W 96-90 ,240,34,78,0.436,28,55,0.509,6,23,0.261,22,31,0.71,96,32,88,0.364,21,53,0.396,11,35,0.314,15,21,0.714,90,2016-04-05,TOR,CHO
8949,49,@,L 96-118 ,240,37,83,0.446,30,65,0.462,7,18,0.389,15,19,0.789,96,43,77,0.558,37,57,0.649,6,20,0.3,26,30,0.867,118,2016-04-10,ORL,MIA
8950,50,Home,L 96-103 ,240,39,89,0.438,29,63,0.46,10,26,0.385,8,12,0.667,96,41,93,0.441,28,56,0.5,13,37,0.351,8,15,0.533,103,2016-04-13,BRK,TOR
8951,51,@,W 96-91 ,240,35,74,0.473,29,51,0.569,6,23,0.261,20,26,0.769,96,31,77,0.403,19,38,0.5,12,39,0.308,17,21,0.81,91,2016-04-13,SAS,DAL
8952,52,@,L 96-101 ,240,39,83,0.47,30,53,0.566,9,30,0.3,9,15,0.6,96,41,85,0.482,35,60,0.583,6,25,0.24,13,15,0.867,101,2016-04-13,UTA,LAL
8953,53,Home,L 96-107 ,240,39,92,0.424,36,76,0.474,3,16,0.188,15,20,0.75,96,40,89,0.449,33,66,0.5,7,23,0.304,20,24,0.833,107,2016-10-26,MIL,CHO
8954,54,Home,L 96-108 ,240,34,89,0.382,28,71,0.394,6,18,0.333,22,28,0.786,96,47,97,0.485,43,81,0.531,4,16,0.25,10,16,0.625,108,2016-10-26,ORL,MIA
8955,55,Home,W 96-89 ,240,31,75,0.413,25,50,0.5,6,25,0.24,28,40,0.7,96,32,84,0.381,23,61,0.377,9,23,0.391,16,21,0.762,89,2016-10-28,UTA,LAL
8956,56,@,L 96-113 ,240,35,87,0.402,28,55,0.509,7,32,0.219,19,24,0.792,96,45,95,0.474,36,69,0.522,9,26,0.346,14,17,0.824,113,2016-10-30,LAL,OKC
8957,57,@,L 96-108 (OT),265,34,89,0.382,29,66,0.439,5,23,0.217,23,27,0.852,96,37,86,0.43,24,57,0.421,13,29,0.448,21,29,0.724,108,2016-11-01,SAC,MIA
8958,58,@,L 96-122 ,240,35,87,0.402,25,60,0.417,10,27,0.37,16,28,0.571,96,46,89,0.517,32,59,0.542,14,30,0.467,16,20,0.8,122,2016-11-03,OKC,GSW
8959,59,Home,W 96-87 ,240,37,84,0.44,31,59,0.525,6,25,0.24,16,18,0.889,96,34,88,0.386,25,60,0.417,9,28,0.321,10,15,0.667,87,2016-11-04,TOR,MIA
8960,60,@,W 96-91 ,240,34,78,0.436,29,62,0.468,5,16,0.313,23,31,0.742,96,30,84,0.357,23,54,0.426,7,30,0.233,24,31,0.774,91,2016-11-06,SAC,TOR
8961,61,@,L 96-110 ,240,33,79,0.418,22,46,0.478,11,33,0.333,19,27,0.704,96,44,92,0.478,34,62,0.548,10,30,0.333,12,17,0.706,110,2016-11-09,BRK,NYK
8962,62,Home,W 96-86 ,240,36,81,0.444,27,61,0.443,9,20,0.45,15,19,0.789,96,32,76,0.421,27,51,0.529,5,25,0.2,17,21,0.81,86,2016-11-11,SAS,DET
8963,63,@,L 96-117 ,240,36,83,0.434,25,54,0.463,11,29,0.379,13,20,0.65,96,48,95,0.505,35,63,0.556,13,32,0.406,8,14,0.571,117,2016-11-12,PHI,ATL
8964,64,@,L 96-106 ,240,35,78,0.449,29,48,0.604,6,30,0.2,20,21,0.952,96,36,68,0.529,29,50,0.58,7,18,0.389,27,36,0.75,106,2016-11-12,MEM,MIL
8965,65,Home,L 96-102 ,240,35,73,0.479,27,45,0.6,8,28,0.286,18,22,0.818,96,36,76,0.474,28,55,0.509,8,21,0.381,22,26,0.846,102,2016-11-14,UTA,MEM
8966,66,Home,W 96-73 ,240,39,97,0.402,32,67,0.478,7,30,0.233,11,21,0.524,96,28,85,0.329,21,62,0.339,7,23,0.304,10,13,0.769,73,2016-11-17,MIA,MIL
8967,67,@,L 96-100 ,240,39,84,0.464,32,56,0.571,7,28,0.25,11,17,0.647,96,37,90,0.411,27,61,0.443,10,29,0.345,16,24,0.667,100,2016-11-18,ATL,CHO
8968,68,Home,L 96-116 ,240,36,76,0.474,35,69,0.507,1,7,0.143,23,29,0.793,96,46,97,0.474,37,71,0.521,9,26,0.346,15,18,0.833,116,2016-11-18,IND,PHO
8969,69,Home,L 96-99 ,240,36,87,0.414,29,70,0.414,7,17,0.412,17,24,0.708,96,35,78,0.449,25,47,0.532,10,31,0.323,19,27,0.704,99,2016-11-21,DET,HOU
8970,70,Home,W 96-91 ,240,35,75,0.467,27,55,0.491,8,20,0.4,18,25,0.72,96,35,74,0.473,27,47,0.574,8,27,0.296,13,20,0.65,91,2016-11-21,SAS,DAL
8971,71,@,W 96-85 ,240,36,85,0.424,31,65,0.477,5,20,0.25,19,22,0.864,96,34,84,0.405,27,57,0.474,7,27,0.259,10,14,0.714,85,2016-11-23,ATL,IND
8972,72,@,L 96-117 ,240,33,86,0.384,30,69,0.435,3,17,0.176,27,33,0.818,96,45,83,0.542,36,59,0.61,9,24,0.375,18,23,0.783,117,2016-11-23,MIN,NOP
8973,73,Home,L 96-104 ,240,38,92,0.413,31,64,0.484,7,28,0.25,13,17,0.765,96,41,86,0.477,33,62,0.532,8,24,0.333,14,20,0.7,104,2016-11-27,ORL,MIL
8974,74,@,W 96-90 ,240,33,81,0.407,31,73,0.425,2,8,0.25,28,41,0.683,96,32,91,0.352,28,70,0.4,4,21,0.19,22,29,0.759,90,2016-11-30,LAL,CHI
8975,75,Home,L 96-114 ,240,39,85,0.459,34,65,0.523,5,20,0.25,13,21,0.619,96,45,88,0.511,35,64,0.547,10,24,0.417,14,16,0.875,114,2016-12-02,NOP,LAC
8976,76,Home,L 96-97 ,240,30,73,0.411,24,49,0.49,6,24,0.25,30,34,0.882,96,40,93,0.43,32,65,0.492,8,28,0.286,9,14,0.643,97,2016-12-05,MIL,SAS
8977,77,Home,W 96-91 ,240,33,86,0.384,31,69,0.449,2,17,0.118,28,35,0.8,96,32,82,0.39,18,41,0.439,14,41,0.341,13,26,0.5,91,2016-12-06,MEM,PHI
8978,78,@,L 96-99 ,240,40,90,0.444,29,58,0.5,11,32,0.344,5,8,0.625,96,41,83,0.494,38,62,0.613,3,21,0.143,14,27,0.519,99,2016-12-11,BOS,OKC
8979,79,Home,W 96-88 ,240,34,78,0.436,25,50,0.5,9,28,0.321,19,26,0.731,96,32,98,0.327,24,68,0.353,8,30,0.267,16,19,0.842,88,2016-12-16,BOS,CHO
8980,80,@,W 96-92 ,240,31,80,0.388,24,56,0.429,7,24,0.292,27,37,0.73,96,29,77,0.377,24,52,0.462,5,25,0.2,29,36,0.806,92,2016-12-16,SAC,MEM
8981,81,@,W 96-95 ,240,35,83,0.422,28,52,0.538,7,31,0.226,19,23,0.826,96,32,72,0.444,22,45,0.489,10,27,0.37,21,28,0.75,95,2016-12-21,DAL,POR
8982,82,@,L 96-123 ,240,37,79,0.468,30,55,0.545,7,24,0.292,15,18,0.833,96,45,80,0.563,36,55,0.655,9,25,0.36,24,27,0.889,123,2016-12-23,WAS,MIL
8983,83,Home,L 96-116 ,240,33,83,0.398,23,56,0.411,10,27,0.37,20,28,0.714,96,43,76,0.566,34,61,0.557,9,15,0.6,21,27,0.778,116,2016-12-31,CHI,MIL
8984,84,Home,L 96-110 ,240,36,85,0.424,25,56,0.446,11,29,0.379,13,16,0.813,96,41,84,0.488,29,57,0.509,12,27,0.444,16,19,0.842,110,2017-01-09,NYK,NOP
8985,85,@,L 96-105 ,240,39,92,0.424,33,65,0.508,6,27,0.222,12,18,0.667,96,39,76,0.513,30,50,0.6,9,26,0.346,18,26,0.692,105,2017-01-11,ORL,LAC
8986,86,Home,W 96-86 ,240,39,86,0.453,34,68,0.5,5,18,0.278,13,14,0.929,96,33,85,0.388,30,65,0.462,3,20,0.15,17,21,0.81,86,2017-01-13,MIN,OKC
8987,87,@,L 96-112 ,240,34,84,0.405,24,59,0.407,10,25,0.4,18,26,0.692,96,40,87,0.46,32,59,0.542,8,28,0.286,24,31,0.774,112,2017-01-20,MIL,ORL
8988,88,Home,W 96-88 ,240,33,81,0.407,27,55,0.491,6,26,0.231,24,28,0.857,96,36,84,0.429,32,70,0.457,4,14,0.286,12,13,0.923,88,2017-01-26,UTA,LAL
8989,89,@,L 96-104 ,240,37,87,0.425,33,61,0.541,4,26,0.154,18,22,0.818,96,39,82,0.476,28,56,0.5,11,26,0.423,15,23,0.652,104,2017-01-30,BRK,MIA
8990,90,Home,L 96-115 ,240,31,74,0.419,26,55,0.473,5,19,0.263,29,39,0.744,96,39,80,0.488,23,52,0.442,16,28,0.571,21,24,0.875,115,2017-01-30,PHO,MEM
8991,91,@,L 96-113 ,240,36,85,0.424,31,57,0.544,5,28,0.179,19,28,0.679,96,46,99,0.465,41,77,0.532,5,22,0.227,16,17,0.941,113,2017-02-06,PHI,DET
8992,92,Home,L 96-97 ,240,38,83,0.458,26,54,0.481,12,29,0.414,8,15,0.533,96,36,73,0.493,29,49,0.592,7,24,0.292,18,25,0.72,97,2017-02-14,LAL,SAC
8993,93,Home,W 96-83 ,240,36,78,0.462,24,52,0.462,12,26,0.462,12,16,0.75,96,31,77,0.403,26,54,0.481,5,23,0.217,16,25,0.64,83,2017-02-25,DAL,NOP
8994,94,@,L 96-100 ,240,40,83,0.482,35,69,0.507,5,14,0.357,11,16,0.688,96,39,76,0.513,33,56,0.589,6,20,0.3,16,18,0.889,100,2017-02-26,PHO,MIL
8995,95,Home,W 96-89 ,240,33,76,0.434,24,58,0.414,9,18,0.5,21,23,0.913,96,37,83,0.446,28,57,0.491,9,26,0.346,6,13,0.462,89,2017-02-27,DAL,MIA
8996,96,Home,L 96-105 ,240,33,90,0.367,26,70,0.371,7,20,0.35,23,26,0.885,96,40,84,0.476,31,59,0.525,9,25,0.36,16,19,0.842,105,2017-03-01,TOR,WAS
8997,97,Home,L 96-97 ,240,34,77,0.442,25,50,0.5,9,27,0.333,19,31,0.613,96,35,78,0.449,20,45,0.444,15,33,0.455,12,21,0.571,97,2017-03-05,ATL,IND
8998,98,@,L 96-108 ,240,36,83,0.434,30,67,0.448,6,16,0.375,18,21,0.857,96,37,75,0.493,24,45,0.533,13,30,0.433,21,28,0.75,108,2017-03-06,SAC,DEN
8999,99,@,L 95-96 ,240,34,84,0.405,26,61,0.426,8,23,0.348,19,23,0.826,95,38,86,0.442,34,67,0.507,4,19,0.211,16,21,0.762,96,2011-12-26,MIL,CHA
9000,0,@,L 95-104 ,240,36,82,0.439,30,55,0.545,6,27,0.222,17,20,0.85,95,44,83,0.53,35,61,0.574,9,22,0.409,7,10,0.7,104,2011-12-26,HOU,ORL
9001,1,Home,W 95-82 ,240,35,88,0.398,25,55,0.455,10,33,0.303,15,22,0.682,95,34,73,0.466,31,66,0.47,3,7,0.429,11,19,0.579,82,2011-12-26,SAS,MEM
9002,2,@,L 95-98 ,240,28,70,0.4,22,56,0.393,6,14,0.429,33,45,0.733,95,40,94,0.426,38,78,0.487,2,16,0.125,16,20,0.8,98,2011-12-27,MIN,MIL
9003,3,Home,L 95-96 ,240,39,82,0.476,32,64,0.5,7,18,0.389,10,16,0.625,95,36,78,0.462,35,72,0.486,1,6,0.167,23,28,0.821,96,2011-12-28,CHA,MIA
9004,4,Home,L 95-98 ,240,34,87,0.391,32,71,0.451,2,16,0.125,25,33,0.758,95,29,77,0.377,19,52,0.365,10,25,0.4,30,38,0.789,98,2011-12-28,MEM,OKC
9005,5,Home,W 95-84 ,240,38,82,0.463,29,63,0.46,9,19,0.474,10,13,0.769,95,35,80,0.438,31,64,0.484,4,16,0.25,10,16,0.625,84,2011-12-31,HOU,ATL
9006,6,@,L 95-101 ,240,37,80,0.463,28,60,0.467,9,20,0.45,12,19,0.632,95,37,78,0.474,27,61,0.443,10,17,0.588,17,24,0.708,101,2012-01-04,GSW,SAS
9007,7,Home,L 95-98 ,240,38,87,0.437,33,73,0.452,5,14,0.357,14,15,0.933,95,36,85,0.424,29,64,0.453,7,21,0.333,19,22,0.864,98,2012-01-07,HOU,OKC
9008,8,Home,L 95-100 ,240,39,85,0.459,34,73,0.466,5,12,0.417,12,20,0.6,95,34,74,0.459,28,59,0.475,6,15,0.4,26,32,0.813,100,2012-01-10,MEM,OKC
9009,9,Home,W 95-89 (OT),265,36,86,0.419,30,69,0.435,6,17,0.353,17,23,0.739,95,32,81,0.395,27,65,0.415,5,16,0.313,20,34,0.588,89,2012-01-11,LAC,MIA
9010,10,@,W 95-85 ,240,35,73,0.479,28,53,0.528,7,20,0.35,18,26,0.692,95,36,80,0.45,35,64,0.547,1,16,0.063,12,17,0.706,85,2012-01-11,OKC,NOH
9011,11,@,L 95-101 (OT),265,41,96,0.427,38,75,0.507,3,21,0.143,10,12,0.833,95,42,92,0.457,37,76,0.487,5,16,0.313,12,17,0.706,101,2012-01-11,HOU,SAS
9012,12,@,W 95-90 ,240,30,66,0.455,27,58,0.466,3,8,0.375,32,38,0.842,95,33,74,0.446,29,57,0.509,4,17,0.235,20,32,0.625,90,2012-01-13,IND,TOR
9013,13,Home,L 95-105 ,240,35,82,0.427,30,67,0.448,5,15,0.333,20,28,0.714,95,41,94,0.436,32,75,0.427,9,19,0.474,14,19,0.737,105,2012-01-17,CLE,GSW
9014,14,Home,L 95-105 ,240,38,91,0.418,31,68,0.456,7,23,0.304,12,14,0.857,95,32,75,0.427,20,50,0.4,12,25,0.48,29,37,0.784,105,2012-01-17,MIL,DEN
9015,15,Home,W 95-89 ,240,40,85,0.471,34,70,0.486,6,15,0.4,9,15,0.6,95,35,74,0.473,33,63,0.524,2,11,0.182,17,23,0.739,89,2012-01-21,CHI,CHA
9016,16,@,L 95-128 ,240,36,87,0.414,30,68,0.441,6,19,0.316,17,22,0.773,95,50,92,0.543,42,76,0.553,8,16,0.5,20,27,0.741,128,2012-01-21,SAC,MEM
9017,17,@,L 95-110 ,240,37,77,0.481,30,58,0.517,7,19,0.368,14,21,0.667,95,43,75,0.573,36,56,0.643,7,19,0.368,17,23,0.739,110,2012-01-23,BRK,CHI
9018,18,@,W 95-90 ,240,38,80,0.475,33,70,0.471,5,10,0.5,14,21,0.667,95,36,90,0.4,33,77,0.429,3,13,0.231,15,21,0.714,90,2012-01-25,IND,CHI
9019,19,Home,W 95-74 ,240,38,78,0.487,29,63,0.46,9,15,0.6,10,15,0.667,95,29,83,0.349,26,72,0.361,3,11,0.273,13,17,0.765,74,2012-01-28,PHI,DET
9020,20,@,L 95-109 ,240,40,75,0.533,36,62,0.581,4,13,0.308,11,19,0.579,95,43,78,0.551,37,63,0.587,6,15,0.4,17,21,0.81,109,2012-01-30,NOP,MIA
9021,21,@,W 95-86 ,240,33,81,0.407,28,61,0.459,5,20,0.25,24,33,0.727,95,30,84,0.357,26,65,0.4,4,19,0.211,22,25,0.88,86,2012-02-01,OKC,DAL
9022,22,Home,W 95-92 ,240,34,76,0.447,29,59,0.492,5,17,0.294,22,29,0.759,95,40,88,0.455,36,70,0.514,4,18,0.222,8,16,0.5,92,2012-02-02,SAC,POR
9023,23,Home,W 95-89 ,240,34,85,0.4,24,63,0.381,10,22,0.455,17,24,0.708,95,33,75,0.44,24,56,0.429,9,19,0.474,14,19,0.737,89,2012-02-04,PHO,CHA
9024,24,Home,W 95-89 ,240,31,69,0.449,27,57,0.474,4,12,0.333,29,34,0.853,95,34,79,0.43,28,57,0.491,6,22,0.273,15,21,0.714,89,2012-02-05,MIA,TOR
9025,25,Home,W 95-90 ,240,38,81,0.469,30,64,0.469,8,17,0.471,11,17,0.647,95,34,81,0.42,27,57,0.474,7,24,0.292,15,20,0.75,90,2012-02-06,PHI,LAL
9026,26,Home,L 95-105 ,240,33,72,0.458,24,46,0.522,9,26,0.346,20,27,0.741,95,44,90,0.489,35,62,0.565,9,28,0.321,8,9,0.889,105,2012-02-08,DEN,DAL
9027,27,@,W 95-64 ,240,39,90,0.433,33,75,0.44,6,15,0.4,11,20,0.55,95,25,76,0.329,24,68,0.353,1,8,0.125,13,19,0.684,64,2012-02-10,CHI,CHA
9028,28,Home,W 95-91 ,240,37,75,0.493,34,62,0.548,3,13,0.231,18,26,0.692,95,34,88,0.386,28,68,0.412,6,20,0.3,17,24,0.708,91,2012-02-12,BOS,CHI
9029,29,Home,L 95-99 ,240,39,84,0.464,36,71,0.507,3,13,0.231,14,25,0.56,95,36,83,0.434,30,69,0.435,6,14,0.429,21,32,0.656,99,2012-02-14,DET,SAS
9030,30,@,L 95-96 ,240,36,83,0.434,29,60,0.483,7,23,0.304,16,18,0.889,95,37,87,0.425,29,69,0.42,8,18,0.444,14,18,0.778,96,2012-02-15,OKC,HOU
9031,31,@,L 95-103 ,240,33,82,0.402,27,59,0.458,6,23,0.261,23,31,0.742,95,38,86,0.442,31,59,0.525,7,27,0.259,20,28,0.714,103,2012-02-22,DEN,LAC
9032,32,@,L 95-99 ,240,36,89,0.404,32,80,0.4,4,9,0.444,19,22,0.864,95,41,90,0.456,38,72,0.528,3,18,0.167,14,20,0.7,99,2012-02-28,NOP,CHI
9033,33,@,L 95-104 ,240,38,87,0.437,29,63,0.46,9,24,0.375,10,11,0.909,95,44,91,0.484,38,70,0.543,6,21,0.286,10,16,0.625,104,2012-02-29,POR,DEN
9034,34,@,W 95-84 ,240,34,77,0.442,25,62,0.403,9,15,0.6,18,23,0.783,95,30,80,0.375,27,64,0.422,3,16,0.188,21,27,0.778,84,2012-02-29,TOR,NOH
9035,35,Home,L 95-102 ,240,37,90,0.411,31,74,0.419,6,16,0.375,15,19,0.789,95,34,75,0.453,19,39,0.487,15,36,0.417,19,27,0.704,102,2012-02-29,WAS,ORL
9036,36,@,L 95-104 ,240,34,86,0.395,33,73,0.452,1,13,0.077,26,32,0.813,95,42,79,0.532,39,71,0.549,3,8,0.375,17,21,0.81,104,2012-03-01,MIN,PHO
9037,37,Home,W 95-94 ,240,32,80,0.4,21,52,0.404,11,28,0.393,20,27,0.741,95,34,84,0.405,29,61,0.475,5,23,0.217,21,32,0.656,94,2012-03-05,MIN,LAC
9038,38,Home,W 95-91 ,240,29,76,0.382,21,49,0.429,8,27,0.296,29,33,0.879,95,36,84,0.429,27,63,0.429,9,21,0.429,10,10,1.0,91,2012-03-05,OKC,DAL
9039,39,Home,W 95-85 ,240,31,80,0.388,24,54,0.444,7,26,0.269,26,30,0.867,95,32,84,0.381,26,61,0.426,6,23,0.261,15,23,0.652,85,2012-03-06,DAL,NYK
9040,40,@,W 95-89 ,240,39,85,0.459,36,78,0.462,3,7,0.429,14,16,0.875,95,33,80,0.413,28,57,0.491,5,23,0.217,18,25,0.72,89,2012-03-10,NOP,MIN
9041,41,@,L 95-122 ,240,36,88,0.409,29,74,0.392,7,14,0.5,16,19,0.842,95,46,73,0.63,36,50,0.72,10,23,0.435,20,26,0.769,122,2012-03-10,CHA,OKC
9042,42,@,L 95-120 ,240,36,80,0.45,30,61,0.492,6,19,0.316,17,21,0.81,95,46,86,0.535,37,65,0.569,9,21,0.429,19,21,0.905,120,2012-03-16,BOS,SAC
9043,43,Home,W 95-91 ,240,35,86,0.407,29,63,0.46,6,23,0.261,19,27,0.704,95,35,72,0.486,29,52,0.558,6,20,0.3,15,18,0.833,91,2012-03-17,LAC,HOU
9044,44,@,L 95-111 ,240,39,84,0.464,31,63,0.492,8,21,0.381,9,14,0.643,95,41,74,0.554,30,56,0.536,11,18,0.611,18,28,0.643,111,2012-03-18,POR,OKC
9045,45,Home,L 95-112 ,240,36,83,0.434,30,62,0.484,6,21,0.286,17,20,0.85,95,45,84,0.536,35,59,0.593,10,25,0.4,12,15,0.8,112,2012-03-19,DEN,DAL
9046,46,@,L 95-99 ,240,36,80,0.45,30,65,0.462,6,15,0.4,17,24,0.708,95,36,76,0.474,35,67,0.522,1,9,0.111,26,35,0.743,99,2012-03-20,PHO,MIA
9047,47,@,W 95-92 ,240,37,76,0.487,30,53,0.566,7,23,0.304,14,21,0.667,95,38,85,0.447,34,67,0.507,4,18,0.222,12,14,0.857,92,2012-03-24,ATL,WAS
9048,48,Home,L 95-102 ,240,33,79,0.418,29,67,0.433,4,12,0.333,25,35,0.714,95,33,73,0.452,31,61,0.508,2,12,0.167,34,45,0.756,102,2012-03-26,CHA,BOS
9049,49,Home,L 95-109 ,240,34,79,0.43,27,63,0.429,7,16,0.438,20,25,0.8,95,45,79,0.57,39,62,0.629,6,17,0.353,13,16,0.813,109,2012-03-27,POR,OKC
9050,50,Home,L 95-99 ,240,34,82,0.415,29,65,0.446,5,17,0.294,22,28,0.786,95,37,88,0.42,33,73,0.452,4,15,0.267,21,28,0.75,99,2012-03-31,MIL,MEM
9051,51,Home,W 95-90 ,240,37,77,0.481,31,65,0.477,6,12,0.5,15,19,0.789,95,35,74,0.473,31,60,0.517,4,14,0.286,16,22,0.727,90,2012-03-31,PHI,ATL
9052,52,@,L 95-102 ,240,33,72,0.458,23,48,0.479,10,24,0.417,19,24,0.792,95,43,76,0.566,40,65,0.615,3,11,0.273,13,19,0.684,102,2012-04-03,ORL,DET
9053,53,Home,W 95-85 ,240,40,80,0.5,36,65,0.554,4,15,0.267,11,16,0.688,95,35,83,0.422,28,67,0.418,7,16,0.438,8,14,0.571,85,2012-04-04,DAL,MEM
9054,54,Home,W 95-90 ,240,37,91,0.407,32,76,0.421,5,15,0.333,16,24,0.667,95,36,85,0.424,34,73,0.466,2,12,0.167,16,24,0.667,90,2012-04-06,MIL,CHA
9055,55,@,W 95-82 ,240,39,91,0.429,27,60,0.45,12,31,0.387,5,10,0.5,95,31,77,0.403,26,56,0.464,5,21,0.238,15,22,0.682,82,2012-04-12,LAC,MIN
9056,56,@,W 95-89 ,240,34,81,0.42,28,65,0.431,6,16,0.375,21,27,0.778,95,34,81,0.42,33,71,0.465,1,10,0.1,20,27,0.741,89,2012-04-13,BRK,PHI
9057,57,Home,L 95-104 ,240,35,78,0.449,25,53,0.472,10,25,0.4,15,17,0.882,95,36,83,0.434,23,48,0.479,13,35,0.371,19,24,0.792,104,2012-04-18,BRK,NYK
9058,58,@,L 95-106 ,240,40,86,0.465,36,74,0.486,4,12,0.333,11,15,0.733,95,38,84,0.452,34,71,0.479,4,13,0.308,26,37,0.703,106,2012-04-21,BRK,MIL
9059,59,@,L 95-102 ,240,31,70,0.443,26,53,0.491,5,17,0.294,28,32,0.875,95,33,82,0.402,19,44,0.432,14,38,0.368,22,28,0.786,102,2012-04-25,CHA,ORL
9060,60,Home,L 95-99 ,240,35,80,0.438,31,63,0.492,4,17,0.235,21,23,0.913,95,38,80,0.475,32,60,0.533,6,20,0.3,17,26,0.654,99,2012-10-31,NOP,SAS
9061,61,Home,L 95-105 ,240,34,68,0.5,27,52,0.519,7,16,0.438,20,28,0.714,95,38,84,0.452,30,62,0.484,8,22,0.364,21,27,0.778,105,2012-11-02,LAL,LAC
9062,62,@,W 95-85 (OT),265,39,93,0.419,29,69,0.42,10,24,0.417,7,12,0.583,95,34,96,0.354,29,70,0.414,5,26,0.192,12,18,0.667,85,2012-11-03,POR,HOU
9063,63,Home,L 95-104 ,240,33,71,0.465,24,49,0.49,9,22,0.409,20,22,0.909,95,41,83,0.494,33,58,0.569,8,25,0.32,14,20,0.7,104,2012-11-04,OKC,ATL
9064,64,Home,W 95-86 ,240,37,83,0.446,32,66,0.485,5,17,0.294,16,18,0.889,95,25,74,0.338,21,51,0.412,4,23,0.174,32,46,0.696,86,2012-11-07,UTA,LAL
9065,65,@,W 95-89 ,240,37,76,0.487,30,54,0.556,7,22,0.318,14,16,0.875,95,34,81,0.42,25,56,0.446,9,25,0.36,12,16,0.75,89,2012-11-09,MIA,ATL
9066,66,Home,L 95-101 ,240,34,74,0.459,31,65,0.477,3,9,0.333,24,31,0.774,95,41,81,0.506,38,65,0.585,3,16,0.188,16,16,1.0,101,2012-11-12,CHI,BOS
9067,67,@,W 95-87 ,240,35,79,0.443,28,61,0.459,7,18,0.389,18,22,0.818,95,30,83,0.361,24,60,0.4,6,23,0.261,21,26,0.808,87,2012-11-12,ATL,POR
9068,68,@,L 95-105 ,240,37,72,0.514,32,53,0.604,5,19,0.263,16,21,0.762,95,37,76,0.487,32,61,0.525,5,15,0.333,26,32,0.813,105,2012-11-16,NYK,MEM
9069,69,Home,L 95-110 ,240,33,78,0.423,26,66,0.394,7,12,0.583,22,28,0.786,95,40,74,0.541,26,45,0.578,14,29,0.483,16,20,0.8,110,2012-11-16,NOP,OKC
9070,70,Home,L 95-103 ,240,36,96,0.375,28,71,0.394,8,25,0.32,15,20,0.75,95,38,74,0.514,28,51,0.549,10,23,0.435,17,20,0.85,103,2012-11-17,CLE,DAL
9071,71,Home,W 95-90 ,240,35,73,0.479,29,52,0.558,6,21,0.286,19,37,0.514,95,34,82,0.415,27,59,0.458,7,23,0.304,15,21,0.714,90,2012-11-20,LAL,BRK
9072,72,@,L 95-103 ,240,32,78,0.41,29,60,0.483,3,18,0.167,28,37,0.757,95,42,78,0.538,31,53,0.585,11,25,0.44,8,18,0.444,103,2012-11-23,MIN,POR
9073,73,@,W 95-83 ,240,33,82,0.402,23,58,0.397,10,24,0.417,19,29,0.655,95,32,75,0.427,31,68,0.456,1,7,0.143,18,24,0.75,83,2012-11-28,BRK,BOS
9074,74,@,L 95-101 ,240,31,82,0.378,25,60,0.417,6,22,0.273,27,35,0.771,95,37,81,0.457,33,62,0.532,4,19,0.211,23,26,0.885,101,2012-11-28,MIN,LAC
9075,75,Home,W 95-85 ,240,34,87,0.391,26,68,0.382,8,19,0.421,19,27,0.704,95,34,93,0.366,29,75,0.387,5,18,0.278,12,16,0.75,85,2012-11-30,MIN,MIL
9076,76,@,L 95-99 (OT),265,36,99,0.364,32,84,0.381,4,15,0.267,19,22,0.864,95,37,89,0.416,30,60,0.5,7,29,0.241,18,24,0.75,99,2012-12-01,MEM,SAS
9077,77,@,W 95-85 ,240,34,72,0.472,30,57,0.526,4,15,0.267,23,27,0.852,95,31,85,0.365,26,69,0.377,5,16,0.313,18,25,0.72,85,2012-12-05,CHI,CLE
9078,78,@,L 95-104 ,240,36,79,0.456,29,63,0.46,7,16,0.438,16,20,0.8,95,41,85,0.482,31,59,0.525,10,26,0.385,12,19,0.632,104,2012-12-07,WAS,ATL
9079,79,Home,W 95-94 (OT),265,37,99,0.374,35,88,0.398,2,11,0.182,19,26,0.731,95,35,81,0.432,29,59,0.492,6,22,0.273,18,25,0.72,94,2012-12-07,PHI,BOS
9080,80,Home,L 95-97 ,240,38,80,0.475,31,58,0.534,7,22,0.318,12,15,0.8,95,38,82,0.463,29,58,0.5,9,24,0.375,12,14,0.857,97,2012-12-12,MIA,GSW
9081,81,Home,W 95-85 ,240,35,77,0.455,27,63,0.429,8,14,0.571,17,27,0.63,95,35,81,0.432,32,69,0.464,3,12,0.25,12,16,0.75,85,2012-12-14,IND,PHI
9082,82,Home,W 95-74 ,240,34,84,0.405,22,48,0.458,12,36,0.333,15,22,0.682,95,27,69,0.391,27,56,0.482,0,13,0.0,20,23,0.87,74,2012-12-14,TOR,DAL
9083,83,Home,W 95-94 ,240,37,80,0.463,26,51,0.51,11,29,0.379,10,12,0.833,95,36,80,0.45,25,60,0.417,11,20,0.55,11,15,0.733,94,2012-12-16,POR,NOH
9084,84,Home,L 95-100 (OT),265,36,95,0.379,30,77,0.39,6,18,0.333,17,22,0.773,95,34,78,0.436,25,54,0.463,9,24,0.375,23,34,0.676,100,2012-12-18,WAS,ATL
9085,85,Home,L 95-110 ,240,37,96,0.385,34,74,0.459,3,22,0.136,18,21,0.857,95,42,78,0.538,32,50,0.64,10,28,0.357,16,18,0.889,110,2012-12-20,DAL,MIA
9086,86,Home,W 95-92 ,240,33,74,0.446,25,52,0.481,8,22,0.364,21,30,0.7,95,38,88,0.432,30,70,0.429,8,18,0.444,8,10,0.8,92,2012-12-23,BRK,PHI
9087,87,Home,L 95-98 ,240,39,79,0.494,35,69,0.507,4,10,0.4,13,20,0.65,95,35,82,0.427,24,58,0.414,11,24,0.458,17,23,0.739,98,2012-12-29,CHA,NOH
9088,88,@,W 95-86 ,240,41,83,0.494,32,61,0.525,9,22,0.409,4,8,0.5,95,36,82,0.439,26,62,0.419,10,20,0.5,4,12,0.333,86,2013-01-01,ATL,NOH
9089,89,Home,W 95-89 ,240,39,85,0.459,36,72,0.5,3,13,0.231,14,20,0.7,95,37,84,0.44,32,70,0.457,5,14,0.357,10,12,0.833,89,2013-01-02,PHO,PHI
9090,90,Home,W 95-80 ,240,40,92,0.435,37,72,0.514,3,20,0.15,12,20,0.6,95,31,82,0.378,26,64,0.406,5,18,0.278,13,18,0.722,80,2013-01-05,IND,MIL
9091,91,Home,W 95-88 ,240,40,83,0.482,35,70,0.5,5,13,0.385,10,12,0.833,95,33,73,0.452,27,52,0.519,6,21,0.286,16,20,0.8,88,2013-01-07,NOP,SAS
9092,92,@,L 95-103 ,240,36,76,0.474,28,56,0.5,8,20,0.4,15,19,0.789,95,40,72,0.556,31,53,0.585,9,19,0.474,14,23,0.609,103,2013-01-11,UTA,ATL
9093,93,@,L 95-109 ,240,37,87,0.425,33,61,0.541,4,26,0.154,17,17,1.0,95,45,78,0.577,37,57,0.649,8,21,0.381,11,17,0.647,109,2013-01-16,BRK,ATL
9094,94,Home,W 95-94 ,240,41,85,0.482,36,74,0.486,5,11,0.455,8,13,0.615,95,39,86,0.453,31,69,0.449,8,17,0.471,8,11,0.727,94,2013-01-16,SAC,WAS
9095,95,@,L 95-105 ,240,34,83,0.41,21,53,0.396,13,30,0.433,14,16,0.875,95,40,87,0.46,29,68,0.426,11,19,0.579,14,17,0.824,105,2013-01-18,HOU,IND
9096,96,Home,W 95-88 ,240,36,80,0.45,31,58,0.534,5,22,0.227,18,20,0.9,95,36,84,0.429,32,68,0.471,4,16,0.25,12,14,0.857,88,2013-01-18,SAS,GSW
9097,97,Home,W 95-83 ,240,39,93,0.419,30,76,0.395,9,17,0.529,8,12,0.667,95,32,81,0.395,29,64,0.453,3,17,0.176,16,23,0.696,83,2013-01-21,CHI,LAL
9098,98,Home,L 95-98 ,240,37,81,0.457,30,57,0.526,7,24,0.292,14,18,0.778,95,39,84,0.464,31,65,0.477,8,19,0.421,12,17,0.706,98,2013-01-21,POR,WAS
9099,99,Home,W 95-90 ,240,37,82,0.451,35,70,0.5,2,12,0.167,19,22,0.864,95,32,84,0.381,25,67,0.373,7,17,0.412,19,22,0.864,90,2013-01-22,CLE,BOS
9100,0,Home,L 95-105 ,240,37,83,0.446,26,49,0.531,11,34,0.324,10,13,0.769,95,40,86,0.465,32,65,0.492,8,21,0.381,17,25,0.68,105,2013-01-23,HOU,DEN
9101,1,Home,L 95-97 ,240,35,81,0.432,27,63,0.429,8,18,0.444,17,20,0.85,95,39,78,0.5,35,62,0.565,4,16,0.25,15,19,0.789,97,2013-01-24,ORL,TOR
9102,2,Home,L 95-105 ,240,36,86,0.419,28,71,0.394,8,15,0.533,15,21,0.714,95,37,76,0.487,31,53,0.585,6,23,0.261,25,30,0.833,105,2013-01-25,SAC,OKC
9103,3,@,L 95-110 ,240,34,77,0.442,30,60,0.5,4,17,0.235,23,28,0.821,95,45,88,0.511,40,77,0.519,5,11,0.455,15,18,0.833,110,2013-01-27,PHO,DAL
9104,4,Home,L 95-108 ,240,36,84,0.429,32,66,0.485,4,18,0.222,19,25,0.76,95,45,84,0.536,34,68,0.5,11,16,0.688,7,10,0.7,108,2013-01-29,CLE,GSW
9105,5,@,L 95-109 ,240,33,79,0.418,25,60,0.417,8,19,0.421,21,24,0.875,95,42,82,0.512,35,62,0.565,7,20,0.35,18,23,0.783,109,2013-02-02,CHA,HOU
9106,6,@,L 95-122 ,240,37,79,0.468,31,64,0.484,6,15,0.4,15,25,0.6,95,52,92,0.565,43,68,0.632,9,24,0.375,9,13,0.692,122,2013-02-06,CHA,CLE
9107,7,Home,L 95-99 ,240,34,82,0.415,30,64,0.469,4,18,0.222,23,26,0.885,95,35,73,0.479,31,54,0.574,4,19,0.211,25,30,0.833,99,2013-02-06,TOR,BOS
9108,8,@,L 95-116 ,240,36,87,0.414,31,64,0.484,5,23,0.217,18,30,0.6,95,46,87,0.529,41,76,0.539,5,11,0.455,19,25,0.76,116,2013-02-07,LAL,BOS
9109,9,Home,L 95-96 ,240,40,97,0.412,38,86,0.442,2,11,0.182,13,15,0.867,95,38,84,0.452,33,65,0.508,5,19,0.263,15,18,0.833,96,2013-02-13,CLE,SAS
9110,10,@,L 95-110 ,240,35,83,0.422,23,64,0.359,12,19,0.632,13,13,1.0,95,45,89,0.506,39,73,0.534,6,16,0.375,14,15,0.933,110,2013-02-24,SAC,NOH
9111,11,@,W 95-90 ,240,34,82,0.415,27,64,0.422,7,18,0.389,20,26,0.769,95,36,85,0.424,35,68,0.515,1,17,0.059,17,21,0.81,90,2013-02-26,MIL,DAL
9112,12,Home,L 95-96 ,240,40,84,0.476,32,65,0.492,8,19,0.421,7,10,0.7,95,39,72,0.542,30,57,0.526,9,15,0.6,9,16,0.563,96,2013-02-27,WAS,DET
9113,13,@,L 95-100 ,240,39,78,0.5,32,59,0.542,7,19,0.368,10,16,0.625,95,35,81,0.432,28,61,0.459,7,20,0.35,23,31,0.742,100,2013-03-01,DET,NOH
9114,14,@,W 95-94 ,240,31,70,0.443,23,49,0.469,8,21,0.381,25,29,0.862,95,35,86,0.407,25,55,0.455,10,31,0.323,14,14,1.0,94,2013-03-07,OKC,NYK
9115,15,Home,W 95-78 ,240,32,81,0.395,20,54,0.37,12,27,0.444,19,33,0.576,95,32,90,0.356,29,73,0.397,3,17,0.176,11,17,0.647,78,2013-03-08,BRK,WAS
9116,16,Home,W 95-90 ,240,34,83,0.41,26,57,0.456,8,26,0.308,19,25,0.76,95,31,76,0.408,26,59,0.441,5,17,0.294,23,28,0.821,90,2013-03-12,CLE,WAS
9117,17,Home,L 95-113 ,240,34,76,0.447,31,62,0.5,3,14,0.214,24,30,0.8,95,43,83,0.518,35,67,0.522,8,16,0.5,19,22,0.864,113,2013-03-15,GSW,CHI
9118,18,@,L 95-97 ,240,39,85,0.459,34,72,0.472,5,13,0.385,12,16,0.75,95,36,64,0.563,31,49,0.633,5,15,0.333,20,27,0.741,97,2013-03-17,NOP,MIN
9119,19,Home,W 95-73 ,240,34,87,0.391,28,64,0.438,6,23,0.261,21,24,0.875,95,28,88,0.318,25,73,0.342,3,15,0.2,14,21,0.667,73,2013-03-19,IND,ORL
9120,20,@,L 95-102 ,240,36,83,0.434,23,57,0.404,13,26,0.5,10,13,0.769,95,42,87,0.483,33,68,0.485,9,19,0.474,9,13,0.692,102,2013-03-19,POR,MIL
9121,21,Home,L 95-98 ,240,37,81,0.457,30,60,0.5,7,21,0.333,14,17,0.824,95,32,72,0.444,20,43,0.465,12,29,0.414,22,30,0.733,98,2013-03-20,CLE,MIA
9122,22,@,L 95-101 ,240,39,86,0.453,31,58,0.534,8,28,0.286,9,17,0.529,95,37,85,0.435,33,71,0.465,4,14,0.286,23,32,0.719,101,2013-03-23,SAC,DEN
9123,23,@,L 95-101 ,240,34,74,0.459,25,49,0.51,9,25,0.36,18,24,0.75,95,37,79,0.468,28,53,0.528,9,26,0.346,18,24,0.75,101,2013-03-23,BRK,LAC
9124,24,@,L 95-96 ,240,33,78,0.423,23,56,0.411,10,22,0.455,19,21,0.905,95,32,80,0.4,23,54,0.426,9,26,0.346,23,27,0.852,96,2013-03-24,SAS,HOU
9125,25,Home,L 95-105 ,240,33,67,0.493,27,54,0.5,6,13,0.462,23,32,0.719,95,43,86,0.5,39,67,0.582,4,19,0.211,15,18,0.833,105,2013-03-29,POR,UTA
9126,26,Home,W 95-94 ,240,30,76,0.395,22,53,0.415,8,23,0.348,27,40,0.675,95,36,72,0.5,29,56,0.518,7,16,0.438,15,22,0.682,94,2013-03-31,CHI,DET
9127,27,@,W 95-82 ,240,40,77,0.519,33,55,0.6,7,22,0.318,8,12,0.667,95,32,66,0.485,23,40,0.575,9,26,0.346,9,19,0.474,82,2013-04-03,NYK,ATL
9128,28,Home,L 95-113 ,240,34,89,0.382,30,75,0.4,4,14,0.286,23,26,0.885,95,43,76,0.566,33,55,0.6,10,21,0.476,17,22,0.773,113,2013-04-03,CLE,BRK
9129,29,Home,W 95-94 ,240,35,89,0.393,29,72,0.403,6,17,0.353,19,30,0.633,95,41,88,0.466,37,70,0.529,4,18,0.222,8,10,0.8,94,2013-04-04,DEN,DAL
9130,30,@,W 95-93 ,240,40,85,0.471,36,70,0.514,4,15,0.267,11,16,0.688,95,30,67,0.448,27,52,0.519,3,15,0.2,30,40,0.75,93,2013-04-05,TOR,MIN
9131,31,Home,W 95-83 ,240,39,77,0.506,28,51,0.549,11,26,0.423,6,11,0.545,95,32,77,0.416,30,65,0.462,2,12,0.167,17,20,0.85,83,2013-04-05,UTA,NOH
9132,32,@,L 95-109 ,240,33,76,0.434,26,52,0.5,7,24,0.292,22,30,0.733,95,42,84,0.5,34,63,0.54,8,21,0.381,17,21,0.81,109,2013-04-07,LAL,LAC
9133,33,@,W 95-92 ,240,32,80,0.4,28,65,0.431,4,15,0.267,27,29,0.931,95,34,80,0.425,27,59,0.458,7,21,0.333,17,19,0.895,92,2013-04-07,NOP,PHO
9134,34,@,L 95-111 ,240,35,90,0.389,29,67,0.433,6,23,0.261,19,22,0.864,95,44,77,0.571,33,56,0.589,11,21,0.524,12,16,0.75,111,2013-04-10,MIN,LAC
9135,35,Home,W 95-85 ,240,37,80,0.463,33,71,0.465,4,9,0.444,17,24,0.708,95,34,87,0.391,25,58,0.431,9,29,0.31,8,12,0.667,85,2013-04-13,CHA,MIL
9136,36,@,L 95-106 ,240,34,79,0.43,20,42,0.476,14,37,0.378,13,13,1.0,95,43,74,0.581,36,56,0.643,7,18,0.389,13,14,0.929,106,2013-04-15,NYK,CHA
9137,37,Home,L 95-96 ,240,39,86,0.453,34,73,0.466,5,13,0.385,12,19,0.632,95,33,66,0.5,20,38,0.526,13,28,0.464,17,27,0.63,96,2013-04-15,CLE,MIA
9138,38,@,L 95-104 ,240,38,87,0.437,31,60,0.517,7,27,0.259,12,21,0.571,95,42,92,0.457,37,69,0.536,5,23,0.217,15,20,0.75,104,2013-04-15,SAC,OKC
9139,39,Home,W 95-92 ,240,37,78,0.474,30,60,0.5,7,18,0.389,14,19,0.737,95,36,85,0.424,29,69,0.42,7,16,0.438,13,17,0.765,92,2013-04-17,CHI,WAS
9140,40,Home,L 95-105 ,240,36,80,0.45,30,54,0.556,6,26,0.231,17,27,0.63,95,43,85,0.506,35,66,0.53,8,19,0.421,11,14,0.786,105,2013-04-17,IND,PHI
9141,41,@,L 95-99 (OT),265,35,84,0.417,27,51,0.529,8,33,0.242,17,24,0.708,95,33,90,0.367,23,58,0.397,10,32,0.313,23,34,0.676,99,2013-04-17,HOU,LAL
9142,42,@,W 95-89 ,240,36,85,0.424,26,58,0.448,10,27,0.37,13,18,0.722,95,37,89,0.416,34,68,0.5,3,21,0.143,12,14,0.857,89,2013-04-17,MIL,OKC
9143,43,Home,L 95-108 ,240,33,79,0.418,26,61,0.426,7,18,0.389,22,22,1.0,95,42,91,0.462,30,62,0.484,12,29,0.414,12,16,0.75,108,2013-04-17,SAS,MIN
9144,44,@,L 95-107 ,240,35,83,0.422,28,57,0.491,7,26,0.269,18,23,0.783,95,37,72,0.514,26,52,0.5,11,20,0.55,22,29,0.759,107,2013-10-29,CHI,MIA
9145,45,@,W 95-90 ,240,30,70,0.429,20,47,0.426,10,23,0.435,25,30,0.833,95,34,85,0.4,29,74,0.392,5,11,0.455,17,21,0.81,90,2013-10-30,IND,NOP
9146,46,@,L 95-102 ,240,40,88,0.455,33,65,0.508,7,23,0.304,8,14,0.571,95,36,77,0.468,26,54,0.481,10,23,0.435,20,31,0.645,102,2013-11-01,TOR,ATL
9147,47,Home,W 95-88 ,240,36,74,0.486,31,59,0.525,5,15,0.333,18,22,0.818,95,33,70,0.471,26,50,0.52,7,20,0.35,15,18,0.833,88,2013-11-04,MEM,BOS
9148,48,Home,L 95-104 ,240,31,72,0.431,25,51,0.49,6,21,0.286,27,33,0.818,95,41,83,0.494,31,60,0.517,10,23,0.435,12,14,0.857,104,2013-11-05,TOR,MIA
9149,49,Home,W 95-79 ,240,37,76,0.487,31,57,0.544,6,19,0.316,15,18,0.833,95,31,75,0.413,27,67,0.403,4,8,0.5,13,19,0.684,79,2013-11-11,IND,MEM
9150,50,@,L 95-105 ,240,33,75,0.44,24,49,0.49,9,26,0.346,20,29,0.69,95,41,84,0.488,31,58,0.534,10,26,0.385,13,19,0.684,105,2013-11-12,WAS,DAL
9151,51,@,L 95-113 ,240,37,87,0.425,34,69,0.493,3,18,0.167,18,27,0.667,95,42,70,0.6,34,54,0.63,8,16,0.5,21,26,0.808,113,2013-11-12,DET,GSW
9152,52,@,L 95-116 ,240,34,84,0.405,31,74,0.419,3,10,0.3,24,33,0.727,95,44,79,0.557,33,59,0.559,11,20,0.55,17,21,0.81,116,2013-11-12,NOP,LAL
9153,53,@,L 95-118 ,240,33,79,0.418,22,49,0.449,11,30,0.367,18,21,0.857,95,46,79,0.582,34,56,0.607,12,23,0.522,14,24,0.583,118,2013-11-12,MIL,MIA
9154,54,@,W 95-91 ,240,37,88,0.42,25,54,0.463,12,34,0.353,9,13,0.692,95,35,77,0.455,30,53,0.566,5,24,0.208,16,21,0.762,91,2013-11-13,NYK,ATL
9155,55,@,L 95-124 ,240,36,87,0.414,31,71,0.437,5,16,0.313,18,21,0.857,95,45,82,0.549,34,60,0.567,11,22,0.5,23,26,0.885,124,2013-11-13,CLE,MIN
9156,56,Home,W 95-91 ,240,36,81,0.444,31,68,0.456,5,13,0.385,18,30,0.6,95,32,67,0.478,23,48,0.479,9,19,0.474,18,25,0.72,91,2013-11-20,CHA,BRK
9157,57,@,L 95-102 ,240,34,82,0.415,25,60,0.417,9,22,0.409,18,28,0.643,95,39,82,0.476,28,58,0.483,11,24,0.458,13,17,0.765,102,2013-11-22,GSW,LAL
9158,58,@,L 95-98 ,240,32,83,0.386,27,69,0.391,5,14,0.357,26,29,0.897,95,36,88,0.409,24,62,0.387,12,26,0.462,14,15,0.933,98,2013-11-22,CHI,POR
9159,59,Home,W 95-73 ,240,36,71,0.507,31,59,0.525,5,12,0.417,18,22,0.818,95,28,71,0.394,24,53,0.453,4,18,0.222,13,29,0.448,73,2013-11-24,OKC,UTA
9160,60,@,W 95-84 ,240,35,72,0.486,31,53,0.585,4,19,0.211,21,25,0.84,95,29,83,0.349,19,55,0.345,10,28,0.357,16,24,0.667,84,2013-11-27,MIA,CLE
9161,61,@,L 95-97 ,240,34,83,0.41,28,61,0.459,6,22,0.273,21,25,0.84,95,31,71,0.437,22,47,0.468,9,24,0.375,26,34,0.765,97,2013-11-29,NYK,DEN
9162,62,@,L 95-114 ,240,37,89,0.416,31,67,0.463,6,22,0.273,15,23,0.652,95,39,74,0.527,20,42,0.476,19,32,0.594,17,20,0.85,114,2013-11-29,BRK,HOU
9163,63,Home,L 95-97 ,240,35,89,0.393,25,60,0.417,10,29,0.345,15,19,0.789,95,36,83,0.434,29,63,0.46,7,20,0.35,18,20,0.9,97,2013-12-03,SAC,OKC
9164,64,@,W 95-86 ,240,40,84,0.476,37,68,0.544,3,16,0.188,12,15,0.8,95,33,80,0.413,29,69,0.42,4,11,0.364,16,18,0.889,86,2013-12-04,IND,UTA
9165,65,Home,L 95-109 ,240,33,88,0.375,30,72,0.417,3,16,0.188,26,34,0.765,95,39,77,0.506,32,56,0.571,7,21,0.333,24,30,0.8,109,2013-12-06,NOP,OKC
9166,66,Home,L 95-110 ,240,36,85,0.424,29,65,0.446,7,20,0.35,16,22,0.727,95,40,72,0.556,29,44,0.659,11,28,0.393,19,21,0.905,110,2013-12-08,DET,MIA
9167,67,Home,W 95-93 ,240,37,86,0.43,25,58,0.431,12,28,0.429,9,15,0.6,95,37,88,0.42,29,65,0.446,8,23,0.348,11,14,0.786,93,2013-12-11,GSW,DAL
9168,68,Home,W 95-87 ,240,35,78,0.449,27,61,0.443,8,17,0.471,17,24,0.708,95,30,80,0.375,26,65,0.4,4,15,0.267,23,28,0.821,87,2013-12-17,CHA,SAC
9169,69,@,L 95-108 ,240,37,93,0.398,30,73,0.411,7,20,0.35,14,20,0.7,95,33,78,0.423,22,49,0.449,11,29,0.379,31,36,0.861,108,2013-12-18,NOP,LAC
9170,70,@,L 95-107 ,240,29,77,0.377,21,48,0.438,8,29,0.276,29,39,0.744,95,43,84,0.512,34,69,0.493,9,15,0.6,12,14,0.857,107,2013-12-19,CHI,OKC
9171,71,@,W 95-87 ,240,39,82,0.476,38,73,0.521,1,9,0.111,16,19,0.842,95,33,79,0.418,27,57,0.474,6,22,0.273,15,23,0.652,87,2013-12-21,MEM,NYK
9172,72,@,W 95-78 ,240,36,74,0.486,31,57,0.544,5,17,0.294,18,20,0.9,95,25,71,0.352,20,54,0.37,5,17,0.294,23,31,0.742,78,2013-12-25,CHI,BRK
9173,73,Home,L 95-101 ,240,33,79,0.418,19,43,0.442,14,36,0.389,15,26,0.577,95,41,80,0.513,32,53,0.604,9,27,0.333,10,17,0.588,101,2013-12-25,LAL,MIA
9174,74,@,W 95-83 ,240,31,73,0.425,21,45,0.467,10,28,0.357,23,33,0.697,95,30,79,0.38,20,60,0.333,10,19,0.526,13,21,0.619,83,2013-12-27,TOR,NYK
9175,75,Home,L 95-117 ,240,40,89,0.449,35,67,0.522,5,22,0.227,10,17,0.588,95,43,90,0.478,32,66,0.485,11,24,0.458,20,29,0.69,117,2013-12-28,MIL,MIN
9176,76,@,W 95-91 ,240,28,65,0.431,22,50,0.44,6,15,0.4,33,42,0.786,95,35,78,0.449,35,73,0.479,0,5,0.0,21,28,0.75,91,2013-12-30,CHI,MEM
9177,77,Home,W 95-82 ,240,34,78,0.436,27,59,0.458,7,19,0.368,20,23,0.87,95,32,74,0.432,27,60,0.45,5,14,0.357,13,20,0.65,82,2014-01-01,TOR,IND
9178,78,@,W 95-93 ,240,31,70,0.443,22,46,0.478,9,24,0.375,24,31,0.774,95,34,68,0.5,25,46,0.543,9,22,0.409,16,19,0.842,93,2014-01-02,BRK,OKC
9179,79,@,W 95-92 ,240,38,77,0.494,36,71,0.507,2,6,0.333,17,22,0.773,95,31,89,0.348,24,60,0.4,7,29,0.241,23,28,0.821,92,2014-01-03,NOP,BOS
9180,80,Home,L 95-126 ,240,38,80,0.475,30,62,0.484,8,18,0.444,11,16,0.688,95,46,100,0.46,30,74,0.405,16,26,0.615,18,23,0.783,126,2014-01-06,PHI,MIN
9181,81,@,L 95-104 (2OT),290,34,80,0.425,28,57,0.491,6,23,0.261,21,27,0.778,95,40,86,0.465,33,66,0.5,7,20,0.35,17,21,0.81,104,2014-01-10,MIA,BRK
9182,82,Home,L 95-101 ,240,38,87,0.437,31,76,0.408,7,11,0.636,12,17,0.706,95,35,67,0.522,30,55,0.545,5,12,0.417,26,31,0.839,101,2014-01-13,NOP,SAS
9183,83,Home,W 95-92 ,240,39,77,0.506,33,62,0.532,6,15,0.4,11,20,0.55,95,35,88,0.398,30,68,0.441,5,20,0.25,17,26,0.654,92,2014-01-15,PHI,CHA
9184,84,Home,L 95-109 ,240,29,83,0.349,22,60,0.367,7,23,0.304,30,36,0.833,95,33,78,0.423,25,48,0.521,8,30,0.267,35,42,0.833,109,2014-01-17,NYK,LAC
9185,85,@,L 95-100 ,240,39,95,0.411,29,66,0.439,10,29,0.345,7,10,0.7,95,32,65,0.492,23,49,0.469,9,16,0.563,27,33,0.818,100,2014-01-20,TOR,CHA
9186,86,@,W 95-92 ,240,35,77,0.455,30,68,0.441,5,9,0.556,20,23,0.87,95,31,74,0.419,24,55,0.436,7,19,0.368,23,28,0.821,92,2014-01-20,NOP,MEM
9187,87,Home,W 95-91 ,240,39,84,0.464,34,69,0.493,5,15,0.333,12,20,0.6,95,39,90,0.433,33,64,0.516,6,26,0.231,7,9,0.778,91,2014-01-22,CHA,LAC
9188,88,Home,L 95-112 ,240,40,93,0.43,34,74,0.459,6,19,0.316,9,11,0.818,95,41,76,0.539,28,55,0.509,13,21,0.619,17,26,0.654,112,2014-01-24,CHI,LAC
9189,89,Home,L 95-104 ,240,38,89,0.427,32,69,0.464,6,20,0.3,13,16,0.813,95,40,84,0.476,32,64,0.5,8,20,0.4,16,22,0.727,104,2014-01-24,PHI,TOR
9190,90,Home,L 95-101 ,240,34,71,0.479,27,49,0.551,7,22,0.318,20,25,0.8,95,39,86,0.453,33,70,0.471,6,16,0.375,17,23,0.739,101,2014-01-24,PHO,WAS
9191,91,@,W 95-86 ,240,34,73,0.466,29,56,0.518,5,17,0.294,22,26,0.846,95,32,85,0.376,24,61,0.393,8,24,0.333,14,16,0.875,86,2014-01-27,MIN,CHI
9192,92,@,W 95-94 ,240,37,86,0.43,30,65,0.462,7,21,0.333,14,25,0.56,95,32,87,0.368,25,68,0.368,7,19,0.368,23,30,0.767,94,2014-01-29,PHI,BOS
9193,93,Home,L 95-112 ,240,37,72,0.514,34,53,0.642,3,19,0.158,18,22,0.818,95,41,80,0.513,25,53,0.472,16,27,0.593,14,19,0.737,112,2014-01-29,MIA,OKC
9194,94,Home,L 95-120 ,240,35,74,0.473,24,50,0.48,11,24,0.458,14,17,0.824,95,49,77,0.636,44,62,0.71,5,15,0.333,17,20,0.85,120,2014-01-31,BRK,OKC
9195,95,@,W 95-90 ,240,33,88,0.375,23,62,0.371,10,26,0.385,19,24,0.792,95,35,73,0.479,32,64,0.5,3,9,0.333,17,21,0.81,90,2014-01-31,GSW,UTA
9196,96,@,L 95-105 ,240,33,79,0.418,25,56,0.446,8,23,0.348,21,29,0.724,95,39,80,0.488,32,59,0.542,7,21,0.333,20,23,0.87,105,2014-02-01,CHA,PHO
9197,97,Home,W 95-93 ,240,36,75,0.48,30,53,0.566,6,22,0.273,17,26,0.654,95,34,83,0.41,29,69,0.42,5,14,0.357,20,25,0.8,93,2014-02-01,SAS,SAC
9198,98,Home,L 95-102 ,240,36,79,0.456,30,65,0.462,6,14,0.429,17,20,0.85,95,38,81,0.469,33,63,0.524,5,18,0.278,21,25,0.84,102,2014-02-03,NOP,SAS
9199,99,@,L 95-111 ,240,32,89,0.36,20,58,0.345,12,31,0.387,19,29,0.655,95,43,84,0.512,34,67,0.507,9,17,0.529,16,24,0.667,111,2014-02-07,BRK,DET
9200,0,Home,L 95-101 ,240,40,90,0.444,34,75,0.453,6,15,0.4,9,11,0.818,95,42,85,0.494,34,61,0.557,8,24,0.333,9,13,0.692,101,2014-02-08,MIL,HOU
9201,1,Home,L 95-98 ,240,32,85,0.376,25,62,0.403,7,23,0.304,24,27,0.889,95,40,83,0.482,33,69,0.478,7,14,0.5,11,12,0.917,98,2014-02-11,POR,OKC
9202,2,Home,L 95-109 ,240,33,88,0.375,18,56,0.321,15,32,0.469,14,21,0.667,95,37,78,0.474,32,65,0.492,5,13,0.385,30,36,0.833,109,2014-02-23,DEN,SAC
9203,3,Home,L 95-100 ,240,37,103,0.359,33,83,0.398,4,20,0.2,17,26,0.654,95,28,76,0.368,16,45,0.356,12,31,0.387,32,38,0.842,100,2014-02-25,DEN,POR
9204,4,Home,W 95-88 (OT),265,38,90,0.422,31,71,0.437,7,19,0.368,12,17,0.706,95,30,74,0.405,23,54,0.426,7,20,0.35,21,22,0.955,88,2014-03-09,CHI,MIA
9205,5,Home,L 95-96 ,240,33,68,0.485,24,41,0.585,9,27,0.333,20,26,0.769,95,34,78,0.436,22,49,0.449,12,29,0.414,16,19,0.842,96,2014-03-12,MIA,BRK
9206,6,@,L 95-108 ,240,37,80,0.463,31,58,0.534,6,22,0.273,15,28,0.536,95,41,70,0.586,32,49,0.653,9,21,0.429,17,27,0.63,108,2014-03-17,PHO,BRK
9207,7,Home,L 95-102 ,240,36,81,0.444,28,59,0.475,8,22,0.364,15,24,0.625,95,38,89,0.427,28,58,0.483,10,31,0.323,16,20,0.8,102,2014-03-20,CLE,OKC
9208,8,@,L 95-105 ,240,37,73,0.507,29,47,0.617,8,26,0.308,13,17,0.765,95,43,84,0.512,36,67,0.537,7,17,0.412,12,17,0.706,105,2014-03-22,MIA,NOP
9209,9,Home,L 95-102 ,240,30,72,0.417,22,49,0.449,8,23,0.348,27,33,0.818,95,38,74,0.514,26,50,0.52,12,24,0.5,14,16,0.875,102,2014-03-24,ATL,PHO
9210,10,Home,W 95-85 ,240,37,85,0.435,31,68,0.456,6,17,0.353,15,22,0.682,95,32,86,0.372,25,60,0.417,7,26,0.269,14,17,0.824,85,2014-03-25,ORL,POR
9211,11,@,L 95-102 ,240,33,68,0.485,26,47,0.553,7,21,0.333,22,27,0.815,95,36,71,0.507,30,57,0.526,6,14,0.429,24,32,0.75,102,2014-03-28,UTA,NOP
9212,12,@,L 95-103 ,240,36,77,0.468,25,47,0.532,11,30,0.367,12,20,0.6,95,36,84,0.429,29,53,0.547,7,31,0.226,24,30,0.8,103,2014-03-31,PHI,ATL
9213,13,Home,L 95-107 ,240,35,83,0.422,28,55,0.509,7,28,0.25,18,24,0.75,95,44,92,0.478,39,71,0.549,5,21,0.238,14,15,0.933,107,2014-04-04,LAL,DAL
9214,14,Home,L 95-102 ,240,34,89,0.382,25,54,0.463,9,35,0.257,18,24,0.75,95,37,86,0.43,31,69,0.449,6,17,0.353,22,32,0.688,102,2014-04-08,ATL,DET
9215,15,@,W 95-83 ,240,40,72,0.556,31,49,0.633,9,23,0.391,6,11,0.545,95,36,87,0.414,32,63,0.508,4,24,0.167,7,13,0.538,83,2014-04-08,DAL,UTA
9216,16,Home,L 95-112 ,240,35,89,0.393,26,61,0.426,9,28,0.321,16,20,0.8,95,45,92,0.489,32,67,0.478,13,25,0.52,9,13,0.692,112,2014-04-11,LAL,GSW
9217,17,@,L 95-117 ,240,39,88,0.443,33,70,0.471,6,18,0.333,11,17,0.647,95,44,81,0.543,39,68,0.574,5,13,0.385,24,32,0.75,117,2014-04-11,PHI,MEM
9218,18,@,W 95-93 ,240,35,80,0.438,29,55,0.527,6,25,0.24,19,31,0.613,95,34,79,0.43,26,49,0.531,8,30,0.267,17,23,0.739,93,2014-04-14,CHA,ATL
9219,19,@,L 95-108 ,240,36,72,0.5,29,57,0.509,7,15,0.467,16,19,0.842,95,39,77,0.506,34,64,0.531,5,13,0.385,25,32,0.781,108,2014-04-14,ORL,CHI
9220,20,Home,W 95-92 ,240,37,81,0.457,29,64,0.453,8,17,0.471,13,19,0.684,95,36,80,0.45,27,51,0.529,9,29,0.31,11,18,0.611,92,2014-04-16,NYK,TOR
9221,21,@,L 95-107 ,240,36,75,0.48,30,56,0.536,6,19,0.316,17,24,0.708,95,39,81,0.481,30,53,0.566,9,28,0.321,20,23,0.87,107,2014-10-29,WAS,MIA
9222,22,@,W 95-77 ,240,33,75,0.44,27,48,0.563,6,27,0.222,23,32,0.719,95,24,78,0.308,21,60,0.35,3,18,0.167,26,35,0.743,77,2014-10-29,GSW,SAC
9223,23,@,W 95-90 ,240,37,69,0.536,31,57,0.544,6,12,0.5,15,18,0.833,95,32,70,0.457,23,46,0.5,9,24,0.375,17,20,0.85,90,2014-10-30,NYK,CLE
9224,24,Home,L 95-108 ,240,38,81,0.469,31,61,0.508,7,20,0.35,12,24,0.5,95,33,83,0.398,29,62,0.468,4,21,0.19,38,48,0.792,108,2014-11-01,ORL,TOR
9225,25,@,W 95-90 ,240,36,81,0.444,30,62,0.484,6,19,0.316,17,21,0.81,95,37,92,0.402,30,65,0.462,7,27,0.259,9,14,0.643,90,2014-11-02,GSW,POR
9226,26,@,L 95-98 ,240,39,90,0.433,30,70,0.429,9,20,0.45,8,10,0.8,95,32,87,0.368,21,64,0.328,11,23,0.478,23,33,0.697,98,2014-11-05,NYK,DET
9227,27,@,W 95-86 ,240,34,73,0.466,29,57,0.509,5,16,0.313,22,30,0.733,95,33,89,0.371,30,74,0.405,3,15,0.2,17,20,0.85,86,2014-11-05,CHI,MIL
9228,28,@,L 95-98 ,240,36,77,0.468,31,57,0.544,5,20,0.25,18,23,0.783,95,37,75,0.493,26,52,0.5,11,23,0.478,13,24,0.542,98,2014-11-07,MIL,DET
9229,29,@,L 95-107 ,240,33,69,0.478,22,45,0.489,11,24,0.458,18,21,0.857,95,34,79,0.43,22,49,0.449,12,30,0.4,27,33,0.818,107,2014-11-09,GSW,PHO
9230,30,Home,L 95-97 ,240,37,86,0.43,29,63,0.46,8,23,0.348,13,14,0.929,95,33,70,0.471,27,58,0.466,6,12,0.5,25,32,0.781,97,2014-11-12,NYK,ORL
9231,31,Home,L 95-103 ,240,37,86,0.43,29,57,0.509,8,29,0.276,13,14,0.929,95,39,91,0.429,32,75,0.427,7,16,0.438,18,19,0.947,103,2014-11-14,PHO,CHO
9232,32,Home,W 95-88 ,240,32,86,0.372,28,71,0.394,4,15,0.267,27,33,0.818,95,34,82,0.415,24,56,0.429,10,26,0.385,10,17,0.588,88,2014-11-15,MEM,DET
9233,33,@,W 95-83 ,240,31,72,0.431,22,45,0.489,9,27,0.333,24,27,0.889,95,29,70,0.414,20,47,0.426,9,23,0.391,16,26,0.615,83,2014-11-17,MIA,BRK
9234,34,Home,W 95-92 ,240,30,82,0.366,15,36,0.417,15,46,0.326,20,23,0.87,95,35,88,0.398,29,53,0.547,6,35,0.171,16,22,0.727,92,2014-11-22,HOU,DAL
9235,35,Home,L 95-97 ,240,42,86,0.488,39,77,0.506,3,9,0.333,8,10,0.8,95,36,72,0.5,27,52,0.519,9,20,0.45,16,23,0.696,97,2014-11-24,UTA,CHI
9236,36,Home,W 95-93 (OT),265,37,90,0.411,28,71,0.394,9,19,0.474,12,18,0.667,95,36,101,0.356,24,69,0.348,12,32,0.375,9,12,0.75,93,2014-12-03,BRK,SAS
9237,37,Home,L 95-102 ,240,36,90,0.4,34,75,0.453,2,15,0.133,21,23,0.913,95,37,80,0.463,25,52,0.481,12,28,0.429,16,21,0.762,102,2014-12-03,CHA,CHI
9238,38,@,L 95-111 ,240,33,85,0.388,21,56,0.375,12,29,0.414,17,21,0.81,95,45,93,0.484,39,74,0.527,6,19,0.316,15,19,0.789,111,2014-12-03,LAL,WAS
9239,39,@,L 95-100 ,240,34,93,0.366,27,65,0.415,7,28,0.25,20,26,0.769,95,33,81,0.407,22,54,0.407,11,27,0.407,23,31,0.742,100,2014-12-06,PHO,HOU
9240,40,@,L 95-98 ,240,32,70,0.457,25,55,0.455,7,15,0.467,24,37,0.649,95,38,96,0.396,33,71,0.465,5,25,0.2,17,25,0.68,98,2014-12-09,SAC,LAL
9241,41,Home,W 95-79 ,240,38,91,0.418,28,61,0.459,10,30,0.333,9,13,0.692,95,30,72,0.417,24,47,0.511,6,25,0.24,13,22,0.591,79,2014-12-10,ATL,PHI
9242,42,@,L 95-109 ,240,37,76,0.487,31,61,0.508,6,15,0.4,15,17,0.882,95,37,73,0.507,27,54,0.5,10,19,0.526,25,30,0.833,109,2014-12-10,NYK,SAS
9243,43,Home,L 95-101 ,240,37,85,0.435,30,63,0.476,7,22,0.318,14,18,0.778,95,40,81,0.494,34,65,0.523,6,16,0.375,15,18,0.833,101,2014-12-12,BOS,NYK
9244,44,Home,L 95-100 ,240,34,77,0.442,26,49,0.531,8,28,0.286,19,22,0.864,95,36,72,0.5,29,52,0.558,7,20,0.35,21,31,0.677,100,2014-12-12,UTA,MIA
9245,45,@,W 95-85 ,240,40,90,0.444,35,73,0.479,5,17,0.294,10,12,0.833,95,34,88,0.386,30,73,0.411,4,15,0.267,13,16,0.813,85,2014-12-13,POR,IND
9246,46,@,W 95-90 ,240,35,79,0.443,29,59,0.492,6,20,0.3,19,23,0.826,95,33,93,0.355,22,64,0.344,11,29,0.379,13,19,0.684,90,2014-12-13,DET,SAC
9247,47,@,W 95-90 (OT),265,36,78,0.462,27,54,0.5,9,24,0.375,14,18,0.778,95,29,78,0.372,20,49,0.408,9,29,0.31,23,28,0.821,90,2014-12-14,TOR,NYK
9248,48,@,L 95-108 ,240,38,78,0.487,34,67,0.507,4,11,0.364,15,22,0.682,95,41,89,0.461,34,71,0.479,7,18,0.389,19,22,0.864,108,2014-12-15,SAS,POR
9249,49,Home,W 95-82 ,240,37,83,0.446,26,53,0.491,11,30,0.367,10,15,0.667,95,36,74,0.486,32,59,0.542,4,15,0.267,6,8,0.75,82,2014-12-15,TOR,ORL
9250,50,@,W 95-91 ,240,33,72,0.458,24,48,0.5,9,24,0.375,20,26,0.769,95,30,77,0.39,22,49,0.449,8,28,0.286,23,32,0.719,91,2014-12-16,MIA,BRK
9251,51,@,L 95-109 ,240,36,81,0.444,33,73,0.452,3,8,0.375,20,35,0.571,95,43,86,0.5,33,69,0.478,10,17,0.588,13,18,0.722,109,2014-12-16,MIN,WAS
9252,52,Home,W 95-91 ,240,31,77,0.403,22,53,0.415,9,24,0.375,24,29,0.828,95,37,78,0.474,28,54,0.519,9,24,0.375,8,12,0.667,91,2014-12-19,CLE,BRK
9253,53,@,L 95-110 ,240,34,76,0.447,24,49,0.49,10,27,0.37,17,18,0.944,95,41,87,0.471,28,51,0.549,13,36,0.361,15,20,0.75,110,2014-12-22,POR,HOU
9254,54,@,L 95-100 ,240,33,85,0.388,26,62,0.419,7,23,0.304,22,29,0.759,95,39,83,0.47,32,65,0.492,7,18,0.389,15,23,0.652,100,2014-12-23,BOS,ORL
9255,55,Home,L 95-103 ,240,37,72,0.514,31,52,0.596,6,20,0.3,15,21,0.714,95,34,73,0.466,27,57,0.474,7,16,0.438,28,37,0.757,103,2014-12-27,MIA,MEM
9256,56,Home,W 95-87 ,240,35,72,0.486,28,57,0.491,7,15,0.467,18,22,0.818,95,35,78,0.449,30,56,0.536,5,22,0.227,12,17,0.706,87,2014-12-30,MEM,SAS
9257,57,@,L 95-106 ,240,38,77,0.494,33,61,0.541,5,16,0.313,14,18,0.778,95,35,79,0.443,25,61,0.41,10,18,0.556,26,30,0.867,106,2014-12-31,MIA,IND
9258,58,Home,W 95-93 (OT),265,39,89,0.438,33,65,0.508,6,24,0.25,11,18,0.611,95,34,89,0.382,26,61,0.426,8,28,0.286,17,20,0.85,93,2014-12-31,SAS,NOP
9259,59,@,L 95-114 ,240,32,75,0.427,29,60,0.483,3,15,0.2,28,36,0.778,95,45,91,0.495,33,60,0.55,12,31,0.387,12,16,0.75,114,2015-01-04,SAC,DET
9260,60,@,W 95-82 ,240,35,77,0.455,31,61,0.508,4,16,0.25,21,27,0.778,95,31,76,0.408,22,51,0.431,9,25,0.36,11,14,0.786,82,2015-01-04,MIL,NYK
9261,61,Home,L 95-104 ,240,36,91,0.396,29,73,0.397,7,18,0.389,16,23,0.696,95,38,78,0.487,32,59,0.542,6,19,0.316,22,23,0.957,104,2015-01-05,BOS,CHO
9262,62,Home,W 95-92 ,240,38,79,0.481,31,56,0.554,7,23,0.304,12,15,0.8,95,33,85,0.388,22,55,0.4,11,30,0.367,15,22,0.682,92,2015-01-05,PHI,CLE
9263,63,Home,L 95-108 ,240,38,87,0.437,32,65,0.492,6,22,0.273,13,18,0.722,95,43,97,0.443,33,76,0.434,10,21,0.476,12,14,0.857,108,2015-01-07,DAL,DET
9264,64,Home,L 95-103 ,240,33,83,0.398,23,52,0.442,10,31,0.323,19,25,0.76,95,42,88,0.477,38,72,0.528,4,16,0.25,15,22,0.682,103,2015-01-08,TOR,CHO
9265,65,@,L 95-106 ,240,36,82,0.439,30,65,0.462,6,17,0.353,17,22,0.773,95,37,81,0.457,27,61,0.443,10,20,0.5,22,26,0.846,106,2015-01-09,MEM,NOP
9266,66,@,L 95-100 ,240,37,83,0.446,30,57,0.526,7,26,0.269,14,21,0.667,95,38,89,0.427,27,66,0.409,11,23,0.478,13,18,0.722,100,2015-01-09,PHO,SAS
9267,67,Home,W 95-87 ,240,35,88,0.398,31,71,0.437,4,17,0.235,21,24,0.875,95,36,81,0.444,33,70,0.471,3,11,0.273,12,16,0.75,87,2015-01-10,CHI,MIL
9268,68,Home,W 95-79 ,240,28,72,0.389,20,54,0.37,8,18,0.444,31,42,0.738,95,28,68,0.412,20,46,0.435,8,22,0.364,15,20,0.75,79,2015-01-15,MIL,NYK
9269,69,@,W 95-83 ,240,35,74,0.473,27,57,0.474,8,17,0.471,17,21,0.81,95,32,75,0.427,25,59,0.424,7,16,0.438,12,14,0.857,83,2015-01-16,MIA,SAC
9270,70,@,W 95-93 ,240,39,82,0.476,34,65,0.523,5,17,0.294,12,20,0.6,95,31,72,0.431,24,47,0.511,7,25,0.28,24,29,0.828,93,2015-01-18,NOP,TOR
9271,71,Home,L 95-103 ,240,36,85,0.424,33,63,0.524,3,22,0.136,20,22,0.909,95,34,76,0.447,24,51,0.471,10,25,0.4,25,33,0.758,103,2015-01-19,MEM,DAL
9272,72,@,L 95-101 ,240,39,82,0.476,31,65,0.477,8,17,0.471,9,13,0.692,95,35,83,0.422,30,61,0.492,5,22,0.227,26,30,0.867,101,2015-01-25,MIL,SAS
9273,73,Home,L 95-103 ,240,35,83,0.422,27,59,0.458,8,24,0.333,17,23,0.739,95,39,93,0.419,30,59,0.508,9,34,0.265,16,17,0.941,103,2015-01-27,DET,CLE
9274,74,Home,W 95-86 ,240,35,83,0.422,25,54,0.463,10,29,0.345,15,18,0.833,95,34,83,0.41,28,65,0.431,6,18,0.333,12,14,0.857,86,2015-01-28,SAS,CHO
9275,75,Home,W 95-88 ,240,37,82,0.451,29,61,0.475,8,21,0.381,13,14,0.929,95,33,89,0.371,24,58,0.414,9,31,0.29,13,18,0.722,88,2015-01-31,MIL,POR
9276,76,@,W 95-93 ,240,37,89,0.416,31,64,0.484,6,25,0.24,15,17,0.882,95,36,88,0.409,28,67,0.418,8,21,0.381,13,13,1.0,93,2015-02-09,SAS,IND
9277,77,@,L 95-109 ,240,36,84,0.429,29,64,0.453,7,20,0.35,16,19,0.842,95,36,74,0.486,24,52,0.462,12,22,0.545,25,29,0.862,109,2015-02-09,NYK,MIA
9278,78,Home,W 95-86 ,240,36,81,0.444,30,62,0.484,6,19,0.316,17,25,0.68,95,35,81,0.432,32,69,0.464,3,12,0.25,13,17,0.765,86,2015-02-10,MEM,BRK
9279,79,@,L 95-110 ,240,34,87,0.391,25,42,0.595,9,45,0.2,18,22,0.818,95,39,81,0.481,35,59,0.593,4,22,0.182,28,45,0.622,110,2015-02-11,HOU,LAC
9280,80,Home,W 95-93 ,240,31,76,0.408,20,50,0.4,11,26,0.423,22,26,0.846,95,39,85,0.459,34,64,0.531,5,21,0.238,10,16,0.625,93,2015-02-11,TOR,WAS
9281,81,Home,W 95-84 ,240,44,88,0.5,40,70,0.571,4,18,0.222,3,6,0.5,95,29,69,0.42,24,50,0.48,5,19,0.263,21,28,0.75,84,2015-02-20,ORL,NOP
9282,82,Home,L 95-106 ,240,34,84,0.405,26,59,0.441,8,25,0.32,19,29,0.655,95,40,83,0.482,32,61,0.525,8,22,0.364,18,22,0.818,106,2015-02-20,PHI,IND
9283,83,@,L 95-111 ,240,37,85,0.435,29,64,0.453,8,21,0.381,13,14,0.929,95,43,85,0.506,30,59,0.508,13,26,0.5,12,15,0.8,111,2015-02-25,SAS,POR
9284,84,Home,W 95-88 ,240,36,81,0.444,22,50,0.44,14,31,0.452,9,12,0.75,95,36,80,0.45,27,54,0.5,9,26,0.346,7,13,0.538,88,2015-02-27,ATL,ORL
9285,85,@,L 95-99 ,240,38,79,0.481,30,53,0.566,8,26,0.308,11,21,0.524,95,37,78,0.474,30,58,0.517,7,20,0.35,18,25,0.72,99,2015-02-28,DET,WAS
9286,86,@,L 95-106 ,240,35,86,0.407,25,62,0.403,10,24,0.417,15,22,0.682,95,39,86,0.453,27,52,0.519,12,34,0.353,16,20,0.8,106,2015-03-03,MIL,DEN
9287,87,Home,W 95-89 ,240,38,80,0.475,30,57,0.526,8,23,0.348,11,13,0.846,95,32,74,0.432,26,58,0.448,6,16,0.375,19,29,0.655,89,2015-03-07,NOP,MEM
9288,88,@,W 95-88 ,240,34,72,0.472,24,50,0.48,10,22,0.455,17,21,0.81,95,38,76,0.5,30,61,0.492,8,15,0.533,4,11,0.364,88,2015-03-08,UTA,BRK
9289,89,@,W 95-69 ,240,44,85,0.518,42,71,0.592,2,14,0.143,5,5,1.0,95,25,77,0.325,21,55,0.382,4,22,0.182,15,20,0.75,69,2015-03-09,WAS,CHO
9290,90,Home,W 95-92 ,240,37,85,0.435,29,58,0.5,8,27,0.296,13,17,0.765,95,37,78,0.474,32,66,0.485,5,12,0.417,13,13,1.0,92,2015-03-11,BOS,MEM
9291,91,Home,L 95-104 (OT),265,36,104,0.346,25,63,0.397,11,41,0.268,12,25,0.48,95,40,87,0.46,30,63,0.476,10,24,0.417,14,20,0.7,104,2015-03-11,PHI,CHI
9292,92,Home,W 95-88 ,240,37,86,0.43,27,60,0.45,10,26,0.385,11,20,0.55,95,34,80,0.425,28,60,0.467,6,20,0.3,14,28,0.5,88,2015-03-13,BOS,ORL
9293,93,@,L 95-105 ,240,35,80,0.438,25,62,0.403,10,18,0.556,15,17,0.882,95,39,83,0.47,27,50,0.54,12,33,0.364,15,22,0.682,105,2015-03-17,MEM,DET
9294,94,@,L 95-114 ,240,31,87,0.356,23,65,0.354,8,22,0.364,25,30,0.833,95,44,84,0.524,30,54,0.556,14,30,0.467,12,20,0.6,114,2015-03-18,ATL,GSW
9295,95,@,W 95-92 (OT),265,34,83,0.41,32,71,0.451,2,12,0.167,25,30,0.833,95,40,97,0.412,36,77,0.468,4,20,0.2,8,10,0.8,92,2015-03-19,MIN,NYK
9296,96,Home,W 95-92 ,240,35,82,0.427,26,56,0.464,9,26,0.346,16,21,0.762,95,36,84,0.429,28,64,0.438,8,20,0.4,12,13,0.923,92,2015-03-20,CLE,IND
9297,97,Home,L 95-114 ,240,38,80,0.475,26,56,0.464,12,24,0.5,7,7,1.0,95,46,82,0.561,39,65,0.6,7,17,0.412,15,17,0.882,114,2015-03-22,ATL,SAS
9298,98,@,W 95-93 ,240,40,81,0.494,34,59,0.576,6,22,0.273,9,12,0.75,95,34,75,0.453,29,60,0.483,5,15,0.333,20,32,0.625,93,2015-03-25,HOU,NOP
9299,99,@,W 95-83 ,240,39,90,0.433,29,59,0.492,10,31,0.323,7,10,0.7,95,32,78,0.41,29,62,0.468,3,16,0.188,16,20,0.8,83,2015-03-25,ATL,ORL
9300,0,Home,L 95-108 ,240,33,87,0.379,31,72,0.431,2,15,0.133,27,32,0.844,95,42,82,0.512,30,57,0.526,12,25,0.48,12,14,0.857,108,2015-03-28,MIL,GSW
9301,1,@,L 95-105 ,240,40,84,0.476,32,59,0.542,8,25,0.32,7,10,0.7,95,41,83,0.494,30,54,0.556,11,29,0.379,12,17,0.706,105,2015-03-31,ATL,DET
9302,2,@,W 95-81 ,240,37,74,0.5,29,56,0.518,8,18,0.444,13,17,0.765,95,32,79,0.405,27,64,0.422,5,15,0.333,12,12,1.0,81,2015-03-31,SAS,MIA
9303,3,Home,W 95-91 ,240,37,89,0.416,29,68,0.426,8,21,0.381,13,18,0.722,95,31,74,0.419,26,48,0.542,5,26,0.192,24,37,0.649,91,2015-04-01,MIL,CHI
9304,4,Home,L 95-101 ,240,37,78,0.474,31,61,0.508,6,17,0.353,15,25,0.6,95,34,87,0.391,20,58,0.345,14,29,0.483,19,28,0.679,101,2015-04-03,SAC,NOP
9305,5,Home,L 95-101 ,240,38,79,0.481,33,64,0.516,5,15,0.333,14,24,0.583,95,40,87,0.46,32,63,0.508,8,24,0.333,13,18,0.722,101,2015-04-05,SAC,UTA
9306,6,Home,W 95-93 ,240,38,99,0.384,32,72,0.444,6,27,0.222,13,15,0.867,95,35,80,0.438,26,56,0.464,9,24,0.375,14,20,0.7,93,2015-04-14,BOS,TOR
9307,7,@,L 95-99 (2OT),290,37,104,0.356,30,80,0.375,7,24,0.292,14,17,0.824,95,40,105,0.381,31,75,0.413,9,30,0.3,10,17,0.588,99,2015-04-14,WAS,IND
9308,8,Home,W 95-83 ,240,36,76,0.474,34,67,0.507,2,9,0.222,21,26,0.808,95,32,78,0.41,24,54,0.444,8,24,0.333,11,15,0.733,83,2015-04-15,MEM,IND
9309,9,@,L 95-97 ,240,38,94,0.404,29,65,0.446,9,29,0.31,10,17,0.588,95,37,87,0.425,30,68,0.441,7,19,0.368,16,23,0.696,97,2015-10-27,CLE,CHI
9310,10,@,L 95-111 ,240,35,83,0.422,29,65,0.446,6,18,0.333,19,27,0.704,95,41,96,0.427,32,66,0.485,9,30,0.3,20,22,0.909,111,2015-10-27,NOP,GSW
9311,11,@,L 95-112 ,240,34,83,0.41,27,61,0.443,7,22,0.318,20,23,0.87,95,39,85,0.459,31,61,0.508,8,24,0.333,26,27,0.963,112,2015-10-28,PHI,BOS
9312,12,Home,L 95-111 ,240,34,87,0.391,28,63,0.444,6,24,0.25,21,33,0.636,95,40,85,0.471,30,64,0.469,10,21,0.476,21,31,0.677,111,2015-10-28,PHO,DAL
9313,13,@,W 95-78 ,240,30,71,0.423,28,60,0.467,2,11,0.182,33,41,0.805,95,29,95,0.305,24,70,0.343,5,25,0.2,15,20,0.75,78,2015-10-30,MIN,DEN
9314,14,@,W 95-87 ,240,36,83,0.434,31,64,0.484,5,19,0.263,18,25,0.72,95,35,98,0.357,29,69,0.42,6,29,0.207,11,14,0.786,87,2015-11-01,SAS,BOS
9315,15,@,L 95-99 ,240,36,94,0.383,27,67,0.403,9,27,0.333,14,23,0.609,95,33,84,0.393,24,57,0.421,9,27,0.333,24,29,0.828,99,2015-11-08,LAL,NYK
9316,16,@,L 95-109 ,240,40,85,0.471,34,66,0.515,6,19,0.316,9,15,0.6,95,43,91,0.473,31,70,0.443,12,21,0.571,11,13,0.846,109,2015-11-09,DET,GSW
9317,17,Home,L 95-104 ,240,36,80,0.45,27,61,0.443,9,19,0.474,14,19,0.737,95,38,78,0.487,30,52,0.577,8,26,0.308,20,27,0.741,104,2015-11-10,MIN,CHO
9318,18,Home,W 95-93 ,240,35,84,0.417,27,61,0.443,8,23,0.348,17,28,0.607,95,42,86,0.488,38,65,0.585,4,21,0.19,5,7,0.714,93,2015-11-11,CHA,NYK
9319,19,Home,W 95-87 ,240,38,88,0.432,34,70,0.486,4,18,0.222,15,19,0.789,95,32,71,0.451,26,50,0.52,6,21,0.286,17,19,0.895,87,2015-11-15,NYK,NOP
9320,20,@,L 95-96 ,240,35,87,0.402,26,66,0.394,9,21,0.429,16,24,0.667,95,35,86,0.407,29,71,0.408,6,15,0.4,20,32,0.625,96,2015-11-16,IND,CHI
9321,21,Home,L 95-111 ,240,36,85,0.424,25,53,0.472,11,32,0.344,12,23,0.522,95,44,93,0.473,33,57,0.579,11,36,0.306,12,17,0.706,111,2015-11-16,HOU,BOS
9322,22,@,L 95-120 ,240,35,89,0.393,27,70,0.386,8,19,0.421,17,24,0.708,95,51,87,0.586,41,58,0.707,10,29,0.345,8,10,0.8,120,2015-11-20,BRK,BOS
9323,23,Home,L 95-97 ,240,36,79,0.456,28,53,0.528,8,26,0.308,15,21,0.714,95,38,78,0.487,31,59,0.525,7,19,0.368,14,20,0.7,97,2015-11-21,DET,WAS
9324,24,Home,W 95-78 ,240,31,81,0.383,26,62,0.419,5,19,0.263,28,36,0.778,95,28,87,0.322,24,63,0.381,4,24,0.167,18,21,0.857,78,2015-11-23,MIA,NYK
9325,25,@,L 95-100 ,240,32,78,0.41,22,47,0.468,10,31,0.323,21,27,0.778,95,36,78,0.462,33,66,0.5,3,12,0.25,25,27,0.926,100,2015-11-23,PHI,MIN
9326,26,@,L 95-99 ,240,31,82,0.378,23,51,0.451,8,31,0.258,25,35,0.714,95,34,82,0.415,25,61,0.41,9,21,0.429,22,29,0.759,99,2015-11-25,ATL,MIN
9327,27,@,W 95-90 ,240,34,81,0.42,26,56,0.464,8,25,0.32,19,25,0.76,95,33,80,0.413,28,55,0.509,5,25,0.2,19,25,0.76,90,2015-11-27,CLE,CHO
9328,28,Home,L 95-105 ,240,36,75,0.48,31,58,0.534,5,17,0.294,18,24,0.75,95,38,80,0.475,30,60,0.5,8,20,0.4,21,25,0.84,105,2015-11-30,MIA,BOS
9329,29,Home,W 95-70 ,240,37,90,0.411,30,69,0.435,7,21,0.333,14,20,0.7,95,26,78,0.333,23,64,0.359,3,14,0.214,15,18,0.833,70,2015-12-02,SAS,MIL
9330,30,@,L 95-97 ,240,35,79,0.443,31,63,0.492,4,16,0.25,21,24,0.875,95,40,81,0.494,37,68,0.544,3,13,0.231,14,24,0.583,97,2015-12-03,OKC,MIA
9331,31,@,L 95-102 ,240,39,87,0.448,35,69,0.507,4,18,0.222,13,14,0.929,95,34,82,0.415,27,59,0.458,7,23,0.304,27,39,0.692,102,2015-12-04,MIL,DET
9332,32,Home,W 95-93 ,240,36,90,0.4,31,75,0.413,5,15,0.333,18,24,0.75,95,36,82,0.439,27,51,0.529,9,31,0.29,12,17,0.706,93,2015-12-06,MEM,PHO
9333,33,@,L 95-98 ,240,35,88,0.398,28,64,0.438,7,24,0.292,18,30,0.6,95,35,86,0.407,29,64,0.453,6,22,0.273,22,31,0.71,98,2015-12-06,SAC,OKC
9334,34,Home,L 95-98 ,240,36,100,0.36,29,69,0.42,7,31,0.226,16,19,0.842,95,39,81,0.481,33,61,0.541,6,20,0.3,14,18,0.778,98,2015-12-09,DAL,ATL
9335,35,Home,L 95-109 ,240,42,90,0.467,40,80,0.5,2,10,0.2,9,12,0.75,95,38,81,0.469,26,53,0.491,12,28,0.429,21,36,0.583,109,2015-12-09,MIL,LAC
9336,36,Home,L 95-107 ,240,36,80,0.45,30,62,0.484,6,18,0.333,17,24,0.708,95,43,93,0.462,33,66,0.5,10,27,0.37,11,16,0.688,107,2015-12-11,PHI,DET
9337,37,@,L 95-108 ,240,36,89,0.404,30,62,0.484,6,27,0.222,17,25,0.68,95,44,90,0.489,38,76,0.5,6,14,0.429,14,18,0.778,108,2015-12-12,GSW,MIL
9338,38,@,L 95-112 ,240,37,86,0.43,28,62,0.452,9,24,0.375,12,20,0.6,95,44,78,0.564,34,63,0.54,10,15,0.667,14,15,0.933,112,2015-12-14,WAS,MEM
9339,39,@,L 95-113 ,240,40,85,0.471,36,72,0.5,4,13,0.308,11,20,0.55,95,41,89,0.461,31,62,0.5,10,27,0.37,21,25,0.84,113,2015-12-15,MIL,LAL
9340,40,@,L 95-114 ,240,35,84,0.417,32,69,0.464,3,15,0.2,22,25,0.88,95,44,83,0.53,36,61,0.59,8,22,0.364,18,23,0.783,114,2015-12-16,WAS,SAS
9341,41,@,L 95-99 ,240,38,81,0.469,31,58,0.534,7,23,0.304,12,17,0.706,95,39,82,0.476,33,64,0.516,6,18,0.333,15,16,0.938,99,2015-12-18,SAC,MIN
9342,42,Home,L 95-101 ,240,33,74,0.446,25,56,0.446,8,18,0.444,21,24,0.875,95,41,79,0.519,36,63,0.571,5,16,0.313,14,24,0.583,101,2015-12-20,PHO,MIL
9343,43,@,L 95-102 ,240,29,83,0.349,17,42,0.405,12,41,0.293,25,31,0.806,95,33,71,0.465,26,43,0.605,7,28,0.25,29,41,0.707,102,2015-12-21,CHA,HOU
9344,44,@,L 95-101 ,240,39,82,0.476,36,71,0.507,3,11,0.273,14,24,0.583,95,37,72,0.514,32,55,0.582,5,17,0.294,22,28,0.786,101,2015-12-28,MIN,SAS
9345,45,Home,W 95-91 ,240,28,84,0.333,21,58,0.362,7,26,0.269,32,36,0.889,95,36,86,0.419,31,65,0.477,5,21,0.238,14,19,0.737,91,2015-12-28,UTA,PHI
9346,46,@,W 95-89 ,240,35,90,0.389,25,56,0.446,10,34,0.294,15,19,0.789,95,36,82,0.439,29,57,0.509,7,25,0.28,10,15,0.667,89,2015-12-31,LAC,NOP
9347,47,@,W 95-85 ,240,32,75,0.427,24,59,0.407,8,16,0.5,23,28,0.821,95,33,84,0.393,30,70,0.429,3,14,0.214,16,24,0.667,85,2016-01-02,MIL,MIN
9348,48,@,W 95-86 ,240,32,76,0.421,26,54,0.481,6,22,0.273,25,29,0.862,95,32,79,0.405,26,48,0.542,6,31,0.194,16,17,0.941,86,2016-01-06,IND,ORL
9349,49,@,L 95-96 ,240,35,84,0.417,21,40,0.525,14,44,0.318,11,16,0.688,95,37,80,0.463,33,71,0.465,4,9,0.444,18,29,0.621,96,2016-01-08,DAL,MIL
9350,50,Home,L 95-103 ,240,40,92,0.435,34,68,0.5,6,24,0.25,9,13,0.692,95,36,73,0.493,29,55,0.527,7,18,0.389,24,30,0.8,103,2016-01-08,PHO,MIA
9351,51,Home,L 95-108 ,240,39,80,0.488,28,63,0.444,11,17,0.647,6,14,0.429,95,41,75,0.547,36,58,0.621,5,17,0.294,21,27,0.778,108,2016-01-09,PHI,TOR
9352,52,Home,W 95-92 ,240,32,77,0.416,20,50,0.4,12,27,0.444,19,23,0.826,95,30,83,0.361,18,47,0.383,12,36,0.333,20,24,0.833,92,2016-01-10,DEN,CHO
9353,53,@,W 95-85 ,240,35,90,0.389,26,58,0.448,9,32,0.281,16,23,0.696,95,35,77,0.455,29,59,0.492,6,18,0.333,9,19,0.474,85,2016-01-10,CLE,PHI
9354,54,Home,W 95-91 ,240,32,87,0.368,26,58,0.448,6,29,0.207,25,32,0.781,95,38,91,0.418,32,68,0.471,6,23,0.261,9,14,0.643,91,2016-01-12,LAL,NOP
9355,55,@,L 95-99 ,240,38,82,0.463,28,56,0.5,10,26,0.385,9,11,0.818,95,38,83,0.458,33,66,0.5,5,17,0.294,18,22,0.818,99,2016-01-14,CLE,SAS
9356,56,Home,L 95-98 ,240,32,78,0.41,26,60,0.433,6,18,0.333,25,26,0.962,95,40,81,0.494,36,69,0.522,4,12,0.333,14,19,0.737,98,2016-01-15,DEN,MIA
9357,57,@,L 95-113 ,240,34,94,0.362,24,69,0.348,10,25,0.4,17,23,0.739,95,47,101,0.465,39,78,0.5,8,23,0.348,11,20,0.55,113,2016-01-16,GSW,DET
9358,58,@,L 95-103 ,240,35,77,0.455,30,57,0.526,5,20,0.25,20,24,0.833,95,39,82,0.476,34,72,0.472,5,10,0.5,20,26,0.769,103,2016-01-16,NYK,MEM
9359,59,Home,L 95-112 ,240,37,82,0.451,31,63,0.492,6,19,0.316,15,19,0.789,95,44,91,0.484,38,70,0.543,6,21,0.286,18,24,0.75,112,2016-01-17,LAL,HOU
9360,60,@,L 95-109 ,240,34,81,0.42,25,54,0.463,9,27,0.333,18,21,0.857,95,39,83,0.47,30,59,0.508,9,24,0.375,22,30,0.733,109,2016-01-20,CHA,OKC
9361,61,Home,L 95-108 ,240,38,84,0.452,32,68,0.471,6,16,0.375,13,18,0.722,95,43,85,0.506,32,64,0.5,11,21,0.524,11,13,0.846,108,2016-01-22,LAL,SAS
9362,62,@,L 95-98 ,240,34,84,0.405,22,50,0.44,12,34,0.353,15,18,0.833,95,34,85,0.4,24,61,0.393,10,24,0.417,20,26,0.769,98,2016-01-23,ATL,PHO
9363,63,@,W 95-92 ,240,34,75,0.453,23,53,0.434,11,22,0.5,16,33,0.485,95,34,85,0.4,25,56,0.446,9,29,0.31,15,18,0.833,92,2016-01-25,DET,UTA
9364,64,Home,L 95-116 ,240,33,90,0.367,27,72,0.375,6,18,0.333,23,26,0.885,95,42,73,0.575,26,44,0.591,16,29,0.552,16,23,0.696,116,2016-01-31,NYK,GSW
9365,65,Home,L 95-110 ,240,36,88,0.409,26,62,0.419,10,26,0.385,13,21,0.619,95,43,71,0.606,34,55,0.618,9,16,0.563,15,18,0.833,110,2016-02-01,NOP,MEM
9366,66,@,L 95-107 ,240,38,86,0.442,33,72,0.458,5,14,0.357,14,24,0.583,95,39,85,0.459,28,54,0.519,11,31,0.355,18,25,0.72,107,2016-02-02,MIL,POR
9367,67,@,L 95-102 ,240,32,85,0.376,21,51,0.412,11,34,0.324,20,28,0.714,95,42,96,0.438,35,75,0.467,7,21,0.333,11,13,0.846,102,2016-02-03,DET,BOS
9368,68,Home,L 95-98 ,240,36,81,0.444,26,55,0.473,10,26,0.385,13,15,0.867,95,43,94,0.457,43,85,0.506,0,9,0.0,12,18,0.667,98,2016-02-05,CHA,MIA
9369,69,Home,L 95-117 ,240,40,92,0.435,36,74,0.486,4,18,0.222,11,15,0.733,95,45,87,0.517,33,59,0.559,12,28,0.429,15,19,0.789,117,2016-02-10,IND,CHO
9370,70,@,L 95-121 ,240,38,88,0.432,35,72,0.486,3,16,0.188,16,24,0.667,95,45,86,0.523,33,54,0.611,12,32,0.375,19,23,0.826,121,2016-02-11,NOP,OKC
9371,71,@,L 95-106 ,240,37,93,0.398,29,72,0.403,8,21,0.381,13,22,0.591,95,42,91,0.462,35,67,0.522,7,24,0.292,15,17,0.882,106,2016-02-18,CHI,CLE
9372,72,Home,L 95-98 ,240,36,81,0.444,29,62,0.468,7,19,0.368,16,21,0.762,95,37,86,0.43,28,55,0.509,9,31,0.29,15,18,0.833,98,2016-02-19,MIL,CHO
9373,73,Home,L 95-103 ,240,36,84,0.429,31,72,0.431,5,12,0.417,18,25,0.72,95,42,83,0.506,37,66,0.561,5,17,0.294,14,16,0.875,103,2016-02-20,MIN,NYK
9374,74,Home,L 95-122 ,240,37,84,0.44,31,64,0.484,6,20,0.3,15,23,0.652,95,46,87,0.529,35,62,0.565,11,25,0.44,19,25,0.76,122,2016-02-22,NYK,TOR
9375,75,Home,L 95-96 ,240,35,85,0.412,31,66,0.47,4,19,0.211,21,24,0.875,95,36,83,0.434,25,55,0.455,11,28,0.393,13,19,0.684,96,2016-02-26,IND,CHO
9376,76,Home,L 95-112 ,240,32,78,0.41,27,55,0.491,5,23,0.217,26,39,0.667,95,43,85,0.506,30,53,0.566,13,32,0.406,13,15,0.867,112,2016-02-26,LAL,MEM
9377,77,@,L 95-108 ,240,39,93,0.419,33,66,0.5,6,27,0.222,11,16,0.688,95,37,80,0.463,33,64,0.516,4,16,0.25,30,36,0.833,108,2016-02-26,ORL,NYK
9378,78,Home,L 95-103 ,240,39,94,0.415,32,72,0.444,7,22,0.318,10,12,0.833,95,38,87,0.437,33,66,0.5,5,21,0.238,22,27,0.815,103,2016-02-27,CHI,POR
9379,79,@,L 95-100 ,240,38,101,0.376,31,77,0.403,7,24,0.292,12,17,0.706,95,37,84,0.44,31,66,0.47,6,18,0.333,20,29,0.69,100,2016-02-29,UTA,BOS
9380,80,@,L 95-105 ,240,32,77,0.416,24,58,0.414,8,19,0.421,23,33,0.697,95,41,83,0.494,32,60,0.533,9,23,0.391,14,16,0.875,105,2016-02-29,BRK,LAC
9381,81,@,L 95-100 ,240,36,90,0.4,22,53,0.415,14,37,0.378,9,13,0.692,95,36,81,0.444,33,46,0.717,3,35,0.086,25,38,0.658,100,2016-03-02,NOP,HOU
9382,82,@,L 95-112 ,240,37,92,0.402,33,62,0.532,4,30,0.133,17,21,0.81,95,41,87,0.471,32,62,0.516,9,25,0.36,21,22,0.955,112,2016-03-06,GSW,LAL
9383,83,Home,W 95-89 ,240,38,84,0.452,29,56,0.518,9,28,0.321,10,15,0.667,95,33,87,0.379,28,70,0.4,5,17,0.294,18,22,0.818,89,2016-03-11,PHI,BRK
9384,84,Home,W 95-83 ,240,36,84,0.429,25,50,0.5,11,34,0.324,12,17,0.706,95,33,95,0.347,27,72,0.375,6,23,0.261,11,14,0.786,83,2016-03-12,ATL,MEM
9385,85,@,W 95-90 ,240,32,89,0.36,24,59,0.407,8,30,0.267,23,26,0.885,95,31,86,0.36,25,63,0.397,6,23,0.261,22,26,0.846,90,2016-03-18,PHO,LAL
9386,86,@,L 95-104 ,240,39,89,0.438,29,51,0.569,10,38,0.263,7,9,0.778,95,41,89,0.461,33,67,0.493,8,22,0.364,14,19,0.737,104,2016-03-24,CLE,BRK
9387,87,Home,L 95-112 ,240,34,88,0.386,27,59,0.458,7,29,0.241,20,28,0.714,95,43,95,0.453,30,61,0.492,13,34,0.382,13,14,0.929,112,2016-03-26,DET,ATL
9388,88,@,L 95-101 ,240,36,83,0.434,26,56,0.464,10,27,0.37,13,17,0.765,95,40,90,0.444,27,61,0.443,13,29,0.448,8,9,0.889,101,2016-03-31,DEN,NOP
9389,89,Home,L 95-99 ,240,37,91,0.407,30,72,0.417,7,19,0.368,14,17,0.824,95,30,71,0.423,18,43,0.419,12,28,0.429,27,29,0.931,99,2016-04-01,MEM,TOR
9390,90,@,L 95-102 ,240,40,80,0.5,34,62,0.548,6,18,0.333,9,10,0.9,95,35,77,0.455,30,57,0.526,5,20,0.25,27,30,0.9,102,2016-04-02,TOR,SAS
9391,91,Home,W 95-87 ,240,33,76,0.434,21,44,0.477,12,32,0.375,17,21,0.81,95,32,84,0.381,24,63,0.381,8,21,0.381,15,20,0.75,87,2016-04-07,ATL,TOR
9392,92,@,L 95-106 ,240,36,75,0.48,26,52,0.5,10,23,0.435,13,19,0.684,95,33,79,0.418,22,49,0.449,11,30,0.367,29,47,0.617,106,2016-10-31,SAC,ATL
9393,93,Home,L 95-99 ,240,35,87,0.402,26,51,0.51,9,36,0.25,16,21,0.762,95,36,86,0.419,26,56,0.464,10,30,0.333,17,24,0.708,99,2016-11-04,BRK,CHO
9394,94,Home,L 95-105 ,240,34,83,0.41,24,55,0.436,10,28,0.357,17,20,0.85,95,36,80,0.45,24,49,0.49,12,31,0.387,21,26,0.808,105,2016-11-04,DAL,POR
9395,95,Home,W 95-92 ,240,31,80,0.388,26,60,0.433,5,20,0.25,28,35,0.8,95,32,83,0.386,27,58,0.466,5,25,0.2,23,36,0.639,92,2016-11-04,WAS,ATL
9396,96,@,L 95-116 ,240,34,86,0.395,28,58,0.483,6,28,0.214,21,28,0.75,95,43,74,0.581,26,41,0.634,17,33,0.515,13,22,0.591,116,2016-11-09,DAL,GSW
9397,97,Home,L 95-98 ,240,36,88,0.409,23,59,0.39,13,29,0.448,10,15,0.667,95,37,89,0.416,31,73,0.425,6,16,0.375,18,20,0.9,98,2016-11-10,MIA,CHI
9398,98,@,L 95-106 ,240,38,91,0.418,34,78,0.436,4,13,0.308,15,18,0.833,95,39,97,0.402,34,82,0.415,5,15,0.333,23,25,0.92,106,2016-11-12,WAS,CHI
9399,99,Home,L 95-106 ,240,36,84,0.429,27,59,0.458,9,25,0.36,14,19,0.737,95,46,90,0.511,42,72,0.583,4,18,0.222,10,14,0.714,106,2016-11-12,DEN,DET
9400,0,@,L 95-127 ,240,34,77,0.442,24,44,0.545,10,33,0.303,17,22,0.773,95,48,90,0.533,34,65,0.523,14,25,0.56,17,21,0.81,127,2016-11-14,BRK,LAC
9401,1,@,L 95-102 ,240,33,77,0.429,24,47,0.511,9,30,0.3,20,24,0.833,95,36,77,0.468,25,50,0.5,11,27,0.407,19,23,0.826,102,2016-11-19,CHI,LAC
9402,2,Home,W 95-87 ,240,34,78,0.436,26,57,0.456,8,21,0.381,19,22,0.864,95,26,77,0.338,13,49,0.265,13,28,0.464,22,27,0.815,87,2016-11-19,ORL,DAL
9403,3,Home,W 95-68 ,240,35,80,0.438,25,46,0.543,10,34,0.294,15,18,0.833,95,26,83,0.313,18,58,0.31,8,25,0.32,8,12,0.667,68,2016-11-25,UTA,ATL
9404,4,@,L 95-122 ,240,36,86,0.419,22,52,0.423,14,34,0.412,9,13,0.692,95,42,77,0.545,29,58,0.5,13,19,0.684,25,31,0.806,122,2016-11-28,PHI,TOR
9405,5,@,L 95-101 (OT),265,38,93,0.409,35,72,0.486,3,21,0.143,16,26,0.615,95,35,85,0.412,25,60,0.417,10,25,0.4,21,26,0.808,101,2016-11-28,SAC,WAS
9406,6,@,W 95-83 ,240,39,86,0.453,33,71,0.465,6,15,0.4,11,12,0.917,95,28,76,0.368,23,56,0.411,5,20,0.25,22,26,0.846,83,2016-11-29,ORL,SAS
9407,7,Home,W 95-94 ,240,33,79,0.418,26,61,0.426,7,18,0.389,22,28,0.786,95,33,74,0.446,27,50,0.54,6,24,0.25,22,31,0.71,94,2016-12-01,MEM,ORL
9408,8,@,L 95-103 ,240,34,80,0.425,23,53,0.434,11,27,0.407,16,20,0.8,95,43,88,0.489,39,69,0.565,4,19,0.211,13,15,0.867,103,2016-12-07,MIA,ATL
9409,9,@,L 95-134 ,240,34,87,0.391,29,67,0.433,5,20,0.25,22,27,0.815,95,51,94,0.543,36,58,0.621,15,36,0.417,17,21,0.81,134,2016-12-07,LAL,HOU
9410,10,Home,W 95-91 ,240,35,80,0.438,31,63,0.492,4,17,0.235,21,27,0.778,95,39,97,0.402,30,69,0.435,9,28,0.321,4,5,0.8,91,2016-12-08,CHI,SAS
9411,11,@,L 95-114 ,240,33,87,0.379,25,60,0.417,8,27,0.296,21,28,0.75,95,43,80,0.538,35,57,0.614,8,23,0.348,20,27,0.741,114,2016-12-13,OKC,POR
9412,12,@,W 95-85 ,240,36,71,0.507,31,54,0.574,5,17,0.294,18,22,0.818,95,32,78,0.41,24,53,0.453,8,25,0.32,13,16,0.813,85,2016-12-14,DET,DAL
9413,13,Home,W 95-89 ,240,37,82,0.451,30,57,0.526,7,25,0.28,14,25,0.56,95,33,89,0.371,24,62,0.387,9,27,0.333,14,17,0.824,89,2016-12-14,MIA,IND
9414,14,@,L 95-102 ,240,36,87,0.414,33,66,0.5,3,21,0.143,20,24,0.833,95,36,86,0.419,26,59,0.441,10,27,0.37,20,28,0.714,102,2016-12-15,IND,NOP
9415,15,@,W 95-69 ,240,38,82,0.463,28,57,0.491,10,25,0.4,9,13,0.692,95,28,92,0.304,23,71,0.324,5,21,0.238,8,15,0.533,69,2016-12-16,MIL,CHI
9416,16,Home,L 95-105 ,240,36,69,0.522,27,45,0.6,9,24,0.375,14,25,0.56,95,41,90,0.456,32,62,0.516,9,28,0.321,14,19,0.737,105,2016-12-18,MIA,BOS
9417,17,Home,L 95-96 ,240,32,72,0.444,22,45,0.489,10,27,0.37,21,28,0.75,95,35,83,0.422,28,52,0.538,7,31,0.226,19,23,0.826,96,2016-12-21,POR,DAL
9418,18,@,L 95-106 ,240,39,90,0.433,34,63,0.54,5,27,0.185,12,16,0.75,95,41,96,0.427,32,76,0.421,9,20,0.45,15,17,0.882,106,2016-12-22,ORL,NYK
9419,19,@,W 95-91 ,240,32,95,0.337,20,61,0.328,12,34,0.353,19,24,0.792,95,35,83,0.422,27,60,0.45,8,23,0.348,13,18,0.722,91,2016-12-26,TOR,POR
9420,20,@,L 95-118 ,240,32,74,0.432,22,49,0.449,10,25,0.4,21,25,0.84,95,47,83,0.566,36,61,0.59,11,22,0.5,13,14,0.929,118,2016-12-30,BRK,WAS
9421,21,@,W 95-89 ,240,36,73,0.493,30,51,0.588,6,22,0.273,17,28,0.607,95,35,87,0.402,28,64,0.438,7,23,0.304,12,18,0.667,89,2017-01-01,POR,MIN
9422,22,Home,L 95-102 ,240,36,79,0.456,27,50,0.54,9,29,0.31,14,17,0.824,95,38,85,0.447,31,68,0.456,7,17,0.412,19,22,0.864,102,2017-01-05,DAL,PHO
9423,23,Home,L 95-105 ,240,36,78,0.462,26,51,0.51,10,27,0.37,13,17,0.765,95,37,94,0.394,29,67,0.433,8,27,0.296,23,27,0.852,105,2017-01-08,BRK,PHI
9424,24,@,L 95-111 ,240,34,90,0.378,27,64,0.422,7,26,0.269,20,29,0.69,95,42,87,0.483,34,55,0.618,8,32,0.25,19,24,0.792,111,2017-01-08,ORL,LAL
9425,25,@,L 95-107 ,240,38,90,0.422,32,60,0.533,6,30,0.2,13,17,0.765,95,39,86,0.453,28,59,0.475,11,27,0.407,18,22,0.818,107,2017-01-10,MIA,GSW
9426,26,@,L 95-103 ,240,38,92,0.413,31,68,0.456,7,24,0.292,12,21,0.571,95,36,81,0.444,28,55,0.509,8,26,0.308,23,29,0.793,103,2017-01-11,MEM,OKC
9427,27,Home,L 95-104 ,240,40,97,0.412,31,55,0.564,9,42,0.214,6,11,0.545,95,38,90,0.422,27,58,0.466,11,32,0.344,17,25,0.68,104,2017-01-12,BRK,NOP
9428,28,@,L 95-98 ,240,36,83,0.434,26,58,0.448,10,25,0.4,13,18,0.722,95,41,81,0.506,36,62,0.581,5,19,0.263,11,16,0.688,98,2017-01-16,NOP,IND
9429,29,@,L 95-118 ,240,30,78,0.385,24,53,0.453,6,25,0.24,29,37,0.784,95,45,91,0.495,35,66,0.53,10,25,0.4,18,28,0.643,118,2017-01-18,ATL,DET
9430,30,@,L 95-99 ,240,37,82,0.451,23,46,0.5,14,36,0.389,7,11,0.636,95,35,73,0.479,26,53,0.491,9,20,0.45,20,29,0.69,99,2017-01-19,DAL,MIA
9431,31,@,L 95-108 ,240,34,80,0.425,25,57,0.439,9,23,0.391,18,25,0.72,95,41,87,0.471,27,54,0.5,14,33,0.424,12,15,0.8,108,2017-01-20,IND,LAL
9432,32,Home,L 95-119 ,240,33,89,0.371,24,55,0.436,9,34,0.265,20,28,0.714,95,41,80,0.513,25,38,0.658,16,42,0.381,21,25,0.84,119,2017-01-21,MEM,HOU
9433,33,Home,L 95-97 ,240,36,84,0.429,31,63,0.492,5,21,0.238,18,26,0.692,95,36,83,0.434,30,63,0.476,6,20,0.3,19,25,0.76,97,2017-01-23,UTA,OKC
9434,34,@,L 95-103 ,240,39,92,0.424,32,69,0.464,7,23,0.304,10,12,0.833,95,39,83,0.47,33,57,0.579,6,26,0.231,19,24,0.792,103,2017-01-25,NYK,DAL
9435,35,Home,L 95-102 ,240,29,62,0.468,19,37,0.514,10,25,0.4,27,29,0.931,95,41,80,0.513,30,54,0.556,11,26,0.423,9,10,0.9,102,2017-01-28,UTA,MEM
9436,36,@,W 95-90 ,240,35,99,0.354,29,72,0.403,6,27,0.222,19,31,0.613,95,37,88,0.42,32,63,0.508,5,25,0.2,11,16,0.688,90,2017-02-01,NYK,BRK
9437,37,@,L 95-113 ,240,35,77,0.455,29,55,0.527,6,22,0.273,19,26,0.731,95,40,86,0.465,30,60,0.5,10,26,0.385,23,28,0.821,113,2017-02-01,PHI,DAL
9438,38,Home,L 95-103 ,240,32,76,0.421,19,42,0.452,13,34,0.382,18,21,0.857,95,40,87,0.46,35,68,0.515,5,19,0.263,18,20,0.9,103,2017-02-05,BRK,TOR
9439,39,Home,L 95-120 ,240,33,74,0.446,27,57,0.474,6,17,0.353,23,32,0.719,95,49,80,0.613,39,54,0.722,10,26,0.385,12,18,0.667,120,2017-02-06,ATL,UTA
9440,40,Home,L 95-107 ,240,37,85,0.435,29,59,0.492,8,26,0.308,13,14,0.929,95,39,87,0.448,26,47,0.553,13,40,0.325,16,20,0.8,107,2017-02-09,CHA,HOU
9441,41,@,W 95-91 ,240,37,75,0.493,29,57,0.509,8,18,0.444,13,22,0.591,95,33,89,0.371,27,56,0.482,6,33,0.182,19,25,0.76,91,2017-02-15,NOP,MEM
9442,42,Home,L 95-109 ,240,32,74,0.432,25,56,0.446,7,18,0.389,24,29,0.828,95,37,74,0.5,29,51,0.569,8,23,0.348,27,30,0.9,109,2017-02-24,MIL,UTA
9443,43,@,L 95-112 ,240,38,94,0.404,30,66,0.455,8,28,0.286,11,17,0.647,95,42,100,0.42,31,69,0.449,11,31,0.355,17,22,0.773,112,2017-02-25,BRK,GSW
9444,44,@,L 95-113 ,240,34,85,0.4,30,73,0.411,4,12,0.333,23,26,0.885,95,38,78,0.487,25,47,0.532,13,31,0.419,24,31,0.774,113,2017-02-25,IND,MIA
9445,45,@,L 95-102 ,240,37,83,0.446,26,53,0.491,11,30,0.367,10,16,0.625,95,35,70,0.5,25,42,0.595,10,28,0.357,22,26,0.846,102,2017-02-27,MIL,CLE
9446,46,@,L 95-100 ,240,35,77,0.455,21,44,0.477,14,33,0.424,11,13,0.846,95,36,64,0.563,26,43,0.605,10,21,0.476,18,24,0.75,100,2017-03-01,DAL,ATL
9447,47,Home,L 95-115 ,240,37,87,0.425,31,63,0.492,6,24,0.25,15,20,0.75,95,43,84,0.512,33,51,0.647,10,33,0.303,19,25,0.76,115,2017-03-03,LAL,BOS
9448,48,@,L 95-109 ,240,34,83,0.41,26,55,0.473,8,28,0.286,19,21,0.905,95,45,92,0.489,39,71,0.549,6,21,0.286,13,20,0.65,109,2017-03-06,CHI,DET
9449,49,Home,L 94-105 ,240,31,82,0.378,22,54,0.407,9,28,0.321,23,30,0.767,94,38,78,0.487,34,71,0.479,4,7,0.571,25,36,0.694,105,2011-12-25,DAL,MIA
9450,50,Home,W 94-78 ,240,36,81,0.444,27,60,0.45,9,21,0.429,13,25,0.52,94,29,77,0.377,23,60,0.383,6,17,0.353,14,21,0.667,78,2011-12-29,ORL,NJN
9451,51,@,W 94-86 ,240,37,74,0.5,32,62,0.516,5,12,0.417,15,23,0.652,94,32,78,0.41,30,62,0.484,2,16,0.125,20,23,0.87,86,2012-01-01,BOS,WAS
9452,52,Home,L 94-108 ,240,33,89,0.371,26,61,0.426,7,28,0.25,21,26,0.808,94,41,78,0.526,28,57,0.491,13,21,0.619,13,18,0.722,108,2012-01-02,BRK,IND
9453,53,Home,W 94-90 ,240,37,76,0.487,32,61,0.525,5,15,0.333,15,23,0.652,94,37,74,0.5,34,64,0.531,3,10,0.3,13,16,0.813,90,2012-01-02,UTA,NOH
9454,54,@,L 94-109 ,240,36,78,0.462,33,65,0.508,3,13,0.231,19,27,0.704,94,42,80,0.525,36,66,0.545,6,14,0.429,19,25,0.76,109,2012-01-06,HOU,OKC
9455,55,Home,W 94-85 ,240,36,71,0.507,34,63,0.54,2,8,0.25,20,30,0.667,94,33,80,0.413,29,63,0.46,4,17,0.235,15,21,0.714,85,2012-01-06,UTA,MEM
9456,56,@,L 94-109 ,240,36,82,0.439,30,68,0.441,6,14,0.429,16,20,0.8,94,47,83,0.566,38,71,0.535,9,12,0.75,6,6,1.0,109,2012-01-07,CHI,ATL
9457,57,@,W 94-81 ,240,39,75,0.52,33,65,0.508,6,10,0.6,10,14,0.714,94,29,71,0.408,21,48,0.438,8,23,0.348,15,21,0.714,81,2012-01-09,NOP,DEN
9458,58,Home,W 94-83 ,240,34,75,0.453,28,63,0.444,6,12,0.5,20,30,0.667,94,31,83,0.373,20,57,0.351,11,26,0.423,10,11,0.909,83,2012-01-12,MEM,NYK
9459,59,@,L 94-102 ,240,35,77,0.455,30,65,0.462,5,12,0.417,19,25,0.76,94,35,85,0.412,26,64,0.406,9,21,0.429,23,30,0.767,102,2012-01-14,LAL,LAC
9460,60,@,L 94-107 ,240,32,74,0.432,23,47,0.489,9,27,0.333,21,27,0.778,94,42,81,0.519,39,73,0.534,3,8,0.375,20,26,0.769,107,2012-01-14,BRK,UTA
9461,61,Home,L 94-102 ,240,38,86,0.442,34,69,0.493,4,17,0.235,14,26,0.538,94,39,80,0.488,35,65,0.538,4,15,0.267,20,29,0.69,102,2012-01-16,CHA,CLE
9462,62,Home,W 94-82 ,240,37,84,0.44,26,61,0.426,11,23,0.478,9,13,0.692,94,35,75,0.467,32,61,0.525,3,14,0.214,9,14,0.643,82,2012-01-16,PHI,MIL
9463,63,@,W 94-91 ,240,37,71,0.521,32,51,0.627,5,20,0.25,15,19,0.789,94,31,80,0.388,28,68,0.412,3,12,0.25,26,29,0.897,91,2012-01-19,DAL,UTA
9464,64,@,W 94-91 ,240,35,83,0.422,27,67,0.403,8,16,0.5,16,21,0.762,94,37,80,0.463,27,57,0.474,10,23,0.435,7,8,0.875,91,2012-01-20,IND,GSW
9465,65,@,W 94-84 ,240,33,82,0.402,28,67,0.418,5,15,0.333,23,31,0.742,94,30,82,0.366,25,67,0.373,5,15,0.333,19,25,0.76,84,2012-01-20,POR,TOR
9466,66,@,L 94-121 ,240,34,70,0.486,27,50,0.54,7,20,0.35,19,27,0.704,94,46,83,0.554,35,59,0.593,11,24,0.458,18,24,0.75,121,2012-01-21,CLE,ATL
9467,67,Home,W 94-91 ,240,30,67,0.448,23,52,0.442,7,15,0.467,27,32,0.844,94,34,81,0.42,31,61,0.508,3,20,0.15,20,24,0.833,91,2012-01-21,DET,POR
9468,68,Home,L 94-100 ,240,37,77,0.481,35,62,0.565,2,15,0.133,18,21,0.857,94,37,72,0.514,32,60,0.533,5,12,0.417,21,30,0.7,100,2012-01-22,WAS,BOS
9469,69,Home,W 94-87 ,240,38,83,0.458,32,69,0.464,6,14,0.429,12,14,0.857,94,28,80,0.35,27,61,0.443,1,19,0.053,30,31,0.968,87,2012-01-27,BOS,IND
9470,70,@,W 94-73 ,240,35,68,0.515,32,54,0.593,3,14,0.214,21,29,0.724,94,27,74,0.365,20,52,0.385,7,22,0.318,12,18,0.667,73,2012-01-29,TOR,NJN
9471,71,@,W 94-72 ,240,36,81,0.444,24,58,0.414,12,23,0.522,10,17,0.588,94,27,73,0.37,24,63,0.381,3,10,0.3,15,19,0.789,72,2012-01-29,ATL,NOH
9472,72,@,L 94-101 ,240,37,87,0.425,33,74,0.446,4,13,0.308,16,20,0.8,94,34,71,0.479,27,54,0.5,7,17,0.412,26,33,0.788,101,2012-02-03,MEM,OKC
9473,73,@,L 94-102 ,240,33,90,0.367,26,72,0.361,7,18,0.389,21,27,0.778,94,34,80,0.425,25,54,0.463,9,26,0.346,25,36,0.694,102,2012-02-03,CLE,ORL
9474,74,Home,W 94-84 ,240,41,81,0.506,37,58,0.638,4,23,0.174,8,8,1.0,94,32,71,0.451,28,55,0.509,4,16,0.25,16,20,0.8,84,2012-02-07,BOS,CHA
9475,75,@,W 94-86 ,240,35,68,0.515,31,51,0.608,4,17,0.235,20,25,0.8,94,33,75,0.44,30,59,0.508,3,16,0.188,17,25,0.68,86,2012-02-10,POR,NOH
9476,76,@,L 94-97 (2OT),290,36,97,0.371,33,77,0.429,3,20,0.15,19,21,0.905,94,39,84,0.464,33,65,0.508,6,19,0.316,13,19,0.684,97,2012-02-11,POR,DAL
9477,77,Home,L 94-99 ,240,39,93,0.419,30,71,0.423,9,22,0.409,7,7,1.0,94,35,81,0.432,20,44,0.455,15,37,0.405,14,21,0.667,99,2012-02-11,MIL,ORL
9478,78,@,W 94-92 ,240,35,81,0.432,25,58,0.431,10,23,0.435,14,20,0.7,94,37,78,0.474,31,67,0.463,6,11,0.545,12,17,0.706,92,2012-02-12,LAL,TOR
9479,79,Home,W 94-85 ,240,33,76,0.434,24,47,0.511,9,29,0.31,19,26,0.731,94,33,90,0.367,27,69,0.391,6,21,0.286,13,17,0.765,85,2012-02-17,ORL,MIL
9480,80,@,L 94-109 ,240,36,82,0.439,33,73,0.452,3,9,0.333,19,29,0.655,94,42,84,0.5,41,74,0.554,1,10,0.1,24,32,0.75,109,2012-02-29,CHA,DET
9481,81,@,L 94-99 ,240,32,85,0.376,26,67,0.388,6,18,0.333,24,28,0.857,94,39,86,0.453,31,63,0.492,8,23,0.348,13,15,0.867,99,2012-03-02,MIL,ATL
9482,82,@,L 94-107 ,240,34,76,0.447,29,57,0.509,5,19,0.263,21,28,0.75,94,45,87,0.517,41,71,0.577,4,16,0.25,13,17,0.765,107,2012-03-02,BRK,BOS
9483,83,Home,L 94-99 ,240,32,72,0.444,22,45,0.489,10,27,0.37,20,27,0.741,94,36,86,0.419,30,69,0.435,6,17,0.353,21,28,0.75,99,2012-03-04,SAS,DEN
9484,84,@,L 94-95 ,240,34,84,0.405,29,61,0.475,5,23,0.217,21,32,0.656,94,32,80,0.4,21,52,0.404,11,28,0.393,20,27,0.741,95,2012-03-05,LAC,MIN
9485,85,@,L 94-106 ,240,44,93,0.473,41,70,0.586,3,23,0.13,3,4,0.75,94,37,78,0.474,24,55,0.436,13,23,0.565,19,26,0.731,106,2012-03-07,POR,MIN
9486,86,Home,L 94-99 ,240,35,86,0.407,30,64,0.469,5,22,0.227,19,26,0.731,94,32,76,0.421,21,50,0.42,11,26,0.423,24,31,0.774,99,2012-03-08,CHI,ORL
9487,87,@,L 94-96 ,240,38,87,0.437,30,65,0.462,8,22,0.364,10,13,0.769,94,37,76,0.487,34,62,0.548,3,14,0.214,19,27,0.704,96,2012-03-08,DAL,PHO
9488,88,@,W 94-91 ,240,37,73,0.507,32,58,0.552,5,15,0.333,15,23,0.652,94,32,79,0.405,28,70,0.4,4,9,0.444,23,30,0.767,91,2012-03-11,MEM,DEN
9489,89,@,L 94-97 ,240,39,83,0.47,33,66,0.5,6,17,0.353,10,12,0.833,94,36,71,0.507,28,55,0.509,8,16,0.5,17,26,0.654,97,2012-03-11,BOS,LAL
9490,90,Home,L 94-106 ,240,33,80,0.413,26,63,0.413,7,17,0.412,21,26,0.808,94,40,79,0.506,35,70,0.5,5,9,0.556,21,26,0.808,106,2012-03-11,NYK,PHI
9491,91,@,L 94-107 ,240,39,82,0.476,38,70,0.543,1,12,0.083,15,18,0.833,94,37,79,0.468,27,52,0.519,10,27,0.37,23,30,0.767,107,2012-03-11,IND,ORL
9492,92,@,W 94-85 ,240,33,67,0.493,28,54,0.519,5,13,0.385,23,27,0.852,94,31,83,0.373,26,60,0.433,5,23,0.217,18,21,0.857,85,2012-03-12,BOS,LAC
9493,93,@,L 94-111 ,240,40,76,0.526,34,63,0.54,6,13,0.462,8,10,0.8,94,43,76,0.566,36,59,0.61,7,17,0.412,18,22,0.818,111,2012-03-14,PHI,IND
9494,94,Home,L 94-102 ,240,36,86,0.419,26,63,0.413,10,23,0.435,12,14,0.857,94,41,81,0.506,33,65,0.508,8,16,0.5,12,13,0.923,102,2012-03-17,BRK,NOH
9495,95,@,W 94-82 ,240,36,82,0.439,29,66,0.439,7,16,0.438,15,23,0.652,94,35,85,0.412,34,77,0.442,1,8,0.125,11,11,1.0,82,2012-03-21,CHI,TOR
9496,96,Home,W 94-82 ,240,36,77,0.468,32,62,0.516,4,15,0.267,18,21,0.857,94,32,82,0.39,29,72,0.403,3,10,0.3,15,24,0.625,82,2012-03-28,BOS,UTA
9497,97,@,W 94-75 ,240,39,83,0.47,28,51,0.549,11,32,0.344,5,12,0.417,94,30,77,0.39,25,54,0.463,5,23,0.217,10,17,0.588,75,2012-04-02,LAC,DAL
9498,98,@,W 94-88 ,240,34,87,0.391,30,71,0.423,4,16,0.25,22,24,0.917,94,33,73,0.452,28,52,0.538,5,21,0.238,17,24,0.708,88,2012-04-02,MEM,OKC
9499,99,@,L 94-98 ,240,38,82,0.463,31,64,0.484,7,18,0.389,11,16,0.688,94,37,80,0.463,28,63,0.444,9,17,0.529,15,24,0.625,98,2012-04-03,GSW,MEM
9500,0,Home,L 94-97 ,240,37,87,0.425,28,56,0.5,9,31,0.29,11,16,0.688,94,41,86,0.477,37,70,0.529,4,16,0.25,11,16,0.688,97,2012-04-04,MIN,GSW
9501,1,Home,W 94-92 ,240,35,67,0.522,30,57,0.526,5,10,0.5,19,27,0.704,94,35,83,0.422,29,63,0.46,6,20,0.3,16,22,0.727,92,2012-04-04,NOP,DEN
9502,2,@,L 94-99 ,240,33,78,0.423,26,57,0.456,7,21,0.333,21,29,0.724,94,36,68,0.529,32,58,0.552,4,10,0.4,23,39,0.59,99,2012-04-05,WAS,DET
9503,3,@,L 94-109 ,240,34,82,0.415,27,60,0.45,7,22,0.318,19,28,0.679,94,44,89,0.494,33,62,0.532,11,27,0.407,10,19,0.526,109,2012-04-07,SAC,LAC
9504,4,Home,W 94-89 ,240,31,80,0.388,22,60,0.367,9,20,0.45,23,27,0.852,94,34,73,0.466,25,52,0.481,9,21,0.429,12,17,0.706,89,2012-04-07,MEM,DAL
9505,5,@,L 94-116 ,240,34,78,0.436,28,56,0.5,6,22,0.273,20,23,0.87,94,47,94,0.5,35,69,0.507,12,25,0.48,10,11,0.909,116,2012-04-07,POR,MIL
9506,6,Home,W 94-85 ,240,37,74,0.5,33,61,0.541,4,13,0.308,16,20,0.8,94,34,84,0.405,30,66,0.455,4,18,0.222,13,18,0.722,85,2012-04-09,MEM,LAC
9507,7,@,W 94-89 ,240,37,80,0.463,27,61,0.443,10,19,0.526,10,13,0.769,94,33,83,0.398,27,62,0.435,6,21,0.286,17,19,0.895,89,2012-04-09,HOU,POR
9508,8,Home,L 94-97 ,240,35,83,0.422,29,58,0.5,6,25,0.24,18,23,0.783,94,40,83,0.482,31,63,0.492,9,20,0.45,8,10,0.8,97,2012-04-13,POR,DAL
9509,9,@,W 94-82 ,240,37,81,0.457,32,67,0.478,5,14,0.357,15,22,0.682,94,32,87,0.368,26,65,0.4,6,22,0.273,12,14,0.857,82,2012-04-14,BOS,NJN
9510,10,@,W 94-82 ,240,39,80,0.488,34,65,0.523,5,15,0.333,11,17,0.647,94,32,79,0.405,29,66,0.439,3,13,0.231,15,20,0.75,82,2012-04-15,BOS,CHA
9511,11,Home,L 94-100 (OT),265,33,84,0.393,27,69,0.391,6,15,0.4,22,28,0.786,94,39,91,0.429,34,74,0.459,5,17,0.294,17,23,0.739,100,2012-04-15,DET,CHI
9512,12,@,L 94-104 ,240,37,83,0.446,28,64,0.438,9,19,0.474,11,21,0.524,94,38,81,0.469,35,62,0.565,3,19,0.158,25,26,0.962,104,2012-04-20,GSW,DAL
9513,13,@,L 94-96 ,240,36,80,0.45,30,55,0.545,6,25,0.24,16,19,0.842,94,35,83,0.422,29,64,0.453,6,19,0.316,20,27,0.741,96,2012-04-26,POR,UTA
9514,14,Home,W 94-84 ,240,36,79,0.456,29,59,0.492,7,20,0.35,15,22,0.682,94,32,90,0.356,24,58,0.414,8,32,0.25,12,20,0.6,84,2012-10-30,CLE,WAS
9515,15,@,L 94-113 ,240,32,85,0.376,21,63,0.333,11,22,0.5,19,26,0.731,94,38,89,0.427,32,75,0.427,6,14,0.429,31,42,0.738,113,2012-10-31,DAL,UTA
9516,16,Home,L 94-104 ,240,36,80,0.45,26,60,0.433,10,20,0.5,12,17,0.706,94,35,77,0.455,29,64,0.453,6,13,0.462,28,34,0.824,104,2012-11-02,GSW,MEM
9517,17,@,L 94-115 ,240,39,91,0.429,34,72,0.472,5,19,0.263,11,18,0.611,94,45,92,0.489,36,81,0.444,9,11,0.818,16,19,0.842,115,2012-11-04,PHO,ORL
9518,18,@,L 94-103 ,240,40,90,0.444,35,75,0.467,5,15,0.333,9,13,0.692,94,38,91,0.418,33,77,0.429,5,14,0.357,22,25,0.88,103,2012-11-05,UTA,MEM
9519,19,Home,W 94-92 ,240,37,81,0.457,33,62,0.532,4,19,0.211,16,23,0.696,94,31,78,0.397,25,57,0.439,6,21,0.286,24,28,0.857,92,2012-11-05,SAC,GSW
9520,20,@,L 94-100 (OT),265,39,95,0.411,29,66,0.439,10,29,0.345,6,7,0.857,94,34,81,0.42,30,68,0.441,4,13,0.308,28,34,0.824,100,2012-11-07,WAS,BOS
9521,21,@,L 94-96 ,240,37,84,0.44,32,66,0.485,5,18,0.278,15,17,0.882,94,35,70,0.5,33,61,0.541,2,9,0.222,24,28,0.857,96,2012-11-09,IND,MIN
9522,22,@,L 94-104 ,240,33,81,0.407,25,53,0.472,8,28,0.286,20,23,0.87,94,35,84,0.417,27,62,0.435,8,22,0.364,26,38,0.684,104,2012-11-09,DAL,NYK
9523,23,@,L 94-105 ,240,36,87,0.414,30,68,0.441,6,19,0.316,16,22,0.727,94,38,71,0.535,30,51,0.588,8,20,0.4,21,26,0.808,105,2012-11-09,DET,OKC
9524,24,Home,W 94-81 ,240,38,78,0.487,36,64,0.563,2,14,0.143,16,24,0.667,94,32,87,0.368,28,71,0.394,4,16,0.25,13,17,0.765,81,2012-11-10,UTA,PHO
9525,25,@,W 94-76 ,240,35,73,0.479,32,66,0.485,3,7,0.429,21,31,0.677,94,25,84,0.298,20,68,0.294,5,16,0.313,21,32,0.656,76,2012-11-14,DET,PHI
9526,26,@,W 94-87 ,240,31,80,0.388,29,66,0.439,2,14,0.143,30,34,0.882,94,32,85,0.376,28,72,0.389,4,13,0.308,19,28,0.679,87,2012-11-17,MEM,CHA
9527,27,@,L 94-102 ,240,37,75,0.493,33,59,0.559,4,16,0.25,16,18,0.889,94,39,79,0.494,30,57,0.526,9,22,0.409,15,20,0.75,102,2012-11-18,CHI,POR
9528,28,Home,L 94-101 ,240,34,89,0.382,24,61,0.393,10,28,0.357,16,25,0.64,94,35,79,0.443,26,58,0.448,9,21,0.429,22,26,0.846,101,2012-11-21,MIN,DEN
9529,29,Home,W 94-91 ,240,36,90,0.4,24,58,0.414,12,32,0.375,10,15,0.667,94,30,76,0.395,18,52,0.346,12,24,0.5,19,23,0.826,91,2012-11-28,ATL,CHA
9530,30,@,L 94-106 ,240,38,92,0.413,31,69,0.449,7,23,0.304,11,12,0.917,94,39,75,0.52,35,66,0.53,4,9,0.444,24,33,0.727,106,2012-11-30,UTA,OKC
9531,31,Home,L 94-102 ,240,37,81,0.457,30,64,0.469,7,17,0.412,13,18,0.722,94,40,92,0.435,32,69,0.464,8,23,0.348,14,16,0.875,102,2012-12-03,GSW,ORL
9532,32,@,L 94-104 ,240,37,84,0.44,31,65,0.477,6,19,0.316,14,30,0.467,94,41,78,0.526,37,61,0.607,4,17,0.235,18,26,0.692,104,2012-12-05,MIN,BOS
9533,33,Home,L 94-97 ,240,34,85,0.4,26,64,0.406,8,21,0.381,18,25,0.72,94,37,78,0.474,33,66,0.5,4,12,0.333,19,24,0.792,97,2012-12-06,PHO,DAL
9534,34,@,L 94-95 (OT),265,35,81,0.432,29,59,0.492,6,22,0.273,18,25,0.72,94,37,99,0.374,35,88,0.398,2,11,0.182,19,26,0.731,95,2012-12-07,BOS,PHI
9535,35,@,W 94-89 ,240,37,80,0.463,33,69,0.478,4,11,0.364,16,23,0.696,94,35,87,0.402,25,67,0.373,10,20,0.5,9,12,0.75,89,2012-12-11,LAC,CHI
9536,36,@,L 94-100 ,240,31,75,0.413,24,48,0.5,7,27,0.259,25,40,0.625,94,37,84,0.44,26,57,0.456,11,27,0.407,15,26,0.577,100,2012-12-11,LAL,CLE
9537,37,Home,L 94-101 ,240,34,81,0.42,29,68,0.426,5,13,0.385,21,31,0.677,94,37,80,0.463,31,63,0.492,6,17,0.353,21,34,0.618,101,2012-12-11,DET,DEN
9538,38,Home,L 94-100 ,240,35,82,0.427,30,66,0.455,5,16,0.313,19,24,0.792,94,37,85,0.435,28,62,0.452,9,23,0.391,17,25,0.68,100,2012-12-12,CHA,LAC
9539,39,@,W 94-88 ,240,29,64,0.453,19,45,0.422,10,19,0.526,26,35,0.743,94,37,75,0.493,33,57,0.579,4,18,0.222,10,17,0.588,88,2012-12-12,BRK,TOR
9540,40,@,L 94-99 ,240,39,94,0.415,32,75,0.427,7,19,0.368,9,10,0.9,94,36,69,0.522,32,59,0.542,4,10,0.4,23,26,0.885,99,2012-12-14,MEM,DEN
9541,41,@,L 94-95 ,240,36,80,0.45,25,60,0.417,11,20,0.55,11,15,0.733,94,37,80,0.463,26,51,0.51,11,29,0.379,10,12,0.833,95,2012-12-16,NOP,POR
9542,42,Home,L 94-99 (OT),265,36,94,0.383,31,70,0.443,5,24,0.208,17,20,0.85,94,36,83,0.434,31,67,0.463,5,16,0.313,22,36,0.611,99,2012-12-21,BOS,MIL
9543,43,@,L 94-99 ,240,39,86,0.453,37,70,0.529,2,16,0.125,14,16,0.875,94,39,76,0.513,35,58,0.603,4,18,0.222,17,23,0.739,99,2012-12-21,NOP,SAS
9544,44,@,W 94-82 ,240,38,88,0.432,33,71,0.465,5,17,0.294,13,16,0.813,94,31,79,0.392,27,59,0.458,4,20,0.2,16,23,0.696,82,2012-12-22,CLE,MIL
9545,45,Home,W 94-91 ,240,32,72,0.444,26,46,0.565,6,26,0.231,24,28,0.857,94,34,84,0.405,27,62,0.435,7,22,0.318,16,18,0.889,91,2012-12-23,NYK,MIN
9546,46,@,L 94-100 ,240,38,89,0.427,29,63,0.46,9,26,0.346,9,16,0.563,94,37,77,0.481,32,56,0.571,5,21,0.238,21,31,0.677,100,2012-12-25,NYK,LAL
9547,47,Home,L 94-97 ,240,36,79,0.456,25,49,0.51,11,30,0.367,11,13,0.846,94,38,76,0.5,36,64,0.563,2,12,0.167,19,20,0.95,97,2012-12-26,ORL,NOH
9548,48,@,W 94-83 ,240,33,82,0.402,24,64,0.375,9,18,0.5,19,20,0.95,94,32,83,0.386,28,66,0.424,4,17,0.235,15,22,0.682,83,2012-12-26,GSW,UTA
9549,49,Home,L 94-102 ,240,36,86,0.419,28,65,0.431,8,21,0.381,14,14,1.0,94,38,78,0.487,25,54,0.463,13,24,0.542,13,16,0.813,102,2012-12-28,CLE,ATL
9550,50,Home,L 94-124 ,240,33,83,0.398,25,53,0.472,8,30,0.267,20,27,0.741,94,45,94,0.479,32,65,0.492,13,29,0.448,21,23,0.913,124,2012-12-29,HOU,OKC
9551,51,@,L 94-96 ,240,36,77,0.468,26,54,0.481,10,23,0.435,12,17,0.706,94,39,82,0.476,33,64,0.516,6,18,0.333,12,15,0.8,96,2012-12-30,MIL,DET
9552,52,Home,L 94-103 ,240,32,79,0.405,22,53,0.415,10,26,0.385,20,26,0.769,94,41,82,0.5,31,60,0.517,10,22,0.455,11,17,0.647,103,2013-01-01,WAS,DAL
9553,53,Home,L 94-97 ,240,34,87,0.391,29,66,0.439,5,21,0.238,21,24,0.875,94,38,88,0.432,35,72,0.486,3,16,0.188,18,23,0.783,97,2013-01-02,CLE,SAC
9554,54,@,L 94-115 ,240,29,80,0.363,21,51,0.412,8,29,0.276,28,39,0.718,94,42,84,0.5,30,61,0.492,12,23,0.522,19,22,0.864,115,2013-01-02,LAC,GSW
9555,55,Home,L 94-96 ,240,37,78,0.474,28,54,0.519,9,24,0.375,11,14,0.786,94,36,77,0.468,31,65,0.477,5,12,0.417,19,25,0.76,96,2013-01-02,ORL,CHI
9556,56,Home,W 94-75 ,240,40,89,0.449,36,80,0.45,4,9,0.444,10,18,0.556,94,27,85,0.318,23,68,0.338,4,17,0.235,17,28,0.607,75,2013-01-04,BOS,IND
9557,57,@,L 94-100 ,240,35,81,0.432,29,62,0.468,6,19,0.316,18,20,0.9,94,31,78,0.397,21,59,0.356,10,19,0.526,28,36,0.778,100,2013-01-07,DAL,UTA
9558,58,@,W 94-87 ,240,40,88,0.455,38,71,0.535,2,17,0.118,12,16,0.75,94,33,71,0.465,26,54,0.481,7,17,0.412,14,20,0.7,87,2013-01-09,MEM,GSW
9559,59,@,L 94-95 ,240,39,86,0.453,31,69,0.449,8,17,0.471,8,11,0.727,94,41,85,0.482,36,74,0.486,5,11,0.455,8,13,0.615,95,2013-01-16,WAS,SAC
9560,60,Home,L 94-98 ,240,34,89,0.382,30,75,0.4,4,14,0.286,22,29,0.759,94,39,92,0.424,33,76,0.434,6,16,0.375,14,20,0.7,98,2013-01-17,PHO,MIL
9561,61,Home,W 94-89 ,240,30,74,0.405,21,48,0.438,9,26,0.346,25,38,0.658,94,35,80,0.438,26,59,0.441,9,21,0.429,10,14,0.714,89,2013-01-18,BRK,ATL
9562,62,Home,W 94-87 ,240,34,93,0.366,29,72,0.403,5,21,0.238,21,31,0.677,94,32,77,0.416,24,57,0.421,8,20,0.4,15,27,0.556,87,2013-01-19,LAC,WAS
9563,63,Home,L 94-100 ,240,34,81,0.42,28,66,0.424,6,15,0.4,20,24,0.833,94,29,74,0.392,19,45,0.422,10,29,0.345,32,41,0.78,100,2013-01-21,CHA,HOU
9564,64,Home,L 94-96 ,240,37,77,0.481,34,66,0.515,3,11,0.273,17,21,0.81,94,36,82,0.439,27,59,0.458,9,23,0.391,15,25,0.6,96,2013-01-28,WAS,SAC
9565,65,@,L 94-99 ,240,34,80,0.425,26,55,0.473,8,25,0.32,18,20,0.9,94,41,81,0.506,40,69,0.58,1,12,0.083,16,24,0.667,99,2013-02-04,CHA,MIA
9566,66,Home,L 94-104 ,240,33,81,0.407,25,63,0.397,8,18,0.444,20,23,0.87,94,37,81,0.457,27,56,0.482,10,25,0.4,20,21,0.952,104,2013-02-06,MIN,SAS
9567,67,Home,L 94-100 ,240,37,80,0.463,36,67,0.537,1,13,0.077,19,27,0.704,94,38,81,0.469,30,55,0.545,8,26,0.308,16,20,0.8,100,2013-02-08,MIN,NYK
9568,68,Home,W 94-91 ,240,33,77,0.429,25,59,0.424,8,18,0.444,20,30,0.667,94,32,77,0.416,26,63,0.413,6,14,0.429,21,26,0.808,91,2013-02-11,CHA,BOS
9569,69,@,L 94-109 ,240,38,68,0.559,33,53,0.623,5,15,0.333,13,23,0.565,94,42,87,0.483,35,68,0.515,7,19,0.368,18,22,0.818,109,2013-02-12,OKC,UTA
9570,70,Home,W 94-92 ,240,37,88,0.42,33,70,0.471,4,18,0.222,16,21,0.762,94,34,76,0.447,30,63,0.476,4,13,0.308,20,24,0.833,92,2013-02-13,MIL,PHI
9571,71,Home,L 94-97 ,240,35,75,0.467,29,61,0.475,6,14,0.429,18,31,0.581,94,34,85,0.4,25,59,0.424,9,26,0.346,20,26,0.769,97,2013-02-20,MIL,BRK
9572,72,Home,W 94-87 ,240,28,70,0.4,23,57,0.404,5,13,0.385,33,44,0.75,94,31,81,0.383,27,68,0.397,4,13,0.308,21,32,0.656,87,2013-02-20,MIN,PHI
9573,73,@,L 94-107 ,240,35,84,0.417,34,69,0.493,1,15,0.067,23,28,0.821,94,40,78,0.513,32,58,0.552,8,20,0.4,19,24,0.792,107,2013-02-23,UTA,LAC
9574,74,Home,L 94-118 ,240,38,79,0.481,34,65,0.523,4,14,0.286,14,22,0.636,94,43,87,0.494,34,66,0.515,9,21,0.429,23,28,0.821,118,2013-02-23,ORL,CLE
9575,75,@,L 94-116 ,240,37,81,0.457,30,60,0.5,7,21,0.333,13,15,0.867,94,44,83,0.53,28,51,0.549,16,32,0.5,12,21,0.571,116,2013-02-28,MIN,LAL
9576,76,Home,W 94-86 ,240,36,75,0.48,33,60,0.55,3,15,0.2,19,28,0.679,94,32,94,0.34,27,71,0.38,5,23,0.217,17,22,0.773,86,2013-03-01,BOS,GSW
9577,77,@,L 94-109 ,240,34,87,0.391,33,75,0.44,1,12,0.083,25,36,0.694,94,44,90,0.489,37,70,0.529,7,20,0.35,14,22,0.636,109,2013-03-02,MIN,POR
9578,78,Home,L 94-95 ,240,35,86,0.407,25,55,0.455,10,31,0.323,14,14,1.0,94,31,70,0.443,23,49,0.469,8,21,0.381,25,29,0.862,95,2013-03-07,NYK,OKC
9579,79,Home,L 94-116 ,240,35,85,0.412,28,62,0.452,7,23,0.304,17,25,0.68,94,46,81,0.568,34,57,0.596,12,24,0.5,12,16,0.75,116,2013-03-08,CHA,OKC
9580,80,@,W 94-88 ,240,27,74,0.365,12,39,0.308,15,35,0.429,25,34,0.735,94,33,87,0.379,24,66,0.364,9,21,0.429,13,20,0.65,88,2013-03-08,HOU,GSW
9581,81,@,L 94-117 ,240,34,79,0.43,23,51,0.451,11,28,0.393,15,22,0.682,94,41,84,0.488,32,63,0.508,9,21,0.429,26,37,0.703,117,2013-03-13,NYK,DEN
9582,82,Home,L 94-98 ,240,40,85,0.471,33,67,0.493,7,18,0.389,7,12,0.583,94,35,75,0.467,30,55,0.545,5,20,0.25,23,27,0.852,98,2013-03-13,PHI,MIA
9583,83,@,L 94-107 ,240,35,79,0.443,32,60,0.533,3,19,0.158,21,31,0.677,94,41,84,0.488,29,61,0.475,12,23,0.522,13,16,0.813,107,2013-03-15,PHO,ATL
9584,84,Home,L 94-107 ,240,33,89,0.371,24,64,0.375,9,25,0.36,19,21,0.905,94,41,79,0.519,34,64,0.531,7,15,0.467,18,22,0.818,107,2013-03-15,MIL,MIA
9585,85,@,L 94-106 ,240,38,79,0.481,33,62,0.532,5,17,0.294,13,18,0.722,94,40,76,0.526,25,42,0.595,15,34,0.441,11,16,0.688,106,2013-03-20,ORL,NYK
9586,86,@,L 94-104 ,240,32,77,0.416,27,60,0.45,5,17,0.294,25,27,0.926,94,38,82,0.463,32,63,0.508,6,19,0.316,22,28,0.786,104,2013-03-22,BOS,DAL
9587,87,Home,L 94-99 ,240,36,79,0.456,25,47,0.532,11,32,0.344,11,14,0.786,94,38,71,0.535,28,49,0.571,10,22,0.455,13,24,0.542,99,2013-03-22,TOR,NYK
9588,88,@,L 94-100 ,240,36,80,0.45,29,59,0.492,7,21,0.333,15,25,0.6,94,40,84,0.476,32,61,0.525,8,23,0.348,12,15,0.8,100,2013-03-25,ATL,IND
9589,89,Home,L 94-108 ,240,37,86,0.43,28,62,0.452,9,24,0.375,11,18,0.611,94,37,78,0.474,22,50,0.44,15,28,0.536,19,29,0.655,108,2013-03-25,ORL,MIA
9590,90,@,L 94-107 ,240,34,77,0.442,28,61,0.459,6,16,0.375,20,22,0.909,94,36,72,0.5,31,59,0.525,5,13,0.385,30,44,0.682,107,2013-03-25,MEM,WAS
9591,91,@,L 94-103 ,240,34,81,0.42,25,54,0.463,9,27,0.333,17,21,0.81,94,40,79,0.506,36,68,0.529,4,11,0.364,19,21,0.905,103,2013-03-29,HOU,MEM
9592,92,@,L 94-95 ,240,36,72,0.5,29,56,0.518,7,16,0.438,15,22,0.682,94,30,76,0.395,22,53,0.415,8,23,0.348,27,40,0.675,95,2013-03-31,DET,CHI
9593,93,@,L 94-102 ,240,41,81,0.506,38,69,0.551,3,12,0.25,9,15,0.6,94,37,81,0.457,28,51,0.549,9,30,0.3,19,26,0.731,102,2013-04-01,CLE,ATL
9594,94,@,W 94-76 ,240,34,67,0.507,30,55,0.545,4,12,0.333,22,28,0.786,94,33,80,0.413,29,51,0.569,4,29,0.138,6,10,0.6,76,2013-04-03,MEM,POR
9595,95,@,L 94-95 ,240,41,88,0.466,37,70,0.529,4,18,0.222,8,10,0.8,94,35,89,0.393,29,72,0.403,6,17,0.353,19,30,0.633,95,2013-04-04,DAL,DEN
9596,96,@,L 94-99 ,240,39,85,0.459,36,75,0.48,3,10,0.3,13,15,0.867,94,32,79,0.405,28,63,0.444,4,16,0.25,31,46,0.674,99,2013-04-09,CLE,IND
9597,97,Home,W 94-75 ,240,39,82,0.476,36,69,0.522,3,13,0.231,13,20,0.65,94,30,80,0.375,28,66,0.424,2,14,0.143,13,18,0.722,75,2013-04-09,MEM,CHA
9598,98,Home,W 94-83 ,240,38,88,0.432,30,53,0.566,8,35,0.229,10,10,1.0,94,33,75,0.44,24,50,0.48,9,25,0.36,8,14,0.571,83,2013-04-09,MIA,MIL
9599,99,@,L 94-98 ,240,33,82,0.402,24,58,0.414,9,24,0.375,19,24,0.792,94,35,84,0.417,30,69,0.435,5,15,0.333,23,34,0.676,98,2013-10-30,BRK,CLE
9600,0,@,L 94-125 ,240,35,89,0.393,27,71,0.38,8,18,0.444,16,21,0.762,94,46,86,0.535,31,59,0.525,15,27,0.556,18,23,0.783,125,2013-10-30,LAL,GSW
9601,1,@,L 94-101 ,240,39,93,0.419,31,78,0.397,8,15,0.533,8,15,0.533,94,40,76,0.526,29,56,0.518,11,20,0.55,10,16,0.625,101,2013-10-30,MEM,SAS
9602,2,Home,L 94-102 ,240,35,83,0.422,26,64,0.406,9,19,0.474,15,20,0.75,94,40,86,0.465,36,70,0.514,4,16,0.25,18,20,0.9,102,2013-11-05,DEN,SAS
9603,3,Home,W 94-79 ,240,40,84,0.476,33,63,0.524,7,21,0.333,7,9,0.778,94,30,90,0.333,21,64,0.328,9,26,0.346,10,14,0.714,79,2013-11-08,PHI,CLE
9604,4,@,L 94-104 ,240,38,82,0.463,30,65,0.462,8,17,0.471,10,18,0.556,94,43,90,0.478,37,71,0.521,6,19,0.316,12,17,0.706,104,2013-11-09,ORL,ATL
9605,5,Home,L 94-107 ,240,35,78,0.449,28,52,0.538,7,26,0.269,17,27,0.63,94,42,88,0.477,33,64,0.516,9,24,0.375,14,23,0.609,107,2013-11-09,HOU,LAC
9606,6,@,L 94-101 ,240,39,88,0.443,35,75,0.467,4,13,0.308,12,13,0.923,94,38,78,0.487,31,56,0.554,7,22,0.318,18,23,0.783,101,2013-11-10,NOP,PHO
9607,7,Home,L 94-103 ,240,33,81,0.407,28,68,0.412,5,13,0.385,23,29,0.793,94,35,76,0.461,25,49,0.51,10,27,0.37,23,28,0.821,103,2013-11-11,CHA,ATL
9608,8,Home,W 94-91 ,240,35,82,0.427,26,56,0.464,9,26,0.346,15,21,0.714,94,33,74,0.446,28,61,0.459,5,13,0.385,20,22,0.909,91,2013-11-13,ORL,MIL
9609,9,@,L 94-110 ,240,34,85,0.4,30,69,0.435,4,16,0.25,22,28,0.786,94,40,79,0.506,29,60,0.483,11,19,0.579,19,24,0.792,110,2013-11-16,IND,CHI
9610,10,@,L 94-97 ,240,38,99,0.384,32,78,0.41,6,21,0.286,12,22,0.545,94,34,78,0.436,25,49,0.51,9,29,0.31,20,26,0.769,97,2013-11-18,PHI,DAL
9611,11,@,W 94-87 ,240,33,72,0.458,29,56,0.518,4,16,0.25,24,31,0.774,94,36,93,0.387,31,73,0.425,5,20,0.25,10,12,0.833,87,2013-11-23,BOS,ATL
9612,12,@,L 94-113 ,240,33,73,0.452,27,54,0.5,6,19,0.316,22,26,0.846,94,43,80,0.538,31,51,0.608,12,29,0.414,15,23,0.652,113,2013-11-25,MIL,DET
9613,13,Home,L 94-99 ,240,31,83,0.373,20,53,0.377,11,30,0.367,21,26,0.808,94,34,85,0.4,21,55,0.382,13,30,0.433,18,22,0.818,99,2013-11-27,BRK,LAL
9614,14,Home,W 94-88 ,240,39,84,0.464,35,69,0.507,4,15,0.267,12,15,0.8,94,36,92,0.391,29,65,0.446,7,27,0.259,9,14,0.643,88,2013-11-27,OKC,SAS
9615,15,@,L 94-105 ,240,38,85,0.447,31,63,0.492,7,22,0.318,11,17,0.647,94,43,82,0.524,39,63,0.619,4,19,0.211,15,21,0.714,105,2013-11-27,PHI,ORL
9616,16,Home,L 94-106 ,240,34,79,0.43,25,51,0.49,9,28,0.321,17,20,0.85,94,40,82,0.488,36,56,0.643,4,26,0.154,22,25,0.88,106,2013-12-08,LAL,TOR
9617,17,@,L 94-118 ,240,34,85,0.4,27,64,0.422,7,21,0.333,19,21,0.905,94,47,77,0.61,42,64,0.656,5,13,0.385,19,20,0.95,118,2013-12-08,IND,OKC
9618,18,Home,W 94-85 ,240,36,86,0.419,26,69,0.377,10,17,0.588,12,17,0.706,94,30,75,0.4,24,53,0.453,6,22,0.273,19,20,0.95,85,2013-12-09,MEM,ORL
9619,19,@,W 94-83 ,240,35,82,0.427,30,55,0.545,5,27,0.185,19,29,0.655,94,33,92,0.359,30,71,0.423,3,21,0.143,14,19,0.737,83,2013-12-09,LAC,PHI
9620,20,Home,L 94-105 ,240,36,82,0.439,35,75,0.467,1,7,0.143,21,23,0.913,94,40,85,0.471,34,66,0.515,6,19,0.316,19,20,0.95,105,2013-12-09,UTA,POR
9621,21,@,L 94-109 ,240,40,87,0.46,30,56,0.536,10,31,0.323,4,5,0.8,94,42,74,0.568,33,55,0.6,9,19,0.474,16,22,0.727,109,2013-12-10,NYK,CLE
9622,22,Home,L 94-121 ,240,39,83,0.47,31,55,0.564,8,28,0.286,8,16,0.5,94,41,85,0.482,30,61,0.492,11,24,0.458,28,33,0.848,121,2013-12-10,DET,MIN
9623,23,@,L 94-99 ,240,39,83,0.47,35,71,0.493,4,12,0.333,12,17,0.706,94,36,76,0.474,28,55,0.509,8,21,0.381,19,25,0.76,99,2013-12-13,CHA,IND
9624,24,@,L 94-130 ,240,37,90,0.411,29,60,0.483,8,30,0.267,12,20,0.6,94,47,78,0.603,26,43,0.605,21,35,0.6,15,26,0.577,130,2013-12-16,PHI,BRK
9625,25,@,L 94-117 ,240,39,84,0.464,34,66,0.515,5,18,0.278,11,17,0.647,94,45,71,0.634,39,56,0.696,6,15,0.4,21,26,0.808,117,2013-12-16,UTA,MIA
9626,26,@,L 94-109 ,240,38,79,0.481,33,67,0.493,5,12,0.417,13,23,0.565,94,44,82,0.537,36,60,0.6,8,22,0.364,13,16,0.813,109,2013-12-18,CHI,HOU
9627,27,@,L 94-97 ,240,32,73,0.438,27,59,0.458,5,14,0.357,25,28,0.893,94,37,77,0.481,32,56,0.571,5,21,0.238,18,22,0.818,97,2013-12-18,IND,MIA
9628,28,@,L 94-104 ,240,35,75,0.467,24,51,0.471,11,24,0.458,13,15,0.867,94,39,83,0.47,28,63,0.444,11,20,0.55,15,20,0.75,104,2013-12-23,UTA,MEM
9629,29,Home,L 94-123 ,240,38,90,0.422,32,67,0.478,6,23,0.261,12,19,0.632,94,45,84,0.536,32,60,0.533,13,24,0.542,20,26,0.769,123,2013-12-25,NYK,OKC
9630,30,Home,L 94-97 ,240,38,81,0.469,30,61,0.492,8,20,0.4,10,11,0.909,94,34,67,0.507,23,44,0.523,11,23,0.478,18,28,0.643,97,2013-12-30,DEN,MIA
9631,31,@,W 94-79 ,240,40,91,0.44,34,68,0.5,6,23,0.261,8,14,0.571,94,29,81,0.358,22,57,0.386,7,24,0.292,14,18,0.778,79,2013-12-31,MIL,LAL
9632,32,Home,L 94-98 ,240,36,82,0.439,33,68,0.485,3,14,0.214,19,26,0.731,94,36,91,0.396,28,58,0.483,8,33,0.242,18,21,0.857,98,2013-12-31,OKC,POR
9633,33,@,W 94-81 ,240,41,85,0.482,35,58,0.603,6,27,0.222,6,10,0.6,94,34,89,0.382,29,70,0.414,5,19,0.263,8,13,0.615,81,2013-12-31,GSW,ORL
9634,34,Home,W 94-82 ,240,35,84,0.417,33,69,0.478,2,15,0.133,22,28,0.786,94,32,81,0.395,30,69,0.435,2,12,0.167,16,23,0.696,82,2014-01-02,CHI,BOS
9635,35,Home,L 94-110 ,240,33,80,0.413,25,54,0.463,8,26,0.308,20,24,0.833,94,40,74,0.541,34,58,0.586,6,16,0.375,24,31,0.774,110,2014-01-04,ORL,MIA
9636,36,@,L 94-110 ,240,33,83,0.398,26,63,0.413,7,20,0.35,21,27,0.778,94,45,95,0.474,36,65,0.554,9,30,0.3,11,13,0.846,110,2014-01-08,ORL,POR
9637,37,@,L 94-120 ,240,37,84,0.44,33,64,0.516,4,20,0.2,16,23,0.696,94,44,87,0.506,32,59,0.542,12,28,0.429,20,26,0.769,120,2014-01-11,ORL,DEN
9638,38,@,L 94-116 ,240,35,83,0.422,26,64,0.406,9,19,0.474,15,22,0.682,94,40,79,0.506,28,56,0.5,12,23,0.522,24,30,0.8,116,2014-01-13,MIL,TOR
9639,39,Home,W 94-89 ,240,34,78,0.436,23,54,0.426,11,24,0.458,15,20,0.75,94,36,82,0.439,33,64,0.516,3,18,0.167,14,20,0.7,89,2014-01-17,TOR,MIN
9640,40,Home,L 94-102 ,240,35,86,0.407,25,56,0.446,10,30,0.333,14,20,0.7,94,41,91,0.451,33,72,0.458,8,19,0.421,12,15,0.8,102,2014-01-20,GSW,IND
9641,41,Home,L 94-95 ,240,32,87,0.368,25,68,0.368,7,19,0.368,23,30,0.767,94,37,86,0.43,30,65,0.462,7,21,0.333,14,25,0.56,95,2014-01-29,BOS,PHI
9642,42,Home,L 94-102 ,240,38,87,0.437,37,72,0.514,1,15,0.067,17,24,0.708,94,39,91,0.429,31,74,0.419,8,17,0.471,16,20,0.8,102,2014-01-30,IND,PHO
9643,43,@,W 94-90 ,240,38,80,0.475,34,68,0.5,4,12,0.333,14,22,0.636,94,39,84,0.464,33,62,0.532,6,22,0.273,6,7,0.857,90,2014-01-31,MEM,MIN
9644,44,@,W 94-79 ,240,37,84,0.44,31,63,0.492,6,21,0.286,14,16,0.875,94,32,78,0.41,29,61,0.475,3,17,0.176,12,13,0.923,79,2014-02-03,TOR,UTA
9645,45,@,W 94-90 ,240,30,79,0.38,22,58,0.379,8,21,0.381,26,33,0.788,94,36,90,0.4,32,69,0.464,4,21,0.19,14,20,0.7,90,2014-02-05,POR,NYK
9646,46,Home,W 94-89 ,240,36,74,0.486,26,49,0.531,10,25,0.4,12,19,0.632,94,29,67,0.433,22,44,0.5,7,23,0.304,24,30,0.8,89,2014-02-08,UTA,MIA
9647,47,@,L 94-100 ,240,34,87,0.391,29,70,0.414,5,17,0.294,21,28,0.75,94,36,82,0.439,25,54,0.463,11,28,0.393,17,26,0.654,100,2014-02-19,BOS,PHO
9648,48,@,W 94-92 ,240,36,72,0.5,29,60,0.483,7,12,0.583,15,20,0.75,94,35,83,0.422,32,66,0.485,3,17,0.176,19,23,0.826,92,2014-02-19,CHI,TOR
9649,49,@,L 94-102 ,240,37,82,0.451,31,69,0.449,6,13,0.462,14,18,0.778,94,39,91,0.429,32,71,0.451,7,20,0.35,17,17,1.0,102,2014-02-21,UTA,POR
9650,50,Home,W 94-93 ,240,36,74,0.486,33,60,0.55,3,14,0.214,19,26,0.731,94,35,81,0.432,29,68,0.426,6,13,0.462,17,21,0.81,93,2014-02-22,WAS,NOP
9651,51,Home,W 94-91 ,240,34,82,0.415,29,67,0.433,5,15,0.333,21,28,0.75,94,36,78,0.462,30,64,0.469,6,14,0.429,13,18,0.722,91,2014-03-02,IND,UTA
9652,52,@,L 94-103 ,240,34,79,0.43,28,64,0.438,6,15,0.4,20,25,0.8,94,38,74,0.514,23,48,0.479,15,26,0.577,12,13,0.923,103,2014-03-05,MEM,BRK
9653,53,Home,L 94-105 ,240,39,87,0.448,37,76,0.487,2,11,0.182,14,17,0.824,94,43,80,0.538,38,61,0.623,5,19,0.263,14,17,0.824,105,2014-03-05,DET,CHI
9654,54,Home,L 94-142 ,240,34,86,0.395,26,56,0.464,8,30,0.267,18,26,0.692,94,57,103,0.553,45,77,0.584,12,26,0.462,16,22,0.727,142,2014-03-06,LAL,LAC
9655,55,@,L 94-105 ,240,32,67,0.478,25,51,0.49,7,16,0.438,23,29,0.793,94,36,81,0.444,28,61,0.459,8,20,0.4,25,31,0.806,105,2014-03-09,IND,DAL
9656,56,Home,W 94-83 ,240,40,73,0.548,36,57,0.632,4,16,0.25,10,13,0.769,94,32,91,0.352,29,72,0.403,3,19,0.158,16,19,0.842,83,2014-03-11,IND,BOS
9657,57,Home,L 94-103 ,240,35,77,0.455,24,48,0.5,11,29,0.379,13,19,0.684,94,40,82,0.488,30,60,0.5,10,22,0.455,13,18,0.722,103,2014-03-14,GSW,CLE
9658,58,Home,L 94-101 ,240,35,90,0.389,27,64,0.422,8,26,0.308,16,18,0.889,94,39,67,0.582,30,46,0.652,9,21,0.429,14,22,0.636,101,2014-03-14,PHI,IND
9659,59,Home,W 94-87 ,240,31,78,0.397,25,58,0.431,6,20,0.3,26,33,0.788,94,31,85,0.365,29,71,0.408,2,14,0.143,23,37,0.622,87,2014-03-15,CHI,SAC
9660,60,@,L 94-115 ,240,35,81,0.432,31,71,0.437,4,10,0.4,20,27,0.741,94,42,76,0.553,34,56,0.607,8,20,0.4,23,28,0.821,115,2014-03-15,MIL,NYK
9661,61,@,L 94-101 ,240,34,71,0.479,23,50,0.46,11,21,0.524,15,22,0.682,94,36,77,0.468,28,51,0.549,8,26,0.308,21,25,0.84,101,2014-03-15,BRK,WAS
9662,62,Home,W 94-89 ,240,33,78,0.423,24,51,0.471,9,27,0.333,19,21,0.905,94,34,93,0.366,25,71,0.352,9,22,0.409,12,14,0.857,89,2014-03-17,DAL,BOS
9663,63,Home,L 94-102 ,240,37,81,0.457,26,57,0.456,11,24,0.458,9,19,0.474,94,36,83,0.434,28,68,0.412,8,15,0.533,22,27,0.815,102,2014-03-19,PHI,CHI
9664,64,@,L 94-124 ,240,34,84,0.405,25,57,0.439,9,27,0.333,17,22,0.773,94,49,94,0.521,41,75,0.547,8,19,0.421,18,19,0.947,124,2014-03-22,POR,CHA
9665,65,@,L 94-103 ,240,37,82,0.451,31,63,0.492,6,19,0.316,14,17,0.824,94,37,80,0.463,31,64,0.484,6,16,0.375,23,29,0.793,103,2014-03-23,ORL,LAL
9666,66,Home,L 94-114 ,240,34,83,0.41,27,56,0.482,7,27,0.259,19,28,0.679,94,46,83,0.554,37,66,0.561,9,17,0.529,13,18,0.722,114,2014-03-24,UTA,DET
9667,67,Home,W 94-81 ,240,33,69,0.478,24,46,0.522,9,23,0.391,19,25,0.76,94,31,85,0.365,22,67,0.328,9,18,0.5,10,16,0.625,81,2014-03-28,OKC,SAC
9668,68,@,L 94-100 ,240,38,79,0.481,29,62,0.468,9,17,0.529,9,13,0.692,94,34,78,0.436,31,57,0.544,3,21,0.143,29,34,0.853,100,2014-03-31,WAS,CHA
9669,69,Home,W 94-80 ,240,38,80,0.475,35,64,0.547,3,16,0.188,15,16,0.938,94,31,77,0.403,24,52,0.462,7,25,0.28,11,15,0.733,80,2014-03-31,CHI,BOS
9670,70,@,W 94-92 ,240,38,85,0.447,33,76,0.434,5,9,0.556,13,23,0.565,94,36,73,0.493,30,53,0.566,6,20,0.3,14,24,0.583,92,2014-03-31,MEM,DEN
9671,71,@,L 94-101 ,240,34,93,0.366,27,77,0.351,7,16,0.438,19,28,0.679,94,39,79,0.494,34,61,0.557,5,18,0.278,18,24,0.75,101,2014-04-02,DET,IND
9672,72,@,L 94-106 ,240,38,88,0.432,29,66,0.439,9,22,0.409,9,12,0.75,94,40,81,0.494,34,63,0.54,6,18,0.333,20,23,0.87,106,2014-04-03,SAS,OKC
9673,73,@,L 94-102 ,240,33,78,0.423,27,67,0.403,6,11,0.545,22,28,0.786,94,40,84,0.476,30,62,0.484,10,22,0.455,12,16,0.75,102,2014-04-04,IND,TOR
9674,74,Home,L 94-96 (OT),265,35,96,0.365,28,74,0.378,7,22,0.318,17,21,0.81,94,34,91,0.374,25,65,0.385,9,26,0.346,19,27,0.704,96,2014-04-05,CLE,CHA
9675,75,@,L 94-100 ,240,38,90,0.422,34,78,0.436,4,12,0.333,14,18,0.778,94,41,87,0.471,36,65,0.554,5,22,0.227,13,15,0.867,100,2014-04-06,NOP,POR
9676,76,@,W 94-88 ,240,39,80,0.488,30,61,0.492,9,19,0.474,7,10,0.7,94,34,80,0.425,28,66,0.424,6,14,0.429,14,17,0.824,88,2014-04-09,PHO,NOP
9677,77,@,W 94-88 (OT),265,35,92,0.38,24,67,0.358,11,25,0.44,13,15,0.867,94,37,82,0.451,36,67,0.537,1,15,0.067,13,20,0.65,88,2014-04-09,CHA,WAS
9678,78,@,L 94-116 ,240,35,86,0.407,26,68,0.382,9,18,0.5,15,19,0.789,94,44,82,0.537,39,69,0.565,5,13,0.385,23,27,0.852,116,2014-04-11,NOP,OKC
9679,79,@,L 94-101 ,240,34,79,0.43,32,66,0.485,2,13,0.154,24,32,0.75,94,35,84,0.417,28,62,0.452,7,22,0.318,24,29,0.828,101,2014-04-12,UTA,DEN
9680,80,Home,W 94-89 ,240,35,87,0.402,33,69,0.478,2,18,0.111,22,26,0.846,94,32,78,0.41,24,53,0.453,8,25,0.32,17,23,0.739,89,2014-10-31,PHO,SAS
9681,81,@,L 94-103 ,240,34,83,0.41,25,57,0.439,9,26,0.346,17,19,0.895,94,34,81,0.42,30,71,0.423,4,10,0.4,31,35,0.886,103,2014-10-31,POR,SAC
9682,82,Home,W 94-92 ,240,31,69,0.449,26,52,0.5,5,17,0.294,27,38,0.711,94,38,92,0.413,30,67,0.448,8,25,0.32,8,11,0.727,92,2014-11-05,SAS,ATL
9683,83,@,L 94-96 (OT),265,35,90,0.389,27,63,0.429,8,27,0.296,16,20,0.8,94,34,91,0.374,27,74,0.365,7,17,0.412,21,23,0.913,96,2014-11-05,IND,WAS
9684,84,Home,L 94-109 ,240,37,83,0.446,28,50,0.56,9,33,0.273,11,13,0.846,94,40,82,0.488,30,58,0.517,10,24,0.417,19,22,0.864,109,2014-11-12,BOS,OKC
9685,85,@,L 94-127 ,240,40,90,0.444,37,68,0.544,3,22,0.136,11,13,0.846,94,49,90,0.544,30,59,0.508,19,31,0.613,10,13,0.769,127,2014-11-15,ATL,CLE
9686,86,Home,W 94-91 ,240,37,86,0.43,37,74,0.5,0,12,0.0,20,24,0.833,94,34,80,0.425,27,56,0.482,7,24,0.292,16,18,0.889,91,2014-11-15,SAC,SAS
9687,87,@,W 94-92 ,240,31,67,0.463,26,52,0.5,5,15,0.333,27,30,0.9,94,38,85,0.447,34,65,0.523,4,20,0.2,12,19,0.632,92,2014-11-21,BRK,OKC
9688,88,Home,L 94-106 ,240,33,71,0.465,28,57,0.491,5,14,0.357,23,29,0.793,94,42,93,0.452,38,76,0.5,4,17,0.235,18,22,0.818,106,2014-11-22,UTA,NOP
9689,89,@,W 94-88 ,240,37,86,0.43,30,67,0.448,7,19,0.368,13,15,0.867,94,37,95,0.389,32,72,0.444,5,23,0.217,9,12,0.75,88,2014-11-23,POR,BOS
9690,90,Home,L 94-101 (OT),265,33,89,0.371,30,65,0.462,3,24,0.125,25,34,0.735,94,34,90,0.378,24,53,0.453,10,37,0.27,23,38,0.605,101,2014-11-23,LAL,DEN
9691,91,Home,W 94-93 ,240,33,66,0.5,22,43,0.512,11,23,0.478,17,19,0.895,94,37,79,0.468,30,58,0.517,7,21,0.333,12,16,0.75,93,2014-11-23,MIA,CHO
9692,92,Home,L 94-96 ,240,34,76,0.447,27,53,0.509,7,23,0.304,19,28,0.679,94,39,87,0.448,33,66,0.5,6,21,0.286,12,17,0.706,96,2014-12-07,DET,OKC
9693,93,@,L 94-103 ,240,31,85,0.365,22,57,0.386,9,28,0.321,23,30,0.767,94,38,87,0.437,31,61,0.508,7,26,0.269,20,22,0.909,103,2014-12-11,CLE,OKC
9694,94,@,L 94-106 ,240,33,80,0.413,25,58,0.431,8,22,0.364,20,23,0.87,94,38,91,0.418,28,65,0.431,10,26,0.385,20,22,0.909,106,2014-12-12,IND,TOR
9695,95,Home,L 94-100 ,240,38,90,0.422,35,80,0.438,3,10,0.3,15,20,0.75,94,34,81,0.42,29,64,0.453,5,17,0.294,27,34,0.794,100,2014-12-14,MIN,LAL
9696,96,Home,L 94-96 ,240,30,75,0.4,18,37,0.486,12,38,0.316,22,27,0.815,94,35,73,0.479,27,57,0.474,8,16,0.5,18,22,0.818,96,2014-12-15,PHO,MIL
9697,97,Home,L 94-101 ,240,37,83,0.446,25,61,0.41,12,22,0.545,8,12,0.667,94,39,73,0.534,35,62,0.565,4,11,0.364,19,24,0.792,101,2014-12-19,ORL,UTA
9698,98,Home,L 94-102 ,240,36,86,0.419,28,62,0.452,8,24,0.333,14,18,0.778,94,38,83,0.458,30,63,0.476,8,20,0.4,18,24,0.75,102,2014-12-27,CHA,ORL
9699,99,Home,L 94-104 (OT),265,33,90,0.367,26,65,0.4,7,25,0.28,21,26,0.808,94,40,85,0.471,34,64,0.531,6,21,0.286,18,21,0.857,104,2014-12-29,CHA,MIL
9700,0,@,L 94-100 ,240,38,82,0.463,30,65,0.462,8,17,0.471,10,14,0.714,94,38,79,0.481,31,60,0.517,7,19,0.368,17,22,0.773,100,2014-12-30,MIN,UTA
9701,1,@,W 94-91 ,240,35,81,0.432,27,61,0.443,8,20,0.4,16,20,0.8,94,38,89,0.427,31,65,0.477,7,24,0.292,8,10,0.8,91,2015-01-02,IND,MIL
9702,2,@,L 94-98 ,240,37,88,0.42,33,74,0.446,4,14,0.286,16,20,0.8,94,33,83,0.398,22,57,0.386,11,26,0.423,21,24,0.875,98,2015-01-05,LAL,POR
9703,3,@,L 94-98 ,240,36,80,0.45,30,62,0.484,6,18,0.333,16,24,0.667,94,37,86,0.43,33,72,0.458,4,14,0.286,20,26,0.769,98,2015-01-07,NOP,CHO
9704,4,@,L 94-112 ,240,35,86,0.407,28,63,0.444,7,23,0.304,17,23,0.739,94,43,86,0.5,33,56,0.589,10,30,0.333,16,17,0.941,112,2015-01-09,CLE,GSW
9705,5,@,L 94-99 ,240,36,74,0.486,29,53,0.547,7,21,0.333,15,22,0.682,94,42,91,0.462,35,70,0.5,7,21,0.333,8,9,0.889,99,2015-01-09,UTA,OKC
9706,6,Home,L 94-106 ,240,36,81,0.444,29,59,0.492,7,22,0.318,15,19,0.789,94,41,86,0.477,28,55,0.509,13,31,0.419,11,17,0.647,106,2015-01-11,LAL,POR
9707,7,Home,L 94-105 ,240,34,73,0.466,26,51,0.51,8,22,0.364,18,23,0.783,94,39,80,0.488,31,59,0.525,8,21,0.381,19,23,0.826,105,2015-01-14,DET,NOP
9708,8,Home,L 94-100 ,240,35,87,0.402,29,61,0.475,6,26,0.231,18,20,0.9,94,37,88,0.42,29,65,0.446,8,23,0.348,18,19,0.947,100,2015-01-14,POR,LAC
9709,9,Home,W 94-85 ,240,36,85,0.424,24,54,0.444,12,31,0.387,10,10,1.0,94,31,65,0.477,28,58,0.483,3,7,0.429,20,27,0.741,85,2015-01-16,UTA,LAL
9710,10,@,L 94-108 ,240,30,80,0.375,22,64,0.344,8,16,0.5,26,32,0.813,94,41,90,0.456,33,72,0.458,8,18,0.444,18,25,0.72,108,2015-01-19,CHI,CLE
9711,11,@,L 94-98 ,240,34,76,0.447,30,64,0.469,4,12,0.333,22,30,0.733,94,35,88,0.398,24,52,0.462,11,36,0.306,17,26,0.654,98,2015-01-19,SAC,POR
9712,12,@,W 94-86 ,240,41,92,0.446,35,66,0.53,6,26,0.231,6,10,0.6,94,32,68,0.471,24,46,0.522,8,22,0.364,14,19,0.737,86,2015-01-20,OKC,MIA
9713,13,@,L 94-103 ,240,37,78,0.474,33,66,0.5,4,12,0.333,16,25,0.64,94,36,76,0.474,29,58,0.5,7,18,0.389,24,26,0.923,103,2015-01-26,ORL,MEM
9714,14,@,L 94-99 ,240,35,80,0.438,25,49,0.51,10,31,0.323,14,17,0.824,94,34,85,0.4,19,48,0.396,15,37,0.405,16,18,0.889,99,2015-01-28,POR,CLE
9715,15,@,L 94-99 ,240,35,82,0.427,25,57,0.439,10,25,0.4,14,16,0.875,94,36,88,0.409,22,53,0.415,14,35,0.4,13,15,0.867,99,2015-01-28,DAL,HOU
9716,16,@,W 94-89 ,240,34,76,0.447,25,50,0.5,9,26,0.346,17,25,0.68,94,35,81,0.432,30,57,0.526,5,24,0.208,14,20,0.7,89,2015-01-28,LAC,UTA
9717,17,@,L 94-103 ,240,34,76,0.447,29,62,0.468,5,14,0.357,21,25,0.84,94,37,74,0.5,29,51,0.569,8,23,0.348,21,25,0.84,103,2015-01-30,MIN,PHI
9718,18,Home,L 94-99 ,240,33,80,0.413,28,55,0.509,5,25,0.2,23,25,0.92,94,34,80,0.425,29,65,0.446,5,15,0.333,26,29,0.897,99,2015-01-31,IND,SAC
9719,19,@,L 94-100 ,240,34,82,0.415,31,69,0.449,3,13,0.231,23,26,0.885,94,39,84,0.464,29,53,0.547,10,31,0.323,12,18,0.667,100,2015-02-02,MIN,DAL
9720,20,Home,W 94-87 ,240,33,76,0.434,27,51,0.529,6,25,0.24,22,27,0.815,94,35,84,0.417,30,74,0.405,5,10,0.5,12,17,0.706,87,2015-02-05,CHA,WAS
9721,21,@,L 94-105 ,240,38,91,0.418,33,69,0.478,5,22,0.227,13,20,0.65,94,31,72,0.431,23,42,0.548,8,30,0.267,35,44,0.795,105,2015-02-05,LAC,CLE
9722,22,Home,W 94-88 ,240,36,92,0.391,33,79,0.418,3,13,0.231,19,21,0.905,94,33,80,0.413,21,50,0.42,12,30,0.4,10,11,0.909,88,2015-02-08,MEM,ATL
9723,23,@,W 94-91 ,240,40,90,0.444,33,63,0.524,7,27,0.259,7,9,0.778,94,33,86,0.384,28,72,0.389,5,14,0.357,20,27,0.741,91,2015-02-11,GSW,MIN
9724,24,@,L 94-119 ,240,35,97,0.361,28,70,0.4,7,27,0.259,17,20,0.85,94,48,92,0.522,40,72,0.556,8,20,0.4,15,23,0.652,119,2015-02-22,DEN,OKC
9725,25,@,L 94-115 ,240,34,82,0.415,32,61,0.525,2,21,0.095,24,31,0.774,94,42,83,0.506,28,52,0.538,14,31,0.452,17,20,0.85,115,2015-02-25,NYK,BOS
9726,26,Home,L 94-104 ,240,35,82,0.427,26,54,0.481,9,28,0.321,15,18,0.833,94,40,77,0.519,30,54,0.556,10,23,0.435,14,23,0.609,104,2015-02-28,DAL,BRK
9727,27,Home,W 94-74 ,240,36,88,0.409,33,70,0.471,3,18,0.167,19,25,0.76,94,29,84,0.345,24,60,0.4,5,24,0.208,11,17,0.647,74,2015-03-01,IND,PHI
9728,28,@,L 94-100 ,240,38,88,0.432,31,70,0.443,7,18,0.389,11,17,0.647,94,32,79,0.405,29,63,0.46,3,16,0.188,33,43,0.767,100,2015-03-04,LAL,MIA
9729,29,Home,W 94-75 ,240,34,82,0.415,27,60,0.45,7,22,0.318,19,21,0.905,94,33,88,0.375,31,72,0.431,2,16,0.125,7,8,0.875,75,2015-03-05,POR,DAL
9730,30,@,L 94-103 ,240,37,91,0.407,30,69,0.435,7,22,0.318,13,15,0.867,94,40,85,0.471,35,65,0.538,5,20,0.25,18,20,0.9,103,2015-03-06,TOR,CHO
9731,31,Home,L 94-127 ,240,33,81,0.407,28,61,0.459,5,20,0.25,23,33,0.697,94,44,87,0.506,29,55,0.527,15,32,0.469,24,29,0.828,127,2015-03-10,DAL,CLE
9732,32,Home,L 94-101 ,240,38,90,0.422,33,72,0.458,5,18,0.278,13,21,0.619,94,36,77,0.468,27,59,0.458,9,18,0.5,20,26,0.769,101,2015-03-12,LAL,NYK
9733,33,@,L 94-125 ,240,38,96,0.396,29,71,0.408,9,25,0.36,9,16,0.563,94,45,90,0.5,26,56,0.464,19,34,0.559,16,17,0.941,125,2015-03-14,NYK,GSW
9734,34,@,W 94-87 ,240,37,84,0.44,35,67,0.522,2,17,0.118,18,26,0.692,94,35,94,0.372,27,57,0.474,8,37,0.216,9,14,0.643,87,2015-03-14,BRK,PHI
9735,35,Home,W 94-66 ,240,33,78,0.423,18,54,0.333,15,24,0.625,13,19,0.684,94,23,78,0.295,18,59,0.305,5,19,0.263,15,18,0.833,66,2015-03-16,UTA,CHO
9736,36,@,L 94-107 ,240,38,89,0.427,32,67,0.478,6,22,0.273,12,17,0.706,94,39,78,0.5,28,51,0.549,11,27,0.407,18,27,0.667,107,2015-03-17,ORL,HOU
9737,37,Home,W 94-83 ,240,36,84,0.429,25,57,0.439,11,27,0.407,11,18,0.611,94,29,88,0.33,21,62,0.339,8,26,0.308,17,19,0.895,83,2015-03-18,PHI,DET
9738,38,@,L 94-101 ,240,36,85,0.424,28,57,0.491,8,28,0.286,14,18,0.778,94,42,87,0.483,35,65,0.538,7,22,0.318,10,13,0.769,101,2015-03-24,SAS,DAL
9739,39,Home,W 94-76 ,240,37,84,0.44,28,58,0.483,9,26,0.346,11,14,0.786,94,31,82,0.378,27,64,0.422,4,18,0.222,10,15,0.667,76,2015-03-27,SAS,DAL
9740,40,Home,W 94-83 ,240,36,75,0.48,29,57,0.509,7,18,0.389,15,21,0.714,94,29,84,0.345,25,67,0.373,4,17,0.235,21,29,0.724,83,2015-03-27,TOR,LAL
9741,41,Home,W 94-89 ,240,32,84,0.381,26,55,0.473,6,29,0.207,24,35,0.686,94,31,73,0.425,25,57,0.439,6,16,0.375,21,32,0.656,89,2015-03-28,UTA,OKC
9742,42,@,L 94-99 ,240,34,76,0.447,23,49,0.469,11,27,0.407,15,21,0.714,94,35,83,0.422,19,46,0.413,16,37,0.432,13,22,0.591,99,2015-04-05,CHI,CLE
9743,43,Home,W 94-86 ,240,35,88,0.398,29,61,0.475,6,27,0.222,18,22,0.818,94,34,77,0.442,32,68,0.471,2,9,0.222,16,24,0.667,86,2015-04-11,LAC,MEM
9744,44,Home,L 94-106 ,240,37,82,0.451,29,55,0.527,8,27,0.296,12,15,0.8,94,37,96,0.385,25,67,0.373,12,29,0.414,20,26,0.769,106,2015-10-27,ATL,DET
9745,45,@,L 94-104 ,240,33,84,0.393,27,60,0.45,6,24,0.25,22,29,0.759,94,36,73,0.493,24,53,0.453,12,20,0.6,20,21,0.952,104,2015-10-28,CHA,MIA
9746,46,@,L 94-112 ,240,36,91,0.396,25,58,0.431,11,33,0.333,11,18,0.611,94,44,88,0.5,32,56,0.571,12,32,0.375,12,14,0.857,112,2015-10-28,NOP,POR
9747,47,@,L 94-97 ,240,36,88,0.409,24,58,0.414,12,30,0.4,10,13,0.769,94,36,83,0.434,28,60,0.467,8,23,0.348,17,22,0.773,97,2015-10-30,CHA,ATL
9748,48,@,L 94-98 (OT),265,34,84,0.405,27,62,0.435,7,22,0.318,19,26,0.731,94,39,104,0.375,33,76,0.434,6,28,0.214,14,28,0.5,98,2015-10-30,CHI,DET
9749,49,@,W 94-92 ,240,37,88,0.42,30,59,0.508,7,29,0.241,13,14,0.929,94,32,86,0.372,18,49,0.367,14,37,0.378,14,15,0.933,92,2015-11-01,ATL,CHO
9750,50,@,W 94-84 ,240,39,79,0.494,35,66,0.53,4,13,0.308,12,17,0.706,94,32,89,0.36,28,76,0.368,4,13,0.308,16,21,0.762,84,2015-11-02,SAS,NYK
9751,51,@,W 94-82 ,240,38,88,0.432,31,65,0.477,7,23,0.304,11,12,0.917,94,33,86,0.384,28,64,0.438,5,22,0.227,11,17,0.647,82,2015-11-03,IND,DET
9752,52,Home,L 94-103 ,240,32,90,0.356,20,54,0.37,12,36,0.333,18,25,0.72,94,42,90,0.467,35,72,0.486,7,18,0.389,12,12,1.0,103,2015-11-03,NOP,ORL
9753,53,Home,L 94-108 ,240,32,82,0.39,26,53,0.491,6,29,0.207,24,27,0.889,94,44,89,0.494,38,62,0.613,6,27,0.222,14,17,0.824,108,2015-11-05,DAL,CHO
9754,54,Home,W 94-86 ,240,37,82,0.451,29,62,0.468,8,20,0.4,12,16,0.75,94,34,82,0.415,31,73,0.425,3,9,0.333,15,19,0.789,86,2015-11-07,MIL,BRK
9755,55,Home,L 94-103 ,240,38,87,0.437,32,68,0.471,6,19,0.316,12,16,0.75,94,38,92,0.413,30,53,0.566,8,39,0.205,19,22,0.864,103,2015-11-07,SAC,GSW
9756,56,@,L 94-114 ,240,34,73,0.466,28,54,0.519,6,19,0.316,20,31,0.645,94,45,81,0.556,36,60,0.6,9,21,0.429,15,23,0.652,114,2015-11-07,CHA,SAS
9757,57,Home,W 94-92 ,240,28,68,0.412,23,49,0.469,5,19,0.263,33,37,0.892,94,35,80,0.438,33,69,0.478,2,11,0.182,20,29,0.69,92,2015-11-09,LAC,MEM
9758,58,@,L 94-106 ,240,35,89,0.393,30,68,0.441,5,21,0.238,19,21,0.905,94,41,83,0.494,32,52,0.615,9,31,0.29,15,19,0.789,106,2015-11-15,POR,CHO
9759,59,@,L 94-102 ,240,36,82,0.439,31,62,0.5,5,20,0.25,17,25,0.68,94,36,89,0.404,26,69,0.377,10,20,0.5,20,21,0.952,102,2015-11-17,CHA,NYK
9760,60,@,L 94-106 ,240,35,88,0.398,28,66,0.424,7,22,0.318,17,23,0.739,94,39,79,0.494,29,50,0.58,10,29,0.345,18,24,0.75,106,2015-11-20,CHI,GSW
9761,61,Home,L 94-111 ,240,31,78,0.397,23,53,0.434,8,25,0.32,24,29,0.828,94,37,79,0.468,29,59,0.492,8,20,0.4,29,47,0.617,111,2015-11-24,DEN,LAC
9762,62,Home,W 94-91 ,240,41,84,0.488,37,71,0.521,4,13,0.308,8,12,0.667,94,33,75,0.44,23,47,0.489,10,28,0.357,15,22,0.682,91,2015-12-01,BRK,PHO
9763,63,Home,L 94-103 ,240,31,72,0.431,17,39,0.436,14,33,0.424,18,24,0.75,94,40,89,0.449,32,66,0.485,8,23,0.348,15,15,1.0,103,2015-12-03,UTA,ORL
9764,64,@,L 94-97 ,240,34,76,0.447,27,51,0.529,7,25,0.28,19,24,0.792,94,37,64,0.578,34,54,0.63,3,10,0.3,20,22,0.909,97,2015-12-09,SAS,TOR
9765,65,@,L 94-107 ,240,35,78,0.449,25,50,0.5,10,28,0.357,14,23,0.609,94,39,80,0.488,30,63,0.476,9,17,0.529,20,26,0.769,107,2015-12-10,ATL,OKC
9766,66,@,W 94-90 ,240,37,79,0.468,31,62,0.5,6,17,0.353,14,16,0.875,94,33,78,0.423,25,50,0.5,8,28,0.286,16,24,0.667,90,2015-12-11,OKC,UTA
9767,67,@,L 94-98 ,240,40,89,0.449,34,73,0.466,6,16,0.375,8,11,0.727,94,33,78,0.423,25,58,0.431,8,20,0.4,24,29,0.828,98,2015-12-12,NOP,CHI
9768,68,@,L 94-104 ,240,33,80,0.413,24,55,0.436,9,25,0.36,19,27,0.704,94,38,77,0.494,26,45,0.578,12,32,0.375,16,21,0.762,104,2015-12-14,PHO,DAL
9769,69,Home,L 94-104 ,240,32,67,0.478,25,47,0.532,7,20,0.35,23,29,0.793,94,34,73,0.466,24,52,0.462,10,21,0.476,26,28,0.929,104,2015-12-16,UTA,NOP
9770,70,Home,L 94-108 ,240,35,74,0.473,26,49,0.531,9,25,0.36,15,17,0.882,94,41,80,0.513,33,59,0.559,8,21,0.381,18,22,0.818,108,2015-12-18,MIA,TOR
9771,71,@,L 94-102 ,240,32,73,0.438,21,41,0.512,11,32,0.344,19,26,0.731,94,39,84,0.464,37,69,0.536,2,15,0.133,22,31,0.71,102,2015-12-18,POR,ORL
9772,72,Home,L 94-104 ,240,35,94,0.372,27,65,0.415,8,29,0.276,16,17,0.941,94,40,76,0.526,31,55,0.564,9,21,0.429,15,24,0.625,104,2015-12-20,TOR,SAC
9773,73,@,W 94-84 ,240,38,85,0.447,28,59,0.475,10,26,0.385,8,11,0.727,94,32,77,0.416,25,54,0.463,7,23,0.304,13,25,0.52,84,2015-12-25,LAC,LAL
9774,74,Home,W 94-88 (OT),265,35,88,0.398,29,62,0.468,6,26,0.231,18,27,0.667,94,36,90,0.4,30,70,0.429,6,20,0.3,10,11,0.909,88,2015-12-25,MIA,NOP
9775,75,Home,L 94-98 ,240,30,76,0.395,21,52,0.404,9,24,0.375,25,31,0.806,94,38,92,0.413,28,59,0.475,10,33,0.303,12,16,0.75,98,2015-12-27,SAC,POR
9776,76,Home,W 94-80 ,240,36,77,0.468,31,67,0.463,5,10,0.5,17,27,0.63,94,28,80,0.35,18,41,0.439,10,39,0.256,14,20,0.7,80,2015-12-30,MIN,UTA
9777,77,Home,W 94-91 ,240,28,82,0.341,22,58,0.379,6,24,0.25,32,39,0.821,94,35,87,0.402,27,65,0.415,8,22,0.364,13,17,0.765,91,2015-12-30,TOR,WAS
9778,78,@,L 94-104 ,240,34,85,0.4,24,53,0.453,10,32,0.313,16,18,0.889,94,36,91,0.396,21,58,0.362,15,33,0.455,17,18,0.944,104,2016-01-01,CHA,TOR
9779,79,Home,W 94-82 ,240,33,73,0.452,26,55,0.473,7,18,0.389,21,29,0.724,94,33,93,0.355,30,73,0.411,3,20,0.15,13,23,0.565,82,2016-01-02,IND,DET
9780,80,Home,L 94-103 ,240,32,85,0.376,26,57,0.456,6,28,0.214,24,27,0.889,94,41,92,0.446,35,71,0.493,6,21,0.286,15,19,0.789,103,2016-01-04,BRK,BOS
9781,81,Home,L 94-99 ,240,34,91,0.374,28,63,0.444,6,28,0.214,20,27,0.741,94,33,74,0.446,23,47,0.489,10,27,0.37,23,36,0.639,99,2016-01-06,BOS,DET
9782,82,@,L 94-112 ,240,35,90,0.389,28,69,0.406,7,21,0.333,17,24,0.708,94,38,83,0.458,30,66,0.455,8,17,0.471,28,33,0.848,112,2016-01-06,MEM,OKC
9783,83,@,L 94-103 ,240,38,78,0.487,31,50,0.62,7,28,0.25,11,17,0.647,94,39,75,0.52,32,52,0.615,7,23,0.304,18,26,0.692,103,2016-01-07,UTA,HOU
9784,84,@,L 94-103 ,240,37,91,0.407,32,61,0.525,5,30,0.167,15,20,0.75,94,40,90,0.444,31,64,0.484,9,26,0.346,14,20,0.7,103,2016-01-13,IND,BOS
9785,85,Home,L 94-97 ,240,28,81,0.346,17,46,0.37,11,35,0.314,27,29,0.931,94,34,83,0.41,30,63,0.476,4,20,0.2,25,34,0.735,97,2016-01-19,PHO,IND
9786,86,Home,L 94-125 ,240,37,100,0.37,36,80,0.45,1,20,0.05,19,24,0.792,94,50,95,0.526,38,63,0.603,12,32,0.375,13,20,0.65,125,2016-01-20,CHI,GSW
9787,87,@,L 94-106 (OT),265,40,91,0.44,35,68,0.515,5,23,0.217,9,11,0.818,94,42,97,0.433,37,72,0.514,5,25,0.2,17,22,0.773,106,2016-01-20,MIN,DAL
9788,88,@,L 94-112 ,240,34,76,0.447,26,50,0.52,8,26,0.308,18,30,0.6,94,41,83,0.494,29,61,0.475,12,22,0.545,18,26,0.692,112,2016-01-24,LAC,TOR
9789,89,@,L 94-113 ,240,32,79,0.405,25,59,0.424,7,20,0.35,23,29,0.793,94,43,86,0.5,33,62,0.532,10,24,0.417,17,21,0.81,113,2016-01-29,ORL,BOS
9790,90,@,L 94-106 ,240,37,87,0.425,28,61,0.459,9,26,0.346,11,14,0.786,94,44,84,0.524,38,62,0.613,6,22,0.273,12,20,0.6,106,2016-02-05,PHI,WAS
9791,91,@,L 94-96 ,240,35,91,0.385,22,63,0.349,13,28,0.464,11,15,0.733,94,39,85,0.459,32,60,0.533,7,25,0.28,11,12,0.917,96,2016-02-07,ATL,ORL
9792,92,@,L 94-114 ,240,40,99,0.404,37,77,0.481,3,22,0.136,11,21,0.524,94,47,96,0.49,45,83,0.542,2,13,0.154,18,28,0.643,114,2016-02-20,WAS,MIA
9793,93,Home,L 94-103 ,240,35,82,0.427,27,57,0.474,8,25,0.32,16,21,0.762,94,40,94,0.426,33,71,0.465,7,23,0.304,16,17,0.941,103,2016-02-26,PHI,WAS
9794,94,Home,L 94-104 ,240,35,84,0.417,27,59,0.458,8,25,0.32,16,22,0.727,94,37,76,0.487,29,57,0.509,8,19,0.421,22,28,0.786,104,2016-02-27,HOU,SAS
9795,95,@,L 94-104 ,240,37,83,0.446,27,57,0.474,10,26,0.385,10,16,0.625,94,40,80,0.5,34,58,0.586,6,22,0.273,18,21,0.857,104,2016-03-02,UTA,TOR
9796,96,@,W 94-86 ,240,36,81,0.444,28,60,0.467,8,21,0.381,14,15,0.933,94,35,89,0.393,27,65,0.415,8,24,0.333,8,8,1.0,86,2016-03-03,SAS,NOP
9797,97,Home,W 94-88 ,240,37,81,0.457,33,63,0.524,4,18,0.222,16,19,0.842,94,32,75,0.427,27,56,0.482,5,19,0.263,19,29,0.655,88,2016-03-04,MEM,UTA
9798,98,Home,L 94-106 ,240,38,92,0.413,29,73,0.397,9,19,0.474,9,11,0.818,94,37,78,0.474,31,58,0.534,6,20,0.3,26,27,0.963,106,2016-03-05,NOP,UTA
9799,99,@,L 94-104 ,240,37,81,0.457,31,65,0.477,6,16,0.375,14,21,0.667,94,40,81,0.494,32,58,0.552,8,23,0.348,16,19,0.842,104,2016-03-05,SAC,SAS
9800,0,@,L 94-110 ,240,33,75,0.44,27,57,0.474,6,18,0.333,22,26,0.846,94,45,99,0.455,39,78,0.5,6,21,0.286,14,19,0.737,110,2016-03-08,NYK,DEN
9801,1,@,L 94-115 ,240,32,79,0.405,24,59,0.407,8,20,0.4,22,31,0.71,94,48,84,0.571,35,54,0.648,13,30,0.433,6,10,0.6,115,2016-03-09,UTA,GSW
9802,2,@,L 94-101 ,240,34,83,0.41,30,63,0.476,4,20,0.2,22,25,0.88,94,38,85,0.447,25,56,0.446,13,29,0.448,12,16,0.75,101,2016-03-11,NYK,LAC
9803,3,@,L 94-128 ,240,31,91,0.341,24,64,0.375,7,27,0.259,25,27,0.926,94,49,83,0.59,40,66,0.606,9,17,0.529,21,26,0.808,128,2016-03-14,POR,OKC
9804,4,Home,W 94-85 ,240,35,71,0.493,23,44,0.523,12,27,0.444,12,14,0.857,94,35,88,0.398,25,45,0.556,10,43,0.233,5,8,0.625,85,2016-03-14,UTA,CLE
9805,5,Home,L 94-101 (OT),265,35,91,0.385,27,63,0.429,8,28,0.286,16,23,0.696,94,32,88,0.364,25,66,0.379,7,22,0.318,30,38,0.789,101,2016-03-17,IND,TOR
9806,6,Home,L 94-99 ,240,35,91,0.385,29,58,0.5,6,33,0.182,18,26,0.692,94,40,90,0.444,34,63,0.54,6,27,0.222,13,19,0.684,99,2016-03-17,PHI,WAS
9807,7,@,W 94-85 ,240,34,83,0.41,21,45,0.467,13,38,0.342,13,14,0.929,94,34,65,0.523,31,57,0.544,3,8,0.375,14,17,0.824,85,2016-03-20,UTA,MIL
9808,8,@,L 94-96 ,240,32,80,0.4,26,56,0.464,6,24,0.25,24,32,0.75,94,37,82,0.451,33,63,0.524,4,19,0.211,18,28,0.643,96,2016-03-24,POR,LAC
9809,9,@,L 94-106 ,240,37,89,0.416,31,64,0.484,6,25,0.24,14,18,0.778,94,39,76,0.513,26,46,0.565,13,30,0.433,15,16,0.938,106,2016-03-24,CHI,NYK
9810,10,@,L 94-116 ,240,35,94,0.372,26,62,0.419,9,32,0.281,15,23,0.652,94,40,90,0.444,33,68,0.485,7,22,0.318,29,39,0.744,116,2016-03-25,PHO,SAC
9811,11,@,L 94-102 ,240,36,86,0.419,31,63,0.492,5,23,0.217,17,27,0.63,94,38,87,0.437,27,62,0.435,11,25,0.44,15,23,0.652,102,2016-03-29,WAS,GSW
9812,12,@,L 94-105 ,240,38,84,0.452,33,60,0.55,5,24,0.208,13,17,0.765,94,37,77,0.481,31,62,0.5,6,15,0.4,25,34,0.735,105,2016-03-30,PHO,MIL
9813,13,Home,L 94-114 ,240,36,86,0.419,29,67,0.433,7,19,0.368,15,21,0.714,94,48,90,0.533,43,74,0.581,5,16,0.313,13,18,0.722,114,2016-03-31,IND,ORL
9814,14,@,W 94-90 ,240,32,76,0.421,22,56,0.393,10,20,0.5,20,34,0.588,94,34,88,0.386,25,63,0.397,9,25,0.36,13,15,0.867,90,2016-04-02,DET,CHI
9815,15,@,L 94-109 ,240,39,87,0.448,31,57,0.544,8,30,0.267,8,15,0.533,94,40,83,0.482,29,54,0.537,11,29,0.379,18,20,0.9,109,2016-04-11,ATL,CLE
9816,16,Home,L 94-113 ,240,36,77,0.468,32,61,0.525,4,16,0.25,18,27,0.667,94,44,86,0.512,38,65,0.585,6,21,0.286,19,26,0.731,113,2016-10-26,PHO,SAC
9817,17,Home,L 94-102 ,240,28,70,0.4,22,50,0.44,6,20,0.3,32,38,0.842,94,36,79,0.456,30,61,0.492,6,18,0.333,24,27,0.889,102,2016-10-27,SAC,SAS
9818,18,@,L 94-103 ,240,37,98,0.378,30,74,0.405,7,24,0.292,13,20,0.65,94,38,87,0.437,28,54,0.519,10,33,0.303,17,20,0.85,103,2016-10-28,IND,BRK
9819,19,@,W 94-91 ,240,33,79,0.418,21,47,0.447,12,32,0.375,16,22,0.727,94,35,90,0.389,31,74,0.419,4,16,0.25,17,18,0.944,91,2016-10-28,CLE,TOR
9820,20,@,L 94-102 ,240,38,80,0.475,31,62,0.5,7,18,0.389,11,17,0.647,94,38,84,0.452,28,54,0.519,10,30,0.333,16,23,0.696,102,2016-11-03,SAC,ORL
9821,21,@,L 94-111 ,240,34,79,0.43,28,61,0.459,6,18,0.333,20,25,0.8,94,46,86,0.535,34,60,0.567,12,26,0.462,7,12,0.583,111,2016-11-05,CHI,IND
9822,22,Home,L 94-100 ,240,31,81,0.383,25,55,0.455,6,26,0.231,26,32,0.813,94,32,71,0.451,18,38,0.474,14,33,0.424,22,27,0.815,100,2016-11-06,MEM,POR
9823,23,@,L 94-102 ,240,38,84,0.452,33,63,0.524,5,21,0.238,13,18,0.722,94,39,81,0.481,31,56,0.554,8,25,0.32,16,20,0.8,102,2016-11-08,NOP,SAC
9824,24,Home,L 94-105 ,240,38,87,0.437,35,72,0.486,3,15,0.2,15,19,0.789,94,36,86,0.419,22,53,0.415,14,33,0.424,19,26,0.731,105,2016-11-11,WAS,CLE
9825,25,Home,W 94-90 ,240,33,82,0.402,25,67,0.373,8,15,0.533,20,27,0.741,94,37,84,0.44,33,69,0.478,4,15,0.267,12,21,0.571,90,2016-11-14,SAS,MIA
9826,26,@,W 94-92 ,240,33,82,0.402,21,51,0.412,12,31,0.387,16,17,0.941,94,37,86,0.43,30,66,0.455,7,20,0.35,11,16,0.688,92,2016-11-19,BOS,DET
9827,27,@,L 94-104 ,240,34,85,0.4,28,64,0.438,6,21,0.286,20,29,0.69,94,42,88,0.477,32,61,0.525,10,27,0.37,10,14,0.714,104,2016-11-20,ATL,NYK
9828,28,@,L 94-101 ,240,34,88,0.386,27,57,0.474,7,31,0.226,19,28,0.679,94,37,78,0.474,26,52,0.5,11,26,0.423,16,20,0.8,101,2016-11-21,MIA,PHI
9829,29,Home,L 94-112 ,240,39,85,0.459,29,56,0.518,10,29,0.345,6,10,0.6,94,45,86,0.523,34,61,0.557,11,25,0.44,11,12,0.917,112,2016-11-22,ATL,NOP
9830,30,@,W 94-91 ,240,40,88,0.455,34,59,0.576,6,29,0.207,8,10,0.8,94,35,80,0.438,28,57,0.491,7,23,0.304,14,20,0.7,91,2016-11-25,WAS,ORL
9831,31,@,L 94-109 ,240,39,88,0.443,27,53,0.509,12,35,0.343,4,10,0.4,94,42,95,0.442,34,75,0.453,8,20,0.4,17,20,0.85,109,2016-11-27,ATL,LAL
9832,32,@,W 94-87 ,240,33,71,0.465,22,52,0.423,11,19,0.579,17,24,0.708,94,33,77,0.429,23,47,0.489,10,30,0.333,11,14,0.786,87,2016-11-30,SAS,DAL
9833,33,Home,L 94-113 ,240,28,69,0.406,19,45,0.422,9,24,0.375,29,39,0.744,94,42,89,0.472,29,58,0.5,13,31,0.419,16,24,0.667,113,2016-12-01,CLE,LAC
9834,34,@,L 94-95 ,240,33,74,0.446,27,50,0.54,6,24,0.25,22,31,0.71,94,33,79,0.418,26,61,0.426,7,18,0.389,22,28,0.786,95,2016-12-01,ORL,MEM
9835,35,Home,L 94-126 ,240,35,87,0.402,24,56,0.429,11,31,0.355,13,15,0.867,94,39,80,0.488,17,40,0.425,22,40,0.55,26,31,0.839,126,2016-12-07,NYK,CLE
9836,36,Home,L 94-109 ,240,34,85,0.4,25,52,0.481,9,33,0.273,17,18,0.944,94,35,78,0.449,28,55,0.509,7,23,0.304,32,41,0.78,109,2016-12-07,PHO,IND
9837,37,Home,L 94-101 ,240,31,83,0.373,14,41,0.341,17,42,0.405,15,22,0.682,94,34,82,0.415,25,62,0.403,9,20,0.45,24,27,0.889,101,2016-12-09,BOS,TOR
9838,38,@,L 94-110 ,240,28,84,0.333,18,58,0.31,10,26,0.385,28,32,0.875,94,43,88,0.489,26,52,0.5,17,36,0.472,7,10,0.7,110,2016-12-12,CHA,IND
9839,39,Home,L 94-99 ,240,38,87,0.437,34,72,0.472,4,15,0.267,14,19,0.737,94,38,86,0.442,32,65,0.492,6,21,0.286,17,22,0.773,99,2016-12-13,CHI,MIN
9840,40,@,W 94-93 ,240,34,74,0.459,24,53,0.453,10,21,0.476,16,24,0.667,94,33,74,0.446,24,47,0.511,9,27,0.333,18,22,0.818,93,2016-12-21,SAC,UTA
9841,41,Home,L 94-106 ,240,36,82,0.439,29,59,0.492,7,23,0.304,15,21,0.714,94,42,82,0.512,37,63,0.587,5,19,0.263,17,25,0.68,106,2016-12-27,MIA,OKC
9842,42,Home,L 94-119 ,240,39,88,0.443,33,64,0.516,6,24,0.25,10,16,0.625,94,48,84,0.571,37,62,0.597,11,22,0.5,12,16,0.75,119,2016-12-28,DET,MIL
9843,43,@,L 94-110 ,240,35,77,0.455,29,57,0.509,6,20,0.3,18,21,0.857,94,39,78,0.5,28,56,0.5,11,22,0.5,21,25,0.84,110,2016-12-30,POR,SAS
9844,44,@,L 94-98 ,240,36,78,0.462,27,51,0.529,9,27,0.333,13,19,0.684,94,38,79,0.481,31,60,0.517,7,19,0.368,15,24,0.625,98,2017-01-02,OKC,MIL
9845,45,Home,L 94-106 ,240,34,83,0.41,26,58,0.448,8,25,0.32,18,24,0.75,94,41,85,0.482,28,55,0.509,13,30,0.433,11,15,0.733,106,2017-01-04,CLE,CHI
9846,46,Home,L 94-99 ,240,34,93,0.366,19,58,0.328,15,35,0.429,11,14,0.786,94,38,90,0.422,29,67,0.433,9,23,0.391,14,17,0.824,99,2017-01-05,NOP,ATL
9847,47,@,W 94-92 ,240,32,77,0.416,24,54,0.444,8,23,0.348,22,28,0.786,94,35,80,0.438,28,60,0.467,7,20,0.35,15,21,0.714,92,2017-01-07,UTA,MIN
9848,48,Home,L 94-109 ,240,34,83,0.41,27,64,0.422,7,19,0.368,19,22,0.864,94,47,83,0.566,40,59,0.678,7,24,0.292,8,11,0.727,109,2017-01-09,CHI,OKC
9849,49,@,L 94-100 ,240,36,82,0.439,24,55,0.436,12,27,0.444,10,16,0.625,94,32,73,0.438,19,50,0.38,13,23,0.565,23,29,0.793,100,2017-01-10,DET,SAC
9850,50,@,L 94-134 ,240,35,85,0.412,29,65,0.446,6,20,0.3,18,25,0.72,94,49,81,0.605,39,60,0.65,10,21,0.476,26,29,0.897,134,2017-01-12,LAL,SAS
9851,51,Home,W 94-89 ,240,31,69,0.449,23,45,0.511,8,24,0.333,24,32,0.75,94,34,86,0.395,28,62,0.452,6,24,0.25,15,23,0.652,89,2017-01-18,PHI,TOR
9852,52,Home,L 94-107 ,240,38,84,0.452,28,52,0.538,10,32,0.313,8,15,0.533,94,45,89,0.506,35,68,0.515,10,21,0.476,7,10,0.7,107,2017-01-29,NOP,WAS
9853,53,@,L 94-108 ,240,30,85,0.353,23,57,0.404,7,28,0.25,27,32,0.844,94,37,86,0.43,30,65,0.462,7,21,0.333,27,38,0.711,108,2017-01-31,OKC,SAS
9854,54,@,L 94-102 ,240,34,87,0.391,24,59,0.407,10,28,0.357,16,21,0.762,94,37,80,0.463,32,66,0.485,5,14,0.357,23,32,0.719,102,2017-02-03,TOR,ORL
9855,55,Home,L 94-127 ,240,35,77,0.455,30,53,0.566,5,24,0.208,19,25,0.76,94,48,88,0.545,34,56,0.607,14,32,0.438,17,21,0.81,127,2017-02-08,NOP,UTA
9856,56,Home,W 94-90 ,240,34,68,0.5,25,54,0.463,9,14,0.643,17,21,0.81,94,33,91,0.363,27,62,0.435,6,29,0.207,18,22,0.818,90,2017-02-12,NYK,SAS
9857,57,@,L 94-105 ,240,35,77,0.455,30,57,0.526,5,20,0.25,19,24,0.792,94,35,73,0.479,28,56,0.5,7,17,0.412,28,35,0.8,105,2017-02-14,TOR,CHI
9858,58,Home,W 94-87 ,240,36,82,0.439,31,63,0.492,5,19,0.263,17,21,0.81,94,34,88,0.386,28,58,0.483,6,30,0.2,13,14,0.929,87,2017-03-02,CHI,GSW
9859,59,@,L 94-101 ,240,35,75,0.467,28,54,0.519,7,21,0.333,17,20,0.85,94,38,87,0.437,32,60,0.533,6,27,0.222,19,23,0.826,101,2017-03-04,TOR,MIL
9860,60,@,W 94-87 ,240,36,76,0.474,28,55,0.509,8,21,0.381,14,23,0.609,94,34,80,0.425,25,51,0.49,9,29,0.31,10,13,0.769,87,2017-03-08,TOR,NOP
9861,61,Home,L 93-115 ,240,32,76,0.421,24,49,0.49,8,27,0.296,21,27,0.778,93,39,79,0.494,29,52,0.558,10,27,0.37,27,34,0.794,115,2011-12-26,DAL,DEN
9862,62,@,L 93-113 ,240,34,79,0.43,23,50,0.46,11,29,0.379,14,18,0.778,93,45,80,0.563,45,75,0.6,0,5,0.0,23,33,0.697,113,2011-12-30,HOU,MEM
9863,63,@,W 93-78 ,240,33,78,0.423,26,55,0.473,7,23,0.304,20,22,0.909,93,26,90,0.289,23,76,0.303,3,14,0.214,23,28,0.821,78,2011-12-30,PHO,NOH
9864,64,Home,W 93-88 ,240,36,75,0.48,30,51,0.588,6,24,0.25,15,24,0.625,93,33,78,0.423,29,63,0.46,4,15,0.267,18,22,0.818,88,2012-01-01,LAC,POR
9865,65,Home,L 93-103 ,240,36,83,0.434,31,63,0.492,5,20,0.25,16,21,0.762,93,34,76,0.447,28,61,0.459,6,15,0.4,29,36,0.806,103,2012-01-03,OKC,POR
9866,66,Home,L 93-101 ,240,35,79,0.443,32,69,0.464,3,10,0.3,20,25,0.8,93,41,86,0.477,37,70,0.529,4,16,0.25,15,18,0.833,101,2012-01-04,NOP,PHI
9867,67,Home,W 93-71 ,240,34,86,0.395,18,53,0.34,16,33,0.485,9,16,0.563,93,27,77,0.351,26,58,0.448,1,19,0.053,16,21,0.762,71,2012-01-05,SAS,DAL
9868,68,@,L 93-109 ,240,37,86,0.43,34,71,0.479,3,15,0.2,16,24,0.667,93,43,77,0.558,33,55,0.6,10,22,0.455,13,17,0.765,109,2012-01-08,MIL,PHO
9869,69,@,W 93-72 ,240,36,80,0.45,26,54,0.481,10,26,0.385,11,15,0.733,93,30,87,0.345,27,77,0.351,3,10,0.3,9,16,0.563,72,2012-01-08,MIN,WAS
9870,70,Home,W 93-78 ,240,40,82,0.488,36,69,0.522,4,13,0.308,9,17,0.529,93,30,76,0.395,26,56,0.464,4,20,0.2,14,17,0.824,78,2012-01-10,WAS,TOR
9871,71,@,L 93-102 ,240,33,74,0.446,30,69,0.435,3,5,0.6,24,24,1.0,93,37,78,0.474,26,56,0.464,11,22,0.5,17,17,1.0,102,2012-01-12,DET,MIL
9872,72,Home,W 93-91 ,240,32,78,0.41,25,57,0.439,7,21,0.333,22,27,0.815,93,38,85,0.447,34,64,0.531,4,21,0.19,11,12,0.917,91,2012-01-14,ATL,MIN
9873,73,Home,W 93-84 ,240,32,71,0.451,27,58,0.466,5,13,0.385,24,31,0.774,93,33,78,0.423,30,66,0.455,3,12,0.25,15,22,0.682,84,2012-01-16,ATL,TOR
9874,74,Home,L 93-102 ,240,30,73,0.411,25,53,0.472,5,20,0.25,28,33,0.848,93,36,71,0.507,19,36,0.528,17,35,0.486,13,22,0.591,102,2012-01-16,NYK,ORL
9875,75,Home,W 93-85 ,240,30,75,0.4,22,52,0.423,8,23,0.348,25,34,0.735,93,35,79,0.443,30,68,0.441,5,11,0.455,10,21,0.476,85,2012-01-18,MIN,DET
9876,76,@,W 93-87 ,240,36,73,0.493,30,59,0.508,6,14,0.429,15,17,0.882,93,34,70,0.486,29,58,0.5,5,12,0.417,14,16,0.875,87,2012-01-18,MEM,NOH
9877,77,Home,W 93-87 ,240,33,81,0.407,25,56,0.446,8,25,0.32,19,29,0.655,93,31,83,0.373,25,63,0.397,6,20,0.3,19,22,0.864,87,2012-01-23,DAL,PHO
9878,78,@,L 93-101 ,240,34,83,0.41,26,62,0.419,8,21,0.381,17,20,0.85,93,41,79,0.519,30,59,0.508,11,20,0.55,8,14,0.571,101,2012-01-25,POR,GSW
9879,79,Home,L 93-122 ,240,34,78,0.436,25,58,0.431,9,20,0.45,16,22,0.727,93,50,91,0.549,48,78,0.615,2,13,0.154,20,25,0.8,122,2012-01-25,SAC,DEN
9880,80,Home,W 93-67 ,240,41,81,0.506,36,67,0.537,5,14,0.357,6,16,0.375,93,24,61,0.393,18,40,0.45,6,21,0.286,13,21,0.619,67,2012-01-27,NOP,ORL
9881,81,@,L 93-96 ,240,37,80,0.463,31,67,0.463,6,13,0.462,13,14,0.929,93,35,79,0.443,28,61,0.459,7,18,0.389,19,23,0.826,96,2012-01-28,SAC,UTA
9882,82,@,L 93-97 ,240,35,81,0.432,32,70,0.457,3,11,0.273,20,28,0.714,93,32,78,0.41,29,70,0.414,3,8,0.375,30,40,0.75,97,2012-01-29,CHI,MIA
9883,83,Home,W 93-89 ,240,32,84,0.381,29,72,0.403,3,12,0.25,26,38,0.684,93,37,80,0.463,32,60,0.533,5,20,0.25,10,13,0.769,89,2012-01-30,UTA,POR
9884,84,@,W 93-90 ,240,37,73,0.507,32,59,0.542,5,14,0.357,14,19,0.737,93,34,75,0.453,27,58,0.466,7,17,0.412,15,21,0.714,90,2012-01-31,BOS,CLE
9885,85,Home,W 93-90 ,240,37,91,0.407,29,67,0.433,8,24,0.333,11,13,0.846,93,35,82,0.427,29,66,0.439,6,16,0.375,14,19,0.737,90,2012-01-31,GSW,SAC
9886,86,Home,W 93-81 ,240,34,74,0.459,30,55,0.545,4,19,0.211,21,27,0.778,93,33,74,0.446,30,66,0.455,3,8,0.375,12,16,0.75,81,2012-02-02,SAS,NOH
9887,87,@,W 93-89 ,240,37,78,0.474,33,65,0.508,4,13,0.308,15,25,0.6,93,33,75,0.44,28,52,0.538,5,23,0.217,18,23,0.783,89,2012-02-03,LAL,DEN
9888,88,Home,L 93-107 ,240,38,83,0.458,36,66,0.545,2,17,0.118,15,19,0.789,93,37,81,0.457,30,53,0.566,7,28,0.25,26,33,0.788,107,2012-02-08,WAS,NYK
9889,89,Home,W 93-83 ,240,35,73,0.479,30,64,0.469,5,9,0.556,18,21,0.857,93,30,78,0.385,27,68,0.397,3,10,0.3,20,24,0.833,83,2012-02-14,MEM,HOU
9890,90,@,W 93-91 ,240,34,84,0.405,24,62,0.387,10,22,0.455,15,17,0.882,93,36,76,0.474,29,57,0.509,7,19,0.368,12,16,0.75,91,2012-02-15,POR,GSW
9891,91,Home,W 93-88 ,240,32,81,0.395,25,62,0.403,7,19,0.368,22,26,0.846,93,35,75,0.467,31,58,0.534,4,17,0.235,14,16,0.875,88,2012-02-16,IND,NJN
9892,92,Home,W 93-92 ,240,32,89,0.36,25,67,0.373,7,22,0.318,22,30,0.733,93,35,93,0.376,31,74,0.419,4,19,0.211,18,25,0.72,92,2012-02-19,CLE,SAC
9893,93,@,L 93-97 ,240,38,79,0.481,35,66,0.53,3,13,0.231,14,18,0.778,93,35,74,0.473,28,52,0.538,7,22,0.318,20,25,0.8,97,2012-02-20,MEM,HOU
9894,94,@,W 93-90 ,240,33,76,0.434,25,54,0.463,8,22,0.364,19,25,0.76,93,37,91,0.407,32,69,0.464,5,22,0.227,11,13,0.846,90,2012-02-20,ORL,MIL
9895,95,@,L 93-101 ,240,33,91,0.363,26,77,0.338,7,14,0.5,20,23,0.87,93,36,80,0.45,28,54,0.519,8,26,0.308,21,24,0.875,101,2012-02-20,NOP,OKC
9896,96,Home,W 93-87 ,240,36,78,0.462,31,60,0.517,5,18,0.278,16,20,0.8,93,33,82,0.402,33,73,0.452,0,9,0.0,21,27,0.778,87,2012-02-22,HOU,PHI
9897,97,@,L 93-103 ,240,35,84,0.417,33,72,0.458,2,12,0.167,21,27,0.778,93,40,76,0.526,37,69,0.536,3,7,0.429,20,28,0.714,103,2012-02-22,DET,TOR
9898,98,@,W 93-92 ,240,37,84,0.44,30,59,0.508,7,25,0.28,12,14,0.857,93,32,89,0.36,24,64,0.375,8,25,0.32,20,28,0.714,92,2012-02-28,BRK,DAL
9899,99,Home,L 93-107 ,240,36,76,0.474,31,60,0.517,5,16,0.313,16,19,0.842,93,39,82,0.476,33,71,0.465,6,11,0.545,23,29,0.793,107,2012-03-01,POR,MIA
9900,0,Home,W 93-83 ,240,35,71,0.493,30,54,0.556,5,17,0.294,18,25,0.72,93,33,88,0.375,26,64,0.406,7,24,0.292,10,15,0.667,83,2012-03-04,LAL,MIA
9901,1,@,L 93-97 ,240,35,94,0.372,28,75,0.373,7,19,0.368,16,23,0.696,93,35,88,0.398,28,68,0.412,7,20,0.35,20,23,0.87,97,2012-03-05,PHI,MIL
9902,2,Home,L 93-99 ,240,32,68,0.471,29,61,0.475,3,7,0.429,26,37,0.703,93,39,87,0.448,38,80,0.475,1,7,0.143,20,24,0.833,99,2012-03-07,CHA,UTA
9903,3,Home,W 93-91 (OT),265,35,75,0.467,32,62,0.516,3,13,0.231,20,31,0.645,93,33,88,0.375,26,71,0.366,7,17,0.412,18,25,0.72,91,2012-03-10,MIA,IND
9904,4,Home,L 93-97 ,240,34,79,0.43,28,60,0.467,6,19,0.316,19,35,0.543,93,36,70,0.514,28,55,0.509,8,15,0.533,17,21,0.81,97,2012-03-11,LAC,GSW
9905,5,Home,L 93-97 ,240,34,80,0.425,24,54,0.444,10,26,0.385,15,20,0.75,93,35,74,0.473,26,53,0.491,9,21,0.429,18,23,0.783,97,2012-03-19,GSW,MIN
9906,6,Home,L 93-109 ,240,35,82,0.427,27,56,0.482,8,26,0.308,15,22,0.682,93,45,77,0.584,36,59,0.61,9,18,0.5,10,13,0.769,109,2012-03-21,DAL,LAL
9907,7,@,L 93-103 ,240,38,79,0.481,34,67,0.507,4,12,0.333,13,19,0.684,93,39,83,0.47,28,60,0.467,11,23,0.478,14,21,0.667,103,2012-03-21,PHO,ORL
9908,8,@,L 93-97 ,240,37,81,0.457,34,73,0.466,3,8,0.375,16,23,0.696,93,31,73,0.425,21,48,0.438,10,25,0.4,25,25,1.0,97,2012-03-22,MEM,POR
9909,9,Home,W 93-84 ,240,36,77,0.468,29,56,0.518,7,21,0.333,14,20,0.7,93,32,80,0.4,26,55,0.473,6,25,0.24,14,21,0.667,84,2012-03-23,ATL,NJN
9910,10,Home,W 93-80 ,240,37,79,0.468,25,44,0.568,12,35,0.343,7,12,0.583,93,31,82,0.378,27,64,0.422,4,18,0.222,14,21,0.667,80,2012-03-23,ORL,CLE
9911,11,Home,W 93-76 ,240,37,81,0.457,30,53,0.566,7,28,0.25,12,18,0.667,93,35,85,0.412,34,76,0.447,1,9,0.111,5,11,0.455,76,2012-03-25,SAS,PHI
9912,12,Home,W 93-86 ,240,34,80,0.425,34,69,0.493,0,11,0.0,25,28,0.893,93,33,85,0.388,24,56,0.429,9,29,0.31,11,13,0.846,86,2012-03-27,MEM,MIN
9913,13,Home,W 93-89 ,240,31,79,0.392,25,63,0.397,6,16,0.375,25,32,0.781,93,33,78,0.423,26,56,0.464,7,22,0.318,16,25,0.64,89,2012-03-29,IND,WAS
9914,14,Home,L 93-102 ,240,35,84,0.417,31,73,0.425,4,11,0.364,19,23,0.826,93,42,91,0.462,37,79,0.468,5,12,0.417,13,17,0.765,102,2012-03-29,LAL,OKC
9915,15,@,L 93-99 ,240,33,71,0.465,26,58,0.448,7,13,0.538,20,21,0.952,93,39,80,0.488,27,52,0.519,12,28,0.429,9,13,0.692,99,2012-03-29,NOP,POR
9916,16,Home,L 93-99 ,240,40,83,0.482,35,66,0.53,5,17,0.294,8,17,0.471,93,42,89,0.472,38,76,0.5,4,13,0.308,11,14,0.786,99,2012-04-02,CHI,HOU
9917,17,@,L 93-99 ,240,38,83,0.458,35,73,0.479,3,10,0.3,14,17,0.824,93,35,75,0.467,32,62,0.516,3,13,0.231,26,32,0.813,99,2012-04-03,PHI,MIA
9918,18,@,L 93-120 ,240,36,79,0.456,31,65,0.477,5,14,0.357,16,20,0.8,93,47,83,0.566,38,64,0.594,9,19,0.474,17,19,0.895,120,2012-04-04,CHA,ATL
9919,19,@,L 93-98 ,240,35,81,0.432,30,64,0.469,5,17,0.294,18,20,0.9,93,31,83,0.373,21,59,0.356,10,24,0.417,26,29,0.897,98,2012-04-04,OKC,MIA
9920,20,Home,W 93-86 ,240,33,80,0.413,28,64,0.438,5,16,0.313,22,26,0.846,93,33,77,0.429,28,64,0.438,5,13,0.385,15,18,0.833,86,2012-04-05,CHI,BOS
9921,21,@,W 93-85 ,240,36,80,0.45,31,61,0.508,5,19,0.263,16,24,0.667,93,35,84,0.417,31,67,0.463,4,17,0.235,11,15,0.733,85,2012-04-05,LAC,SAC
9922,22,@,W 93-91 ,240,34,73,0.466,29,63,0.46,5,10,0.5,20,26,0.769,93,36,80,0.45,27,65,0.415,9,15,0.6,10,10,1.0,91,2012-04-09,LAL,NOH
9923,23,Home,W 93-85 ,240,39,78,0.5,36,63,0.571,3,15,0.2,12,15,0.8,93,34,93,0.366,23,58,0.397,11,35,0.314,6,10,0.6,85,2012-04-10,WAS,ORL
9924,24,@,L 93-104 ,240,38,79,0.481,31,55,0.564,7,24,0.292,10,14,0.714,93,42,84,0.5,38,70,0.543,4,14,0.286,16,19,0.842,104,2012-04-11,PHO,MEM
9925,25,@,W 93-75 ,240,41,77,0.532,40,67,0.597,1,10,0.1,10,16,0.625,93,29,80,0.363,22,62,0.355,7,18,0.389,10,12,0.833,75,2012-04-11,PHI,TOR
9926,26,@,W 93-85 ,240,36,78,0.462,32,61,0.525,4,17,0.235,17,21,0.81,93,31,73,0.425,22,43,0.512,9,30,0.3,14,23,0.609,85,2012-04-15,MIA,NYK
9927,27,Home,W 93-90 ,240,33,74,0.446,24,50,0.48,9,24,0.375,18,24,0.75,93,37,83,0.446,32,67,0.478,5,16,0.313,11,17,0.647,90,2012-04-19,PHO,LAC
9928,28,Home,W 93-83 ,240,38,84,0.452,29,64,0.453,9,20,0.45,8,12,0.667,93,31,79,0.392,27,64,0.422,4,15,0.267,17,19,0.895,83,2012-04-21,CHI,DAL
9929,29,Home,W 93-89 ,240,40,90,0.444,36,73,0.493,4,17,0.235,9,10,0.9,93,29,78,0.372,23,54,0.426,6,24,0.25,25,31,0.806,89,2012-04-21,MEM,POR
9930,30,@,W 93-88 ,240,41,92,0.446,36,76,0.474,5,16,0.313,6,10,0.6,93,30,82,0.366,23,56,0.411,7,26,0.269,21,21,1.0,88,2012-04-22,GSW,MIN
9931,31,@,L 93-99 ,240,34,70,0.486,23,45,0.511,11,25,0.44,14,25,0.56,93,36,77,0.468,27,53,0.509,9,24,0.375,18,24,0.75,99,2012-04-25,LAC,NYK
9932,32,Home,W 93-87 ,240,33,79,0.418,31,70,0.443,2,9,0.222,25,33,0.758,93,34,84,0.405,28,67,0.418,6,17,0.353,13,16,0.813,87,2012-10-31,CHI,SAC
9933,33,@,L 93-99 ,240,36,86,0.419,28,67,0.418,8,19,0.421,13,17,0.765,93,40,84,0.476,38,78,0.487,2,6,0.333,17,24,0.708,99,2012-11-06,ORL,CHI
9934,34,@,W 93-87 ,240,37,82,0.451,30,64,0.469,7,18,0.389,12,21,0.571,93,31,84,0.369,23,51,0.451,8,33,0.242,17,23,0.739,87,2012-11-07,DEN,HOU
9935,35,Home,W 93-85 ,240,35,94,0.372,29,75,0.387,6,19,0.316,17,23,0.739,93,31,76,0.408,22,49,0.449,9,27,0.333,14,15,0.933,85,2012-11-09,MEM,HOU
9936,36,@,W 93-83 ,240,34,73,0.466,28,59,0.475,6,14,0.429,19,25,0.76,93,30,79,0.38,18,53,0.34,12,26,0.462,11,16,0.688,83,2012-11-10,PHI,TOR
9937,37,@,L 93-98 ,240,33,82,0.402,26,67,0.388,7,15,0.467,20,28,0.714,93,36,72,0.5,32,62,0.516,4,10,0.4,22,29,0.759,98,2012-11-14,UTA,BOS
9938,38,Home,L 93-98 ,240,37,88,0.42,31,68,0.456,6,20,0.3,13,19,0.684,93,36,77,0.468,23,50,0.46,13,27,0.481,13,16,0.813,98,2012-11-15,DEN,MIA
9939,39,@,L 93-99 ,240,36,81,0.444,29,59,0.492,7,22,0.318,14,18,0.778,93,40,87,0.46,30,69,0.435,10,18,0.556,9,10,0.9,99,2012-11-16,UTA,PHI
9940,40,@,L 93-102 ,240,38,83,0.458,32,60,0.533,6,23,0.261,11,15,0.733,93,40,75,0.533,33,60,0.55,7,15,0.467,15,19,0.789,102,2012-11-21,BRK,GSW
9941,41,Home,W 93-89 ,240,32,74,0.432,25,55,0.455,7,19,0.368,22,31,0.71,93,38,95,0.4,36,79,0.456,2,16,0.125,11,19,0.579,89,2012-11-21,HOU,CHI
9942,42,@,L 93-104 ,240,32,75,0.427,24,56,0.429,8,19,0.421,21,25,0.84,93,38,75,0.507,31,58,0.534,7,17,0.412,21,26,0.808,104,2012-11-24,LAC,ATL
9943,43,@,W 93-86 ,240,32,82,0.39,28,66,0.424,4,16,0.25,25,26,0.962,93,38,88,0.432,35,71,0.493,3,17,0.176,7,10,0.7,86,2012-11-24,CHI,MIL
9944,44,@,W 93-92 ,240,39,85,0.459,36,70,0.514,3,15,0.2,12,19,0.632,93,35,80,0.438,30,69,0.435,5,11,0.455,17,19,0.895,92,2012-11-26,MIL,CHI
9945,45,Home,W 93-88 ,240,38,81,0.469,34,74,0.459,4,7,0.571,13,21,0.619,93,36,82,0.439,33,70,0.471,3,12,0.25,13,18,0.722,88,2012-12-01,CHI,PHI
9946,46,@,L 93-108 ,240,36,81,0.444,33,68,0.485,3,13,0.231,18,32,0.563,93,38,94,0.404,32,80,0.4,6,14,0.429,26,32,0.813,108,2012-12-07,CHA,MIL
9947,47,Home,W 93-85 ,240,34,78,0.436,27,65,0.415,7,13,0.538,18,18,1.0,93,27,84,0.321,19,61,0.311,8,23,0.348,23,28,0.821,85,2012-12-08,CHI,NYK
9948,48,@,W 93-83 ,240,34,77,0.442,27,60,0.45,7,17,0.412,18,25,0.72,93,33,77,0.429,27,61,0.443,6,16,0.375,11,18,0.611,83,2012-12-08,ATL,MEM
9949,49,@,L 93-104 ,240,38,82,0.463,32,65,0.492,6,17,0.353,11,13,0.846,93,37,76,0.487,32,57,0.561,5,19,0.263,25,30,0.833,104,2012-12-09,IND,OKC
9950,50,@,L 93-99 ,240,35,89,0.393,28,64,0.438,7,25,0.28,16,20,0.8,93,34,76,0.447,25,52,0.481,9,24,0.375,22,30,0.733,99,2012-12-12,WAS,HOU
9951,51,Home,L 93-115 ,240,31,84,0.369,26,58,0.448,5,26,0.192,26,36,0.722,93,49,99,0.495,39,75,0.52,10,24,0.417,7,8,0.875,115,2012-12-15,ATL,GSW
9952,52,@,L 93-107 ,240,36,79,0.456,30,59,0.508,6,20,0.3,15,21,0.714,93,38,85,0.447,34,71,0.479,4,14,0.286,27,30,0.9,107,2012-12-17,SAS,OKC
9953,53,@,L 93-102 ,240,39,96,0.406,32,71,0.451,7,25,0.28,8,12,0.667,93,44,82,0.537,38,68,0.559,6,14,0.429,8,8,1.0,102,2012-12-17,MIN,ORL
9954,54,@,L 93-98 ,240,32,80,0.4,30,72,0.417,2,8,0.25,27,34,0.794,93,37,86,0.43,31,72,0.431,6,14,0.429,18,26,0.692,98,2012-12-18,IND,MIL
9955,55,Home,W 93-77 ,240,37,74,0.5,33,54,0.611,4,20,0.2,15,19,0.789,93,29,75,0.387,27,56,0.482,2,19,0.105,17,22,0.773,77,2012-12-19,LAC,NOH
9956,56,@,L 93-99 ,240,33,82,0.402,28,62,0.452,5,20,0.25,22,26,0.846,93,37,84,0.44,28,64,0.438,9,20,0.45,16,23,0.696,99,2012-12-20,OKC,MIN
9957,57,@,L 93-101 ,240,38,98,0.388,38,76,0.5,0,22,0.0,17,24,0.708,93,33,92,0.359,19,56,0.339,14,36,0.389,21,26,0.808,101,2012-12-20,DEN,POR
9958,58,Home,W 93-90 ,240,33,81,0.407,25,62,0.403,8,19,0.421,19,21,0.905,93,35,70,0.5,31,56,0.554,4,14,0.286,16,19,0.842,90,2012-12-21,TOR,ORL
9959,59,@,L 93-96 ,240,40,89,0.449,35,70,0.5,5,19,0.263,8,11,0.727,93,33,69,0.478,26,49,0.531,7,20,0.35,23,28,0.821,96,2012-12-22,PHO,POR
9960,60,Home,L 93-97 ,240,38,76,0.5,29,56,0.518,9,20,0.45,8,15,0.533,93,36,83,0.434,29,65,0.446,7,18,0.389,18,25,0.72,97,2012-12-23,ORL,UTA
9961,61,@,W 93-76 ,240,38,77,0.494,32,67,0.478,6,10,0.6,11,13,0.846,93,26,64,0.406,19,44,0.432,7,20,0.35,17,29,0.586,76,2012-12-25,BOS,BRK
9962,62,@,L 93-108 ,240,34,88,0.386,30,67,0.448,4,21,0.19,21,24,0.875,93,40,84,0.476,30,67,0.448,10,17,0.588,18,19,0.947,108,2012-12-26,BRK,MIL
9963,63,@,W 93-83 ,240,34,71,0.479,26,53,0.491,8,18,0.444,17,22,0.773,93,32,71,0.451,24,49,0.49,8,22,0.364,11,16,0.688,83,2013-01-02,MEM,BOS
9964,64,Home,L 93-110 ,240,36,73,0.493,28,54,0.519,8,19,0.421,13,17,0.765,93,38,76,0.5,29,59,0.492,9,17,0.529,25,29,0.862,110,2013-01-02,OKC,BRK
9965,65,@,L 93-113 ,240,36,90,0.4,30,71,0.423,6,19,0.316,15,23,0.652,93,44,85,0.518,37,61,0.607,7,24,0.292,18,21,0.857,113,2013-01-05,SAC,BRK
9966,66,@,L 93-99 ,240,36,84,0.429,30,66,0.455,6,18,0.333,15,18,0.833,93,38,79,0.481,28,55,0.509,10,24,0.417,13,21,0.619,99,2013-01-09,DAL,LAC
9967,67,Home,W 93-83 ,240,36,79,0.456,34,68,0.5,2,11,0.182,19,27,0.704,93,30,78,0.385,23,54,0.426,7,24,0.292,16,25,0.64,83,2013-01-12,WAS,ATL
9968,68,@,L 93-113 ,240,39,95,0.411,35,74,0.473,4,21,0.19,11,12,0.917,93,40,69,0.58,27,44,0.614,13,25,0.52,20,27,0.741,113,2013-01-13,CLE,LAL
9969,69,@,W 93-88 ,240,32,83,0.386,28,66,0.424,4,17,0.235,25,32,0.781,93,31,79,0.392,22,50,0.44,9,29,0.31,17,26,0.654,88,2013-01-16,CLE,POR
9970,70,Home,L 93-98 ,240,35,85,0.412,27,64,0.422,8,21,0.381,15,22,0.682,93,41,86,0.477,33,62,0.532,8,24,0.333,8,11,0.727,98,2013-01-19,ATL,SAS
9971,71,Home,L 93-97 ,240,31,72,0.431,26,57,0.456,5,15,0.333,26,38,0.684,93,37,81,0.457,32,63,0.508,5,18,0.278,18,21,0.857,97,2013-01-19,CHA,SAC
9972,72,@,L 93-106 ,240,31,73,0.425,24,56,0.429,7,17,0.412,24,32,0.75,93,47,96,0.49,43,83,0.518,4,13,0.308,8,10,0.8,106,2013-01-23,LAL,MEM
9973,73,Home,W 93-88 ,240,30,71,0.423,25,55,0.455,5,16,0.313,28,37,0.757,93,33,83,0.398,27,65,0.415,6,18,0.333,16,26,0.615,88,2013-01-24,PHO,LAC
9974,74,@,L 93-121 ,240,37,88,0.42,29,66,0.439,8,22,0.364,11,22,0.5,93,47,89,0.528,34,58,0.586,13,31,0.419,14,17,0.824,121,2013-01-26,SAC,DEN
9975,75,Home,W 93-85 ,240,35,78,0.449,28,60,0.467,7,18,0.389,16,25,0.64,93,32,81,0.395,26,69,0.377,6,12,0.5,15,21,0.714,85,2013-01-28,CHI,CHA
9976,76,Home,W 93-92 ,240,36,75,0.48,26,49,0.531,10,26,0.385,11,18,0.611,93,33,85,0.388,24,63,0.381,9,22,0.409,17,23,0.739,92,2013-01-30,ATL,TOR
9977,77,Home,W 93-89 ,240,39,75,0.52,34,64,0.531,5,11,0.455,10,20,0.5,93,34,78,0.436,33,64,0.516,1,14,0.071,20,22,0.909,89,2013-02-01,BRK,CHI
9978,78,@,W 93-76 ,240,38,93,0.409,30,73,0.411,8,20,0.4,9,13,0.692,93,31,79,0.392,25,60,0.417,6,19,0.316,8,15,0.533,76,2013-02-02,CHI,ATL
9979,79,@,L 93-113 ,240,35,86,0.407,30,71,0.423,5,15,0.333,18,24,0.75,93,45,89,0.506,36,70,0.514,9,19,0.474,14,20,0.7,113,2013-02-02,PHO,GSW
9980,80,@,W 93-90 ,240,34,82,0.415,28,66,0.424,6,16,0.375,19,25,0.76,93,36,83,0.434,33,66,0.5,3,17,0.176,15,21,0.714,90,2013-02-06,BRK,DET
9981,81,Home,W 93-84 ,240,39,75,0.52,35,61,0.574,4,14,0.286,11,17,0.647,93,35,78,0.449,34,63,0.54,1,15,0.067,13,15,0.867,84,2013-02-06,NOP,PHO
9982,82,Home,L 93-100 ,240,38,89,0.427,34,75,0.453,4,14,0.286,13,19,0.684,93,36,80,0.45,28,54,0.519,8,26,0.308,20,25,0.8,100,2013-02-08,CHA,LAL
9983,83,@,L 93-99 ,240,36,74,0.486,30,57,0.526,6,17,0.353,15,20,0.75,93,36,79,0.456,28,59,0.475,8,20,0.4,19,23,0.826,99,2013-02-08,GSW,MEM
9984,84,@,W 93-89 ,240,36,79,0.456,31,67,0.463,5,12,0.417,16,18,0.889,93,37,78,0.474,33,62,0.532,4,16,0.25,11,17,0.647,89,2013-02-08,CHI,UTA
9985,85,Home,L 93-97 ,240,29,85,0.341,24,63,0.381,5,22,0.227,30,38,0.789,93,38,87,0.437,36,76,0.474,2,11,0.182,19,25,0.76,97,2013-02-13,MIN,UTA
9986,86,@,L 93-99 ,240,36,85,0.424,32,72,0.444,4,13,0.308,17,20,0.85,93,32,75,0.427,24,42,0.571,8,33,0.242,27,35,0.771,99,2013-02-24,PHI,NYK
9987,87,Home,W 93-82 ,240,32,83,0.386,29,69,0.42,3,14,0.214,26,33,0.788,93,33,85,0.388,29,74,0.392,4,11,0.364,12,21,0.571,82,2013-02-28,CHI,PHI
9988,88,@,W 93-81 ,240,34,70,0.486,27,50,0.54,7,20,0.35,18,22,0.818,93,29,72,0.403,26,61,0.426,3,11,0.273,20,25,0.8,81,2013-03-01,IND,TOR
9989,89,Home,L 93-99 ,240,32,74,0.432,24,45,0.533,8,29,0.276,21,26,0.808,93,39,84,0.464,31,64,0.484,8,20,0.4,13,19,0.684,99,2013-03-03,NYK,MIA
9990,90,@,L 93-102 ,240,37,77,0.481,27,56,0.482,10,21,0.476,9,11,0.818,93,42,79,0.532,34,58,0.586,8,21,0.381,10,13,0.769,102,2013-03-08,PHI,MIA
9991,91,@,W 93-80 ,240,36,83,0.434,30,60,0.5,6,23,0.261,15,22,0.682,93,32,77,0.416,27,59,0.458,5,18,0.278,11,16,0.688,80,2013-03-09,BRK,ATL
9992,92,Home,L 93-103 ,240,37,82,0.451,31,67,0.463,6,15,0.4,13,20,0.65,93,38,78,0.487,25,50,0.5,13,28,0.464,14,19,0.737,103,2013-03-09,GSW,MIL
9993,93,Home,L 93-108 ,240,35,84,0.417,29,64,0.453,6,20,0.3,17,22,0.773,93,44,86,0.512,41,74,0.554,3,12,0.25,17,25,0.68,108,2013-03-11,PHO,DEN
9994,94,@,L 93-105 ,240,33,77,0.429,27,60,0.45,6,17,0.353,21,24,0.875,93,43,82,0.524,35,61,0.574,8,21,0.381,11,14,0.786,105,2013-03-11,OKC,SAS
9995,95,@,L 93-106 ,240,39,85,0.459,33,67,0.493,6,18,0.333,9,12,0.75,93,43,86,0.5,35,70,0.5,8,16,0.5,12,24,0.5,106,2013-03-13,MIL,WAS
9996,96,Home,L 93-99 ,240,37,99,0.374,25,72,0.347,12,27,0.444,7,9,0.778,93,33,78,0.423,20,52,0.385,13,26,0.5,20,30,0.667,99,2013-03-15,IND,LAL
9997,97,Home,L 93-105 ,240,36,86,0.419,28,63,0.444,8,23,0.348,13,16,0.813,93,44,84,0.524,36,63,0.571,8,21,0.381,9,13,0.692,105,2013-03-17,BRK,ATL
9998,98,Home,W 93-80 ,240,34,75,0.453,26,47,0.553,8,28,0.286,17,31,0.548,93,29,81,0.358,17,55,0.309,12,26,0.462,10,14,0.714,80,2013-03-17,LAC,NYK
9999,99,@,W 93-72 ,240,35,70,0.5,25,51,0.49,10,19,0.526,13,15,0.867,93,28,83,0.337,25,66,0.379,3,17,0.176,13,13,1.0,72,2013-03-18,GSW,NOH
10000,0,@,L 93-100 ,240,36,79,0.456,31,62,0.5,5,17,0.294,16,20,0.8,93,34,76,0.447,28,53,0.528,6,23,0.261,26,32,0.813,100,2013-03-20,UTA,HOU
10001,1,@,L 93-104 ,240,37,84,0.44,31,72,0.431,6,12,0.5,13,15,0.867,93,41,85,0.482,33,59,0.559,8,26,0.308,14,15,0.933,104,2013-03-20,GSW,SAS
10002,2,Home,L 93-104 ,240,37,83,0.446,30,59,0.508,7,24,0.292,12,16,0.75,93,41,87,0.471,31,69,0.449,10,18,0.556,12,16,0.75,104,2013-03-22,ATL,POR
10003,3,@,W 93-92 ,240,34,76,0.447,29,62,0.468,5,14,0.357,20,28,0.714,93,38,86,0.442,31,69,0.449,7,17,0.412,9,14,0.643,92,2013-03-27,BOS,CLE
10004,4,Home,L 93-111 ,240,36,82,0.439,28,64,0.438,8,18,0.444,13,21,0.619,93,46,95,0.484,41,75,0.547,5,20,0.25,14,25,0.56,111,2013-03-27,POR,BRK
10005,5,@,L 93-101 ,240,36,79,0.456,31,63,0.492,5,16,0.313,16,20,0.8,93,37,83,0.446,32,68,0.471,5,15,0.333,22,27,0.815,101,2013-03-29,OKC,MIN
10006,6,@,L 93-98 ,240,34,93,0.366,30,69,0.435,4,24,0.167,21,30,0.7,93,36,71,0.507,29,51,0.569,7,20,0.35,19,22,0.864,98,2013-04-03,DET,BOS
10007,7,Home,L 93-95 ,240,30,67,0.448,27,52,0.519,3,15,0.2,30,40,0.75,93,40,85,0.471,36,70,0.514,4,15,0.267,11,16,0.688,95,2013-04-05,MIN,TOR
10008,8,Home,L 93-101 ,240,37,81,0.457,31,65,0.477,6,16,0.375,13,17,0.765,93,34,74,0.459,26,55,0.473,8,19,0.421,25,28,0.893,101,2013-04-10,BOS,BRK
10009,9,@,L 93-113 ,240,35,78,0.449,26,54,0.481,9,24,0.375,14,17,0.824,93,43,83,0.518,31,65,0.477,12,18,0.667,15,20,0.75,113,2013-04-12,CHA,DET
10010,10,Home,L 93-96 ,240,35,83,0.422,29,64,0.453,6,19,0.316,17,32,0.531,93,35,78,0.449,28,52,0.538,7,26,0.269,19,28,0.679,96,2013-04-12,NOP,LAC
10011,11,@,L 93-105 ,240,37,73,0.507,28,53,0.528,9,20,0.45,10,14,0.714,93,41,83,0.494,35,68,0.515,6,15,0.4,17,19,0.895,105,2013-04-13,PHO,MIN
10012,12,@,L 93-105 ,240,29,82,0.354,18,56,0.321,11,26,0.423,24,31,0.774,93,36,70,0.514,30,53,0.566,6,17,0.353,27,41,0.659,105,2013-04-14,CHI,MIA
10013,13,Home,W 93-87 ,240,36,82,0.439,30,67,0.448,6,15,0.4,15,21,0.714,93,34,84,0.405,26,54,0.481,8,30,0.267,11,19,0.579,87,2013-04-14,TOR,BRK
10014,14,Home,W 93-77 ,240,37,79,0.468,30,52,0.577,7,27,0.259,12,15,0.8,93,30,73,0.411,23,52,0.442,7,21,0.333,10,15,0.667,77,2013-04-16,LAC,POR
10015,15,@,L 93-105 ,240,40,77,0.519,38,63,0.603,2,14,0.143,11,25,0.44,93,42,78,0.538,30,49,0.612,12,29,0.414,9,19,0.474,105,2013-04-17,ORL,MIA
10016,16,Home,W 93-87 ,240,38,86,0.442,33,69,0.478,5,17,0.294,12,23,0.522,93,32,66,0.485,29,53,0.547,3,13,0.231,20,29,0.69,87,2013-10-30,TOR,BOS
10017,17,Home,L 93-104 ,240,34,81,0.42,30,59,0.508,4,22,0.182,21,27,0.778,93,34,67,0.507,25,45,0.556,9,22,0.409,27,35,0.771,104,2013-11-02,UTA,HOU
10018,18,@,L 93-103 ,240,35,82,0.427,23,52,0.442,12,30,0.4,11,16,0.688,93,37,70,0.529,26,43,0.605,11,27,0.407,18,27,0.667,103,2013-11-03,WAS,MIA
10019,19,Home,W 93-92 ,240,39,85,0.459,34,69,0.493,5,16,0.313,10,11,0.909,93,34,94,0.362,29,66,0.439,5,28,0.179,19,24,0.792,92,2013-11-04,CLE,MIN
10020,20,Home,L 93-106 ,240,34,90,0.378,30,74,0.405,4,16,0.25,21,27,0.778,93,42,84,0.5,34,64,0.531,8,20,0.4,14,20,0.7,106,2013-11-06,MIN,GSW
10021,21,@,L 93-107 ,240,36,85,0.424,27,62,0.435,9,23,0.391,12,14,0.857,93,43,79,0.544,38,66,0.576,5,13,0.385,16,23,0.696,107,2013-11-06,DAL,OKC
10022,22,Home,W 93-85 ,240,36,71,0.507,32,56,0.571,4,15,0.267,17,24,0.708,93,35,87,0.402,29,65,0.446,6,22,0.273,9,12,0.75,85,2013-11-20,ATL,DET
10023,23,@,L 93-104 ,240,39,86,0.453,35,71,0.493,4,15,0.267,11,12,0.917,93,39,81,0.481,31,60,0.517,8,21,0.381,18,24,0.75,104,2013-11-20,BOS,SAS
10024,24,@,L 93-103 ,240,39,78,0.5,32,58,0.552,7,20,0.35,8,12,0.667,93,38,75,0.507,31,58,0.534,7,17,0.412,20,27,0.741,103,2013-11-22,UTA,DAL
10025,25,@,W 93-86 ,240,34,69,0.493,28,45,0.622,6,24,0.25,19,27,0.704,93,34,82,0.415,30,69,0.435,4,13,0.308,14,18,0.778,86,2013-11-25,HOU,MEM
10026,26,@,L 93-112 ,240,37,97,0.381,35,82,0.427,2,15,0.133,17,20,0.85,93,44,81,0.543,34,56,0.607,10,25,0.4,14,19,0.737,112,2013-11-25,NOP,SAS
10027,27,Home,L 93-100 ,240,38,89,0.427,31,69,0.449,7,20,0.35,10,13,0.769,93,36,80,0.45,33,71,0.465,3,9,0.333,25,31,0.806,100,2013-11-27,BOS,MEM
10028,28,Home,W 93-80 ,240,32,74,0.432,26,49,0.531,6,25,0.24,23,31,0.742,93,32,83,0.386,29,63,0.46,3,20,0.15,13,15,0.867,80,2013-11-27,LAC,NYK
10029,29,Home,W 93-73 ,240,38,85,0.447,29,63,0.46,9,22,0.409,8,10,0.8,93,29,73,0.397,23,55,0.418,6,18,0.333,9,13,0.692,73,2013-11-29,IND,WAS
10030,30,@,L 93-97 ,240,39,82,0.476,33,67,0.493,6,15,0.4,9,15,0.6,93,37,78,0.474,30,63,0.476,7,15,0.467,16,19,0.842,97,2013-11-30,CHI,CLE
10031,31,@,L 93-95 ,240,37,88,0.42,29,65,0.446,8,23,0.348,11,14,0.786,93,37,86,0.43,25,58,0.431,12,28,0.429,9,15,0.6,95,2013-12-11,DAL,GSW
10032,32,@,L 93-102 ,240,26,70,0.371,20,46,0.435,6,24,0.25,35,52,0.673,93,33,74,0.446,25,54,0.463,8,20,0.4,28,30,0.933,102,2013-12-12,LAC,BRK
10033,33,Home,L 93-103 ,240,36,85,0.424,29,64,0.453,7,21,0.333,14,24,0.583,93,38,84,0.452,30,63,0.476,8,21,0.381,19,20,0.95,103,2013-12-13,DEN,UTA
10034,34,@,L 93-106 ,240,36,81,0.444,31,64,0.484,5,17,0.294,16,19,0.842,93,42,88,0.477,32,64,0.5,10,24,0.417,12,18,0.667,106,2013-12-14,MIL,DAL
10035,35,@,L 93-102 ,240,37,85,0.435,30,61,0.492,7,24,0.292,12,19,0.632,93,37,85,0.435,30,61,0.492,7,24,0.292,21,28,0.75,102,2013-12-15,NOP,DEN
10036,36,Home,L 93-101 ,240,37,83,0.446,32,68,0.471,5,15,0.333,14,20,0.7,93,35,79,0.443,23,53,0.434,12,26,0.462,19,25,0.76,101,2013-12-15,MEM,MIN
10037,37,Home,L 93-105 ,240,36,87,0.414,31,68,0.456,5,19,0.263,16,22,0.727,93,43,88,0.489,38,66,0.576,5,22,0.227,14,20,0.7,105,2013-12-17,DEN,OKC
10038,38,@,L 93-104 ,240,33,88,0.375,28,70,0.4,5,18,0.278,22,30,0.733,93,41,91,0.451,36,71,0.507,5,20,0.25,17,24,0.708,104,2013-12-17,NOP,GSW
10039,39,@,L 93-104 ,240,33,88,0.375,24,56,0.429,9,32,0.281,18,25,0.72,93,34,79,0.43,22,53,0.415,12,26,0.462,24,32,0.75,104,2013-12-27,MIL,BRK
10040,40,Home,L 93-95 ,240,34,68,0.5,25,46,0.543,9,22,0.409,16,19,0.842,93,31,70,0.443,22,46,0.478,9,24,0.375,24,31,0.774,95,2014-01-02,OKC,BRK
10041,41,@,L 93-111 ,240,34,86,0.395,30,67,0.448,4,19,0.211,21,27,0.778,93,44,89,0.494,31,61,0.508,13,28,0.464,10,18,0.556,111,2014-01-07,PHI,CLE
10042,42,Home,W 93-66 ,240,37,83,0.446,31,70,0.443,6,13,0.462,13,22,0.591,93,26,81,0.321,21,67,0.313,5,14,0.357,9,23,0.391,66,2014-01-10,IND,WAS
10043,43,@,L 93-96 ,240,35,76,0.461,26,52,0.5,9,24,0.375,14,16,0.875,93,40,79,0.506,34,68,0.5,6,11,0.545,10,13,0.769,96,2014-01-17,CHI,WAS
10044,44,@,L 93-108 ,240,33,77,0.429,28,60,0.467,5,17,0.294,22,28,0.786,93,39,86,0.453,30,65,0.462,9,21,0.429,21,30,0.7,108,2014-01-19,SAC,OKC
10045,45,Home,W 93-91 ,240,30,71,0.423,26,56,0.464,4,15,0.267,29,36,0.806,93,33,90,0.367,30,77,0.39,3,13,0.231,22,24,0.917,91,2014-01-19,ORL,BOS
10046,46,Home,W 93-86 ,240,38,74,0.514,33,54,0.611,5,20,0.25,12,16,0.75,93,33,84,0.393,28,57,0.491,5,27,0.185,15,18,0.833,86,2014-01-21,MIA,BOS
10047,47,Home,W 93-85 ,240,32,76,0.421,25,53,0.472,7,23,0.304,22,32,0.688,93,34,73,0.466,27,53,0.509,7,20,0.35,10,14,0.714,85,2014-01-22,TOR,DAL
10048,48,Home,W 93-78 ,240,37,88,0.42,33,74,0.446,4,14,0.286,15,23,0.652,93,30,74,0.405,23,50,0.46,7,24,0.292,11,14,0.786,78,2014-01-24,CLE,MIL
10049,49,@,L 93-95 ,240,34,83,0.41,29,69,0.42,5,14,0.357,20,25,0.8,93,36,75,0.48,30,53,0.566,6,22,0.273,17,26,0.654,95,2014-02-01,SAC,SAS
10050,50,Home,W 93-81 ,240,35,66,0.53,29,38,0.763,6,28,0.214,17,29,0.586,93,30,83,0.361,24,65,0.369,6,18,0.333,15,27,0.556,81,2014-02-09,BRK,NOP
10051,51,Home,W 93-92 ,240,34,83,0.41,29,71,0.408,5,12,0.417,20,26,0.769,93,35,79,0.443,24,55,0.436,11,24,0.458,11,19,0.579,92,2014-02-09,ORL,IND
10052,52,Home,W 93-84 ,240,34,79,0.43,26,58,0.448,8,21,0.381,17,22,0.773,93,29,82,0.354,27,71,0.38,2,11,0.182,24,28,0.857,84,2014-02-09,WAS,SAC
10053,53,@,W 93-89 ,240,34,84,0.405,29,69,0.42,5,15,0.333,20,30,0.667,93,33,83,0.398,29,60,0.483,4,23,0.174,19,27,0.704,89,2014-02-12,CLE,DET
10054,54,@,L 93-98 ,240,35,85,0.412,29,58,0.5,6,27,0.222,17,20,0.85,93,37,75,0.493,31,63,0.492,6,12,0.5,18,24,0.75,98,2014-02-18,NYK,MEM
10055,55,Home,L 93-103 ,240,38,81,0.469,34,66,0.515,4,15,0.267,13,21,0.619,93,42,74,0.568,35,58,0.603,7,16,0.438,12,15,0.8,103,2014-02-18,WAS,TOR
10056,56,@,L 93-101 ,240,35,89,0.393,29,67,0.433,6,22,0.273,17,24,0.708,93,33,80,0.413,28,60,0.467,5,20,0.25,30,37,0.811,101,2014-02-19,ORL,CLE
10057,57,Home,W 93-86 ,240,37,85,0.435,31,65,0.477,6,20,0.3,13,17,0.765,93,32,78,0.41,30,57,0.526,2,21,0.095,20,24,0.833,86,2014-02-22,GSW,BRK
10058,58,@,L 93-94 ,240,35,81,0.432,29,68,0.426,6,13,0.462,17,21,0.81,93,36,74,0.486,33,60,0.55,3,14,0.214,19,26,0.731,94,2014-02-22,NOP,WAS
10059,59,Home,W 93-79 ,240,37,88,0.42,28,65,0.431,9,23,0.391,10,14,0.714,93,29,81,0.358,23,60,0.383,6,21,0.286,15,17,0.882,79,2014-02-23,MIA,CHI
10060,60,Home,L 93-99 ,240,34,84,0.405,29,67,0.433,5,17,0.294,20,24,0.833,93,35,79,0.443,25,47,0.532,10,32,0.313,19,24,0.792,99,2014-02-25,CLE,TOR
10061,61,@,L 93-101 ,240,34,77,0.442,26,52,0.5,8,25,0.32,17,24,0.708,93,41,93,0.441,33,69,0.478,8,24,0.333,11,13,0.846,101,2014-02-26,HOU,LAC
10062,62,@,L 93-105 ,240,35,82,0.427,29,67,0.433,6,15,0.4,17,21,0.81,93,44,91,0.484,36,72,0.5,8,19,0.421,9,14,0.643,105,2014-03-14,MIN,CHA
10063,63,@,L 93-109 ,240,32,80,0.4,26,67,0.388,6,13,0.462,23,30,0.767,93,45,89,0.506,34,64,0.531,11,25,0.44,8,12,0.667,109,2014-03-19,ORL,PHO
10064,64,@,W 93-92 ,240,34,82,0.415,27,53,0.509,7,29,0.241,18,25,0.72,93,34,91,0.374,24,50,0.48,10,41,0.244,14,21,0.667,92,2014-03-21,NYK,PHI
10065,65,Home,W 93-91 ,240,37,84,0.44,32,69,0.464,5,15,0.333,14,23,0.609,93,28,74,0.378,17,35,0.486,11,39,0.282,24,27,0.889,91,2014-03-24,MIA,POR
10066,66,Home,L 93-99 ,240,37,81,0.457,31,62,0.5,6,19,0.316,13,21,0.619,93,37,75,0.493,23,47,0.489,14,28,0.5,11,12,0.917,99,2014-03-26,WAS,PHO
10067,67,@,L 93-100 ,240,41,81,0.506,39,69,0.565,2,12,0.167,9,16,0.563,93,40,81,0.494,31,61,0.508,9,20,0.45,11,14,0.786,100,2014-03-28,MEM,GSW
10068,68,Home,L 93-98 ,240,38,69,0.551,31,50,0.62,7,19,0.368,10,14,0.714,93,33,73,0.452,27,54,0.5,6,19,0.316,26,27,0.963,98,2014-03-30,ORL,TOR
10069,69,Home,W 93-83 ,240,34,66,0.515,27,41,0.659,7,25,0.28,18,22,0.818,93,35,70,0.5,27,44,0.614,8,26,0.308,5,10,0.5,83,2014-03-31,MIA,TOR
10070,70,Home,L 93-123 ,240,35,83,0.422,31,65,0.477,4,18,0.222,19,26,0.731,93,42,79,0.532,30,57,0.526,12,22,0.545,27,35,0.771,123,2014-04-02,PHI,CHA
10071,71,Home,L 93-109 ,240,35,81,0.432,29,60,0.483,6,21,0.286,17,27,0.63,93,39,97,0.402,33,76,0.434,6,21,0.286,25,31,0.806,109,2014-04-04,POR,PHO
10072,72,@,W 93-91 ,240,36,89,0.404,23,58,0.397,13,31,0.419,8,14,0.571,93,36,76,0.474,31,58,0.534,5,18,0.278,14,20,0.7,91,2014-04-06,DAL,SAC
10073,73,@,W 93-88 ,240,36,79,0.456,35,60,0.583,1,19,0.053,20,21,0.952,93,34,80,0.425,28,58,0.483,6,22,0.273,14,25,0.56,88,2014-04-11,ATL,BRK
10074,74,Home,L 93-95 ,240,34,79,0.43,26,49,0.531,8,30,0.267,17,23,0.739,93,35,80,0.438,29,55,0.527,6,25,0.24,19,31,0.613,95,2014-04-14,ATL,CHA
10075,75,@,L 93-114 ,240,36,80,0.45,29,53,0.547,7,27,0.259,14,16,0.875,93,46,78,0.59,32,49,0.653,14,29,0.483,8,15,0.533,114,2014-04-14,MIA,WAS
10076,76,Home,L 93-104 ,240,38,81,0.469,35,63,0.556,3,18,0.167,14,17,0.824,93,40,77,0.519,26,50,0.52,14,27,0.519,10,14,0.714,104,2014-10-29,UTA,HOU
10077,77,Home,W 93-90 ,240,34,87,0.391,27,57,0.474,7,30,0.233,18,25,0.72,93,28,65,0.431,22,44,0.5,6,21,0.286,28,34,0.824,90,2014-10-30,LAC,OKC
10078,78,Home,W 93-81 ,240,36,88,0.409,27,64,0.422,9,24,0.375,12,21,0.571,93,32,86,0.372,27,63,0.429,5,23,0.217,12,22,0.545,81,2014-10-31,MIL,PHI
10079,79,@,L 93-96 ,240,33,70,0.471,27,55,0.491,6,15,0.4,21,29,0.724,93,39,78,0.5,31,62,0.5,8,16,0.5,10,17,0.588,96,2014-11-02,CHA,NYK
10080,80,Home,W 93-81 ,240,31,76,0.408,27,62,0.435,4,14,0.286,27,37,0.73,93,29,86,0.337,25,62,0.403,4,24,0.167,19,29,0.655,81,2014-11-03,MEM,NOP
10081,81,Home,L 93-104 ,240,33,74,0.446,22,52,0.423,11,22,0.5,16,23,0.696,93,32,75,0.427,16,41,0.39,16,34,0.471,24,30,0.8,104,2014-11-03,PHI,HOU
10082,82,Home,W 93-92 ,240,40,88,0.455,35,70,0.5,5,18,0.278,8,11,0.727,93,29,82,0.354,26,68,0.382,3,14,0.214,31,34,0.912,92,2014-11-08,MIL,MEM
10083,83,@,L 93-101 ,240,36,80,0.45,30,56,0.536,6,24,0.25,15,22,0.682,93,36,78,0.462,30,60,0.5,6,18,0.333,23,27,0.852,101,2014-11-09,SAC,OKC
10084,84,Home,L 93-100 ,240,35,89,0.393,27,64,0.422,8,25,0.32,15,21,0.714,93,37,77,0.481,33,62,0.532,4,15,0.267,22,32,0.688,100,2014-11-13,TOR,CHI
10085,85,@,W 93-80 ,240,33,80,0.413,23,57,0.404,10,23,0.435,17,20,0.85,93,28,75,0.373,26,63,0.413,2,12,0.167,22,31,0.71,80,2014-11-14,SAS,LAL
10086,86,@,L 93-111 ,240,33,75,0.44,28,59,0.475,5,16,0.313,22,30,0.733,93,43,84,0.512,35,63,0.556,8,21,0.381,17,23,0.739,111,2014-11-15,UTA,TOR
10087,87,@,L 93-98 ,240,37,78,0.474,30,61,0.492,7,17,0.412,12,18,0.667,93,42,84,0.5,39,74,0.527,3,10,0.3,11,16,0.688,98,2014-11-15,ORL,WAS
10088,88,@,L 93-109 ,240,32,82,0.39,19,48,0.396,13,34,0.382,16,26,0.615,93,41,76,0.539,35,62,0.565,6,14,0.429,21,27,0.778,109,2014-11-16,DEN,NYK
10089,89,Home,L 93-107 ,240,32,80,0.4,21,56,0.375,11,24,0.458,18,24,0.75,93,41,79,0.519,28,53,0.528,13,26,0.5,12,15,0.8,107,2014-11-17,DET,ORL
10090,90,@,L 93-119 ,240,34,78,0.436,26,44,0.591,8,34,0.235,17,21,0.81,93,46,86,0.535,39,69,0.565,7,17,0.412,20,22,0.909,119,2014-11-17,HOU,MEM
10091,91,@,L 93-102 ,240,38,85,0.447,33,66,0.5,5,19,0.263,12,19,0.632,93,38,76,0.5,31,57,0.544,7,19,0.368,19,23,0.826,102,2014-11-17,NOP,POR
10092,92,Home,L 93-110 ,240,30,67,0.448,24,41,0.585,6,26,0.231,27,31,0.871,93,43,77,0.558,30,46,0.652,13,31,0.419,11,17,0.647,110,2014-11-20,MIA,LAC
10093,93,Home,L 93-110 ,240,35,81,0.432,32,65,0.492,3,16,0.188,20,29,0.69,93,32,80,0.4,24,56,0.429,8,24,0.333,38,42,0.905,110,2014-11-22,CLE,TOR
10094,94,@,L 93-94 ,240,37,79,0.468,30,58,0.517,7,21,0.333,12,16,0.75,93,33,66,0.5,22,43,0.512,11,23,0.478,17,19,0.895,94,2014-11-23,CHA,MIA
10095,95,Home,L 93-99 ,240,33,81,0.407,25,62,0.403,8,19,0.421,19,24,0.792,93,36,80,0.45,31,58,0.534,5,22,0.227,22,25,0.88,99,2014-11-26,LAL,MEM
10096,96,Home,L 93-104 ,240,33,91,0.363,22,68,0.324,11,23,0.478,16,24,0.667,93,37,79,0.468,28,58,0.483,9,21,0.429,21,27,0.778,104,2014-11-30,DET,GSW
10097,97,@,W 93-90 ,240,35,76,0.461,30,61,0.492,5,15,0.333,18,25,0.72,93,34,85,0.4,27,59,0.458,7,26,0.269,15,18,0.833,90,2014-11-30,ORL,PHO
10098,98,@,L 93-107 ,240,39,90,0.433,37,81,0.457,2,9,0.222,13,20,0.65,93,39,86,0.453,27,53,0.509,12,33,0.364,17,25,0.68,107,2014-11-30,MIN,POR
10099,99,Home,L 93-98 ,240,35,81,0.432,24,53,0.453,11,28,0.393,12,14,0.857,93,39,89,0.438,33,72,0.458,6,17,0.353,14,20,0.7,98,2014-12-02,NYK,BRK
10100,0,@,L 93-95 (OT),265,36,101,0.356,24,69,0.348,12,32,0.375,9,12,0.75,93,37,90,0.411,28,71,0.394,9,19,0.474,12,18,0.667,95,2014-12-03,SAS,BRK
10101,1,Home,L 93-98 ,240,36,79,0.456,28,63,0.444,8,16,0.5,13,21,0.619,93,37,74,0.5,30,57,0.526,7,17,0.412,17,20,0.85,98,2014-12-05,UTA,ORL
10102,2,@,L 93-101 ,240,34,93,0.366,23,66,0.348,11,27,0.407,14,21,0.667,93,36,88,0.409,28,71,0.394,8,17,0.471,21,26,0.808,101,2014-12-07,WAS,BOS
10103,3,@,L 93-104 ,240,37,78,0.474,28,59,0.475,9,19,0.474,10,13,0.769,93,40,80,0.5,36,65,0.554,4,15,0.267,20,26,0.769,104,2014-12-09,NYK,NOP
10104,4,@,L 93-105 ,240,37,90,0.411,28,55,0.509,9,35,0.257,10,15,0.667,93,40,81,0.494,32,58,0.552,8,23,0.348,17,20,0.85,105,2014-12-10,HOU,GSW
10105,5,@,W 93-75 ,240,33,71,0.465,24,53,0.453,9,18,0.5,18,21,0.857,93,28,80,0.35,24,58,0.414,4,22,0.182,15,18,0.833,75,2014-12-14,CHI,MIA
10106,6,Home,W 93-84 ,240,41,84,0.488,37,71,0.521,4,13,0.308,7,12,0.583,93,30,78,0.385,25,61,0.41,5,17,0.294,19,28,0.679,84,2014-12-14,WAS,UTA
10107,7,Home,W 93-86 ,240,36,83,0.434,29,62,0.468,7,21,0.333,14,17,0.824,93,35,93,0.376,29,64,0.453,6,29,0.207,10,14,0.714,86,2014-12-15,ATL,CHI
10108,8,@,L 93-99 ,240,32,77,0.416,29,64,0.453,3,13,0.231,26,26,1.0,93,37,86,0.43,28,60,0.467,9,26,0.346,16,20,0.8,99,2014-12-20,SAS,DAL
10109,9,@,L 93-113 ,240,36,92,0.391,31,76,0.408,5,16,0.313,16,21,0.762,93,42,86,0.488,32,62,0.516,10,24,0.417,19,25,0.76,113,2014-12-25,LAL,CHI
10110,10,@,L 93-114 ,240,36,81,0.444,33,67,0.493,3,14,0.214,18,33,0.545,93,42,88,0.477,24,45,0.533,18,43,0.419,12,14,0.857,114,2014-12-26,PHI,POR
10111,11,@,L 93-95 (OT),265,34,89,0.382,26,61,0.426,8,28,0.286,17,20,0.85,93,39,89,0.438,33,65,0.508,6,24,0.25,11,18,0.611,95,2014-12-31,NOP,SAS
10112,12,Home,L 93-105 ,240,34,82,0.415,24,53,0.453,10,29,0.345,15,19,0.789,93,39,86,0.453,27,52,0.519,12,34,0.353,15,24,0.625,105,2015-01-07,CLE,HOU
10113,13,Home,W 93-90 ,240,33,74,0.446,26,57,0.456,7,17,0.412,20,26,0.769,93,35,88,0.398,27,66,0.409,8,22,0.364,12,16,0.75,90,2015-01-07,DEN,ORL
10114,14,@,L 93-98 ,240,37,88,0.42,28,57,0.491,9,31,0.29,10,10,1.0,93,34,80,0.425,23,47,0.489,11,33,0.333,19,26,0.731,98,2015-01-10,BRK,DET
10115,15,Home,L 93-108 ,240,32,81,0.395,29,66,0.439,3,15,0.2,26,26,1.0,93,41,84,0.488,32,60,0.533,9,24,0.375,17,20,0.85,108,2015-01-10,MIN,SAS
10116,16,Home,W 93-92 ,240,32,80,0.4,21,56,0.375,11,24,0.458,18,25,0.72,93,29,87,0.333,25,69,0.362,4,18,0.222,30,42,0.714,92,2015-01-10,PHI,IND
10117,17,@,L 93-101 ,240,38,96,0.396,29,67,0.433,9,29,0.31,8,12,0.667,93,37,75,0.493,31,63,0.492,6,12,0.5,21,24,0.875,101,2015-01-13,SAS,WAS
10118,18,Home,L 93-98 ,240,33,86,0.384,29,73,0.397,4,13,0.308,23,35,0.657,93,37,85,0.435,29,64,0.453,8,21,0.381,16,20,0.8,98,2015-01-14,CHA,SAS
10119,19,Home,L 93-95 ,240,31,72,0.431,24,47,0.511,7,25,0.28,24,29,0.828,93,39,82,0.476,34,65,0.523,5,17,0.294,12,20,0.6,95,2015-01-18,TOR,NOP
10120,20,Home,W 93-82 ,240,37,84,0.44,28,54,0.519,9,30,0.3,10,14,0.714,93,29,82,0.354,20,47,0.426,9,35,0.257,15,26,0.577,82,2015-01-19,ATL,DET
10121,21,@,L 93-102 ,240,33,84,0.393,21,55,0.382,12,29,0.414,15,21,0.714,93,39,82,0.476,30,61,0.492,9,21,0.429,15,19,0.789,102,2015-01-19,BOS,LAC
10122,22,@,L 93-103 ,240,36,87,0.414,26,61,0.426,10,26,0.385,11,18,0.611,93,40,83,0.482,30,58,0.517,10,25,0.4,13,13,1.0,103,2015-01-23,OKC,ATL
10123,23,@,W 93-85 ,240,39,85,0.459,29,68,0.426,10,17,0.588,5,7,0.714,93,32,82,0.39,29,67,0.433,3,15,0.2,18,24,0.75,85,2015-01-28,DEN,NOP
10124,24,@,W 93-87 ,240,35,84,0.417,27,54,0.5,8,30,0.267,15,20,0.75,93,32,90,0.356,25,66,0.379,7,24,0.292,16,23,0.696,87,2015-01-30,HOU,BOS
10125,25,@,W 93-72 ,240,34,82,0.415,21,53,0.396,13,29,0.448,12,20,0.6,93,29,88,0.33,20,59,0.339,9,29,0.31,5,10,0.5,72,2015-01-30,DAL,MIA
10126,26,@,L 93-99 ,240,36,87,0.414,32,69,0.464,4,18,0.222,17,27,0.63,93,39,90,0.433,33,68,0.485,6,22,0.273,15,17,0.882,99,2015-01-30,CHI,PHO
10127,27,Home,L 93-108 ,240,33,78,0.423,25,54,0.463,8,24,0.333,19,24,0.792,93,42,74,0.568,31,53,0.585,11,21,0.524,13,22,0.591,108,2015-01-31,ORL,DAL
10128,28,Home,L 93-109 ,240,35,79,0.443,25,46,0.543,10,33,0.303,13,18,0.722,93,40,81,0.494,31,62,0.5,9,19,0.474,20,23,0.87,109,2015-02-04,TOR,BRK
10129,29,@,L 93-100 ,240,37,80,0.463,30,60,0.5,7,20,0.35,12,18,0.667,93,38,84,0.452,24,57,0.421,14,27,0.519,10,14,0.714,100,2015-02-06,UTA,PHO
10130,30,@,L 93-96 ,240,36,86,0.419,29,57,0.509,7,29,0.241,14,20,0.7,93,37,75,0.493,29,55,0.527,8,20,0.4,14,19,0.737,96,2015-02-07,BOS,MIL
10131,31,Home,L 93-95 ,240,36,88,0.409,28,67,0.418,8,21,0.381,13,13,1.0,93,37,89,0.416,31,64,0.484,6,25,0.24,15,17,0.882,95,2015-02-09,IND,SAS
10132,32,@,L 93-113 ,240,34,84,0.405,25,60,0.417,9,24,0.375,16,20,0.8,93,44,78,0.564,34,53,0.642,10,25,0.4,15,19,0.789,113,2015-02-11,MIA,CLE
10133,33,Home,L 93-106 ,240,34,74,0.459,27,59,0.458,7,15,0.467,18,25,0.72,93,40,75,0.533,31,55,0.564,9,20,0.45,17,18,0.944,106,2015-02-11,NOP,IND
10134,34,@,L 93-95 ,240,39,85,0.459,34,64,0.531,5,21,0.238,10,16,0.625,93,31,76,0.408,20,50,0.4,11,26,0.423,22,26,0.846,95,2015-02-11,WAS,TOR
10135,35,Home,L 93-102 ,240,33,82,0.402,24,58,0.414,9,24,0.375,18,30,0.6,93,34,77,0.442,20,40,0.5,14,37,0.378,20,24,0.833,102,2015-02-24,DET,CLE
10136,36,@,W 93-90 (OT),265,32,84,0.381,26,53,0.491,6,31,0.194,23,32,0.719,93,33,78,0.423,27,56,0.482,6,22,0.273,18,31,0.581,90,2015-02-25,MIA,ORL
10137,37,Home,W 93-86 ,240,34,80,0.425,28,63,0.444,6,17,0.353,19,29,0.655,93,33,92,0.359,24,63,0.381,9,29,0.31,11,14,0.786,86,2015-02-27,IND,CLE
10138,38,@,L 93-101 ,240,34,87,0.391,30,70,0.429,4,17,0.235,21,29,0.724,93,40,85,0.471,34,67,0.507,6,18,0.333,15,22,0.682,101,2015-02-27,MIL,LAL
10139,39,@,W 93-91 ,240,34,79,0.43,24,54,0.444,10,25,0.4,15,20,0.75,93,32,81,0.395,25,55,0.455,7,26,0.269,20,21,0.952,91,2015-02-28,ATL,MIA
10140,40,@,L 93-102 ,240,35,74,0.473,25,53,0.472,10,21,0.476,13,16,0.813,93,38,79,0.481,32,63,0.508,6,16,0.375,20,22,0.909,102,2015-03-02,NOP,DAL
10141,41,@,W 93-82 ,240,36,80,0.45,31,55,0.564,5,25,0.2,16,19,0.842,93,33,82,0.402,30,71,0.423,3,11,0.273,13,19,0.684,82,2015-03-03,UTA,MEM
10142,42,@,L 93-102 ,240,34,80,0.425,29,66,0.439,5,14,0.357,20,25,0.8,93,37,73,0.507,23,39,0.59,14,34,0.412,14,25,0.56,102,2015-03-04,MIL,GSW
10143,43,Home,L 93-98 (OT),265,37,96,0.385,26,65,0.4,11,31,0.355,8,18,0.444,93,34,87,0.391,26,55,0.473,8,32,0.25,22,29,0.759,98,2015-03-04,LAC,POR
10144,44,@,L 93-103 ,240,37,102,0.363,31,73,0.425,6,29,0.207,13,17,0.765,93,38,91,0.418,32,63,0.508,6,28,0.214,21,25,0.84,103,2015-03-06,DET,HOU
10145,45,Home,L 93-100 ,240,38,82,0.463,36,68,0.529,2,14,0.143,15,21,0.714,93,38,78,0.487,29,52,0.558,9,26,0.346,15,22,0.682,100,2015-03-08,LAL,DAL
10146,46,Home,W 93-85 ,240,32,75,0.427,29,62,0.468,3,13,0.231,26,30,0.867,93,32,84,0.381,24,49,0.49,8,35,0.229,13,19,0.684,85,2015-03-10,LAL,DET
10147,47,@,W 93-89 ,240,35,83,0.422,27,55,0.491,8,28,0.286,15,21,0.714,93,34,85,0.4,25,61,0.41,9,24,0.375,12,15,0.8,89,2015-03-14,BOS,IND
10148,48,Home,W 93-75 ,240,40,90,0.444,34,72,0.472,6,18,0.333,7,13,0.538,93,32,81,0.395,29,63,0.46,3,18,0.167,8,15,0.533,75,2015-03-22,OKC,MIA
10149,49,@,W 93-86 ,240,34,77,0.442,25,53,0.472,9,24,0.375,16,23,0.696,93,28,69,0.406,23,50,0.46,5,19,0.263,25,37,0.676,86,2015-03-25,MIA,BOS
10150,50,Home,L 93-95 ,240,34,75,0.453,29,60,0.483,5,15,0.333,20,32,0.625,93,40,81,0.494,34,59,0.576,6,22,0.273,9,12,0.75,95,2015-03-25,NOP,HOU
10151,51,@,L 93-106 ,240,36,91,0.396,26,57,0.456,10,34,0.294,11,17,0.647,93,44,76,0.579,40,64,0.625,4,12,0.333,14,22,0.636,106,2015-04-01,PHI,WAS
10152,52,Home,W 93-74 ,240,36,83,0.434,28,67,0.418,8,16,0.5,13,18,0.722,93,28,80,0.35,24,62,0.387,4,18,0.222,14,20,0.7,74,2015-04-03,IND,CHO
10153,53,@,L 93-123 ,240,40,87,0.46,34,70,0.486,6,17,0.353,7,11,0.636,93,47,85,0.553,33,51,0.647,14,34,0.412,15,17,0.882,123,2015-04-03,DEN,SAS
10154,54,@,L 93-100 ,240,35,85,0.412,29,64,0.453,6,21,0.286,17,28,0.607,93,39,83,0.47,36,73,0.493,3,10,0.3,19,23,0.826,100,2015-04-13,ORL,MIA
10155,55,@,L 93-95 ,240,35,80,0.438,26,56,0.464,9,24,0.375,14,20,0.7,93,38,99,0.384,32,72,0.444,6,27,0.222,13,15,0.867,95,2015-04-14,TOR,BOS
10156,56,Home,L 93-103 ,240,31,85,0.365,21,51,0.412,10,34,0.294,21,28,0.75,93,40,87,0.46,29,57,0.509,11,30,0.367,12,16,0.75,103,2015-11-01,LAL,DAL
10157,57,@,L 93-117 ,240,35,92,0.38,26,66,0.394,9,26,0.346,14,19,0.737,93,45,86,0.523,32,61,0.525,13,25,0.52,14,18,0.778,117,2015-11-01,DEN,OKC
10158,58,Home,L 93-102 (OT),265,33,93,0.355,22,61,0.361,11,32,0.344,16,23,0.696,93,39,96,0.406,32,80,0.4,7,16,0.438,17,27,0.63,102,2015-11-07,CHI,MIN
10159,59,@,L 93-95 ,240,42,86,0.488,38,65,0.585,4,21,0.19,5,7,0.714,93,35,84,0.417,27,61,0.443,8,23,0.348,17,28,0.607,95,2015-11-11,NYK,CHO
10160,60,@,L 93-106 ,240,36,76,0.474,30,56,0.536,6,20,0.3,15,20,0.75,93,42,103,0.408,31,70,0.443,11,33,0.333,11,12,0.917,106,2015-11-13,ATL,BOS
10161,61,@,L 93-102 ,240,34,87,0.391,26,62,0.419,8,25,0.32,17,23,0.739,93,32,76,0.421,22,49,0.449,10,27,0.37,28,31,0.903,102,2015-11-13,UTA,ORL
10162,62,Home,W 93-80 ,240,38,89,0.427,31,66,0.47,7,23,0.304,10,13,0.769,93,31,75,0.413,24,56,0.429,7,19,0.368,11,13,0.846,80,2015-11-16,SAS,POR
10163,63,Home,W 93-89 ,240,35,72,0.486,28,50,0.56,7,22,0.318,16,22,0.727,93,34,80,0.425,29,60,0.483,5,20,0.25,16,18,0.889,89,2015-11-18,UTA,TOR
10164,64,@,L 93-102 ,240,35,80,0.438,29,60,0.483,6,20,0.3,17,21,0.81,93,39,83,0.47,31,55,0.564,8,28,0.286,16,17,0.941,102,2015-11-20,UTA,DAL
10165,65,@,W 93-90 ,240,33,72,0.458,21,52,0.404,12,20,0.6,15,23,0.652,93,35,92,0.38,32,63,0.508,3,29,0.103,17,23,0.739,90,2015-11-20,NYK,OKC
10166,66,Home,L 93-107 ,240,32,88,0.364,26,70,0.371,6,18,0.333,23,27,0.852,93,43,87,0.494,35,62,0.565,8,25,0.32,13,17,0.765,107,2015-11-22,LAL,POR
10167,67,@,W 93-88 ,240,33,86,0.384,26,68,0.382,7,18,0.389,20,23,0.87,93,31,88,0.352,25,66,0.379,6,22,0.273,20,27,0.741,88,2015-11-24,CHI,POR
10168,68,Home,L 93-102 ,240,30,71,0.423,20,37,0.541,10,34,0.294,23,27,0.852,93,39,80,0.488,36,64,0.563,3,16,0.188,21,23,0.913,102,2015-11-25,HOU,MEM
10169,69,Home,L 93-96 ,240,29,77,0.377,25,58,0.431,4,19,0.211,31,38,0.816,93,38,86,0.442,33,69,0.478,5,17,0.294,15,20,0.75,96,2015-12-01,MIN,ORL
10170,70,@,L 93-95 ,240,36,82,0.439,27,51,0.529,9,31,0.29,12,17,0.706,93,36,90,0.4,31,75,0.413,5,15,0.333,18,24,0.75,95,2015-12-06,PHO,MEM
10171,71,Home,L 93-111 ,240,37,90,0.411,33,77,0.429,4,13,0.308,15,18,0.833,93,40,81,0.494,28,53,0.528,12,28,0.429,19,24,0.792,111,2015-12-07,NOP,BOS
10172,72,@,L 93-102 ,240,34,83,0.41,27,64,0.422,7,19,0.368,18,20,0.9,93,34,74,0.459,25,49,0.51,9,25,0.36,25,32,0.781,102,2015-12-07,LAL,TOR
10173,73,@,W 93-92 ,240,41,88,0.466,37,73,0.507,4,15,0.267,7,13,0.538,93,37,87,0.425,29,58,0.5,8,29,0.276,10,15,0.667,92,2015-12-09,MEM,DET
10174,74,Home,L 93-98 ,240,36,88,0.409,25,53,0.472,11,35,0.314,10,10,1.0,93,40,96,0.417,31,71,0.437,9,25,0.36,9,10,0.9,98,2015-12-12,CHA,BOS
10175,75,@,W 93-92 ,240,35,78,0.449,20,48,0.417,15,30,0.5,8,14,0.571,93,39,88,0.443,35,70,0.5,4,18,0.222,10,12,0.833,92,2015-12-22,DET,MIA
10176,76,Home,L 93-99 ,240,35,91,0.385,29,66,0.439,6,25,0.24,17,25,0.68,93,39,84,0.464,35,61,0.574,4,23,0.174,17,23,0.739,99,2015-12-26,DET,BOS
10177,77,@,L 93-103 ,240,38,79,0.481,34,65,0.523,4,14,0.286,13,15,0.867,93,38,84,0.452,28,62,0.452,10,22,0.455,17,26,0.654,103,2015-12-28,MIL,DAL
10178,78,Home,W 93-87 ,240,38,87,0.437,31,61,0.508,7,26,0.269,10,18,0.556,93,31,74,0.419,25,49,0.51,6,25,0.24,19,25,0.76,87,2015-12-28,IND,ATL
10179,79,@,W 93-87 ,240,38,86,0.442,34,64,0.531,4,22,0.182,13,22,0.591,93,37,89,0.416,32,65,0.492,5,24,0.208,8,11,0.727,87,2015-12-29,CLE,DEN
10180,80,@,L 93-100 ,240,35,83,0.422,32,63,0.508,3,20,0.15,20,22,0.909,93,36,82,0.439,27,56,0.482,9,26,0.346,19,21,0.905,100,2015-12-30,BRK,ORL
10181,81,Home,W 93-84 ,240,33,87,0.379,28,71,0.394,5,16,0.313,22,29,0.759,93,31,84,0.369,27,60,0.45,4,24,0.167,18,25,0.72,84,2016-01-01,LAL,PHI
10182,82,@,W 93-91 ,240,33,68,0.485,22,42,0.524,11,26,0.423,16,21,0.762,93,30,75,0.4,18,46,0.391,12,29,0.414,19,25,0.76,91,2016-01-04,HOU,UTA
10183,83,@,W 93-87 ,240,36,77,0.468,30,57,0.526,6,20,0.3,15,21,0.714,93,33,79,0.418,29,63,0.46,4,16,0.25,17,22,0.773,87,2016-01-10,DAL,MIN
10184,84,@,L 93-113 ,240,34,85,0.4,29,73,0.397,5,12,0.417,20,23,0.87,93,47,89,0.528,42,66,0.636,5,23,0.217,14,22,0.636,113,2016-01-15,MIN,OKC
10185,85,Home,L 93-112 ,240,32,90,0.356,28,65,0.431,4,25,0.16,25,31,0.806,93,43,89,0.483,37,69,0.536,6,20,0.3,20,28,0.714,112,2016-01-20,LAL,SAC
10186,86,@,L 93-115 ,240,33,70,0.471,25,50,0.5,8,20,0.4,19,25,0.76,93,45,81,0.556,34,53,0.642,11,28,0.393,14,16,0.875,115,2016-01-27,PHO,CLE
10187,87,@,L 93-103 ,240,38,87,0.437,31,69,0.449,7,18,0.389,10,20,0.5,93,37,85,0.435,29,65,0.446,8,20,0.4,21,29,0.724,103,2016-01-28,NYK,TOR
10188,88,@,L 93-105 ,240,34,78,0.436,29,65,0.446,5,13,0.385,20,25,0.8,93,40,81,0.494,32,55,0.582,8,26,0.308,17,24,0.708,105,2016-01-29,LAL,LAC
10189,89,@,L 93-120 ,240,40,93,0.43,35,78,0.449,5,15,0.333,8,11,0.727,93,45,84,0.536,28,52,0.538,17,32,0.531,13,19,0.684,120,2016-01-31,CHI,LAC
10190,90,@,L 93-96 ,240,35,80,0.438,31,64,0.484,4,16,0.25,19,28,0.679,93,32,76,0.421,26,49,0.531,6,27,0.222,26,30,0.867,96,2016-01-31,MIN,POR
10191,91,@,L 93-112 ,240,29,78,0.372,21,53,0.396,8,25,0.32,27,39,0.692,93,45,83,0.542,35,61,0.574,10,22,0.455,12,15,0.8,112,2016-02-01,TOR,DEN
10192,92,@,W 93-90 ,240,37,88,0.42,35,73,0.479,2,15,0.133,17,23,0.739,93,34,87,0.391,26,67,0.388,8,20,0.4,14,19,0.737,90,2016-02-03,MIA,DAL
10193,93,Home,L 93-107 ,240,34,81,0.42,30,61,0.492,4,20,0.2,21,28,0.75,93,40,74,0.541,32,47,0.681,8,27,0.296,19,23,0.826,107,2016-02-05,ORL,LAC
10194,94,Home,L 93-100 ,240,33,83,0.398,26,66,0.394,7,17,0.412,20,29,0.69,93,37,81,0.457,28,56,0.5,9,25,0.36,17,33,0.515,100,2016-02-07,MIA,LAC
10195,95,@,L 93-111 ,240,30,81,0.37,23,56,0.411,7,25,0.28,26,36,0.722,93,37,68,0.544,27,45,0.6,10,23,0.435,27,44,0.614,111,2016-02-19,BOS,UTA
10196,96,@,L 93-101 (OT),265,36,92,0.391,31,77,0.403,5,15,0.333,16,25,0.64,93,38,100,0.38,36,87,0.414,2,13,0.154,23,34,0.676,101,2016-02-22,IND,MIA
10197,97,@,L 93-116 ,240,34,84,0.405,23,55,0.418,11,29,0.379,14,20,0.7,93,43,107,0.402,36,81,0.444,7,26,0.269,23,24,0.958,116,2016-03-02,POR,BOS
10198,98,@,L 93-114 ,240,35,80,0.438,28,56,0.5,7,24,0.292,16,22,0.727,93,38,67,0.567,29,51,0.569,9,16,0.563,29,38,0.763,114,2016-03-11,WAS,UTA
10199,99,Home,W 93-85 ,240,34,85,0.4,30,61,0.492,4,24,0.167,21,25,0.84,93,31,81,0.383,29,63,0.46,2,18,0.111,21,25,0.84,85,2016-03-12,SAS,OKC
10200,0,Home,L 93-101 ,240,35,83,0.422,26,51,0.51,9,32,0.281,14,20,0.7,93,38,87,0.437,29,69,0.42,9,18,0.5,16,23,0.696,101,2016-03-19,CHA,DEN
10201,1,@,W 93-84 ,240,39,83,0.47,30,62,0.484,9,21,0.429,6,7,0.857,93,32,84,0.381,28,73,0.384,4,11,0.364,16,19,0.842,84,2016-03-26,UTA,MIN
10202,2,Home,L 93-107 ,240,33,79,0.418,25,56,0.446,8,23,0.348,19,28,0.679,93,37,83,0.446,23,49,0.469,14,34,0.412,19,25,0.76,107,2016-03-26,NYK,CLE
10203,3,@,L 93-105 ,240,37,89,0.416,30,74,0.405,7,15,0.467,12,19,0.632,93,38,80,0.475,24,51,0.471,14,29,0.483,15,18,0.833,105,2016-03-28,SAC,POR
10204,4,@,L 93-110 ,240,34,88,0.386,28,69,0.406,6,19,0.316,19,27,0.704,93,41,79,0.519,31,64,0.484,10,15,0.667,18,23,0.783,110,2016-04-02,MIA,POR
10205,5,@,L 93-107 ,240,37,82,0.451,30,64,0.469,7,18,0.389,12,16,0.75,93,40,88,0.455,27,54,0.5,13,34,0.382,14,17,0.824,107,2016-04-05,NOP,PHI
10206,6,@,L 93-103 ,240,35,87,0.402,28,65,0.431,7,22,0.318,16,22,0.727,93,30,60,0.5,18,29,0.621,12,31,0.387,31,39,0.795,103,2016-04-08,MEM,DAL
10207,7,@,W 93-89 ,240,37,78,0.474,30,58,0.517,7,20,0.35,12,19,0.632,93,32,89,0.36,25,69,0.362,7,20,0.35,18,21,0.857,89,2016-04-10,TOR,NYK
10208,8,Home,L 93-99 ,240,34,84,0.405,29,66,0.439,5,18,0.278,20,30,0.667,93,38,78,0.487,31,58,0.534,7,20,0.35,16,22,0.727,99,2016-04-12,DET,MIA
10209,9,Home,W 93-92 ,240,34,80,0.425,23,49,0.469,11,31,0.355,14,21,0.667,93,32,84,0.381,21,54,0.389,11,30,0.367,17,20,0.85,92,2016-10-30,HOU,DAL
10210,10,@,L 93-109 ,240,34,86,0.395,22,48,0.458,12,38,0.316,13,15,0.867,93,39,79,0.494,26,45,0.578,13,34,0.382,18,26,0.692,109,2016-11-02,PHI,CHO
10211,11,@,L 93-118 ,240,35,81,0.432,25,50,0.5,10,31,0.323,13,22,0.591,93,46,92,0.5,36,71,0.507,10,21,0.476,16,20,0.8,118,2016-11-09,BOS,WAS
10212,12,@,L 93-100 ,240,36,95,0.379,25,66,0.379,11,29,0.379,10,12,0.833,93,39,92,0.424,25,54,0.463,14,38,0.368,8,15,0.533,100,2016-11-13,CHA,CLE
10213,13,Home,W 93-77 ,240,34,78,0.436,25,53,0.472,9,25,0.36,16,18,0.889,93,32,84,0.381,27,57,0.474,5,27,0.185,8,11,0.727,77,2016-11-14,NYK,DAL
10214,14,@,W 93-90 ,240,37,80,0.463,31,63,0.492,6,17,0.353,13,19,0.684,93,36,89,0.404,29,66,0.439,7,23,0.304,11,14,0.786,90,2016-11-15,ATL,MIA
10215,15,@,L 93-103 ,240,35,86,0.407,24,56,0.429,11,30,0.367,12,20,0.6,93,43,86,0.5,33,58,0.569,10,28,0.357,7,11,0.636,103,2016-11-16,CLE,IND
10216,16,Home,W 93-71 ,240,29,76,0.382,27,58,0.466,2,18,0.111,33,38,0.868,93,25,64,0.391,18,42,0.429,7,22,0.318,14,22,0.636,71,2016-11-19,MEM,MIN
10217,17,Home,W 93-89 ,240,35,86,0.407,27,57,0.474,8,29,0.276,15,21,0.714,93,32,77,0.416,25,52,0.481,7,25,0.28,18,24,0.75,89,2016-11-21,MIL,ORL
10218,18,Home,L 93-99 ,240,36,86,0.419,32,62,0.516,4,24,0.167,17,25,0.68,93,38,84,0.452,26,46,0.565,12,38,0.316,11,14,0.786,99,2016-11-21,MIN,BOS
10219,19,Home,L 93-111 ,240,34,89,0.382,22,49,0.449,12,40,0.3,13,16,0.813,93,36,80,0.45,21,46,0.457,15,34,0.441,24,29,0.828,111,2016-12-01,BRK,MIL
10220,20,Home,W 93-85 ,240,35,81,0.432,23,58,0.397,12,23,0.522,11,16,0.688,93,28,75,0.373,19,50,0.38,9,25,0.36,20,31,0.645,85,2016-12-14,MEM,CLE
10221,21,Home,L 93-108 ,240,33,82,0.402,22,49,0.449,11,33,0.333,16,21,0.762,93,40,93,0.43,30,76,0.395,10,17,0.588,18,26,0.692,108,2016-12-20,PHI,NOP
10222,22,Home,L 93-94 ,240,33,74,0.446,24,47,0.511,9,27,0.333,18,22,0.818,93,34,74,0.459,24,53,0.453,10,21,0.476,16,24,0.667,94,2016-12-21,UTA,SAC
10223,23,Home,W 93-91 ,240,33,85,0.388,26,53,0.491,7,32,0.219,20,25,0.8,93,33,82,0.402,26,58,0.448,7,24,0.292,18,20,0.9,91,2017-01-03,PHI,MIN
10224,24,@,L 93-101 ,240,34,73,0.466,27,53,0.509,7,20,0.35,18,21,0.857,93,36,91,0.396,28,70,0.4,8,21,0.381,21,28,0.75,101,2017-01-05,UTA,TOR
10225,25,Home,L 93-100 ,240,38,91,0.418,30,68,0.441,8,23,0.348,9,13,0.692,93,39,86,0.453,24,37,0.649,15,49,0.306,7,12,0.583,100,2017-01-06,ORL,HOU
10226,26,@,L 93-102 ,240,28,85,0.329,22,62,0.355,6,23,0.261,31,32,0.969,93,36,76,0.474,22,38,0.579,14,38,0.368,16,20,0.8,102,2017-01-13,CHA,PHI
10227,27,@,L 93-109 ,240,36,87,0.414,26,56,0.464,10,31,0.323,11,21,0.524,93,44,91,0.484,36,74,0.486,8,17,0.471,13,18,0.722,109,2017-01-14,PHI,WAS
10228,28,@,L 93-102 ,240,34,81,0.42,27,53,0.509,7,28,0.25,18,19,0.947,93,39,82,0.476,30,60,0.5,9,22,0.409,15,19,0.789,102,2017-01-20,CHI,ATL
10229,29,Home,W 93-92 ,240,36,92,0.391,24,63,0.381,12,29,0.414,9,16,0.563,93,33,89,0.371,27,70,0.386,6,19,0.316,20,28,0.714,92,2017-01-20,PHI,POR
10230,30,@,L 93-110 ,240,33,78,0.423,21,49,0.429,12,29,0.414,15,18,0.833,93,45,91,0.495,38,71,0.535,7,20,0.35,13,23,0.565,110,2017-01-21,PHI,ATL
10231,31,@,L 93-103 ,240,35,85,0.412,28,63,0.444,7,22,0.318,16,21,0.762,93,35,76,0.461,25,50,0.5,10,26,0.385,23,31,0.742,103,2017-01-24,UTA,DEN
10232,32,@,L 93-116 ,240,34,86,0.395,27,60,0.45,7,26,0.269,18,21,0.857,93,45,93,0.484,33,61,0.541,12,32,0.375,14,19,0.737,116,2017-02-01,ATL,MIA
10233,33,Home,W 93-90 ,240,33,87,0.379,25,61,0.41,8,26,0.308,19,29,0.655,93,34,88,0.386,27,60,0.45,7,28,0.25,15,21,0.714,90,2017-02-06,IND,OKC
10234,34,@,L 93-110 ,240,40,101,0.396,33,66,0.5,7,35,0.2,6,14,0.429,93,44,97,0.454,34,73,0.466,10,24,0.417,12,17,0.706,110,2017-02-24,LAL,OKC
10235,35,@,L 93-104 ,240,39,84,0.464,32,64,0.5,7,20,0.35,8,12,0.667,93,37,86,0.43,29,60,0.483,8,26,0.308,22,28,0.786,104,2017-03-08,NYK,MIL
10236,36,Home,W 92-78 ,240,35,77,0.455,29,61,0.475,6,16,0.375,16,24,0.667,92,28,70,0.4,24,49,0.49,4,21,0.19,18,25,0.72,78,2011-12-28,GSW,NYK
10237,37,Home,W 92-89 ,240,39,86,0.453,37,62,0.597,2,24,0.083,12,15,0.8,92,34,80,0.425,27,54,0.5,7,26,0.269,14,22,0.636,89,2011-12-31,LAL,DEN
10238,38,Home,L 92-114 ,240,30,86,0.349,24,64,0.375,6,22,0.273,26,41,0.634,92,40,89,0.449,30,61,0.492,10,28,0.357,24,27,0.889,114,2011-12-31,SAC,NYK
10239,39,@,L 92-100 ,240,35,83,0.422,32,72,0.444,3,11,0.273,19,23,0.826,92,38,83,0.458,28,63,0.444,10,20,0.5,14,21,0.667,100,2012-01-02,WAS,BOS
10240,40,Home,L 92-100 ,240,34,73,0.466,29,60,0.483,5,13,0.385,19,28,0.679,92,39,82,0.476,30,66,0.455,9,16,0.563,13,20,0.65,100,2012-01-02,MIA,ATL
10241,41,Home,W 92-77 ,240,36,77,0.468,26,50,0.52,10,27,0.37,10,13,0.769,92,24,81,0.296,17,58,0.293,7,23,0.304,22,26,0.846,77,2012-01-04,TOR,CLE
10242,42,Home,W 92-86 ,240,31,69,0.449,27,50,0.54,4,19,0.211,26,40,0.65,92,29,80,0.363,23,60,0.383,6,20,0.3,22,27,0.815,86,2012-01-07,LAC,MIL
10243,43,Home,W 92-68 ,240,34,74,0.459,31,58,0.534,3,16,0.188,21,25,0.84,92,28,71,0.394,27,67,0.403,1,4,0.25,11,14,0.786,68,2012-01-09,CHI,DET
10244,44,@,L 92-97 ,240,32,85,0.376,24,61,0.393,8,24,0.333,20,25,0.8,92,37,76,0.487,32,62,0.516,5,14,0.357,18,23,0.783,97,2012-01-13,CLE,LAL
10245,45,@,L 92-104 ,240,34,83,0.41,29,64,0.453,5,19,0.263,19,23,0.826,92,34,71,0.479,27,53,0.509,7,18,0.389,29,34,0.853,104,2012-01-14,NYK,OKC
10246,46,Home,W 92-89 ,240,33,71,0.465,28,60,0.467,5,11,0.455,21,27,0.778,92,35,92,0.38,30,73,0.411,5,19,0.263,14,20,0.7,89,2012-01-18,ATL,POR
10247,47,Home,W 92-88 ,240,28,93,0.301,20,62,0.323,8,31,0.258,28,41,0.683,92,34,78,0.436,33,65,0.508,1,13,0.077,19,27,0.704,88,2012-01-18,SAC,IND
10248,48,Home,W 92-80 ,240,32,77,0.416,20,50,0.4,12,27,0.444,16,26,0.615,92,29,76,0.382,23,56,0.411,6,20,0.3,16,22,0.727,80,2012-01-20,ORL,LAL
10249,49,@,L 92-113 ,240,37,83,0.446,29,68,0.426,8,15,0.533,10,15,0.667,92,44,81,0.543,37,65,0.569,7,16,0.438,18,21,0.857,113,2012-01-21,PHI,MIA
10250,50,Home,L 92-97 ,240,37,92,0.402,32,75,0.427,5,17,0.294,13,17,0.765,92,38,83,0.458,35,72,0.486,3,11,0.273,18,21,0.857,97,2012-01-23,MIL,ATL
10251,51,Home,L 92-107 ,240,33,80,0.413,28,68,0.412,5,12,0.417,21,27,0.778,92,39,86,0.453,32,65,0.492,7,21,0.333,22,28,0.786,107,2012-01-23,MIN,HOU
10252,52,Home,W 92-85 ,240,32,70,0.457,27,52,0.519,5,18,0.278,23,26,0.885,92,34,68,0.5,28,52,0.538,6,16,0.375,11,17,0.647,85,2012-01-24,MIA,CLE
10253,53,Home,W 92-75 ,240,39,83,0.47,36,73,0.493,3,10,0.3,11,16,0.688,92,28,78,0.359,27,69,0.391,1,9,0.111,18,25,0.72,75,2012-01-25,WAS,CHA
10254,54,@,L 92-95 ,240,40,88,0.455,36,70,0.514,4,18,0.222,8,16,0.5,92,34,76,0.447,29,59,0.492,5,17,0.294,22,29,0.759,95,2012-02-02,POR,SAC
10255,55,@,L 92-99 ,240,30,72,0.417,20,46,0.435,10,26,0.385,22,26,0.846,92,37,83,0.446,35,69,0.507,2,14,0.143,23,26,0.885,99,2012-02-04,BRK,NYK
10256,56,Home,L 92-100 ,240,34,81,0.42,31,72,0.431,3,9,0.333,21,26,0.808,92,37,78,0.474,29,54,0.537,8,24,0.333,18,25,0.72,100,2012-02-06,NOP,SAC
10257,57,@,L 92-99 ,240,32,78,0.41,29,63,0.46,3,15,0.2,25,29,0.862,92,36,71,0.507,29,53,0.547,7,18,0.389,20,26,0.769,99,2012-02-08,LAC,CLE
10258,58,Home,L 92-99 ,240,33,78,0.423,23,51,0.451,10,27,0.37,16,20,0.8,92,39,73,0.534,37,64,0.578,2,9,0.222,19,29,0.655,99,2012-02-08,BRK,DET
10259,59,@,L 92-109 ,240,31,74,0.419,26,55,0.473,5,19,0.263,25,31,0.806,92,43,79,0.544,39,69,0.565,4,10,0.4,19,25,0.76,109,2012-02-10,BRK,DET
10260,60,@,L 92-98 ,240,30,78,0.385,24,62,0.387,6,16,0.375,26,37,0.703,92,34,73,0.466,33,64,0.516,1,9,0.111,29,37,0.784,98,2012-02-10,IND,MEM
10261,61,Home,W 92-85 ,240,33,77,0.429,28,56,0.5,5,21,0.238,21,34,0.618,92,30,80,0.375,24,56,0.429,6,24,0.25,19,23,0.826,85,2012-02-10,NYK,LAL
10262,62,Home,L 92-94 ,240,37,78,0.474,31,67,0.463,6,11,0.545,12,17,0.706,92,35,81,0.432,25,58,0.431,10,23,0.435,14,20,0.7,94,2012-02-12,TOR,LAL
10263,63,@,L 92-96 ,240,33,74,0.446,23,47,0.489,10,27,0.37,16,25,0.64,92,35,79,0.443,29,61,0.475,6,18,0.333,20,28,0.714,96,2012-02-13,LAC,DAL
10264,64,@,L 92-109 ,240,33,99,0.333,24,75,0.32,9,24,0.375,17,19,0.895,92,40,78,0.513,36,64,0.563,4,14,0.286,25,34,0.735,109,2012-02-14,PHO,DEN
10265,65,@,W 92-89 ,240,36,80,0.45,29,65,0.446,7,15,0.467,13,17,0.765,92,33,86,0.384,26,68,0.382,7,18,0.389,16,18,0.889,89,2012-02-15,NOP,MIL
10266,66,@,L 92-93 ,240,35,93,0.376,31,74,0.419,4,19,0.211,18,25,0.72,92,32,89,0.36,25,67,0.373,7,22,0.318,22,30,0.733,93,2012-02-19,SAC,CLE
10267,67,Home,W 92-91 ,240,33,85,0.388,30,69,0.435,3,16,0.188,23,26,0.885,92,40,90,0.444,37,79,0.468,3,11,0.273,8,10,0.8,91,2012-02-19,MIN,PHI
10268,68,@,W 92-85 ,240,33,86,0.384,26,67,0.388,7,19,0.368,19,24,0.792,92,29,85,0.341,24,62,0.387,5,23,0.217,22,33,0.667,85,2012-02-19,MIL,NJN
10269,69,@,L 92-103 ,240,32,78,0.41,20,55,0.364,12,23,0.522,16,22,0.727,92,38,83,0.458,30,64,0.469,8,19,0.421,19,22,0.864,103,2012-02-20,POR,LAL
10270,70,Home,L 92-100 ,240,34,85,0.4,29,64,0.453,5,21,0.238,19,26,0.731,92,32,82,0.39,17,51,0.333,15,31,0.484,21,29,0.724,100,2012-02-20,NYK,NJN
10271,71,Home,L 92-93 ,240,32,89,0.36,24,64,0.375,8,25,0.32,20,28,0.714,92,37,84,0.44,30,59,0.508,7,25,0.28,12,14,0.857,93,2012-02-28,DAL,NJN
10272,72,@,W 92-88 ,240,30,78,0.385,24,59,0.407,6,19,0.316,26,34,0.765,92,37,90,0.411,33,73,0.452,4,17,0.235,10,12,0.833,88,2012-02-29,OKC,PHI
10273,73,@,L 92-97 ,240,37,83,0.446,26,54,0.481,11,29,0.379,7,10,0.7,92,40,88,0.455,37,75,0.493,3,13,0.231,14,17,0.824,97,2012-03-02,DAL,NOH
10274,74,Home,W 92-72 ,240,33,78,0.423,24,63,0.381,9,15,0.6,17,27,0.63,92,27,79,0.342,24,63,0.381,3,16,0.188,15,22,0.682,72,2012-03-05,CHI,IND
10275,75,@,W 92-88 ,240,35,79,0.443,26,51,0.51,9,28,0.321,13,28,0.464,92,32,79,0.405,24,59,0.407,8,20,0.4,16,20,0.8,88,2012-03-05,ORL,TOR
10276,76,@,L 92-97 (OT),265,32,83,0.386,27,64,0.422,5,19,0.263,23,29,0.793,92,35,81,0.432,31,67,0.463,4,14,0.286,23,31,0.742,97,2012-03-06,HOU,BOS
10277,77,Home,L 92-110 ,240,35,79,0.443,27,61,0.443,8,18,0.444,14,23,0.609,92,42,80,0.525,35,61,0.574,7,19,0.368,19,21,0.905,110,2012-03-07,GSW,MEM
10278,78,Home,W 92-75 ,240,40,82,0.488,36,71,0.507,4,11,0.364,8,15,0.533,92,20,64,0.313,15,42,0.357,5,22,0.227,30,38,0.789,75,2012-03-13,IND,POR
10279,79,@,L 92-97 ,240,37,92,0.402,33,70,0.471,4,22,0.182,14,20,0.7,92,33,80,0.413,23,58,0.397,10,22,0.455,21,27,0.778,97,2012-03-16,MIN,LAL
10280,80,@,L 92-99 (OT),265,33,80,0.413,27,55,0.491,6,25,0.24,20,25,0.8,92,42,101,0.416,40,88,0.455,2,13,0.154,13,16,0.813,99,2012-03-17,GSW,UTA
10281,81,@,L 92-97 ,240,37,78,0.474,31,60,0.517,6,18,0.333,12,19,0.632,92,34,85,0.4,32,78,0.41,2,7,0.286,27,37,0.73,97,2012-03-18,WAS,MEM
10282,82,Home,L 92-101 ,240,39,79,0.494,36,70,0.514,3,9,0.333,11,14,0.786,92,39,89,0.438,25,60,0.417,14,29,0.483,9,10,0.9,101,2012-03-21,NOP,GSW
10283,83,Home,L 92-112 ,240,34,84,0.405,33,76,0.434,1,8,0.125,23,26,0.885,92,48,90,0.533,44,77,0.571,4,13,0.308,12,21,0.571,112,2012-03-23,CHA,MIL
10284,84,Home,L 92-95 ,240,38,85,0.447,34,67,0.507,4,18,0.222,12,14,0.857,92,37,76,0.487,30,53,0.566,7,23,0.304,14,21,0.667,95,2012-03-24,WAS,ATL
10285,85,Home,W 92-78 ,240,36,74,0.486,32,65,0.492,4,9,0.444,16,17,0.941,92,30,91,0.33,22,67,0.328,8,24,0.333,10,15,0.667,78,2012-04-01,OKC,CHI
10286,86,Home,W 92-75 ,240,35,71,0.493,32,56,0.571,3,15,0.2,19,21,0.905,92,32,77,0.416,28,68,0.412,4,9,0.444,7,9,0.778,75,2012-04-01,PHO,NOH
10287,87,@,L 92-99 ,240,34,71,0.479,26,51,0.51,8,20,0.4,16,20,0.8,92,37,77,0.481,33,60,0.55,4,17,0.235,21,23,0.913,99,2012-04-01,WAS,TOR
10288,88,Home,W 92-87 ,240,35,76,0.461,28,58,0.483,7,18,0.389,15,22,0.682,92,31,77,0.403,27,65,0.415,4,12,0.333,21,30,0.7,87,2012-04-03,TOR,CHA
10289,89,@,L 92-94 ,240,35,83,0.422,29,63,0.46,6,20,0.3,16,22,0.727,92,35,67,0.522,30,57,0.526,5,10,0.5,19,27,0.704,94,2012-04-04,DEN,NOH
10290,90,Home,W 92-77 ,240,36,81,0.444,27,61,0.443,9,20,0.45,11,16,0.688,92,27,72,0.375,22,50,0.44,5,22,0.227,18,29,0.621,77,2012-04-16,LAC,OKC
10291,91,@,L 92-97 ,240,39,81,0.481,34,69,0.493,5,12,0.417,9,14,0.643,92,37,72,0.514,28,55,0.509,9,17,0.529,14,17,0.824,97,2012-04-20,BOS,ATL
10292,92,Home,L 92-103 ,240,38,93,0.409,33,77,0.429,5,16,0.313,11,18,0.611,92,40,75,0.533,36,63,0.571,4,12,0.333,19,22,0.864,103,2012-04-20,SAC,OKC
10293,93,Home,W 92-86 ,240,29,78,0.372,23,61,0.377,6,17,0.353,28,36,0.778,92,34,76,0.447,30,62,0.484,4,14,0.286,14,18,0.778,86,2012-04-23,MIL,TOR
10294,94,@,W 92-87 ,240,38,81,0.469,32,64,0.5,6,17,0.353,10,10,1.0,92,35,80,0.438,29,66,0.439,6,14,0.429,11,16,0.688,87,2012-04-25,CHI,IND
10295,95,@,L 92-101 ,240,33,86,0.384,31,72,0.431,2,14,0.143,24,30,0.8,92,38,74,0.514,33,59,0.559,5,15,0.333,20,29,0.69,101,2012-10-31,MEM,LAC
10296,96,Home,W 92-80 ,240,32,87,0.368,30,70,0.429,2,17,0.118,26,36,0.722,92,32,89,0.36,29,73,0.397,3,16,0.188,13,16,0.813,80,2012-11-02,MIN,SAC
10297,97,@,L 92-106 ,240,32,89,0.36,23,63,0.365,9,26,0.346,19,24,0.792,92,39,76,0.513,34,67,0.507,5,9,0.556,23,32,0.719,106,2012-11-02,POR,OKC
10298,98,Home,W 92-89 ,240,40,92,0.435,38,81,0.469,2,11,0.182,10,14,0.714,92,37,90,0.411,33,77,0.429,4,13,0.308,11,19,0.579,89,2012-11-02,PHO,DET
10299,99,@,L 92-94 ,240,31,78,0.397,25,57,0.439,6,21,0.286,24,28,0.857,92,37,81,0.457,33,62,0.532,4,19,0.211,16,23,0.696,94,2012-11-05,GSW,SAC
10300,0,Home,L 92-96 ,240,35,88,0.398,32,69,0.464,3,19,0.158,19,26,0.731,92,32,72,0.444,27,57,0.474,5,15,0.333,27,34,0.794,96,2012-11-10,MIL,BOS
10301,1,@,W 92-90 ,240,27,73,0.37,26,63,0.413,1,10,0.1,37,42,0.881,92,33,83,0.398,27,66,0.409,6,17,0.353,18,27,0.667,90,2012-11-12,OKC,DET
10302,2,Home,W 92-76 ,240,31,78,0.397,28,65,0.431,3,13,0.231,27,32,0.844,92,25,84,0.298,20,53,0.377,5,31,0.161,21,32,0.656,76,2012-11-13,CHA,WAS
10303,3,Home,W 92-88 ,240,33,71,0.465,28,53,0.528,5,18,0.278,21,25,0.84,92,34,78,0.436,27,55,0.491,7,23,0.304,13,18,0.722,88,2012-11-14,GSW,ATL
10304,4,Home,L 92-97 ,240,36,78,0.462,30,61,0.492,6,17,0.353,14,17,0.824,92,36,81,0.444,31,66,0.47,5,15,0.333,20,28,0.714,97,2012-11-19,MEM,DEN
10305,5,@,W 92-87 ,240,40,85,0.471,39,73,0.534,1,12,0.083,11,19,0.579,92,29,82,0.354,23,62,0.371,6,20,0.3,23,28,0.821,87,2012-11-19,LAC,SAS
10306,6,Home,W 92-83 ,240,35,86,0.407,22,63,0.349,13,23,0.565,9,14,0.643,92,31,86,0.36,27,69,0.391,4,17,0.235,17,22,0.773,83,2012-11-21,CLE,PHI
10307,7,Home,L 92-93 ,240,35,80,0.438,30,69,0.435,5,11,0.455,17,19,0.895,92,39,85,0.459,36,70,0.514,3,15,0.2,12,19,0.632,93,2012-11-26,CHI,MIL
10308,8,Home,L 92-118 ,240,37,90,0.411,33,76,0.434,4,14,0.286,14,17,0.824,92,45,80,0.563,32,57,0.561,13,23,0.565,15,20,0.75,118,2012-11-26,WAS,SAS
10309,9,Home,L 92-97 ,240,32,75,0.427,26,58,0.448,6,17,0.353,22,25,0.88,92,37,85,0.435,28,59,0.475,9,26,0.346,14,19,0.737,97,2012-11-30,SAC,IND
10310,10,Home,W 92-77 ,240,38,93,0.409,27,68,0.397,11,25,0.44,5,8,0.625,92,29,85,0.341,24,64,0.375,5,21,0.238,14,18,0.778,77,2012-12-01,DAL,DET
10311,11,@,L 92-103 ,240,34,74,0.459,26,52,0.5,8,22,0.364,16,20,0.8,92,38,80,0.475,29,60,0.483,9,20,0.45,18,19,0.947,103,2012-12-01,IND,GSW
10312,12,@,L 92-99 ,240,34,79,0.43,28,57,0.491,6,22,0.273,18,22,0.818,92,36,80,0.45,27,54,0.5,9,26,0.346,18,19,0.947,99,2012-12-05,POR,IND
10313,13,Home,L 92-112 ,240,32,76,0.421,26,60,0.433,6,16,0.375,22,28,0.786,92,41,91,0.451,23,47,0.489,18,44,0.409,12,19,0.632,112,2012-12-06,MIA,NYK
10314,14,@,W 92-89 ,240,38,86,0.442,35,69,0.507,3,17,0.176,13,20,0.65,92,34,76,0.447,24,53,0.453,10,23,0.435,11,18,0.611,89,2012-12-07,DEN,IND
10315,15,@,L 92-114 ,240,37,95,0.389,26,62,0.419,11,33,0.333,7,8,0.875,92,48,87,0.552,42,67,0.627,6,20,0.3,12,13,0.923,114,2012-12-07,HOU,SAS
10316,16,Home,W 92-79 ,240,40,75,0.533,36,61,0.59,4,14,0.286,8,12,0.667,92,31,79,0.392,27,62,0.435,4,17,0.235,13,16,0.813,79,2012-12-08,BOS,PHI
10317,17,@,L 92-101 ,240,32,75,0.427,23,47,0.489,9,28,0.321,19,20,0.95,92,39,67,0.582,30,46,0.652,9,21,0.429,14,22,0.636,101,2012-12-10,ATL,MIA
10318,18,Home,W 92-74 ,240,36,89,0.404,36,69,0.522,0,20,0.0,20,22,0.909,92,26,74,0.351,23,53,0.434,3,21,0.143,19,21,0.905,74,2012-12-10,POR,TOR
10319,19,Home,W 92-88 ,240,31,71,0.437,26,56,0.464,5,15,0.333,25,32,0.781,92,33,83,0.398,24,61,0.393,9,22,0.409,13,16,0.813,88,2012-12-12,OKC,NOH
10320,20,@,W 92-90 ,240,37,83,0.446,32,63,0.508,5,20,0.25,13,16,0.813,92,33,77,0.429,26,60,0.433,7,17,0.412,17,22,0.773,90,2012-12-18,UTA,BRK
10321,21,@,L 92-103 ,240,37,86,0.43,33,69,0.478,4,17,0.235,14,19,0.737,92,36,77,0.468,23,52,0.442,13,25,0.52,18,23,0.783,103,2012-12-18,MIN,MIA
10322,22,Home,L 92-100 ,240,36,94,0.383,27,70,0.386,9,24,0.375,11,17,0.647,92,36,84,0.429,27,59,0.458,9,25,0.36,19,20,0.95,100,2012-12-19,ATL,OKC
10323,23,Home,W 92-82 ,240,36,89,0.404,33,76,0.434,3,13,0.231,17,20,0.85,92,31,76,0.408,25,55,0.455,6,21,0.286,14,17,0.824,82,2012-12-21,MEM,DAL
10324,24,Home,W 92-75 ,240,38,77,0.494,31,58,0.534,7,19,0.368,9,10,0.9,92,32,76,0.421,27,62,0.435,5,14,0.357,6,8,0.75,75,2012-12-22,ATL,CHI
10325,25,@,L 92-95 ,240,38,88,0.432,30,70,0.429,8,18,0.444,8,10,0.8,92,33,74,0.446,25,52,0.481,8,22,0.364,21,30,0.7,95,2012-12-23,PHI,BRK
10326,26,Home,L 92-105 ,240,34,78,0.436,29,64,0.453,5,14,0.357,19,28,0.679,92,37,81,0.457,25,58,0.431,12,23,0.522,19,25,0.76,105,2012-12-26,CHA,MIA
10327,27,Home,W 92-78 ,240,37,82,0.451,30,59,0.508,7,23,0.304,11,21,0.524,92,30,78,0.385,25,49,0.51,5,29,0.172,13,29,0.448,78,2013-01-01,DEN,LAC
10328,28,@,L 92-104 ,240,38,90,0.422,33,74,0.446,5,16,0.313,11,20,0.55,92,41,83,0.494,36,59,0.61,5,24,0.208,17,23,0.739,104,2013-01-02,NOP,HOU
10329,29,@,W 92-81 ,240,37,69,0.536,35,61,0.574,2,8,0.25,16,20,0.8,92,31,79,0.392,26,65,0.4,5,14,0.357,14,18,0.778,81,2013-01-06,MEM,PHO
10330,30,Home,L 92-104 ,240,34,76,0.447,26,53,0.491,8,23,0.348,16,21,0.762,92,38,77,0.494,32,55,0.582,6,22,0.273,22,24,0.917,104,2013-01-06,TOR,OKC
10331,31,@,L 92-118 ,240,33,78,0.423,26,64,0.406,7,14,0.5,19,23,0.826,92,44,82,0.537,34,68,0.5,10,14,0.714,20,24,0.833,118,2013-01-07,CLE,CHI
10332,32,Home,W 92-90 ,240,30,80,0.375,21,53,0.396,9,27,0.333,23,30,0.767,92,35,77,0.455,29,58,0.5,6,19,0.316,14,20,0.7,90,2013-01-10,POR,MIA
10333,33,@,L 92-104 ,240,31,69,0.449,27,51,0.529,4,18,0.222,26,33,0.788,92,44,84,0.524,36,62,0.581,8,22,0.364,8,9,0.889,104,2013-01-11,MIN,NOH
10334,34,@,W 92-75 ,240,36,90,0.4,28,61,0.459,8,29,0.276,12,18,0.667,92,29,80,0.363,26,68,0.382,3,12,0.25,14,18,0.778,75,2013-01-16,MIA,GSW
10335,35,Home,W 92-79 ,240,30,64,0.469,27,50,0.54,3,14,0.214,29,36,0.806,92,25,78,0.321,17,47,0.362,8,31,0.258,21,28,0.75,79,2013-01-19,MIN,HOU
10336,36,Home,L 92-104 ,240,31,76,0.408,25,61,0.41,6,15,0.4,24,29,0.828,92,43,87,0.494,31,62,0.5,12,25,0.48,6,12,0.5,104,2013-01-23,CHA,ATL
10337,37,Home,W 92-88 ,240,38,85,0.447,35,73,0.479,3,12,0.25,13,19,0.684,92,31,86,0.36,24,68,0.353,7,18,0.389,19,26,0.731,88,2013-01-23,UTA,WAS
10338,38,@,L 92-93 ,240,33,85,0.388,24,63,0.381,9,22,0.409,17,23,0.739,92,36,75,0.48,26,49,0.531,10,26,0.385,11,18,0.611,93,2013-01-30,TOR,ATL
10339,39,Home,W 92-84 ,240,40,95,0.421,34,82,0.415,6,13,0.462,6,10,0.6,92,30,75,0.4,23,53,0.434,7,22,0.318,17,21,0.81,84,2013-01-30,PHI,WAS
10340,40,Home,W 92-86 ,240,38,83,0.458,35,71,0.493,3,12,0.25,13,15,0.867,92,33,78,0.423,25,51,0.49,8,27,0.296,12,19,0.632,86,2013-01-30,PHO,LAL
10341,41,@,W 92-83 ,240,37,82,0.451,34,69,0.493,3,13,0.231,15,18,0.833,92,31,89,0.348,25,66,0.379,6,23,0.261,15,19,0.789,83,2013-02-05,LAL,BRK
10342,42,@,L 92-103 ,240,38,84,0.452,33,72,0.458,5,12,0.417,11,16,0.688,92,38,74,0.514,28,50,0.56,10,24,0.417,17,23,0.739,103,2013-02-06,MEM,ATL
10343,43,Home,L 92-100 ,240,40,79,0.506,35,61,0.574,5,18,0.278,7,11,0.636,92,39,75,0.52,31,61,0.508,8,14,0.571,14,17,0.824,100,2013-02-11,CLE,MIN
10344,44,@,L 92-94 ,240,34,76,0.447,30,63,0.476,4,13,0.308,20,24,0.833,92,37,88,0.42,33,70,0.471,4,18,0.222,16,21,0.762,94,2013-02-13,PHI,MIL
10345,45,@,W 92-88 ,240,31,73,0.425,22,52,0.423,9,21,0.429,21,24,0.875,92,28,79,0.354,19,54,0.352,9,25,0.36,23,32,0.719,88,2013-02-13,TOR,NYK
10346,46,Home,L 92-105 ,240,37,89,0.416,33,64,0.516,4,25,0.16,14,17,0.824,92,38,81,0.469,29,57,0.509,9,24,0.375,20,27,0.741,105,2013-02-19,ORL,CHA
10347,47,Home,W 92-86 ,240,35,79,0.443,28,58,0.483,7,21,0.333,15,19,0.789,92,36,85,0.424,34,72,0.472,2,13,0.154,12,15,0.8,86,2013-02-24,POR,BOS
10348,48,@,L 92-103 ,240,35,78,0.449,33,58,0.569,2,20,0.1,20,25,0.8,92,34,82,0.415,29,69,0.42,5,13,0.385,30,32,0.938,103,2013-02-27,TOR,CLE
10349,49,Home,W 92-87 ,240,36,81,0.444,26,59,0.441,10,22,0.455,10,12,0.833,92,31,73,0.425,23,50,0.46,8,23,0.348,17,22,0.773,87,2013-03-01,PHO,ATL
10350,50,@,L 92-97 ,240,35,81,0.432,27,62,0.435,8,19,0.421,14,18,0.778,92,33,71,0.465,27,58,0.466,6,13,0.462,25,33,0.758,97,2013-03-03,CHI,IND
10351,51,@,L 92-107 ,240,36,85,0.424,29,63,0.46,7,22,0.318,13,16,0.813,92,43,77,0.558,32,54,0.593,11,23,0.478,10,12,0.833,107,2013-03-07,LAC,DEN
10352,52,Home,L 92-103 ,240,33,72,0.458,27,58,0.466,6,14,0.429,20,26,0.769,92,45,86,0.523,41,75,0.547,4,11,0.364,9,11,0.818,103,2013-03-08,CLE,MEM
10353,53,Home,W 92-63 ,240,32,78,0.41,21,58,0.362,11,20,0.55,17,24,0.708,92,20,73,0.274,15,46,0.326,5,27,0.185,18,28,0.643,63,2013-03-11,GSW,NYK
10354,54,@,L 92-96 ,240,36,92,0.391,28,63,0.444,8,29,0.276,12,16,0.75,92,37,79,0.468,29,57,0.509,8,22,0.364,14,21,0.667,96,2013-03-13,LAL,ATL
10355,55,Home,W 92-91 ,240,37,84,0.44,32,71,0.451,5,13,0.385,13,17,0.765,92,37,83,0.446,29,64,0.453,8,19,0.421,9,10,0.9,91,2013-03-14,SAS,DAL
10356,56,Home,W 92-78 ,240,33,68,0.485,30,58,0.517,3,10,0.3,23,27,0.852,92,26,80,0.325,20,58,0.345,6,22,0.273,20,29,0.69,78,2013-03-15,TOR,CHA
10357,57,Home,W 92-77 ,240,40,82,0.488,35,66,0.53,5,16,0.313,7,11,0.636,92,29,86,0.337,23,62,0.371,6,24,0.25,13,18,0.722,77,2013-03-18,MEM,MIN
10358,58,@,W 92-91 ,240,36,79,0.456,26,53,0.491,10,26,0.385,10,14,0.714,92,32,75,0.427,28,58,0.483,4,17,0.235,23,25,0.92,91,2013-03-23,DET,CHA
10359,59,@,L 92-101 ,240,36,88,0.409,29,71,0.408,7,17,0.412,13,16,0.813,92,37,75,0.493,27,55,0.491,10,20,0.5,17,22,0.773,101,2013-03-23,WAS,GSW
10360,60,Home,L 92-93 ,240,38,86,0.442,31,69,0.449,7,17,0.412,9,14,0.643,92,34,76,0.447,29,62,0.468,5,14,0.357,20,28,0.714,93,2013-03-27,CLE,BOS
10361,61,@,L 92-100 ,240,37,89,0.416,31,65,0.477,6,24,0.25,12,13,0.923,92,42,89,0.472,34,73,0.466,8,16,0.5,8,9,0.889,100,2013-03-27,MIL,PHI
10362,62,@,L 92-97 ,240,30,81,0.37,26,61,0.426,4,20,0.2,28,32,0.875,92,37,86,0.43,32,71,0.451,5,15,0.333,18,22,0.818,97,2013-03-29,WAS,ORL
10363,63,@,L 92-100 ,240,38,76,0.5,36,68,0.529,2,8,0.25,14,23,0.609,92,38,73,0.521,33,57,0.579,5,16,0.313,19,27,0.704,100,2013-03-30,CHA,PHI
10364,64,@,L 92-112 ,240,38,82,0.463,31,64,0.484,7,18,0.389,9,12,0.75,92,40,74,0.541,28,53,0.528,12,21,0.571,20,29,0.69,112,2013-03-31,CLE,NOH
10365,65,@,L 92-109 ,240,32,81,0.395,25,62,0.403,7,19,0.368,21,26,0.808,92,41,85,0.482,32,68,0.471,9,17,0.529,18,28,0.643,109,2013-03-31,TOR,WAS
10366,66,Home,W 92-90 ,240,36,79,0.456,34,72,0.472,2,7,0.286,18,24,0.75,92,36,75,0.48,28,52,0.538,8,23,0.348,10,11,0.909,90,2013-04-01,MEM,SAS
10367,67,@,W 92-90 ,240,38,82,0.463,34,71,0.479,4,11,0.364,12,19,0.632,92,31,70,0.443,26,57,0.456,5,13,0.385,23,30,0.767,90,2013-04-04,CHI,BRK
10368,68,Home,L 92-95 ,240,34,80,0.425,27,59,0.458,7,21,0.333,17,19,0.895,92,32,80,0.4,28,65,0.431,4,15,0.267,27,29,0.931,95,2013-04-07,PHO,NOH
10369,69,@,L 92-95 ,240,36,85,0.424,29,69,0.42,7,16,0.438,13,17,0.765,92,37,78,0.474,30,60,0.5,7,18,0.389,14,19,0.737,95,2013-04-17,WAS,CHI
10370,70,@,L 92-98 ,240,37,90,0.411,35,69,0.507,2,21,0.095,16,17,0.941,92,39,91,0.429,30,67,0.448,9,24,0.375,11,16,0.688,98,2013-04-17,ATL,NYK
10371,71,@,L 92-93 ,240,34,94,0.362,29,66,0.439,5,28,0.179,19,24,0.792,92,39,85,0.459,34,69,0.493,5,16,0.313,10,11,0.909,93,2013-11-04,MIN,CLE
10372,72,Home,W 92-90 ,240,36,73,0.493,33,58,0.569,3,15,0.2,17,30,0.567,92,35,79,0.443,28,63,0.444,7,16,0.438,13,15,0.867,90,2013-11-06,CHA,TOR
10373,73,Home,W 92-79 ,240,39,77,0.506,31,55,0.564,8,22,0.364,6,8,0.75,92,33,91,0.363,28,76,0.368,5,15,0.333,8,11,0.727,79,2013-11-13,SAS,WAS
10374,74,@,W 92-79 ,240,34,82,0.415,29,65,0.446,5,17,0.294,19,27,0.704,92,30,86,0.349,22,64,0.344,8,22,0.364,11,15,0.733,79,2013-11-16,OKC,MIL
10375,75,Home,W 92-86 ,240,35,70,0.5,28,51,0.549,7,19,0.368,15,21,0.714,92,33,76,0.434,27,52,0.519,6,24,0.25,14,18,0.778,86,2013-11-19,DET,NYK
10376,76,Home,L 92-120 ,240,29,71,0.408,14,42,0.333,15,29,0.517,19,21,0.905,92,38,74,0.514,23,50,0.46,15,24,0.625,29,32,0.906,120,2013-11-20,ORL,MIA
10377,77,@,L 92-107 ,240,33,83,0.398,25,51,0.49,8,32,0.25,18,24,0.75,92,39,79,0.494,32,57,0.561,7,22,0.318,22,24,0.917,107,2013-11-25,PHO,MIA
10378,78,Home,L 92-109 ,240,30,73,0.411,21,51,0.412,9,22,0.409,23,27,0.852,92,42,83,0.506,34,61,0.557,8,22,0.364,17,20,0.85,109,2013-11-26,ATL,ORL
10379,79,Home,L 92-100 (OT),265,37,85,0.435,27,60,0.45,10,25,0.4,8,10,0.8,92,37,74,0.5,27,48,0.563,10,26,0.385,16,22,0.727,100,2013-11-27,MIL,WAS
10380,80,Home,W 92-76 ,240,35,79,0.443,32,64,0.5,3,15,0.2,19,31,0.613,92,28,84,0.333,23,67,0.343,5,17,0.294,15,20,0.75,76,2013-11-29,CHA,MIL
10381,81,Home,W 92-85 ,240,36,78,0.462,28,61,0.459,8,17,0.471,12,20,0.6,92,35,84,0.417,31,65,0.477,4,19,0.211,11,15,0.733,85,2013-11-30,MIL,BOS
10382,82,@,W 92-75 ,240,34,80,0.425,22,61,0.361,12,19,0.632,12,15,0.8,92,30,90,0.333,27,72,0.375,3,18,0.167,12,15,0.8,75,2013-12-07,DET,CHI
10383,83,Home,L 92-103 ,240,40,88,0.455,37,72,0.514,3,16,0.188,9,14,0.643,92,35,83,0.422,28,61,0.459,7,22,0.318,26,34,0.765,103,2013-12-07,PHI,DEN
10384,84,Home,L 92-101 ,240,31,87,0.356,22,61,0.361,9,26,0.346,21,27,0.778,92,38,86,0.442,34,68,0.5,4,18,0.222,21,28,0.75,101,2013-12-10,ATL,OKC
10385,85,@,W 92-83 ,240,38,90,0.422,31,71,0.437,7,19,0.368,9,9,1.0,92,31,84,0.369,27,67,0.403,4,17,0.235,17,18,0.944,83,2013-12-11,ORL,CHA
10386,86,@,L 92-115 ,240,37,76,0.487,31,58,0.534,6,18,0.333,12,21,0.571,92,39,76,0.513,28,53,0.528,11,23,0.478,26,35,0.743,115,2013-12-16,SAS,LAC
10387,87,Home,L 92-96 ,240,37,91,0.407,32,75,0.427,5,16,0.313,13,17,0.765,92,37,75,0.493,30,53,0.566,7,22,0.318,15,19,0.789,96,2013-12-17,MEM,LAL
10388,88,Home,L 92-115 ,240,34,88,0.386,26,60,0.433,8,28,0.286,16,24,0.667,92,46,96,0.479,36,72,0.5,10,24,0.417,13,18,0.722,115,2013-12-23,CLE,DET
10389,89,@,L 92-100 ,240,38,93,0.409,33,75,0.44,5,18,0.278,11,20,0.55,92,31,71,0.437,26,47,0.553,5,24,0.208,33,40,0.825,100,2013-12-26,MEM,HOU
10390,90,@,L 92-109 ,240,39,95,0.411,34,77,0.442,5,18,0.278,9,18,0.5,92,45,85,0.529,41,71,0.577,4,14,0.286,15,23,0.652,109,2013-12-27,DET,ORL
10391,91,@,W 92-91 ,240,33,91,0.363,28,62,0.452,5,29,0.172,21,25,0.84,92,35,84,0.417,30,64,0.469,5,20,0.25,16,17,0.941,91,2013-12-31,ATL,BOS
10392,92,@,L 92-113 ,240,37,84,0.44,32,69,0.464,5,15,0.333,13,15,0.867,92,40,78,0.513,31,58,0.534,9,20,0.45,24,28,0.857,113,2013-12-31,BRK,SAS
10393,93,Home,L 92-95 ,240,31,89,0.348,24,60,0.4,7,29,0.241,23,28,0.821,92,38,77,0.494,36,71,0.507,2,6,0.333,17,22,0.773,95,2014-01-03,BOS,NOP
10394,94,@,L 92-116 ,240,37,79,0.468,34,64,0.531,3,15,0.2,15,21,0.714,92,50,90,0.556,46,72,0.639,4,18,0.222,12,16,0.75,116,2014-01-04,LAC,SAS
10395,95,@,W 92-80 ,240,37,76,0.487,32,63,0.508,5,13,0.385,13,16,0.813,92,32,78,0.41,26,52,0.5,6,26,0.231,10,18,0.556,80,2014-01-05,NYK,DAL
10396,96,Home,W 92-87 ,240,36,82,0.439,30,68,0.441,6,14,0.429,14,23,0.609,92,33,82,0.402,27,59,0.458,6,23,0.261,15,19,0.789,87,2014-01-07,CHI,PHO
10397,97,@,L 92-102 ,240,37,68,0.544,30,47,0.638,7,21,0.333,11,21,0.524,92,44,82,0.537,35,58,0.603,9,24,0.375,5,10,0.5,102,2014-01-09,MIA,NYK
10398,98,@,L 92-119 ,240,37,84,0.44,29,65,0.446,8,19,0.421,10,14,0.714,92,48,88,0.545,39,69,0.565,9,19,0.474,14,19,0.737,119,2014-01-10,CHA,MIN
10399,99,Home,L 92-102 ,240,36,78,0.462,31,59,0.525,5,19,0.263,15,21,0.714,92,39,82,0.476,33,64,0.516,6,18,0.333,18,23,0.783,102,2014-01-11,PHI,NYK
10400,0,Home,L 92-104 ,240,38,101,0.376,35,84,0.417,3,17,0.176,13,14,0.929,92,37,79,0.468,29,60,0.483,8,19,0.421,22,34,0.647,104,2014-01-13,BOS,HOU
10401,1,@,L 92-116 ,240,39,92,0.424,35,79,0.443,4,13,0.308,10,17,0.588,92,45,82,0.549,39,66,0.591,6,16,0.375,20,25,0.8,116,2014-01-14,SAC,IND
10402,2,@,L 92-95 ,240,35,88,0.398,30,68,0.441,5,20,0.25,17,26,0.654,92,39,77,0.506,33,62,0.532,6,15,0.4,11,20,0.55,95,2014-01-15,CHA,PHI
10403,3,Home,L 92-104 ,240,33,82,0.402,21,48,0.438,12,34,0.353,14,21,0.667,92,38,82,0.463,32,57,0.561,6,25,0.24,22,25,0.88,104,2014-01-16,HOU,OKC
10404,4,@,L 92-106 ,240,33,83,0.398,28,63,0.444,5,20,0.25,21,24,0.875,92,38,83,0.458,29,64,0.453,9,19,0.474,21,22,0.955,106,2014-01-18,LAC,IND
10405,5,Home,L 92-95 ,240,31,74,0.419,24,55,0.436,7,19,0.368,23,28,0.821,92,35,77,0.455,30,68,0.441,5,9,0.556,20,23,0.87,95,2014-01-20,MEM,NOP
10406,6,@,L 92-100 ,240,36,77,0.468,33,62,0.532,3,15,0.2,17,19,0.895,92,37,81,0.457,32,69,0.464,5,12,0.417,21,27,0.778,100,2014-01-26,ORL,NOP
10407,7,Home,L 92-104 ,240,37,94,0.394,32,70,0.457,5,24,0.208,13,16,0.813,92,42,99,0.424,37,78,0.474,5,21,0.238,15,27,0.556,104,2014-01-28,LAL,IND
10408,8,@,L 92-111 ,240,31,76,0.408,23,52,0.442,8,24,0.333,22,34,0.647,92,45,91,0.495,39,70,0.557,6,21,0.286,15,20,0.75,111,2014-01-30,LAC,GSW
10409,9,@,L 92-106 ,240,38,87,0.437,30,57,0.526,8,30,0.267,8,10,0.8,92,41,80,0.513,34,54,0.63,7,26,0.269,17,24,0.708,106,2014-02-01,CLE,HOU
10410,10,Home,L 92-101 ,240,31,80,0.388,23,52,0.442,8,28,0.286,22,29,0.759,92,35,78,0.449,29,60,0.483,6,18,0.333,25,31,0.806,101,2014-02-04,PHO,CHI
10411,11,@,W 92-86 ,240,34,80,0.425,27,58,0.466,7,22,0.318,17,17,1.0,92,36,82,0.439,30,63,0.476,6,19,0.316,8,11,0.727,86,2014-02-09,CHI,LAL
10412,12,@,L 92-93 ,240,35,79,0.443,24,55,0.436,11,24,0.458,11,19,0.579,92,34,83,0.41,29,71,0.408,5,12,0.417,20,26,0.769,93,2014-02-09,IND,ORL
10413,13,Home,W 92-89 ,240,33,70,0.471,30,57,0.526,3,13,0.231,23,27,0.852,92,34,74,0.459,27,50,0.54,7,24,0.292,14,20,0.7,89,2014-02-11,MEM,WAS
10414,14,Home,L 92-104 ,240,37,80,0.463,31,63,0.492,6,17,0.353,12,17,0.706,92,41,82,0.5,32,63,0.508,9,19,0.474,13,14,0.929,104,2014-02-12,BOS,SAS
10415,15,Home,W 92-76 ,240,35,70,0.5,31,56,0.554,4,14,0.286,18,21,0.857,92,26,67,0.388,21,50,0.42,5,17,0.294,19,28,0.679,76,2014-02-13,CHI,BRK
10416,16,Home,L 92-101 ,240,33,79,0.418,27,62,0.435,6,17,0.353,20,28,0.714,92,39,86,0.453,36,67,0.537,3,19,0.158,20,24,0.833,101,2014-02-19,SAC,GSW
10417,17,Home,L 92-94 ,240,35,83,0.422,32,66,0.485,3,17,0.176,19,23,0.826,92,36,72,0.5,29,60,0.483,7,12,0.583,15,20,0.75,94,2014-02-19,TOR,CHI
10418,18,@,L 92-101 ,240,38,97,0.392,34,75,0.453,4,22,0.182,12,17,0.706,92,40,83,0.482,33,61,0.541,7,22,0.318,14,19,0.737,101,2014-02-21,BOS,LAL
10419,19,Home,W 92-89 ,240,30,82,0.366,22,62,0.355,8,20,0.4,24,27,0.889,92,34,79,0.43,30,64,0.469,4,15,0.267,17,22,0.773,89,2014-02-22,CHA,MEM
10420,20,Home,W 92-82 ,240,34,73,0.466,25,53,0.472,9,20,0.45,15,15,1.0,92,33,90,0.367,30,73,0.411,3,17,0.176,13,15,0.867,82,2014-02-28,SAS,CHA
10421,21,Home,W 92-81 ,240,35,83,0.422,34,70,0.486,1,13,0.077,21,27,0.778,92,32,86,0.372,27,62,0.435,5,24,0.208,12,18,0.667,81,2014-03-02,ORL,PHI
10422,22,@,L 92-125 ,240,32,94,0.34,22,64,0.344,10,30,0.333,18,26,0.692,92,43,76,0.566,36,56,0.643,7,20,0.35,32,43,0.744,125,2014-03-04,PHI,OKC
10423,23,@,L 92-101 ,240,37,86,0.43,34,69,0.493,3,17,0.176,15,20,0.75,92,36,77,0.468,27,48,0.563,9,29,0.31,20,22,0.909,101,2014-03-07,CLE,CHA
10424,24,Home,L 92-104 ,240,36,76,0.474,31,54,0.574,5,22,0.227,15,20,0.75,92,37,80,0.463,27,57,0.474,10,23,0.435,20,28,0.714,104,2014-03-08,PHI,UTA
10425,25,Home,L 92-116 ,240,34,81,0.42,26,62,0.419,8,19,0.421,16,23,0.696,92,42,80,0.525,31,61,0.508,11,19,0.579,21,24,0.875,116,2014-03-12,BOS,NYK
10426,26,@,L 92-97 ,240,34,83,0.41,26,58,0.448,8,25,0.32,16,25,0.64,92,33,81,0.407,19,49,0.388,14,32,0.438,17,29,0.586,97,2014-03-15,DEN,ATL
10427,27,Home,L 92-101 ,240,37,89,0.416,30,71,0.423,7,18,0.389,11,16,0.688,92,39,68,0.574,30,48,0.625,9,20,0.45,14,18,0.778,101,2014-03-16,MIL,CHA
10428,28,Home,W 92-86 ,240,32,82,0.39,28,65,0.431,4,17,0.235,24,29,0.828,92,31,73,0.425,26,50,0.52,5,23,0.217,19,27,0.704,86,2014-03-19,NYK,IND
10429,29,Home,L 92-93 ,240,34,91,0.374,24,50,0.48,10,41,0.244,14,21,0.667,92,34,82,0.415,27,53,0.509,7,29,0.241,18,25,0.72,93,2014-03-21,PHI,NYK
10430,30,@,L 92-98 ,240,39,90,0.433,35,74,0.473,4,16,0.25,10,26,0.385,92,33,73,0.452,25,48,0.521,8,25,0.32,24,35,0.686,98,2014-03-21,DET,PHO
10431,31,@,L 92-109 ,240,34,90,0.378,27,66,0.409,7,24,0.292,17,20,0.85,92,48,91,0.527,42,79,0.532,6,12,0.5,7,13,0.538,109,2014-03-24,MIN,MEM
10432,32,Home,L 92-94 ,240,36,73,0.493,30,53,0.566,6,20,0.3,14,24,0.583,92,38,85,0.447,33,76,0.434,5,9,0.556,13,23,0.565,94,2014-03-31,DEN,MEM
10433,33,@,W 92-83 ,240,33,70,0.471,24,41,0.585,9,29,0.31,17,24,0.708,92,33,85,0.388,25,61,0.41,8,24,0.333,9,15,0.6,83,2014-03-31,NYK,UTA
10434,34,Home,L 92-105 ,240,32,72,0.444,24,48,0.5,8,24,0.333,20,26,0.769,92,40,78,0.513,28,53,0.528,12,25,0.48,13,15,0.867,105,2014-04-02,ATL,CHI
10435,35,@,L 92-118 ,240,32,81,0.395,29,57,0.509,3,24,0.125,25,30,0.833,92,45,72,0.625,35,53,0.66,10,19,0.526,18,21,0.857,118,2014-04-02,BOS,WAS
10436,36,@,L 92-100 ,240,29,80,0.363,22,57,0.386,7,23,0.304,27,32,0.844,92,32,83,0.386,30,72,0.417,2,11,0.182,34,38,0.895,100,2014-04-04,DEN,MEM
10437,37,@,L 92-100 ,240,36,77,0.468,35,63,0.556,1,14,0.071,19,28,0.679,92,43,79,0.544,34,62,0.548,9,17,0.529,5,9,0.556,100,2014-04-05,MIN,ORL
10438,38,@,L 92-112 ,240,38,86,0.442,33,72,0.458,5,14,0.357,11,17,0.647,92,43,77,0.558,34,55,0.618,9,22,0.409,17,18,0.944,112,2014-04-06,MEM,SAS
10439,39,Home,L 92-107 ,240,34,82,0.415,31,68,0.456,3,14,0.214,21,28,0.75,92,38,80,0.475,26,58,0.448,12,22,0.545,19,27,0.704,107,2014-04-08,SAC,OKC
10440,40,@,L 92-95 ,240,36,80,0.45,27,51,0.529,9,29,0.31,11,18,0.611,92,37,81,0.457,29,64,0.453,8,17,0.471,13,19,0.684,95,2014-04-16,TOR,NYK
10441,41,@,L 92-102 ,240,31,81,0.383,19,49,0.388,12,32,0.375,18,21,0.857,92,35,69,0.507,28,49,0.571,7,20,0.35,25,33,0.758,102,2014-11-01,IND,ATL
10442,42,Home,L 92-98 ,240,33,88,0.375,24,57,0.421,9,31,0.29,17,21,0.81,92,34,68,0.5,31,58,0.534,3,10,0.3,27,33,0.818,98,2014-11-02,LAC,SAC
10443,43,@,L 92-94 ,240,38,92,0.413,30,67,0.448,8,25,0.32,8,11,0.727,92,31,69,0.449,26,52,0.5,5,17,0.294,27,38,0.711,94,2014-11-05,ATL,SAS
10444,44,@,L 92-102 ,240,35,87,0.402,31,71,0.437,4,16,0.25,18,23,0.783,92,41,78,0.526,36,65,0.554,5,13,0.385,15,17,0.882,102,2014-11-08,MIN,MIA
10445,45,@,L 92-93 ,240,29,82,0.354,26,68,0.382,3,14,0.214,31,34,0.912,92,40,88,0.455,35,70,0.5,5,18,0.278,8,11,0.727,93,2014-11-08,MEM,MIL
10446,46,@,L 92-107 ,240,35,79,0.443,32,65,0.492,3,14,0.214,19,27,0.704,92,42,82,0.512,36,65,0.554,6,17,0.353,17,22,0.773,107,2014-11-09,CHA,LAL
10447,47,@,W 92-90 ,240,35,74,0.473,30,58,0.517,5,16,0.313,17,25,0.68,92,37,83,0.446,30,65,0.462,7,18,0.389,9,13,0.692,90,2014-11-19,SAS,CLE
10448,48,Home,L 92-98 ,240,30,74,0.405,15,36,0.417,15,38,0.395,17,23,0.739,92,37,91,0.407,32,71,0.451,5,20,0.25,19,23,0.826,98,2014-11-19,HOU,LAL
10449,49,@,L 92-96 ,240,35,80,0.438,32,70,0.457,3,10,0.3,19,26,0.731,92,38,83,0.458,29,57,0.509,9,26,0.346,11,13,0.846,96,2014-11-19,MEM,TOR
10450,50,Home,L 92-121 ,240,37,90,0.411,33,77,0.429,4,13,0.308,14,22,0.636,92,46,84,0.548,33,63,0.524,13,21,0.619,16,18,0.889,121,2014-11-21,MIN,SAS
10451,51,Home,L 92-94 ,240,38,85,0.447,34,65,0.523,4,20,0.2,12,19,0.632,92,31,67,0.463,26,52,0.5,5,15,0.333,27,30,0.9,94,2014-11-21,OKC,BRK
10452,52,@,L 92-95 ,240,35,88,0.398,29,53,0.547,6,35,0.171,16,22,0.727,92,30,82,0.366,15,36,0.417,15,46,0.326,20,23,0.87,95,2014-11-22,DAL,HOU
10453,53,Home,L 92-99 ,240,35,78,0.449,32,62,0.516,3,16,0.188,19,27,0.704,92,37,71,0.521,25,45,0.556,12,26,0.462,13,18,0.722,99,2014-11-22,ORL,MIA
10454,54,Home,L 92-113 ,240,31,75,0.413,29,55,0.527,2,20,0.1,28,35,0.8,92,45,88,0.511,30,56,0.536,15,32,0.469,8,10,0.8,113,2014-11-24,CHA,LAC
10455,55,Home,L 92-108 ,240,37,84,0.44,28,57,0.491,9,27,0.333,9,17,0.529,92,40,77,0.519,31,56,0.554,9,21,0.429,19,27,0.704,108,2014-12-08,IND,ATL
10456,56,@,L 92-101 ,240,32,79,0.405,29,62,0.468,3,17,0.176,25,37,0.676,92,35,74,0.473,32,66,0.485,3,8,0.375,28,36,0.778,101,2014-12-08,UTA,SAC
10457,57,Home,L 92-111 ,240,36,78,0.462,35,71,0.493,1,7,0.143,19,29,0.655,92,45,88,0.511,39,64,0.609,6,24,0.25,15,20,0.75,111,2014-12-12,MIN,OKC
10458,58,Home,L 92-104 ,240,36,84,0.429,31,66,0.47,5,18,0.278,15,17,0.882,92,41,87,0.471,35,67,0.522,6,20,0.3,16,24,0.667,104,2014-12-16,SAC,OKC
10459,59,@,L 92-109 ,240,37,85,0.435,32,66,0.485,5,19,0.263,13,15,0.867,92,44,80,0.55,37,61,0.607,7,19,0.368,14,18,0.778,109,2014-12-17,ORL,BOS
10460,60,Home,L 92-104 ,240,34,83,0.41,31,69,0.449,3,14,0.214,21,29,0.724,92,40,78,0.513,34,61,0.557,6,17,0.353,18,25,0.72,104,2014-12-21,WAS,PHO
10461,61,@,W 92-90 ,240,29,84,0.345,24,71,0.338,5,13,0.385,29,33,0.879,92,36,83,0.434,31,70,0.443,5,13,0.385,13,21,0.619,90,2014-12-29,CHI,IND
10462,62,Home,L 92-98 ,240,32,86,0.372,22,55,0.4,10,31,0.323,18,24,0.75,92,33,81,0.407,27,58,0.466,6,23,0.261,26,30,0.867,98,2015-01-02,UTA,ATL
10463,63,@,L 92-101 ,240,40,82,0.488,36,68,0.529,4,14,0.286,8,13,0.615,92,43,78,0.551,39,62,0.629,4,16,0.25,11,18,0.611,101,2015-01-03,WAS,SAS
10464,64,@,W 92-85 ,240,38,79,0.481,36,69,0.522,2,10,0.2,14,17,0.824,92,33,74,0.446,27,55,0.491,6,19,0.316,13,17,0.765,85,2015-01-05,WAS,NOP
10465,65,@,L 92-95 ,240,33,85,0.388,22,55,0.4,11,30,0.367,15,22,0.682,92,38,79,0.481,31,56,0.554,7,23,0.304,12,15,0.8,95,2015-01-05,CLE,PHI
10466,66,@,L 92-93 ,240,29,87,0.333,25,69,0.362,4,18,0.222,30,42,0.714,92,32,80,0.4,21,56,0.375,11,24,0.458,18,25,0.72,93,2015-01-10,IND,PHI
10467,67,@,L 92-103 ,240,37,92,0.402,34,71,0.479,3,21,0.143,15,20,0.75,92,36,76,0.474,26,50,0.52,10,26,0.385,21,26,0.808,103,2015-01-10,ORL,POR
10468,68,Home,L 92-103 ,240,36,75,0.48,26,49,0.531,10,26,0.385,10,12,0.833,92,39,83,0.47,36,66,0.545,3,17,0.176,22,29,0.759,103,2015-01-14,BRK,MEM
10469,69,@,W 92-89 ,240,36,90,0.4,30,66,0.455,6,24,0.25,14,24,0.583,92,34,76,0.447,29,58,0.5,5,18,0.278,16,25,0.64,89,2015-01-19,TOR,MIL
10470,70,@,L 92-99 ,240,35,84,0.417,27,57,0.474,8,27,0.296,14,20,0.7,92,38,78,0.487,28,55,0.509,10,23,0.435,13,17,0.765,99,2015-01-19,NOP,NYK
10471,71,@,L 92-106 ,240,35,84,0.417,27,62,0.435,8,22,0.364,14,18,0.778,92,42,81,0.519,37,57,0.649,5,24,0.208,17,25,0.68,106,2015-01-21,UTA,CLE
10472,72,Home,W 92-86 ,240,34,74,0.459,33,67,0.493,1,7,0.143,23,29,0.793,92,27,85,0.318,22,57,0.386,5,28,0.179,27,32,0.844,86,2015-01-21,MEM,TOR
10473,73,@,W 92-84 ,240,40,80,0.5,37,76,0.487,3,4,0.75,9,14,0.643,92,35,84,0.417,33,75,0.44,2,9,0.222,12,17,0.706,84,2015-01-23,NOP,MIN
10474,74,Home,W 92-84 ,240,36,86,0.419,32,66,0.485,4,20,0.2,16,24,0.667,92,29,85,0.341,27,72,0.375,2,13,0.154,24,32,0.75,84,2015-01-26,OKC,MIN
10475,75,Home,L 92-98 ,240,37,87,0.425,32,67,0.478,5,20,0.25,13,16,0.813,92,38,78,0.487,34,62,0.548,4,16,0.25,18,27,0.667,98,2015-01-27,LAL,WAS
10476,76,@,L 92-100 ,240,34,85,0.4,29,63,0.46,5,22,0.227,19,22,0.864,92,40,91,0.44,32,74,0.432,8,17,0.471,12,17,0.706,100,2015-01-28,OKC,NYK
10477,77,Home,W 92-80 ,240,37,84,0.44,27,62,0.435,10,22,0.455,8,13,0.615,92,27,76,0.355,20,60,0.333,7,16,0.438,19,23,0.826,80,2015-02-01,NYK,LAL
10478,78,@,W 92-88 ,240,37,79,0.468,33,64,0.516,4,15,0.267,14,19,0.737,92,33,81,0.407,27,66,0.409,6,15,0.4,16,19,0.842,88,2015-02-02,CHA,WAS
10479,79,Home,W 92-88 ,240,37,74,0.5,34,63,0.54,3,11,0.273,15,22,0.682,92,34,89,0.382,28,65,0.431,6,24,0.25,14,17,0.824,88,2015-02-06,BRK,NYK
10480,80,Home,L 92-106 ,240,35,87,0.402,27,69,0.391,8,18,0.444,14,17,0.824,92,37,81,0.457,25,56,0.446,12,25,0.48,20,24,0.833,106,2015-02-07,NYK,GSW
10481,81,Home,W 92-76 ,240,37,83,0.446,27,58,0.466,10,25,0.4,8,17,0.471,92,26,72,0.361,22,50,0.44,4,22,0.182,20,22,0.909,76,2015-02-20,UTA,POR
10482,82,Home,W 92-81 ,240,36,78,0.462,31,60,0.517,5,18,0.278,15,19,0.789,92,33,90,0.367,27,71,0.38,6,19,0.316,9,13,0.692,81,2015-02-22,DAL,CHO
10483,83,Home,L 92-98 ,240,33,82,0.402,20,49,0.408,13,33,0.394,13,16,0.813,92,42,89,0.472,39,80,0.488,3,9,0.333,11,13,0.846,98,2015-02-22,POR,MEM
10484,84,@,L 92-99 ,240,38,84,0.452,29,58,0.5,9,26,0.346,7,11,0.636,92,38,79,0.481,30,60,0.5,8,19,0.421,15,18,0.833,99,2015-02-24,TOR,DAL
10485,85,@,L 92-105 ,240,38,88,0.432,29,62,0.468,9,26,0.346,7,11,0.636,92,40,96,0.417,31,72,0.431,9,24,0.375,16,18,0.889,105,2015-02-24,IND,OKC
10486,86,Home,L 92-99 ,240,37,92,0.402,28,59,0.475,9,33,0.273,9,17,0.529,92,36,74,0.486,31,52,0.596,5,22,0.227,22,30,0.733,99,2015-03-01,DEN,NOP
10487,87,@,L 92-97 ,240,35,84,0.417,27,62,0.435,8,22,0.364,14,19,0.737,92,33,78,0.423,24,49,0.49,9,29,0.31,22,30,0.733,97,2015-03-03,WAS,CHI
10488,88,@,W 92-86 ,240,30,79,0.38,23,61,0.377,7,18,0.389,25,30,0.833,92,30,78,0.385,27,63,0.429,3,15,0.2,23,30,0.767,86,2015-03-07,IND,NYK
10489,89,Home,W 92-84 ,240,35,95,0.368,22,58,0.379,13,37,0.351,9,17,0.529,92,30,77,0.39,19,52,0.365,11,25,0.44,13,16,0.813,84,2015-03-07,PHI,ATL
10490,90,@,L 92-95 ,240,37,78,0.474,32,66,0.485,5,12,0.417,13,13,1.0,92,37,85,0.435,29,58,0.5,8,27,0.296,13,17,0.765,95,2015-03-11,MEM,BOS
10491,91,@,L 92-102 ,240,35,79,0.443,30,56,0.536,5,23,0.217,17,24,0.708,92,34,79,0.43,22,46,0.478,12,33,0.364,22,31,0.71,102,2015-03-13,MIA,TOR
10492,92,Home,W 92-81 ,240,33,80,0.413,31,71,0.437,2,9,0.222,24,28,0.857,92,30,81,0.37,22,63,0.349,8,18,0.444,13,21,0.619,81,2015-03-16,MEM,DEN
10493,93,@,L 92-106 ,240,30,79,0.38,19,46,0.413,11,33,0.333,21,27,0.778,92,42,76,0.553,38,61,0.623,4,15,0.267,18,22,0.818,106,2015-03-16,CLE,MIA
10494,94,@,L 92-99 ,240,32,79,0.405,27,65,0.415,5,14,0.357,23,29,0.793,92,35,77,0.455,26,53,0.491,9,24,0.375,20,28,0.714,99,2015-03-17,CHA,LAC
10495,95,@,L 92-117 ,240,36,80,0.45,31,60,0.517,5,20,0.25,15,21,0.714,92,45,82,0.549,30,53,0.566,15,29,0.517,12,20,0.6,117,2015-03-18,BRK,CLE
10496,96,Home,L 92-95 (OT),265,40,97,0.412,36,77,0.468,4,20,0.2,8,10,0.8,92,34,83,0.41,32,71,0.451,2,12,0.167,25,30,0.833,95,2015-03-19,NYK,MIN
10497,97,@,L 92-108 ,240,30,79,0.38,20,54,0.37,10,25,0.4,22,26,0.846,92,42,79,0.532,33,51,0.647,9,28,0.321,15,17,0.882,108,2015-03-20,TOR,CHI
10498,98,@,L 92-95 ,240,36,84,0.429,28,64,0.438,8,20,0.4,12,13,0.923,92,35,82,0.427,26,56,0.464,9,26,0.346,16,21,0.762,95,2015-03-20,IND,CLE
10499,99,@,L 92-98 ,240,37,96,0.385,32,77,0.416,5,19,0.263,13,22,0.591,92,39,76,0.513,33,55,0.6,6,21,0.286,14,23,0.609,98,2015-03-22,DAL,PHO
10500,0,@,W 92-89 ,240,34,81,0.42,27,54,0.5,7,27,0.259,17,20,0.85,92,35,80,0.438,31,64,0.484,4,16,0.25,15,23,0.652,89,2015-03-25,POR,UTA
10501,1,Home,L 92-96 ,240,38,87,0.437,31,63,0.492,7,24,0.292,9,14,0.643,92,29,69,0.42,25,49,0.51,4,20,0.2,34,43,0.791,96,2015-03-27,NYK,BOS
10502,2,Home,L 92-113 ,240,37,83,0.446,32,67,0.478,5,16,0.313,13,21,0.619,92,44,78,0.564,35,62,0.565,9,16,0.563,16,21,0.762,113,2015-04-01,LAL,NOP
10503,3,@,L 92-100 ,240,36,88,0.409,32,71,0.451,4,17,0.235,16,26,0.615,92,38,80,0.475,34,59,0.576,4,21,0.19,20,28,0.714,100,2015-04-03,OKC,MEM
10504,4,Home,W 92-91 ,240,35,86,0.407,34,73,0.466,1,13,0.077,21,23,0.913,92,28,76,0.368,17,50,0.34,11,26,0.423,24,33,0.727,91,2015-04-04,CHA,PHI
10505,5,Home,L 92-107 ,240,32,85,0.376,26,63,0.413,6,22,0.273,22,31,0.71,92,34,79,0.43,21,45,0.467,13,34,0.382,26,42,0.619,107,2015-04-04,DEN,LAC
10506,6,@,W 92-83 ,240,38,79,0.481,30,57,0.526,8,22,0.364,8,10,0.8,92,34,81,0.42,33,66,0.5,1,15,0.067,14,18,0.778,83,2015-04-04,WAS,MEM
10507,7,@,L 92-107 ,240,39,91,0.429,30,63,0.476,9,28,0.321,5,10,0.5,92,44,83,0.53,37,62,0.597,7,21,0.333,12,15,0.8,107,2015-04-05,GSW,SAS
10508,8,@,W 92-74 ,240,33,77,0.429,21,50,0.42,12,27,0.444,14,19,0.737,92,28,81,0.346,18,59,0.305,10,22,0.455,8,11,0.727,74,2015-04-08,TOR,CHO
10509,9,@,L 92-102 ,240,40,96,0.417,36,81,0.444,4,15,0.267,8,13,0.615,92,35,72,0.486,31,56,0.554,4,16,0.25,28,36,0.778,102,2015-04-13,LAL,SAC
10510,10,@,L 92-109 ,240,34,82,0.415,25,62,0.403,9,20,0.45,15,23,0.652,92,41,82,0.5,30,54,0.556,11,28,0.393,16,26,0.615,109,2015-04-13,DAL,UTA
10511,11,Home,W 92-87 ,240,38,77,0.494,26,44,0.591,12,33,0.364,4,4,1.0,92,30,71,0.423,18,38,0.474,12,33,0.364,15,16,0.938,87,2015-04-15,TOR,CHO
10512,12,Home,W 92-87 ,240,30,74,0.405,23,55,0.418,7,19,0.368,25,34,0.735,92,35,75,0.467,33,63,0.524,2,12,0.167,15,21,0.714,87,2015-10-28,DET,UTA
10513,13,@,L 92-102 ,240,33,77,0.429,27,56,0.482,6,21,0.286,20,22,0.909,92,39,86,0.453,33,61,0.541,6,25,0.24,18,21,0.857,102,2015-10-30,MIA,CLE
10514,14,Home,L 92-112 ,240,30,82,0.366,25,59,0.424,5,23,0.217,27,36,0.75,92,43,93,0.462,34,67,0.507,9,26,0.346,17,25,0.68,112,2015-10-30,HOU,GSW
10515,15,@,L 92-110 ,240,34,86,0.395,25,62,0.403,9,24,0.375,15,19,0.789,92,37,83,0.446,33,65,0.508,4,18,0.222,32,42,0.762,110,2015-10-30,POR,PHO
10516,16,Home,W 92-87 ,240,33,87,0.379,26,59,0.441,7,28,0.25,19,22,0.864,92,35,90,0.389,28,67,0.418,7,23,0.304,10,17,0.588,87,2015-11-01,CHI,ORL
10517,17,Home,L 92-94 ,240,32,86,0.372,18,49,0.367,14,37,0.378,14,15,0.933,92,37,88,0.42,30,59,0.508,7,29,0.241,13,14,0.929,94,2015-11-01,CHA,ATL
10518,18,Home,L 92-98 ,240,38,86,0.442,33,58,0.569,5,28,0.179,11,16,0.688,92,37,90,0.411,30,69,0.435,7,21,0.333,17,22,0.773,98,2015-11-03,MIA,ATL
10519,19,Home,L 92-108 ,240,33,88,0.375,28,64,0.438,5,24,0.208,21,33,0.636,92,41,77,0.532,30,52,0.577,11,25,0.44,15,32,0.469,108,2015-11-04,UTA,POR
10520,20,Home,L 92-99 ,240,33,81,0.407,29,57,0.509,4,24,0.167,22,28,0.786,92,35,81,0.432,32,67,0.478,3,14,0.214,26,29,0.897,99,2015-11-06,NYK,MIL
10521,21,Home,W 92-87 ,240,33,77,0.429,24,52,0.462,9,25,0.36,17,22,0.773,92,30,86,0.349,25,63,0.397,5,23,0.217,22,29,0.759,87,2015-11-06,ORL,TOR
10522,22,Home,L 92-100 ,240,37,92,0.402,27,62,0.435,10,30,0.333,8,13,0.615,92,37,74,0.5,29,52,0.558,8,22,0.364,18,36,0.5,100,2015-11-06,PHO,DET
10523,23,@,L 92-94 ,240,35,80,0.438,33,69,0.478,2,11,0.182,20,29,0.69,92,28,68,0.412,23,49,0.469,5,19,0.263,33,37,0.892,94,2015-11-09,MEM,LAC
10524,24,@,L 92-101 ,240,34,89,0.382,25,57,0.439,9,32,0.281,15,20,0.75,92,37,74,0.5,28,58,0.483,9,16,0.563,18,24,0.75,101,2015-11-11,DET,SAC
10525,25,Home,W 92-91 ,240,36,77,0.468,32,64,0.5,4,13,0.308,16,25,0.64,92,34,89,0.382,30,72,0.417,4,17,0.235,19,25,0.76,91,2015-11-12,MIA,UTA
10526,26,Home,W 92-83 ,240,33,85,0.388,28,69,0.406,5,16,0.313,21,25,0.84,92,33,82,0.402,25,60,0.417,8,22,0.364,9,11,0.818,83,2015-11-14,SAS,PHI
10527,27,@,W 92-86 ,240,30,76,0.395,23,52,0.442,7,24,0.292,25,30,0.833,92,34,76,0.447,29,54,0.537,5,22,0.227,13,20,0.65,86,2015-11-16,DAL,PHI
10528,28,Home,W 92-82 ,240,34,72,0.472,27,51,0.529,7,21,0.333,17,22,0.773,92,32,74,0.432,31,65,0.477,1,9,0.111,17,17,1.0,82,2015-11-21,SAS,MEM
10529,29,@,L 92-104 ,240,32,92,0.348,21,66,0.318,11,26,0.423,17,20,0.85,92,37,87,0.425,29,59,0.492,8,28,0.286,22,29,0.759,104,2015-11-27,CHI,IND
10530,30,Home,W 92-81 ,240,33,77,0.429,26,51,0.51,7,26,0.269,19,27,0.704,92,30,75,0.4,22,50,0.44,8,25,0.32,13,17,0.765,81,2015-11-28,DAL,DEN
10531,31,Home,W 92-84 ,240,34,81,0.42,30,68,0.441,4,13,0.308,20,27,0.741,92,30,77,0.39,18,41,0.439,12,36,0.333,12,16,0.75,84,2015-11-29,MEM,PHI
10532,32,Home,W 92-89 ,240,37,86,0.43,31,70,0.443,6,16,0.375,12,20,0.6,92,37,90,0.411,35,76,0.461,2,14,0.143,13,18,0.722,89,2015-11-30,CHI,SAS
10533,33,Home,W 92-74 ,240,35,77,0.455,29,59,0.492,6,18,0.333,16,22,0.727,92,28,75,0.373,22,56,0.393,6,19,0.316,12,16,0.75,74,2015-11-30,MIL,DEN
10534,34,Home,L 92-93 ,240,37,87,0.425,29,58,0.5,8,29,0.276,10,15,0.667,92,41,88,0.466,37,73,0.507,4,15,0.267,7,13,0.538,93,2015-12-09,DET,MEM
10535,35,@,L 92-106 ,240,38,90,0.422,31,71,0.437,7,19,0.368,9,15,0.6,92,46,89,0.517,40,69,0.58,6,20,0.3,8,9,0.889,106,2015-12-21,IND,SAS
10536,36,Home,L 92-93 ,240,39,88,0.443,35,70,0.5,4,18,0.222,10,12,0.833,92,35,78,0.449,20,48,0.417,15,30,0.5,8,14,0.571,93,2015-12-22,MIA,DET
10537,37,@,L 92-98 ,240,37,90,0.411,30,71,0.423,7,19,0.368,11,21,0.524,92,28,69,0.406,14,37,0.378,14,32,0.438,28,32,0.875,98,2015-12-26,MEM,CHO
10538,38,Home,W 92-87 (OT),265,31,75,0.413,22,48,0.458,9,27,0.333,21,28,0.75,92,33,81,0.407,26,63,0.413,7,18,0.389,14,26,0.538,87,2016-01-02,UTA,MEM
10539,39,@,L 92-101 ,240,35,98,0.357,30,73,0.411,5,25,0.2,17,22,0.773,92,39,94,0.415,30,72,0.417,9,22,0.409,14,17,0.824,101,2016-01-07,BOS,CHI
10540,40,@,L 92-95 ,240,30,83,0.361,18,47,0.383,12,36,0.333,20,24,0.833,92,32,77,0.416,20,50,0.4,12,27,0.444,19,23,0.826,95,2016-01-10,CHA,DEN
10541,41,Home,L 92-105 ,240,33,87,0.379,24,51,0.471,9,36,0.25,17,22,0.773,92,39,72,0.542,34,60,0.567,5,12,0.417,22,26,0.846,105,2016-01-16,CHA,MIL
10542,42,Home,L 92-112 ,240,35,89,0.393,27,63,0.429,8,26,0.308,14,20,0.7,92,43,97,0.443,32,72,0.444,11,25,0.44,15,19,0.789,112,2016-01-24,PHI,BOS
10543,43,Home,L 92-95 ,240,34,85,0.4,25,56,0.446,9,29,0.31,15,18,0.833,92,34,75,0.453,23,53,0.434,11,22,0.5,16,33,0.485,95,2016-01-25,UTA,DET
10544,44,@,W 92-90 ,240,33,76,0.434,27,51,0.529,6,25,0.24,20,26,0.769,92,30,74,0.405,23,49,0.469,7,25,0.28,23,28,0.821,90,2016-01-26,DAL,LAL
10545,45,@,L 92-111 ,240,33,83,0.398,26,55,0.473,7,28,0.25,19,21,0.905,92,38,78,0.487,29,63,0.46,9,15,0.6,26,30,0.867,111,2016-01-28,ATL,IND
10546,46,@,L 92-107 ,240,39,96,0.406,34,79,0.43,5,17,0.294,9,11,0.818,92,40,78,0.513,31,54,0.574,9,24,0.375,18,21,0.857,107,2016-02-01,ORL,SAS
10547,47,Home,L 92-98 (OT),265,34,90,0.378,28,65,0.431,6,25,0.24,18,21,0.857,92,35,95,0.368,30,73,0.411,5,22,0.227,23,31,0.742,98,2016-02-08,PHI,LAC
10548,48,Home,L 92-103 ,240,38,88,0.432,28,61,0.459,10,27,0.37,6,7,0.857,92,39,83,0.47,33,64,0.516,6,19,0.316,19,24,0.792,103,2016-02-10,DET,DEN
10549,49,@,L 92-99 ,240,34,88,0.386,28,56,0.5,6,32,0.188,18,24,0.75,92,36,82,0.439,32,68,0.471,4,14,0.286,23,32,0.719,99,2016-02-11,WAS,MIL
10550,50,Home,L 92-115 ,240,37,90,0.411,32,69,0.464,5,21,0.238,13,19,0.684,92,41,80,0.513,31,57,0.544,10,23,0.435,23,27,0.852,115,2016-02-21,OKC,CLE
10551,51,Home,L 92-102 ,240,36,86,0.419,26,52,0.5,10,34,0.294,10,16,0.625,92,39,89,0.438,25,44,0.568,14,45,0.311,10,12,0.833,102,2016-02-22,ATL,GSW
10552,52,Home,L 92-108 ,240,39,96,0.406,33,78,0.423,6,18,0.333,8,15,0.533,92,44,85,0.518,36,66,0.545,8,19,0.421,12,15,0.8,108,2016-02-24,SAC,SAS
10553,53,@,L 92-126 ,240,33,91,0.363,27,64,0.422,6,27,0.222,20,27,0.741,92,45,93,0.484,32,66,0.485,13,27,0.481,23,27,0.852,126,2016-03-01,PHO,CHO
10554,54,@,L 92-108 ,240,33,82,0.402,28,60,0.467,5,22,0.227,21,27,0.778,92,40,83,0.482,31,66,0.47,9,17,0.529,19,25,0.76,108,2016-03-03,PHO,MIA
10555,55,@,L 92-103 ,240,35,89,0.393,29,60,0.483,6,29,0.207,16,21,0.762,92,40,81,0.494,36,68,0.529,4,13,0.308,19,24,0.792,103,2016-03-12,NOP,MIL
10556,56,Home,W 92-85 ,240,39,80,0.488,33,61,0.541,6,19,0.316,8,11,0.727,92,35,86,0.407,27,59,0.458,8,27,0.296,7,12,0.583,85,2016-03-19,CHI,UTA
10557,57,Home,W 92-91 ,240,35,85,0.412,26,52,0.5,9,33,0.273,13,17,0.765,92,41,76,0.539,36,67,0.537,5,9,0.556,4,7,0.571,91,2016-03-21,DET,MIL
10558,58,Home,W 92-84 ,240,36,79,0.456,29,59,0.492,7,20,0.35,13,15,0.867,92,35,85,0.412,31,69,0.449,4,16,0.25,10,14,0.714,84,2016-03-24,IND,NOP
10559,59,@,L 92-111 ,240,37,86,0.43,33,71,0.465,4,15,0.267,14,17,0.824,92,44,85,0.518,37,65,0.569,7,20,0.35,16,18,0.889,111,2016-03-26,SAS,OKC
10560,60,@,L 92-100 ,240,36,80,0.45,28,63,0.444,8,17,0.471,12,18,0.667,92,36,75,0.48,24,51,0.471,12,24,0.5,16,22,0.727,100,2016-03-30,NOP,SAS
10561,61,@,W 92-87 ,240,34,81,0.42,27,59,0.458,7,22,0.318,17,20,0.85,92,33,96,0.344,26,71,0.366,7,25,0.28,14,20,0.7,87,2016-04-03,IND,NYK
10562,62,@,L 92-108 ,240,34,77,0.442,23,48,0.479,11,29,0.379,13,19,0.684,92,39,87,0.448,32,68,0.471,7,19,0.368,23,26,0.885,108,2016-04-05,CHI,MEM
10563,63,@,W 92-86 ,240,34,77,0.442,24,50,0.48,10,27,0.37,14,18,0.778,92,34,90,0.378,31,73,0.425,3,17,0.176,15,19,0.789,86,2016-04-10,GSW,SAS
10564,64,Home,L 92-101 ,240,35,77,0.455,26,44,0.591,9,33,0.273,13,18,0.722,92,36,81,0.444,25,49,0.51,11,32,0.344,18,22,0.818,101,2016-04-11,UTA,DAL
10565,65,Home,L 92-97 ,240,37,87,0.425,30,64,0.469,7,23,0.304,11,13,0.846,92,39,90,0.433,28,66,0.424,11,24,0.458,8,10,0.8,97,2016-04-13,MIL,IND
10566,66,@,L 92-93 ,240,32,84,0.381,21,54,0.389,11,30,0.367,17,20,0.85,92,34,80,0.425,23,49,0.469,11,31,0.355,14,21,0.667,93,2016-10-30,DAL,HOU
10567,67,@,L 92-95 ,240,32,83,0.386,27,58,0.466,5,25,0.2,23,36,0.639,92,31,80,0.388,26,60,0.433,5,20,0.25,28,35,0.8,95,2016-11-04,ATL,WAS
10568,68,@,L 92-112 ,240,33,84,0.393,29,65,0.446,4,19,0.211,22,29,0.759,92,45,86,0.523,38,70,0.543,7,16,0.438,15,24,0.625,112,2016-11-05,MIN,OKC
10569,69,Home,L 92-116 ,240,30,74,0.405,20,49,0.408,10,25,0.4,22,25,0.88,92,47,91,0.516,38,68,0.559,9,23,0.391,13,14,0.929,116,2016-11-05,SAS,LAC
10570,70,Home,L 92-94 ,240,37,86,0.43,30,66,0.455,7,20,0.35,11,16,0.688,92,33,82,0.402,21,51,0.412,12,31,0.387,16,17,0.941,94,2016-11-19,DET,BOS
10571,71,Home,L 92-111 ,240,34,86,0.395,24,55,0.436,10,31,0.323,14,22,0.636,92,45,98,0.459,30,60,0.5,15,38,0.395,6,8,0.75,111,2016-11-23,BRK,BOS
10572,72,@,W 92-87 ,240,33,73,0.452,24,51,0.471,9,22,0.409,17,22,0.773,92,33,91,0.363,26,66,0.394,7,25,0.28,14,23,0.609,87,2016-11-23,PHO,ORL
10573,73,@,L 92-97 ,240,33,88,0.375,27,62,0.435,6,26,0.231,20,25,0.8,92,36,88,0.409,25,60,0.417,11,28,0.393,14,15,0.933,97,2016-12-02,SAC,BOS
10574,74,@,L 92-99 ,240,38,86,0.442,32,64,0.5,6,22,0.273,10,15,0.667,92,36,89,0.404,27,65,0.415,9,24,0.375,18,24,0.75,99,2016-12-03,MIA,POR
10575,75,Home,L 92-98 ,240,38,86,0.442,28,59,0.475,10,27,0.37,6,13,0.462,92,42,79,0.532,35,56,0.625,7,23,0.304,7,14,0.5,98,2016-12-04,DET,ORL
10576,76,@,L 92-101 ,240,36,98,0.367,30,70,0.429,6,28,0.214,14,19,0.737,92,41,89,0.461,35,61,0.574,6,28,0.214,13,26,0.5,101,2016-12-04,NOP,OKC
10577,77,Home,W 92-85 ,240,35,78,0.449,29,59,0.492,6,19,0.316,16,17,0.941,92,31,76,0.408,24,44,0.545,7,32,0.219,16,24,0.667,85,2016-12-08,WAS,DEN
10578,78,@,L 92-112 ,240,35,83,0.422,28,58,0.483,7,25,0.28,15,18,0.833,92,45,77,0.584,33,51,0.647,12,26,0.462,10,12,0.833,112,2016-12-12,DEN,DAL
10579,79,@,L 92-116 ,240,33,84,0.393,23,61,0.377,10,23,0.435,16,21,0.762,92,47,84,0.56,37,61,0.607,10,23,0.435,12,21,0.571,116,2016-12-12,LAL,SAC
10580,80,Home,L 92-107 ,240,34,85,0.4,24,58,0.414,10,27,0.37,14,18,0.778,92,39,74,0.527,34,58,0.586,5,16,0.313,24,26,0.923,107,2016-12-15,PHO,SAS
10581,81,Home,L 92-96 ,240,29,77,0.377,24,52,0.462,5,25,0.2,29,36,0.806,92,31,80,0.388,24,56,0.429,7,24,0.292,27,37,0.73,96,2016-12-16,MEM,SAC
10582,82,@,W 92-84 ,240,35,83,0.422,26,54,0.481,9,29,0.31,13,14,0.929,92,34,82,0.415,27,56,0.482,7,26,0.269,9,13,0.692,84,2016-12-21,MIN,ATL
10583,83,@,L 92-104 ,240,35,93,0.376,28,70,0.4,7,23,0.304,15,16,0.938,92,38,85,0.447,26,56,0.464,12,29,0.414,16,17,0.941,104,2016-12-30,NYK,NOP
10584,84,Home,L 92-111 ,240,37,86,0.43,28,58,0.483,9,28,0.321,9,10,0.9,92,44,81,0.543,34,62,0.548,10,19,0.526,13,18,0.722,111,2017-01-04,ORL,ATL
10585,85,Home,L 92-94 ,240,35,80,0.438,28,60,0.467,7,20,0.35,15,21,0.714,92,32,77,0.416,24,54,0.444,8,23,0.348,22,28,0.786,94,2017-01-07,MIN,UTA
10586,86,@,L 92-101 ,240,36,78,0.462,23,50,0.46,13,28,0.464,7,9,0.778,92,40,71,0.563,34,55,0.618,6,16,0.375,15,21,0.714,101,2017-01-09,DAL,MIN
10587,87,@,L 92-100 ,240,31,85,0.365,22,54,0.407,9,31,0.29,21,25,0.84,92,38,79,0.481,25,45,0.556,13,34,0.382,11,19,0.579,100,2017-01-10,CLE,UTA
10588,88,@,L 92-111 ,240,37,93,0.398,30,65,0.462,7,28,0.25,11,14,0.786,92,43,95,0.453,29,51,0.569,14,44,0.318,11,15,0.733,111,2017-01-18,MIL,HOU
10589,89,@,L 92-93 ,240,33,89,0.371,27,70,0.386,6,19,0.316,20,28,0.714,92,36,92,0.391,24,63,0.381,12,29,0.414,9,16,0.563,93,2017-01-20,POR,PHI
10590,90,Home,L 92-100 ,240,35,85,0.412,28,63,0.444,7,22,0.318,15,20,0.75,92,35,77,0.455,28,55,0.509,7,22,0.318,23,30,0.767,100,2017-01-24,ORL,CHI
10591,91,@,L 92-123 ,240,37,92,0.402,33,68,0.485,4,24,0.167,14,19,0.737,92,48,85,0.565,33,57,0.579,15,28,0.536,12,13,0.923,123,2017-02-08,CHI,GSW
10592,92,@,L 92-108 ,240,29,73,0.397,19,41,0.463,10,32,0.313,24,27,0.889,92,42,84,0.5,32,59,0.542,10,25,0.4,14,15,0.933,108,2017-02-08,BOS,SAC
10593,93,Home,L 92-103 ,240,39,92,0.424,34,75,0.453,5,17,0.294,9,13,0.692,92,41,82,0.5,32,63,0.508,9,19,0.474,12,15,0.8,103,2017-02-10,DET,SAS
10594,94,@,L 92-102 ,240,35,84,0.417,26,57,0.456,9,27,0.333,13,23,0.565,92,40,78,0.513,29,52,0.558,11,26,0.423,11,11,1.0,102,2017-02-24,MEM,IND
10595,95,Home,L 92-102 ,240,37,87,0.425,29,65,0.446,8,22,0.364,10,13,0.769,92,34,72,0.472,23,48,0.479,11,24,0.458,23,32,0.719,102,2017-02-26,WAS,UTA
10596,96,@,W 92-91 ,240,33,78,0.423,26,52,0.5,7,26,0.269,19,23,0.826,92,33,73,0.452,24,49,0.49,9,24,0.375,16,19,0.842,91,2017-02-27,TOR,NYK
10597,97,@,L 92-120 ,240,35,73,0.479,24,46,0.522,11,27,0.407,11,18,0.611,92,46,88,0.523,28,54,0.519,18,34,0.529,10,12,0.833,120,2017-03-04,CLE,MIA
10598,98,@,L 92-102 ,240,35,84,0.417,29,65,0.446,6,19,0.316,16,20,0.8,92,41,88,0.466,35,68,0.515,6,20,0.3,14,21,0.667,102,2017-03-09,SAS,OKC
10599,99,@,L 91-99 ,240,34,82,0.415,26,58,0.448,8,24,0.333,15,22,0.682,91,36,77,0.468,32,62,0.516,4,15,0.267,23,31,0.742,99,2011-12-26,CHI,GSW
10600,0,Home,W 91-79 ,240,32,87,0.368,25,72,0.347,7,15,0.467,20,25,0.8,91,27,75,0.36,20,56,0.357,7,19,0.368,18,21,0.857,79,2011-12-26,IND,DET
10601,1,@,L 91-100 ,240,37,88,0.42,36,72,0.5,1,16,0.063,16,19,0.842,91,35,75,0.467,26,57,0.456,9,18,0.5,21,35,0.6,100,2011-12-26,LAL,SAC
10602,2,@,L 91-98 (OT),265,34,88,0.386,29,63,0.46,5,25,0.2,18,31,0.581,91,36,94,0.383,34,84,0.405,2,10,0.2,24,32,0.75,98,2011-12-30,CLE,IND
10603,3,Home,W 91-86 ,240,33,83,0.398,29,64,0.453,4,19,0.211,21,27,0.778,91,37,88,0.42,32,69,0.464,5,19,0.263,7,11,0.636,86,2012-01-02,DEN,MIL
10604,4,@,L 91-102 ,240,36,72,0.5,29,55,0.527,7,17,0.412,12,20,0.6,91,39,87,0.448,31,64,0.484,8,23,0.348,16,21,0.762,102,2012-01-02,GSW,PHO
10605,5,Home,W 91-87 ,240,30,79,0.38,29,69,0.42,1,10,0.1,30,40,0.75,91,34,82,0.415,27,63,0.429,7,19,0.368,12,15,0.8,87,2012-01-09,NYK,CHA
10606,6,Home,L 91-98 ,240,34,80,0.425,28,60,0.467,6,20,0.3,17,21,0.81,91,30,81,0.37,23,57,0.404,7,24,0.292,31,34,0.912,98,2012-01-11,TOR,SAC
10607,7,@,L 91-93 ,240,38,85,0.447,34,64,0.531,4,21,0.19,11,12,0.917,91,32,78,0.41,25,57,0.439,7,21,0.333,22,27,0.815,93,2012-01-14,MIN,ATL
10608,8,Home,L 91-99 ,240,31,74,0.419,24,55,0.436,7,19,0.368,22,26,0.846,91,38,73,0.521,35,58,0.603,3,15,0.2,20,27,0.741,99,2012-01-15,DET,GSW
10609,9,@,L 91-102 ,240,38,91,0.418,33,76,0.434,5,15,0.333,10,14,0.714,91,40,81,0.494,35,62,0.565,5,19,0.263,17,23,0.739,102,2012-01-15,PHO,SAS
10610,10,@,L 91-101 ,240,33,78,0.423,25,54,0.463,8,24,0.333,17,26,0.654,91,37,80,0.463,29,59,0.492,8,21,0.381,19,35,0.543,101,2012-01-16,BRK,LAC
10611,11,Home,W 91-89 ,240,37,87,0.425,29,65,0.446,8,22,0.364,9,17,0.529,91,34,81,0.42,25,61,0.41,9,20,0.45,12,18,0.667,89,2012-01-18,LAC,DAL
10612,12,@,W 91-88 ,240,36,79,0.456,29,67,0.433,7,12,0.583,12,16,0.75,91,32,86,0.372,28,71,0.394,4,15,0.267,20,30,0.667,88,2012-01-18,PHO,NYK
10613,13,Home,L 91-94 ,240,31,80,0.388,28,68,0.412,3,12,0.25,26,29,0.897,91,37,71,0.521,32,51,0.627,5,20,0.25,15,19,0.789,94,2012-01-19,UTA,DAL
10614,14,Home,L 91-94 ,240,37,80,0.463,27,57,0.474,10,23,0.435,7,8,0.875,91,35,83,0.422,27,67,0.403,8,16,0.5,16,21,0.762,94,2012-01-20,GSW,IND
10615,15,@,L 91-94 ,240,34,81,0.42,31,61,0.508,3,20,0.15,20,24,0.833,91,30,67,0.448,23,52,0.442,7,15,0.467,27,32,0.844,94,2012-01-21,POR,DET
10616,16,@,L 91-103 ,240,29,81,0.358,21,62,0.339,8,19,0.421,25,31,0.806,91,35,72,0.486,27,51,0.529,8,21,0.381,25,40,0.625,103,2012-01-22,TOR,LAC
10617,17,@,W 91-82 ,240,28,80,0.35,23,50,0.46,5,30,0.167,30,34,0.882,91,25,67,0.373,22,55,0.4,3,12,0.25,29,35,0.829,82,2012-01-22,MIL,MIA
10618,18,@,W 91-90 ,240,36,85,0.424,34,72,0.472,2,13,0.154,17,23,0.739,91,38,76,0.5,29,51,0.569,9,25,0.36,5,8,0.625,90,2012-01-23,MEM,GSW
10619,19,Home,W 91-81 ,240,34,78,0.436,25,58,0.431,9,20,0.45,14,26,0.538,91,32,76,0.421,29,56,0.518,3,20,0.15,14,20,0.7,81,2012-01-25,CLE,NYK
10620,20,@,L 91-96 ,240,37,87,0.425,29,64,0.453,8,23,0.348,9,14,0.643,91,32,66,0.485,24,50,0.48,8,16,0.5,24,32,0.75,96,2012-01-25,LAC,LAL
10621,21,@,L 91-101 ,240,35,75,0.467,34,68,0.5,1,7,0.143,20,21,0.952,91,34,64,0.531,29,51,0.569,5,13,0.385,28,33,0.848,101,2012-01-25,NOP,OKC
10622,22,@,L 91-98 ,240,30,84,0.357,24,66,0.364,6,18,0.333,25,31,0.806,91,35,72,0.486,26,50,0.52,9,22,0.409,19,27,0.704,98,2012-01-26,MEM,LAC
10623,23,@,W 91-83 ,240,34,73,0.466,24,52,0.462,10,21,0.476,13,19,0.684,91,30,79,0.38,25,62,0.403,5,17,0.294,18,31,0.581,83,2012-01-26,BOS,ORL
10624,24,@,L 91-99 ,240,36,79,0.456,27,57,0.474,9,22,0.409,10,13,0.769,91,35,76,0.461,28,58,0.483,7,18,0.389,22,31,0.71,99,2012-02-01,HOU,SAS
10625,25,Home,L 91-112 ,240,39,85,0.459,31,58,0.534,8,27,0.296,5,12,0.417,91,39,73,0.534,27,52,0.519,12,21,0.571,22,25,0.88,112,2012-02-02,LAC,DEN
10626,26,Home,W 91-89 ,240,31,76,0.408,21,56,0.375,10,20,0.5,19,25,0.76,91,34,80,0.425,31,65,0.477,3,15,0.2,18,21,0.857,89,2012-02-03,BOS,NYK
10627,27,Home,W 91-88 ,240,37,93,0.398,31,70,0.443,6,23,0.261,11,15,0.733,91,32,67,0.478,26,54,0.481,6,13,0.462,18,27,0.667,88,2012-02-04,CLE,DAL
10628,28,@,L 91-100 ,240,39,91,0.429,37,81,0.457,2,10,0.2,11,14,0.786,91,37,82,0.451,31,62,0.5,6,20,0.3,20,23,0.87,100,2012-02-04,HOU,MIN
10629,29,@,L 91-107 ,240,32,82,0.39,25,63,0.397,7,19,0.368,20,30,0.667,91,39,84,0.464,33,67,0.493,6,17,0.353,23,26,0.885,107,2012-02-07,CLE,MIA
10630,30,@,L 91-95 ,240,34,88,0.386,28,68,0.412,6,20,0.3,17,24,0.708,91,37,75,0.493,34,62,0.548,3,13,0.231,18,26,0.692,95,2012-02-12,CHI,BOS
10631,31,Home,L 91-93 ,240,36,76,0.474,29,57,0.509,7,19,0.368,12,16,0.75,91,34,84,0.405,24,62,0.387,10,22,0.455,15,17,0.882,93,2012-02-15,GSW,POR
10632,32,Home,L 91-98 ,240,35,84,0.417,33,68,0.485,2,16,0.125,19,28,0.679,91,37,74,0.5,31,59,0.525,6,15,0.4,18,23,0.783,98,2012-02-17,TOR,CHA
10633,33,@,L 91-92 ,240,40,90,0.444,37,79,0.468,3,11,0.273,8,10,0.8,91,33,85,0.388,30,69,0.435,3,16,0.188,23,26,0.885,92,2012-02-19,PHI,MIN
10634,34,@,L 91-110 ,240,37,88,0.42,35,75,0.467,2,13,0.154,15,19,0.789,91,43,79,0.544,37,66,0.561,6,13,0.462,18,24,0.75,110,2012-02-22,MIL,CHI
10635,35,Home,L 91-96 ,240,36,90,0.4,28,58,0.483,8,32,0.25,11,16,0.688,91,35,76,0.461,27,56,0.482,8,20,0.4,18,31,0.581,96,2012-02-22,DAL,LAL
10636,36,Home,L 91-108 ,240,38,81,0.469,29,57,0.509,9,24,0.375,6,9,0.667,91,45,84,0.536,32,55,0.582,13,29,0.448,5,15,0.333,108,2012-02-22,BRK,ORL
10637,37,Home,L 91-112 ,240,35,80,0.438,26,58,0.448,9,22,0.409,12,16,0.75,91,47,89,0.528,37,69,0.536,10,20,0.5,8,12,0.667,112,2012-03-02,CLE,CHI
10638,38,Home,L 91-96 ,240,38,97,0.392,37,86,0.43,1,11,0.091,14,17,0.824,91,39,82,0.476,32,66,0.485,7,16,0.438,11,16,0.688,96,2012-03-04,PHI,CHI
10639,39,@,L 91-95 ,240,36,84,0.429,27,63,0.429,9,21,0.429,10,10,1.0,91,29,76,0.382,21,49,0.429,8,27,0.296,29,33,0.879,95,2012-03-05,DAL,OKC
10640,40,@,L 91-104 ,240,34,84,0.405,31,73,0.425,3,11,0.273,20,24,0.833,91,41,78,0.526,38,71,0.535,3,7,0.429,19,27,0.704,104,2012-03-09,UTA,PHI
10641,41,@,L 91-93 (OT),265,33,88,0.375,26,71,0.366,7,17,0.412,18,25,0.72,91,35,75,0.467,32,62,0.516,3,13,0.231,20,31,0.645,93,2012-03-10,IND,MIA
10642,42,@,L 91-98 ,240,36,86,0.419,31,72,0.431,5,14,0.357,14,19,0.737,91,41,86,0.477,37,75,0.493,4,11,0.364,12,15,0.8,98,2012-03-10,MEM,PHO
10643,43,Home,L 91-94 ,240,32,79,0.405,28,70,0.4,4,9,0.444,23,30,0.767,91,37,73,0.507,32,58,0.552,5,15,0.333,15,23,0.652,94,2012-03-11,DEN,MEM
10644,44,@,W 91-87 ,240,32,78,0.41,23,54,0.426,9,24,0.375,18,23,0.783,91,39,85,0.459,35,69,0.507,4,16,0.25,5,12,0.417,87,2012-03-15,PHO,LAC
10645,45,@,L 91-98 ,240,36,76,0.474,33,61,0.541,3,15,0.2,16,17,0.941,91,34,74,0.459,27,54,0.5,7,20,0.35,23,31,0.742,98,2012-03-17,BOS,DEN
10646,46,@,L 91-95 ,240,35,72,0.486,29,52,0.558,6,20,0.3,15,18,0.833,91,35,86,0.407,29,63,0.46,6,23,0.261,19,27,0.704,95,2012-03-17,HOU,LAC
10647,47,Home,W 91-81 ,240,34,74,0.459,32,66,0.485,2,8,0.25,21,27,0.778,91,30,76,0.395,21,51,0.412,9,25,0.36,12,21,0.571,81,2012-03-18,MIA,ORL
10648,48,@,L 91-114 ,240,29,79,0.367,17,53,0.321,12,26,0.462,21,27,0.778,91,42,78,0.538,33,56,0.589,9,22,0.409,21,22,0.955,114,2012-03-21,LAC,OKC
10649,49,Home,L 91-100 ,240,36,90,0.4,33,75,0.44,3,15,0.2,16,20,0.8,91,43,89,0.483,36,72,0.5,7,17,0.412,7,10,0.7,100,2012-03-22,MIL,BOS
10650,50,Home,L 91-108 ,240,35,74,0.473,22,54,0.407,13,20,0.65,8,11,0.727,91,44,88,0.5,36,72,0.5,8,16,0.5,12,16,0.75,108,2012-03-26,CHI,DEN
10651,51,Home,W 91-75 ,240,30,76,0.395,21,48,0.438,9,28,0.321,22,32,0.688,91,28,72,0.389,26,59,0.441,2,13,0.154,17,27,0.63,75,2012-03-31,NYK,CLE
10652,52,Home,W 91-72 ,240,33,70,0.471,28,57,0.491,5,13,0.385,20,22,0.909,91,31,89,0.348,28,73,0.384,3,16,0.188,7,17,0.412,72,2012-04-01,BOS,MIA
10653,53,Home,W 91-87 ,240,39,81,0.481,32,59,0.542,7,22,0.318,6,6,1.0,91,34,85,0.4,28,67,0.418,6,18,0.333,13,15,0.867,87,2012-04-03,LAL,NJN
10654,54,Home,W 91-75 ,240,30,72,0.417,20,49,0.408,10,23,0.435,21,26,0.808,91,29,78,0.372,23,62,0.371,6,16,0.375,11,16,0.688,75,2012-04-08,OKC,TOR
10655,55,Home,L 91-93 ,240,36,80,0.45,27,65,0.415,9,15,0.6,10,10,1.0,91,34,73,0.466,29,63,0.46,5,10,0.5,20,26,0.769,93,2012-04-09,NOP,LAL
10656,56,Home,W 91-84 ,240,31,73,0.425,27,59,0.458,4,14,0.286,25,33,0.758,91,35,87,0.402,28,63,0.444,7,24,0.292,7,10,0.7,84,2012-04-09,UTA,SAS
10657,57,Home,L 91-103 ,240,31,87,0.356,27,67,0.403,4,20,0.2,25,29,0.862,91,40,78,0.513,34,64,0.531,6,14,0.429,17,22,0.773,103,2012-04-11,HOU,UTA
10658,58,@,L 91-105 ,240,38,96,0.396,36,80,0.45,2,16,0.125,13,18,0.722,91,40,76,0.526,31,58,0.534,9,18,0.5,16,19,0.842,105,2012-04-14,PHO,SAS
10659,59,Home,L 91-112 ,240,39,80,0.488,37,70,0.529,2,10,0.2,11,11,1.0,91,50,84,0.595,43,66,0.652,7,18,0.389,5,11,0.455,112,2012-04-17,LAL,SAS
10660,60,@,W 91-84 ,240,40,91,0.44,35,78,0.449,5,13,0.385,6,11,0.545,91,26,73,0.356,19,51,0.373,7,22,0.318,25,30,0.833,84,2012-04-17,MEM,MIN
10661,61,@,L 91-103 ,240,29,60,0.483,27,53,0.509,2,7,0.286,31,38,0.816,91,42,83,0.506,34,61,0.557,8,22,0.364,11,13,0.846,103,2012-04-18,NOP,MEM
10662,62,Home,L 91-112 ,240,31,79,0.392,25,59,0.424,6,20,0.3,23,29,0.793,91,38,80,0.475,28,63,0.444,10,17,0.588,26,32,0.813,112,2012-04-18,POR,UTA
10663,63,@,W 91-80 ,240,34,73,0.466,31,58,0.534,3,15,0.2,20,28,0.714,91,33,91,0.363,26,72,0.361,7,19,0.368,7,9,0.778,80,2012-04-19,MIN,DET
10664,64,Home,L 91-99 ,240,38,77,0.494,35,64,0.547,3,13,0.231,12,31,0.387,91,40,85,0.471,35,70,0.5,5,15,0.333,14,18,0.778,99,2012-10-30,LAL,DAL
10665,65,@,L 91-114 ,240,36,93,0.387,31,71,0.437,5,22,0.227,14,18,0.778,91,48,78,0.615,38,58,0.655,10,20,0.5,8,13,0.615,114,2012-11-05,POR,DAL
10666,66,Home,L 91-97 ,240,35,84,0.417,30,69,0.435,5,15,0.333,16,18,0.889,91,36,73,0.493,31,60,0.517,5,13,0.385,20,21,0.952,97,2012-11-08,CHI,OKC
10667,67,Home,L 91-101 ,240,34,78,0.436,30,60,0.5,4,18,0.222,19,22,0.864,91,40,78,0.513,34,63,0.54,6,15,0.4,15,19,0.789,101,2012-11-09,WAS,MIL
10668,68,@,L 91-106 ,240,34,83,0.41,27,60,0.45,7,23,0.304,16,23,0.696,91,40,73,0.548,33,58,0.569,7,15,0.467,19,22,0.864,106,2012-11-11,CLE,OKC
10669,69,@,L 91-102 ,240,30,86,0.349,23,65,0.354,7,21,0.333,24,31,0.774,91,37,92,0.402,28,71,0.394,9,21,0.429,19,23,0.826,102,2012-11-19,HOU,UTA
10670,70,Home,L 91-101 ,240,31,83,0.373,23,61,0.377,8,22,0.364,21,26,0.808,91,42,78,0.538,31,56,0.554,11,22,0.5,6,14,0.429,101,2012-11-23,CHA,ATL
10671,71,@,L 91-102 ,240,35,80,0.438,28,63,0.444,7,17,0.412,14,18,0.778,91,40,84,0.476,35,65,0.538,5,19,0.263,17,30,0.567,102,2012-11-23,GSW,DEN
10672,72,Home,W 91-90 ,240,36,78,0.462,32,65,0.492,4,13,0.308,15,26,0.577,91,32,78,0.41,26,60,0.433,6,18,0.333,20,25,0.8,90,2012-11-23,DET,TOR
10673,73,@,W 91-78 ,240,37,79,0.468,31,62,0.5,6,17,0.353,11,18,0.611,91,30,84,0.357,28,69,0.406,2,15,0.133,16,22,0.727,78,2012-11-27,PHO,CLE
10674,74,@,L 91-94 ,240,30,76,0.395,18,52,0.346,12,24,0.5,19,23,0.826,91,36,90,0.4,24,58,0.414,12,32,0.375,10,15,0.667,94,2012-11-28,CHA,ATL
10675,75,Home,W 91-88 ,240,36,79,0.456,32,66,0.485,4,13,0.308,15,20,0.75,91,34,82,0.415,28,63,0.444,6,19,0.316,14,17,0.824,88,2012-12-01,MIL,BOS
10676,76,Home,W 91-73 ,240,30,70,0.429,26,51,0.51,4,19,0.211,27,35,0.771,91,30,87,0.345,23,63,0.365,7,24,0.292,6,9,0.667,73,2012-12-07,MIN,CLE
10677,77,Home,W 91-82 ,240,32,79,0.405,28,58,0.483,4,21,0.19,23,28,0.821,91,30,80,0.375,26,65,0.4,4,15,0.267,18,21,0.857,82,2012-12-07,SAC,ORL
10678,78,@,L 91-103 ,240,36,88,0.409,31,70,0.443,5,18,0.278,14,21,0.667,91,37,62,0.597,28,45,0.622,9,17,0.529,20,27,0.741,103,2012-12-19,CLE,BOS
10679,79,@,L 91-97 ,240,35,84,0.417,32,72,0.444,3,12,0.25,18,30,0.6,91,35,72,0.486,25,43,0.581,10,29,0.345,17,22,0.773,97,2012-12-19,DET,TOR
10680,80,@,L 91-94 ,240,34,84,0.405,27,62,0.435,7,22,0.318,16,18,0.889,91,32,72,0.444,26,46,0.565,6,26,0.231,24,28,0.857,94,2012-12-23,MIN,NYK
10681,81,@,L 91-129 ,240,34,74,0.459,29,60,0.483,5,14,0.357,18,29,0.621,91,47,84,0.56,27,54,0.5,20,30,0.667,15,19,0.789,129,2012-12-23,DAL,SAS
10682,82,@,L 91-109 ,240,35,86,0.407,26,62,0.419,9,24,0.375,12,16,0.75,91,44,87,0.506,38,66,0.576,6,21,0.286,15,20,0.75,109,2012-12-26,SAC,POR
10683,83,@,L 91-97 ,240,38,82,0.463,36,68,0.529,2,14,0.143,13,16,0.813,91,34,77,0.442,26,61,0.426,8,16,0.5,21,29,0.724,97,2012-12-28,PHO,IND
10684,84,@,W 91-81 ,240,33,70,0.471,29,60,0.483,4,10,0.4,21,38,0.553,91,33,94,0.351,29,78,0.372,4,16,0.25,11,18,0.611,81,2012-12-31,CHA,CHI
10685,85,@,L 91-110 ,240,28,78,0.359,19,53,0.358,9,25,0.36,26,35,0.743,91,39,76,0.513,35,65,0.538,4,11,0.364,28,39,0.718,110,2013-01-05,UTA,DEN
10686,86,@,L 91-103 ,240,35,80,0.438,26,47,0.553,9,33,0.273,12,29,0.414,91,41,79,0.519,32,56,0.571,9,23,0.391,12,16,0.75,103,2013-01-11,HOU,BOS
10687,87,@,L 91-98 ,240,37,85,0.435,32,61,0.525,5,24,0.208,12,16,0.75,91,36,82,0.439,32,66,0.485,4,16,0.25,22,31,0.71,98,2013-01-11,CLE,DEN
10688,88,@,L 91-120 ,240,37,87,0.425,32,69,0.464,5,18,0.278,12,15,0.8,91,46,82,0.561,39,71,0.549,7,11,0.636,21,25,0.84,120,2013-01-14,ORL,WAS
10689,89,@,W 91-83 ,240,37,84,0.44,31,64,0.484,6,20,0.3,11,16,0.688,91,38,83,0.458,35,68,0.515,3,15,0.2,4,6,0.667,83,2013-01-23,BRK,MIN
10690,90,@,W 91-83 ,240,33,77,0.429,24,57,0.421,9,20,0.45,16,23,0.696,91,32,88,0.364,29,72,0.403,3,16,0.188,16,18,0.889,83,2013-01-27,NOP,MEM
10691,91,@,L 91-112 ,240,36,87,0.414,33,71,0.465,3,16,0.188,16,20,0.8,91,41,87,0.471,31,62,0.5,10,25,0.4,20,27,0.741,112,2013-02-04,DAL,OKC
10692,92,@,L 91-98 (OT),265,35,87,0.402,32,67,0.478,3,20,0.15,18,25,0.72,91,38,72,0.528,31,60,0.517,7,12,0.583,15,18,0.833,98,2013-02-04,SAC,UTA
10693,93,@,L 91-116 ,240,34,89,0.382,28,73,0.384,6,16,0.375,17,24,0.708,91,38,77,0.494,27,57,0.474,11,20,0.55,29,38,0.763,116,2013-02-09,GSW,DAL
10694,94,@,L 91-94 ,240,32,77,0.416,26,63,0.413,6,14,0.429,21,26,0.808,91,33,77,0.429,25,59,0.424,8,18,0.444,20,30,0.667,94,2013-02-11,BOS,CHA
10695,95,Home,W 91-85 ,240,36,83,0.434,29,62,0.468,7,21,0.333,12,18,0.667,91,35,85,0.412,32,72,0.444,3,13,0.231,12,17,0.706,85,2013-02-12,LAL,PHO
10696,96,Home,L 91-105 ,240,38,82,0.463,29,62,0.468,9,20,0.45,6,10,0.6,91,45,80,0.563,42,71,0.592,3,9,0.333,12,20,0.6,105,2013-02-19,DET,MEM
10697,97,@,L 91-125 ,240,29,86,0.337,24,58,0.414,5,28,0.179,28,36,0.778,91,42,79,0.532,31,55,0.564,11,24,0.458,30,39,0.769,125,2013-02-20,NYK,IND
10698,98,Home,L 91-102 ,240,37,83,0.446,33,68,0.485,4,15,0.267,13,23,0.565,91,38,78,0.487,33,61,0.541,5,17,0.294,21,26,0.808,102,2013-02-27,UTA,ATL
10699,99,Home,L 91-99 ,240,32,75,0.427,23,50,0.46,9,25,0.36,18,25,0.72,91,39,80,0.488,35,57,0.614,4,23,0.174,17,21,0.81,99,2013-02-28,IND,LAC
10700,0,@,L 91-98 ,240,33,77,0.429,29,64,0.453,4,13,0.308,21,27,0.778,91,34,73,0.466,24,54,0.444,10,19,0.526,20,27,0.741,98,2013-03-01,MEM,MIA
10701,1,Home,W 91-85 ,240,38,87,0.437,34,75,0.453,4,12,0.333,11,18,0.611,91,31,76,0.408,25,56,0.446,6,20,0.3,17,28,0.607,85,2013-03-06,MEM,POR
10702,2,@,L 91-105 ,240,26,63,0.413,16,36,0.444,10,27,0.37,29,34,0.853,91,38,68,0.559,31,54,0.574,7,14,0.5,22,31,0.71,105,2013-03-10,IND,MIA
10703,3,Home,W 91-79 ,240,30,68,0.441,26,52,0.5,4,16,0.25,27,33,0.818,91,29,77,0.377,22,57,0.386,7,20,0.35,14,20,0.7,79,2013-03-10,OKC,BOS
10704,4,@,L 91-99 ,240,40,86,0.465,35,74,0.473,5,12,0.417,6,10,0.6,91,41,83,0.494,29,56,0.518,12,27,0.444,5,7,0.714,99,2013-03-10,PHI,ORL
10705,5,@,L 91-107 ,240,35,80,0.438,29,61,0.475,6,19,0.316,15,18,0.833,91,41,82,0.5,32,57,0.561,9,25,0.36,16,26,0.615,107,2013-03-13,MIN,IND
10706,6,@,L 91-92 ,240,37,83,0.446,29,64,0.453,8,19,0.421,9,10,0.9,91,37,84,0.44,32,71,0.451,5,13,0.385,13,17,0.765,92,2013-03-14,DAL,SAS
10707,7,@,L 91-98 ,240,34,88,0.386,28,72,0.389,6,16,0.375,17,21,0.81,91,39,79,0.494,33,66,0.5,6,13,0.462,14,19,0.737,98,2013-03-16,IND,PHI
10708,8,Home,L 91-108 ,240,39,94,0.415,37,74,0.5,2,20,0.1,11,12,0.917,91,39,67,0.582,29,45,0.644,10,22,0.455,20,29,0.69,108,2013-03-17,TOR,MIA
10709,9,Home,L 91-92 ,240,32,75,0.427,28,58,0.483,4,17,0.235,23,25,0.92,91,36,79,0.456,26,53,0.491,10,26,0.385,10,14,0.714,92,2013-03-23,CHA,DET
10710,10,@,L 91-107 ,240,32,83,0.386,28,69,0.406,4,14,0.286,23,28,0.821,91,41,84,0.488,34,70,0.486,7,14,0.5,18,21,0.857,107,2013-03-25,PHI,UTA
10711,11,Home,L 91-100 ,240,32,83,0.386,26,62,0.419,6,21,0.286,21,26,0.808,91,35,78,0.449,29,60,0.483,6,18,0.333,24,28,0.857,100,2013-03-27,HOU,IND
10712,12,Home,L 91-105 ,240,35,71,0.493,31,57,0.544,4,14,0.286,17,24,0.708,91,34,73,0.466,21,44,0.477,13,29,0.448,24,28,0.857,105,2013-03-27,NOP,LAC
10713,13,Home,L 91-97 ,240,36,89,0.404,30,67,0.448,6,22,0.273,13,22,0.591,91,36,89,0.404,33,76,0.434,3,13,0.231,22,26,0.846,97,2013-04-05,BOS,CLE
10714,14,Home,W 91-85 ,240,32,89,0.36,25,72,0.347,7,17,0.412,20,24,0.833,91,34,90,0.378,33,77,0.429,1,13,0.077,16,22,0.727,85,2013-04-07,CLE,ORL
10715,15,Home,L 91-96 ,240,37,80,0.463,33,58,0.569,4,22,0.182,13,16,0.813,91,42,90,0.467,39,77,0.506,3,13,0.231,9,12,0.75,96,2013-04-07,POR,DAL
10716,16,Home,L 91-102 ,240,34,85,0.4,28,68,0.412,6,17,0.353,17,21,0.81,91,37,89,0.416,25,62,0.403,12,27,0.444,16,17,0.941,102,2013-04-10,DAL,PHO
10717,17,Home,L 91-101 ,240,34,79,0.43,28,57,0.491,6,22,0.273,17,24,0.708,91,40,79,0.506,30,51,0.588,10,28,0.357,11,17,0.647,101,2013-04-12,CLE,NYK
10718,18,@,W 91-87 ,240,37,80,0.463,31,64,0.484,6,16,0.375,11,18,0.611,91,34,83,0.41,28,70,0.4,6,13,0.462,13,20,0.65,87,2013-04-13,LAC,MEM
10719,19,Home,W 91-86 ,240,31,85,0.365,22,58,0.379,9,27,0.333,20,31,0.645,91,33,89,0.371,27,71,0.38,6,18,0.333,14,19,0.737,86,2013-04-14,LAL,SAS
10720,20,Home,W 91-77 ,240,38,86,0.442,30,65,0.462,8,21,0.381,7,11,0.636,91,31,85,0.365,26,69,0.377,5,16,0.313,10,15,0.667,77,2013-04-14,PHI,CLE
10721,21,@,L 91-104 ,240,33,81,0.407,25,55,0.455,8,26,0.308,17,24,0.708,91,43,83,0.518,39,64,0.609,4,19,0.211,14,18,0.778,104,2013-10-30,POR,PHO
10722,22,@,W 91-85 ,240,38,94,0.404,33,73,0.452,5,21,0.238,10,14,0.714,91,30,82,0.366,22,55,0.4,8,27,0.296,17,24,0.708,85,2013-11-01,SAS,LAL
10723,23,Home,L 91-99 ,240,33,87,0.379,28,62,0.452,5,25,0.2,20,25,0.8,91,38,73,0.521,29,52,0.558,9,21,0.429,14,23,0.609,99,2013-11-05,DET,IND
10724,24,Home,L 91-101 ,240,31,76,0.408,27,60,0.45,4,16,0.25,25,30,0.833,91,42,90,0.467,30,64,0.469,12,26,0.462,5,9,0.556,101,2013-11-08,CHA,NYK
10725,25,Home,W 91-84 ,240,36,78,0.462,30,57,0.526,6,21,0.286,13,16,0.813,91,32,81,0.395,26,63,0.413,6,18,0.333,14,16,0.875,84,2013-11-08,IND,TOR
10726,26,@,W 91-89 ,240,34,95,0.358,32,81,0.395,2,14,0.143,21,26,0.808,91,33,83,0.398,29,63,0.46,4,20,0.2,19,29,0.655,89,2013-11-08,BOS,ORL
10727,27,@,L 91-104 ,240,36,86,0.419,30,64,0.469,6,22,0.273,13,15,0.867,91,39,80,0.488,29,57,0.509,10,23,0.435,16,18,0.889,104,2013-11-08,SAC,POR
10728,28,Home,L 91-96 ,240,35,76,0.461,27,57,0.474,8,19,0.421,13,16,0.813,91,37,80,0.463,30,66,0.455,7,14,0.5,15,20,0.75,96,2013-11-09,BRK,IND
10729,29,@,W 91-83 ,240,33,78,0.423,27,59,0.458,6,19,0.316,19,21,0.905,91,31,81,0.383,20,58,0.345,11,23,0.478,10,16,0.625,83,2013-11-09,DAL,MIL
10730,30,@,L 91-115 ,240,34,77,0.442,31,59,0.525,3,18,0.167,20,24,0.833,91,40,83,0.482,30,58,0.517,10,25,0.4,25,29,0.862,115,2013-11-09,UTA,TOR
10731,31,Home,L 91-95 ,240,35,77,0.455,30,53,0.566,5,24,0.208,16,21,0.762,91,37,88,0.42,25,54,0.463,12,34,0.353,9,13,0.692,95,2013-11-13,ATL,NYK
10732,32,@,L 91-94 ,240,33,74,0.446,28,61,0.459,5,13,0.385,20,22,0.909,91,35,82,0.427,26,56,0.464,9,26,0.346,15,21,0.714,94,2013-11-13,MIL,ORL
10733,33,@,W 91-82 ,240,35,76,0.461,31,61,0.508,4,15,0.267,17,22,0.773,91,35,91,0.385,30,75,0.4,5,16,0.313,7,11,0.636,82,2013-11-15,SAS,UTA
10734,34,@,L 91-95 ,240,32,67,0.478,23,48,0.479,9,19,0.474,18,25,0.72,91,36,81,0.444,31,68,0.456,5,13,0.385,18,30,0.6,95,2013-11-20,BRK,CHA
10735,35,Home,L 91-98 ,240,32,77,0.416,23,54,0.426,9,23,0.391,18,21,0.857,91,38,84,0.452,30,65,0.462,8,19,0.421,14,14,1.0,98,2013-11-20,CLE,WAS
10736,36,@,W 91-82 ,240,35,86,0.407,24,55,0.436,11,31,0.355,10,15,0.667,91,35,80,0.438,30,66,0.455,5,14,0.357,7,12,0.583,82,2013-11-20,POR,MIL
10737,37,@,L 91-105 ,240,38,92,0.413,30,64,0.469,8,28,0.286,7,15,0.467,91,41,79,0.519,37,60,0.617,4,19,0.211,19,29,0.655,105,2013-11-21,LAC,OKC
10738,38,Home,L 91-98 ,240,32,77,0.416,29,63,0.46,3,14,0.214,24,33,0.727,91,33,70,0.471,23,47,0.489,10,23,0.435,22,38,0.579,98,2013-11-22,CHA,PHO
10739,39,@,L 91-102 ,240,38,85,0.447,32,70,0.457,6,15,0.4,9,14,0.643,91,37,84,0.44,28,59,0.475,9,25,0.36,19,22,0.864,102,2013-11-25,NYK,POR
10740,40,Home,L 91-109 ,240,34,78,0.436,25,59,0.424,9,19,0.474,14,15,0.933,91,42,76,0.553,34,59,0.576,8,17,0.471,17,17,1.0,109,2013-11-29,ORL,SAS
10741,41,@,L 91-110 ,240,37,87,0.425,30,58,0.517,7,29,0.241,10,15,0.667,91,46,84,0.548,41,70,0.586,5,14,0.357,13,21,0.619,110,2013-12-03,PHO,MEM
10742,42,@,W 91-90 ,240,34,81,0.42,27,57,0.474,7,24,0.292,16,19,0.842,91,33,74,0.446,29,64,0.453,4,10,0.4,20,25,0.8,90,2013-12-13,CHI,MIL
10743,43,@,L 91-106 ,240,31,75,0.413,24,48,0.5,7,27,0.259,22,38,0.579,91,39,81,0.481,36,68,0.529,3,13,0.231,25,30,0.833,106,2013-12-15,HOU,SAC
10744,44,@,L 91-105 ,240,37,93,0.398,29,75,0.387,8,18,0.444,9,14,0.643,91,40,73,0.548,35,58,0.603,5,15,0.333,20,23,0.87,105,2013-12-18,MEM,DAL
10745,45,@,L 91-104 ,240,33,95,0.347,28,73,0.384,5,22,0.227,20,25,0.8,91,42,78,0.538,35,59,0.593,7,19,0.368,13,15,0.867,104,2013-12-20,MIN,LAL
10746,46,@,L 91-112 ,240,31,88,0.352,25,58,0.431,6,30,0.2,23,29,0.793,91,39,86,0.453,26,53,0.491,13,33,0.394,21,31,0.677,112,2013-12-21,DEN,LAC
10747,47,@,L 91-105 ,240,36,77,0.468,28,56,0.5,8,21,0.381,11,16,0.688,91,38,71,0.535,30,52,0.577,8,19,0.421,21,25,0.84,105,2013-12-28,BRK,IND
10748,48,Home,L 91-95 ,240,35,78,0.449,35,73,0.479,0,5,0.0,21,28,0.75,91,28,65,0.431,22,50,0.44,6,15,0.4,33,42,0.786,95,2013-12-30,MEM,CHI
10749,49,Home,L 91-92 ,240,35,84,0.417,30,64,0.469,5,20,0.25,16,17,0.941,91,33,91,0.363,28,62,0.452,5,29,0.172,21,25,0.84,92,2013-12-31,BOS,ATL
10750,50,Home,W 91-76 ,240,34,77,0.442,29,52,0.558,5,25,0.2,18,22,0.818,91,29,80,0.363,28,68,0.412,1,12,0.083,17,23,0.739,76,2013-12-31,IND,CLE
10751,51,Home,L 91-99 ,240,37,90,0.411,29,60,0.483,8,30,0.267,9,16,0.563,91,44,92,0.478,41,78,0.526,3,14,0.214,8,14,0.571,99,2014-01-02,PHO,MEM
10752,52,Home,W 91-84 ,240,33,81,0.407,27,64,0.422,6,17,0.353,19,24,0.792,91,32,86,0.372,24,58,0.414,8,28,0.286,12,14,0.857,84,2014-01-04,CHI,ATL
10753,53,Home,W 91-86 ,240,33,80,0.413,25,53,0.472,8,27,0.296,17,26,0.654,91,27,70,0.386,19,46,0.413,8,24,0.333,24,26,0.923,86,2014-01-06,BRK,ATL
10754,54,@,L 91-112 ,240,34,86,0.395,30,70,0.429,4,16,0.25,19,35,0.543,91,35,86,0.407,24,55,0.436,11,31,0.355,31,34,0.912,112,2014-01-08,DET,TOR
10755,55,Home,W 91-90 ,240,36,78,0.462,30,61,0.492,6,17,0.353,13,18,0.722,91,33,81,0.407,28,70,0.4,5,11,0.455,19,23,0.826,90,2014-01-17,MEM,SAC
10756,56,@,L 91-93 ,240,33,90,0.367,30,77,0.39,3,13,0.231,22,24,0.917,91,30,71,0.423,26,56,0.464,4,15,0.267,29,36,0.806,93,2014-01-19,BOS,ORL
10757,57,@,L 91-95 ,240,39,90,0.433,33,64,0.516,6,26,0.231,7,9,0.778,91,39,84,0.464,34,69,0.493,5,15,0.333,12,20,0.6,95,2014-01-22,LAC,CHA
10758,58,Home,L 91-103 ,240,34,90,0.378,30,63,0.476,4,27,0.148,19,27,0.704,91,40,76,0.526,36,55,0.655,4,21,0.19,19,25,0.76,103,2014-01-25,PHI,OKC
10759,59,Home,L 91-106 ,240,33,67,0.493,22,41,0.537,11,26,0.423,14,23,0.609,91,41,76,0.539,33,53,0.623,8,23,0.348,16,24,0.667,106,2014-02-01,NYK,MIA
10760,60,@,W 91-75 ,240,37,78,0.474,32,65,0.492,5,13,0.385,12,19,0.632,91,29,93,0.312,25,73,0.342,4,20,0.2,13,16,0.813,75,2014-02-04,CHA,GSW
10761,61,@,L 91-98 ,240,28,75,0.373,24,57,0.421,4,18,0.222,31,37,0.838,91,39,81,0.481,31,66,0.47,8,15,0.533,12,16,0.75,98,2014-02-07,MIN,NOP
10762,62,Home,L 91-102 ,240,33,92,0.359,22,65,0.338,11,27,0.407,14,15,0.933,91,37,82,0.451,27,59,0.458,10,23,0.435,18,20,0.9,102,2014-02-09,BOS,DAL
10763,63,Home,W 91-83 (OT),265,35,88,0.398,25,68,0.368,10,20,0.5,11,18,0.611,91,33,86,0.384,30,72,0.417,3,14,0.214,14,16,0.875,83,2014-02-09,CLE,MEM
10764,64,@,L 91-104 ,240,35,87,0.402,29,65,0.446,6,22,0.273,15,20,0.75,91,40,83,0.482,34,63,0.54,6,20,0.3,18,31,0.581,104,2014-02-19,IND,MIN
10765,65,Home,L 91-98 ,240,35,75,0.467,28,54,0.519,7,21,0.333,14,21,0.667,91,37,83,0.446,27,62,0.435,10,21,0.476,14,20,0.7,98,2014-02-19,NOP,NYK
10766,66,@,L 91-98 ,240,32,82,0.39,26,62,0.419,6,20,0.3,21,29,0.724,91,40,93,0.43,33,72,0.458,7,21,0.333,11,13,0.846,98,2014-02-21,CLE,TOR
10767,67,Home,L 91-100 ,240,34,85,0.4,23,54,0.426,11,31,0.355,12,17,0.706,91,36,71,0.507,27,52,0.519,9,19,0.474,19,28,0.679,100,2014-02-28,DAL,CHI
10768,68,@,L 91-94 ,240,36,78,0.462,30,64,0.469,6,14,0.429,13,18,0.722,91,34,82,0.415,29,67,0.433,5,15,0.333,21,28,0.75,94,2014-03-02,UTA,IND
10769,69,@,L 91-104 ,240,35,78,0.449,27,55,0.491,8,23,0.348,13,22,0.591,91,44,81,0.543,38,66,0.576,6,15,0.4,10,10,1.0,104,2014-03-05,UTA,WAS
10770,70,Home,W 91-84 ,240,31,70,0.443,23,49,0.469,8,21,0.381,21,26,0.808,91,29,80,0.363,25,50,0.5,4,30,0.133,22,26,0.846,84,2014-03-07,BOS,BRK
10771,71,Home,W 91-79 ,240,34,79,0.43,32,68,0.471,2,11,0.182,21,25,0.84,91,28,77,0.364,23,66,0.348,5,11,0.455,18,24,0.75,79,2014-03-21,IND,CHI
10772,72,Home,W 91-86 ,240,35,75,0.467,28,55,0.509,7,20,0.35,14,16,0.875,91,36,79,0.456,33,65,0.508,3,14,0.214,11,17,0.647,86,2014-03-21,MIA,MEM
10773,73,Home,W 91-81 ,240,31,70,0.443,26,56,0.464,5,14,0.357,24,31,0.774,91,30,87,0.345,29,67,0.433,1,20,0.05,20,22,0.909,81,2014-03-22,CHI,PHI
10774,74,@,L 91-93 ,240,28,74,0.378,17,35,0.486,11,39,0.282,24,27,0.889,91,37,84,0.44,32,69,0.464,5,15,0.333,14,23,0.609,93,2014-03-24,POR,MIA
10775,75,@,L 91-113 ,240,36,88,0.409,25,55,0.455,11,33,0.333,8,18,0.444,91,44,79,0.557,31,52,0.596,13,27,0.481,12,16,0.75,113,2014-03-24,PHI,SAS
10776,76,@,W 91-87 ,240,36,79,0.456,32,70,0.457,4,9,0.444,15,16,0.938,91,32,69,0.464,27,53,0.509,5,16,0.313,18,26,0.692,87,2014-03-26,MEM,UTA
10777,77,@,W 91-74 ,240,35,80,0.438,25,58,0.431,10,22,0.455,11,16,0.688,91,33,84,0.393,30,67,0.448,3,17,0.176,5,7,0.714,74,2014-03-28,POR,CHI
10778,78,Home,W 91-78 ,240,34,87,0.391,27,64,0.422,7,23,0.304,16,17,0.941,91,28,79,0.354,26,66,0.394,2,13,0.154,20,25,0.8,78,2014-03-28,WAS,IND
10779,79,Home,W 91-80 ,240,33,78,0.423,27,62,0.435,6,16,0.375,19,23,0.826,91,31,87,0.356,28,76,0.368,3,11,0.273,15,18,0.833,80,2014-04-04,CHA,ORL
10780,80,@,L 91-102 ,240,33,88,0.375,18,46,0.391,15,42,0.357,10,13,0.769,91,34,61,0.557,22,34,0.647,12,27,0.444,22,30,0.733,102,2014-04-06,NYK,MIA
10781,81,Home,L 91-93 ,240,36,76,0.474,31,58,0.534,5,18,0.278,14,20,0.7,91,36,89,0.404,23,58,0.397,13,31,0.419,8,14,0.571,93,2014-04-06,SAC,DAL
10782,82,@,L 91-110 ,240,36,81,0.444,32,64,0.5,4,17,0.235,15,25,0.6,91,42,91,0.462,37,76,0.487,5,15,0.333,21,26,0.808,110,2014-04-08,SAS,MIN
10783,83,@,L 91-104 ,240,32,68,0.471,27,60,0.45,5,8,0.625,22,34,0.647,91,40,84,0.476,32,62,0.516,8,22,0.364,16,19,0.842,104,2014-04-12,MIL,WAS
10784,84,Home,L 91-97 ,240,38,80,0.475,33,54,0.611,5,26,0.192,10,14,0.714,91,40,77,0.519,34,62,0.548,6,15,0.4,11,15,0.733,97,2014-04-14,PHO,MEM
10785,85,Home,W 91-86 (OT),265,34,85,0.4,29,64,0.453,5,21,0.238,18,26,0.692,91,34,86,0.395,26,64,0.406,8,22,0.364,10,15,0.667,86,2014-04-16,CHA,CHI
10786,86,@,L 91-103 ,240,34,89,0.382,28,68,0.412,6,21,0.286,17,30,0.567,91,38,81,0.469,30,56,0.536,8,25,0.32,19,28,0.679,103,2014-10-29,PHI,IND
10787,87,@,L 91-97 ,240,38,91,0.418,31,70,0.443,7,21,0.333,8,13,0.615,91,37,76,0.487,33,66,0.5,4,10,0.4,19,28,0.679,97,2014-10-30,DET,MIN
10788,88,@,L 91-102 ,240,35,80,0.438,28,54,0.519,7,26,0.269,14,20,0.7,91,37,80,0.463,31,60,0.517,6,20,0.3,22,31,0.71,102,2014-11-01,DEN,OKC
10789,89,@,L 91-118 ,240,36,87,0.414,29,56,0.518,7,31,0.226,12,15,0.8,91,42,88,0.477,35,62,0.565,7,26,0.269,27,33,0.818,118,2014-11-01,PHO,UTA
10790,90,Home,L 91-108 ,240,31,74,0.419,19,46,0.413,12,28,0.429,17,27,0.63,91,35,68,0.515,18,31,0.581,17,37,0.459,21,27,0.778,108,2014-11-04,MIA,HOU
10791,91,@,L 91-100 ,240,37,80,0.463,31,59,0.525,6,21,0.286,11,13,0.846,91,38,81,0.469,33,63,0.524,5,18,0.278,19,19,1.0,100,2014-11-04,CHA,NOP
10792,92,Home,L 91-98 ,240,36,82,0.439,28,61,0.459,8,21,0.381,11,17,0.647,91,37,90,0.411,30,73,0.411,7,17,0.412,17,22,0.773,98,2014-11-05,BRK,MIN
10793,93,@,W 91-89 ,240,39,88,0.443,36,68,0.529,3,20,0.15,10,12,0.833,91,33,77,0.429,25,52,0.481,8,25,0.32,15,23,0.652,89,2014-11-05,ORL,PHI
10794,94,Home,L 91-102 ,240,32,69,0.464,24,48,0.5,8,21,0.381,19,21,0.905,91,40,80,0.5,31,63,0.492,9,17,0.529,13,17,0.765,102,2014-11-05,PHO,MEM
10795,95,@,W 91-89 ,240,34,81,0.42,25,63,0.397,9,18,0.5,14,17,0.824,91,37,79,0.468,25,54,0.463,12,25,0.48,3,11,0.273,89,2014-11-07,MEM,OKC
10796,96,@,L 91-102 ,240,34,80,0.425,27,66,0.409,7,14,0.5,16,25,0.64,91,39,88,0.443,32,68,0.471,7,20,0.35,17,20,0.85,102,2014-11-10,DET,CHI
10797,97,@,W 91-85 ,240,27,71,0.38,17,44,0.386,10,27,0.37,27,28,0.964,91,36,83,0.434,30,57,0.526,6,26,0.231,7,12,0.583,85,2014-11-10,ATL,NYK
10798,98,@,L 91-139 ,240,29,72,0.403,26,58,0.448,3,14,0.214,30,41,0.732,91,56,84,0.667,41,64,0.641,15,20,0.75,12,16,0.75,139,2014-11-14,MIN,NOP
10799,99,@,L 91-94 ,240,34,80,0.425,27,56,0.482,7,24,0.292,16,18,0.889,91,37,86,0.43,37,74,0.5,0,12,0.0,20,24,0.833,94,2014-11-15,SAS,SAC
10800,0,@,W 91-84 ,240,35,74,0.473,30,56,0.536,5,18,0.278,16,26,0.615,91,30,73,0.411,19,48,0.396,11,25,0.44,13,22,0.591,84,2014-11-16,MIL,MIA
10801,1,Home,W 91-78 ,240,41,84,0.488,37,74,0.5,4,10,0.4,5,9,0.556,91,27,75,0.36,21,48,0.438,6,27,0.222,18,23,0.783,78,2014-11-21,WAS,CLE
10802,2,Home,W 91-83 ,240,33,66,0.5,27,49,0.551,6,17,0.353,19,21,0.905,91,30,75,0.4,22,49,0.449,8,26,0.308,15,25,0.6,83,2014-11-22,NYK,PHI
10803,3,@,L 91-107 ,240,32,77,0.416,25,52,0.481,7,25,0.28,20,28,0.714,91,42,85,0.494,35,64,0.547,7,21,0.333,16,23,0.696,107,2014-11-23,LAC,MEM
10804,4,@,W 91-86 ,240,33,93,0.355,26,68,0.382,7,25,0.28,18,24,0.75,91,32,90,0.356,29,73,0.397,3,17,0.176,19,27,0.704,86,2014-11-23,GSW,OKC
10805,5,Home,W 91-86 ,240,32,76,0.421,18,40,0.45,14,36,0.389,13,19,0.684,91,35,76,0.461,29,54,0.537,6,22,0.273,10,15,0.667,86,2014-11-24,HOU,NYK
10806,6,Home,L 91-99 ,240,34,85,0.4,25,61,0.41,9,24,0.375,14,17,0.824,91,35,71,0.493,27,47,0.574,8,24,0.333,21,28,0.75,99,2014-11-26,PHI,BRK
10807,7,@,L 91-100 ,240,36,89,0.404,29,65,0.446,7,24,0.292,12,16,0.75,91,38,76,0.5,33,59,0.559,5,17,0.294,19,22,0.864,100,2014-11-28,NOP,ATL
10808,8,Home,L 91-103 ,240,32,84,0.381,24,56,0.429,8,28,0.286,19,30,0.633,91,35,71,0.493,26,48,0.542,9,23,0.391,24,31,0.774,103,2014-12-05,PHI,OKC
10809,9,Home,L 91-105 ,240,35,86,0.407,27,62,0.435,8,24,0.333,13,20,0.65,91,41,84,0.488,32,64,0.5,9,20,0.45,14,21,0.667,105,2014-12-05,TOR,CLE
10810,10,@,W 91-89 ,240,41,81,0.506,36,69,0.522,5,12,0.417,4,9,0.444,91,38,84,0.452,31,69,0.449,7,15,0.467,6,9,0.667,89,2014-12-10,WAS,ORL
10811,11,Home,L 91-99 ,240,34,83,0.41,26,67,0.388,8,16,0.5,15,21,0.714,91,34,74,0.459,29,58,0.5,5,16,0.313,26,35,0.743,99,2014-12-14,DEN,SAS
10812,12,@,L 91-110 ,240,29,88,0.33,19,62,0.306,10,26,0.385,23,29,0.793,91,40,83,0.482,33,66,0.5,7,17,0.412,23,27,0.852,110,2014-12-15,LAL,IND
10813,13,@,L 91-113 ,240,35,83,0.422,27,56,0.482,8,27,0.296,13,22,0.591,91,43,80,0.538,31,56,0.554,12,24,0.5,15,20,0.75,113,2014-12-15,DET,LAC
10814,14,Home,L 91-95 ,240,30,77,0.39,22,49,0.449,8,28,0.286,23,32,0.719,91,33,72,0.458,24,48,0.5,9,24,0.375,20,26,0.769,95,2014-12-16,BRK,MIA
10815,15,@,L 91-95 ,240,37,78,0.474,28,54,0.519,9,24,0.375,8,12,0.667,91,31,77,0.403,22,53,0.415,9,24,0.375,24,29,0.828,95,2014-12-19,BRK,CLE
10816,16,Home,L 91-109 ,240,32,71,0.451,20,45,0.444,12,26,0.462,15,17,0.882,91,43,98,0.439,33,74,0.446,10,24,0.417,13,17,0.765,109,2014-12-19,PHI,CHO
10817,17,@,L 91-105 ,240,39,86,0.453,38,70,0.543,1,16,0.063,12,15,0.8,91,46,76,0.605,39,62,0.629,7,14,0.5,6,10,0.6,105,2014-12-21,MEM,CLE
10818,18,Home,L 91-97 ,240,38,86,0.442,31,63,0.492,7,23,0.304,8,9,0.889,91,34,75,0.453,25,56,0.446,9,19,0.474,20,27,0.741,97,2014-12-22,MEM,UTA
10819,19,@,W 91-87 ,240,33,77,0.429,28,58,0.483,5,19,0.263,20,27,0.741,91,33,80,0.413,25,54,0.463,8,26,0.308,13,18,0.722,87,2014-12-23,PHI,MIA
10820,20,Home,L 91-99 ,240,38,89,0.427,33,80,0.413,5,9,0.556,10,16,0.625,91,39,85,0.459,34,68,0.5,5,17,0.294,16,24,0.667,99,2014-12-23,WAS,CHI
10821,21,@,L 91-101 ,240,32,72,0.444,26,46,0.565,6,26,0.231,21,33,0.636,91,40,84,0.476,33,63,0.524,7,21,0.333,14,17,0.824,101,2014-12-25,CLE,MIA
10822,22,Home,L 91-102 ,240,36,80,0.45,32,58,0.552,4,22,0.182,15,19,0.789,91,44,86,0.512,37,70,0.529,7,16,0.438,7,10,0.7,102,2014-12-25,NYK,WAS
10823,23,@,W 91-87 ,240,33,87,0.379,29,72,0.403,4,15,0.267,21,30,0.7,91,32,87,0.368,26,59,0.441,6,28,0.214,17,26,0.654,87,2015-01-02,CLE,CHO
10824,24,Home,L 91-94 ,240,38,89,0.427,31,65,0.477,7,24,0.292,8,10,0.8,91,35,81,0.432,27,61,0.443,8,20,0.4,16,20,0.8,94,2015-01-02,MIL,IND
10825,25,@,L 91-127 ,240,32,79,0.405,23,54,0.426,9,25,0.36,18,26,0.692,91,46,85,0.541,31,48,0.646,15,37,0.405,20,26,0.769,127,2015-01-03,PHI,LAC
10826,26,@,L 91-117 ,240,30,98,0.306,25,70,0.357,5,28,0.179,26,34,0.765,91,41,88,0.466,26,60,0.433,15,28,0.536,20,32,0.625,117,2015-01-05,OKC,GSW
10827,27,@,L 91-101 ,240,34,82,0.415,23,56,0.411,11,26,0.423,12,16,0.75,91,39,76,0.513,31,60,0.517,8,16,0.5,15,21,0.714,101,2015-01-07,NYK,WAS
10828,28,Home,L 91-105 ,240,34,83,0.41,23,50,0.46,11,33,0.333,12,14,0.857,91,36,73,0.493,26,44,0.591,10,29,0.345,23,27,0.852,105,2015-01-14,BOS,ATL
10829,29,@,L 91-110 ,240,31,78,0.397,26,53,0.491,5,25,0.2,24,26,0.923,91,39,78,0.5,26,49,0.531,13,29,0.448,19,26,0.731,110,2015-01-21,IND,ATL
10830,30,Home,L 91-98 ,240,29,79,0.367,21,56,0.375,8,23,0.348,25,32,0.781,91,37,91,0.407,30,71,0.423,7,20,0.35,17,20,0.85,98,2015-01-21,PHI,NYK
10831,31,@,W 91-86 ,240,33,80,0.413,27,56,0.482,6,24,0.25,19,24,0.792,91,31,81,0.383,22,52,0.423,9,29,0.31,15,18,0.833,86,2015-01-23,TOR,PHI
10832,32,Home,L 91-104 ,240,34,82,0.415,27,64,0.422,7,18,0.389,16,23,0.696,91,34,73,0.466,25,47,0.532,9,26,0.346,27,34,0.794,104,2015-01-27,IND,TOR
10833,33,Home,W 91-85 ,240,34,78,0.436,24,50,0.48,10,28,0.357,13,18,0.722,91,31,81,0.383,17,46,0.37,14,35,0.4,9,15,0.6,85,2015-01-31,ATL,PHI
10834,34,@,L 91-108 ,240,35,74,0.473,29,60,0.483,6,14,0.429,15,23,0.652,91,42,88,0.477,33,68,0.485,9,20,0.45,15,18,0.833,108,2015-02-03,MIA,DET
10835,35,Home,L 91-102 ,240,37,97,0.381,30,72,0.417,7,25,0.28,10,13,0.769,91,45,85,0.529,40,70,0.571,5,15,0.333,7,11,0.636,102,2015-02-04,NOP,OKC
10836,36,Home,L 91-94 ,240,33,86,0.384,28,72,0.389,5,14,0.357,20,27,0.741,91,40,90,0.444,33,63,0.524,7,27,0.259,7,9,0.778,94,2015-02-11,MIN,GSW
10837,37,@,L 91-100 ,240,33,78,0.423,28,62,0.452,5,16,0.313,20,22,0.909,91,38,84,0.452,32,62,0.516,6,22,0.273,18,33,0.545,100,2015-02-20,CHI,DET
10838,38,Home,L 91-105 ,240,33,79,0.418,28,62,0.452,5,17,0.294,20,27,0.741,91,35,83,0.422,27,62,0.435,8,21,0.381,27,31,0.871,105,2015-02-21,MIA,NOP
10839,39,Home,L 91-93 ,240,32,81,0.395,25,55,0.455,7,26,0.269,20,21,0.952,91,34,79,0.43,24,54,0.444,10,25,0.4,15,20,0.75,93,2015-02-28,MIA,ATL
10840,40,Home,L 91-115 ,240,35,88,0.398,32,72,0.444,3,16,0.188,18,24,0.75,91,42,85,0.494,34,66,0.515,8,19,0.421,23,28,0.821,115,2015-03-04,BRK,CHO
10841,41,Home,W 91-85 ,240,36,78,0.462,26,58,0.448,10,20,0.5,9,15,0.6,91,31,81,0.383,22,53,0.415,9,28,0.321,14,22,0.636,85,2015-03-07,MIL,WAS
10842,42,Home,L 91-101 ,240,35,80,0.438,25,58,0.431,10,22,0.455,11,14,0.786,91,42,84,0.5,37,70,0.529,5,14,0.357,12,17,0.706,101,2015-03-09,CHI,MEM
10843,43,Home,L 91-111 ,240,35,84,0.417,29,68,0.426,6,16,0.375,15,23,0.652,91,45,87,0.517,33,66,0.5,12,21,0.571,9,11,0.818,111,2015-03-10,BRK,NOP
10844,44,@,L 91-97 ,240,34,85,0.4,24,67,0.358,10,18,0.556,13,13,1.0,91,39,79,0.494,31,61,0.508,8,18,0.444,11,16,0.688,97,2015-03-11,ORL,MIL
10845,45,@,L 91-109 ,240,34,79,0.43,27,47,0.574,7,32,0.219,16,24,0.667,91,44,92,0.478,33,59,0.559,11,33,0.333,10,17,0.588,109,2015-03-12,HOU,UTA
10846,46,@,L 91-101 ,240,31,82,0.378,16,50,0.32,15,32,0.469,14,19,0.737,91,33,89,0.371,26,70,0.371,7,19,0.368,28,33,0.848,101,2015-03-13,CHI,CHO
10847,47,@,W 91-86 ,240,34,76,0.447,29,53,0.547,5,23,0.217,18,27,0.667,91,34,85,0.4,27,67,0.403,7,18,0.389,11,15,0.733,86,2015-03-15,ATL,LAL
10848,48,@,L 91-108 ,240,37,79,0.468,30,52,0.577,7,27,0.259,10,19,0.526,91,43,81,0.531,36,65,0.554,7,16,0.438,15,19,0.789,108,2015-03-20,DEN,MIA
10849,49,@,L 91-101 ,240,36,91,0.396,30,73,0.411,6,18,0.333,13,16,0.813,91,37,78,0.474,28,57,0.491,9,21,0.429,18,25,0.72,101,2015-03-20,CHA,SAC
10850,50,@,L 91-107 ,240,33,77,0.429,27,56,0.482,6,21,0.286,19,24,0.792,91,44,90,0.489,33,64,0.516,11,26,0.423,8,10,0.8,107,2015-03-21,CHI,DET
10851,51,@,L 91-106 ,240,32,73,0.438,22,51,0.431,10,22,0.455,17,21,0.81,91,38,78,0.487,30,60,0.5,8,18,0.444,22,26,0.846,106,2015-03-21,UTA,GSW
10852,52,Home,L 91-110 ,240,32,89,0.36,31,72,0.431,1,17,0.059,26,30,0.867,91,47,92,0.511,41,70,0.586,6,22,0.273,10,14,0.714,110,2015-03-23,BRK,BOS
10853,53,@,W 91-88 ,240,39,91,0.429,36,77,0.468,3,14,0.214,10,11,0.909,91,36,91,0.396,33,79,0.418,3,12,0.25,13,20,0.65,88,2015-03-25,BRK,CHO
10854,54,@,L 91-130 ,240,36,90,0.4,30,72,0.417,6,18,0.333,13,14,0.929,91,51,88,0.58,38,67,0.567,13,21,0.619,15,19,0.789,130,2015-03-25,OKC,SAS
10855,55,@,L 91-107 ,240,32,81,0.395,27,54,0.5,5,27,0.185,22,31,0.71,91,39,76,0.513,26,52,0.5,13,24,0.542,16,23,0.696,107,2015-03-27,UTA,DEN
10856,56,Home,L 91-99 ,240,29,75,0.387,25,60,0.417,4,15,0.267,29,37,0.784,91,34,80,0.425,25,51,0.49,9,29,0.31,22,33,0.667,99,2015-03-29,WAS,HOU
10857,57,@,L 91-95 ,240,31,74,0.419,26,48,0.542,5,26,0.192,24,37,0.649,91,37,89,0.416,29,68,0.426,8,21,0.381,13,18,0.722,95,2015-04-01,CHI,MIL
10858,58,Home,L 91-103 ,240,39,93,0.419,34,76,0.447,5,17,0.294,8,9,0.889,91,35,86,0.407,22,57,0.386,13,29,0.448,20,23,0.87,103,2015-04-01,ORL,SAS
10859,59,@,L 91-92 ,240,28,76,0.368,17,50,0.34,11,26,0.423,24,33,0.727,91,35,86,0.407,34,73,0.466,1,13,0.077,21,23,0.913,92,2015-04-04,PHI,CHO
10860,60,@,L 91-101 ,240,38,99,0.384,28,67,0.418,10,32,0.313,5,8,0.625,91,37,72,0.514,34,59,0.576,3,13,0.231,24,29,0.828,101,2015-04-05,PHI,NYK
10861,61,@,L 91-116 ,240,32,85,0.376,29,74,0.392,3,11,0.273,24,29,0.828,91,42,85,0.494,30,52,0.577,12,33,0.364,20,23,0.87,116,2015-04-08,MIN,POR
10862,62,@,L 91-103 ,240,33,75,0.44,26,59,0.441,7,16,0.438,18,28,0.643,91,36,74,0.486,23,43,0.535,13,31,0.419,18,25,0.72,103,2015-04-08,SAC,UTA
10863,63,Home,L 91-99 ,240,34,72,0.472,29,59,0.492,5,13,0.385,18,24,0.75,91,37,76,0.487,31,59,0.525,6,17,0.353,19,29,0.655,99,2015-04-10,NYK,MIL
10864,64,@,L 91-107 ,240,35,85,0.412,31,69,0.449,4,16,0.25,17,23,0.739,91,35,69,0.507,27,50,0.54,8,19,0.421,29,34,0.853,107,2015-04-12,PHO,SAS
10865,65,Home,W 91-85 ,240,31,77,0.403,24,53,0.453,7,24,0.292,22,26,0.846,91,36,92,0.391,28,63,0.444,8,29,0.276,5,7,0.714,85,2015-04-15,CHI,ATL
10866,66,@,L 91-117 ,240,38,101,0.376,33,74,0.446,5,27,0.185,10,18,0.556,91,41,76,0.539,29,48,0.604,12,28,0.429,23,34,0.676,117,2015-04-15,UTA,HOU
10867,67,@,L 91-101 ,240,38,79,0.481,35,66,0.53,3,13,0.231,12,18,0.667,91,34,80,0.425,25,57,0.439,9,23,0.391,24,28,0.857,101,2015-10-31,BRK,MEM
10868,68,Home,L 91-102 ,240,33,86,0.384,26,63,0.413,7,23,0.304,18,25,0.72,91,37,82,0.451,32,65,0.492,5,17,0.294,23,26,0.885,102,2015-11-03,DAL,TOR
10869,69,Home,W 91-87 ,240,35,86,0.407,27,63,0.429,8,23,0.348,13,17,0.765,91,34,81,0.42,28,53,0.528,6,28,0.214,13,15,0.867,87,2015-11-04,MIL,PHI
10870,70,Home,L 91-102 ,240,32,77,0.416,28,53,0.528,4,24,0.167,23,32,0.719,91,38,79,0.481,32,62,0.516,6,17,0.353,20,31,0.645,102,2015-11-11,BOS,IND
10871,71,@,L 91-92 ,240,34,89,0.382,30,72,0.417,4,17,0.235,19,25,0.76,91,36,77,0.468,32,64,0.5,4,13,0.308,16,25,0.64,92,2015-11-12,UTA,MIA
10872,72,Home,L 91-103 ,240,36,79,0.456,31,55,0.564,5,24,0.208,14,30,0.467,91,36,97,0.371,32,76,0.421,4,21,0.19,27,35,0.771,103,2015-11-17,MIA,MIN
10873,73,Home,L 91-102 ,240,35,77,0.455,27,52,0.519,8,25,0.32,13,17,0.765,91,34,78,0.436,19,45,0.422,15,33,0.455,19,24,0.792,102,2015-11-20,LAL,TOR
10874,74,@,L 91-102 ,240,38,86,0.442,31,62,0.5,7,24,0.292,8,16,0.5,91,38,90,0.422,30,65,0.462,8,25,0.32,18,24,0.75,102,2015-11-20,LAC,POR
10875,75,@,L 91-96 ,240,31,82,0.378,21,51,0.412,10,31,0.323,19,24,0.792,91,30,69,0.435,25,51,0.49,5,18,0.278,31,45,0.689,96,2015-11-21,PHI,MIA
10876,76,Home,L 91-97 ,240,38,92,0.413,29,61,0.475,9,31,0.29,6,8,0.75,91,31,81,0.383,24,61,0.393,7,20,0.35,28,31,0.903,97,2015-11-21,ORL,SAC
10877,77,@,W 91-80 ,240,29,78,0.372,25,61,0.41,4,17,0.235,29,31,0.935,91,29,74,0.392,22,42,0.524,7,32,0.219,15,20,0.75,80,2015-11-22,TOR,LAC
10878,78,Home,L 91-102 ,240,38,75,0.507,34,63,0.54,4,12,0.333,11,17,0.647,91,39,77,0.506,33,64,0.516,6,13,0.462,18,25,0.72,102,2015-11-25,LAC,UTA
10879,79,@,L 91-100 ,240,31,83,0.373,22,56,0.393,9,27,0.333,20,25,0.8,91,34,86,0.395,29,70,0.414,5,16,0.313,27,32,0.844,100,2015-11-25,NYK,ORL
10880,80,@,W 91-80 ,240,36,75,0.48,28,53,0.528,8,22,0.364,11,14,0.786,91,31,77,0.403,24,57,0.421,7,20,0.35,11,13,0.846,80,2015-11-27,SAS,DEN
10881,81,Home,L 91-101 ,240,37,86,0.43,29,64,0.453,8,22,0.364,9,15,0.6,91,37,77,0.481,28,52,0.538,9,25,0.36,18,19,0.947,101,2015-11-27,SAC,MIN
10882,82,@,L 91-110 ,240,36,88,0.409,31,61,0.508,5,27,0.185,14,20,0.7,91,45,93,0.484,36,68,0.529,9,25,0.36,11,16,0.688,110,2015-11-29,BOS,ORL
10883,83,@,L 91-94 ,240,33,75,0.44,23,47,0.489,10,28,0.357,15,22,0.682,91,41,84,0.488,37,71,0.521,4,13,0.308,8,12,0.667,94,2015-12-01,PHO,BRK
10884,84,@,L 91-103 ,240,33,89,0.371,25,55,0.455,8,34,0.235,17,24,0.708,91,37,79,0.468,23,47,0.489,14,32,0.438,15,23,0.652,103,2015-12-01,LAL,PHI
10885,85,Home,L 91-103 ,240,30,79,0.38,24,52,0.462,6,27,0.222,25,39,0.641,91,32,76,0.421,25,56,0.446,7,20,0.35,32,39,0.821,103,2015-12-02,LAC,IND
10886,86,@,L 91-108 ,240,39,91,0.429,36,80,0.45,3,11,0.273,10,15,0.667,91,39,87,0.448,27,60,0.45,12,27,0.444,18,21,0.857,108,2015-12-04,BRK,NYK
10887,87,@,L 91-106 ,240,32,76,0.421,26,51,0.51,6,25,0.24,21,28,0.75,91,44,89,0.494,42,85,0.494,2,4,0.5,16,24,0.667,106,2015-12-05,NYK,MIL
10888,88,@,L 91-111 ,240,32,80,0.4,27,62,0.435,5,18,0.278,22,29,0.759,91,41,93,0.441,32,69,0.464,9,24,0.375,20,26,0.769,111,2015-12-06,LAL,DET
10889,89,@,L 91-100 ,240,34,87,0.391,30,56,0.536,4,31,0.129,19,22,0.864,91,37,74,0.5,31,60,0.517,6,14,0.429,20,27,0.741,100,2015-12-10,PHI,BRK
10890,90,@,L 91-107 ,240,37,94,0.394,32,73,0.438,5,21,0.238,12,17,0.706,91,41,82,0.5,36,62,0.581,5,20,0.25,20,24,0.833,107,2015-12-19,CHI,NYK
10891,91,Home,W 91-84 ,240,32,83,0.386,27,61,0.443,5,22,0.227,22,25,0.88,91,32,82,0.39,27,66,0.409,5,16,0.313,15,16,0.938,84,2015-12-23,CLE,NYK
10892,92,@,L 91-100 ,240,33,72,0.458,30,55,0.545,3,17,0.176,22,32,0.688,91,37,82,0.451,26,57,0.456,11,25,0.44,15,19,0.789,100,2015-12-23,MEM,WAS
10893,93,@,L 91-100 ,240,33,89,0.371,29,70,0.414,4,19,0.211,21,24,0.875,91,36,85,0.424,28,65,0.431,8,20,0.4,20,29,0.69,100,2015-12-27,NYK,BOS
10894,94,@,L 91-95 ,240,36,86,0.419,31,65,0.477,5,21,0.238,14,19,0.737,91,28,84,0.333,21,58,0.362,7,26,0.269,32,36,0.889,95,2015-12-28,PHI,UTA
10895,95,Home,L 91-108 ,240,34,87,0.391,27,63,0.429,7,24,0.292,16,24,0.667,91,41,78,0.526,34,55,0.618,7,23,0.304,19,25,0.76,108,2015-12-28,WAS,LAC
10896,96,@,L 91-114 ,240,33,81,0.407,26,62,0.419,7,19,0.368,18,24,0.75,91,42,82,0.512,28,55,0.509,14,27,0.519,16,20,0.8,114,2015-12-30,GSW,DAL
10897,97,@,L 91-94 ,240,35,87,0.402,27,65,0.415,8,22,0.364,13,17,0.765,91,28,82,0.341,22,58,0.379,6,24,0.25,32,39,0.821,94,2015-12-30,WAS,TOR
10898,98,@,L 91-103 ,240,40,85,0.471,35,65,0.538,5,20,0.25,6,8,0.75,91,43,92,0.467,35,66,0.53,8,26,0.308,9,10,0.9,103,2016-01-01,ORL,WAS
10899,99,@,W 91-78 ,240,35,91,0.385,32,76,0.421,3,15,0.2,18,26,0.692,91,28,72,0.389,21,44,0.477,7,28,0.25,15,24,0.625,78,2016-01-04,MEM,POR
10900,0,Home,L 91-93 ,240,30,75,0.4,18,46,0.391,12,29,0.414,19,25,0.76,91,33,68,0.485,22,42,0.524,11,26,0.423,16,21,0.762,93,2016-01-04,UTA,HOU
10901,1,@,W 91-74 ,240,35,80,0.438,31,58,0.534,4,22,0.182,17,18,0.944,91,31,78,0.397,26,62,0.419,5,16,0.313,7,12,0.583,74,2016-01-06,TOR,BRK
10902,2,Home,L 91-100 ,240,34,92,0.37,27,62,0.435,7,30,0.233,16,20,0.8,91,37,87,0.425,30,59,0.508,7,28,0.25,19,22,0.864,100,2016-01-06,NOP,DAL
10903,3,Home,W 91-84 ,240,30,82,0.366,22,64,0.344,8,18,0.444,23,30,0.767,91,32,87,0.368,28,68,0.412,4,19,0.211,16,19,0.842,84,2016-01-08,MEM,DEN
10904,4,@,W 91-86 ,240,36,81,0.444,31,60,0.517,5,21,0.238,14,19,0.737,91,31,83,0.373,22,54,0.407,9,29,0.31,15,20,0.75,86,2016-01-08,IND,NOP
10905,5,@,L 91-95 ,240,38,91,0.418,32,68,0.471,6,23,0.261,9,14,0.643,91,32,87,0.368,26,58,0.448,6,29,0.207,25,32,0.781,95,2016-01-12,NOP,LAL
10906,6,Home,L 91-107 ,240,33,72,0.458,26,54,0.481,7,18,0.389,18,24,0.75,91,33,77,0.429,15,42,0.357,18,35,0.514,23,27,0.852,107,2016-01-12,MEM,HOU
10907,7,@,W 91-77 ,240,34,87,0.391,26,52,0.5,8,35,0.229,15,23,0.652,91,26,74,0.351,20,49,0.408,6,25,0.24,19,29,0.655,77,2016-01-15,CLE,HOU
10908,8,@,W 91-79 ,240,36,74,0.486,31,62,0.5,5,12,0.417,14,16,0.875,91,27,74,0.365,22,52,0.423,5,22,0.227,20,26,0.769,79,2016-01-19,MIL,MIA
10909,9,@,W 91-78 ,240,36,77,0.468,31,60,0.517,5,17,0.294,14,20,0.7,91,35,84,0.417,31,65,0.477,4,19,0.211,4,8,0.5,78,2016-01-20,CLE,BRK
10910,10,Home,W 91-88 ,240,33,92,0.359,26,68,0.382,7,24,0.292,18,24,0.75,91,35,84,0.417,27,51,0.529,8,33,0.242,10,15,0.667,88,2016-01-21,SAC,ATL
10911,11,Home,L 91-116 ,240,32,75,0.427,25,51,0.49,7,24,0.292,20,30,0.667,91,44,90,0.489,35,68,0.515,9,22,0.409,19,23,0.826,116,2016-01-25,WAS,BOS
10912,12,@,W 91-89 ,240,32,78,0.41,17,41,0.415,15,37,0.405,12,24,0.5,91,35,83,0.422,30,67,0.448,5,16,0.313,14,24,0.583,89,2016-01-26,LAC,IND
10913,13,Home,L 91-114 ,240,32,85,0.376,23,60,0.383,9,25,0.36,18,23,0.783,91,47,95,0.495,41,78,0.526,6,17,0.353,14,16,0.875,114,2016-01-28,LAL,CHI
10914,14,Home,W 91-79 ,240,37,80,0.463,29,59,0.492,8,21,0.381,9,15,0.6,91,28,78,0.359,24,58,0.414,4,20,0.2,19,23,0.826,79,2016-01-29,DAL,BRK
10915,15,@,L 91-109 ,240,31,80,0.388,21,51,0.412,10,29,0.345,19,28,0.679,91,45,92,0.489,38,72,0.528,7,20,0.35,12,16,0.75,109,2016-01-29,CHA,POR
10916,16,Home,W 91-78 ,240,31,78,0.397,23,49,0.469,8,29,0.276,21,23,0.913,91,27,74,0.365,22,51,0.431,5,23,0.217,19,24,0.792,78,2016-01-31,DAL,PHO
10917,17,@,W 91-85 ,240,33,76,0.434,29,58,0.5,4,18,0.222,21,24,0.875,91,30,80,0.375,20,51,0.392,10,29,0.345,15,17,0.882,85,2016-02-05,MEM,NYK
10918,18,@,L 91-108 ,240,35,90,0.389,25,65,0.385,10,25,0.4,11,14,0.786,91,35,80,0.438,21,44,0.477,14,36,0.389,24,31,0.774,108,2016-02-08,CHI,CHO
10919,19,@,L 91-111 ,240,33,83,0.398,26,60,0.433,7,23,0.304,18,26,0.692,91,39,83,0.47,28,55,0.509,11,28,0.393,22,34,0.647,111,2016-02-24,PHI,DET
10920,20,Home,L 91-102 ,240,38,78,0.487,31,66,0.47,7,12,0.583,8,12,0.667,91,37,88,0.42,25,58,0.431,12,30,0.4,16,24,0.667,102,2016-02-27,MIL,DET
10921,21,@,L 91-99 ,240,34,96,0.354,30,68,0.441,4,28,0.143,19,22,0.864,91,32,78,0.41,25,62,0.403,7,16,0.438,28,30,0.933,99,2016-03-07,SAS,IND
10922,22,Home,L 91-116 ,240,36,79,0.456,32,64,0.5,4,15,0.267,15,19,0.789,91,47,85,0.553,43,66,0.652,4,19,0.211,18,19,0.947,116,2016-03-08,MIN,SAS
10923,23,@,W 91-84 ,240,38,80,0.475,30,55,0.545,8,25,0.32,7,14,0.5,91,30,86,0.349,23,60,0.383,7,26,0.269,17,23,0.739,84,2016-03-08,ATL,UTA
10924,24,@,L 91-105 ,240,36,82,0.439,27,61,0.443,9,21,0.429,10,12,0.833,91,37,77,0.481,24,49,0.49,13,28,0.464,18,25,0.72,105,2016-03-18,BOS,TOR
10925,25,Home,W 91-88 ,240,35,87,0.402,27,68,0.397,8,19,0.421,13,19,0.684,91,37,86,0.43,33,69,0.478,4,17,0.235,10,13,0.769,88,2016-03-21,CHA,SAS
10926,26,@,L 91-124 ,240,32,81,0.395,24,59,0.407,8,22,0.364,19,25,0.76,91,48,86,0.558,33,55,0.6,15,31,0.484,13,17,0.765,124,2016-03-21,DEN,CLE
10927,27,@,L 91-92 ,240,41,76,0.539,36,67,0.537,5,9,0.556,4,7,0.571,91,35,85,0.412,26,52,0.5,9,33,0.273,13,17,0.765,92,2016-03-21,MIL,DET
10928,28,Home,W 91-75 ,240,35,81,0.432,25,55,0.455,10,26,0.385,11,13,0.846,91,31,80,0.388,27,62,0.435,4,18,0.222,9,14,0.643,75,2016-03-21,IND,PHI
10929,29,Home,W 91-79 ,240,35,80,0.438,27,60,0.45,8,20,0.4,13,21,0.619,91,31,89,0.348,25,67,0.373,6,22,0.273,11,20,0.55,79,2016-03-23,BOS,TOR
10930,30,@,L 91-113 ,240,35,73,0.479,30,51,0.588,5,22,0.227,16,23,0.696,91,45,83,0.542,36,61,0.59,9,22,0.409,14,22,0.636,113,2016-03-24,UTA,OKC
10931,31,Home,L 91-115 ,240,37,84,0.44,33,69,0.478,4,15,0.267,13,15,0.867,91,41,74,0.554,25,45,0.556,16,29,0.552,17,21,0.81,115,2016-03-26,MIL,CHO
10932,32,Home,L 91-115 ,240,37,85,0.435,33,70,0.471,4,15,0.267,13,20,0.65,91,39,73,0.534,27,44,0.614,12,29,0.414,25,28,0.893,115,2016-03-26,NOP,TOR
10933,33,@,L 91-99 ,240,36,89,0.404,26,58,0.448,10,31,0.323,9,13,0.692,91,32,75,0.427,24,56,0.429,8,19,0.421,27,37,0.73,99,2016-03-28,NYK,NOP
10934,34,Home,W 91-89 ,240,35,85,0.412,27,60,0.45,8,25,0.32,13,17,0.765,91,35,77,0.455,32,60,0.533,3,17,0.176,16,18,0.889,89,2016-03-30,DAL,NYK
10935,35,@,L 91-100 ,240,33,90,0.367,23,51,0.451,10,39,0.256,15,21,0.714,91,36,84,0.429,29,57,0.509,7,27,0.259,21,27,0.778,100,2016-04-01,PHI,CHO
10936,36,@,L 91-105 ,240,36,101,0.356,32,77,0.416,4,24,0.167,15,20,0.75,91,42,84,0.5,28,61,0.459,14,23,0.609,7,7,1.0,105,2016-04-01,BRK,NYK
10937,37,@,W 91-81 ,240,37,83,0.446,30,58,0.517,7,25,0.28,10,14,0.714,91,32,90,0.356,28,71,0.394,4,19,0.211,13,17,0.765,81,2016-04-06,LAC,LAL
10938,38,@,L 91-98 ,240,30,74,0.405,22,44,0.5,8,30,0.267,23,33,0.697,91,37,76,0.487,28,58,0.483,9,18,0.5,15,37,0.405,98,2016-04-10,DAL,LAC
10939,39,Home,L 91-96 ,240,31,77,0.403,19,38,0.5,12,39,0.308,17,21,0.81,91,35,74,0.473,29,51,0.569,6,23,0.261,20,26,0.769,96,2016-04-13,DAL,SAS
10940,40,@,L 91-109 ,240,35,84,0.417,31,62,0.5,4,22,0.182,17,22,0.773,91,41,86,0.477,38,68,0.559,3,18,0.167,24,29,0.828,109,2016-10-26,DET,TOR
10941,41,Home,L 91-97 ,240,32,86,0.372,18,52,0.346,14,34,0.412,13,20,0.65,91,35,92,0.38,28,70,0.4,7,22,0.318,20,24,0.833,97,2016-10-28,MIA,CHO
10942,42,Home,L 91-94 ,240,35,90,0.389,31,74,0.419,4,16,0.25,17,18,0.944,91,33,79,0.418,21,47,0.447,12,32,0.375,16,22,0.727,94,2016-10-28,TOR,CLE
10943,43,Home,L 91-106 ,240,33,76,0.434,27,56,0.482,6,20,0.3,19,21,0.905,91,38,76,0.5,23,45,0.511,15,31,0.484,15,18,0.833,106,2016-11-01,SAS,UTA
10944,44,@,L 91-117 ,240,33,84,0.393,23,56,0.411,10,28,0.357,15,19,0.789,91,41,82,0.5,27,49,0.551,14,33,0.424,21,25,0.84,117,2016-11-05,SAC,MIL
10945,45,Home,L 91-96 ,240,30,84,0.357,23,54,0.426,7,30,0.233,24,31,0.774,91,34,78,0.436,29,62,0.468,5,16,0.313,23,31,0.742,96,2016-11-06,TOR,SAC
10946,46,Home,L 91-101 ,240,34,85,0.4,26,64,0.406,8,21,0.381,15,20,0.75,91,38,74,0.514,29,47,0.617,9,27,0.333,16,22,0.727,101,2016-11-10,SAC,LAL
10947,47,Home,L 91-102 ,240,38,81,0.469,33,64,0.516,5,17,0.294,10,19,0.526,91,40,81,0.494,34,61,0.557,6,20,0.3,16,19,0.842,102,2016-11-12,MIA,UTA
10948,48,@,L 91-105 ,240,33,85,0.388,26,59,0.441,7,26,0.269,18,23,0.783,91,42,86,0.488,34,64,0.531,8,22,0.364,13,30,0.433,105,2016-11-20,UTA,DEN
10949,49,@,L 91-96 ,240,35,74,0.473,27,47,0.574,8,27,0.296,13,20,0.65,91,35,75,0.467,27,55,0.491,8,20,0.4,18,25,0.72,96,2016-11-21,DAL,SAS
10950,50,Home,L 91-94 ,240,35,80,0.438,28,57,0.491,7,23,0.304,14,20,0.7,91,40,88,0.455,34,59,0.576,6,29,0.207,8,10,0.8,94,2016-11-25,ORL,WAS
10951,51,Home,W 91-81 ,240,32,77,0.416,22,50,0.44,10,27,0.37,17,20,0.85,91,30,77,0.39,25,57,0.439,5,20,0.25,16,18,0.889,81,2016-11-27,DAL,NOP
10952,52,Home,W 91-70 ,240,40,92,0.435,35,73,0.479,5,19,0.263,6,7,0.857,91,22,70,0.314,18,46,0.391,4,24,0.167,22,27,0.815,70,2016-11-27,IND,LAC
10953,53,@,L 91-102 ,240,33,75,0.44,31,60,0.517,2,15,0.133,23,32,0.719,91,40,88,0.455,32,67,0.478,8,21,0.381,14,21,0.667,102,2016-12-06,CHI,DET
10954,54,@,L 91-96 ,240,32,82,0.39,18,41,0.439,14,41,0.341,13,26,0.5,91,33,86,0.384,31,69,0.449,2,17,0.118,28,35,0.8,96,2016-12-06,PHI,MEM
10955,55,Home,L 91-105 ,240,36,82,0.439,29,62,0.468,7,20,0.35,12,18,0.667,91,39,74,0.527,28,50,0.56,11,24,0.458,16,19,0.842,105,2016-12-06,MIN,SAS
10956,56,@,L 91-95 ,240,39,97,0.402,30,69,0.435,9,28,0.321,4,5,0.8,91,35,80,0.438,31,63,0.492,4,17,0.235,21,27,0.778,95,2016-12-08,SAS,CHI
10957,57,@,L 91-103 ,240,38,96,0.396,31,74,0.419,7,22,0.318,8,10,0.8,91,37,84,0.44,32,66,0.485,5,18,0.278,24,28,0.857,103,2016-12-23,CHI,CHO
10958,58,Home,W 91-87 ,240,33,89,0.371,22,61,0.361,11,28,0.393,14,21,0.667,91,36,87,0.414,28,67,0.418,8,20,0.4,7,13,0.538,87,2016-12-23,NOP,MIA
10959,59,Home,L 91-95 ,240,35,83,0.422,27,60,0.45,8,23,0.348,13,18,0.722,91,32,95,0.337,20,61,0.328,12,34,0.353,19,24,0.792,95,2016-12-26,POR,TOR
10960,60,Home,W 91-82 ,240,36,93,0.387,31,67,0.463,5,26,0.192,14,18,0.778,91,33,82,0.402,23,54,0.426,10,28,0.357,6,13,0.462,82,2016-12-29,CHA,MIA
10961,61,@,L 91-99 ,240,30,75,0.4,23,48,0.479,7,27,0.259,24,29,0.828,91,37,83,0.446,28,62,0.452,9,21,0.429,16,23,0.696,99,2016-12-29,TOR,PHO
10962,62,Home,W 91-86 ,240,35,73,0.479,27,53,0.509,8,20,0.4,13,20,0.65,91,36,87,0.414,29,70,0.414,7,17,0.412,7,10,0.7,86,2016-12-31,UTA,PHO
10963,63,@,L 91-101 ,240,38,87,0.437,32,61,0.525,6,26,0.231,9,12,0.75,91,37,86,0.43,25,47,0.532,12,39,0.308,15,21,0.714,101,2017-01-02,WAS,HOU
10964,64,@,L 91-93 ,240,33,82,0.402,26,58,0.448,7,24,0.292,18,20,0.9,91,33,85,0.388,26,53,0.491,7,32,0.219,20,25,0.8,93,2017-01-03,MIN,PHI
10965,65,@,L 91-126 ,240,31,88,0.352,22,54,0.407,9,34,0.265,20,27,0.741,91,46,91,0.505,31,57,0.544,15,34,0.441,19,24,0.792,126,2017-01-16,CLE,GSW
10966,66,@,L 91-107 ,240,31,76,0.408,25,47,0.532,6,29,0.207,23,32,0.719,91,38,83,0.458,27,55,0.491,11,28,0.393,20,25,0.8,107,2017-01-20,SAC,MEM
10967,67,@,L 91-107 ,240,37,100,0.37,31,74,0.419,6,26,0.231,11,16,0.688,91,41,92,0.446,33,63,0.524,8,29,0.276,17,22,0.773,107,2017-01-29,OKC,CLE
10968,68,@,L 91-105 ,240,37,84,0.44,32,67,0.478,5,17,0.294,12,22,0.545,91,38,83,0.458,28,52,0.538,10,31,0.323,19,22,0.864,105,2017-02-04,NOP,WAS
10969,69,@,L 91-110 ,240,29,87,0.333,24,64,0.375,5,23,0.217,28,34,0.824,91,35,72,0.486,21,48,0.438,14,24,0.583,26,34,0.765,110,2017-02-08,PHO,MEM
10970,70,@,L 91-98 ,240,35,92,0.38,25,55,0.455,10,37,0.27,11,11,1.0,91,36,82,0.439,30,63,0.476,6,19,0.316,20,22,0.909,98,2017-02-15,DAL,DET
10971,71,Home,L 91-95 ,240,33,89,0.371,27,56,0.482,6,33,0.182,19,25,0.76,91,37,75,0.493,29,57,0.509,8,18,0.444,13,22,0.591,95,2017-02-15,MEM,NOP
10972,72,Home,L 91-92 ,240,33,73,0.452,24,49,0.49,9,24,0.375,16,19,0.842,91,33,78,0.423,26,52,0.5,7,26,0.269,19,23,0.826,92,2017-02-27,NYK,TOR
10973,73,Home,L 91-101 ,240,35,83,0.422,29,66,0.439,6,17,0.353,15,20,0.75,91,41,85,0.482,35,60,0.583,6,25,0.24,13,16,0.813,101,2017-03-04,CHI,LAC
10974,74,@,L 91-107 ,240,35,83,0.422,26,59,0.441,9,24,0.375,12,18,0.667,91,42,86,0.488,37,66,0.561,5,20,0.25,18,20,0.9,107,2017-03-08,LAC,MIN
10975,75,@,L 91-98 ,240,36,81,0.444,24,53,0.453,12,28,0.429,7,11,0.636,91,37,89,0.416,30,64,0.469,7,25,0.28,17,21,0.81,98,2017-03-08,CHI,ORL
10976,76,@,W 90-84 ,240,34,86,0.395,28,60,0.467,6,26,0.231,16,20,0.8,90,31,74,0.419,30,67,0.448,1,7,0.143,21,34,0.618,84,2011-12-26,BRK,WAS
10977,77,@,L 90-115 ,240,29,74,0.392,22,54,0.407,7,20,0.35,25,33,0.758,90,45,80,0.563,35,61,0.574,10,19,0.526,15,15,1.0,115,2011-12-28,LAC,SAS
10978,78,@,W 90-85 ,240,32,81,0.395,25,65,0.385,7,16,0.438,19,22,0.864,90,36,79,0.456,30,64,0.469,6,15,0.4,7,13,0.538,85,2011-12-28,IND,TOR
10979,79,@,L 90-99 ,240,35,88,0.398,31,65,0.477,4,23,0.174,16,24,0.667,90,33,71,0.465,31,53,0.585,2,18,0.111,31,37,0.838,99,2012-01-01,LAL,DEN
10980,80,@,L 90-129 ,240,35,92,0.38,29,74,0.392,6,18,0.333,14,21,0.667,90,48,80,0.6,41,69,0.594,7,11,0.636,26,31,0.839,129,2012-01-01,CHA,MIA
10981,81,@,W 90-85 ,240,30,68,0.441,23,51,0.451,7,17,0.412,23,29,0.793,90,28,78,0.359,18,43,0.419,10,35,0.286,19,25,0.76,85,2012-01-02,TOR,NYK
10982,82,@,L 90-94 ,240,37,74,0.5,34,64,0.531,3,10,0.3,13,16,0.813,90,37,76,0.487,32,61,0.525,5,15,0.333,15,23,0.652,94,2012-01-02,NOP,UTA
10983,83,@,W 90-86 ,240,33,80,0.413,30,71,0.423,3,9,0.333,21,25,0.84,90,33,82,0.402,26,61,0.426,7,21,0.333,13,24,0.542,86,2012-01-04,MEM,MIN
10984,84,@,L 90-97 ,240,38,77,0.494,34,63,0.54,4,14,0.286,10,19,0.526,90,37,77,0.481,34,66,0.515,3,11,0.273,20,29,0.69,97,2012-01-06,GSW,LAL
10985,85,Home,L 90-101 ,240,28,83,0.337,18,50,0.36,10,33,0.303,24,32,0.75,90,38,76,0.5,33,61,0.541,5,15,0.333,20,24,0.833,101,2012-01-07,BRK,MIA
10986,86,Home,W 90-82 ,240,35,74,0.473,29,55,0.527,6,19,0.316,14,21,0.667,90,38,93,0.409,37,84,0.44,1,9,0.111,5,10,0.5,82,2012-01-08,LAL,MEM
10987,87,@,W 90-85 ,240,35,79,0.443,29,63,0.46,6,16,0.375,14,25,0.56,90,29,64,0.453,25,53,0.472,4,11,0.364,23,32,0.719,85,2012-01-11,DAL,BOS
10988,88,@,W 90-87 (OT),265,35,82,0.427,31,73,0.425,4,9,0.444,16,19,0.842,90,36,93,0.387,32,79,0.405,4,14,0.286,11,16,0.688,87,2012-01-11,LAL,UTA
10989,89,Home,L 90-101 ,240,34,75,0.453,26,54,0.481,8,21,0.381,14,20,0.7,90,39,89,0.438,29,70,0.414,10,19,0.526,13,21,0.619,101,2012-01-12,PHO,CLE
10990,90,Home,L 90-95 ,240,33,74,0.446,29,57,0.509,4,17,0.235,20,32,0.625,90,30,66,0.455,27,58,0.466,3,8,0.375,32,38,0.842,95,2012-01-13,TOR,IND
10991,91,Home,L 90-103 ,240,38,88,0.432,35,74,0.473,3,14,0.214,11,17,0.647,90,37,86,0.43,31,70,0.443,6,16,0.375,23,27,0.852,103,2012-01-14,WAS,PHI
10992,92,Home,W 90-88 (OT),265,35,88,0.398,26,61,0.426,9,27,0.333,11,13,0.846,90,37,94,0.394,34,83,0.41,3,11,0.273,11,16,0.688,88,2012-01-19,HOU,NOH
10993,93,Home,W 90-76 ,240,35,84,0.417,31,67,0.463,4,17,0.235,16,19,0.842,90,32,74,0.432,27,59,0.458,5,15,0.333,7,8,0.875,76,2012-01-20,PHI,ATL
10994,94,Home,L 90-91 ,240,38,76,0.5,29,51,0.569,9,25,0.36,5,8,0.625,90,36,85,0.424,34,72,0.472,2,13,0.154,17,23,0.739,91,2012-01-23,GSW,MEM
10995,95,Home,L 90-95 ,240,36,90,0.4,33,77,0.429,3,13,0.231,15,21,0.714,90,38,80,0.475,33,70,0.471,5,10,0.5,14,21,0.667,95,2012-01-25,CHI,IND
10996,96,Home,L 90-105 ,240,39,95,0.411,33,73,0.452,6,22,0.273,6,10,0.6,90,34,77,0.442,25,56,0.446,9,21,0.429,28,33,0.848,105,2012-01-25,DAL,MIN
10997,97,Home,L 90-97 (OT),265,35,79,0.443,30,65,0.462,5,14,0.357,15,19,0.789,90,37,82,0.451,25,55,0.455,12,27,0.444,11,14,0.786,97,2012-01-25,PHI,NJN
10998,98,Home,L 90-93 ,240,34,75,0.453,27,58,0.466,7,17,0.412,15,21,0.714,90,37,73,0.507,32,59,0.542,5,14,0.357,14,19,0.737,93,2012-01-31,CLE,BOS
10999,99,@,L 90-93 ,240,35,82,0.427,29,66,0.439,6,16,0.375,14,19,0.737,90,37,91,0.407,29,67,0.433,8,24,0.333,11,13,0.846,93,2012-01-31,SAC,GSW
11000,0,Home,L 90-113 ,240,37,93,0.398,36,81,0.444,1,12,0.083,15,19,0.789,90,48,90,0.533,34,60,0.567,14,30,0.467,3,4,0.75,113,2012-02-04,MIL,CHI
11001,1,Home,L 90-99 ,240,33,84,0.393,27,60,0.45,6,24,0.25,18,21,0.857,90,41,79,0.519,30,55,0.545,11,24,0.458,6,7,0.857,99,2012-02-06,ATL,PHO
11002,2,Home,L 90-99 ,240,34,78,0.436,31,56,0.554,3,22,0.136,19,33,0.576,90,35,81,0.432,25,62,0.403,10,19,0.526,19,24,0.792,99,2012-02-06,DEN,HOU
11003,3,@,L 90-95 ,240,34,81,0.42,27,57,0.474,7,24,0.292,15,20,0.75,90,38,81,0.469,30,64,0.469,8,17,0.471,11,17,0.647,95,2012-02-06,LAL,PHI
11004,4,@,W 90-67 ,240,39,85,0.459,35,69,0.507,4,16,0.25,8,12,0.667,90,28,75,0.373,27,72,0.375,1,3,0.333,10,17,0.588,67,2012-02-08,CHI,NOH
11005,5,Home,L 90-100 ,240,38,93,0.409,31,79,0.392,7,14,0.5,7,11,0.636,90,37,84,0.44,32,69,0.464,5,15,0.333,21,26,0.808,100,2012-02-08,PHI,SAS
11006,6,Home,L 90-105 ,240,33,76,0.434,31,61,0.508,2,15,0.133,22,29,0.759,90,35,70,0.5,30,57,0.526,5,13,0.385,30,35,0.857,105,2012-02-14,IND,MIA
11007,7,@,W 90-87 ,240,33,80,0.413,27,63,0.429,6,17,0.353,18,27,0.667,90,37,73,0.507,33,58,0.569,4,15,0.267,9,15,0.6,87,2012-02-14,NYK,TOR
11008,8,@,L 90-102 ,240,38,85,0.447,31,67,0.463,7,18,0.389,7,15,0.467,90,43,85,0.506,39,69,0.565,4,16,0.25,12,16,0.75,102,2012-02-15,CHA,MIN
11009,9,Home,W 90-78 ,240,38,80,0.475,35,68,0.515,3,12,0.25,11,14,0.786,90,27,74,0.365,16,45,0.356,11,29,0.379,13,25,0.52,78,2012-02-19,MIA,ORL
11010,10,@,L 90-102 ,240,35,78,0.449,32,60,0.533,3,18,0.167,17,25,0.68,90,34,80,0.425,27,60,0.45,7,20,0.35,27,32,0.844,102,2012-02-19,LAL,PHO
11011,11,Home,W 90-79 ,240,34,88,0.386,26,68,0.382,8,20,0.4,14,19,0.737,90,30,74,0.405,21,49,0.429,9,25,0.36,10,21,0.476,79,2012-02-20,CHI,ATL
11012,12,Home,L 90-93 ,240,37,91,0.407,32,69,0.464,5,22,0.227,11,13,0.846,90,33,76,0.434,25,54,0.463,8,22,0.364,19,25,0.76,93,2012-02-20,MIL,ORL
11013,13,@,L 90-97 ,240,30,73,0.411,24,50,0.48,6,23,0.261,24,29,0.828,90,37,85,0.435,29,68,0.426,8,17,0.471,15,22,0.682,97,2012-03-03,OKC,ATL
11014,14,Home,L 90-96 ,240,37,76,0.487,31,52,0.596,6,24,0.25,10,17,0.588,90,38,91,0.418,33,74,0.446,5,17,0.294,15,24,0.625,96,2012-03-09,OKC,CLE
11015,15,@,L 90-105 ,240,34,71,0.479,31,59,0.525,3,12,0.25,19,28,0.679,90,39,72,0.542,32,61,0.525,7,11,0.636,20,26,0.769,105,2012-03-12,DET,UTA
11016,16,Home,L 90-103 ,240,34,78,0.436,29,56,0.518,5,22,0.227,17,25,0.68,90,36,79,0.456,24,54,0.444,12,25,0.48,19,24,0.792,103,2012-03-15,DEN,OKC
11017,17,@,L 90-97 ,240,30,71,0.423,22,52,0.423,8,19,0.421,22,30,0.733,90,38,80,0.475,33,70,0.471,5,10,0.5,16,22,0.727,97,2012-03-20,OKC,UTA
11018,18,@,L 90-97 ,240,35,90,0.389,30,63,0.476,5,27,0.185,15,24,0.625,90,34,59,0.576,32,54,0.593,2,5,0.4,27,34,0.794,97,2012-03-22,LAC,NOH
11019,19,Home,W 90-87 ,240,31,85,0.365,21,55,0.382,10,30,0.333,18,27,0.667,90,32,74,0.432,25,52,0.481,7,22,0.318,16,17,0.941,87,2012-03-25,POR,GSW
11020,20,@,L 90-105 ,240,29,69,0.42,21,49,0.429,8,20,0.4,24,37,0.649,90,37,81,0.457,27,63,0.429,10,18,0.556,21,28,0.75,105,2012-03-26,MIA,IND
11021,21,Home,W 90-81 ,240,34,73,0.466,28,54,0.519,6,19,0.316,16,20,0.8,90,33,79,0.418,27,58,0.466,6,21,0.286,9,12,0.75,81,2012-03-27,DAL,HOU
11022,22,@,L 90-100 ,240,31,70,0.443,25,53,0.472,6,17,0.353,22,33,0.667,90,37,73,0.507,33,54,0.611,4,19,0.211,22,26,0.846,100,2012-03-30,NYK,ATL
11023,23,@,L 90-95 ,240,35,74,0.473,31,60,0.517,4,14,0.286,16,22,0.727,90,37,77,0.481,31,65,0.477,6,12,0.5,15,19,0.789,95,2012-03-31,ATL,PHI
11024,24,Home,L 90-125 ,240,34,82,0.415,25,58,0.431,9,24,0.375,13,15,0.867,90,48,81,0.593,37,58,0.638,11,23,0.478,18,21,0.857,125,2012-04-03,CLE,SAS
11025,25,@,L 90-95 ,240,36,85,0.424,34,73,0.466,2,12,0.167,16,24,0.667,90,37,91,0.407,32,76,0.421,5,15,0.333,16,24,0.667,95,2012-04-06,CHA,MIL
11026,26,@,L 90-99 ,240,33,81,0.407,23,56,0.411,10,25,0.4,14,18,0.778,90,40,82,0.488,36,69,0.522,4,13,0.308,15,19,0.789,99,2012-04-07,MIN,NOH
11027,27,Home,L 90-114 ,240,32,83,0.386,26,61,0.426,6,22,0.273,20,23,0.87,90,47,82,0.573,40,62,0.645,7,20,0.35,13,16,0.813,114,2012-04-09,MIN,PHO
11028,28,@,L 90-103 ,240,37,79,0.468,34,68,0.5,3,11,0.273,13,16,0.813,90,40,83,0.482,29,64,0.453,11,19,0.579,12,14,0.857,103,2012-04-10,CHA,CLE
11029,29,@,L 90-93 ,240,37,83,0.446,32,67,0.478,5,16,0.313,11,17,0.647,90,33,74,0.446,24,50,0.48,9,24,0.375,18,24,0.75,93,2012-04-19,LAC,PHO
11030,30,@,L 90-98 ,240,35,83,0.422,23,50,0.46,12,33,0.364,8,15,0.533,90,36,79,0.456,30,60,0.5,6,19,0.316,20,27,0.741,98,2012-04-20,NYK,CLE
11031,31,@,W 90-85 ,240,36,101,0.356,31,85,0.365,5,16,0.313,13,18,0.722,90,36,81,0.444,30,65,0.462,6,16,0.375,7,9,0.778,85,2012-04-25,PHI,MIL
11032,32,@,W 90-88 ,240,37,78,0.474,32,67,0.478,5,11,0.455,11,16,0.688,90,33,91,0.363,27,74,0.365,6,17,0.353,16,19,0.842,88,2012-10-31,IND,TOR
11033,33,Home,W 90-89 ,240,31,85,0.365,24,66,0.364,7,19,0.368,21,24,0.875,90,33,83,0.398,26,57,0.456,7,26,0.269,16,27,0.593,89,2012-11-02,CHA,IND
11034,34,Home,L 90-108 ,240,35,91,0.385,29,76,0.382,6,15,0.4,14,21,0.667,90,44,83,0.53,38,67,0.567,6,16,0.375,14,19,0.737,108,2012-11-07,MIL,MEM
11035,35,Home,W 90-75 ,240,34,76,0.447,27,56,0.482,7,20,0.35,15,22,0.682,90,28,80,0.35,25,68,0.368,3,12,0.25,16,20,0.8,75,2012-11-07,MIN,ORL
11036,36,Home,L 90-103 ,240,32,75,0.427,25,55,0.455,7,20,0.35,19,30,0.633,90,41,77,0.532,38,64,0.594,3,13,0.231,18,25,0.72,103,2012-11-08,POR,LAC
11037,37,@,L 90-103 ,240,36,90,0.4,29,67,0.433,7,23,0.304,11,14,0.786,90,36,81,0.444,28,56,0.5,8,25,0.32,23,30,0.767,103,2012-11-11,SAC,LAL
11038,38,@,W 90-82 ,240,30,65,0.462,26,50,0.52,4,15,0.267,26,32,0.813,90,29,80,0.363,25,64,0.391,4,16,0.25,20,25,0.8,82,2012-11-12,MIN,DAL
11039,39,Home,L 90-92 ,240,33,83,0.398,27,66,0.409,6,17,0.353,18,27,0.667,90,27,73,0.37,26,63,0.413,1,10,0.1,37,42,0.881,92,2012-11-12,DET,OKC
11040,40,Home,L 90-99 ,240,37,80,0.463,31,62,0.5,6,18,0.333,10,19,0.526,90,36,75,0.48,31,58,0.534,5,17,0.294,22,25,0.88,99,2012-11-18,SAC,BRK
11041,41,@,L 90-95 ,240,34,82,0.415,27,59,0.458,7,23,0.304,15,21,0.714,90,35,73,0.479,29,52,0.558,6,21,0.286,19,37,0.514,95,2012-11-20,BRK,LAL
11042,42,Home,W 90-74 ,240,36,83,0.434,31,63,0.492,5,20,0.25,13,18,0.722,90,28,85,0.329,25,68,0.368,3,17,0.176,15,22,0.682,74,2012-11-21,ORL,DET
11043,43,@,L 90-91 ,240,32,78,0.41,26,60,0.433,6,18,0.333,20,25,0.8,90,36,78,0.462,32,65,0.492,4,13,0.308,15,26,0.577,91,2012-11-23,TOR,DET
11044,44,Home,W 90-78 ,240,34,85,0.4,30,73,0.411,4,12,0.333,18,21,0.857,90,29,72,0.403,25,56,0.446,4,16,0.25,16,20,0.8,78,2012-11-30,MEM,DET
11045,45,@,L 90-112 ,240,34,84,0.405,29,65,0.446,5,19,0.263,17,19,0.895,90,45,90,0.5,39,70,0.557,6,20,0.3,16,21,0.762,112,2012-12-05,DAL,LAC
11046,46,@,L 90-106 ,240,35,78,0.449,27,60,0.45,8,18,0.444,12,13,0.923,90,40,69,0.58,33,58,0.569,7,11,0.636,19,24,0.792,106,2012-12-08,NOP,MIA
11047,47,Home,L 90-98 ,240,36,78,0.462,31,58,0.534,5,20,0.25,13,18,0.722,90,40,77,0.519,35,62,0.565,5,15,0.333,13,18,0.722,98,2012-12-09,PHO,ORL
11048,48,@,L 90-113 ,240,34,79,0.43,28,58,0.483,6,21,0.286,16,20,0.8,90,43,75,0.573,29,46,0.63,14,29,0.483,13,23,0.565,113,2012-12-13,CHA,ATL
11049,49,@,L 90-98 ,240,33,72,0.458,27,53,0.509,6,19,0.316,18,25,0.72,90,40,88,0.455,33,61,0.541,7,27,0.259,11,12,0.917,98,2012-12-13,SAS,POR
11050,50,@,W 90-86 ,240,33,83,0.398,28,68,0.412,5,15,0.333,19,27,0.704,90,32,81,0.395,23,63,0.365,9,18,0.5,13,14,0.929,86,2012-12-14,MIL,CLE
11051,51,@,L 90-101 ,240,34,83,0.41,31,70,0.443,3,13,0.231,19,24,0.792,90,41,85,0.482,33,63,0.524,8,22,0.364,11,15,0.733,101,2012-12-17,SAC,PHO
11052,52,Home,L 90-92 ,240,33,77,0.429,26,60,0.433,7,17,0.412,17,22,0.773,90,37,83,0.446,32,63,0.508,5,20,0.25,13,16,0.813,92,2012-12-18,BRK,UTA
11053,53,Home,W 90-80 ,240,36,88,0.409,33,80,0.413,3,8,0.375,15,19,0.789,90,30,85,0.353,25,65,0.385,5,20,0.25,15,19,0.789,80,2012-12-19,MEM,MIL
11054,54,Home,W 90-83 ,240,34,81,0.42,26,61,0.426,8,20,0.4,14,17,0.824,90,34,77,0.442,25,60,0.417,9,17,0.529,6,8,0.75,83,2012-12-19,ORL,WAS
11055,55,@,L 90-93 ,240,35,70,0.5,31,56,0.554,4,14,0.286,16,19,0.842,90,33,81,0.407,25,62,0.403,8,19,0.421,19,21,0.905,93,2012-12-21,ORL,TOR
11056,56,Home,W 90-72 ,240,39,80,0.488,38,69,0.551,1,11,0.091,11,13,0.846,90,29,74,0.392,27,64,0.422,2,10,0.2,12,19,0.632,72,2013-01-09,TOR,PHI
11057,57,@,L 90-92 ,240,35,77,0.455,29,58,0.5,6,19,0.316,14,20,0.7,90,30,80,0.375,21,53,0.396,9,27,0.333,23,30,0.767,92,2013-01-10,MIA,POR
11058,58,@,W 90-87 ,240,36,71,0.507,31,61,0.508,5,10,0.5,13,18,0.722,90,34,65,0.523,28,49,0.571,6,16,0.375,13,21,0.619,87,2013-01-12,UTA,DET
11059,59,Home,L 90-102 ,240,35,84,0.417,26,59,0.441,9,25,0.36,11,18,0.611,90,40,84,0.476,35,67,0.522,5,17,0.294,17,22,0.773,102,2013-01-14,PHO,OKC
11060,60,@,W 90-78 ,240,31,71,0.437,29,54,0.537,2,17,0.118,26,31,0.839,90,34,74,0.459,30,56,0.536,4,18,0.222,6,16,0.375,78,2013-01-16,NOP,BOS
11061,61,Home,L 90-99 ,240,31,72,0.431,21,50,0.42,10,22,0.455,18,28,0.643,90,40,83,0.482,38,70,0.543,2,13,0.154,17,23,0.739,99,2013-01-17,LAL,MIA
11062,62,@,W 90-77 ,240,35,77,0.455,30,64,0.469,5,13,0.385,15,23,0.652,90,30,84,0.357,26,65,0.4,4,19,0.211,13,20,0.65,77,2013-01-17,LAC,MIN
11063,63,@,W 90-85 ,240,34,81,0.42,31,63,0.492,3,18,0.167,19,26,0.731,90,37,84,0.44,33,70,0.471,4,14,0.286,7,11,0.636,85,2013-01-21,SAS,PHI
11064,64,@,L 90-95 ,240,32,84,0.381,25,67,0.373,7,17,0.412,19,22,0.864,90,37,82,0.451,35,70,0.5,2,12,0.167,19,22,0.864,95,2013-01-22,BOS,CLE
11065,65,@,L 90-105 ,240,38,84,0.452,30,64,0.469,8,20,0.4,6,8,0.75,90,42,91,0.462,35,68,0.515,7,23,0.304,14,21,0.667,105,2013-01-22,ORL,DET
11066,66,Home,L 90-117 ,240,34,84,0.405,32,73,0.438,2,11,0.182,20,28,0.714,90,46,98,0.469,35,75,0.467,11,23,0.478,14,22,0.636,117,2013-01-29,DET,MIL
11067,67,Home,L 90-96 ,240,33,76,0.434,28,57,0.491,5,19,0.263,19,27,0.704,90,35,76,0.461,32,67,0.478,3,9,0.333,23,36,0.639,96,2013-01-30,MIN,LAC
11068,68,@,L 90-98 ,240,37,79,0.468,33,62,0.532,4,17,0.235,12,15,0.8,90,37,84,0.44,30,72,0.417,7,12,0.583,17,27,0.63,98,2013-02-04,LAC,WAS
11069,69,Home,L 90-96 ,240,36,82,0.439,33,73,0.452,3,9,0.333,15,17,0.882,90,37,73,0.507,33,63,0.524,4,10,0.4,18,22,0.818,96,2013-02-05,MEM,PHO
11070,70,Home,L 90-93 ,240,36,83,0.434,33,66,0.5,3,17,0.176,15,21,0.714,90,34,82,0.415,28,66,0.424,6,16,0.375,19,25,0.76,93,2013-02-06,DET,BRK
11071,71,Home,L 90-102 ,240,36,95,0.379,31,72,0.431,5,23,0.217,13,22,0.591,90,42,74,0.568,38,62,0.613,4,12,0.333,14,17,0.824,102,2013-02-11,MIL,WAS
11072,72,Home,L 90-107 ,240,35,84,0.417,26,66,0.394,9,18,0.5,11,16,0.688,90,44,75,0.587,36,56,0.643,8,19,0.421,11,22,0.5,107,2013-02-11,PHI,LAC
11073,73,@,L 90-97 ,240,35,79,0.443,28,59,0.475,7,20,0.35,13,16,0.813,90,33,77,0.429,26,57,0.456,7,20,0.35,24,36,0.667,97,2013-02-19,BOS,DEN
11074,74,Home,L 90-103 ,240,36,72,0.5,29,46,0.63,7,26,0.269,11,16,0.688,90,37,78,0.474,27,55,0.491,10,23,0.435,19,25,0.76,103,2013-02-20,ATL,MIA
11075,75,Home,L 90-116 ,240,32,76,0.421,27,60,0.45,5,16,0.313,21,25,0.84,90,43,73,0.589,35,56,0.625,8,17,0.471,22,28,0.786,116,2013-02-21,LAC,SAS
11076,76,@,W 90-72 ,240,34,75,0.453,26,53,0.491,8,22,0.364,14,19,0.737,90,26,77,0.338,24,63,0.381,2,14,0.143,18,24,0.75,72,2013-02-23,IND,DET
11077,77,Home,L 90-114 ,240,35,78,0.449,24,50,0.48,11,28,0.393,9,10,0.9,90,45,77,0.584,36,56,0.643,9,21,0.429,15,18,0.833,114,2013-02-23,PHI,MIA
11078,78,@,W 90-84 ,240,34,81,0.42,27,69,0.391,7,12,0.583,15,17,0.882,90,29,79,0.367,24,60,0.4,5,19,0.263,21,27,0.778,84,2013-02-25,WAS,TOR
11079,79,Home,L 90-95 ,240,36,85,0.424,35,68,0.515,1,17,0.059,17,21,0.81,90,34,82,0.415,27,64,0.422,7,18,0.389,20,26,0.769,95,2013-02-26,DAL,MIL
11080,80,Home,W 90-84 ,240,29,78,0.372,24,64,0.375,5,14,0.357,27,34,0.794,90,33,76,0.434,30,64,0.469,3,12,0.25,15,19,0.789,84,2013-02-27,MEM,DAL
11081,81,Home,L 90-98 ,240,36,78,0.462,29,55,0.527,7,23,0.304,11,14,0.786,90,39,78,0.5,30,57,0.526,9,21,0.429,11,14,0.786,98,2013-03-01,BRK,DAL
11082,82,Home,W 90-87 ,240,34,80,0.425,28,65,0.431,6,15,0.4,16,21,0.762,90,33,85,0.388,27,66,0.409,6,19,0.316,15,20,0.75,87,2013-03-03,WAS,PHI
11083,83,Home,W 90-81 ,240,39,86,0.453,34,60,0.567,5,26,0.192,7,14,0.5,90,33,89,0.371,29,73,0.397,4,16,0.25,11,12,0.917,81,2013-03-10,LAL,CHI
11084,84,@,L 90-103 ,240,34,80,0.425,27,60,0.45,7,20,0.35,15,18,0.833,90,42,81,0.519,36,65,0.554,6,16,0.375,13,15,0.867,103,2013-03-11,DET,UTA
11085,85,@,L 90-95 ,240,31,76,0.408,26,59,0.441,5,17,0.294,23,28,0.821,90,34,83,0.41,26,57,0.456,8,26,0.308,19,25,0.76,95,2013-03-12,WAS,CLE
11086,86,@,L 90-105 ,240,36,82,0.439,29,57,0.509,7,25,0.28,11,17,0.647,90,40,78,0.513,30,50,0.6,10,28,0.357,15,21,0.714,105,2013-03-14,NYK,POR
11087,87,Home,W 90-84 ,240,31,71,0.437,26,55,0.473,5,16,0.313,23,31,0.742,90,33,77,0.429,29,65,0.446,4,12,0.333,14,22,0.636,84,2013-03-16,UTA,MEM
11088,88,Home,L 90-111 ,240,35,92,0.38,29,68,0.426,6,24,0.25,14,21,0.667,90,39,88,0.443,31,66,0.47,8,22,0.364,25,29,0.862,111,2013-03-18,CLE,IND
11089,89,@,W 90-83 ,240,32,69,0.464,24,46,0.522,8,23,0.348,18,25,0.72,90,29,76,0.382,20,57,0.351,9,19,0.474,16,24,0.667,83,2013-03-18,NYK,UTA
11090,90,@,L 90-98 ,240,37,99,0.374,29,80,0.363,8,19,0.421,8,11,0.727,90,38,79,0.481,30,61,0.492,8,18,0.444,14,17,0.824,98,2013-03-20,MIL,ATL
11091,91,Home,W 90-89 (OT),265,32,89,0.36,26,74,0.351,6,15,0.4,20,24,0.833,90,30,84,0.357,28,66,0.424,2,18,0.111,27,32,0.844,89,2013-03-20,MEM,OKC
11092,92,Home,W 90-83 ,240,36,76,0.474,32,62,0.516,4,14,0.286,14,18,0.778,90,30,73,0.411,27,63,0.429,3,10,0.3,20,25,0.8,83,2013-03-22,NOP,MEM
11093,93,@,L 90-92 ,240,36,75,0.48,28,52,0.538,8,23,0.348,10,11,0.909,90,36,79,0.456,34,72,0.472,2,7,0.286,18,24,0.75,92,2013-04-01,SAS,MEM
11094,94,Home,L 90-102 ,240,30,60,0.5,22,40,0.55,8,20,0.4,22,27,0.815,90,37,71,0.521,23,44,0.523,14,27,0.519,14,20,0.7,102,2013-04-02,MIA,NYK
11095,95,Home,W 90-86 ,240,33,78,0.423,27,65,0.415,6,13,0.462,18,26,0.692,90,35,89,0.393,30,66,0.455,5,23,0.217,11,16,0.688,86,2013-04-02,WAS,CHI
11096,96,Home,L 90-92 ,240,31,70,0.443,26,57,0.456,5,13,0.385,23,30,0.767,90,38,82,0.463,34,71,0.479,4,11,0.364,12,19,0.632,92,2013-04-04,BRK,CHI
11097,97,Home,L 90-101 ,240,34,73,0.466,29,56,0.518,5,17,0.294,17,27,0.63,90,37,80,0.463,28,64,0.438,9,16,0.563,18,24,0.75,101,2013-04-05,ATL,PHI
11098,98,Home,L 90-97 ,240,35,74,0.473,28,57,0.491,7,17,0.412,13,18,0.722,90,40,88,0.455,29,63,0.46,11,25,0.44,6,7,0.857,97,2013-04-07,GSW,UTA
11099,99,@,W 90-80 ,240,32,81,0.395,23,60,0.383,9,21,0.429,17,18,0.944,90,31,79,0.392,24,54,0.444,7,25,0.28,11,14,0.786,80,2013-04-09,OKC,UTA
11100,0,Home,L 90-106 ,240,36,88,0.409,30,68,0.441,6,20,0.3,12,18,0.667,90,40,77,0.519,31,55,0.564,9,22,0.409,17,21,0.81,106,2013-04-12,POR,OKC
11101,1,Home,W 90-80 ,240,35,82,0.427,24,51,0.471,11,31,0.355,9,11,0.818,90,28,65,0.431,20,37,0.541,8,28,0.286,16,26,0.615,80,2013-04-14,NYK,IND
11102,2,@,L 90-114 ,240,37,84,0.44,30,67,0.448,7,17,0.412,9,13,0.692,90,40,80,0.5,28,59,0.475,12,21,0.571,22,28,0.786,114,2013-04-17,BOS,TOR
11103,3,Home,L 90-95 ,240,34,85,0.4,29,74,0.392,5,11,0.455,17,21,0.81,90,30,70,0.429,20,47,0.426,10,23,0.435,25,30,0.833,95,2013-10-30,NOP,IND
11104,4,Home,W 90-83 ,240,36,71,0.507,33,58,0.569,3,13,0.231,15,17,0.882,90,34,74,0.459,29,58,0.5,5,16,0.313,10,12,0.833,83,2013-10-30,NYK,MIL
11105,5,Home,W 90-88 ,240,33,81,0.407,25,60,0.417,8,21,0.381,16,23,0.696,90,34,79,0.43,29,64,0.453,5,15,0.333,15,17,0.882,88,2013-10-30,SAC,DEN
11106,6,Home,W 90-84 ,240,33,73,0.452,30,61,0.492,3,12,0.25,21,34,0.618,90,32,84,0.381,28,66,0.424,4,18,0.222,16,22,0.727,84,2013-11-01,CHA,CLE
11107,7,@,L 90-110 ,240,32,92,0.348,26,80,0.325,6,12,0.5,20,26,0.769,90,39,70,0.557,28,48,0.583,11,22,0.5,21,27,0.778,110,2013-11-01,NOP,ORL
11108,8,Home,L 90-97 ,240,37,84,0.44,31,67,0.463,6,17,0.353,10,18,0.556,90,31,78,0.397,24,55,0.436,7,23,0.304,28,38,0.737,97,2013-11-02,MIL,TOR
11109,9,Home,L 90-110 ,240,31,88,0.352,26,63,0.413,5,25,0.2,23,37,0.622,90,41,92,0.446,26,54,0.481,15,38,0.395,13,20,0.65,110,2013-11-04,PHI,GSW
11110,10,@,L 90-92 ,240,35,79,0.443,28,63,0.444,7,16,0.438,13,15,0.867,90,36,73,0.493,33,58,0.569,3,15,0.2,17,30,0.567,92,2013-11-06,TOR,CHA
11111,11,@,L 90-98 ,240,36,95,0.379,33,76,0.434,3,19,0.158,15,21,0.714,90,40,82,0.488,35,66,0.53,5,16,0.313,13,17,0.765,98,2013-11-06,LAC,ORL
11112,12,@,L 90-108 ,240,33,78,0.423,23,48,0.479,10,30,0.333,14,26,0.538,90,42,79,0.532,37,66,0.561,5,13,0.385,19,25,0.76,108,2013-11-09,GSW,MEM
11113,13,Home,L 90-113 ,240,35,92,0.38,25,66,0.379,10,26,0.385,10,18,0.556,90,44,90,0.489,34,70,0.486,10,20,0.5,15,19,0.789,113,2013-11-10,LAL,MIN
11114,14,Home,W 90-89 ,240,35,84,0.417,29,69,0.42,6,15,0.4,14,23,0.609,90,37,86,0.43,32,71,0.451,5,15,0.333,10,13,0.769,89,2013-11-13,POR,PHO
11115,15,Home,L 90-97 ,240,34,80,0.425,24,55,0.436,10,25,0.4,12,17,0.706,90,38,85,0.447,32,62,0.516,6,23,0.261,15,24,0.625,97,2013-11-15,SAC,DET
11116,16,Home,L 90-110 ,240,34,90,0.378,24,60,0.4,10,30,0.333,12,16,0.75,90,44,78,0.564,35,56,0.625,9,22,0.409,13,17,0.765,110,2013-11-16,NYK,ATL
11117,17,@,W 90-83 ,240,36,76,0.474,27,54,0.5,9,22,0.409,9,13,0.692,90,28,73,0.384,20,43,0.465,8,30,0.267,19,32,0.594,83,2013-11-29,MIA,TOR
11118,18,@,W 90-82 ,240,34,74,0.459,29,56,0.518,5,18,0.278,17,23,0.739,90,30,73,0.411,23,53,0.434,7,20,0.35,15,22,0.682,82,2013-12-07,BRK,MIL
11119,19,Home,W 90-84 ,240,34,67,0.507,29,52,0.558,5,15,0.333,17,25,0.68,90,33,77,0.429,29,56,0.518,4,21,0.19,14,20,0.7,84,2013-12-10,IND,MIA
11120,20,Home,W 90-86 ,240,33,68,0.485,26,47,0.553,7,21,0.333,17,25,0.68,90,32,80,0.4,27,59,0.458,5,21,0.238,17,19,0.895,86,2013-12-13,BOS,NYK
11121,21,Home,L 90-91 ,240,33,74,0.446,29,64,0.453,4,10,0.4,20,25,0.8,90,34,81,0.42,27,57,0.474,7,24,0.292,16,19,0.842,91,2013-12-13,MIL,CHI
11122,22,@,L 90-117 ,240,30,81,0.37,24,61,0.393,6,20,0.3,24,37,0.649,90,42,90,0.467,28,58,0.483,14,32,0.438,19,25,0.76,117,2013-12-23,LAL,PHO
11123,23,@,L 90-98 ,240,32,76,0.421,25,57,0.439,7,19,0.368,19,21,0.905,90,35,77,0.455,32,63,0.508,3,14,0.214,25,32,0.781,98,2013-12-28,UTA,LAC
11124,24,@,L 90-112 ,240,39,93,0.419,32,74,0.432,7,19,0.368,5,8,0.625,90,40,76,0.526,31,56,0.554,9,20,0.45,23,26,0.885,112,2014-01-08,DAL,SAS
11125,25,Home,L 90-107 ,240,36,80,0.45,33,73,0.452,3,7,0.429,15,19,0.789,90,41,78,0.526,27,50,0.54,14,28,0.5,11,16,0.688,107,2014-01-10,NOP,DAL
11126,26,Home,W 90-87 ,240,32,80,0.4,28,66,0.424,4,14,0.286,22,27,0.815,90,33,81,0.407,28,60,0.467,5,21,0.238,16,20,0.8,87,2014-01-14,MEM,OKC
11127,27,@,L 90-91 ,240,33,81,0.407,28,70,0.4,5,11,0.455,19,23,0.826,90,36,78,0.462,30,61,0.492,6,17,0.353,13,18,0.722,91,2014-01-17,SAC,MEM
11128,28,@,L 90-101 ,240,33,72,0.458,26,53,0.491,7,19,0.368,17,23,0.739,90,40,81,0.494,30,53,0.566,10,28,0.357,11,13,0.846,101,2014-01-21,ORL,BRK
11129,29,Home,L 90-99 ,240,34,86,0.395,29,70,0.414,5,16,0.313,17,24,0.708,90,34,82,0.415,25,55,0.455,9,27,0.333,22,28,0.786,99,2014-01-26,CLE,PHO
11130,30,@,L 90-97 ,240,35,82,0.427,29,59,0.492,6,23,0.261,14,21,0.667,90,33,75,0.44,28,57,0.491,5,18,0.278,26,47,0.553,97,2014-01-28,SAS,HOU
11131,31,Home,L 90-100 ,240,36,80,0.45,28,59,0.475,8,21,0.381,10,14,0.714,90,37,85,0.435,29,64,0.453,8,21,0.381,18,20,0.9,100,2014-01-31,DEN,TOR
11132,32,Home,L 90-94 ,240,39,84,0.464,33,62,0.532,6,22,0.273,6,7,0.857,90,38,80,0.475,34,68,0.5,4,12,0.333,14,22,0.636,94,2014-01-31,MIN,MEM
11133,33,Home,L 90-95 ,240,35,73,0.479,32,64,0.5,3,9,0.333,17,21,0.81,90,33,88,0.375,23,62,0.371,10,26,0.385,19,24,0.792,95,2014-01-31,UTA,GSW
11134,34,@,L 90-99 ,240,30,76,0.395,21,53,0.396,9,23,0.391,21,25,0.84,90,38,79,0.481,32,69,0.464,6,10,0.6,17,22,0.773,99,2014-02-01,MIL,MEM
11135,35,@,L 90-100 ,240,37,81,0.457,32,62,0.516,5,19,0.263,11,12,0.917,90,37,84,0.44,30,67,0.448,7,17,0.412,19,22,0.864,100,2014-02-03,POR,WAS
11136,36,Home,L 90-94 ,240,36,90,0.4,32,69,0.464,4,21,0.19,14,20,0.7,90,30,79,0.38,22,58,0.379,8,21,0.381,26,33,0.788,94,2014-02-05,NYK,POR
11137,37,@,L 90-117 ,240,32,76,0.421,25,50,0.5,7,26,0.269,19,26,0.731,90,48,85,0.565,37,57,0.649,11,28,0.393,10,14,0.714,117,2014-02-07,DEN,NYK
11138,38,@,L 90-117 ,240,33,84,0.393,24,60,0.4,9,24,0.375,15,20,0.75,90,45,86,0.523,33,60,0.55,12,26,0.462,15,23,0.652,117,2014-02-12,DEN,MIN
11139,39,Home,L 90-101 ,240,35,82,0.427,31,61,0.508,4,21,0.19,16,20,0.8,90,39,76,0.513,31,58,0.534,8,18,0.444,15,26,0.577,101,2014-02-20,MIL,DEN
11140,40,Home,W 90-87 ,240,31,80,0.388,28,65,0.431,3,15,0.2,25,36,0.694,90,35,83,0.422,26,60,0.433,9,23,0.391,8,11,0.727,87,2014-02-21,CHA,NOP
11141,41,@,L 90-105 ,240,36,87,0.414,31,73,0.425,5,14,0.357,13,17,0.765,90,34,65,0.523,25,48,0.521,9,17,0.529,28,36,0.778,105,2014-02-23,ORL,TOR
11142,42,Home,L 90-101 ,240,32,87,0.368,27,65,0.415,5,22,0.227,21,28,0.75,90,39,94,0.415,30,76,0.395,9,18,0.5,14,16,0.875,101,2014-02-26,PHI,ORL
11143,43,@,L 90-109 ,240,35,79,0.443,30,61,0.492,5,18,0.278,15,18,0.833,90,39,84,0.464,31,62,0.5,8,22,0.364,23,33,0.697,109,2014-03-02,NYK,CHI
11144,44,@,L 90-99 ,240,36,89,0.404,24,58,0.414,12,31,0.387,6,9,0.667,90,40,80,0.5,30,59,0.508,10,21,0.476,9,9,1.0,99,2014-03-10,WAS,MIA
11145,45,@,W 90-88 ,240,32,74,0.432,28,56,0.5,4,18,0.222,22,27,0.815,90,31,75,0.413,27,57,0.474,4,18,0.222,22,22,1.0,88,2014-03-12,MEM,NOP
11146,46,@,L 90-103 ,240,32,83,0.386,28,62,0.452,4,21,0.19,22,30,0.733,90,38,88,0.432,27,64,0.422,11,24,0.458,16,22,0.727,103,2014-03-12,POR,SAS
11147,47,@,L 90-99 ,240,35,81,0.432,26,58,0.448,9,23,0.391,11,20,0.55,90,31,81,0.383,25,63,0.397,6,18,0.333,31,38,0.816,99,2014-03-17,PHI,IND
11148,48,Home,L 90-99 ,240,31,77,0.403,28,62,0.452,3,15,0.2,25,29,0.862,90,35,89,0.393,25,61,0.41,10,28,0.357,19,25,0.76,99,2014-03-22,GSW,SAS
11149,49,Home,L 90-99 ,240,32,79,0.405,23,57,0.404,9,22,0.409,17,22,0.773,90,36,80,0.45,25,57,0.439,11,23,0.478,16,18,0.889,99,2014-03-26,BOS,TOR
11150,50,Home,W 90-76 ,240,34,76,0.447,29,62,0.468,5,14,0.357,17,21,0.81,90,29,78,0.372,21,56,0.375,8,22,0.364,10,16,0.625,76,2014-03-30,CLE,IND
11151,51,@,L 90-111 ,240,36,85,0.424,28,64,0.438,8,21,0.381,10,10,1.0,90,44,83,0.53,40,64,0.625,4,19,0.211,19,22,0.864,111,2014-04-02,GSW,SAS
11152,52,@,L 90-102 ,240,31,68,0.456,29,60,0.483,2,8,0.25,26,35,0.743,90,31,84,0.369,24,62,0.387,7,22,0.318,33,42,0.786,102,2014-04-04,MIL,CHI
11153,53,@,W 90-89 ,240,38,78,0.487,33,59,0.559,5,19,0.263,9,15,0.6,90,34,76,0.447,20,45,0.444,14,31,0.452,7,8,0.875,89,2014-04-04,WAS,NYK
11154,54,Home,L 90-102 ,240,35,80,0.438,24,53,0.453,11,27,0.407,9,11,0.818,90,42,88,0.477,34,73,0.466,8,15,0.533,10,13,0.769,102,2014-04-13,LAL,MEM
11155,55,Home,L 90-108 ,240,28,79,0.354,25,69,0.362,3,10,0.3,31,39,0.795,90,31,73,0.425,19,44,0.432,12,29,0.414,34,50,0.68,108,2014-10-28,LAL,HOU
11156,56,Home,L 90-95 ,240,32,70,0.457,23,46,0.5,9,24,0.375,17,20,0.85,90,37,69,0.536,31,57,0.544,6,12,0.5,15,18,0.833,95,2014-10-30,CLE,NYK
11157,57,@,L 90-93 ,240,28,65,0.431,22,44,0.5,6,21,0.286,28,34,0.824,90,34,87,0.391,27,57,0.474,7,30,0.233,18,25,0.72,93,2014-10-30,OKC,LAC
11158,58,Home,L 90-102 ,240,32,76,0.421,31,59,0.525,1,17,0.059,25,35,0.714,90,42,87,0.483,35,61,0.574,7,26,0.269,11,13,0.846,102,2014-11-01,DET,BRK
11159,59,@,L 90-104 ,240,37,98,0.378,36,73,0.493,1,25,0.04,15,18,0.833,90,32,76,0.421,20,42,0.476,12,34,0.353,28,40,0.7,104,2014-11-01,BOS,HOU
11160,60,Home,L 90-95 ,240,37,92,0.402,30,65,0.462,7,27,0.259,9,14,0.643,90,36,81,0.444,30,62,0.484,6,19,0.316,17,21,0.81,95,2014-11-02,POR,GSW
11161,61,@,L 90-98 ,240,38,88,0.432,32,74,0.432,6,14,0.429,8,14,0.571,90,35,75,0.467,28,60,0.467,7,15,0.467,21,27,0.778,98,2014-11-04,ORL,CHI
11162,62,Home,L 90-97 ,240,33,77,0.429,25,53,0.472,8,24,0.333,16,25,0.64,90,39,81,0.481,37,70,0.529,2,11,0.182,17,23,0.739,97,2014-11-08,IND,WAS
11163,63,Home,L 90-99 ,240,35,83,0.422,31,66,0.47,4,17,0.235,16,23,0.696,90,37,77,0.481,30,59,0.508,7,18,0.389,18,25,0.72,99,2014-11-15,CHI,IND
11164,64,Home,L 90-92 ,240,37,83,0.446,30,65,0.462,7,18,0.389,9,13,0.692,90,35,74,0.473,30,58,0.517,5,16,0.313,17,25,0.68,92,2014-11-19,CLE,SAS
11165,65,Home,L 90-114 ,240,34,86,0.395,26,62,0.419,8,24,0.333,14,18,0.778,90,45,84,0.536,33,63,0.524,12,21,0.571,12,16,0.75,114,2014-11-19,ORL,LAC
11166,66,Home,L 90-101 ,240,34,86,0.395,27,65,0.415,7,21,0.333,15,21,0.714,90,41,83,0.494,35,63,0.556,6,20,0.3,13,21,0.619,101,2014-11-19,PHI,BOS
11167,67,Home,L 90-93 ,240,34,85,0.4,27,59,0.458,7,26,0.269,15,18,0.833,90,35,76,0.461,30,61,0.492,5,15,0.333,18,25,0.72,93,2014-11-30,PHO,ORL
11168,68,@,W 90-87 ,240,32,70,0.457,27,52,0.519,5,18,0.278,21,26,0.808,90,37,88,0.42,29,62,0.468,8,26,0.308,5,6,0.833,87,2014-12-04,CLE,NYK
11169,69,Home,W 90-82 ,240,32,81,0.395,31,69,0.449,1,12,0.083,25,33,0.758,90,31,80,0.388,21,45,0.467,10,35,0.286,10,12,0.833,82,2014-12-10,MIN,POR
11170,70,Home,L 90-95 ,240,33,93,0.355,22,64,0.344,11,29,0.379,13,19,0.684,90,35,79,0.443,29,59,0.492,6,20,0.3,19,23,0.826,95,2014-12-13,SAC,DET
11171,71,Home,L 90-95 (OT),265,29,78,0.372,20,49,0.408,9,29,0.31,23,28,0.821,90,36,78,0.462,27,54,0.5,9,24,0.375,14,18,0.778,95,2014-12-14,NYK,TOR
11172,72,Home,L 90-99 ,240,33,86,0.384,27,61,0.443,6,25,0.24,18,23,0.783,90,38,82,0.463,33,64,0.516,5,18,0.278,18,22,0.818,99,2014-12-18,HOU,NOP
11173,73,Home,L 90-99 ,240,35,88,0.398,28,66,0.424,7,22,0.318,13,16,0.813,90,35,78,0.449,25,53,0.472,10,25,0.4,19,23,0.826,99,2014-12-20,NYK,PHO
11174,74,@,L 90-97 ,240,37,75,0.493,31,61,0.508,6,14,0.429,10,14,0.714,90,35,84,0.417,29,67,0.433,6,17,0.353,21,24,0.875,97,2014-12-26,SAS,NOP
11175,75,@,W 90-85 ,240,33,90,0.367,24,61,0.393,9,29,0.31,15,19,0.789,90,31,80,0.388,19,50,0.38,12,30,0.4,11,14,0.786,85,2014-12-27,ATL,MIL
11176,76,Home,L 90-92 ,240,36,83,0.434,31,70,0.443,5,13,0.385,13,21,0.619,90,29,84,0.345,24,71,0.338,5,13,0.385,29,33,0.879,92,2014-12-29,IND,CHI
11177,77,Home,L 90-98 ,240,33,87,0.379,29,68,0.426,4,19,0.211,20,21,0.952,90,35,78,0.449,31,62,0.5,4,16,0.25,24,32,0.75,98,2015-01-03,ORL,CHO
11178,78,Home,L 90-109 ,240,35,86,0.407,27,61,0.443,8,25,0.32,12,17,0.706,90,44,78,0.564,32,52,0.615,12,26,0.462,9,11,0.818,109,2015-01-04,CLE,DAL
11179,79,@,L 90-93 ,240,35,88,0.398,27,66,0.409,8,22,0.364,12,16,0.75,90,33,74,0.446,26,57,0.456,7,17,0.412,20,26,0.769,93,2015-01-07,ORL,DEN
11180,80,@,W 90-88 ,240,36,79,0.456,28,62,0.452,8,17,0.471,10,17,0.588,90,33,73,0.452,30,57,0.526,3,16,0.188,19,27,0.704,88,2015-01-09,PHI,BRK
11181,81,Home,L 90-104 ,240,34,75,0.453,25,49,0.51,9,26,0.346,13,18,0.722,90,39,81,0.481,33,60,0.55,6,21,0.286,20,24,0.833,104,2015-01-11,LAC,MIA
11182,82,Home,L 90-99 ,240,36,82,0.439,32,65,0.492,4,17,0.235,14,18,0.778,90,40,77,0.519,35,61,0.574,5,16,0.313,14,27,0.519,99,2015-01-17,BRK,WAS
11183,83,@,W 90-89 ,240,39,87,0.448,32,68,0.471,7,19,0.368,5,7,0.714,90,33,89,0.371,24,61,0.393,9,28,0.321,14,19,0.737,89,2015-01-22,BOS,POR
11184,84,@,L 90-129 ,240,36,89,0.404,34,73,0.466,2,16,0.125,16,24,0.667,90,46,89,0.517,31,61,0.508,15,28,0.536,22,28,0.786,129,2015-01-23,CHA,CLE
11185,85,Home,L 90-99 ,240,35,82,0.427,26,58,0.448,9,24,0.375,11,19,0.579,90,35,74,0.473,27,55,0.491,8,19,0.421,21,23,0.913,99,2015-01-26,UTA,BOS
11186,86,Home,L 90-109 ,240,38,78,0.487,31,52,0.596,7,26,0.269,7,10,0.7,90,42,79,0.532,32,58,0.552,10,21,0.476,15,20,0.75,109,2015-01-27,DAL,MEM
11187,87,@,L 90-101 ,240,30,84,0.357,27,66,0.409,3,18,0.167,27,32,0.844,90,38,80,0.475,27,49,0.551,11,31,0.355,14,22,0.636,101,2015-01-30,SAC,CLE
11188,88,Home,L 90-106 ,240,34,82,0.415,28,69,0.406,6,13,0.462,16,21,0.762,90,42,87,0.483,32,55,0.582,10,32,0.313,12,19,0.632,106,2015-01-31,MIN,CLE
11189,89,@,L 90-101 ,240,31,89,0.348,23,64,0.359,8,25,0.32,20,26,0.769,90,38,92,0.413,30,65,0.462,8,27,0.296,17,23,0.739,101,2015-02-04,CHI,HOU
11190,90,Home,L 90-100 ,240,33,73,0.452,26,50,0.52,7,23,0.304,17,26,0.654,90,38,80,0.475,32,67,0.478,6,13,0.462,18,22,0.818,100,2015-02-04,UTA,MEM
11191,91,Home,W 90-89 ,240,35,81,0.432,30,64,0.469,5,17,0.294,15,17,0.882,90,36,69,0.522,34,57,0.596,2,12,0.167,15,20,0.75,89,2015-02-06,MIN,MEM
11192,92,@,L 90-102 ,240,32,82,0.39,29,69,0.42,3,13,0.231,23,33,0.697,90,43,86,0.5,38,67,0.567,5,19,0.263,11,17,0.647,102,2015-02-07,SAC,UTA
11193,93,@,W 90-87 ,240,33,81,0.407,28,66,0.424,5,15,0.333,19,26,0.731,90,35,79,0.443,26,52,0.5,9,27,0.333,8,12,0.667,87,2015-02-23,MEM,LAC
11194,94,Home,W 90-81 ,240,34,83,0.41,30,68,0.441,4,15,0.267,18,23,0.783,90,32,79,0.405,27,60,0.45,5,19,0.263,12,21,0.571,81,2015-02-23,UTA,SAS
11195,95,Home,L 90-93 (OT),265,33,78,0.423,27,56,0.482,6,22,0.273,18,31,0.581,90,32,84,0.381,26,53,0.491,6,31,0.194,23,32,0.719,93,2015-02-25,ORL,MIA
11196,96,@,L 90-102 ,240,34,84,0.405,30,68,0.441,4,16,0.25,18,23,0.783,90,39,80,0.488,33,64,0.516,6,16,0.375,18,25,0.72,102,2015-02-25,MEM,SAC
11197,97,@,L 90-97 ,240,39,84,0.464,34,72,0.472,5,12,0.417,7,9,0.778,90,34,77,0.442,33,66,0.5,1,11,0.091,28,33,0.848,97,2015-03-06,LAL,MEM
11198,98,Home,L 90-100 ,240,29,69,0.42,25,52,0.481,4,17,0.235,28,34,0.824,90,39,87,0.448,33,62,0.532,6,25,0.24,16,17,0.941,100,2015-03-09,MIA,BOS
11199,99,Home,L 90-108 ,240,38,70,0.543,35,58,0.603,3,12,0.25,11,14,0.786,90,42,84,0.5,29,53,0.547,13,31,0.419,11,16,0.688,108,2015-03-22,MIL,CLE
11200,0,Home,L 90-97 ,240,39,89,0.438,34,73,0.466,5,16,0.313,7,13,0.538,90,40,86,0.465,32,65,0.492,8,21,0.381,9,13,0.692,97,2015-04-04,MIL,ORL
11201,1,@,L 90-99 ,240,39,85,0.459,32,69,0.464,7,16,0.438,5,10,0.5,90,36,84,0.429,30,68,0.441,6,16,0.375,21,23,0.913,99,2015-04-04,NOP,POR
11202,2,Home,L 90-119 ,240,31,89,0.348,22,62,0.355,9,27,0.333,19,27,0.704,90,47,72,0.653,39,57,0.684,8,15,0.533,17,23,0.739,119,2015-04-08,PHI,WAS
11203,3,Home,L 90-99 ,240,32,77,0.416,23,43,0.535,9,34,0.265,17,25,0.68,90,38,84,0.452,30,62,0.484,8,22,0.364,15,21,0.714,99,2015-04-10,CLE,BOS
11204,4,Home,W 90-75 ,240,37,84,0.44,32,65,0.492,5,19,0.263,11,19,0.579,90,30,85,0.353,23,60,0.383,7,25,0.28,8,10,0.8,75,2015-04-10,NOP,PHO
11205,5,Home,L 90-100 ,240,34,83,0.41,21,51,0.412,13,32,0.406,9,17,0.529,90,35,85,0.412,26,50,0.52,9,35,0.257,21,26,0.808,100,2015-04-13,CHA,HOU
11206,6,@,L 90-101 ,240,38,83,0.458,30,60,0.5,8,23,0.348,6,9,0.667,90,39,96,0.406,35,75,0.467,4,21,0.19,19,27,0.704,101,2015-04-13,POR,OKC
11207,7,Home,L 90-112 ,240,33,77,0.429,26,58,0.448,7,19,0.368,17,27,0.63,90,41,81,0.506,31,55,0.564,10,26,0.385,20,27,0.741,112,2015-04-15,NYK,DET
11208,8,Home,L 90-101 ,240,33,79,0.418,25,49,0.51,8,30,0.267,16,28,0.571,90,39,94,0.415,28,62,0.452,11,32,0.344,12,16,0.75,101,2015-10-31,POR,PHO
11209,9,Home,W 90-87 ,240,36,80,0.45,31,65,0.477,5,15,0.333,13,24,0.542,90,36,81,0.444,30,61,0.492,6,20,0.3,9,13,0.692,87,2015-11-06,IND,MIA
11210,10,Home,W 90-82 ,240,30,82,0.366,23,55,0.418,7,27,0.259,23,29,0.793,90,29,88,0.33,20,61,0.328,9,27,0.333,15,18,0.833,82,2015-11-13,DAL,LAL
11211,11,@,W 90-84 ,240,33,78,0.423,27,50,0.54,6,28,0.214,18,31,0.581,90,29,79,0.367,20,52,0.385,9,27,0.333,17,21,0.81,84,2015-11-13,CLE,NYK
11212,12,Home,W 90-88 ,240,37,84,0.44,28,64,0.438,9,20,0.45,7,13,0.538,90,33,76,0.434,21,47,0.447,12,29,0.414,10,14,0.714,88,2015-11-17,BRK,ATL
11213,13,@,L 90-104 ,240,34,84,0.405,25,67,0.373,9,17,0.529,13,16,0.813,90,40,88,0.455,32,66,0.485,8,22,0.364,16,17,0.941,104,2015-11-20,SAS,NOP
11214,14,Home,L 90-93 ,240,35,92,0.38,32,63,0.508,3,29,0.103,17,23,0.739,90,33,72,0.458,21,52,0.404,12,20,0.6,15,23,0.652,93,2015-11-20,OKC,NYK
11215,15,Home,L 90-95 ,240,33,80,0.413,28,55,0.509,5,25,0.2,19,25,0.76,90,34,81,0.42,26,56,0.464,8,25,0.32,19,25,0.76,95,2015-11-27,CHA,CLE
11216,16,@,L 90-111 ,240,34,94,0.362,29,74,0.392,5,20,0.25,17,23,0.739,90,40,83,0.482,33,64,0.516,7,19,0.368,24,30,0.8,111,2015-11-27,NOP,LAC
11217,17,@,L 90-114 ,240,31,74,0.419,23,48,0.479,8,26,0.308,20,22,0.909,90,43,82,0.524,31,55,0.564,12,27,0.444,16,22,0.727,114,2015-11-27,MIL,ORL
11218,18,Home,W 90-88 ,240,35,87,0.402,26,60,0.433,9,27,0.333,11,17,0.647,90,33,81,0.407,29,64,0.453,4,17,0.235,18,24,0.75,88,2015-11-28,CLE,BRK
11219,19,@,L 90-99 ,240,36,93,0.387,31,78,0.397,5,15,0.333,13,22,0.591,90,36,89,0.404,30,72,0.417,6,17,0.353,21,27,0.778,99,2015-12-02,DEN,CHI
11220,20,Home,W 90-88 ,240,30,73,0.411,26,60,0.433,4,13,0.308,26,33,0.788,90,33,85,0.388,25,52,0.481,8,33,0.242,14,18,0.778,88,2015-12-07,MIL,POR
11221,21,Home,W 90-83 ,240,34,70,0.486,27,50,0.54,7,20,0.35,15,23,0.652,90,33,80,0.413,29,69,0.42,4,11,0.364,13,16,0.813,83,2015-12-11,TOR,MIL
11222,22,Home,L 90-94 ,240,33,78,0.423,25,50,0.5,8,28,0.286,16,24,0.667,90,37,79,0.468,31,62,0.5,6,17,0.353,14,16,0.875,94,2015-12-11,UTA,OKC
11223,23,@,L 90-106 ,240,29,79,0.367,19,51,0.373,10,28,0.357,22,26,0.846,90,41,86,0.477,31,64,0.484,10,22,0.455,14,16,0.875,106,2015-12-14,TOR,IND
11224,24,@,L 90-103 ,240,38,88,0.432,33,72,0.458,5,16,0.313,9,11,0.818,90,36,75,0.48,25,54,0.463,11,21,0.524,20,24,0.833,103,2015-12-16,MIL,LAC
11225,25,@,L 90-106 ,240,32,92,0.348,21,66,0.318,11,26,0.423,15,18,0.833,90,38,79,0.481,36,65,0.554,2,14,0.143,28,37,0.757,106,2015-12-16,POR,OKC
11226,26,Home,L 90-104 ,240,31,66,0.47,24,43,0.558,7,23,0.304,21,32,0.656,90,40,85,0.471,35,70,0.5,5,15,0.333,19,24,0.792,104,2015-12-22,PHI,MEM
11227,27,Home,L 90-111 ,240,34,81,0.42,28,67,0.418,6,14,0.429,16,18,0.889,90,42,81,0.519,29,52,0.558,13,29,0.448,14,19,0.737,111,2015-12-26,MIL,TOR
11228,28,@,L 90-99 (OT),265,35,79,0.443,24,50,0.48,11,29,0.379,9,18,0.5,90,38,87,0.437,34,72,0.472,4,15,0.267,19,20,0.95,99,2015-12-29,MIA,MEM
11229,29,@,L 90-115 ,240,35,86,0.407,30,72,0.417,5,14,0.357,15,19,0.789,90,41,86,0.477,27,51,0.529,14,35,0.4,19,28,0.679,115,2015-12-31,MIN,DET
11230,30,Home,L 90-109 ,240,29,84,0.345,23,62,0.371,6,22,0.273,26,34,0.765,90,35,79,0.443,26,56,0.464,9,23,0.391,30,37,0.811,109,2016-01-02,CHA,OKC
11231,31,Home,L 90-98 ,240,37,82,0.451,35,65,0.538,2,17,0.118,14,15,0.933,90,39,70,0.557,36,62,0.581,3,8,0.375,17,18,0.944,98,2016-01-06,MIA,NYK
11232,32,@,L 90-104 ,240,31,70,0.443,22,46,0.478,9,24,0.375,19,29,0.655,90,40,94,0.426,29,69,0.42,11,25,0.44,13,16,0.813,104,2016-01-13,MIA,LAC
11233,33,@,L 90-120 ,240,31,74,0.419,26,60,0.433,5,14,0.357,23,31,0.742,90,44,85,0.518,33,59,0.559,11,26,0.423,21,25,0.84,120,2016-01-25,SAS,GSW
11234,34,Home,L 90-92 ,240,30,74,0.405,23,49,0.469,7,25,0.28,23,28,0.821,90,33,76,0.434,27,51,0.529,6,25,0.24,20,26,0.769,92,2016-01-26,LAL,DAL
11235,35,@,L 90-103 ,240,35,75,0.467,33,65,0.508,2,10,0.2,18,26,0.692,90,40,76,0.526,30,51,0.588,10,25,0.4,13,16,0.813,103,2016-01-29,MIN,UTA
11236,36,Home,L 90-93 ,240,34,87,0.391,26,67,0.388,8,20,0.4,14,19,0.737,90,37,88,0.42,35,73,0.479,2,15,0.133,17,23,0.739,93,2016-02-03,DAL,MIA
11237,37,Home,L 90-116 ,240,33,73,0.452,30,58,0.517,3,15,0.2,21,27,0.778,90,41,80,0.513,29,58,0.5,12,22,0.545,22,25,0.88,116,2016-02-05,DAL,SAS
11238,38,Home,L 90-109 ,240,33,71,0.465,22,49,0.449,11,22,0.5,13,19,0.684,90,45,86,0.523,36,66,0.545,9,20,0.45,10,12,0.833,109,2016-02-10,BRK,MEM
11239,39,Home,L 90-113 ,240,38,86,0.442,33,72,0.458,5,14,0.357,9,12,0.75,90,43,90,0.478,30,57,0.526,13,33,0.394,14,15,0.933,113,2016-02-10,CHI,ATL
11240,40,@,L 90-100 ,240,36,91,0.396,29,73,0.397,7,18,0.389,11,17,0.647,90,39,78,0.5,29,53,0.547,10,25,0.4,12,15,0.8,100,2016-03-07,MIL,CHI
11241,41,Home,L 90-109 ,240,30,81,0.37,26,56,0.464,4,25,0.16,26,32,0.813,90,39,83,0.47,27,51,0.529,12,32,0.375,19,29,0.655,109,2016-03-07,DAL,LAC
11242,42,Home,L 90-114 ,240,32,79,0.405,22,47,0.468,10,32,0.313,16,19,0.842,90,41,84,0.488,23,47,0.489,18,37,0.486,14,20,0.7,114,2016-03-13,LAC,CLE
11243,43,@,W 90-87 ,240,33,75,0.44,28,54,0.519,5,21,0.238,19,27,0.704,90,34,85,0.4,31,69,0.449,3,16,0.188,16,21,0.762,87,2016-03-13,NYK,LAL
11244,44,Home,L 90-95 ,240,31,86,0.36,25,63,0.397,6,23,0.261,22,26,0.846,90,32,89,0.36,24,59,0.407,8,30,0.267,23,26,0.885,95,2016-03-18,LAL,PHO
11245,45,@,L 90-101 ,240,35,84,0.417,32,71,0.451,3,13,0.231,17,26,0.654,90,41,97,0.423,36,65,0.554,5,32,0.156,14,17,0.824,101,2016-03-25,MIL,ATL
11246,46,@,L 90-105 ,240,37,94,0.394,30,65,0.462,7,29,0.241,9,13,0.692,90,38,80,0.475,28,52,0.538,10,28,0.357,19,26,0.731,105,2016-03-27,DEN,LAC
11247,47,@,L 90-114 ,240,31,89,0.348,24,70,0.343,7,19,0.368,21,27,0.778,90,44,84,0.524,33,59,0.559,11,25,0.44,15,18,0.833,114,2016-03-28,BOS,LAC
11248,48,Home,L 90-94 ,240,34,88,0.386,25,63,0.397,9,25,0.36,13,15,0.867,90,32,76,0.421,22,56,0.393,10,20,0.5,20,34,0.588,94,2016-04-02,CHI,DET
11249,49,@,L 90-103 ,240,30,81,0.37,18,50,0.36,12,31,0.387,18,30,0.6,90,39,95,0.411,28,61,0.459,11,34,0.324,14,19,0.737,103,2016-04-05,PHO,ATL
11250,50,@,L 90-96 ,240,32,88,0.364,21,53,0.396,11,35,0.314,15,21,0.714,90,34,78,0.436,28,55,0.509,6,23,0.261,22,31,0.71,96,2016-04-05,CHA,TOR
11251,51,@,L 90-102 ,240,36,80,0.45,26,53,0.491,10,27,0.37,8,9,0.889,90,41,80,0.513,35,61,0.574,6,19,0.316,14,20,0.7,102,2016-04-12,NYK,IND
11252,52,@,L 90-94 ,240,37,84,0.44,33,69,0.478,4,15,0.267,12,21,0.571,90,33,82,0.402,25,67,0.373,8,15,0.533,20,27,0.741,94,2016-11-14,MIA,SAS
11253,53,Home,L 90-93 ,240,36,89,0.404,29,66,0.439,7,23,0.304,11,14,0.786,90,37,80,0.463,31,63,0.492,6,17,0.353,13,19,0.684,93,2016-11-15,MIA,ATL
11254,54,Home,W 90-83 ,240,33,76,0.434,26,55,0.473,7,21,0.333,17,23,0.739,90,34,83,0.41,26,60,0.433,8,23,0.348,7,10,0.7,83,2016-11-16,BOS,DAL
11255,55,Home,L 90-105 ,240,30,73,0.411,21,42,0.5,9,31,0.29,21,33,0.636,90,40,84,0.476,28,58,0.483,12,26,0.462,13,17,0.765,105,2016-11-21,CHA,MEM
11256,56,@,L 90-128 ,240,37,91,0.407,29,56,0.518,8,35,0.229,8,12,0.667,90,43,85,0.506,23,42,0.548,20,43,0.465,22,24,0.917,128,2016-11-25,DAL,CLE
11257,57,@,W 90-81 ,240,33,85,0.388,21,54,0.389,12,31,0.387,12,18,0.667,90,29,82,0.354,25,63,0.397,4,19,0.211,19,23,0.826,81,2016-11-25,MIA,MEM
11258,58,Home,L 90-96 ,240,32,91,0.352,28,70,0.4,4,21,0.19,22,29,0.759,90,33,81,0.407,31,73,0.425,2,8,0.25,28,41,0.683,96,2016-11-30,CHI,LAL
11259,59,Home,L 90-117 ,240,37,78,0.474,34,62,0.548,3,16,0.188,13,20,0.65,90,42,84,0.5,28,55,0.509,14,29,0.483,19,23,0.826,117,2016-12-09,MIN,DET
11260,60,@,L 90-103 ,240,38,93,0.409,33,72,0.458,5,21,0.238,9,19,0.474,90,45,96,0.469,36,64,0.563,9,32,0.281,4,8,0.5,103,2016-12-15,NYK,GSW
11261,61,Home,L 90-105 ,240,32,84,0.381,22,54,0.407,10,30,0.333,16,22,0.727,90,40,83,0.482,34,64,0.531,6,19,0.316,19,25,0.76,105,2016-12-17,DET,IND
11262,62,@,L 90-135 ,240,34,86,0.395,26,58,0.448,8,28,0.286,14,20,0.7,90,51,87,0.586,37,59,0.627,14,28,0.5,19,26,0.731,135,2016-12-17,POR,GSW
11263,63,@,W 90-88 ,240,37,87,0.425,30,58,0.517,7,29,0.241,9,15,0.6,90,34,74,0.459,21,45,0.467,13,29,0.448,7,11,0.636,88,2016-12-23,DAL,LAC
11264,64,@,L 90-109 ,240,31,87,0.356,23,64,0.359,8,23,0.348,20,24,0.833,90,45,89,0.506,34,62,0.548,11,27,0.407,8,14,0.571,109,2016-12-23,LAL,ORL
11265,65,Home,L 90-110 ,240,35,79,0.443,23,49,0.469,12,30,0.4,8,16,0.5,90,39,78,0.5,27,58,0.466,12,20,0.6,20,21,0.952,110,2016-12-23,POR,SAS
11266,66,Home,W 90-85 ,240,32,83,0.386,26,58,0.448,6,25,0.24,20,28,0.714,90,34,81,0.42,25,56,0.446,9,25,0.36,8,10,0.8,85,2016-12-26,CHI,IND
11267,67,@,L 90-106 ,240,30,79,0.38,19,51,0.373,11,28,0.393,19,23,0.826,90,41,92,0.446,25,64,0.391,16,28,0.571,8,15,0.533,106,2016-12-26,CLE,DET
11268,68,@,L 90-104 ,240,35,83,0.422,27,51,0.529,8,32,0.25,12,17,0.706,90,37,82,0.451,22,51,0.431,15,31,0.484,15,18,0.833,104,2016-12-26,ATL,MIN
11269,69,Home,W 90-82 ,240,34,90,0.378,28,59,0.475,6,31,0.194,16,22,0.727,90,32,88,0.364,21,62,0.339,11,26,0.423,7,10,0.7,82,2017-01-02,CLE,NOP
11270,70,@,L 90-99 ,240,36,91,0.396,30,68,0.441,6,23,0.261,12,16,0.75,90,36,77,0.468,27,54,0.5,9,23,0.391,18,22,0.818,99,2017-01-03,MIA,PHO
11271,71,Home,L 90-95 ,240,37,88,0.42,32,63,0.508,5,25,0.2,11,16,0.688,90,35,99,0.354,29,72,0.403,6,27,0.222,19,31,0.613,95,2017-02-01,BRK,NYK
11272,72,@,L 90-93 ,240,34,88,0.386,27,60,0.45,7,28,0.25,15,21,0.714,90,33,87,0.379,25,61,0.41,8,26,0.308,19,29,0.655,93,2017-02-06,OKC,IND
11273,73,@,L 90-94 ,240,33,91,0.363,27,62,0.435,6,29,0.207,18,22,0.818,90,34,68,0.5,25,54,0.463,9,14,0.643,17,21,0.81,94,2017-02-12,SAS,NYK
11274,74,Home,W 90-85 ,240,32,84,0.381,20,52,0.385,12,32,0.375,14,19,0.737,90,32,76,0.421,19,38,0.5,13,38,0.342,8,9,0.889,85,2017-02-15,TOR,CHO
11275,75,Home,L 90-108 ,240,30,79,0.38,24,59,0.407,6,20,0.3,24,36,0.667,90,40,99,0.404,23,62,0.371,17,37,0.459,11,13,0.846,108,2017-02-24,ATL,MIA
11276,76,Home,L 90-101 ,240,34,83,0.41,29,58,0.5,5,25,0.2,17,22,0.773,90,34,81,0.42,26,52,0.5,8,29,0.276,25,31,0.806,101,2017-03-01,ORL,NYK
11277,77,@,L 90-97 (OT),265,35,89,0.393,31,73,0.425,4,16,0.25,16,22,0.727,90,38,94,0.404,32,70,0.457,6,24,0.25,15,24,0.625,97,2017-03-04,MIN,SAS
11278,78,@,L 89-97 ,240,30,81,0.37,22,53,0.415,8,28,0.286,21,26,0.808,89,34,72,0.472,24,53,0.453,10,19,0.526,19,26,0.731,97,2011-12-25,ORL,OKC
11279,79,Home,L 89-105 ,240,36,81,0.444,27,60,0.45,9,21,0.429,8,11,0.727,89,40,70,0.571,33,58,0.569,7,12,0.583,18,22,0.818,105,2011-12-28,DET,CLE
11280,80,@,L 89-92 ,240,34,80,0.425,27,54,0.5,7,26,0.269,14,22,0.636,89,39,86,0.453,37,62,0.597,2,24,0.083,12,15,0.8,92,2011-12-31,DEN,LAL
11281,81,@,L 89-104 ,240,33,89,0.371,31,73,0.425,2,16,0.125,21,25,0.84,89,36,74,0.486,26,58,0.448,10,16,0.625,22,31,0.71,104,2011-12-31,UTA,SAS
11282,82,Home,W 89-78 ,240,31,62,0.5,29,54,0.537,2,8,0.25,25,33,0.758,89,28,63,0.444,20,41,0.488,8,22,0.364,14,21,0.667,78,2012-01-02,DET,ORL
11283,83,Home,W 89-70 ,240,35,71,0.493,29,55,0.527,6,16,0.375,13,21,0.619,89,30,74,0.405,26,54,0.481,4,20,0.2,6,10,0.6,70,2012-01-04,BOS,NJN
11284,84,@,L 89-98 ,240,37,82,0.451,32,65,0.492,5,17,0.294,10,15,0.667,89,38,91,0.418,30,69,0.435,8,22,0.364,14,21,0.667,98,2012-01-04,PHO,DAL
11285,85,@,L 89-117 ,240,35,76,0.461,28,60,0.467,7,16,0.438,12,17,0.706,89,47,82,0.573,41,66,0.621,6,16,0.375,17,24,0.708,117,2012-01-04,HOU,LAC
11286,86,@,L 89-95 (OT),265,32,81,0.395,27,65,0.415,5,16,0.313,20,34,0.588,89,36,86,0.419,30,69,0.435,6,17,0.353,17,23,0.739,95,2012-01-11,MIA,LAC
11287,87,@,L 89-103 ,240,35,80,0.438,31,60,0.517,4,20,0.2,15,16,0.938,89,40,89,0.449,32,68,0.471,8,21,0.381,15,19,0.789,103,2012-01-13,SAC,HOU
11288,88,@,L 89-120 ,240,36,81,0.444,32,64,0.5,4,17,0.235,13,20,0.65,89,47,85,0.553,35,67,0.522,12,18,0.667,14,19,0.737,120,2012-01-13,WAS,PHI
11289,89,@,L 89-96 ,240,36,77,0.468,31,60,0.517,5,17,0.294,12,17,0.706,89,36,78,0.462,29,56,0.518,7,22,0.318,17,26,0.654,96,2012-01-17,CHA,ORL
11290,90,@,L 89-92 ,240,35,92,0.38,30,73,0.411,5,19,0.263,14,20,0.7,89,33,71,0.465,28,60,0.467,5,11,0.455,21,27,0.778,92,2012-01-18,POR,ATL
11291,91,@,L 89-91 ,240,34,81,0.42,25,61,0.41,9,20,0.45,12,18,0.667,89,37,87,0.425,29,65,0.446,8,22,0.364,9,17,0.529,91,2012-01-18,DAL,LAC
11292,92,@,L 89-95 ,240,35,74,0.473,33,63,0.524,2,11,0.182,17,23,0.739,89,40,85,0.471,34,70,0.486,6,15,0.4,9,15,0.6,95,2012-01-21,CHA,CHI
11293,93,@,L 89-101 ,240,32,80,0.4,25,62,0.403,7,18,0.389,18,25,0.72,89,41,88,0.466,34,69,0.493,7,19,0.368,12,21,0.571,101,2012-01-23,SAC,POR
11294,94,@,L 89-99 ,240,30,84,0.357,12,41,0.293,18,43,0.419,11,14,0.786,89,37,80,0.463,35,70,0.5,2,10,0.2,23,26,0.885,99,2012-01-27,NYK,MIA
11295,95,Home,W 89-72 ,240,35,78,0.449,29,63,0.46,6,15,0.4,13,16,0.813,89,27,70,0.386,23,55,0.418,4,15,0.267,14,21,0.667,72,2012-01-27,PHI,CHA
11296,96,@,L 89-100 ,240,36,82,0.439,30,63,0.476,6,19,0.316,11,17,0.647,89,40,80,0.5,35,61,0.574,5,19,0.263,15,16,0.938,100,2012-01-28,LAL,MIL
11297,97,@,L 89-93 ,240,37,80,0.463,32,60,0.533,5,20,0.25,10,13,0.769,89,32,84,0.381,29,72,0.403,3,12,0.25,26,38,0.684,93,2012-01-30,POR,UTA
11298,98,@,L 89-91 ,240,34,80,0.425,31,65,0.477,3,15,0.2,18,21,0.857,89,31,76,0.408,21,56,0.375,10,20,0.5,19,25,0.76,91,2012-02-03,NYK,BOS
11299,99,Home,L 89-93 ,240,33,75,0.44,28,52,0.538,5,23,0.217,18,23,0.783,89,37,78,0.474,33,65,0.508,4,13,0.308,15,25,0.6,93,2012-02-03,DEN,LAL
11300,0,@,L 89-106 ,240,33,87,0.379,28,68,0.412,5,19,0.263,18,25,0.72,89,42,93,0.452,39,80,0.488,3,13,0.231,19,28,0.679,106,2012-02-03,WAS,TOR
11301,1,Home,W 89-87 ,240,35,78,0.449,33,68,0.485,2,10,0.2,17,23,0.739,89,34,72,0.472,30,60,0.5,4,12,0.333,15,18,0.833,87,2012-02-04,DET,NOH
11302,2,@,L 89-95 ,240,33,75,0.44,24,56,0.429,9,19,0.474,14,19,0.737,89,34,85,0.4,24,63,0.381,10,22,0.455,17,24,0.708,95,2012-02-04,CHA,PHO
11303,3,@,L 89-95 ,240,34,79,0.43,28,57,0.491,6,22,0.273,15,21,0.714,89,31,69,0.449,27,57,0.474,4,12,0.333,29,34,0.853,95,2012-02-05,TOR,MIA
11304,4,@,W 89-84 ,240,34,73,0.466,27,57,0.474,7,16,0.438,14,21,0.667,89,31,83,0.373,27,70,0.386,4,13,0.308,18,21,0.857,84,2012-02-06,SAS,MEM
11305,5,@,L 89-102 ,240,36,76,0.474,31,61,0.508,5,15,0.333,12,17,0.706,89,35,83,0.422,18,41,0.439,17,42,0.405,15,21,0.714,102,2012-02-08,MIA,ORL
11306,6,Home,L 89-96 ,240,35,74,0.473,26,47,0.553,9,27,0.333,10,16,0.625,89,42,86,0.488,34,70,0.486,8,16,0.5,4,6,0.667,96,2012-02-09,PHO,HOU
11307,7,@,W 89-87 (OT),265,36,82,0.439,30,65,0.462,6,17,0.353,11,18,0.611,89,35,83,0.422,26,59,0.441,9,24,0.375,8,14,0.571,87,2012-02-10,ATL,ORL
11308,8,Home,L 89-106 ,240,34,89,0.382,30,68,0.441,4,21,0.19,17,28,0.607,89,40,81,0.494,35,66,0.53,5,15,0.333,21,23,0.913,106,2012-02-10,WAS,MIA
11309,9,Home,L 89-103 ,240,35,87,0.402,28,63,0.444,7,24,0.292,12,15,0.8,89,42,80,0.525,35,58,0.603,7,22,0.318,12,17,0.706,103,2012-02-11,BRK,SAS
11310,10,Home,L 89-98 ,240,30,73,0.411,23,56,0.411,7,17,0.412,22,30,0.733,89,36,83,0.434,30,65,0.462,6,18,0.333,20,24,0.833,98,2012-02-13,CHA,PHI
11311,11,@,L 89-102 ,240,33,80,0.413,27,59,0.458,6,21,0.286,17,25,0.68,89,36,85,0.424,24,55,0.436,12,30,0.4,18,22,0.818,102,2012-02-13,MIN,ORL
11312,12,Home,L 89-92 ,240,33,86,0.384,26,68,0.382,7,18,0.389,16,18,0.889,89,36,80,0.45,29,65,0.446,7,15,0.467,13,17,0.765,92,2012-02-15,MIL,NOH
11313,13,Home,W 89-80 ,240,30,76,0.395,20,55,0.364,10,21,0.476,19,28,0.679,89,31,78,0.397,28,63,0.444,3,15,0.2,15,18,0.833,80,2012-02-16,CHI,BOS
11314,14,@,W 89-85 ,240,32,75,0.427,25,63,0.397,7,12,0.583,18,23,0.783,89,31,75,0.413,27,51,0.529,4,24,0.167,19,29,0.655,85,2012-02-17,NOP,NYK
11315,15,Home,W 89-73 ,240,36,89,0.404,29,64,0.453,7,25,0.28,10,14,0.714,89,29,74,0.392,22,50,0.44,7,24,0.292,8,11,0.727,73,2012-02-20,DAL,BOS
11316,16,Home,W 89-76 ,240,31,78,0.397,25,66,0.379,6,12,0.5,21,29,0.724,89,31,85,0.365,23,70,0.329,8,15,0.533,6,8,0.75,76,2012-02-21,MEM,PHI
11317,17,@,W 89-84 ,240,36,89,0.404,34,79,0.43,2,10,0.2,15,20,0.75,89,27,85,0.318,21,58,0.362,6,27,0.222,24,37,0.649,84,2012-02-22,NOP,CLE
11318,18,Home,L 89-96 ,240,37,86,0.43,29,66,0.439,8,20,0.4,7,12,0.583,89,37,88,0.42,30,73,0.411,7,15,0.467,15,21,0.714,96,2012-02-29,SAS,CHI
11319,19,Home,W 89-86 ,240,35,80,0.438,35,70,0.5,0,10,0.0,19,25,0.76,89,35,76,0.461,27,53,0.509,8,23,0.348,8,9,0.889,86,2012-03-07,MIA,ATL
11320,20,Home,L 89-95 ,240,33,80,0.413,28,57,0.491,5,23,0.217,18,25,0.72,89,39,85,0.459,36,78,0.462,3,7,0.429,14,16,0.875,95,2012-03-10,MIN,NOH
11321,21,Home,L 89-115 ,240,33,82,0.402,26,63,0.413,7,19,0.368,16,21,0.762,89,46,91,0.505,34,67,0.507,12,24,0.5,11,15,0.733,115,2012-03-13,SAC,GSW
11322,22,Home,L 89-99 ,240,34,75,0.453,30,61,0.492,4,14,0.286,17,19,0.895,89,39,75,0.52,33,57,0.579,6,18,0.333,15,17,0.882,99,2012-03-15,NOP,WAS
11323,23,Home,L 89-100 ,240,36,85,0.424,28,58,0.483,8,27,0.296,9,11,0.818,89,39,79,0.494,28,58,0.483,11,21,0.524,11,12,0.917,100,2012-03-16,CHI,POR
11324,24,Home,W 89-80 ,240,31,77,0.403,25,56,0.446,6,21,0.286,21,31,0.677,89,33,79,0.418,30,66,0.455,3,13,0.231,11,15,0.733,80,2012-03-17,CHI,PHI
11325,25,@,L 89-102 ,240,37,85,0.435,31,63,0.492,6,22,0.273,9,20,0.45,89,35,72,0.486,27,58,0.466,8,14,0.571,24,26,0.923,102,2012-03-20,LAC,IND
11326,26,Home,L 89-108 ,240,31,84,0.369,25,64,0.391,6,20,0.3,21,27,0.778,89,40,83,0.482,34,66,0.515,6,17,0.353,22,29,0.759,108,2012-03-21,BRK,WAS
11327,27,@,L 89-102 ,240,35,79,0.443,32,65,0.492,3,14,0.214,16,22,0.727,89,39,88,0.443,34,72,0.472,5,16,0.313,19,22,0.864,102,2012-03-24,CHA,NJN
11328,28,@,W 89-86 ,240,36,90,0.4,34,71,0.479,2,19,0.105,15,17,0.882,89,37,81,0.457,36,76,0.474,1,5,0.2,11,12,0.917,86,2012-03-24,SAS,NOH
11329,29,Home,W 89-80 ,240,26,74,0.351,19,43,0.442,7,31,0.226,30,35,0.857,89,31,85,0.365,25,61,0.41,6,24,0.25,12,18,0.667,80,2012-03-26,NYK,MIL
11330,30,@,L 89-93 ,240,33,78,0.423,26,56,0.464,7,22,0.318,16,25,0.64,89,31,79,0.392,25,63,0.397,6,16,0.375,25,32,0.781,93,2012-03-29,WAS,IND
11331,31,@,L 89-98 ,240,35,94,0.372,34,79,0.43,1,15,0.067,18,26,0.692,89,38,73,0.521,31,59,0.525,7,14,0.5,15,20,0.75,98,2012-03-30,MEM,HOU
11332,32,@,L 89-94 ,240,34,73,0.466,25,52,0.481,9,21,0.429,12,17,0.706,89,31,80,0.388,22,60,0.367,9,20,0.45,23,27,0.852,94,2012-04-07,DAL,MEM
11333,33,Home,L 89-109 ,240,37,87,0.425,31,68,0.456,6,19,0.316,9,13,0.692,89,39,81,0.481,31,61,0.508,8,20,0.4,23,25,0.92,109,2012-04-09,MIL,OKC
11334,34,@,L 89-119 ,240,30,74,0.405,23,54,0.426,7,20,0.35,22,26,0.846,89,42,80,0.525,27,52,0.519,15,28,0.536,20,24,0.833,119,2012-04-09,DET,ORL
11335,35,Home,L 89-94 ,240,33,83,0.398,27,62,0.435,6,21,0.286,17,19,0.895,89,37,80,0.463,27,61,0.443,10,19,0.526,10,13,0.769,94,2012-04-09,POR,HOU
11336,36,@,L 89-115 ,240,35,90,0.389,26,65,0.4,9,25,0.36,10,14,0.714,89,43,90,0.478,38,78,0.487,5,12,0.417,24,32,0.75,115,2012-04-13,SAC,OKC
11337,37,Home,L 89-95 ,240,34,81,0.42,33,71,0.465,1,10,0.1,20,27,0.741,89,34,81,0.42,28,65,0.431,6,16,0.375,21,27,0.778,95,2012-04-13,PHI,NJN
11338,38,Home,L 89-98 ,240,38,87,0.437,34,73,0.466,4,14,0.286,9,12,0.75,89,34,66,0.515,31,58,0.534,3,8,0.375,27,33,0.818,98,2012-04-14,WAS,CLE
11339,39,@,L 89-93 ,240,29,78,0.372,23,54,0.426,6,24,0.25,25,31,0.806,89,40,90,0.444,36,73,0.493,4,17,0.235,9,10,0.9,93,2012-04-21,POR,MEM
11340,40,@,L 89-124 ,240,37,96,0.385,31,80,0.388,6,16,0.375,9,11,0.818,89,48,81,0.593,36,59,0.61,12,22,0.545,16,21,0.762,124,2012-04-23,POR,SAS
11341,41,@,L 89-106 ,240,33,78,0.423,28,63,0.444,5,15,0.333,18,23,0.783,89,45,85,0.529,36,58,0.621,9,27,0.333,7,9,0.778,106,2012-04-26,DAL,ATL
11342,42,@,L 89-90 ,240,33,83,0.398,26,57,0.456,7,26,0.269,16,27,0.593,89,31,85,0.365,24,66,0.364,7,19,0.368,21,24,0.875,90,2012-11-02,IND,CHA
11343,43,@,L 89-102 ,240,32,84,0.381,25,58,0.431,7,26,0.269,18,27,0.667,89,42,86,0.488,37,71,0.521,5,15,0.333,13,18,0.722,102,2012-11-02,DEN,ORL
11344,44,@,L 89-92 ,240,37,90,0.411,33,77,0.429,4,13,0.308,11,19,0.579,89,40,92,0.435,38,81,0.469,2,11,0.182,10,14,0.714,92,2012-11-02,DET,PHO
11345,45,@,W 89-82 ,240,32,75,0.427,27,57,0.474,5,18,0.278,20,23,0.87,89,29,88,0.33,26,71,0.366,3,17,0.176,21,25,0.84,82,2012-11-03,NOP,CHI
11346,46,@,W 89-86 ,240,36,84,0.429,28,63,0.444,8,21,0.381,9,13,0.692,89,34,78,0.436,28,58,0.483,6,20,0.3,12,17,0.706,86,2012-11-03,BOS,WAS
11347,47,Home,W 89-86 ,240,38,87,0.437,31,65,0.477,7,22,0.318,6,12,0.5,89,35,85,0.412,27,59,0.458,8,26,0.308,8,9,0.889,86,2012-11-07,ATL,IND
11348,48,Home,L 89-95 ,240,34,81,0.42,25,56,0.446,9,25,0.36,12,16,0.75,89,37,76,0.487,30,54,0.556,7,22,0.318,14,16,0.875,95,2012-11-09,ATL,MIA
11349,49,Home,W 89-85 ,240,34,80,0.425,27,64,0.422,7,16,0.438,14,24,0.583,89,35,79,0.443,25,55,0.455,10,24,0.417,5,7,0.714,85,2012-11-10,IND,WAS
11350,50,Home,W 89-76 ,240,38,82,0.463,33,67,0.493,5,15,0.333,8,8,1.0,89,30,72,0.417,21,47,0.447,9,25,0.36,7,16,0.438,76,2012-11-11,LAC,ATL
11351,51,Home,L 89-99 ,240,37,75,0.493,32,61,0.525,5,14,0.357,10,17,0.588,89,41,84,0.488,32,60,0.533,9,24,0.375,8,11,0.727,99,2012-11-13,ORL,NYK
11352,52,@,W 89-87 ,240,38,84,0.452,34,68,0.5,4,16,0.25,9,14,0.643,89,31,81,0.383,26,62,0.419,5,19,0.263,20,37,0.541,87,2012-11-14,CHA,MIN
11353,53,@,L 89-107 ,240,30,70,0.429,22,48,0.458,8,22,0.364,21,31,0.677,89,43,76,0.566,37,61,0.607,6,15,0.4,15,19,0.789,107,2012-11-17,TOR,BOS
11354,54,Home,L 89-96 ,240,31,87,0.356,27,70,0.386,4,17,0.235,23,31,0.742,89,34,70,0.486,31,51,0.608,3,19,0.158,25,29,0.862,96,2012-11-19,WAS,IND
11355,55,@,L 89-93 ,240,38,95,0.4,36,79,0.456,2,16,0.125,11,19,0.579,89,32,74,0.432,25,55,0.455,7,19,0.368,22,31,0.71,93,2012-11-21,CHI,HOU
11356,56,Home,L 89-115 ,240,34,92,0.37,24,64,0.375,10,28,0.357,11,20,0.55,89,40,82,0.488,28,60,0.467,12,22,0.545,23,34,0.676,115,2012-11-24,DAL,LAL
11357,57,@,L 89-96 (OT),265,33,85,0.388,27,64,0.422,6,21,0.286,17,24,0.708,89,37,91,0.407,28,63,0.444,9,28,0.321,13,19,0.684,96,2012-11-26,NYK,BRK
11358,58,Home,L 89-97 ,240,37,84,0.44,31,67,0.463,6,17,0.353,9,14,0.643,89,38,83,0.458,32,61,0.525,6,22,0.273,15,18,0.833,97,2012-11-27,SAC,MIN
11359,59,Home,L 89-110 ,240,41,95,0.432,39,80,0.488,2,15,0.133,5,8,0.625,89,44,84,0.524,33,59,0.559,11,25,0.44,11,15,0.733,110,2012-11-28,ORL,SAS
11360,60,@,L 89-102 ,240,33,75,0.44,27,47,0.574,6,28,0.214,17,27,0.63,89,40,78,0.513,33,58,0.569,7,20,0.35,15,19,0.789,102,2012-12-01,BRK,MIA
11361,61,Home,W 89-79 ,240,36,84,0.429,32,66,0.485,4,18,0.222,13,19,0.684,89,32,95,0.337,29,75,0.387,3,20,0.15,12,17,0.706,79,2012-12-03,DET,CLE
11362,62,Home,L 89-92 ,240,34,76,0.447,24,53,0.453,10,23,0.435,11,18,0.611,89,38,86,0.442,35,69,0.507,3,17,0.176,13,20,0.65,92,2012-12-07,IND,DEN
11363,63,Home,L 89-96 ,240,36,75,0.48,28,59,0.475,8,16,0.5,9,12,0.75,89,36,72,0.5,28,55,0.509,8,17,0.471,16,22,0.727,96,2012-12-07,NOP,MEM
11364,64,Home,L 89-94 ,240,35,87,0.402,25,67,0.373,10,20,0.5,9,12,0.75,89,37,80,0.463,33,69,0.478,4,11,0.364,16,23,0.696,94,2012-12-11,CHI,LAC
11365,65,Home,L 89-96 ,240,41,91,0.451,39,77,0.506,2,14,0.143,5,11,0.455,89,34,78,0.436,30,67,0.448,4,11,0.364,24,26,0.923,96,2012-12-12,PHI,CHI
11366,66,@,L 89-101 ,240,34,85,0.4,26,65,0.4,8,20,0.4,13,17,0.765,89,37,76,0.487,27,49,0.551,10,27,0.37,17,23,0.739,101,2012-12-14,BOS,HOU
11367,67,@,L 89-100 ,240,35,81,0.432,30,71,0.423,5,10,0.5,14,19,0.737,89,37,74,0.5,32,65,0.492,5,9,0.556,21,24,0.875,100,2012-12-18,BOS,CHI
11368,68,Home,L 89-99 ,240,32,80,0.4,27,64,0.422,5,16,0.313,20,26,0.769,89,39,80,0.488,34,64,0.531,5,16,0.313,16,25,0.64,99,2012-12-21,CLE,IND
11369,69,@,L 89-105 ,240,30,73,0.411,23,57,0.404,7,16,0.438,22,26,0.846,89,38,73,0.521,27,49,0.551,11,24,0.458,18,22,0.818,105,2012-12-22,UTA,MIA
11370,70,Home,L 89-99 ,240,35,90,0.389,30,75,0.4,5,15,0.333,14,17,0.824,89,37,71,0.521,28,55,0.509,9,16,0.563,16,23,0.696,99,2012-12-26,MEM,PHI
11371,71,@,L 89-96 ,240,35,87,0.402,30,67,0.448,5,20,0.25,14,23,0.609,89,34,80,0.425,27,63,0.429,7,17,0.412,21,26,0.808,96,2012-12-28,PHI,GSW
11372,72,Home,W 89-85 ,240,34,76,0.447,26,53,0.491,8,23,0.348,13,16,0.813,89,36,85,0.424,32,68,0.471,4,17,0.235,9,11,0.818,85,2012-12-29,POR,PHI
11373,73,Home,W 89-81 ,240,29,77,0.377,24,61,0.393,5,16,0.313,26,31,0.839,89,35,83,0.422,32,70,0.457,3,13,0.231,8,10,0.8,81,2013-01-02,IND,WAS
11374,74,@,L 89-95 ,240,37,84,0.44,32,70,0.457,5,14,0.357,10,12,0.833,89,39,85,0.459,36,72,0.5,3,13,0.231,14,20,0.7,95,2013-01-02,PHI,PHO
11375,75,Home,L 89-96 ,240,30,65,0.462,25,45,0.556,5,20,0.25,24,31,0.774,89,36,80,0.45,31,66,0.47,5,14,0.357,19,24,0.792,96,2013-01-04,MIA,CHI
11376,76,@,W 89-81 ,240,39,85,0.459,36,69,0.522,3,16,0.188,8,12,0.667,89,28,68,0.412,18,39,0.462,10,29,0.345,15,19,0.789,81,2013-01-05,BOS,ATL
11377,77,@,L 89-115 ,240,32,72,0.444,27,52,0.519,5,20,0.25,20,26,0.769,89,47,90,0.522,37,62,0.597,10,28,0.357,11,15,0.733,115,2013-01-05,GSW,LAC
11378,78,Home,L 89-109 ,240,38,79,0.481,31,62,0.5,7,17,0.412,6,10,0.6,89,40,83,0.482,30,59,0.508,10,24,0.417,19,22,0.864,109,2013-01-08,PHI,BRK
11379,79,@,L 89-100 ,240,33,79,0.418,27,64,0.422,6,15,0.4,17,24,0.708,89,39,80,0.488,31,59,0.525,8,21,0.381,14,20,0.7,100,2013-01-14,CHA,BOS
11380,80,@,L 89-94 ,240,35,80,0.438,26,59,0.441,9,21,0.429,10,14,0.714,89,30,74,0.405,21,48,0.438,9,26,0.346,25,38,0.658,94,2013-01-18,ATL,BRK
11381,81,@,W 89-86 ,240,32,83,0.386,24,55,0.436,8,28,0.286,17,20,0.85,89,31,76,0.408,28,58,0.483,3,18,0.167,21,28,0.75,86,2013-01-24,NYK,BOS
11382,82,@,L 89-106 ,240,34,98,0.347,28,73,0.384,6,25,0.24,15,19,0.789,89,40,72,0.556,35,58,0.603,5,14,0.357,21,25,0.84,106,2013-01-31,MEM,OKC
11383,83,@,L 89-93 ,240,34,78,0.436,33,64,0.516,1,14,0.071,20,22,0.909,89,39,75,0.52,34,64,0.531,5,11,0.455,10,20,0.5,93,2013-02-01,CHI,BRK
11384,84,@,L 89-102 ,240,33,70,0.471,28,56,0.5,5,14,0.357,18,24,0.75,89,39,70,0.557,32,53,0.604,7,17,0.412,17,24,0.708,102,2013-02-01,MIA,IND
11385,85,Home,W 89-80 ,240,36,76,0.474,33,62,0.532,3,14,0.214,14,19,0.737,89,30,79,0.38,29,69,0.42,1,10,0.1,19,25,0.76,80,2013-02-01,PHI,SAC
11386,86,@,L 89-111 ,240,34,77,0.442,27,61,0.443,7,16,0.438,14,19,0.737,89,36,68,0.529,21,41,0.512,15,27,0.556,24,32,0.75,111,2013-02-08,LAC,MIA
11387,87,Home,L 89-93 ,240,37,78,0.474,33,62,0.532,4,16,0.25,11,17,0.647,89,36,79,0.456,31,67,0.463,5,12,0.417,16,18,0.889,93,2013-02-08,UTA,CHI
11388,88,Home,W 89-74 ,240,36,80,0.45,29,64,0.453,7,16,0.438,10,11,0.909,89,25,76,0.329,20,58,0.345,5,18,0.278,19,32,0.594,74,2013-02-08,WAS,BRK
11389,89,@,L 89-102 ,240,34,69,0.493,29,56,0.518,5,13,0.385,16,25,0.64,89,40,78,0.513,32,62,0.516,8,16,0.5,14,18,0.778,102,2013-02-10,NOP,TOR
11390,90,Home,L 89-103 ,240,37,78,0.474,35,66,0.53,2,12,0.167,13,20,0.65,89,39,75,0.52,31,59,0.525,8,16,0.5,17,20,0.85,103,2013-02-11,CHI,SAS
11391,91,@,W 89-84 (OT),265,31,80,0.388,27,68,0.397,4,12,0.333,23,32,0.719,89,33,96,0.344,28,74,0.378,5,22,0.227,13,18,0.722,84,2013-02-11,BRK,IND
11392,92,Home,L 89-105 ,240,33,74,0.446,28,58,0.483,5,16,0.313,18,28,0.643,89,43,83,0.518,36,58,0.621,7,25,0.28,12,20,0.6,105,2013-03-01,CLE,LAC
11393,93,Home,W 89-88 ,240,30,81,0.37,26,64,0.406,4,17,0.235,25,30,0.833,89,37,81,0.457,35,71,0.493,2,10,0.2,12,18,0.667,88,2013-03-08,CHI,UTA
11394,94,@,L 89-90 (OT),265,30,84,0.357,28,66,0.424,2,18,0.111,27,32,0.844,89,32,89,0.36,26,74,0.351,6,15,0.4,20,24,0.833,90,2013-03-20,OKC,MEM
11395,95,Home,L 89-99 ,240,39,89,0.438,35,75,0.467,4,14,0.286,7,11,0.636,89,41,84,0.488,31,63,0.492,10,21,0.476,7,10,0.7,99,2013-03-21,CHI,POR
11396,96,@,L 89-103 ,240,34,83,0.41,27,61,0.443,7,22,0.318,14,18,0.778,89,38,68,0.559,30,53,0.566,8,15,0.533,19,26,0.731,103,2013-03-22,DET,MIA
11397,97,Home,L 89-97 ,240,38,92,0.413,33,76,0.434,5,16,0.313,8,10,0.8,89,34,80,0.425,29,59,0.492,5,21,0.238,24,33,0.727,97,2013-03-22,ORL,OKC
11398,98,Home,L 89-108 ,240,34,74,0.459,29,56,0.518,5,18,0.278,16,18,0.889,89,42,69,0.609,28,42,0.667,14,27,0.519,10,16,0.625,108,2013-03-29,NOP,MIA
11399,99,@,L 89-108 ,240,32,74,0.432,25,49,0.51,7,25,0.28,18,23,0.783,89,35,72,0.486,21,45,0.467,14,27,0.519,24,31,0.774,108,2013-03-31,BOS,NYK
11400,0,@,W 89-79 ,240,31,69,0.449,18,36,0.5,13,33,0.394,14,17,0.824,89,28,88,0.318,25,72,0.347,3,16,0.188,20,22,0.909,79,2013-04-05,MIA,CHA
11401,1,@,W 89-87 ,240,32,73,0.438,29,66,0.439,3,7,0.429,22,29,0.759,89,29,81,0.358,22,56,0.393,7,25,0.28,22,28,0.786,87,2013-04-07,MEM,SAC
11402,2,@,L 89-105 ,240,33,90,0.367,26,71,0.366,7,19,0.368,16,20,0.8,89,39,91,0.429,29,67,0.433,10,24,0.417,17,22,0.773,105,2013-04-09,MIN,GSW
11403,3,Home,L 89-107 ,240,33,87,0.379,24,65,0.369,9,22,0.409,14,18,0.778,89,45,86,0.523,36,65,0.554,9,21,0.429,8,8,1.0,107,2013-04-14,NOP,DAL
11404,4,Home,L 89-95 ,240,37,89,0.416,34,68,0.5,3,21,0.143,12,14,0.857,89,36,85,0.424,26,58,0.448,10,27,0.37,13,18,0.722,95,2013-04-17,OKC,MIL
11405,5,Home,W 89-74 ,240,32,77,0.416,22,49,0.449,10,28,0.357,15,20,0.75,89,29,83,0.349,26,68,0.382,3,15,0.2,13,15,0.867,74,2013-11-02,IND,CLE
11406,6,Home,L 89-91 ,240,33,83,0.398,29,63,0.46,4,20,0.2,19,29,0.655,89,34,95,0.358,32,81,0.395,2,14,0.143,21,26,0.808,91,2013-11-08,ORL,BOS
11407,7,Home,L 89-120 ,240,31,82,0.378,25,60,0.417,6,22,0.273,21,29,0.724,89,41,76,0.539,29,48,0.604,12,28,0.429,26,30,0.867,120,2013-11-10,NYK,SAS
11408,8,@,W 89-83 ,240,30,82,0.366,27,70,0.386,3,12,0.25,26,30,0.867,89,29,77,0.377,22,56,0.393,7,21,0.333,18,25,0.72,83,2013-11-13,CHA,BOS
11409,9,@,L 89-90 ,240,37,86,0.43,32,71,0.451,5,15,0.333,10,13,0.769,89,35,84,0.417,29,69,0.42,6,15,0.4,14,23,0.609,90,2013-11-13,PHO,POR
11410,10,@,W 89-86 ,240,37,85,0.435,36,72,0.5,1,13,0.077,14,14,1.0,89,35,80,0.438,25,56,0.446,10,24,0.417,6,11,0.545,86,2013-11-15,MEM,LAL
11411,11,Home,L 89-96 ,240,36,84,0.429,33,71,0.465,3,13,0.231,14,22,0.636,89,37,85,0.435,29,62,0.468,8,23,0.348,14,21,0.667,96,2013-11-22,DET,ATL
11412,12,@,L 89-98 ,240,36,82,0.439,25,53,0.472,11,29,0.379,6,15,0.4,89,37,76,0.487,30,57,0.526,7,19,0.368,17,22,0.773,98,2013-11-23,NYK,WAS
11413,13,Home,W 89-83 (OT),265,33,85,0.388,26,68,0.382,7,17,0.412,16,19,0.842,89,31,79,0.392,30,66,0.455,1,13,0.077,20,28,0.714,83,2013-11-25,UTA,CHI
11414,14,Home,W 89-82 ,240,33,82,0.402,25,61,0.41,8,21,0.381,15,17,0.882,89,30,78,0.385,27,61,0.443,3,17,0.176,19,25,0.76,82,2013-12-03,DAL,CHA
11415,15,@,L 89-108 ,240,38,94,0.404,33,74,0.446,5,20,0.25,8,17,0.471,89,47,91,0.516,39,68,0.574,8,23,0.348,6,11,0.545,108,2013-12-06,CLE,ATL
11416,16,@,W 89-81 ,240,36,84,0.429,29,68,0.426,7,16,0.438,10,18,0.556,89,31,81,0.383,28,68,0.412,3,13,0.231,16,21,0.762,81,2013-12-23,GSW,DEN
11417,17,@,W 89-85 ,240,33,80,0.413,25,55,0.455,8,25,0.32,15,24,0.625,89,30,80,0.375,21,57,0.368,9,23,0.391,16,20,0.8,85,2013-12-27,OKC,CHA
11418,18,@,L 89-105 ,240,33,82,0.402,27,59,0.458,6,23,0.261,17,24,0.708,89,42,89,0.472,31,65,0.477,11,24,0.458,10,15,0.667,105,2013-12-27,DEN,NOP
11419,19,Home,W 89-82 ,240,31,71,0.437,23,47,0.489,8,24,0.333,19,22,0.864,89,29,79,0.367,19,57,0.333,10,22,0.455,14,20,0.7,82,2014-01-04,BRK,CLE
11420,20,Home,W 89-85 ,240,33,81,0.407,24,55,0.436,9,26,0.346,14,20,0.7,89,32,86,0.372,29,67,0.433,3,19,0.158,18,23,0.783,85,2014-01-07,NYK,DET
11421,21,@,L 89-117 ,240,34,85,0.4,30,66,0.455,4,19,0.211,17,22,0.773,89,43,86,0.5,33,63,0.524,10,23,0.435,21,23,0.913,117,2014-01-16,NYK,IND
11422,22,Home,L 89-110 ,240,32,74,0.432,28,58,0.483,4,16,0.25,21,31,0.677,89,43,79,0.544,34,57,0.596,9,22,0.409,15,19,0.789,110,2014-01-17,DET,UTA
11423,23,@,L 89-94 ,240,36,82,0.439,33,64,0.516,3,18,0.167,14,20,0.7,89,34,78,0.436,23,54,0.426,11,24,0.458,15,20,0.75,94,2014-01-17,MIN,TOR
11424,24,@,W 89-87 ,240,31,77,0.403,20,54,0.37,11,23,0.478,16,22,0.727,89,37,88,0.42,31,69,0.449,6,19,0.316,7,10,0.7,87,2014-01-25,CHI,CHA
11425,25,Home,L 89-100 ,240,33,80,0.413,27,65,0.415,6,15,0.4,17,27,0.63,89,39,74,0.527,35,61,0.574,4,13,0.308,18,23,0.783,100,2014-01-28,CLE,NOP
11426,26,Home,L 89-99 ,240,38,79,0.481,33,58,0.569,5,21,0.238,8,8,1.0,89,41,75,0.547,37,61,0.607,4,14,0.286,13,16,0.813,99,2014-01-29,SAC,MEM
11427,27,@,L 89-96 ,240,33,80,0.413,28,66,0.424,5,14,0.357,18,22,0.818,89,41,82,0.5,37,68,0.544,4,14,0.286,10,12,0.833,96,2014-02-02,ORL,BOS
11428,28,@,W 89-85 ,240,34,74,0.459,29,56,0.518,5,18,0.278,16,20,0.8,89,33,76,0.434,26,51,0.51,7,25,0.28,12,15,0.8,85,2014-02-04,IND,ATL
11429,29,@,L 89-103 ,240,29,73,0.397,22,52,0.423,7,21,0.333,24,29,0.828,89,46,93,0.495,42,80,0.525,4,13,0.308,7,10,0.7,103,2014-02-06,SAS,BRK
11430,30,@,L 89-99 ,240,31,87,0.356,26,72,0.361,5,15,0.333,22,24,0.917,89,40,88,0.455,31,66,0.47,9,22,0.409,10,15,0.667,99,2014-02-07,SAC,BOS
11431,31,@,L 89-94 ,240,29,67,0.433,22,44,0.5,7,23,0.304,24,30,0.8,89,36,74,0.486,26,49,0.531,10,25,0.4,12,19,0.632,94,2014-02-08,MIA,UTA
11432,32,Home,L 89-107 ,240,31,87,0.356,25,62,0.403,6,25,0.24,21,21,1.0,89,39,82,0.476,28,55,0.509,11,27,0.407,18,20,0.9,107,2014-02-10,MIN,HOU
11433,33,@,L 89-114 ,240,37,82,0.451,32,68,0.471,5,14,0.357,10,12,0.833,89,45,82,0.549,33,58,0.569,12,24,0.5,12,15,0.8,114,2014-02-11,DAL,CHA
11434,34,@,L 89-92 ,240,34,74,0.459,27,50,0.54,7,24,0.292,14,20,0.7,89,33,70,0.471,30,57,0.526,3,13,0.231,23,27,0.852,92,2014-02-11,WAS,MEM
11435,35,@,L 89-105 ,240,36,87,0.414,26,60,0.433,10,27,0.37,7,15,0.467,89,40,80,0.5,27,49,0.551,13,31,0.419,12,15,0.8,105,2014-02-12,CHA,BRK
11436,36,Home,L 89-93 ,240,33,83,0.398,29,60,0.483,4,23,0.174,19,27,0.704,89,34,84,0.405,29,69,0.42,5,15,0.333,20,30,0.667,93,2014-02-12,DET,CLE
11437,37,@,L 89-117 ,240,35,87,0.402,28,72,0.389,7,15,0.467,12,22,0.545,89,42,84,0.5,32,67,0.478,10,17,0.588,23,27,0.852,117,2014-02-21,DEN,CHI
11438,38,@,L 89-92 ,240,34,79,0.43,30,64,0.469,4,15,0.267,17,22,0.773,89,30,82,0.366,22,62,0.355,8,20,0.4,24,27,0.889,92,2014-02-22,MEM,CHA
11439,39,@,L 89-108 ,240,36,71,0.507,27,51,0.529,9,20,0.45,8,19,0.421,89,41,79,0.519,31,57,0.544,10,22,0.455,16,17,0.941,108,2014-02-26,NOP,DAL
11440,40,Home,L 89-112 ,240,30,81,0.37,24,59,0.407,6,22,0.273,23,33,0.697,89,39,82,0.476,29,51,0.569,10,31,0.323,24,29,0.828,112,2014-02-27,DEN,BRK
11441,41,@,L 89-96 ,240,32,75,0.427,26,55,0.473,6,20,0.3,19,28,0.679,89,32,68,0.471,31,61,0.508,1,7,0.143,31,41,0.756,96,2014-03-03,NOP,SAC
11442,42,Home,L 89-101 ,240,38,84,0.452,35,70,0.5,3,14,0.214,10,12,0.833,89,40,82,0.488,34,60,0.567,6,22,0.273,15,24,0.625,101,2014-03-05,ORL,HOU
11443,43,@,L 89-111 ,240,37,93,0.398,32,72,0.444,5,21,0.238,10,14,0.714,89,44,87,0.506,37,74,0.5,7,13,0.538,16,22,0.727,111,2014-03-08,CHA,MEM
11444,44,@,L 89-104 ,240,36,81,0.444,31,58,0.534,5,23,0.217,12,21,0.571,89,41,77,0.532,29,52,0.558,12,25,0.48,10,16,0.625,104,2014-03-09,SAC,BRK
11445,45,@,L 89-99 ,240,34,84,0.405,31,69,0.449,3,15,0.2,18,30,0.6,89,38,87,0.437,31,69,0.449,7,18,0.389,16,19,0.842,99,2014-03-11,SAC,DET
11446,46,@,L 89-94 ,240,34,93,0.366,25,71,0.352,9,22,0.409,12,14,0.857,89,33,78,0.423,24,51,0.471,9,27,0.333,19,21,0.905,94,2014-03-17,BOS,DAL
11447,47,@,L 89-103 ,240,35,77,0.455,31,64,0.484,4,13,0.308,15,20,0.75,89,37,82,0.451,27,55,0.491,10,27,0.37,19,21,0.905,103,2014-03-18,ORL,GSW
11448,48,Home,W 89-88 ,240,29,75,0.387,18,48,0.375,11,27,0.407,20,26,0.769,89,31,79,0.392,24,62,0.387,7,17,0.412,19,24,0.792,88,2014-03-22,UTA,ORL
11449,49,Home,L 89-100 ,240,32,86,0.372,28,65,0.431,4,21,0.19,21,25,0.84,89,39,82,0.476,27,55,0.491,12,27,0.444,10,18,0.556,100,2014-03-24,CHA,HOU
11450,50,Home,W 89-77 ,240,35,84,0.417,31,69,0.449,4,15,0.267,15,16,0.938,89,27,73,0.37,23,63,0.365,4,10,0.4,19,21,0.905,77,2014-03-24,CHI,IND
11451,51,@,W 89-84 ,240,32,80,0.4,23,55,0.418,9,25,0.36,16,18,0.889,89,28,79,0.354,18,48,0.375,10,31,0.323,18,22,0.818,84,2014-03-30,NYK,GSW
11452,52,Home,L 89-90 ,240,34,76,0.447,20,45,0.444,14,31,0.452,7,8,0.875,89,38,78,0.487,33,59,0.559,5,19,0.263,9,15,0.6,90,2014-04-04,NYK,WAS
11453,53,@,L 89-100 ,240,29,74,0.392,23,52,0.442,6,22,0.273,25,32,0.781,89,37,81,0.457,28,56,0.5,9,25,0.36,17,21,0.81,100,2014-04-13,CHI,NYK
11454,54,@,L 89-101 ,240,31,77,0.403,22,45,0.489,9,32,0.281,18,22,0.818,89,35,79,0.443,26,50,0.52,9,29,0.31,22,30,0.733,101,2014-04-14,OKC,NOP
11455,55,Home,W 89-79 ,240,30,85,0.353,24,61,0.393,6,24,0.25,23,31,0.742,89,31,84,0.369,25,58,0.431,6,26,0.231,11,19,0.579,79,2014-10-29,DEN,DET
11456,56,@,L 89-106 ,240,33,81,0.407,31,65,0.477,2,16,0.125,21,26,0.808,89,39,87,0.448,28,58,0.483,11,29,0.379,17,22,0.773,106,2014-10-29,OKC,POR
11457,57,Home,L 89-97 ,240,34,74,0.459,26,53,0.491,8,21,0.381,13,16,0.813,89,35,79,0.443,28,60,0.467,7,19,0.368,20,27,0.741,97,2014-10-31,IND,MEM
11458,58,@,L 89-94 ,240,32,78,0.41,24,53,0.453,8,25,0.32,17,23,0.739,89,35,87,0.402,33,69,0.478,2,18,0.111,22,26,0.846,94,2014-10-31,SAS,PHO
11459,59,@,L 89-96 ,240,30,77,0.39,26,55,0.473,4,22,0.182,25,31,0.806,89,35,82,0.427,30,64,0.469,5,18,0.278,21,29,0.724,96,2014-11-05,MIA,CHO
11460,60,Home,L 89-91 ,240,33,77,0.429,25,52,0.481,8,25,0.32,15,23,0.652,89,39,88,0.443,36,68,0.529,3,20,0.15,10,12,0.833,91,2014-11-05,PHI,ORL
11461,61,Home,L 89-91 ,240,37,79,0.468,25,54,0.463,12,25,0.48,3,11,0.273,89,34,81,0.42,25,63,0.397,9,18,0.5,14,17,0.824,91,2014-11-07,OKC,MEM
11462,62,@,W 89-85 ,240,33,83,0.398,31,64,0.484,2,19,0.105,21,27,0.778,89,33,74,0.446,28,52,0.538,5,22,0.227,14,17,0.824,85,2014-11-10,SAS,LAC
11463,63,Home,L 89-96 (OT),265,38,96,0.396,26,60,0.433,12,36,0.333,1,6,0.167,89,38,89,0.427,27,58,0.466,11,31,0.355,9,15,0.6,96,2014-11-14,OKC,DET
11464,64,Home,L 89-105 ,240,36,81,0.444,29,58,0.5,7,23,0.304,10,22,0.455,89,39,80,0.488,29,54,0.537,10,26,0.385,17,25,0.68,105,2014-11-17,LAC,CHI
11465,65,@,L 89-99 ,240,31,83,0.373,27,62,0.435,4,21,0.19,23,24,0.958,89,38,80,0.475,33,56,0.589,5,24,0.208,18,26,0.692,99,2014-11-21,DET,ATL
11466,66,Home,L 89-99 ,240,33,79,0.418,30,62,0.484,3,17,0.176,20,29,0.69,89,37,77,0.481,32,63,0.508,5,14,0.357,20,24,0.833,99,2014-11-25,NOP,SAC
11467,67,@,L 89-102 ,240,31,71,0.437,26,55,0.473,5,16,0.313,22,28,0.786,89,42,94,0.447,30,59,0.508,12,35,0.343,6,15,0.4,102,2014-11-26,SAC,HOU
11468,68,Home,L 89-111 ,240,36,87,0.414,30,69,0.435,6,18,0.333,11,15,0.733,89,41,85,0.482,30,59,0.508,11,26,0.423,18,20,0.9,111,2014-11-30,BOS,SAS
11469,69,@,L 89-119 ,240,31,82,0.378,26,60,0.433,5,22,0.227,22,30,0.733,89,45,85,0.529,38,65,0.585,7,20,0.35,22,27,0.815,119,2014-12-05,DEN,WAS
11470,70,Home,L 89-91 ,240,38,84,0.452,31,69,0.449,7,15,0.467,6,9,0.667,89,41,81,0.506,36,69,0.522,5,12,0.417,4,9,0.444,91,2014-12-10,ORL,WAS
11471,71,@,L 89-105 ,240,35,81,0.432,26,54,0.481,9,27,0.333,10,22,0.455,89,41,80,0.513,31,60,0.517,10,20,0.5,13,19,0.684,105,2014-12-17,BRK,TOR
11472,72,Home,L 89-98 ,240,36,73,0.493,27,52,0.519,9,21,0.429,8,12,0.667,89,33,80,0.413,25,50,0.5,8,30,0.267,24,26,0.923,98,2014-12-26,ORL,CLE
11473,73,Home,L 89-101 ,240,34,86,0.395,28,67,0.418,6,19,0.316,15,18,0.833,89,38,75,0.507,27,55,0.491,11,20,0.55,14,21,0.667,101,2015-01-03,MIN,UTA
11474,74,@,W 89-81 ,240,35,88,0.398,30,70,0.429,5,18,0.278,14,17,0.824,89,30,74,0.405,27,60,0.45,3,14,0.214,18,26,0.692,81,2015-01-07,BOS,BRK
11475,75,@,L 89-114 ,240,37,85,0.435,32,65,0.492,5,20,0.25,10,17,0.588,89,40,85,0.471,28,52,0.538,12,33,0.364,22,30,0.733,114,2015-01-07,LAL,LAC
11476,76,@,L 89-120 ,240,36,76,0.474,31,56,0.554,5,20,0.25,12,15,0.8,89,42,89,0.472,26,58,0.448,16,31,0.516,20,24,0.833,120,2015-01-11,WAS,ATL
11477,77,@,L 89-104 ,240,30,71,0.423,24,53,0.453,6,18,0.333,23,27,0.852,89,38,81,0.469,25,52,0.481,13,29,0.448,15,19,0.789,104,2015-01-14,MIA,GSW
11478,78,@,L 89-97 ,240,34,83,0.41,25,58,0.431,9,25,0.36,12,25,0.48,89,33,79,0.418,25,54,0.463,8,25,0.32,23,29,0.793,97,2015-01-16,DEN,DAL
11479,79,Home,L 89-110 ,240,35,82,0.427,29,57,0.509,6,25,0.24,13,17,0.765,89,42,69,0.609,30,46,0.652,12,23,0.522,14,16,0.875,110,2015-01-16,TOR,ATL
11480,80,@,L 89-107 ,240,38,82,0.463,31,54,0.574,7,28,0.25,6,7,0.857,89,38,88,0.432,23,53,0.434,15,35,0.429,16,19,0.842,107,2015-01-17,PHI,DET
11481,81,Home,W 89-69 ,240,31,80,0.388,23,63,0.365,8,17,0.471,19,23,0.826,89,28,84,0.333,25,74,0.338,3,10,0.3,10,16,0.625,69,2015-01-18,SAS,UTA
11482,82,Home,L 89-92 ,240,34,76,0.447,29,58,0.5,5,18,0.278,16,25,0.64,89,36,90,0.4,30,66,0.455,6,24,0.25,14,24,0.583,92,2015-01-19,MIL,TOR
11483,83,Home,L 89-90 ,240,33,89,0.371,24,61,0.393,9,28,0.321,14,19,0.737,89,39,87,0.448,32,68,0.471,7,19,0.368,5,7,0.714,90,2015-01-22,POR,BOS
11484,84,Home,W 89-87 ,240,36,75,0.48,32,58,0.552,4,17,0.235,13,15,0.867,89,32,78,0.41,29,63,0.46,3,15,0.2,20,23,0.87,87,2015-01-23,MIA,IND
11485,85,Home,W 89-69 ,240,37,78,0.474,30,57,0.526,7,21,0.333,8,12,0.667,89,23,75,0.307,21,55,0.382,2,20,0.1,21,23,0.913,69,2015-01-28,PHI,DET
11486,86,Home,L 89-94 ,240,35,81,0.432,30,57,0.526,5,24,0.208,14,20,0.7,89,34,76,0.447,25,50,0.5,9,26,0.346,17,25,0.68,94,2015-01-28,UTA,LAC
11487,87,@,L 89-90 ,240,36,69,0.522,34,57,0.596,2,12,0.167,15,20,0.75,89,35,81,0.432,30,64,0.469,5,17,0.294,15,17,0.882,90,2015-02-06,MEM,MIN
11488,88,Home,W 89-81 ,240,29,74,0.392,20,51,0.392,9,23,0.391,22,30,0.733,89,29,84,0.345,23,61,0.377,6,23,0.261,17,20,0.85,81,2015-02-07,PHI,CHO
11489,89,@,W 89-84 ,240,34,85,0.4,27,56,0.482,7,29,0.241,14,19,0.737,89,33,79,0.418,26,55,0.473,7,24,0.292,11,14,0.786,84,2015-02-09,GSW,PHI
11490,90,Home,W 89-88 ,240,30,93,0.323,20,62,0.323,10,31,0.323,19,20,0.95,89,33,78,0.423,26,49,0.531,7,29,0.241,15,23,0.652,88,2015-02-11,BOS,ATL
11491,91,@,L 89-105 ,240,32,86,0.372,30,74,0.405,2,12,0.167,23,30,0.767,89,37,83,0.446,30,63,0.476,7,20,0.35,24,25,0.96,105,2015-02-11,MEM,OKC
11492,92,Home,W 89-83 ,240,31,67,0.463,27,56,0.482,4,11,0.364,23,28,0.821,89,25,73,0.342,20,58,0.345,5,15,0.333,28,36,0.778,83,2015-02-11,ORL,NYK
11493,93,@,L 89-104 ,240,33,91,0.363,24,64,0.375,9,27,0.333,14,17,0.824,89,38,91,0.418,31,69,0.449,7,22,0.318,21,26,0.808,104,2015-02-19,DAL,OKC
11494,94,Home,W 89-81 ,240,33,78,0.423,28,63,0.444,5,15,0.333,18,22,0.818,89,30,84,0.357,23,58,0.397,7,26,0.269,14,21,0.667,81,2015-02-20,MIL,DEN
11495,95,Home,L 89-127 ,240,38,86,0.442,37,70,0.529,1,16,0.063,12,16,0.75,89,46,90,0.511,32,57,0.561,14,33,0.424,21,28,0.75,127,2015-02-20,WAS,CLE
11496,96,@,L 89-106 ,240,37,85,0.435,31,68,0.456,6,17,0.353,9,14,0.643,89,37,89,0.416,24,57,0.421,13,32,0.406,19,25,0.76,106,2015-02-22,WAS,DET
11497,97,@,L 89-96 ,240,33,77,0.429,31,63,0.492,2,14,0.143,21,31,0.677,89,37,96,0.385,28,65,0.431,9,31,0.29,13,16,0.813,96,2015-02-27,MIN,CHI
11498,98,Home,W 89-81 ,240,28,80,0.35,16,47,0.34,12,33,0.364,21,34,0.618,89,30,93,0.323,26,76,0.342,4,17,0.235,17,22,0.773,81,2015-02-27,PHI,WAS
11499,99,Home,L 89-113 ,240,31,77,0.403,27,55,0.491,4,22,0.182,23,28,0.821,89,42,87,0.483,29,59,0.492,13,28,0.464,16,19,0.842,113,2015-02-27,TOR,GSW
11500,0,@,L 89-104 ,240,32,87,0.368,26,67,0.388,6,20,0.3,19,26,0.731,89,38,81,0.469,27,58,0.466,11,23,0.478,17,19,0.895,104,2015-03-06,DAL,GSW
11501,1,@,W 89-83 ,240,27,71,0.38,21,59,0.356,6,12,0.5,29,41,0.707,89,32,88,0.364,22,56,0.393,10,32,0.313,9,18,0.5,83,2015-03-06,UTA,PHI
11502,2,Home,W 89-79 ,240,31,75,0.413,23,55,0.418,8,20,0.4,19,23,0.826,89,30,84,0.357,21,59,0.356,9,25,0.36,10,14,0.714,79,2015-03-07,CLE,PHO
11503,3,@,L 89-95 ,240,32,74,0.432,26,58,0.448,6,16,0.375,19,29,0.655,89,38,80,0.475,30,57,0.526,8,23,0.348,11,13,0.846,95,2015-03-07,MEM,NOP
11504,4,Home,W 89-76 ,240,35,79,0.443,24,48,0.5,11,31,0.355,8,15,0.533,89,31,83,0.373,29,75,0.387,2,8,0.25,12,21,0.571,76,2015-03-09,LAC,MIN
11505,5,Home,L 89-93 ,240,34,85,0.4,25,61,0.41,9,24,0.375,12,15,0.8,89,35,83,0.422,27,55,0.491,8,28,0.286,15,21,0.714,93,2015-03-14,IND,BOS
11506,6,@,L 89-102 ,240,32,73,0.438,27,59,0.458,5,14,0.357,20,30,0.667,89,41,83,0.494,35,65,0.538,6,18,0.333,14,23,0.609,102,2015-03-15,NYK,PHO
11507,7,@,L 89-108 ,240,34,84,0.405,26,60,0.433,8,24,0.333,13,24,0.542,89,44,88,0.5,36,68,0.529,8,20,0.4,12,15,0.8,108,2015-03-16,PHI,BOS
11508,8,@,L 89-101 ,240,35,88,0.398,30,68,0.441,5,20,0.25,14,20,0.7,89,38,81,0.469,33,58,0.569,5,23,0.217,20,23,0.87,101,2015-03-20,BOS,SAS
11509,9,@,L 89-106 ,240,35,84,0.417,27,65,0.415,8,19,0.421,11,16,0.688,89,39,75,0.52,35,64,0.547,4,11,0.364,24,29,0.828,106,2015-03-22,NYK,TOR
11510,10,Home,W 89-88 ,240,36,87,0.414,32,70,0.457,4,17,0.235,13,17,0.765,89,33,75,0.44,25,56,0.446,8,19,0.421,14,18,0.778,88,2015-03-24,MIL,MIA
11511,11,Home,L 89-111 ,240,37,85,0.435,33,68,0.485,4,17,0.235,11,16,0.688,89,43,84,0.512,29,50,0.58,14,34,0.412,11,13,0.846,111,2015-03-25,MEM,CLE
11512,12,Home,L 89-92 ,240,35,80,0.438,31,64,0.484,4,16,0.25,15,23,0.652,89,34,81,0.42,27,54,0.5,7,27,0.259,17,20,0.85,92,2015-03-25,UTA,POR
11513,13,@,L 89-94 ,240,31,73,0.425,25,57,0.439,6,16,0.375,21,32,0.656,89,32,84,0.381,26,55,0.473,6,29,0.207,24,35,0.686,94,2015-03-28,OKC,UTA
11514,14,@,L 89-103 ,240,36,82,0.439,30,68,0.441,6,14,0.429,11,12,0.917,89,42,83,0.506,38,66,0.576,4,17,0.235,15,18,0.833,103,2015-03-29,MEM,SAS
11515,15,@,L 89-112 ,240,37,82,0.451,35,62,0.565,2,20,0.1,13,19,0.684,89,37,85,0.435,23,55,0.418,14,30,0.467,24,36,0.667,112,2015-04-05,MIA,IND
11516,16,@,W 89-78 ,240,35,91,0.385,29,68,0.426,6,23,0.261,13,17,0.765,89,34,88,0.386,29,70,0.414,5,18,0.278,5,7,0.714,78,2015-04-09,CHI,MIA
11517,17,@,W 89-88 ,240,36,76,0.474,31,61,0.508,5,15,0.333,12,19,0.632,89,31,71,0.437,20,48,0.417,11,23,0.478,15,22,0.682,88,2015-04-10,MEM,UTA
11518,18,@,L 89-109 ,240,32,79,0.405,22,43,0.512,10,36,0.278,15,18,0.833,89,42,86,0.488,33,64,0.516,9,22,0.409,16,21,0.762,109,2015-11-01,HOU,MIA
11519,19,Home,L 89-103 ,240,29,74,0.392,22,54,0.407,7,20,0.35,24,40,0.6,89,40,83,0.482,37,63,0.587,3,20,0.15,20,25,0.8,103,2015-11-03,SAC,MEM
11520,20,Home,W 89-79 ,240,31,74,0.419,19,47,0.404,12,27,0.444,15,18,0.833,89,30,91,0.33,24,72,0.333,6,19,0.316,13,14,0.929,79,2015-11-07,UTA,MEM
11521,21,@,L 89-93 ,240,34,80,0.425,29,60,0.483,5,20,0.25,16,18,0.889,89,35,72,0.486,28,50,0.56,7,22,0.318,16,22,0.727,93,2015-11-18,TOR,UTA
11522,22,Home,L 89-111 ,240,28,73,0.384,23,54,0.426,5,19,0.263,28,40,0.7,89,42,77,0.545,31,50,0.62,11,27,0.407,16,18,0.889,111,2015-11-23,UTA,OKC
11523,23,@,L 89-92 ,240,37,90,0.411,35,76,0.461,2,14,0.143,13,18,0.722,89,37,86,0.43,31,70,0.443,6,16,0.375,12,20,0.6,92,2015-11-30,SAS,CHI
11524,24,@,W 89-77 ,240,36,78,0.462,28,55,0.509,8,23,0.348,9,10,0.9,89,28,87,0.322,19,55,0.345,9,32,0.281,12,14,0.857,77,2015-12-15,CLE,BOS
11525,25,@,L 89-110 ,240,31,79,0.392,24,55,0.436,7,24,0.292,20,22,0.909,89,36,79,0.456,27,54,0.5,9,25,0.36,29,37,0.784,110,2015-12-21,PHO,UTA
11526,26,Home,L 89-102 ,240,29,81,0.358,21,53,0.396,8,28,0.286,23,32,0.719,89,36,85,0.424,29,56,0.518,7,29,0.241,23,26,0.885,102,2015-12-23,CHA,BOS
11527,27,@,L 89-115 ,240,33,95,0.347,26,67,0.388,7,28,0.25,16,24,0.667,89,41,85,0.482,28,54,0.519,13,31,0.419,20,23,0.87,115,2015-12-23,POR,NOP
11528,28,Home,W 89-83 ,240,32,78,0.41,27,60,0.45,5,18,0.278,20,27,0.741,89,30,95,0.316,25,65,0.385,5,30,0.167,18,25,0.72,83,2015-12-25,GSW,CLE
11529,29,@,L 89-104 ,240,37,83,0.446,32,63,0.508,5,20,0.25,10,15,0.667,89,45,82,0.549,38,65,0.585,7,17,0.412,7,11,0.636,104,2015-12-28,NOP,ORL
11530,30,Home,L 89-95 ,240,36,82,0.439,29,57,0.509,7,25,0.28,10,15,0.667,89,35,90,0.389,25,56,0.446,10,34,0.294,15,19,0.789,95,2015-12-31,NOP,LAC
11531,31,@,L 89-115 ,240,36,81,0.444,30,61,0.492,6,20,0.3,11,11,1.0,89,43,88,0.489,29,58,0.5,14,30,0.467,15,21,0.714,115,2016-01-04,ORL,DET
11532,32,@,L 89-103 ,240,38,82,0.463,33,73,0.452,5,9,0.556,8,10,0.8,89,43,92,0.467,35,65,0.538,8,27,0.296,9,14,0.643,103,2016-01-09,BRK,DET
11533,33,@,L 89-108 ,240,32,82,0.39,26,51,0.51,6,31,0.194,19,25,0.76,89,38,82,0.463,23,49,0.469,15,33,0.455,17,29,0.586,108,2016-01-13,DAL,OKC
11534,34,@,L 89-114 ,240,34,87,0.391,29,58,0.5,5,29,0.172,16,24,0.667,89,42,76,0.553,32,53,0.604,10,23,0.435,20,30,0.667,114,2016-01-16,POR,PHI
11535,35,Home,L 89-117 ,240,32,81,0.395,26,63,0.413,6,18,0.333,19,23,0.826,89,42,86,0.488,33,72,0.458,9,14,0.643,24,28,0.857,117,2016-01-21,PHO,SAS
11536,36,@,W 89-84 ,240,37,81,0.457,34,67,0.507,3,14,0.214,12,17,0.706,89,35,88,0.398,30,70,0.429,5,18,0.278,9,12,0.75,84,2016-01-25,MIA,CHI
11537,37,Home,L 89-91 ,240,35,83,0.422,30,67,0.448,5,16,0.313,14,24,0.583,89,32,78,0.41,17,41,0.415,15,37,0.405,12,24,0.5,91,2016-01-26,IND,LAC
11538,38,@,L 89-106 ,240,32,78,0.41,28,63,0.444,4,15,0.267,21,28,0.75,89,35,79,0.443,24,50,0.48,11,29,0.379,25,32,0.781,106,2016-01-26,WAS,TOR
11539,39,Home,L 89-97 ,240,31,82,0.378,25,62,0.403,6,20,0.3,21,28,0.75,89,40,90,0.444,37,71,0.521,3,19,0.158,14,17,0.824,97,2016-02-02,NYK,BOS
11540,40,Home,L 89-98 ,240,30,80,0.375,21,56,0.375,9,24,0.375,20,26,0.769,89,34,78,0.436,29,62,0.468,5,16,0.313,25,31,0.806,98,2016-02-06,PHO,UTA
11541,41,Home,L 89-103 ,240,36,80,0.45,28,52,0.538,8,28,0.286,9,17,0.529,89,39,70,0.557,28,50,0.56,11,20,0.55,14,17,0.824,103,2016-02-08,DET,TOR
11542,42,Home,W 89-87 ,240,31,78,0.397,27,51,0.529,4,27,0.148,23,33,0.697,89,29,93,0.312,21,58,0.362,8,35,0.229,21,26,0.808,87,2016-02-08,IND,LAL
11543,43,@,L 89-103 ,240,31,77,0.403,27,62,0.435,4,15,0.267,23,29,0.793,89,42,86,0.488,35,68,0.515,7,18,0.389,12,21,0.571,103,2016-02-18,UTA,WAS
11544,44,@,L 89-109 ,240,29,83,0.349,23,60,0.383,6,23,0.261,25,33,0.758,89,43,94,0.457,31,68,0.456,12,26,0.462,11,17,0.647,109,2016-02-23,NOP,WAS
11545,45,@,L 89-101 ,240,36,87,0.414,35,74,0.473,1,13,0.077,16,23,0.696,89,39,96,0.406,34,80,0.425,5,16,0.313,18,22,0.818,101,2016-02-27,MIA,BOS
11546,46,@,L 89-102 ,240,38,99,0.384,32,80,0.4,6,19,0.316,7,11,0.636,89,39,97,0.402,32,76,0.421,7,21,0.333,17,22,0.773,102,2016-03-02,CHI,ORL
11547,47,@,L 89-102 ,240,36,92,0.391,30,66,0.455,6,26,0.231,11,15,0.733,89,42,79,0.532,38,63,0.603,4,16,0.25,14,18,0.778,102,2016-03-05,DET,NYK
11548,48,@,L 89-95 ,240,33,87,0.379,28,70,0.4,5,17,0.294,18,22,0.818,89,38,84,0.452,29,56,0.518,9,28,0.321,10,15,0.667,95,2016-03-11,BRK,PHI
11549,49,Home,L 89-107 ,240,34,77,0.442,32,64,0.5,2,13,0.154,19,26,0.731,89,39,83,0.47,25,53,0.472,14,30,0.467,15,17,0.882,107,2016-03-15,MIL,TOR
11550,50,@,L 89-99 ,240,32,81,0.395,22,60,0.367,10,21,0.476,15,17,0.882,89,39,87,0.448,31,58,0.534,8,29,0.276,13,17,0.765,99,2016-03-19,NYK,WAS
11551,51,@,W 89-87 ,240,31,77,0.403,20,48,0.417,11,29,0.379,16,20,0.8,89,33,74,0.446,24,51,0.471,9,23,0.391,12,22,0.545,87,2016-03-23,UTA,HOU
11552,52,@,L 89-111 ,240,36,88,0.409,30,64,0.469,6,24,0.25,11,17,0.647,89,48,89,0.539,41,70,0.586,7,19,0.368,8,12,0.667,111,2016-03-26,CHI,ORL
11553,53,@,L 89-91 ,240,35,77,0.455,32,60,0.533,3,17,0.176,16,18,0.889,89,35,85,0.412,27,60,0.45,8,25,0.32,13,17,0.765,91,2016-03-30,NYK,DAL
11554,54,Home,L 89-98 ,240,31,81,0.383,18,48,0.375,13,33,0.394,14,24,0.583,89,39,85,0.459,31,61,0.508,8,24,0.333,12,14,0.857,98,2016-04-01,DET,DAL
11555,55,@,L 89-107 ,240,32,80,0.4,27,58,0.466,5,22,0.227,20,25,0.8,89,44,84,0.524,35,70,0.5,9,14,0.643,10,14,0.714,107,2016-04-05,DET,MIA
11556,56,Home,L 89-93 ,240,32,89,0.36,25,69,0.362,7,20,0.35,18,21,0.857,89,37,78,0.474,30,58,0.517,7,20,0.35,12,19,0.632,93,2016-04-10,NYK,TOR
11557,57,@,L 89-96 ,240,32,84,0.381,23,61,0.377,9,23,0.391,16,21,0.762,89,31,75,0.413,25,50,0.5,6,25,0.24,28,40,0.7,96,2016-10-28,LAL,UTA
11558,58,@,L 89-102 ,240,35,86,0.407,28,64,0.438,7,22,0.318,12,15,0.8,89,41,89,0.461,33,76,0.434,8,13,0.615,12,21,0.571,102,2016-11-01,NYK,DET
11559,59,Home,W 89-83 (OT),265,33,94,0.351,25,67,0.373,8,27,0.296,15,20,0.75,89,30,81,0.37,19,47,0.404,11,34,0.324,12,16,0.75,83,2016-11-02,MEM,NOP
11560,60,Home,W 89-82 ,240,34,88,0.386,24,61,0.393,10,27,0.37,11,19,0.579,89,30,82,0.366,23,61,0.377,7,21,0.333,15,19,0.789,82,2016-11-16,ORL,NOP
11561,61,@,L 89-93 ,240,32,77,0.416,25,52,0.481,7,25,0.28,18,24,0.75,89,35,86,0.407,27,57,0.474,8,29,0.276,15,21,0.714,93,2016-11-21,ORL,MIL
11562,62,Home,L 89-105 ,240,31,78,0.397,22,56,0.393,9,22,0.409,18,22,0.818,89,40,90,0.444,34,69,0.493,6,21,0.286,19,26,0.731,105,2016-11-25,PHI,CHI
11563,63,Home,L 89-112 ,240,31,78,0.397,22,51,0.431,9,27,0.333,18,21,0.857,89,45,92,0.489,33,64,0.516,12,28,0.429,10,11,0.909,112,2016-11-29,CHA,DET
11564,64,Home,L 89-120 ,240,32,78,0.41,22,48,0.458,10,30,0.333,15,20,0.75,89,47,84,0.56,37,62,0.597,10,22,0.455,16,21,0.762,120,2016-12-07,DAL,SAC
11565,65,@,L 89-110 ,240,34,77,0.442,25,50,0.5,9,27,0.333,12,20,0.6,89,38,87,0.437,30,61,0.492,8,26,0.308,26,29,0.897,110,2016-12-10,GSW,MEM
11566,66,@,L 89-95 ,240,33,89,0.371,24,62,0.387,9,27,0.333,14,17,0.824,89,37,82,0.451,30,57,0.526,7,25,0.28,14,25,0.56,95,2016-12-14,IND,MIA
11567,67,@,L 89-109 ,240,30,82,0.366,24,63,0.381,6,19,0.316,23,27,0.852,89,42,72,0.583,29,49,0.592,13,23,0.565,12,15,0.8,109,2016-12-14,OKC,UTA
11568,68,Home,L 89-100 ,240,32,88,0.364,26,57,0.456,6,31,0.194,19,24,0.792,89,36,79,0.456,27,49,0.551,9,30,0.3,19,22,0.864,100,2016-12-16,PHI,LAL
11569,69,@,L 89-102 ,240,31,79,0.392,22,51,0.431,9,28,0.321,18,23,0.783,89,35,74,0.473,23,49,0.469,12,25,0.48,20,22,0.909,102,2016-12-28,SAC,POR
11570,70,Home,L 89-101 ,240,32,68,0.471,25,49,0.51,7,19,0.368,18,25,0.72,89,38,77,0.494,24,46,0.522,14,31,0.452,11,14,0.786,101,2016-12-29,LAL,DAL
11571,71,Home,L 89-95 ,240,35,87,0.402,28,64,0.438,7,23,0.304,12,18,0.667,89,36,73,0.493,30,51,0.588,6,22,0.273,17,28,0.607,95,2017-01-01,MIN,POR
11572,72,Home,L 89-101 ,240,33,78,0.423,27,51,0.529,6,27,0.222,17,23,0.739,89,39,93,0.419,32,69,0.464,7,24,0.292,16,20,0.8,101,2017-01-02,BRK,UTA
11573,73,@,L 89-104 ,240,35,89,0.393,32,71,0.451,3,18,0.167,16,21,0.762,89,44,92,0.478,37,69,0.536,7,23,0.304,9,11,0.818,104,2017-01-12,CHI,NYK
11574,74,@,L 89-94 ,240,34,86,0.395,28,62,0.452,6,24,0.25,15,23,0.652,89,31,69,0.449,23,45,0.511,8,24,0.333,24,32,0.75,94,2017-01-18,TOR,PHI
11575,75,Home,W 89-74 ,240,32,81,0.395,28,62,0.452,4,19,0.211,21,25,0.84,89,30,82,0.366,26,63,0.413,4,19,0.211,10,18,0.556,74,2017-02-06,MEM,SAS
11576,76,@,L 89-117 ,240,35,84,0.417,25,59,0.424,10,25,0.4,9,13,0.692,89,44,81,0.543,38,57,0.667,6,24,0.25,23,26,0.885,117,2017-02-12,CHI,MIN
11577,77,@,L 89-102 ,240,34,78,0.436,27,57,0.474,7,21,0.333,14,19,0.737,89,40,79,0.506,34,58,0.586,6,21,0.286,16,16,1.0,102,2017-02-13,DET,MIL
11578,78,@,L 89-96 ,240,37,83,0.446,28,57,0.491,9,26,0.346,6,13,0.462,89,33,76,0.434,24,58,0.414,9,18,0.5,21,23,0.913,96,2017-02-27,MIA,DAL
11579,79,@,L 89-104 ,240,33,82,0.402,31,60,0.517,2,22,0.091,21,30,0.7,89,42,86,0.488,35,61,0.574,7,25,0.28,13,16,0.813,104,2017-03-05,OKC,DAL
11580,80,@,W 88-87 ,240,36,89,0.404,29,74,0.392,7,15,0.467,9,14,0.643,88,36,76,0.474,32,60,0.533,4,16,0.25,11,20,0.55,87,2011-12-25,CHI,LAL
11581,81,@,L 88-96 ,240,30,76,0.395,25,61,0.41,5,15,0.333,23,28,0.821,88,39,82,0.476,31,67,0.463,8,15,0.533,10,13,0.769,96,2011-12-31,IND,DET
11582,82,@,L 88-93 ,240,33,78,0.423,29,63,0.46,4,15,0.267,18,22,0.818,88,36,75,0.48,30,51,0.588,6,24,0.25,15,24,0.625,93,2012-01-01,POR,LAC
11583,83,Home,L 88-96 ,240,36,77,0.468,28,60,0.467,8,17,0.471,8,10,0.8,88,37,79,0.468,32,58,0.552,5,21,0.238,17,22,0.773,96,2012-01-06,NOP,DEN
11584,84,@,W 88-87 ,240,32,81,0.395,28,65,0.431,4,16,0.25,20,28,0.714,88,29,70,0.414,22,51,0.431,7,19,0.368,22,24,0.917,87,2012-01-07,UTA,GSW
11585,85,@,W 88-79 ,240,34,76,0.447,30,63,0.476,4,13,0.308,16,21,0.762,88,31,75,0.413,25,61,0.41,6,14,0.429,11,13,0.846,79,2012-01-13,CHI,BOS
11586,86,Home,L 88-97 ,240,34,87,0.391,28,73,0.384,6,14,0.429,14,16,0.875,88,36,80,0.45,29,61,0.475,7,19,0.368,18,19,0.947,97,2012-01-16,BOS,OKC
11587,87,Home,L 88-91 ,240,32,86,0.372,28,71,0.394,4,15,0.267,20,30,0.667,88,36,79,0.456,29,67,0.433,7,12,0.583,12,16,0.75,91,2012-01-18,NYK,PHO
11588,88,@,L 88-92 ,240,34,78,0.436,33,65,0.508,1,13,0.077,19,27,0.704,88,28,93,0.301,20,62,0.323,8,31,0.258,28,41,0.683,92,2012-01-18,IND,SAC
11589,89,@,L 88-90 (OT),265,37,94,0.394,34,83,0.41,3,11,0.273,11,16,0.688,88,35,88,0.398,26,61,0.426,9,27,0.333,11,13,0.846,90,2012-01-19,NOP,HOU
11590,90,@,W 88-86 ,240,36,83,0.434,31,62,0.5,5,21,0.238,11,19,0.579,88,31,82,0.378,26,57,0.456,5,25,0.2,19,21,0.905,86,2012-01-20,SAC,SAS
11591,91,@,W 88-87 ,240,34,79,0.43,31,66,0.47,3,13,0.231,17,20,0.85,88,36,69,0.522,31,58,0.534,5,11,0.455,10,14,0.714,87,2012-01-29,CLE,BOS
11592,92,Home,L 88-98 ,240,37,92,0.402,34,78,0.436,3,14,0.214,11,13,0.846,88,34,75,0.453,28,55,0.509,6,20,0.3,24,31,0.774,98,2012-01-30,WAS,CHI
11593,93,Home,W 88-80 ,240,34,81,0.42,30,67,0.448,4,14,0.286,16,19,0.842,88,26,74,0.351,23,57,0.404,3,17,0.176,25,33,0.758,80,2012-02-03,DET,MIL
11594,94,@,L 88-91 ,240,32,67,0.478,26,54,0.481,6,13,0.462,18,27,0.667,88,37,93,0.398,31,70,0.443,6,23,0.261,11,15,0.733,91,2012-02-04,DAL,CLE
11595,95,@,L 88-99 ,240,33,76,0.434,31,65,0.477,2,11,0.182,20,26,0.769,88,35,73,0.479,26,45,0.578,9,28,0.321,20,31,0.645,99,2012-02-06,UTA,NYK
11596,96,@,W 88-87 (OT),265,36,91,0.396,35,76,0.461,1,15,0.067,15,20,0.75,88,38,97,0.392,32,78,0.41,6,19,0.316,5,5,1.0,87,2012-02-09,LAL,BOS
11597,97,Home,L 88-98 ,240,34,78,0.436,32,68,0.471,2,10,0.2,18,23,0.783,88,42,83,0.506,37,70,0.529,5,13,0.385,9,13,0.692,98,2012-02-12,MEM,UTA
11598,98,Home,L 88-98 ,240,34,77,0.442,33,71,0.465,1,6,0.167,19,32,0.594,88,35,74,0.473,31,62,0.5,4,12,0.333,24,29,0.828,98,2012-02-15,BOS,DET
11599,99,@,L 88-93 ,240,35,75,0.467,31,58,0.534,4,17,0.235,14,16,0.875,88,32,81,0.395,25,62,0.403,7,19,0.368,22,26,0.846,93,2012-02-16,BRK,IND
11600,0,@,L 88-104 ,240,36,84,0.429,31,64,0.484,5,20,0.25,11,19,0.579,88,37,79,0.468,30,58,0.517,7,21,0.333,23,29,0.793,104,2012-02-20,WAS,PHO
11601,1,Home,L 88-102 ,240,31,88,0.352,23,69,0.333,8,19,0.421,18,23,0.783,88,34,85,0.4,27,69,0.391,7,16,0.438,27,32,0.844,102,2012-02-22,CHA,IND
11602,2,@,L 88-102 ,240,31,79,0.392,24,62,0.387,7,17,0.412,19,22,0.864,88,42,85,0.494,38,71,0.535,4,14,0.286,14,19,0.737,102,2012-02-23,NYK,MIA
11603,3,Home,W 88-85 ,240,29,75,0.387,22,55,0.4,7,20,0.35,23,28,0.821,88,35,75,0.467,33,58,0.569,2,17,0.118,13,18,0.722,85,2012-02-28,HOU,TOR
11604,4,Home,L 88-92 ,240,37,90,0.411,33,73,0.452,4,17,0.235,10,12,0.833,88,30,78,0.385,24,59,0.407,6,19,0.316,26,34,0.765,92,2012-02-29,PHI,OKC
11605,5,@,L 88-96 ,240,38,99,0.384,36,86,0.419,2,13,0.154,10,14,0.714,88,40,88,0.455,35,76,0.461,5,12,0.417,11,16,0.688,96,2012-03-04,SAC,PHO
11606,6,Home,L 88-92 ,240,32,79,0.405,24,59,0.407,8,20,0.4,16,20,0.8,88,35,79,0.443,26,51,0.51,9,28,0.321,13,28,0.464,92,2012-03-05,TOR,ORL
11607,7,Home,W 88-85 (OT),265,37,93,0.398,34,83,0.41,3,10,0.3,11,12,0.917,88,34,81,0.42,31,59,0.525,3,22,0.136,14,17,0.824,85,2012-03-06,DET,LAL
11608,8,Home,L 88-96 ,240,29,76,0.382,26,61,0.426,3,15,0.2,27,33,0.818,88,37,74,0.5,29,55,0.527,8,19,0.421,14,21,0.667,96,2012-03-13,CLE,TOR
11609,9,@,L 88-102 ,240,38,78,0.487,33,67,0.493,5,11,0.455,7,9,0.778,88,40,83,0.482,28,56,0.5,12,27,0.444,10,13,0.769,102,2012-03-16,WAS,ATL
11610,10,Home,L 88-102 ,240,32,79,0.405,28,60,0.467,4,19,0.211,20,27,0.741,88,32,77,0.416,25,53,0.472,7,24,0.292,31,40,0.775,102,2012-03-17,IND,NYK
11611,11,@,W 88-73 ,240,34,77,0.442,32,61,0.525,2,16,0.125,18,20,0.9,88,29,75,0.387,23,60,0.383,6,15,0.4,9,17,0.529,73,2012-03-23,MIA,DET
11612,12,Home,W 88-76 ,240,34,70,0.486,31,60,0.517,3,10,0.3,17,18,0.944,88,30,87,0.345,27,73,0.37,3,14,0.214,13,19,0.684,76,2012-03-25,BOS,WAS
11613,13,@,W 88-83 ,240,33,81,0.407,25,60,0.417,8,21,0.381,14,20,0.7,88,31,78,0.397,28,65,0.431,3,13,0.231,18,22,0.818,83,2012-03-28,MIN,CHA
11614,14,Home,L 88-99 ,240,36,98,0.367,30,76,0.395,6,22,0.273,10,11,0.909,88,38,73,0.521,36,56,0.643,2,17,0.118,21,29,0.724,99,2012-03-30,CHA,DEN
11615,15,Home,W 88-85 ,240,32,77,0.416,25,55,0.455,7,22,0.318,17,22,0.773,88,39,92,0.424,37,82,0.451,2,10,0.2,5,10,0.5,85,2012-03-31,LAL,NOH
11616,16,Home,L 88-94 ,240,33,73,0.452,28,52,0.538,5,21,0.238,17,24,0.708,88,34,87,0.391,30,71,0.423,4,16,0.25,22,24,0.917,94,2012-04-02,OKC,MEM
11617,17,@,L 88-101 ,240,32,86,0.372,26,67,0.388,6,19,0.316,18,19,0.947,88,37,81,0.457,25,57,0.439,12,24,0.5,15,19,0.789,101,2012-04-04,BRK,POR
11618,18,@,W 88-82 ,240,29,80,0.363,23,60,0.383,6,20,0.3,24,31,0.774,88,31,78,0.397,26,65,0.4,5,13,0.385,15,20,0.75,82,2012-04-07,ORL,PHI
11619,19,Home,L 88-107 ,240,34,88,0.386,32,77,0.416,2,11,0.182,18,21,0.857,88,39,85,0.459,33,68,0.485,6,17,0.353,23,26,0.885,107,2012-04-10,BRK,PHI
11620,20,Home,W 88-86 (OT),265,37,89,0.416,34,76,0.447,3,13,0.231,11,13,0.846,88,34,83,0.41,32,63,0.508,2,20,0.1,16,23,0.696,86,2012-04-11,BOS,ATL
11621,21,Home,W 88-75 ,240,32,73,0.438,29,60,0.483,3,13,0.231,21,21,1.0,88,25,70,0.357,20,52,0.385,5,18,0.278,20,25,0.8,75,2012-04-15,NOP,MEM
11622,22,@,L 88-111 ,240,32,87,0.368,25,62,0.403,7,25,0.28,17,25,0.68,88,39,88,0.443,28,64,0.438,11,24,0.458,22,25,0.88,111,2012-04-16,MIN,IND
11623,23,Home,L 88-114 ,240,39,89,0.438,37,74,0.5,2,15,0.133,8,14,0.571,88,48,87,0.552,45,78,0.577,3,9,0.333,15,20,0.75,114,2012-04-22,CHA,SAC
11624,24,@,L 88-97 ,240,35,76,0.461,28,56,0.5,7,20,0.35,11,13,0.846,88,35,85,0.412,30,69,0.435,5,16,0.313,22,24,0.917,97,2012-04-22,HOU,MIA
11625,25,Home,L 88-93 ,240,30,82,0.366,23,56,0.411,7,26,0.269,21,21,1.0,88,41,92,0.446,36,76,0.474,5,16,0.313,6,10,0.6,93,2012-04-22,MIN,GSW
11626,26,@,L 88-100 ,240,34,84,0.405,29,61,0.475,5,23,0.217,15,23,0.652,88,37,87,0.425,33,74,0.446,4,13,0.308,22,29,0.759,100,2012-04-24,PHO,UTA
11627,27,Home,W 88-76 ,240,34,72,0.472,32,60,0.533,2,12,0.167,18,22,0.818,88,30,73,0.411,23,47,0.489,7,26,0.269,9,15,0.6,76,2012-04-26,MEM,ORL
11628,28,Home,L 88-90 ,240,33,91,0.363,27,74,0.365,6,17,0.353,16,19,0.842,88,37,78,0.474,32,67,0.478,5,11,0.455,11,16,0.688,90,2012-10-31,TOR,IND
11629,29,Home,L 88-99 ,240,33,74,0.446,28,60,0.467,5,14,0.357,17,21,0.81,88,40,86,0.465,32,68,0.471,8,18,0.444,11,12,0.917,99,2012-11-02,BOS,MIL
11630,30,Home,W 88-86 ,240,37,81,0.457,32,67,0.478,5,14,0.357,9,14,0.643,88,35,85,0.412,25,57,0.439,10,28,0.357,6,12,0.5,86,2012-11-02,NOP,UTA
11631,31,Home,L 88-110 ,240,29,86,0.337,21,64,0.328,8,22,0.364,22,26,0.846,88,39,84,0.464,26,52,0.5,13,32,0.406,19,19,1.0,110,2012-11-05,PHI,NYK
11632,32,@,L 88-108 ,240,30,84,0.357,23,54,0.426,7,30,0.233,21,25,0.84,88,35,74,0.473,26,49,0.531,9,25,0.36,29,34,0.853,108,2012-11-06,TOR,OKC
11633,33,@,L 88-92 ,240,34,78,0.436,27,55,0.491,7,23,0.304,13,18,0.722,88,33,71,0.465,28,53,0.528,5,18,0.278,21,25,0.84,92,2012-11-14,ATL,GSW
11634,34,Home,L 88-97 ,240,34,79,0.43,29,61,0.475,5,18,0.278,15,21,0.714,88,38,71,0.535,30,52,0.577,8,19,0.421,13,19,0.684,97,2012-11-17,PHO,MIA
11635,35,Home,W 88-76 ,240,33,90,0.367,26,65,0.4,7,25,0.28,15,19,0.789,88,28,71,0.394,20,51,0.392,8,20,0.4,12,18,0.667,76,2012-11-18,NYK,IND
11636,36,Home,L 88-102 ,240,33,72,0.458,28,59,0.475,5,13,0.385,17,21,0.81,88,35,73,0.479,24,52,0.462,11,21,0.524,21,25,0.84,102,2012-11-28,MIL,NYK
11637,37,@,L 88-93 ,240,36,82,0.439,33,70,0.471,3,12,0.25,13,18,0.722,88,38,81,0.469,34,74,0.459,4,7,0.571,13,21,0.619,93,2012-12-01,PHI,CHI
11638,38,@,L 88-91 ,240,34,82,0.415,28,63,0.444,6,19,0.316,14,17,0.824,88,36,79,0.456,32,66,0.485,4,13,0.308,15,20,0.75,91,2012-12-01,BOS,MIL
11639,39,Home,L 88-105 ,240,35,83,0.422,30,63,0.476,5,20,0.25,13,23,0.565,88,41,77,0.532,28,52,0.538,13,25,0.52,10,17,0.588,105,2012-12-04,PHI,MIN
11640,40,Home,L 88-97 ,240,32,79,0.405,25,54,0.463,7,25,0.28,17,23,0.739,88,33,71,0.465,26,55,0.473,7,16,0.438,24,30,0.8,97,2012-12-09,BRK,MIL
11641,41,@,L 88-92 ,240,33,83,0.398,24,61,0.393,9,22,0.409,13,16,0.813,88,31,71,0.437,26,56,0.464,5,15,0.333,25,32,0.781,92,2012-12-12,NOP,OKC
11642,42,Home,L 88-94 ,240,37,75,0.493,33,57,0.579,4,18,0.222,10,17,0.588,88,29,64,0.453,19,45,0.422,10,19,0.526,26,35,0.743,94,2012-12-12,TOR,BRK
11643,43,@,W 88-77 ,240,35,72,0.486,28,48,0.583,7,24,0.292,11,16,0.688,88,32,83,0.386,29,70,0.414,3,13,0.231,10,15,0.667,77,2012-12-15,IND,DET
11644,44,@,L 88-103 ,240,38,81,0.469,32,65,0.492,6,16,0.375,6,8,0.75,88,38,81,0.469,26,56,0.464,12,25,0.48,15,20,0.75,103,2012-12-15,BOS,SAS
11645,45,@,W 88-76 ,240,35,78,0.449,30,56,0.536,5,22,0.227,13,17,0.765,88,29,71,0.408,22,51,0.431,7,20,0.35,11,19,0.579,76,2012-12-17,LAC,DET
11646,46,@,L 88-110 ,240,33,87,0.379,30,67,0.448,3,20,0.15,19,30,0.633,88,47,92,0.511,41,72,0.569,6,20,0.3,10,15,0.667,110,2012-12-22,CHA,DEN
11647,47,Home,L 88-123 ,240,36,81,0.444,31,63,0.492,5,18,0.278,11,22,0.5,88,46,82,0.561,31,55,0.564,15,27,0.556,16,21,0.762,123,2012-12-29,ORL,TOR
11648,48,Home,W 88-83 ,240,28,70,0.4,16,45,0.356,12,25,0.48,20,24,0.833,88,31,82,0.378,28,71,0.394,3,11,0.273,18,24,0.75,83,2012-12-31,IND,MEM
11649,49,@,L 88-95 ,240,33,73,0.452,27,52,0.519,6,21,0.286,16,20,0.8,88,40,83,0.482,35,70,0.5,5,13,0.385,10,12,0.833,95,2013-01-07,SAS,NOH
11650,50,Home,W 88-79 ,240,35,84,0.417,30,65,0.462,5,19,0.263,13,16,0.813,88,30,75,0.4,21,48,0.438,9,27,0.333,10,13,0.769,79,2013-01-09,NOP,HOU
11651,51,@,L 88-96 ,240,36,78,0.462,33,71,0.465,3,7,0.429,13,16,0.813,88,38,89,0.427,27,61,0.443,11,28,0.393,9,12,0.75,96,2013-01-12,CHA,IND
11652,52,@,L 88-106 ,240,33,89,0.371,29,73,0.397,4,16,0.25,18,23,0.783,88,45,80,0.563,37,59,0.627,8,21,0.381,8,11,0.727,106,2013-01-13,MIN,SAS
11653,53,@,L 88-104 ,240,34,95,0.358,27,67,0.403,7,28,0.25,13,22,0.591,88,42,84,0.5,32,55,0.582,10,29,0.345,10,18,0.556,104,2013-01-15,MIL,LAL
11654,54,Home,L 88-93 ,240,31,79,0.392,22,50,0.44,9,29,0.31,17,26,0.654,88,32,83,0.386,28,66,0.424,4,17,0.235,25,32,0.781,93,2013-01-16,POR,CLE
11655,55,@,L 88-95 ,240,36,84,0.429,32,68,0.471,4,16,0.25,12,14,0.857,88,36,80,0.45,31,58,0.534,5,22,0.227,18,20,0.9,95,2013-01-18,GSW,SAS
11656,56,@,L 88-103 ,240,33,83,0.398,29,68,0.426,4,15,0.267,18,25,0.72,88,36,78,0.462,27,59,0.458,9,19,0.474,22,31,0.71,103,2013-01-20,BOS,DET
11657,57,@,W 88-85 ,240,31,74,0.419,19,50,0.38,12,24,0.5,14,20,0.7,88,34,84,0.405,28,63,0.444,6,21,0.286,11,17,0.647,85,2013-01-21,BRK,NYK
11658,58,@,L 88-92 ,240,31,86,0.36,24,68,0.353,7,18,0.389,19,26,0.731,88,38,85,0.447,35,73,0.479,3,12,0.25,13,19,0.684,92,2013-01-23,WAS,UTA
11659,59,@,L 88-93 ,240,33,83,0.398,27,65,0.415,6,18,0.333,16,26,0.615,88,30,71,0.423,25,55,0.455,5,16,0.313,28,37,0.757,93,2013-01-24,LAC,PHO
11660,60,@,L 88-110 ,240,34,72,0.472,30,60,0.5,4,12,0.333,16,23,0.696,88,43,77,0.558,38,60,0.633,5,17,0.294,19,23,0.826,110,2013-01-25,DET,MIA
11661,61,Home,L 88-104 ,240,34,82,0.415,28,68,0.412,6,14,0.429,14,19,0.737,88,45,91,0.495,41,78,0.526,4,13,0.308,10,13,0.769,104,2013-01-30,MIL,CHI
11662,62,@,W 88-69 ,240,32,81,0.395,27,64,0.422,5,17,0.294,19,25,0.76,88,31,89,0.348,29,81,0.358,2,8,0.25,5,7,0.714,69,2013-02-06,IND,PHI
11663,63,@,L 88-105 ,240,34,69,0.493,30,53,0.566,4,16,0.25,16,25,0.64,88,41,79,0.519,35,66,0.53,6,13,0.462,17,22,0.773,105,2013-02-10,MIN,MEM
11664,64,Home,L 88-102 ,240,33,74,0.446,26,51,0.51,7,23,0.304,15,18,0.833,88,41,80,0.513,31,52,0.596,10,28,0.357,10,16,0.625,102,2013-02-10,NYK,LAC
11665,65,Home,L 88-92 ,240,28,79,0.354,19,54,0.352,9,25,0.36,23,32,0.719,88,31,73,0.425,22,52,0.423,9,21,0.429,21,24,0.875,92,2013-02-13,NYK,TOR
11666,66,Home,L 88-96 ,240,30,78,0.385,24,63,0.381,6,15,0.4,22,27,0.815,88,35,78,0.449,27,58,0.466,8,20,0.4,18,20,0.9,96,2013-02-19,WAS,TOR
11667,67,@,W 88-82 ,240,29,80,0.363,23,67,0.343,6,13,0.462,24,34,0.706,88,26,71,0.366,18,53,0.34,8,18,0.444,22,26,0.846,82,2013-02-20,MEM,TOR
11668,68,Home,W 88-82 ,240,34,76,0.447,31,60,0.517,3,16,0.188,17,29,0.586,88,35,84,0.417,30,69,0.435,5,15,0.333,7,9,0.778,82,2013-02-22,MEM,ORL
11669,69,Home,L 88-113 ,240,35,84,0.417,31,65,0.477,4,19,0.211,14,23,0.609,88,44,79,0.557,34,57,0.596,10,22,0.455,15,23,0.652,113,2013-02-22,PHO,BOS
11670,70,Home,L 88-96 ,240,31,74,0.419,24,58,0.414,7,16,0.438,19,29,0.655,88,35,81,0.432,27,53,0.509,8,28,0.286,18,21,0.857,96,2013-03-01,WAS,NYK
11671,71,@,L 88-104 ,240,36,89,0.404,29,65,0.446,7,24,0.292,9,11,0.818,88,46,86,0.535,41,71,0.577,5,15,0.333,7,9,0.778,104,2013-03-04,ATL,DEN
11672,72,@,L 88-89 ,240,37,81,0.457,35,71,0.493,2,10,0.2,12,18,0.667,88,30,81,0.37,26,64,0.406,4,17,0.235,25,30,0.833,89,2013-03-08,UTA,CHI
11673,73,Home,L 88-94 ,240,33,87,0.379,24,66,0.364,9,21,0.429,13,20,0.65,88,27,74,0.365,12,39,0.308,15,35,0.429,25,34,0.735,94,2013-03-08,GSW,HOU
11674,74,@,L 88-111 ,240,35,84,0.417,30,66,0.455,5,18,0.278,13,19,0.684,88,42,78,0.538,33,61,0.541,9,17,0.529,18,22,0.818,111,2013-03-09,MIN,DEN
11675,75,@,L 88-112 ,240,34,79,0.43,31,66,0.47,3,13,0.231,17,19,0.895,88,39,76,0.513,33,61,0.541,6,15,0.4,28,35,0.8,112,2013-03-13,TOR,BOS
11676,76,@,L 88-105 ,240,34,76,0.447,27,56,0.482,7,20,0.35,13,21,0.619,88,41,79,0.519,31,64,0.484,10,15,0.667,13,20,0.65,105,2013-03-16,CHA,BOS
11677,77,@,W 88-79 ,240,33,68,0.485,27,53,0.509,6,15,0.4,16,25,0.64,88,28,83,0.337,25,68,0.368,3,15,0.2,20,22,0.909,79,2013-03-20,WAS,PHO
11678,78,Home,L 88-107 ,240,35,78,0.449,31,61,0.508,4,17,0.235,14,20,0.7,88,40,81,0.494,30,60,0.5,10,21,0.476,17,20,0.85,107,2013-03-27,TOR,ATL
11679,79,@,L 88-103 ,240,34,76,0.447,28,60,0.467,6,16,0.375,14,19,0.737,88,44,85,0.518,38,70,0.543,6,15,0.4,9,13,0.692,103,2013-03-27,PHO,UTA
11680,80,@,L 88-97 ,240,34,87,0.391,30,74,0.405,4,13,0.308,16,27,0.593,88,34,78,0.436,28,57,0.491,6,21,0.286,23,31,0.742,97,2013-03-30,ORL,ATL
11681,81,@,W 88-86 ,240,33,71,0.465,21,43,0.488,12,28,0.429,10,15,0.667,88,35,79,0.443,28,55,0.509,7,24,0.292,9,16,0.563,86,2013-03-31,MIA,SAS
11682,82,Home,W 88-83 ,240,35,81,0.432,31,67,0.463,4,14,0.286,14,16,0.875,88,33,94,0.351,29,78,0.372,4,16,0.25,13,16,0.813,83,2013-04-03,CHA,PHI
11683,83,@,L 88-98 ,240,33,83,0.398,29,68,0.426,4,15,0.267,18,23,0.783,88,36,78,0.462,29,59,0.492,7,19,0.368,19,22,0.864,98,2013-04-03,NOP,GSW
11684,84,Home,W 88-78 ,240,30,66,0.455,29,58,0.5,1,8,0.125,27,36,0.75,88,26,80,0.325,21,61,0.344,5,19,0.263,21,29,0.724,78,2013-04-03,TOR,WAS
11685,85,@,L 88-100 ,240,33,83,0.398,25,62,0.403,8,21,0.381,14,17,0.824,88,38,82,0.463,26,58,0.448,12,24,0.5,12,13,0.923,100,2013-04-04,SAS,OKC
11686,86,@,L 88-97 ,240,34,77,0.442,25,59,0.424,9,18,0.5,11,14,0.786,88,34,72,0.472,32,64,0.5,2,8,0.25,27,33,0.818,97,2013-04-12,CHI,TOR
11687,87,Home,L 88-120 ,240,35,83,0.422,30,69,0.435,5,14,0.357,13,15,0.867,88,48,81,0.593,38,65,0.585,10,16,0.625,14,19,0.737,120,2013-04-13,ORL,BOS
11688,88,Home,L 88-99 ,240,35,82,0.427,29,70,0.414,6,12,0.5,12,14,0.857,88,40,93,0.43,31,72,0.431,9,21,0.429,10,13,0.769,99,2013-04-17,POR,GSW
11689,89,@,L 88-90 ,240,34,79,0.43,29,64,0.453,5,15,0.333,15,17,0.882,88,33,81,0.407,25,60,0.417,8,21,0.381,16,23,0.696,90,2013-10-30,DEN,SAC
11690,90,@,L 88-95 ,240,33,70,0.471,26,50,0.52,7,20,0.35,15,18,0.833,88,36,74,0.486,31,59,0.525,5,15,0.333,18,22,0.818,95,2013-11-04,BOS,MEM
11691,91,@,L 88-104 ,240,31,82,0.378,27,64,0.422,4,18,0.222,22,30,0.733,88,40,78,0.513,36,67,0.537,4,11,0.364,20,32,0.625,104,2013-11-05,UTA,BRK
11692,92,@,L 88-102 ,240,35,77,0.455,27,60,0.45,8,17,0.471,10,16,0.625,88,41,80,0.513,32,59,0.542,9,21,0.429,11,14,0.786,102,2013-11-16,UTA,GSW
11693,93,@,L 88-106 ,240,34,86,0.395,29,68,0.426,5,18,0.278,15,18,0.833,88,40,94,0.426,33,71,0.465,7,23,0.304,19,22,0.864,106,2013-11-16,BOS,MIN
11694,94,@,L 88-104 ,240,33,74,0.446,22,50,0.44,11,24,0.458,11,15,0.733,88,41,81,0.506,31,60,0.517,10,21,0.476,12,19,0.632,104,2013-11-19,ATL,MIA
11695,95,@,W 88-81 (OT),265,34,88,0.386,31,76,0.408,3,12,0.25,17,19,0.895,88,36,82,0.439,31,64,0.484,5,18,0.278,4,8,0.5,81,2013-11-20,MEM,GSW
11696,96,@,L 88-96 ,240,36,86,0.419,30,69,0.435,6,17,0.353,10,13,0.769,88,37,78,0.474,32,60,0.533,5,18,0.278,17,23,0.739,96,2013-11-22,WAS,TOR
11697,97,@,L 88-94 ,240,36,92,0.391,29,65,0.446,7,27,0.259,9,14,0.643,88,39,84,0.464,35,69,0.507,4,15,0.267,12,15,0.8,94,2013-11-27,SAS,OKC
11698,98,Home,W 88-87 ,240,31,73,0.425,28,58,0.483,3,15,0.2,23,30,0.767,88,29,77,0.377,20,53,0.377,9,24,0.375,20,21,0.952,87,2013-11-29,ATL,DAL
11699,99,Home,L 88-97 ,240,36,77,0.468,29,62,0.468,7,15,0.467,9,12,0.75,88,34,73,0.466,25,55,0.455,9,18,0.5,20,26,0.769,97,2013-11-30,MEM,BRK
11700,0,@,L 88-98 ,240,36,92,0.391,30,69,0.435,6,23,0.261,10,13,0.769,88,37,91,0.407,32,77,0.416,5,14,0.357,19,24,0.792,98,2013-12-04,DEN,CLE
11701,1,Home,L 88-97 ,240,31,88,0.352,22,57,0.386,9,31,0.29,17,19,0.895,88,36,79,0.456,25,55,0.455,11,24,0.458,14,19,0.737,97,2013-12-04,HOU,PHO
11702,2,@,L 88-105 ,240,37,92,0.402,31,65,0.477,6,27,0.222,8,13,0.615,88,42,91,0.462,38,70,0.543,4,21,0.19,17,25,0.68,105,2013-12-06,PHI,CHA
11703,3,Home,W 88-82 ,240,31,83,0.373,27,69,0.391,4,14,0.286,22,30,0.733,88,28,87,0.322,21,52,0.404,7,35,0.2,19,26,0.731,82,2013-12-07,CLE,LAC
11704,4,@,L 88-98 ,240,32,93,0.344,24,64,0.375,8,29,0.276,16,28,0.571,88,32,76,0.421,22,43,0.512,10,33,0.303,24,42,0.571,98,2013-12-08,ORL,HOU
11705,5,Home,L 88-96 ,240,33,80,0.413,27,63,0.429,6,17,0.353,16,19,0.842,88,34,76,0.447,28,59,0.475,6,17,0.353,22,34,0.647,96,2013-12-11,BOS,LAC
11706,6,@,W 88-85 ,240,30,77,0.39,23,57,0.404,7,20,0.35,21,23,0.913,88,39,89,0.438,37,76,0.487,2,13,0.154,5,8,0.625,85,2013-12-14,LAL,CHA
11707,7,@,W 88-85 ,240,32,83,0.386,22,62,0.355,10,21,0.476,14,18,0.778,88,36,83,0.434,34,71,0.479,2,12,0.167,11,16,0.688,85,2013-12-21,UTA,CHA
11708,8,Home,L 88-107 ,240,31,85,0.365,24,65,0.369,7,20,0.35,19,26,0.731,88,41,85,0.482,29,54,0.537,12,31,0.387,13,22,0.591,107,2013-12-30,LAC,PHO
11709,9,Home,L 88-101 ,240,34,82,0.415,30,70,0.429,4,12,0.333,16,17,0.941,88,40,79,0.506,29,57,0.509,11,22,0.5,10,13,0.769,101,2014-01-03,WAS,TOR
11710,10,@,L 88-107 ,240,36,77,0.468,33,68,0.485,3,9,0.333,13,17,0.765,88,40,78,0.513,31,51,0.608,9,27,0.333,18,23,0.783,107,2014-01-07,NOP,MIA
11711,11,@,L 88-101 ,240,30,85,0.353,24,61,0.393,6,24,0.25,22,27,0.815,88,37,90,0.411,23,59,0.39,14,31,0.452,13,18,0.722,101,2014-01-09,OKC,DEN
11712,12,Home,L 88-102 ,240,34,79,0.43,25,58,0.431,9,21,0.429,11,19,0.579,88,39,75,0.52,32,57,0.561,7,18,0.389,17,28,0.607,102,2014-01-13,CHI,WAS
11713,13,@,L 88-107 ,240,34,76,0.447,27,52,0.519,7,24,0.292,13,16,0.813,88,40,79,0.506,27,52,0.519,13,27,0.481,14,15,0.933,107,2014-01-13,ORL,DAL
11714,14,Home,W 88-83 ,240,29,84,0.345,25,67,0.373,4,17,0.235,26,36,0.722,88,30,78,0.385,19,54,0.352,11,24,0.458,12,25,0.48,83,2014-01-15,BOS,TOR
11715,15,@,W 88-87 ,240,36,78,0.462,32,71,0.451,4,7,0.571,12,16,0.75,88,32,79,0.405,18,45,0.4,14,34,0.412,9,14,0.643,87,2014-01-24,MEM,HOU
11716,16,@,L 88-103 ,240,28,83,0.337,22,62,0.355,6,21,0.286,26,33,0.788,88,38,91,0.418,28,66,0.424,10,25,0.4,17,21,0.81,103,2014-01-26,POR,GSW
11717,17,@,W 88-85 ,240,34,90,0.378,24,68,0.353,10,22,0.455,10,15,0.667,88,30,80,0.375,23,57,0.404,7,23,0.304,18,23,0.783,85,2014-01-28,WAS,GSW
11718,18,@,L 88-114 ,240,32,82,0.39,26,60,0.433,6,22,0.273,18,24,0.75,88,44,82,0.537,34,62,0.548,10,20,0.5,16,23,0.696,114,2014-01-28,BOS,NYK
11719,19,Home,W 88-77 ,240,33,82,0.402,29,62,0.468,4,20,0.2,18,25,0.72,88,29,82,0.354,27,61,0.443,2,21,0.095,17,23,0.739,77,2014-01-29,MIN,NOP
11720,20,Home,W 88-79 ,240,38,80,0.475,34,71,0.479,4,9,0.444,8,10,0.8,88,27,70,0.386,24,54,0.444,3,16,0.188,22,33,0.667,79,2014-02-01,NOP,CHI
11721,21,@,L 88-114 ,240,31,79,0.392,25,58,0.431,6,21,0.286,20,26,0.769,88,42,74,0.568,34,61,0.557,8,13,0.615,22,26,0.846,114,2014-03-03,UTA,MIL
11722,22,Home,L 88-108 ,240,30,76,0.395,23,50,0.46,7,26,0.269,21,26,0.808,88,46,98,0.469,41,70,0.586,5,28,0.179,11,12,0.917,108,2014-03-05,BOS,GSW
11723,23,@,L 88-95 (OT),265,30,74,0.405,23,54,0.426,7,20,0.35,21,22,0.955,88,38,90,0.422,31,71,0.437,7,19,0.368,12,17,0.706,95,2014-03-09,MIA,CHI
11724,24,Home,L 88-90 ,240,31,75,0.413,27,57,0.474,4,18,0.222,22,22,1.0,88,32,74,0.432,28,56,0.5,4,18,0.222,22,27,0.815,90,2014-03-12,NOP,MEM
11725,25,@,L 88-89 ,240,31,79,0.392,24,62,0.387,7,17,0.412,19,24,0.792,88,29,75,0.387,18,48,0.375,11,27,0.407,20,26,0.769,89,2014-03-22,ORL,UTA
11726,26,@,L 88-112 ,240,35,87,0.402,27,62,0.435,8,25,0.32,10,16,0.625,88,40,88,0.455,26,55,0.473,14,33,0.424,18,23,0.783,112,2014-03-28,NYK,PHO
11727,27,@,W 88-67 ,240,32,74,0.432,25,51,0.49,7,23,0.304,17,21,0.81,88,27,79,0.342,23,65,0.354,4,14,0.286,9,14,0.643,67,2014-03-29,MIA,MIL
11728,28,@,L 88-102 ,240,40,95,0.421,36,84,0.429,4,11,0.364,4,6,0.667,88,43,81,0.531,38,65,0.585,5,16,0.313,11,16,0.688,102,2014-04-02,MEM,MIN
11729,29,Home,L 88-107 ,240,32,78,0.41,27,58,0.466,5,20,0.25,19,30,0.633,88,41,73,0.562,29,46,0.63,12,27,0.444,13,17,0.765,107,2014-04-06,IND,ATL
11730,30,@,W 88-87 ,240,36,68,0.529,27,45,0.6,9,23,0.391,7,14,0.5,88,33,69,0.478,26,45,0.578,7,24,0.292,14,19,0.737,87,2014-04-08,BRK,MIA
11731,31,Home,L 88-94 ,240,34,80,0.425,28,66,0.424,6,14,0.429,14,17,0.824,88,39,80,0.488,30,61,0.492,9,19,0.474,7,10,0.7,94,2014-04-09,NOP,PHO
11732,32,Home,L 88-94 (OT),265,37,82,0.451,36,67,0.537,1,15,0.067,13,20,0.65,88,35,92,0.38,24,67,0.358,11,25,0.44,13,15,0.867,94,2014-04-09,WAS,CHA
11733,33,Home,L 88-93 ,240,34,80,0.425,28,58,0.483,6,22,0.273,14,25,0.56,88,36,79,0.456,35,60,0.583,1,19,0.053,20,21,0.952,93,2014-04-11,BRK,ATL
11734,34,@,L 88-97 ,240,35,74,0.473,27,54,0.5,8,20,0.4,10,14,0.714,88,34,73,0.466,22,44,0.5,12,29,0.414,17,23,0.739,97,2014-04-13,ORL,BRK
11735,35,@,L 88-100 ,240,34,65,0.523,28,44,0.636,6,21,0.286,14,25,0.56,88,32,81,0.395,24,50,0.48,8,31,0.258,28,33,0.848,100,2014-11-04,OKC,TOR
11736,36,@,L 88-120 ,240,33,87,0.379,23,53,0.434,10,34,0.294,12,18,0.667,88,43,76,0.566,36,59,0.61,7,17,0.412,27,30,0.9,120,2014-11-09,PHI,TOR
11737,37,Home,W 88-87 ,240,29,78,0.372,22,44,0.5,7,34,0.206,23,37,0.622,88,34,80,0.425,27,59,0.458,7,21,0.333,12,18,0.667,87,2014-11-14,HOU,PHI
11738,38,@,L 88-95 ,240,34,82,0.415,24,56,0.429,10,26,0.385,10,17,0.588,88,32,86,0.372,28,71,0.394,4,15,0.267,27,33,0.818,95,2014-11-15,DET,MEM
11739,39,@,W 88-86 ,240,37,75,0.493,33,60,0.55,4,15,0.267,10,13,0.769,88,33,87,0.379,26,62,0.419,7,25,0.28,13,19,0.684,86,2014-11-19,PHO,DET
11740,40,Home,W 88-86 ,240,35,78,0.449,33,63,0.524,2,15,0.133,16,24,0.667,88,37,86,0.43,32,72,0.444,5,14,0.357,7,12,0.583,86,2014-11-19,IND,CHO
11741,41,@,L 88-103 ,240,36,84,0.429,31,65,0.477,5,19,0.263,11,16,0.688,88,38,74,0.514,34,68,0.5,4,6,0.667,23,27,0.852,103,2014-11-20,CHI,SAC
11742,42,@,L 88-101 ,240,35,82,0.427,29,65,0.446,6,17,0.353,12,19,0.632,88,41,82,0.5,35,59,0.593,6,23,0.261,13,19,0.684,101,2014-11-21,UTA,GSW
11743,43,Home,L 88-94 ,240,37,95,0.389,32,72,0.444,5,23,0.217,9,12,0.75,88,37,86,0.43,30,67,0.448,7,19,0.368,13,15,0.867,94,2014-11-23,BOS,POR
11744,44,Home,L 88-104 ,240,34,83,0.41,28,60,0.467,6,23,0.261,14,25,0.56,88,39,77,0.506,26,48,0.542,13,29,0.448,13,16,0.813,104,2014-11-28,DET,MIL
11745,45,Home,W 88-82 ,240,33,83,0.398,29,62,0.468,4,21,0.19,18,23,0.783,88,36,91,0.396,31,73,0.425,5,18,0.278,5,8,0.625,82,2014-12-04,POR,IND
11746,46,Home,L 88-110 ,240,36,81,0.444,32,62,0.516,4,19,0.211,12,19,0.632,88,43,90,0.478,34,65,0.523,9,25,0.36,15,22,0.682,110,2014-12-08,BRK,CLE
11747,47,Home,W 88-70 ,240,36,81,0.444,31,61,0.508,5,20,0.25,11,17,0.647,88,22,69,0.319,11,41,0.268,11,28,0.393,15,20,0.75,70,2014-12-12,BRK,PHI
11748,48,@,L 88-112 ,240,34,99,0.343,27,68,0.397,7,31,0.226,13,18,0.722,88,39,80,0.488,35,62,0.565,4,18,0.222,30,34,0.882,112,2014-12-14,PHO,OKC
11749,49,@,L 88-97 ,240,38,83,0.458,33,67,0.493,5,16,0.313,7,14,0.5,88,38,83,0.458,29,59,0.492,9,24,0.375,12,17,0.706,97,2014-12-15,CHA,CLE
11750,50,Home,L 88-114 ,240,30,85,0.353,27,70,0.386,3,15,0.2,25,28,0.893,88,48,90,0.533,39,65,0.6,9,25,0.36,9,15,0.6,114,2014-12-20,NOP,POR
11751,51,Home,L 88-96 ,240,35,84,0.417,28,61,0.459,7,23,0.304,11,20,0.55,88,35,82,0.427,29,59,0.492,6,23,0.261,20,25,0.8,96,2014-12-21,ORL,PHI
11752,52,Home,W 88-71 ,240,30,84,0.357,26,61,0.426,4,23,0.174,24,28,0.857,88,24,74,0.324,19,48,0.396,5,26,0.192,18,28,0.643,71,2014-12-27,UTA,PHI
11753,53,@,L 88-101 ,240,32,79,0.405,26,55,0.473,6,24,0.25,18,24,0.75,88,45,90,0.5,40,77,0.519,5,13,0.385,6,10,0.6,101,2014-12-27,BOS,WAS
11754,54,Home,W 88-87 ,240,27,71,0.38,21,53,0.396,6,18,0.333,28,30,0.933,88,33,90,0.367,25,62,0.403,8,28,0.286,13,18,0.722,87,2015-01-04,LAL,IND
11755,55,Home,W 88-84 ,240,31,67,0.463,26,53,0.491,5,14,0.357,21,28,0.75,88,34,86,0.395,27,62,0.435,7,24,0.292,9,13,0.692,84,2015-01-04,MIA,BRK
11756,56,Home,L 88-96 (OT),265,33,84,0.393,30,59,0.508,3,25,0.12,19,23,0.826,88,37,94,0.394,27,67,0.403,10,27,0.37,12,19,0.632,96,2015-01-05,BRK,DAL
11757,57,Home,L 88-90 ,240,33,73,0.452,30,57,0.526,3,16,0.188,19,27,0.704,88,36,79,0.456,28,62,0.452,8,17,0.471,10,17,0.588,90,2015-01-09,BRK,PHI
11758,58,@,L 88-95 ,240,33,89,0.371,24,58,0.414,9,31,0.29,13,18,0.722,88,37,82,0.451,29,61,0.475,8,21,0.381,13,14,0.929,95,2015-01-31,POR,MIL
11759,59,Home,L 88-92 ,240,33,81,0.407,27,66,0.409,6,15,0.4,16,19,0.842,88,37,79,0.468,33,64,0.516,4,15,0.267,14,19,0.737,92,2015-02-02,WAS,CHO
11760,60,@,L 88-92 ,240,34,89,0.382,28,65,0.431,6,24,0.25,14,17,0.824,88,37,74,0.5,34,63,0.54,3,11,0.273,15,22,0.682,92,2015-02-06,NYK,BRK
11761,61,@,L 88-98 ,240,33,85,0.388,28,63,0.444,5,22,0.227,17,22,0.773,88,37,82,0.451,33,58,0.569,4,24,0.167,20,26,0.769,98,2015-02-06,DEN,DET
11762,62,@,L 88-94 ,240,33,80,0.413,21,50,0.42,12,30,0.4,10,11,0.909,88,36,92,0.391,33,79,0.418,3,13,0.231,19,21,0.905,94,2015-02-08,ATL,MEM
11763,63,@,L 88-89 ,240,33,78,0.423,26,49,0.531,7,29,0.241,15,23,0.652,88,30,93,0.323,20,62,0.323,10,31,0.323,19,20,0.95,89,2015-02-11,ATL,BOS
11764,64,@,L 88-104 ,240,31,75,0.413,20,50,0.4,11,25,0.44,15,19,0.789,88,44,82,0.537,39,67,0.582,5,15,0.333,11,16,0.688,104,2015-02-25,PHI,MIL
11765,65,@,L 88-95 ,240,36,80,0.45,27,54,0.5,9,26,0.346,7,13,0.538,88,36,81,0.444,22,50,0.44,14,31,0.452,9,12,0.75,95,2015-02-27,ORL,ATL
11766,66,Home,W 88-85 ,240,37,90,0.411,35,78,0.449,2,12,0.167,12,16,0.75,88,38,93,0.409,36,79,0.456,2,14,0.143,7,9,0.778,85,2015-03-04,NOP,DET
11767,67,Home,L 88-95 ,240,38,76,0.5,30,61,0.492,8,15,0.533,4,11,0.364,88,34,72,0.472,24,50,0.48,10,22,0.455,17,21,0.81,95,2015-03-08,BRK,UTA
11768,68,@,L 88-95 ,240,34,80,0.425,28,60,0.467,6,20,0.3,14,28,0.5,88,37,86,0.43,27,60,0.45,10,26,0.385,11,20,0.55,95,2015-03-13,ORL,BOS
11769,69,Home,W 88-85 ,240,33,69,0.478,27,55,0.491,6,14,0.429,16,24,0.667,88,32,84,0.381,24,61,0.393,8,23,0.348,13,22,0.591,85,2015-03-14,UTA,DET
11770,70,@,W 88-84 ,240,33,63,0.524,27,52,0.519,6,11,0.545,16,23,0.696,88,34,82,0.415,30,60,0.5,4,22,0.182,12,24,0.5,84,2015-03-18,WAS,UTA
11771,71,@,L 88-89 ,240,33,75,0.44,25,56,0.446,8,19,0.421,14,18,0.778,88,36,87,0.414,32,70,0.457,4,17,0.235,13,17,0.765,89,2015-03-24,MIA,MIL
11772,72,Home,L 88-91 ,240,36,91,0.396,33,79,0.418,3,12,0.25,13,20,0.65,88,39,91,0.429,36,77,0.468,3,14,0.214,10,11,0.909,91,2015-03-25,CHA,BRK
11773,73,@,L 88-102 ,240,35,79,0.443,28,64,0.438,7,15,0.467,11,18,0.611,88,43,84,0.512,34,64,0.531,9,20,0.45,7,12,0.583,102,2015-03-27,SAC,NOP
11774,74,@,L 88-110 ,240,32,75,0.427,30,63,0.476,2,12,0.167,22,24,0.917,88,43,75,0.573,37,62,0.597,6,13,0.462,18,24,0.75,110,2015-03-29,MIN,NOP
11775,75,@,L 88-101 ,240,34,75,0.453,30,58,0.517,4,17,0.235,16,23,0.696,88,36,79,0.456,27,50,0.54,9,29,0.31,20,24,0.833,101,2015-03-30,MIL,ATL
11776,76,@,L 88-114 ,240,32,75,0.427,25,54,0.463,7,21,0.333,17,21,0.81,88,40,80,0.5,25,45,0.556,15,35,0.429,19,25,0.76,114,2015-04-02,MIA,CLE
11777,77,Home,W 88-82 ,240,33,85,0.388,29,68,0.426,4,17,0.235,18,21,0.857,88,32,74,0.432,26,55,0.473,6,19,0.316,12,15,0.8,82,2015-04-03,CHI,DET
11778,78,Home,L 88-113 ,240,34,84,0.405,29,65,0.446,5,19,0.263,15,28,0.536,88,47,89,0.528,37,65,0.569,10,24,0.417,9,13,0.692,113,2015-04-07,OKC,SAS
11779,79,Home,L 88-89 ,240,31,71,0.437,20,48,0.417,11,23,0.478,15,22,0.682,88,36,76,0.474,31,61,0.508,5,15,0.333,12,19,0.632,89,2015-04-10,UTA,MEM
11780,80,Home,L 88-100 ,240,31,78,0.397,27,64,0.422,4,14,0.286,22,28,0.786,88,37,84,0.44,31,63,0.492,6,21,0.286,20,24,0.833,100,2015-04-13,MIN,NOP
11781,81,@,L 88-101 ,240,38,79,0.481,31,59,0.525,7,20,0.35,5,13,0.385,88,39,80,0.488,30,56,0.536,9,24,0.375,14,23,0.609,101,2015-04-15,ORL,BRK
11782,82,@,W 88-87 ,240,33,84,0.393,26,56,0.464,7,28,0.25,15,25,0.6,88,37,100,0.37,32,74,0.432,5,26,0.192,8,12,0.667,87,2015-10-28,WAS,ORL
11783,83,@,L 88-104 ,240,35,97,0.361,29,67,0.433,6,30,0.2,12,15,0.8,88,38,87,0.437,30,56,0.536,8,31,0.258,20,33,0.606,104,2015-10-29,DAL,LAC
11784,84,Home,L 88-111 ,240,35,100,0.35,30,75,0.4,5,25,0.2,13,23,0.565,88,41,96,0.427,31,71,0.437,10,25,0.4,19,23,0.826,111,2015-11-09,PHI,CHI
11785,85,Home,L 88-106 ,240,34,84,0.405,27,65,0.415,7,19,0.368,13,19,0.684,88,46,87,0.529,40,64,0.625,6,23,0.261,8,11,0.727,106,2015-11-09,SAC,SAS
11786,86,@,L 88-101 ,240,34,77,0.442,23,55,0.418,11,22,0.5,9,12,0.75,88,38,84,0.452,33,64,0.516,5,20,0.25,20,27,0.741,101,2015-11-10,LAL,MIA
11787,87,@,L 88-90 ,240,33,76,0.434,21,47,0.447,12,29,0.414,10,14,0.714,88,37,84,0.44,28,64,0.438,9,20,0.45,7,13,0.538,90,2015-11-17,ATL,BRK
11788,88,@,L 88-113 ,240,32,79,0.405,24,53,0.453,8,26,0.308,16,22,0.727,88,40,81,0.494,28,56,0.5,12,25,0.48,21,22,0.955,113,2015-11-20,PHI,CHO
11789,89,@,L 88-109 ,240,31,91,0.341,25,63,0.397,6,28,0.214,20,24,0.833,88,43,83,0.518,34,70,0.486,9,13,0.692,14,17,0.824,109,2015-11-23,DET,MIL
11790,90,Home,L 88-93 ,240,31,88,0.352,25,66,0.379,6,22,0.273,20,27,0.741,88,33,86,0.384,26,68,0.382,7,18,0.389,20,23,0.87,93,2015-11-24,POR,CHI
11791,91,Home,W 88-83 ,240,33,81,0.407,25,53,0.472,8,28,0.286,14,19,0.737,88,34,83,0.41,28,61,0.459,6,22,0.273,9,12,0.75,83,2015-11-25,SAS,DAL
11792,92,@,L 88-90 ,240,33,81,0.407,29,64,0.453,4,17,0.235,18,24,0.75,88,35,87,0.402,26,60,0.433,9,27,0.333,11,17,0.647,90,2015-11-28,BRK,CLE
11793,93,@,L 88-108 ,240,37,87,0.425,31,61,0.508,6,26,0.231,8,13,0.615,88,40,85,0.471,31,68,0.456,9,17,0.529,19,20,0.95,108,2015-11-28,ATL,SAS
11794,94,@,L 88-90 ,240,33,85,0.388,25,52,0.481,8,33,0.242,14,18,0.778,88,30,73,0.411,26,60,0.433,4,13,0.308,26,33,0.788,90,2015-12-07,POR,MIL
11795,95,Home,L 88-125 ,240,33,81,0.407,30,67,0.448,3,14,0.214,19,22,0.864,88,47,84,0.56,34,58,0.586,13,26,0.5,18,23,0.783,125,2015-12-08,MEM,OKC
11796,96,Home,L 88-100 ,240,33,84,0.393,25,51,0.49,8,33,0.242,14,15,0.933,88,40,89,0.449,33,73,0.452,7,16,0.438,13,15,0.867,100,2015-12-14,ATL,MIA
11797,97,@,L 88-97 ,240,30,80,0.375,24,63,0.381,6,17,0.353,22,24,0.917,88,34,78,0.436,24,49,0.49,10,29,0.345,19,21,0.905,97,2015-12-18,MEM,DAL
11798,98,@,L 88-104 ,240,26,71,0.366,22,49,0.449,4,22,0.182,32,38,0.842,88,44,84,0.524,38,68,0.559,6,16,0.375,10,17,0.588,104,2015-12-18,NOP,PHO
11799,99,@,L 88-97 ,240,31,79,0.392,25,51,0.49,6,28,0.214,20,25,0.8,88,34,73,0.466,24,48,0.5,10,25,0.4,19,25,0.76,97,2015-12-18,DEN,UTA
11800,0,Home,W 88-84 ,240,32,74,0.432,25,59,0.424,7,15,0.467,17,26,0.654,88,36,88,0.409,31,68,0.456,5,20,0.25,7,8,0.875,84,2015-12-25,HOU,SAS
11801,1,@,L 88-94 (OT),265,36,90,0.4,30,70,0.429,6,20,0.3,10,11,0.909,88,35,88,0.398,29,62,0.468,6,26,0.231,18,27,0.667,94,2015-12-25,NOP,MIA
11802,2,Home,L 88-102 ,240,35,75,0.467,31,63,0.492,4,12,0.333,14,18,0.778,88,40,80,0.5,31,54,0.574,9,26,0.346,13,14,0.929,102,2015-12-26,MIN,IND
11803,3,Home,L 88-109 ,240,29,91,0.319,24,70,0.343,5,21,0.238,25,30,0.833,88,40,86,0.465,27,55,0.491,13,31,0.419,16,21,0.762,109,2016-01-05,LAL,GSW
11804,4,Home,L 88-97 ,240,33,84,0.393,25,59,0.424,8,25,0.32,14,15,0.933,88,34,75,0.453,29,61,0.475,5,14,0.357,24,26,0.923,97,2016-01-08,WAS,TOR
11805,5,@,L 88-100 ,240,32,80,0.4,29,67,0.433,3,13,0.231,21,30,0.7,88,39,84,0.464,32,60,0.533,7,24,0.292,15,18,0.833,100,2016-01-10,MIL,NYK
11806,6,@,L 88-91 ,240,35,84,0.417,27,51,0.529,8,33,0.242,10,15,0.667,88,33,92,0.359,26,68,0.382,7,24,0.292,18,24,0.75,91,2016-01-21,ATL,SAC
11807,7,Home,L 88-116 ,240,33,85,0.388,29,67,0.433,4,18,0.222,18,20,0.9,88,43,76,0.566,30,53,0.566,13,23,0.565,17,24,0.708,116,2016-01-22,NYK,LAC
11808,8,Home,L 88-96 ,240,34,79,0.43,26,53,0.491,8,26,0.308,12,13,0.923,88,37,80,0.463,29,55,0.527,8,25,0.32,14,21,0.667,96,2016-02-22,CLE,DET
11809,9,@,L 88-103 ,240,32,88,0.364,27,68,0.397,5,20,0.25,19,22,0.864,88,37,89,0.416,30,55,0.545,7,34,0.206,22,24,0.917,103,2016-02-26,CHI,ATL
11810,10,@,L 88-94 ,240,32,75,0.427,27,56,0.482,5,19,0.263,19,29,0.655,88,37,81,0.457,33,63,0.524,4,18,0.222,16,19,0.842,94,2016-03-04,UTA,MEM
11811,11,@,W 88-80 ,240,35,88,0.398,28,63,0.444,7,25,0.28,11,14,0.786,88,32,91,0.352,28,72,0.389,4,19,0.211,12,15,0.8,80,2016-03-20,SAC,NYK
11812,12,@,L 88-91 ,240,37,86,0.43,33,69,0.478,4,17,0.235,10,13,0.769,88,35,87,0.402,27,68,0.397,8,19,0.421,13,19,0.684,91,2016-03-21,SAS,CHO
11813,13,@,L 88-112 ,240,37,77,0.481,30,63,0.476,7,14,0.5,7,12,0.583,88,42,81,0.519,34,67,0.507,8,14,0.571,20,24,0.833,112,2016-03-23,MIA,SAS
11814,14,Home,L 88-101 ,240,33,87,0.379,26,59,0.441,7,28,0.25,15,17,0.882,88,39,72,0.542,32,54,0.593,7,18,0.389,16,29,0.552,101,2016-03-27,LAL,WAS
11815,15,Home,L 88-97 ,240,31,70,0.443,22,46,0.478,9,24,0.375,17,19,0.895,88,36,88,0.409,25,56,0.446,11,32,0.344,14,15,0.933,97,2016-03-28,DEN,DAL
11816,16,Home,W 88-82 ,240,33,87,0.379,29,68,0.426,4,19,0.211,18,20,0.9,88,31,82,0.378,25,61,0.41,6,21,0.286,14,22,0.636,82,2016-03-29,DET,OKC
11817,17,@,W 88-78 ,240,32,83,0.386,18,43,0.419,14,40,0.35,10,17,0.588,88,29,71,0.408,25,50,0.5,4,21,0.19,16,18,0.889,78,2016-04-03,DAL,MIN
11818,18,@,W 88-86 ,240,32,72,0.444,25,55,0.455,7,17,0.412,17,19,0.895,88,32,68,0.471,27,51,0.529,5,17,0.294,17,21,0.81,86,2016-04-05,SAS,UTA
11819,19,Home,W 88-86 ,240,33,80,0.413,23,47,0.489,10,33,0.303,12,14,0.857,88,34,78,0.436,28,58,0.483,6,20,0.3,12,18,0.667,86,2016-04-06,DAL,HOU
11820,20,@,L 88-98 ,240,38,88,0.432,36,69,0.522,2,19,0.105,10,12,0.833,88,37,86,0.43,32,72,0.444,5,14,0.357,19,22,0.864,98,2016-04-13,MIA,BOS
11821,21,@,L 88-117 ,240,32,87,0.368,23,60,0.383,9,27,0.333,15,20,0.75,88,45,94,0.479,32,59,0.542,13,35,0.371,14,19,0.737,117,2016-10-25,NYK,CLE
11822,22,Home,W 88-75 ,240,34,83,0.41,28,56,0.5,6,27,0.222,14,20,0.7,88,29,73,0.397,22,54,0.407,7,19,0.368,10,13,0.769,75,2016-10-30,LAC,UTA
11823,23,Home,L 88-118 ,240,33,96,0.344,28,65,0.431,5,31,0.161,17,21,0.81,88,45,89,0.506,34,62,0.548,11,27,0.407,17,18,0.944,118,2016-10-31,BRK,CHI
11824,24,Home,L 88-99 ,240,31,84,0.369,22,58,0.379,9,26,0.346,17,22,0.773,88,32,85,0.376,24,58,0.414,8,27,0.296,27,33,0.818,99,2016-11-04,MEM,LAC
11825,25,Home,W 88-86 ,240,31,78,0.397,22,50,0.44,9,28,0.321,17,27,0.63,88,34,86,0.395,28,69,0.406,6,17,0.353,12,17,0.706,86,2016-11-05,ORL,WAS
11826,26,@,L 88-104 ,240,33,88,0.375,28,61,0.459,5,27,0.185,17,22,0.773,88,43,92,0.467,38,76,0.5,5,16,0.313,13,16,0.813,104,2016-11-14,OKC,DET
11827,27,@,L 88-115 ,240,34,90,0.378,29,68,0.426,5,22,0.227,15,17,0.882,88,44,91,0.484,27,51,0.529,17,40,0.425,10,17,0.588,115,2016-11-14,PHI,HOU
11828,28,Home,W 88-69 ,240,35,90,0.389,27,65,0.415,8,25,0.32,10,10,1.0,88,27,84,0.321,22,59,0.373,5,25,0.2,10,13,0.769,69,2016-11-14,IND,ORL
11829,29,Home,L 88-113 ,240,34,95,0.358,25,61,0.41,9,34,0.265,11,18,0.611,88,41,98,0.418,34,78,0.436,7,20,0.35,24,28,0.857,113,2016-11-15,POR,CHI
11830,30,Home,L 88-104 ,240,31,83,0.373,20,51,0.392,11,32,0.344,15,19,0.789,88,44,90,0.489,35,62,0.565,9,28,0.321,7,12,0.583,104,2016-11-18,BOS,GSW
11831,31,@,L 88-106 ,240,37,82,0.451,36,63,0.571,1,19,0.053,13,17,0.765,88,42,83,0.506,34,60,0.567,8,23,0.348,14,26,0.538,106,2016-11-26,DET,OKC
11832,32,@,L 88-105 ,240,37,87,0.425,32,57,0.561,5,30,0.167,9,18,0.5,88,38,88,0.432,30,57,0.526,8,31,0.258,21,25,0.84,105,2016-11-29,LAL,NOP
11833,33,Home,L 88-105 ,240,36,95,0.379,27,63,0.429,9,32,0.281,7,10,0.7,88,37,78,0.474,24,52,0.462,13,26,0.5,18,26,0.692,105,2016-12-02,PHI,ORL
11834,34,Home,W 88-86 ,240,31,87,0.356,25,67,0.373,6,20,0.3,20,30,0.667,88,25,82,0.305,18,54,0.333,7,28,0.25,29,40,0.725,86,2016-12-08,MEM,POR
11835,35,Home,L 88-99 ,240,33,84,0.393,26,59,0.441,7,25,0.28,15,22,0.682,88,39,91,0.429,27,51,0.529,12,40,0.3,9,13,0.692,99,2016-12-08,NOP,PHI
11836,36,@,L 88-109 ,240,34,91,0.374,25,57,0.439,9,34,0.265,11,14,0.786,88,41,85,0.482,32,63,0.508,9,22,0.409,18,23,0.783,109,2016-12-09,ORL,CHO
11837,37,@,L 88-96 ,240,32,98,0.327,24,68,0.353,8,30,0.267,16,19,0.842,88,34,78,0.436,25,50,0.5,9,28,0.321,19,26,0.731,96,2016-12-16,CHA,BOS
11838,38,Home,L 88-90 ,240,34,74,0.459,21,45,0.467,13,29,0.448,7,11,0.636,88,37,87,0.425,30,58,0.517,7,29,0.241,9,15,0.6,90,2016-12-23,LAC,DAL
11839,39,@,L 88-114 ,240,31,75,0.413,23,45,0.511,8,30,0.267,18,21,0.857,88,37,78,0.474,27,49,0.551,10,29,0.345,30,35,0.857,114,2016-12-31,LAC,OKC
11840,40,Home,W 88-79 ,240,34,78,0.436,25,54,0.463,9,24,0.375,11,14,0.786,88,28,72,0.389,19,49,0.388,9,23,0.391,14,23,0.609,79,2017-01-08,MEM,UTA
11841,41,@,L 88-96 ,240,36,84,0.429,32,70,0.457,4,14,0.286,12,13,0.923,88,33,81,0.407,27,55,0.491,6,26,0.231,24,28,0.857,96,2017-01-26,LAL,UTA
11842,42,Home,L 88-100 ,240,33,79,0.418,30,66,0.455,3,13,0.231,19,25,0.76,88,41,89,0.461,32,65,0.492,9,24,0.375,9,11,0.818,100,2017-01-27,CHI,MIA
11843,43,Home,L 88-98 ,240,31,77,0.403,25,53,0.472,6,24,0.25,20,28,0.714,88,33,69,0.478,24,49,0.49,9,20,0.45,23,26,0.885,98,2017-02-01,ORL,IND
11844,44,@,L 88-104 ,240,32,73,0.438,23,50,0.46,9,23,0.391,15,25,0.6,88,36,78,0.462,25,49,0.51,11,29,0.379,21,27,0.778,104,2017-02-01,MIL,UTA
11845,45,Home,L 88-106 ,240,33,71,0.465,27,56,0.482,6,15,0.4,16,28,0.571,88,41,86,0.477,30,53,0.566,11,33,0.333,13,18,0.722,106,2017-02-08,MIL,MIA
11846,46,@,W 88-72 ,240,36,81,0.444,27,56,0.482,9,25,0.36,7,11,0.636,88,28,87,0.322,24,64,0.375,4,23,0.174,12,18,0.667,72,2017-02-13,LAC,UTA
11847,47,@,L 88-111 ,240,32,79,0.405,23,57,0.404,9,22,0.409,15,20,0.75,88,42,81,0.519,31,59,0.525,11,22,0.5,16,23,0.696,111,2017-02-15,POR,UTA
11848,48,Home,L 88-102 ,240,36,82,0.439,30,65,0.462,6,17,0.353,10,15,0.667,88,40,95,0.421,32,72,0.444,8,23,0.348,14,20,0.7,102,2017-02-27,SAC,MIN
11849,49,@,L 88-100 ,240,37,81,0.457,25,51,0.49,12,30,0.4,2,3,0.667,88,35,86,0.407,24,55,0.436,11,31,0.355,19,21,0.905,100,2017-03-06,IND,CHO
11850,50,Home,W 88-83 ,240,33,81,0.407,23,54,0.426,10,27,0.37,12,15,0.8,88,30,84,0.357,20,51,0.392,10,33,0.303,13,18,0.722,83,2017-03-06,UTA,NOP
11851,51,Home,L 87-88 ,240,36,76,0.474,32,60,0.533,4,16,0.25,11,20,0.55,87,36,89,0.404,29,74,0.392,7,15,0.467,9,14,0.643,88,2011-12-25,LAL,CHI
11852,52,@,L 87-100 ,240,31,77,0.403,26,58,0.448,5,19,0.263,20,26,0.769,87,39,80,0.488,34,64,0.531,5,16,0.313,17,20,0.85,100,2012-01-02,OKC,DAL
11853,53,@,W 87-74 ,240,32,80,0.4,24,66,0.364,8,14,0.571,15,18,0.833,87,26,66,0.394,21,52,0.404,5,14,0.357,17,24,0.708,74,2012-01-06,IND,BOS
11854,54,Home,L 87-98 ,240,31,79,0.392,27,59,0.458,4,20,0.2,21,31,0.677,87,37,80,0.463,29,63,0.46,8,17,0.471,16,22,0.727,98,2012-01-06,MIN,CLE
11855,55,Home,L 87-88 ,240,29,70,0.414,22,51,0.431,7,19,0.368,22,24,0.917,87,32,81,0.395,28,65,0.431,4,16,0.25,20,28,0.714,88,2012-01-07,GSW,UTA
11856,56,@,L 87-91 ,240,34,82,0.415,27,63,0.429,7,19,0.368,12,15,0.8,87,30,79,0.38,29,69,0.42,1,10,0.1,30,40,0.75,91,2012-01-09,CHA,NYK
11857,57,@,L 87-97 ,240,27,80,0.338,20,56,0.357,7,24,0.292,26,33,0.788,87,34,77,0.442,31,58,0.534,3,19,0.158,26,28,0.929,97,2012-01-09,MIN,TOR
11858,58,Home,L 87-90 (OT),265,36,93,0.387,32,79,0.405,4,14,0.286,11,16,0.688,87,35,82,0.427,31,73,0.425,4,9,0.444,16,19,0.842,90,2012-01-11,UTA,LAL
11859,59,@,W 87-80 ,240,24,70,0.343,18,45,0.4,6,25,0.24,33,38,0.868,87,34,90,0.378,30,74,0.405,4,16,0.25,8,16,0.5,80,2012-01-13,MIN,NOH
11860,60,Home,L 87-93 ,240,34,70,0.486,29,58,0.5,5,12,0.417,14,16,0.875,87,36,73,0.493,30,59,0.508,6,14,0.429,15,17,0.882,93,2012-01-18,NOP,MEM
11861,61,@,L 87-98 ,240,34,81,0.42,28,61,0.459,6,20,0.3,13,16,0.813,87,38,85,0.447,29,67,0.433,9,18,0.5,13,18,0.722,98,2012-01-19,LAL,MIA
11862,62,@,L 87-97 ,240,37,79,0.468,32,65,0.492,5,14,0.357,8,15,0.533,87,38,86,0.442,31,59,0.525,7,27,0.259,14,15,0.933,97,2012-01-22,CHA,NJN
11863,63,Home,W 87-56 ,240,33,78,0.423,31,65,0.477,2,13,0.154,19,19,1.0,87,16,65,0.246,12,49,0.245,4,16,0.25,20,30,0.667,56,2012-01-23,BOS,ORL
11864,64,@,L 87-93 ,240,31,83,0.373,25,63,0.397,6,20,0.3,19,22,0.864,87,33,81,0.407,25,56,0.446,8,25,0.32,19,29,0.655,93,2012-01-23,PHO,DAL
11865,65,@,L 87-94 ,240,28,80,0.35,27,61,0.443,1,19,0.053,30,31,0.968,87,38,83,0.458,32,69,0.464,6,14,0.429,12,14,0.857,94,2012-01-27,IND,BOS
11866,66,Home,W 87-79 ,240,36,82,0.439,34,73,0.466,2,9,0.222,13,18,0.722,87,31,75,0.413,24,59,0.407,7,16,0.438,10,11,0.909,79,2012-01-27,MIN,SAS
11867,67,Home,L 87-88 ,240,36,69,0.522,31,58,0.534,5,11,0.455,10,14,0.714,87,34,79,0.43,31,66,0.47,3,13,0.231,17,20,0.85,88,2012-01-29,BOS,CLE
11868,68,Home,L 87-98 ,240,35,83,0.422,29,67,0.433,6,16,0.375,11,13,0.846,87,37,87,0.425,25,62,0.403,12,25,0.48,12,16,0.75,98,2012-02-03,DAL,IND
11869,69,Home,L 87-98 ,240,32,74,0.432,27,59,0.458,5,15,0.333,18,27,0.667,87,44,88,0.5,40,79,0.506,4,9,0.444,6,9,0.667,98,2012-02-04,ATL,PHI
11870,70,@,L 87-89 ,240,34,72,0.472,30,60,0.5,4,12,0.333,15,18,0.833,87,35,78,0.449,33,68,0.485,2,10,0.2,17,23,0.739,89,2012-02-04,NOP,DET
11871,71,@,L 87-96 ,240,29,75,0.387,25,61,0.41,4,14,0.286,25,30,0.833,87,39,87,0.448,35,75,0.467,4,12,0.333,14,20,0.7,96,2012-02-04,LAL,UTA
11872,72,Home,L 87-108 ,240,32,79,0.405,29,62,0.468,3,17,0.176,20,26,0.769,87,40,72,0.556,31,57,0.544,9,15,0.6,19,23,0.826,108,2012-02-06,BRK,CHI
11873,73,@,L 87-97 ,240,33,75,0.44,28,61,0.459,5,14,0.357,16,23,0.696,87,35,76,0.461,26,55,0.473,9,21,0.429,18,24,0.75,97,2012-02-08,IND,ATL
11874,74,Home,L 87-88 (OT),265,38,97,0.392,32,78,0.41,6,19,0.316,5,5,1.0,87,36,91,0.396,35,76,0.461,1,15,0.067,15,20,0.75,88,2012-02-09,BOS,LAL
11875,75,Home,L 87-89 (OT),265,35,83,0.422,26,59,0.441,9,24,0.375,8,14,0.571,87,36,82,0.439,30,65,0.462,6,17,0.353,11,18,0.611,89,2012-02-10,ORL,ATL
11876,76,Home,L 87-101 ,240,38,80,0.475,35,71,0.493,3,9,0.333,8,13,0.615,87,35,74,0.473,31,54,0.574,4,20,0.2,27,32,0.844,101,2012-02-10,UTA,OKC
11877,77,Home,L 87-107 ,240,35,90,0.389,24,63,0.381,11,27,0.407,6,7,0.857,87,38,83,0.458,33,71,0.465,5,12,0.417,26,31,0.839,107,2012-02-12,ATL,MIA
11878,78,Home,L 87-90 ,240,37,73,0.507,33,58,0.569,4,15,0.267,9,15,0.6,87,33,80,0.413,27,63,0.429,6,17,0.353,18,27,0.667,90,2012-02-14,TOR,NYK
11879,79,@,L 87-98 ,240,32,87,0.368,27,71,0.38,5,16,0.313,18,27,0.667,87,36,77,0.468,26,50,0.52,10,27,0.37,16,23,0.696,98,2012-02-15,IND,CLE
11880,80,@,L 87-103 ,240,36,85,0.424,30,67,0.448,6,18,0.333,9,12,0.75,87,40,75,0.533,25,50,0.5,15,25,0.6,8,13,0.615,103,2012-02-15,PHI,ORL
11881,81,Home,L 87-111 ,240,30,76,0.395,24,60,0.4,6,16,0.375,21,31,0.677,87,40,79,0.506,26,58,0.448,14,21,0.667,17,20,0.85,111,2012-02-17,CLE,MIA
11882,82,@,L 87-110 ,240,31,89,0.348,24,66,0.364,7,23,0.304,18,21,0.857,87,39,74,0.527,29,50,0.58,10,24,0.417,22,27,0.815,110,2012-02-17,GSW,OKC
11883,83,@,L 87-93 ,240,33,82,0.402,33,73,0.452,0,9,0.0,21,27,0.778,87,36,78,0.462,31,60,0.517,5,18,0.278,16,20,0.8,93,2012-02-22,PHI,HOU
11884,84,@,L 87-111 ,240,28,75,0.373,18,52,0.346,10,23,0.435,21,26,0.808,87,40,74,0.541,30,49,0.612,10,25,0.4,21,25,0.84,111,2012-03-10,DAL,GSW
11885,85,@,L 87-107 ,240,33,81,0.407,29,69,0.42,4,12,0.333,17,19,0.895,87,45,84,0.536,39,75,0.52,6,9,0.667,11,17,0.647,107,2012-03-14,CHA,HOU
11886,86,Home,L 87-91 ,240,39,85,0.459,35,69,0.507,4,16,0.25,5,12,0.417,87,32,78,0.41,23,54,0.426,9,24,0.375,18,23,0.783,91,2012-03-15,LAC,PHO
11887,87,Home,L 87-103 ,240,33,84,0.393,28,64,0.438,5,20,0.25,16,20,0.8,87,43,85,0.506,35,67,0.522,8,18,0.444,9,12,0.75,103,2012-03-18,CLE,ATL
11888,88,Home,W 87-83 (OT),265,35,87,0.402,31,67,0.463,4,20,0.2,13,19,0.684,87,31,81,0.383,29,65,0.446,2,16,0.125,19,23,0.826,83,2012-03-18,LAC,DET
11889,89,@,L 87-106 ,240,33,69,0.478,31,56,0.554,2,13,0.154,19,22,0.864,87,39,81,0.481,34,65,0.523,5,16,0.313,23,33,0.697,106,2012-03-20,TOR,NYK
11890,90,Home,L 87-116 ,240,29,82,0.354,22,58,0.379,7,24,0.292,22,26,0.846,87,48,83,0.578,37,62,0.597,11,21,0.524,9,13,0.692,116,2012-03-20,POR,MIL
11891,91,@,L 87-104 ,240,31,81,0.383,20,55,0.364,11,26,0.423,14,17,0.824,87,43,88,0.489,34,63,0.54,9,25,0.36,9,11,0.818,104,2012-03-23,DAL,SAS
11892,92,@,L 87-103 ,240,33,71,0.465,26,49,0.531,7,22,0.318,14,14,1.0,87,39,74,0.527,33,63,0.524,6,11,0.545,19,23,0.826,103,2012-03-25,MIA,OKC
11893,93,@,L 87-90 ,240,32,74,0.432,25,52,0.481,7,22,0.318,16,17,0.941,87,31,85,0.365,21,55,0.382,10,30,0.333,18,27,0.667,90,2012-03-25,GSW,POR
11894,94,@,W 87-75 ,240,35,83,0.422,28,68,0.412,7,15,0.467,10,16,0.625,87,30,87,0.345,25,70,0.357,5,17,0.294,10,12,0.833,75,2012-03-28,DET,CLE
11895,95,Home,L 87-102 ,240,33,74,0.446,23,46,0.5,10,28,0.357,11,15,0.733,87,43,79,0.544,36,68,0.529,7,11,0.636,9,14,0.643,102,2012-03-28,GSW,NOH
11896,96,@,L 87-91 ,240,34,85,0.4,28,67,0.418,6,18,0.333,13,15,0.867,87,39,81,0.481,32,59,0.542,7,22,0.318,6,6,1.0,91,2012-04-03,BRK,LAL
11897,97,@,L 87-92 ,240,31,77,0.403,27,65,0.415,4,12,0.333,21,30,0.7,87,35,76,0.461,28,58,0.483,7,18,0.389,15,22,0.682,92,2012-04-03,CHA,TOR
11898,98,@,W 87-86 ,240,36,86,0.419,29,58,0.5,7,28,0.25,8,11,0.727,87,38,83,0.458,34,73,0.466,4,10,0.4,6,13,0.462,86,2012-04-04,SAS,BOS
11899,99,Home,L 87-104 ,240,30,70,0.429,23,56,0.411,7,14,0.5,20,37,0.541,87,42,93,0.452,33,71,0.465,9,22,0.409,11,13,0.846,104,2012-04-08,SAC,HOU
11900,0,@,W 87-84 ,240,34,89,0.382,30,71,0.423,4,18,0.222,15,19,0.789,87,32,84,0.381,28,70,0.4,4,14,0.286,16,22,0.727,84,2012-04-16,WAS,CHI
11901,1,Home,L 87-109 ,240,35,79,0.443,31,70,0.443,4,9,0.444,13,16,0.813,87,39,80,0.488,33,59,0.559,6,21,0.286,25,36,0.694,109,2012-04-16,TOR,ATL
11902,2,Home,L 87-103 ,240,36,79,0.456,31,65,0.477,5,14,0.357,10,16,0.625,87,43,82,0.524,34,67,0.507,9,15,0.6,8,10,0.8,103,2012-04-18,CLE,PHI
11903,3,Home,L 87-99 ,240,38,90,0.422,34,71,0.479,4,19,0.211,7,10,0.7,87,37,79,0.468,33,63,0.524,4,16,0.25,21,28,0.75,99,2012-04-18,GSW,LAL
11904,4,Home,L 87-105 ,240,31,72,0.431,27,58,0.466,4,14,0.286,21,23,0.913,87,43,80,0.538,38,66,0.576,5,14,0.357,14,17,0.824,105,2012-04-23,BRK,PHI
11905,5,Home,L 87-92 ,240,35,80,0.438,29,66,0.439,6,14,0.429,11,16,0.688,87,38,81,0.469,32,64,0.5,6,17,0.353,10,10,1.0,92,2012-04-25,IND,CHI
11906,6,Home,W 87-74 ,240,35,87,0.402,27,63,0.429,8,24,0.333,9,11,0.818,87,29,78,0.372,27,69,0.391,2,9,0.222,14,23,0.609,74,2012-04-26,BOS,MIL
11907,7,@,L 87-93 ,240,34,84,0.405,28,67,0.418,6,17,0.353,13,16,0.813,87,33,79,0.418,31,70,0.443,2,9,0.222,25,33,0.758,93,2012-10-31,SAC,CHI
11908,8,@,W 87-85 ,240,33,86,0.384,28,69,0.406,5,17,0.294,16,23,0.696,87,32,80,0.4,28,59,0.475,4,21,0.19,17,22,0.773,85,2012-10-31,GSW,PHO
11909,9,Home,L 87-93 ,240,31,84,0.369,23,51,0.451,8,33,0.242,17,23,0.739,87,37,82,0.451,30,64,0.469,7,18,0.389,12,21,0.571,93,2012-11-07,HOU,DEN
11910,10,Home,W 87-80 ,240,34,80,0.425,28,67,0.418,6,13,0.462,13,16,0.813,87,33,85,0.388,30,72,0.417,3,13,0.231,11,15,0.733,80,2012-11-10,CHI,MIN
11911,11,Home,L 87-95 ,240,30,83,0.361,24,60,0.4,6,23,0.261,21,26,0.808,87,35,79,0.443,28,61,0.459,7,18,0.389,18,22,0.818,95,2012-11-12,POR,ATL
11912,12,Home,L 87-89 ,240,31,81,0.383,26,62,0.419,5,19,0.263,20,37,0.541,87,38,84,0.452,34,68,0.5,4,16,0.25,9,14,0.643,89,2012-11-14,MIN,CHA
11913,13,Home,L 87-94 ,240,32,85,0.376,28,72,0.389,4,13,0.308,19,28,0.679,87,31,80,0.388,29,66,0.439,2,14,0.143,30,34,0.882,94,2012-11-17,CHA,MEM
11914,14,Home,L 87-92 ,240,29,82,0.354,23,62,0.371,6,20,0.3,23,28,0.821,87,40,85,0.471,39,73,0.534,1,12,0.083,11,19,0.579,92,2012-11-19,SAS,LAC
11915,15,@,L 87-114 ,240,31,77,0.403,26,58,0.448,5,19,0.263,20,26,0.769,87,46,77,0.597,39,60,0.65,7,17,0.412,15,18,0.833,114,2012-11-21,POR,PHO
11916,16,@,L 87-108 ,240,35,78,0.449,30,60,0.5,5,18,0.278,12,21,0.571,87,43,81,0.531,31,52,0.596,12,29,0.414,10,15,0.667,108,2012-11-30,WAS,NYK
11917,17,Home,L 87-103 ,240,35,85,0.412,28,66,0.424,7,19,0.368,10,18,0.556,87,37,80,0.463,24,52,0.462,13,28,0.464,16,22,0.727,103,2012-12-05,NOP,LAL
11918,18,Home,W 87-81 ,240,32,77,0.416,31,67,0.463,1,10,0.1,22,27,0.815,87,34,77,0.442,33,62,0.532,1,15,0.067,12,17,0.706,81,2012-12-05,UTA,ORL
11919,19,Home,L 87-96 ,240,29,77,0.377,25,56,0.446,4,21,0.19,25,32,0.781,87,36,88,0.409,28,69,0.406,8,19,0.421,16,20,0.8,96,2012-12-22,WAS,DET
11920,20,@,W 87-84 ,240,33,81,0.407,24,50,0.48,9,31,0.29,12,15,0.8,87,32,84,0.381,25,56,0.446,7,28,0.25,13,17,0.765,84,2012-12-26,HOU,MIN
11921,21,@,W 87-84 ,240,31,82,0.378,21,55,0.382,10,27,0.37,15,23,0.652,87,35,76,0.461,31,58,0.534,4,18,0.222,10,14,0.714,84,2012-12-26,CLE,WAS
11922,22,@,L 87-104 ,240,36,87,0.414,33,68,0.485,3,19,0.158,12,16,0.75,87,40,86,0.465,33,62,0.532,7,24,0.292,17,28,0.607,104,2012-12-28,POR,LAL
11923,23,Home,W 87-77 ,240,34,87,0.391,27,71,0.38,7,16,0.438,12,18,0.667,87,31,85,0.365,28,75,0.373,3,10,0.3,12,18,0.667,77,2012-12-29,CHI,WAS
11924,24,@,W 87-80 ,240,40,89,0.449,39,80,0.488,1,9,0.111,6,9,0.667,87,34,75,0.453,30,60,0.5,4,15,0.267,8,11,0.727,80,2013-01-04,UTA,PHO
11925,25,Home,W 87-77 ,240,33,91,0.363,24,69,0.348,9,22,0.409,12,19,0.632,87,28,68,0.412,20,49,0.408,8,19,0.421,13,18,0.722,77,2013-01-08,IND,MIA
11926,26,Home,W 87-79 ,240,37,81,0.457,34,67,0.507,3,14,0.214,10,12,0.833,87,33,84,0.393,31,72,0.431,2,12,0.167,11,18,0.611,79,2013-01-09,BOS,PHO
11927,27,Home,L 87-94 ,240,33,71,0.465,26,54,0.481,7,17,0.412,14,20,0.7,87,40,88,0.455,38,71,0.535,2,17,0.118,12,16,0.75,94,2013-01-09,GSW,MEM
11928,28,Home,L 87-103 ,240,36,91,0.396,35,75,0.467,1,16,0.063,14,19,0.737,87,39,90,0.433,31,68,0.456,8,22,0.364,17,25,0.68,103,2013-01-11,MIL,DET
11929,29,Home,L 87-90 ,240,34,65,0.523,28,49,0.571,6,16,0.375,13,21,0.619,87,36,71,0.507,31,61,0.508,5,10,0.5,13,18,0.722,90,2013-01-12,DET,UTA
11930,30,@,L 87-100 ,240,33,82,0.402,29,59,0.492,4,23,0.174,17,22,0.773,87,35,81,0.432,24,51,0.471,11,30,0.367,19,25,0.76,100,2013-01-13,NOP,NYK
11931,31,@,W 87-83 ,240,32,71,0.451,26,48,0.542,6,23,0.261,17,22,0.773,87,31,86,0.36,25,65,0.385,6,21,0.286,15,18,0.833,83,2013-01-13,OKC,POR
11932,32,Home,L 87-102 ,240,35,79,0.443,29,62,0.468,6,17,0.353,11,22,0.5,87,33,72,0.458,22,41,0.537,11,31,0.355,25,31,0.806,102,2013-01-17,DET,NYK
11933,33,@,L 87-94 ,240,32,77,0.416,24,57,0.421,8,20,0.4,15,27,0.556,87,34,93,0.366,29,72,0.403,5,21,0.238,21,31,0.677,94,2013-01-19,WAS,LAC
11934,34,@,L 87-103 ,240,27,78,0.346,23,59,0.39,4,19,0.211,29,33,0.879,87,41,88,0.466,32,68,0.471,9,20,0.45,12,18,0.667,103,2013-01-25,GSW,CHI
11935,35,Home,W 87-76 ,240,39,93,0.419,37,77,0.481,2,16,0.125,7,10,0.7,87,27,88,0.307,25,72,0.347,2,16,0.125,20,23,0.87,76,2013-02-09,PHI,CHA
11936,36,Home,L 87-96 ,240,35,84,0.417,31,67,0.463,4,17,0.235,13,20,0.65,87,39,84,0.464,34,71,0.479,5,13,0.385,13,17,0.765,96,2013-02-19,NOP,CHI
11937,37,@,L 87-94 ,240,31,81,0.383,27,68,0.397,4,13,0.308,21,32,0.656,87,28,70,0.4,23,57,0.404,5,13,0.385,33,44,0.75,94,2013-02-20,PHI,MIN
11938,38,Home,L 87-97 ,240,30,81,0.37,27,72,0.375,3,9,0.333,24,33,0.727,87,32,72,0.444,27,55,0.491,5,17,0.294,28,35,0.8,97,2013-02-24,PHO,SAS
11939,39,@,L 87-92 ,240,31,73,0.425,23,50,0.46,8,23,0.348,17,22,0.773,87,36,81,0.444,26,59,0.441,10,22,0.455,10,12,0.833,92,2013-03-01,ATL,PHO
11940,40,@,L 87-90 ,240,33,85,0.388,27,66,0.409,6,19,0.316,15,20,0.75,87,34,80,0.425,28,65,0.431,6,15,0.4,16,21,0.762,90,2013-03-03,PHI,WAS
11941,41,@,W 87-77 ,240,31,75,0.413,18,40,0.45,13,35,0.371,12,15,0.8,87,32,74,0.432,25,54,0.463,7,20,0.35,6,10,0.6,77,2013-03-06,NYK,DET
11942,42,Home,W 87-83 ,240,27,75,0.36,19,52,0.365,8,23,0.348,25,29,0.862,87,33,83,0.398,25,59,0.424,8,24,0.333,9,12,0.75,83,2013-03-06,GSW,SAC
11943,43,Home,W 87-82 ,240,31,76,0.408,27,62,0.435,4,14,0.286,21,31,0.677,87,29,65,0.446,23,46,0.5,6,19,0.316,18,22,0.818,82,2013-03-06,MIN,WAS
11944,44,@,L 87-104 ,240,32,79,0.405,27,64,0.422,5,15,0.333,18,23,0.783,87,35,70,0.5,25,52,0.481,10,18,0.556,24,32,0.75,104,2013-03-09,CHA,WAS
11945,45,@,L 87-110 ,240,28,80,0.35,23,65,0.354,5,15,0.333,26,33,0.788,87,37,69,0.536,30,53,0.566,7,16,0.438,29,33,0.879,110,2013-03-13,UTA,OKC
11946,46,Home,W 87-80 ,240,35,77,0.455,34,65,0.523,1,12,0.083,16,22,0.727,87,30,85,0.353,26,73,0.356,4,12,0.333,16,19,0.842,80,2013-03-15,DEN,MEM
11947,47,@,L 87-96 ,240,35,80,0.438,32,61,0.525,3,19,0.158,14,19,0.737,87,36,72,0.5,27,52,0.519,9,20,0.45,15,19,0.789,96,2013-03-15,NOP,WAS
11948,48,Home,W 87-86 ,240,31,71,0.437,26,55,0.473,5,16,0.313,20,26,0.769,87,33,72,0.458,29,58,0.5,4,14,0.286,16,17,0.941,86,2013-03-20,NOP,BOS
11949,49,Home,W 87-84 ,240,35,81,0.432,32,70,0.457,3,11,0.273,14,22,0.636,87,30,78,0.385,25,64,0.391,5,14,0.357,19,24,0.792,84,2013-03-23,CHI,IND
11950,50,Home,L 87-97 ,240,37,86,0.43,33,68,0.485,4,18,0.222,9,15,0.6,87,42,86,0.488,35,68,0.515,7,18,0.389,6,10,0.6,97,2013-03-29,CLE,PHI
11951,51,@,L 87-109 ,240,32,79,0.405,27,59,0.458,5,20,0.25,18,36,0.5,87,42,74,0.568,38,60,0.633,4,14,0.286,21,31,0.677,109,2013-03-29,BRK,DEN
11952,52,Home,W 87-86 ,240,33,82,0.402,25,62,0.403,8,20,0.4,13,14,0.929,87,34,80,0.425,30,70,0.429,4,10,0.4,14,17,0.824,86,2013-04-05,CHI,ORL
11953,53,@,L 87-106 ,240,33,82,0.402,27,62,0.435,6,20,0.3,15,20,0.75,87,40,83,0.482,26,58,0.448,14,25,0.56,12,14,0.857,106,2013-04-06,PHI,MIA
11954,54,Home,L 87-89 ,240,29,81,0.358,22,56,0.393,7,25,0.28,22,28,0.786,87,32,73,0.438,29,66,0.439,3,7,0.429,22,29,0.759,89,2013-04-07,SAC,MEM
11955,55,Home,L 87-91 ,240,34,83,0.41,28,70,0.4,6,13,0.462,13,20,0.65,87,37,80,0.463,31,64,0.484,6,16,0.375,11,18,0.611,91,2013-04-13,MEM,LAC
11956,56,@,L 87-93 ,240,34,84,0.405,26,54,0.481,8,30,0.267,11,19,0.579,87,36,82,0.439,30,67,0.448,6,15,0.4,15,21,0.714,93,2013-04-14,BRK,TOR
11957,57,@,L 87-99 ,240,31,84,0.369,27,73,0.37,4,11,0.364,21,28,0.75,87,42,82,0.512,36,66,0.545,6,16,0.375,9,11,0.818,99,2013-04-17,NOP,DAL
11958,58,@,L 87-97 ,240,36,93,0.387,27,74,0.365,9,19,0.474,6,10,0.6,87,34,71,0.479,27,54,0.5,7,17,0.412,22,32,0.688,97,2013-10-29,ORL,IND
11959,59,@,L 87-93 ,240,32,66,0.485,29,53,0.547,3,13,0.231,20,29,0.69,87,38,86,0.442,33,69,0.478,5,17,0.294,12,23,0.522,93,2013-10-30,BOS,TOR
11960,60,Home,W 87-84 ,240,31,83,0.373,25,61,0.41,6,22,0.273,19,24,0.792,87,31,85,0.365,26,68,0.382,5,17,0.294,17,27,0.63,84,2013-11-01,PHO,UTA
11961,61,@,L 87-98 ,240,30,87,0.345,24,61,0.393,6,26,0.231,21,24,0.875,87,39,76,0.513,28,49,0.571,11,27,0.407,9,12,0.75,98,2013-11-02,SAC,GSW
11962,62,Home,W 87-77 ,240,34,76,0.447,32,63,0.508,2,13,0.154,17,29,0.586,87,31,74,0.419,28,58,0.483,3,16,0.188,12,12,1.0,77,2013-11-03,DET,BOS
11963,63,@,L 87-97 ,240,37,80,0.463,36,70,0.514,1,10,0.1,12,18,0.667,87,40,89,0.449,33,69,0.478,7,20,0.35,10,14,0.714,97,2013-11-06,UTA,BOS
11964,64,Home,L 87-103 ,240,35,82,0.427,29,61,0.475,6,21,0.286,11,17,0.647,87,31,67,0.463,23,52,0.442,8,15,0.533,33,39,0.846,103,2013-11-13,MEM,TOR
11965,65,Home,L 87-98 ,240,32,81,0.395,25,66,0.379,7,15,0.467,16,19,0.842,87,32,79,0.405,20,57,0.351,12,22,0.545,22,30,0.733,98,2013-11-18,UTA,GSW
11966,66,@,L 87-97 ,240,38,98,0.388,35,88,0.398,3,10,0.3,8,14,0.571,87,38,84,0.452,29,63,0.46,9,21,0.429,12,22,0.545,97,2013-11-21,CHI,DEN
11967,67,Home,L 87-94 ,240,36,93,0.387,31,73,0.425,5,20,0.25,10,12,0.833,87,33,72,0.458,29,56,0.518,4,16,0.25,24,31,0.774,94,2013-11-23,ATL,BOS
11968,68,@,L 87-88 ,240,29,77,0.377,20,53,0.377,9,24,0.375,20,21,0.952,87,31,73,0.425,28,58,0.483,3,15,0.2,23,30,0.767,88,2013-11-29,DAL,ATL
11969,69,Home,L 87-111 ,240,30,75,0.4,28,59,0.475,2,16,0.125,25,34,0.735,87,43,85,0.506,36,67,0.537,7,18,0.389,18,28,0.643,111,2013-12-03,BRK,DEN
11970,70,@,L 87-107 ,240,32,77,0.416,26,55,0.473,6,22,0.273,17,24,0.708,87,37,74,0.5,27,55,0.491,10,19,0.526,23,32,0.719,107,2013-12-05,MIA,CHI
11971,71,@,L 87-95 ,240,30,80,0.375,26,65,0.4,4,15,0.267,23,28,0.821,87,35,78,0.449,27,61,0.443,8,17,0.471,17,24,0.708,95,2013-12-17,SAC,CHA
11972,72,Home,L 87-95 ,240,33,79,0.418,27,57,0.474,6,22,0.273,15,23,0.652,87,39,82,0.476,38,73,0.521,1,9,0.111,16,19,0.842,95,2013-12-21,NYK,MEM
11973,73,@,W 87-78 ,240,30,78,0.385,24,54,0.444,6,24,0.25,21,23,0.913,87,33,88,0.375,28,64,0.438,5,24,0.208,7,10,0.7,78,2014-01-01,DAL,WAS
11974,74,Home,W 87-81 (OT),265,33,96,0.344,29,77,0.377,4,19,0.211,17,24,0.708,87,32,84,0.381,25,59,0.424,7,25,0.28,10,18,0.556,81,2014-01-02,CLE,ORL
11975,75,@,L 87-96 ,240,36,76,0.474,32,54,0.593,4,22,0.182,11,14,0.786,87,36,81,0.444,29,65,0.446,7,16,0.438,17,17,1.0,96,2014-01-02,MIL,UTA
11976,76,@,L 87-92 ,240,33,82,0.402,27,59,0.458,6,23,0.261,15,19,0.789,87,36,82,0.439,30,68,0.441,6,14,0.429,14,23,0.609,92,2014-01-07,PHO,CHI
11977,77,@,L 87-97 ,240,35,87,0.402,26,60,0.433,9,27,0.333,8,9,0.889,87,34,75,0.453,24,52,0.462,10,23,0.435,19,22,0.864,97,2014-01-08,IND,ATL
11978,78,@,L 87-123 ,240,29,84,0.345,25,68,0.368,4,16,0.25,25,28,0.893,87,45,92,0.489,38,69,0.551,7,23,0.304,26,35,0.743,123,2014-01-10,LAL,LAC
11979,79,@,L 87-90 ,240,33,81,0.407,28,60,0.467,5,21,0.238,16,20,0.8,87,32,80,0.4,28,66,0.424,4,14,0.286,22,27,0.815,90,2014-01-14,OKC,MEM
11980,80,Home,L 87-97 ,240,32,83,0.386,30,72,0.417,2,11,0.182,21,28,0.75,87,37,84,0.44,31,62,0.5,6,22,0.273,17,19,0.895,97,2014-01-18,NOP,GSW
11981,81,Home,L 87-98 ,240,33,88,0.375,25,69,0.362,8,19,0.421,13,18,0.722,87,37,70,0.529,27,49,0.551,10,21,0.476,14,18,0.778,98,2014-01-22,CLE,CHI
11982,82,Home,L 87-88 ,240,32,79,0.405,18,45,0.4,14,34,0.412,9,14,0.643,87,36,78,0.462,32,71,0.451,4,7,0.571,12,16,0.75,88,2014-01-24,HOU,MEM
11983,83,Home,L 87-89 ,240,37,88,0.42,31,69,0.449,6,19,0.316,7,10,0.7,87,31,77,0.403,20,54,0.37,11,23,0.478,16,22,0.727,89,2014-01-25,CHA,CHI
11984,84,Home,L 87-112 ,240,38,82,0.463,33,61,0.541,5,21,0.238,6,13,0.462,87,40,76,0.526,27,50,0.54,13,26,0.5,19,25,0.76,112,2014-01-25,MIL,ATL
11985,85,@,L 87-103 ,240,32,77,0.416,24,57,0.421,8,20,0.4,15,25,0.6,87,39,86,0.453,33,66,0.5,6,20,0.3,19,28,0.679,103,2014-01-28,ORL,DET
11986,86,@,L 87-102 ,240,29,81,0.358,19,51,0.373,10,30,0.333,19,28,0.679,87,38,74,0.514,36,62,0.581,2,12,0.167,24,37,0.649,102,2014-02-01,UTA,LAC
11987,87,@,L 87-102 ,240,32,77,0.416,28,63,0.444,4,14,0.286,19,20,0.95,87,40,83,0.482,29,61,0.475,11,22,0.5,11,15,0.733,102,2014-02-06,CHI,GSW
11988,88,@,L 87-90 ,240,35,83,0.422,26,60,0.433,9,23,0.391,8,11,0.727,87,31,80,0.388,28,65,0.431,3,15,0.2,25,36,0.694,90,2014-02-21,NOP,CHA
11989,89,@,L 87-109 ,240,31,76,0.408,21,53,0.396,10,23,0.435,15,20,0.75,87,43,84,0.512,34,66,0.515,9,18,0.5,14,20,0.7,109,2014-03-05,IND,CHA
11990,90,@,L 87-111 ,240,34,79,0.43,30,66,0.455,4,13,0.308,15,18,0.833,87,40,79,0.506,31,56,0.554,9,23,0.391,22,26,0.846,111,2014-03-06,MIA,SAS
11991,91,@,L 87-99 ,240,30,72,0.417,25,53,0.472,5,19,0.263,22,37,0.595,87,34,73,0.466,24,52,0.462,10,21,0.476,21,28,0.75,99,2014-03-07,SAC,TOR
11992,92,@,L 87-101 ,240,34,78,0.436,25,56,0.446,9,22,0.409,10,24,0.417,87,37,88,0.42,29,68,0.426,8,20,0.4,19,25,0.76,101,2014-03-12,DET,TOR
11993,93,@,L 87-111 ,240,28,79,0.354,23,53,0.434,5,26,0.192,26,34,0.765,87,43,86,0.5,29,62,0.468,14,24,0.583,11,13,0.846,111,2014-03-13,HOU,CHI
11994,94,@,W 87-80 ,240,34,80,0.425,29,54,0.537,5,26,0.192,14,20,0.7,87,29,94,0.309,26,73,0.356,3,21,0.143,19,21,0.905,80,2014-03-14,PHO,BOS
11995,95,Home,L 87-96 ,240,35,77,0.455,28,63,0.444,7,14,0.5,10,13,0.769,87,37,76,0.487,28,53,0.528,9,23,0.391,13,20,0.65,96,2014-03-14,UTA,LAC
11996,96,@,L 87-94 ,240,31,85,0.365,29,71,0.408,2,14,0.143,23,37,0.622,87,31,78,0.397,25,58,0.431,6,20,0.3,26,33,0.788,94,2014-03-15,SAC,CHI
11997,97,Home,L 87-91 ,240,32,69,0.464,27,53,0.509,5,16,0.313,18,26,0.692,87,36,79,0.456,32,70,0.457,4,9,0.444,15,16,0.938,91,2014-03-26,UTA,MEM
11998,98,Home,L 87-88 ,240,33,69,0.478,26,45,0.578,7,24,0.292,14,19,0.737,87,36,68,0.529,27,45,0.6,9,23,0.391,7,14,0.5,88,2014-04-08,MIA,BRK
11999,99,Home,L 87-102 ,240,34,80,0.425,30,63,0.476,4,17,0.235,15,16,0.938,87,41,82,0.5,30,61,0.492,11,21,0.524,9,12,0.75,102,2014-04-09,MIN,CHI
12000,0,Home,L 87-100 ,240,30,73,0.411,20,43,0.465,10,30,0.333,17,22,0.773,87,38,74,0.514,28,51,0.549,10,23,0.435,14,16,0.875,100,2014-04-16,MIA,PHI
12001,1,@,W 87-81 ,240,37,83,0.446,30,62,0.484,7,21,0.333,6,7,0.857,87,31,78,0.397,25,54,0.463,6,24,0.25,13,22,0.591,81,2014-11-04,MIL,IND
12002,2,@,L 87-108 ,240,33,90,0.367,28,67,0.418,5,23,0.217,16,16,1.0,87,40,77,0.519,28,47,0.596,12,30,0.4,16,19,0.842,108,2014-11-06,DAL,POR
12003,3,Home,L 87-98 ,240,30,86,0.349,20,44,0.455,10,42,0.238,17,21,0.81,87,39,87,0.448,30,59,0.508,9,28,0.321,11,17,0.647,98,2014-11-08,HOU,GSW
12004,4,@,L 87-88 ,240,34,80,0.425,27,59,0.458,7,21,0.333,12,18,0.667,87,29,78,0.372,22,44,0.5,7,34,0.206,23,37,0.622,88,2014-11-14,PHI,HOU
12005,5,Home,L 87-108 ,240,34,84,0.405,26,62,0.419,8,22,0.364,11,22,0.5,87,43,87,0.494,35,64,0.547,8,23,0.348,14,25,0.56,108,2014-11-14,IND,DEN
12006,6,@,L 87-112 ,240,32,84,0.381,25,67,0.373,7,17,0.412,16,28,0.571,87,45,87,0.517,34,61,0.557,11,26,0.423,11,14,0.786,112,2014-11-15,CHA,GSW
12007,7,@,L 87-97 ,240,35,89,0.393,34,70,0.486,1,19,0.053,16,17,0.941,87,33,78,0.423,22,52,0.423,11,26,0.423,20,27,0.741,97,2014-11-15,BRK,POR
12008,8,@,L 87-105 ,240,30,83,0.361,22,61,0.361,8,22,0.364,19,28,0.679,87,39,79,0.494,30,63,0.476,9,16,0.563,18,22,0.818,105,2014-11-21,CHI,POR
12009,9,@,L 87-99 ,240,34,91,0.374,25,64,0.391,9,27,0.333,10,10,1.0,87,41,79,0.519,33,58,0.569,8,21,0.381,9,11,0.818,99,2014-11-22,BRK,SAS
12010,10,@,L 87-113 ,240,33,71,0.465,28,58,0.483,5,13,0.385,16,22,0.727,87,38,74,0.514,32,54,0.593,6,20,0.3,31,38,0.816,113,2014-11-26,WAS,CLE
12011,11,Home,L 87-90 ,240,37,88,0.42,29,62,0.468,8,26,0.308,5,6,0.833,87,32,70,0.457,27,52,0.519,5,18,0.278,21,26,0.808,90,2014-12-04,NYK,CLE
12012,12,Home,L 87-104 ,240,36,90,0.4,31,71,0.437,5,19,0.263,10,15,0.667,87,43,83,0.518,35,65,0.538,8,18,0.444,10,15,0.667,104,2014-12-07,LAL,NOP
12013,13,@,L 87-103 ,240,39,80,0.488,34,64,0.531,5,16,0.313,4,8,0.5,87,43,73,0.589,35,60,0.583,8,13,0.615,9,11,0.818,103,2014-12-07,MIA,MEM
12014,14,@,L 87-96 ,240,38,87,0.437,33,64,0.516,5,23,0.217,6,10,0.6,87,35,84,0.417,32,70,0.457,3,14,0.214,23,29,0.793,96,2014-12-10,BOS,CHO
12015,15,Home,W 87-81 ,240,29,78,0.372,20,49,0.408,9,29,0.31,20,27,0.741,87,30,77,0.39,21,51,0.412,9,26,0.346,12,16,0.75,81,2014-12-12,ATL,ORL
12016,16,Home,L 87-114 ,240,31,79,0.392,23,57,0.404,8,22,0.364,17,27,0.63,87,42,72,0.583,26,49,0.531,16,23,0.696,14,20,0.7,114,2014-12-13,CHA,BRK
12017,17,Home,L 87-105 ,240,33,93,0.355,29,65,0.446,4,28,0.143,17,21,0.81,87,38,86,0.442,32,61,0.525,6,25,0.24,23,35,0.657,105,2014-12-15,PHI,BOS
12018,18,Home,L 87-107 ,240,37,84,0.44,32,63,0.508,5,21,0.238,8,10,0.8,87,42,83,0.506,27,50,0.54,15,33,0.455,8,8,1.0,107,2014-12-16,NYK,DAL
12019,19,Home,L 87-105 ,240,27,70,0.386,23,53,0.434,4,17,0.235,29,40,0.725,87,35,66,0.53,21,41,0.512,14,25,0.56,21,24,0.875,105,2014-12-17,MIA,UTA
12020,20,Home,L 87-91 ,240,33,80,0.413,25,54,0.463,8,26,0.308,13,18,0.722,87,33,77,0.429,28,58,0.483,5,19,0.263,20,27,0.741,91,2014-12-23,MIA,PHI
12021,21,@,L 87-114 ,240,33,74,0.446,29,62,0.468,4,12,0.333,17,27,0.63,87,43,82,0.524,35,67,0.522,8,15,0.533,20,29,0.69,114,2014-12-30,WAS,DAL
12022,22,@,L 87-95 ,240,35,78,0.449,30,56,0.536,5,22,0.227,12,17,0.706,87,35,72,0.486,28,57,0.491,7,15,0.467,18,22,0.818,95,2014-12-30,SAS,MEM
12023,23,Home,L 87-91 ,240,32,87,0.368,26,59,0.441,6,28,0.214,17,26,0.654,87,33,87,0.379,29,72,0.403,4,15,0.267,21,30,0.7,91,2015-01-02,CHA,CLE
12024,24,@,L 87-88 ,240,33,90,0.367,25,62,0.403,8,28,0.286,13,18,0.722,87,27,71,0.38,21,53,0.396,6,18,0.333,28,30,0.933,88,2015-01-04,IND,LAL
12025,25,@,L 87-95 ,240,36,81,0.444,33,70,0.471,3,11,0.273,12,16,0.75,87,35,88,0.398,31,71,0.437,4,17,0.235,21,24,0.875,95,2015-01-10,MIL,CHI
12026,26,Home,L 87-105 ,240,31,76,0.408,22,51,0.431,9,25,0.36,16,25,0.64,87,42,87,0.483,30,64,0.469,12,23,0.522,9,16,0.563,105,2015-01-13,PHI,ATL
12027,27,@,L 87-89 ,240,32,78,0.41,29,63,0.46,3,15,0.2,20,23,0.87,87,36,75,0.48,32,58,0.552,4,17,0.235,13,15,0.867,89,2015-01-23,IND,MIA
12028,28,Home,L 87-99 ,240,34,79,0.43,33,66,0.5,1,13,0.077,18,25,0.72,87,35,87,0.402,22,43,0.512,13,44,0.295,16,21,0.762,99,2015-01-25,LAL,HOU
12029,29,Home,L 87-93 ,240,32,90,0.356,25,66,0.379,7,24,0.292,16,23,0.696,87,35,84,0.417,27,54,0.5,8,30,0.267,15,20,0.75,93,2015-01-30,BOS,HOU
12030,30,@,L 87-106 ,240,33,91,0.363,24,65,0.369,9,26,0.346,12,17,0.706,87,40,87,0.46,28,55,0.509,12,32,0.375,14,18,0.778,106,2015-01-31,PHO,GSW
12031,31,@,L 87-94 ,240,35,84,0.417,30,74,0.405,5,10,0.5,12,17,0.706,87,33,76,0.434,27,51,0.529,6,25,0.24,22,27,0.815,94,2015-02-05,WAS,CHO
12032,32,@,L 87-108 ,240,34,88,0.386,28,65,0.431,6,23,0.261,13,17,0.765,87,40,90,0.444,32,59,0.542,8,31,0.258,20,23,0.87,108,2015-02-05,PHO,POR
12033,33,Home,W 87-82 ,240,32,74,0.432,28,61,0.459,4,13,0.308,19,24,0.792,87,31,93,0.333,24,65,0.369,7,28,0.25,13,16,0.813,82,2015-02-08,TOR,SAS
12034,34,Home,W 87-82 ,240,28,75,0.373,18,47,0.383,10,28,0.357,21,26,0.808,87,30,80,0.375,19,51,0.373,11,29,0.379,11,21,0.524,82,2015-02-11,DAL,UTA
12035,35,Home,L 87-104 ,240,33,81,0.407,24,60,0.4,9,21,0.429,12,17,0.706,87,42,88,0.477,32,61,0.525,10,27,0.37,10,11,0.909,104,2015-02-11,DET,SAS
12036,36,Home,L 87-111 ,240,35,82,0.427,29,64,0.453,6,18,0.333,11,16,0.688,87,38,79,0.481,29,59,0.492,9,20,0.45,26,35,0.743,111,2015-02-20,NYK,MIA
12037,37,Home,W 87-71 ,240,27,76,0.355,19,50,0.38,8,26,0.308,25,32,0.781,87,30,89,0.337,26,71,0.366,4,18,0.222,7,13,0.538,71,2015-02-23,CHI,MIL
12038,38,Home,L 87-90 ,240,35,79,0.443,26,52,0.5,9,27,0.333,8,12,0.667,87,33,81,0.407,28,66,0.424,5,15,0.333,19,26,0.731,90,2015-02-23,LAC,MEM
12039,39,@,L 87-104 ,240,34,80,0.425,29,49,0.592,5,31,0.161,14,18,0.778,87,39,85,0.459,26,50,0.52,13,35,0.371,13,16,0.813,104,2015-02-25,DAL,ATL
12040,40,Home,W 87-82 ,240,30,70,0.429,24,52,0.462,6,18,0.333,21,29,0.724,87,31,79,0.392,26,66,0.394,5,13,0.385,15,17,0.882,82,2015-03-10,UTA,NYK
12041,41,@,L 87-107 ,240,31,80,0.388,28,61,0.459,3,19,0.158,22,30,0.733,87,40,80,0.5,35,63,0.556,5,17,0.294,22,31,0.71,107,2015-03-12,MEM,WAS
12042,42,Home,L 87-96 ,240,32,78,0.41,22,52,0.423,10,26,0.385,13,21,0.619,87,39,83,0.47,31,65,0.477,8,18,0.444,10,12,0.833,96,2015-03-13,PHO,ATL
12043,43,Home,L 87-94 ,240,35,94,0.372,27,57,0.474,8,37,0.216,9,14,0.643,87,37,84,0.44,35,67,0.522,2,17,0.118,18,26,0.692,94,2015-03-14,PHI,BRK
12044,44,@,L 87-101 ,240,32,89,0.36,23,62,0.371,9,27,0.333,14,21,0.667,87,39,81,0.481,34,67,0.507,5,14,0.357,18,22,0.818,101,2015-03-22,PHI,LAL
12045,45,@,W 87-81 ,240,36,89,0.404,29,63,0.46,7,26,0.269,8,18,0.444,87,32,87,0.368,26,67,0.388,6,20,0.3,11,12,0.917,81,2015-03-27,POR,PHO
12046,46,Home,W 87-86 ,240,33,85,0.388,24,62,0.387,9,23,0.391,12,18,0.667,87,34,84,0.405,24,54,0.444,10,30,0.333,8,15,0.533,86,2015-03-29,CLE,PHI
12047,47,@,L 87-100 ,240,34,81,0.42,28,66,0.424,6,15,0.4,13,23,0.565,87,39,86,0.453,33,59,0.559,6,27,0.222,16,18,0.889,100,2015-04-01,IND,BOS
12048,48,@,L 87-101 ,240,31,84,0.369,24,63,0.381,7,21,0.333,18,20,0.9,87,43,93,0.462,36,77,0.468,7,16,0.438,8,12,0.667,101,2015-04-03,NYK,WAS
12049,49,Home,W 87-85 ,240,30,69,0.435,25,55,0.455,5,14,0.357,22,29,0.759,87,29,74,0.392,22,53,0.415,7,21,0.333,20,24,0.833,85,2015-04-04,PHO,UTA
12050,50,@,L 87-92 ,240,30,71,0.423,18,38,0.474,12,33,0.364,15,16,0.938,87,38,77,0.494,26,44,0.591,12,33,0.364,4,4,1.0,92,2015-04-15,CHA,TOR
12051,51,@,L 87-92 ,240,35,75,0.467,33,63,0.524,2,12,0.167,15,21,0.714,87,30,74,0.405,23,55,0.418,7,19,0.368,25,34,0.735,92,2015-10-28,UTA,DET
12052,52,Home,L 87-88 ,240,37,100,0.37,32,74,0.432,5,26,0.192,8,12,0.667,87,33,84,0.393,26,56,0.464,7,28,0.25,15,25,0.6,88,2015-10-28,ORL,WAS
12053,53,Home,L 87-95 ,240,35,98,0.357,29,69,0.42,6,29,0.207,11,14,0.786,87,36,83,0.434,31,64,0.484,5,19,0.263,18,25,0.72,95,2015-11-01,BOS,SAS
12054,54,@,L 87-92 ,240,35,90,0.389,28,67,0.418,7,23,0.304,10,17,0.588,87,33,87,0.379,26,59,0.441,7,28,0.25,19,22,0.864,92,2015-11-01,ORL,CHI
12055,55,@,L 87-106 ,240,29,69,0.42,24,50,0.48,5,19,0.263,24,24,1.0,87,41,90,0.456,30,65,0.462,11,25,0.44,13,20,0.65,106,2015-11-01,MIL,TOR
12056,56,@,L 87-101 ,240,36,83,0.434,31,62,0.5,5,21,0.238,10,13,0.769,87,37,76,0.487,29,54,0.537,8,22,0.364,19,24,0.792,101,2015-11-04,BRK,ATL
12057,57,@,L 87-91 ,240,34,81,0.42,28,53,0.528,6,28,0.214,13,15,0.867,87,35,86,0.407,27,63,0.429,8,23,0.348,13,17,0.765,91,2015-11-04,PHI,MIL
12058,58,@,L 87-90 ,240,36,81,0.444,30,61,0.492,6,20,0.3,9,13,0.692,87,36,80,0.45,31,65,0.477,5,15,0.333,13,24,0.542,90,2015-11-06,MIA,IND
12059,59,@,L 87-92 ,240,30,86,0.349,25,63,0.397,5,23,0.217,22,29,0.759,87,33,77,0.429,24,52,0.462,9,25,0.36,17,22,0.773,92,2015-11-06,TOR,ORL
12060,60,@,L 87-95 ,240,32,71,0.451,26,50,0.52,6,21,0.286,17,19,0.895,87,38,88,0.432,34,70,0.486,4,18,0.222,15,19,0.789,95,2015-11-15,NOP,NYK
12061,61,@,L 87-101 ,240,31,87,0.356,21,55,0.382,10,32,0.313,15,18,0.833,87,39,83,0.47,31,57,0.544,8,26,0.308,15,15,1.0,101,2015-11-25,WAS,CHO
12062,62,@,L 87-103 ,240,31,90,0.344,22,61,0.361,9,29,0.31,16,20,0.8,87,37,79,0.468,30,55,0.545,7,24,0.292,22,26,0.846,103,2015-11-27,DET,OKC
12063,63,@,L 87-101 ,240,29,69,0.42,24,52,0.462,5,17,0.294,24,30,0.8,87,38,82,0.463,29,64,0.453,9,18,0.5,16,21,0.762,101,2015-11-28,NOP,UTA
12064,64,Home,W 87-83 ,240,35,81,0.432,31,69,0.449,4,12,0.333,13,16,0.813,87,34,101,0.337,28,77,0.364,6,24,0.25,9,21,0.429,83,2015-11-29,BRK,DET
12065,65,Home,W 87-82 ,240,27,70,0.386,12,39,0.308,15,31,0.484,18,22,0.818,87,33,82,0.402,25,54,0.463,8,28,0.286,8,14,0.571,82,2015-11-29,CHA,MIL
12066,66,@,L 87-102 ,240,33,87,0.379,28,64,0.438,5,23,0.217,16,27,0.593,87,33,85,0.388,25,66,0.379,8,19,0.421,28,56,0.5,102,2015-11-30,POR,LAC
12067,67,@,L 87-99 ,240,32,86,0.372,23,56,0.411,9,30,0.3,14,24,0.583,87,38,88,0.432,34,69,0.493,4,19,0.211,19,22,0.864,99,2015-12-02,PHI,NYK
12068,68,@,L 87-100 ,240,32,86,0.372,19,59,0.322,13,27,0.481,10,13,0.769,87,37,74,0.5,27,48,0.563,10,26,0.385,16,20,0.8,100,2015-12-04,LAL,ATL
12069,69,@,L 87-109 ,240,36,88,0.409,27,63,0.429,9,25,0.36,6,10,0.6,87,44,82,0.537,38,68,0.559,6,14,0.429,15,25,0.6,109,2015-12-11,LAL,SAS
12070,70,Home,L 87-107 ,240,36,84,0.429,31,60,0.517,5,24,0.208,10,18,0.556,87,34,88,0.386,22,57,0.386,12,31,0.387,27,42,0.643,107,2015-12-17,LAL,HOU
12071,71,@,L 87-93 ,240,31,74,0.419,25,49,0.51,6,25,0.24,19,25,0.76,87,38,87,0.437,31,61,0.508,7,26,0.269,10,18,0.556,93,2015-12-28,ATL,IND
12072,72,Home,L 87-93 ,240,37,89,0.416,32,65,0.492,5,24,0.208,8,11,0.727,87,38,86,0.442,34,64,0.531,4,22,0.182,13,22,0.591,93,2015-12-29,DEN,CLE
12073,73,@,L 87-92 (OT),265,33,81,0.407,26,63,0.413,7,18,0.389,14,26,0.538,87,31,75,0.413,22,48,0.458,9,27,0.333,21,28,0.75,92,2016-01-02,MEM,UTA
12074,74,Home,L 87-93 ,240,33,79,0.418,29,63,0.46,4,16,0.25,17,22,0.773,87,36,77,0.468,30,57,0.526,6,20,0.3,15,21,0.714,93,2016-01-10,MIN,DAL
12075,75,@,L 87-117 ,240,35,81,0.432,32,66,0.485,3,15,0.2,14,25,0.56,87,39,69,0.565,32,51,0.627,7,18,0.389,32,40,0.8,117,2016-01-17,PHO,MIN
12076,76,Home,L 87-96 ,240,33,84,0.393,29,67,0.433,4,17,0.235,17,26,0.654,87,36,74,0.486,27,55,0.491,9,19,0.474,15,21,0.714,96,2016-01-20,ORL,PHI
12077,77,@,L 87-106 ,240,33,68,0.485,26,53,0.491,7,15,0.467,14,18,0.778,87,45,86,0.523,40,70,0.571,5,16,0.313,11,13,0.846,106,2016-01-20,MIA,WAS
12078,78,@,L 87-105 ,240,27,70,0.386,22,48,0.458,5,22,0.227,28,32,0.875,87,39,81,0.481,34,61,0.557,5,20,0.25,22,26,0.846,105,2016-01-31,ATL,MIA
12079,79,@,L 87-89 ,240,29,93,0.312,21,58,0.362,8,35,0.229,21,26,0.808,87,31,78,0.397,27,51,0.529,4,27,0.148,23,33,0.697,89,2016-02-08,LAL,IND
12080,80,@,W 87-81 ,240,34,90,0.378,28,66,0.424,6,24,0.25,13,17,0.765,87,30,85,0.353,17,39,0.436,13,46,0.283,8,14,0.571,81,2016-02-24,DEN,LAC
12081,81,Home,W 87-76 ,240,38,77,0.494,30,60,0.5,8,17,0.471,3,5,0.6,87,27,81,0.333,20,49,0.408,7,32,0.219,15,23,0.652,76,2016-02-28,ATL,CHO
12082,82,Home,L 87-90 ,240,34,85,0.4,31,69,0.449,3,16,0.188,16,21,0.762,87,33,75,0.44,28,54,0.519,5,21,0.238,19,27,0.704,90,2016-03-13,LAL,NYK
12083,83,@,L 87-108 ,240,32,69,0.464,24,50,0.48,8,19,0.421,15,22,0.682,87,44,82,0.537,36,62,0.581,8,20,0.4,12,16,0.75,108,2016-03-15,LAC,SAS
12084,84,Home,W 87-79 ,240,32,78,0.41,24,57,0.421,8,21,0.381,15,18,0.833,87,31,82,0.378,22,46,0.478,9,36,0.25,8,10,0.8,79,2016-03-19,SAS,GSW
12085,85,Home,L 87-89 ,240,33,74,0.446,24,51,0.471,9,23,0.391,12,22,0.545,87,31,77,0.403,20,48,0.417,11,29,0.379,16,20,0.8,89,2016-03-23,HOU,UTA
12086,86,Home,L 87-101 ,240,33,83,0.398,27,64,0.422,6,19,0.316,15,24,0.625,87,37,72,0.514,32,57,0.561,5,15,0.333,22,30,0.733,101,2016-03-28,MEM,SAS
12087,87,@,L 87-107 ,240,35,94,0.372,31,73,0.425,4,21,0.19,13,21,0.619,87,38,87,0.437,26,49,0.531,12,38,0.316,19,24,0.792,107,2016-03-31,BRK,CLE
12088,88,Home,L 87-106 ,240,33,85,0.388,25,62,0.403,8,23,0.348,13,21,0.619,87,42,76,0.553,34,54,0.63,8,22,0.364,14,23,0.609,106,2016-04-03,BRK,NOP
12089,89,Home,L 87-92 ,240,33,96,0.344,26,71,0.366,7,25,0.28,14,20,0.7,87,34,81,0.42,27,59,0.458,7,22,0.318,17,20,0.85,92,2016-04-03,NYK,IND
12090,90,@,L 87-95 ,240,32,84,0.381,24,63,0.381,8,21,0.381,15,20,0.75,87,33,76,0.434,21,44,0.477,12,32,0.375,17,21,0.81,95,2016-04-07,TOR,ATL
12091,91,@,L 87-96 ,240,34,88,0.386,25,60,0.417,9,28,0.321,10,15,0.667,87,37,84,0.44,31,59,0.525,6,25,0.24,16,18,0.889,96,2016-11-04,MIA,TOR
12092,92,@,L 87-115 ,240,33,94,0.351,27,71,0.38,6,23,0.261,15,17,0.882,87,35,90,0.389,24,63,0.381,11,27,0.407,34,43,0.791,115,2016-11-11,NYK,BOS
12093,93,@,W 87-74 ,240,33,81,0.407,26,53,0.491,7,28,0.25,14,16,0.875,87,26,78,0.333,18,58,0.31,8,20,0.4,14,19,0.737,74,2016-11-11,UTA,ORL
12094,94,@,L 87-95 ,240,26,77,0.338,13,49,0.265,13,28,0.464,22,27,0.815,87,34,78,0.436,26,57,0.456,8,21,0.381,19,22,0.864,95,2016-11-19,DAL,ORL
12095,95,Home,L 87-92 ,240,33,91,0.363,26,66,0.394,7,25,0.28,14,23,0.609,87,33,73,0.452,24,51,0.471,9,22,0.409,17,22,0.773,92,2016-11-23,ORL,PHO
12096,96,Home,L 87-94 ,240,33,77,0.429,23,47,0.489,10,30,0.333,11,14,0.786,87,33,71,0.465,22,52,0.423,11,19,0.579,17,24,0.708,94,2016-11-30,DAL,SAS
12097,97,@,L 87-97 ,240,32,86,0.372,23,55,0.418,9,31,0.29,14,18,0.778,87,35,74,0.473,30,56,0.536,5,18,0.278,22,31,0.71,97,2016-12-01,DAL,CHO
12098,98,Home,W 87-77 ,240,30,88,0.341,24,67,0.358,6,21,0.286,21,29,0.724,87,34,89,0.382,30,62,0.484,4,27,0.148,5,8,0.625,77,2016-12-07,CHA,DET
12099,99,Home,L 87-117 ,240,30,81,0.37,19,55,0.345,11,26,0.423,16,24,0.667,87,43,84,0.512,36,58,0.621,7,26,0.269,24,29,0.828,117,2016-12-07,ORL,BOS
12100,0,@,L 87-109 ,240,32,79,0.405,21,45,0.467,11,34,0.324,12,14,0.857,87,37,74,0.5,18,37,0.486,19,37,0.514,16,22,0.727,109,2016-12-10,DAL,HOU
12101,1,@,L 87-91 ,240,36,87,0.414,28,67,0.418,8,20,0.4,7,13,0.538,87,33,89,0.371,22,61,0.361,11,28,0.393,14,21,0.667,91,2016-12-23,MIA,NOP
12102,2,Home,L 87-108 ,240,32,83,0.386,23,59,0.39,9,24,0.375,14,26,0.538,87,43,85,0.506,36,64,0.563,7,21,0.333,15,20,0.75,108,2017-01-10,LAL,POR
12103,3,@,L 87-98 ,240,35,80,0.438,30,59,0.508,5,21,0.238,12,18,0.667,87,36,77,0.468,24,48,0.5,12,29,0.414,14,19,0.737,98,2017-01-15,MIN,DAL
12104,4,@,L 87-110 ,240,34,79,0.43,26,53,0.491,8,26,0.308,11,17,0.647,87,42,84,0.5,31,56,0.554,11,28,0.393,15,16,0.938,110,2017-02-06,DAL,DEN
12105,5,@,L 87-94 ,240,34,88,0.386,28,58,0.483,6,30,0.2,13,14,0.929,87,36,82,0.439,31,63,0.492,5,19,0.263,17,21,0.81,94,2017-03-02,GSW,CHI
12106,6,Home,L 87-94 ,240,34,80,0.425,25,51,0.49,9,29,0.31,10,13,0.769,87,36,76,0.474,28,55,0.509,8,21,0.381,14,23,0.609,94,2017-03-08,NOP,TOR
12107,7,Home,L 86-105 ,240,32,82,0.39,27,61,0.443,5,21,0.238,17,24,0.708,86,37,81,0.457,29,58,0.5,8,23,0.348,23,38,0.605,105,2011-12-25,GSW,LAC
12108,8,@,L 86-99 ,240,33,72,0.458,27,58,0.466,6,14,0.429,14,18,0.778,86,32,72,0.444,25,47,0.532,7,25,0.28,28,38,0.737,99,2011-12-30,TOR,DAL
12109,9,Home,L 86-94 ,240,32,78,0.41,30,62,0.484,2,16,0.125,20,23,0.87,86,37,74,0.5,32,62,0.516,5,12,0.417,15,23,0.652,94,2012-01-01,WAS,BOS
12110,10,@,L 86-91 ,240,37,88,0.42,32,69,0.464,5,19,0.263,7,11,0.636,86,33,83,0.398,29,64,0.453,4,19,0.211,21,27,0.778,91,2012-01-02,MIL,DEN
12111,11,Home,L 86-90 ,240,33,82,0.402,26,61,0.426,7,21,0.333,13,24,0.542,86,33,80,0.413,30,71,0.423,3,9,0.333,21,25,0.84,90,2012-01-04,MIN,MEM
12112,12,@,L 86-92 ,240,29,80,0.363,23,60,0.383,6,20,0.3,22,27,0.815,86,31,69,0.449,27,50,0.54,4,19,0.211,26,40,0.65,92,2012-01-07,MIL,LAC
12113,13,@,L 86-96 ,240,30,82,0.366,26,69,0.377,4,13,0.308,22,30,0.733,86,38,76,0.5,32,59,0.542,6,17,0.353,14,19,0.737,96,2012-01-09,IND,PHI
12114,14,Home,L 86-100 ,240,30,69,0.435,24,56,0.429,6,13,0.462,20,25,0.8,86,38,69,0.551,34,54,0.63,4,15,0.267,20,27,0.741,100,2012-01-10,DET,DAL
12115,15,@,L 86-102 ,240,33,78,0.423,32,66,0.485,1,12,0.083,19,25,0.76,86,47,87,0.54,44,77,0.571,3,10,0.3,5,9,0.556,102,2012-01-16,CHI,MEM
12116,16,@,L 86-99 ,240,35,79,0.443,31,62,0.5,4,17,0.235,12,20,0.6,86,37,80,0.463,27,54,0.5,10,26,0.385,15,19,0.789,99,2012-01-16,SAC,MIN
12117,17,Home,L 86-100 ,240,27,73,0.37,21,51,0.412,6,22,0.273,26,33,0.788,86,39,82,0.476,31,60,0.517,8,22,0.364,14,20,0.7,100,2012-01-20,NYK,MIL
12118,18,Home,L 86-88 ,240,31,82,0.378,26,57,0.456,5,25,0.2,19,21,0.905,86,36,83,0.434,31,62,0.5,5,21,0.238,11,19,0.579,88,2012-01-20,SAS,SAC
12119,19,Home,W 86-84 ,240,32,88,0.364,27,70,0.386,5,18,0.278,17,24,0.708,86,33,76,0.434,32,73,0.438,1,3,0.333,17,20,0.85,84,2012-01-28,PHO,MEM
12120,20,@,L 86-113 ,240,32,71,0.451,29,62,0.468,3,9,0.333,19,25,0.76,86,42,70,0.6,33,52,0.635,9,18,0.5,20,25,0.8,113,2012-01-31,DET,NYK
12121,21,Home,L 86-95 ,240,30,84,0.357,26,65,0.4,4,19,0.211,22,25,0.88,86,33,81,0.407,28,61,0.459,5,20,0.25,24,33,0.727,95,2012-02-01,DAL,OKC
12122,22,Home,W 86-84 ,240,32,79,0.405,28,65,0.431,4,14,0.286,18,28,0.643,86,31,82,0.378,23,59,0.39,8,23,0.348,14,21,0.667,84,2012-02-07,MIN,SAC
12123,23,Home,L 86-94 ,240,33,75,0.44,30,59,0.508,3,16,0.188,17,25,0.68,86,35,68,0.515,31,51,0.608,4,17,0.235,20,25,0.8,94,2012-02-10,NOP,POR
12124,24,Home,W 86-74 ,240,33,75,0.44,28,56,0.5,5,19,0.263,15,20,0.75,86,29,65,0.446,26,55,0.473,3,10,0.3,13,18,0.722,74,2012-02-10,TOR,BOS
12125,25,Home,L 86-111 ,240,26,74,0.351,25,60,0.417,1,14,0.071,33,43,0.767,86,41,78,0.526,33,58,0.569,8,20,0.4,21,24,0.875,111,2012-02-11,CHA,LAC
12126,26,Home,W 86-80 ,240,32,75,0.427,29,64,0.453,3,11,0.273,19,28,0.679,86,30,73,0.411,26,59,0.441,4,14,0.286,16,23,0.696,80,2012-02-13,NOP,UTA
12127,27,Home,W 86-78 ,240,37,84,0.44,29,67,0.433,8,17,0.471,4,9,0.444,86,31,90,0.344,24,63,0.381,7,27,0.259,9,14,0.643,78,2012-02-14,LAL,ATL
12128,28,@,W 86-83 ,240,33,74,0.446,26,57,0.456,7,17,0.412,13,14,0.929,86,31,78,0.397,27,61,0.443,4,17,0.235,17,25,0.68,83,2012-02-28,BOS,CLE
12129,29,Home,W 86-74 ,240,31,72,0.431,25,50,0.5,6,22,0.273,18,24,0.75,86,29,70,0.414,26,61,0.426,3,9,0.333,13,22,0.591,74,2012-03-05,POR,NOH
12130,30,@,L 86-89 ,240,35,76,0.461,27,53,0.509,8,23,0.348,8,9,0.889,86,35,80,0.438,35,70,0.5,0,10,0.0,19,25,0.76,89,2012-03-07,ATL,MIA
12131,31,@,L 86-104 ,240,31,72,0.431,25,57,0.439,6,15,0.4,18,23,0.783,86,42,88,0.477,34,70,0.486,8,18,0.444,12,17,0.706,104,2012-03-09,POR,BOS
12132,32,Home,W 86-85 ,240,38,68,0.559,37,60,0.617,1,8,0.125,9,15,0.6,86,31,73,0.425,23,54,0.426,8,19,0.421,15,22,0.682,85,2012-03-09,DET,ATL
12133,33,@,L 86-105 ,240,29,73,0.397,24,52,0.462,5,21,0.238,23,25,0.92,86,39,74,0.527,32,53,0.604,7,21,0.333,20,25,0.8,105,2012-03-10,TOR,DET
12134,34,Home,W 86-70 ,240,34,67,0.507,26,38,0.684,8,29,0.276,10,14,0.714,86,28,83,0.337,22,63,0.349,6,20,0.3,8,10,0.8,70,2012-03-16,ORL,NJN
12135,35,@,L 86-99 ,240,35,82,0.427,34,71,0.479,1,11,0.091,15,22,0.682,86,40,85,0.471,33,65,0.508,7,20,0.35,12,19,0.632,99,2012-03-18,HOU,PHO
12136,36,@,L 86-99 ,240,36,74,0.486,32,64,0.5,4,10,0.4,10,13,0.769,86,41,92,0.446,38,82,0.463,3,10,0.3,14,18,0.778,99,2012-03-23,BOS,PHI
12137,37,Home,L 86-89 ,240,37,81,0.457,36,76,0.474,1,5,0.2,11,12,0.917,86,36,90,0.4,34,71,0.479,2,19,0.105,15,17,0.882,89,2012-03-24,NOP,SAS
12138,38,@,L 86-93 ,240,33,85,0.388,24,56,0.429,9,29,0.31,11,13,0.846,86,34,80,0.425,34,69,0.493,0,11,0.0,25,28,0.893,93,2012-03-27,MIN,MEM
12139,39,@,L 86-103 ,240,30,80,0.375,25,54,0.463,5,26,0.192,21,32,0.656,86,41,82,0.5,34,63,0.54,7,19,0.368,14,23,0.609,103,2012-03-28,PHO,LAC
12140,40,@,L 86-108 ,240,31,69,0.449,22,43,0.512,9,26,0.346,15,26,0.577,86,43,85,0.506,31,51,0.608,12,34,0.353,10,12,0.833,108,2012-03-28,ORL,NYK
12141,41,Home,L 86-87 ,240,38,83,0.458,34,73,0.466,4,10,0.4,6,13,0.462,86,36,86,0.419,29,58,0.5,7,28,0.25,8,11,0.727,87,2012-04-04,BOS,SAS
12142,42,@,L 86-93 ,240,33,77,0.429,28,64,0.438,5,13,0.385,15,18,0.833,86,33,80,0.413,28,64,0.438,5,16,0.313,22,26,0.846,93,2012-04-05,BOS,CHI
12143,43,@,W 86-72 ,240,32,76,0.421,23,58,0.397,9,18,0.5,13,14,0.929,86,26,74,0.351,21,52,0.404,5,22,0.227,15,19,0.789,72,2012-04-07,BOS,IND
12144,44,@,L 86-98 ,240,31,73,0.425,24,52,0.462,7,21,0.333,17,21,0.81,86,39,90,0.433,30,70,0.429,9,20,0.45,11,16,0.688,98,2012-04-10,NYK,CHI
12145,45,@,L 86-88 (OT),265,34,83,0.41,32,63,0.508,2,20,0.1,16,23,0.696,86,37,89,0.416,34,76,0.447,3,13,0.231,11,13,0.846,88,2012-04-11,ATL,BOS
12146,46,@,L 86-96 (OT),265,36,82,0.439,32,71,0.451,4,11,0.364,10,16,0.625,86,37,86,0.43,26,64,0.406,11,22,0.5,11,19,0.579,96,2012-04-12,MIA,CHI
12147,47,Home,L 86-102 ,240,29,72,0.403,24,50,0.48,5,22,0.227,23,31,0.742,86,41,74,0.554,37,62,0.597,4,12,0.333,16,23,0.696,102,2012-04-15,ATL,TOR
12148,48,@,L 86-101 ,240,32,87,0.368,22,61,0.361,10,26,0.385,12,20,0.6,86,41,83,0.494,37,67,0.552,4,16,0.25,15,21,0.714,101,2012-04-15,HOU,DEN
12149,49,@,W 86-84 ,240,36,87,0.414,29,69,0.42,7,18,0.389,7,9,0.778,86,31,77,0.403,22,52,0.423,9,25,0.36,13,16,0.813,84,2012-04-21,WAS,MIA
12150,50,@,L 86-92 ,240,34,76,0.447,30,62,0.484,4,14,0.286,14,18,0.778,86,29,78,0.372,23,61,0.377,6,17,0.353,28,36,0.778,92,2012-04-23,TOR,MIL
12151,51,@,L 86-108 ,240,34,87,0.391,29,72,0.403,5,15,0.333,13,16,0.813,86,41,81,0.506,27,49,0.551,14,32,0.438,12,16,0.75,108,2012-04-26,PHI,DET
12152,52,Home,W 86-84 ,240,35,79,0.443,30,60,0.5,5,19,0.263,11,16,0.688,86,29,77,0.377,22,60,0.367,7,17,0.412,19,23,0.826,84,2012-11-01,SAS,OKC
12153,53,Home,L 86-115 ,240,32,79,0.405,24,59,0.407,8,20,0.4,14,27,0.519,86,44,69,0.638,40,59,0.678,4,10,0.4,23,30,0.767,115,2012-11-02,CLE,CHI
12154,54,@,L 86-88 ,240,35,85,0.412,25,57,0.439,10,28,0.357,6,12,0.5,86,37,81,0.457,32,67,0.478,5,14,0.357,9,14,0.643,88,2012-11-02,UTA,NOH
12155,55,Home,L 86-89 ,240,34,78,0.436,28,58,0.483,6,20,0.3,12,17,0.706,86,36,84,0.429,28,63,0.444,8,21,0.381,9,13,0.692,89,2012-11-03,WAS,BOS
12156,56,@,L 86-105 ,240,29,64,0.453,23,48,0.479,6,16,0.375,22,31,0.71,86,40,90,0.444,30,69,0.435,10,21,0.476,15,17,0.882,105,2012-11-04,MIN,TOR
12157,57,@,L 86-89 ,240,35,85,0.412,27,59,0.458,8,26,0.308,8,9,0.889,86,38,87,0.437,31,65,0.477,7,22,0.318,6,12,0.5,89,2012-11-07,IND,ATL
12158,58,@,L 86-95 ,240,25,74,0.338,21,51,0.412,4,23,0.174,32,46,0.696,86,37,83,0.446,32,66,0.485,5,17,0.294,16,18,0.889,95,2012-11-07,LAL,UTA
12159,59,Home,L 86-97 ,240,32,91,0.352,29,75,0.387,3,16,0.188,19,26,0.731,86,35,72,0.486,30,54,0.556,5,18,0.278,22,26,0.846,97,2012-11-09,SAC,SAS
12160,60,@,L 86-104 ,240,30,79,0.38,26,64,0.406,4,15,0.267,22,36,0.611,86,38,86,0.442,24,62,0.387,14,24,0.583,14,16,0.875,104,2012-11-11,MIA,MEM
12161,61,Home,L 86-103 ,240,36,77,0.468,35,66,0.53,1,11,0.091,13,19,0.684,86,35,72,0.486,21,45,0.467,14,27,0.519,19,22,0.864,103,2012-11-13,SAC,POR
12162,62,Home,W 86-79 ,240,34,80,0.425,25,60,0.417,9,20,0.45,9,12,0.75,86,30,84,0.357,25,64,0.391,5,20,0.25,14,15,0.933,79,2012-11-18,PHI,CLE
12163,63,@,L 86-97 ,240,32,80,0.4,28,67,0.418,4,13,0.308,18,21,0.857,86,38,80,0.475,31,62,0.5,7,18,0.389,14,23,0.609,97,2012-11-18,ORL,TOR
12164,64,Home,W 86-76 ,240,34,73,0.466,29,60,0.483,5,13,0.385,13,19,0.684,86,29,72,0.403,25,55,0.455,4,17,0.235,14,22,0.636,76,2012-11-23,BRK,LAC
12165,65,Home,L 86-93 ,240,38,88,0.432,35,71,0.493,3,17,0.176,7,10,0.7,86,32,82,0.39,28,66,0.424,4,16,0.25,25,26,0.962,93,2012-11-24,MIL,CHI
12166,66,Home,L 86-98 ,240,35,78,0.449,34,67,0.507,1,11,0.091,15,19,0.789,86,38,83,0.458,27,63,0.429,11,20,0.55,11,13,0.846,98,2012-11-30,ORL,BRK
12167,67,@,W 86-80 ,240,35,80,0.438,29,58,0.5,6,22,0.273,10,16,0.625,86,31,81,0.383,24,59,0.407,7,22,0.318,11,11,1.0,80,2012-12-12,ATL,ORL
12168,68,Home,L 86-90 ,240,32,81,0.395,23,63,0.365,9,18,0.5,13,14,0.929,86,33,83,0.398,28,68,0.412,5,15,0.333,19,27,0.704,90,2012-12-14,CLE,MIL
12169,69,Home,L 86-99 ,240,31,74,0.419,26,57,0.456,5,17,0.294,19,24,0.792,86,38,85,0.447,34,74,0.459,4,11,0.364,19,24,0.792,99,2012-12-15,UTA,MEM
12170,70,@,L 86-100 ,240,35,78,0.449,25,53,0.472,10,25,0.4,6,9,0.667,86,38,83,0.458,27,54,0.5,11,29,0.379,13,17,0.765,100,2012-12-19,BRK,NYK
12171,71,Home,L 86-111 ,240,38,95,0.4,37,79,0.468,1,16,0.063,9,10,0.9,86,41,81,0.506,33,62,0.532,8,19,0.421,21,24,0.875,111,2012-12-30,DAL,SAS
12172,72,Home,L 86-95 ,240,36,82,0.439,26,62,0.419,10,20,0.5,4,12,0.333,86,41,83,0.494,32,61,0.525,9,22,0.409,4,8,0.5,95,2013-01-01,NOP,ATL
12173,73,@,W 86-84 ,240,33,81,0.407,23,54,0.426,10,27,0.37,10,15,0.667,86,32,81,0.395,30,76,0.395,2,5,0.4,18,18,1.0,84,2013-01-04,POR,MEM
12174,74,@,L 86-109 ,240,35,84,0.417,32,67,0.478,3,17,0.176,13,20,0.65,86,41,85,0.482,33,60,0.55,8,25,0.32,19,23,0.826,109,2013-01-05,PHI,SAS
12175,75,@,L 86-97 ,240,35,83,0.422,29,59,0.492,6,24,0.25,10,12,0.833,86,33,81,0.407,27,67,0.403,6,14,0.429,25,31,0.806,97,2013-01-13,IND,BRK
12176,76,@,L 86-97 ,240,37,85,0.435,35,68,0.515,2,17,0.118,10,12,0.833,86,40,86,0.465,28,65,0.431,12,21,0.571,5,5,1.0,97,2013-01-16,IND,ORL
12177,77,Home,L 86-89 ,240,31,76,0.408,28,58,0.483,3,18,0.167,21,28,0.75,86,32,83,0.386,24,55,0.436,8,28,0.286,17,20,0.85,89,2013-01-24,BOS,NYK
12178,78,Home,W 86-73 ,240,34,79,0.43,31,69,0.449,3,10,0.3,15,19,0.789,86,29,71,0.408,25,56,0.446,4,15,0.267,11,12,0.917,73,2013-01-26,WAS,CHI
12179,79,@,L 86-92 ,240,33,78,0.423,25,51,0.49,8,27,0.296,12,19,0.632,86,38,83,0.458,35,71,0.493,3,12,0.25,13,15,0.867,92,2013-01-30,LAL,PHO
12180,80,@,L 86-96 ,240,33,83,0.398,25,63,0.397,8,20,0.4,12,17,0.706,86,32,76,0.421,19,41,0.463,13,35,0.371,19,26,0.731,96,2013-02-01,MIL,NYK
12181,81,Home,W 86-77 ,240,35,81,0.432,31,66,0.47,4,15,0.267,12,17,0.706,86,29,79,0.367,22,59,0.373,7,20,0.35,12,16,0.75,77,2013-02-01,UTA,POR
12182,82,@,L 86-115 ,240,28,70,0.4,25,56,0.446,3,14,0.214,27,33,0.818,86,45,77,0.584,40,62,0.645,5,15,0.333,20,29,0.69,115,2013-02-02,NOP,MIN
12183,83,@,L 86-96 ,240,36,88,0.409,30,66,0.455,6,22,0.273,8,17,0.471,86,38,78,0.487,33,58,0.569,5,20,0.25,15,16,0.938,96,2013-02-02,WAS,SAS
12184,84,@,W 86-76 ,240,33,82,0.402,27,64,0.422,6,18,0.333,14,22,0.636,86,30,87,0.345,24,67,0.358,6,20,0.3,10,14,0.714,76,2013-02-06,LAC,ORL
12185,85,@,L 86-100 ,240,29,82,0.354,23,63,0.365,6,19,0.316,22,29,0.759,86,39,81,0.481,34,71,0.479,5,10,0.5,17,26,0.654,100,2013-02-06,MIL,UTA
12186,86,Home,L 86-111 ,240,34,72,0.472,28,53,0.528,6,19,0.316,12,17,0.706,86,43,73,0.589,31,54,0.574,12,19,0.632,13,20,0.65,111,2013-02-10,BRK,SAS
12187,87,Home,L 86-105 ,240,29,81,0.358,24,62,0.387,5,19,0.263,23,33,0.697,86,41,83,0.494,31,62,0.5,10,21,0.476,13,14,0.929,105,2013-02-11,DET,NOH
12188,88,@,W 86-67 ,240,37,73,0.507,34,60,0.567,3,13,0.231,9,14,0.643,86,28,75,0.373,26,65,0.4,2,10,0.2,9,11,0.818,67,2013-02-21,MIA,CHI
12189,89,@,L 86-92 ,240,36,85,0.424,34,72,0.472,2,13,0.154,12,15,0.8,86,35,79,0.443,28,58,0.483,7,21,0.333,15,19,0.789,92,2013-02-24,BOS,POR
12190,90,@,L 86-94 ,240,32,94,0.34,27,71,0.38,5,23,0.217,17,22,0.773,86,36,75,0.48,33,60,0.55,3,15,0.2,19,28,0.679,94,2013-03-01,GSW,BOS
12191,91,Home,L 86-115 ,240,32,82,0.39,27,67,0.403,5,15,0.333,17,19,0.895,86,43,83,0.518,32,64,0.5,11,19,0.579,18,23,0.783,115,2013-03-08,ORL,IND
12192,92,@,L 86-96 ,240,34,78,0.436,27,62,0.435,7,16,0.438,11,18,0.611,86,41,82,0.5,34,61,0.557,7,21,0.333,7,11,0.636,96,2013-03-15,CLE,DAL
12193,93,@,L 86-87 ,240,33,72,0.458,29,58,0.5,4,14,0.286,16,17,0.941,86,31,71,0.437,26,55,0.473,5,16,0.313,20,26,0.769,87,2013-03-20,BOS,NOH
12194,94,Home,L 86-117 ,240,36,95,0.379,32,73,0.438,4,22,0.182,10,21,0.476,86,42,79,0.532,40,67,0.597,2,12,0.167,31,40,0.775,117,2013-03-22,PHO,MIN
12195,95,@,L 86-110 ,240,25,66,0.379,20,50,0.4,5,16,0.313,31,39,0.795,86,41,85,0.482,27,60,0.45,14,25,0.56,14,15,0.933,110,2013-03-25,DEN,NOH
12196,96,Home,L 86-99 ,240,29,67,0.433,24,51,0.471,5,16,0.313,23,34,0.676,86,37,73,0.507,31,63,0.492,6,10,0.6,19,27,0.704,99,2013-03-30,MIN,MEM
12197,97,Home,L 86-88 ,240,35,79,0.443,28,55,0.509,7,24,0.292,9,16,0.563,86,33,71,0.465,21,43,0.488,12,28,0.429,10,15,0.667,88,2013-03-31,SAS,MIA
12198,98,@,L 86-90 ,240,35,89,0.393,30,66,0.455,5,23,0.217,11,16,0.688,86,33,78,0.423,27,65,0.415,6,13,0.462,18,26,0.692,90,2013-04-02,CHI,WAS
12199,99,@,L 86-87 ,240,34,80,0.425,30,70,0.429,4,10,0.4,14,17,0.824,86,33,82,0.402,25,62,0.403,8,20,0.4,13,14,0.929,87,2013-04-05,ORL,CHI
12200,0,Home,W 86-84 ,240,34,74,0.459,29,54,0.537,5,20,0.25,13,18,0.722,86,38,86,0.442,35,72,0.486,3,14,0.214,5,7,0.714,84,2013-04-05,LAL,MEM
12201,1,@,L 86-96 ,240,35,87,0.402,31,66,0.47,4,21,0.19,12,17,0.706,86,39,86,0.453,33,71,0.465,6,15,0.4,12,21,0.571,96,2013-04-10,SAS,DEN
12202,2,Home,L 86-97 ,240,36,87,0.414,35,74,0.473,1,13,0.077,13,21,0.619,86,40,93,0.43,33,71,0.465,7,22,0.318,10,11,0.909,97,2013-04-12,WAS,PHI
12203,3,@,L 86-91 ,240,33,89,0.371,27,71,0.38,6,18,0.333,14,19,0.737,86,31,85,0.365,22,58,0.379,9,27,0.333,20,31,0.645,91,2013-04-14,SAS,LAL
12204,4,Home,W 86-70 ,240,34,84,0.405,30,71,0.423,4,13,0.308,14,20,0.7,86,25,78,0.321,22,67,0.328,3,11,0.273,17,26,0.654,70,2013-04-17,MEM,UTA
12205,5,@,L 86-107 ,240,34,89,0.382,30,72,0.417,4,17,0.235,14,15,0.933,86,42,89,0.472,35,72,0.486,7,17,0.412,16,22,0.727,107,2013-11-03,BRK,ORL
12206,6,@,L 86-107 ,240,31,82,0.378,28,69,0.406,3,13,0.231,21,27,0.778,86,41,94,0.436,33,70,0.471,8,24,0.333,17,23,0.739,107,2013-11-13,BRK,SAC
12207,7,@,W 86-80 ,240,32,80,0.4,24,60,0.4,8,20,0.4,14,20,0.7,86,32,79,0.405,28,64,0.438,4,15,0.267,12,17,0.706,80,2013-11-15,CHA,CLE
12208,8,Home,L 86-89 ,240,35,80,0.438,25,56,0.446,10,24,0.417,6,11,0.545,86,37,85,0.435,36,72,0.5,1,13,0.077,14,14,1.0,89,2013-11-15,LAL,MEM
12209,9,Home,L 86-97 ,240,33,87,0.379,26,64,0.406,7,23,0.304,13,17,0.765,86,40,72,0.556,36,59,0.61,4,13,0.308,13,18,0.722,97,2013-11-17,SAC,MEM
12210,10,Home,W 86-81 ,240,27,75,0.36,21,63,0.333,6,12,0.5,26,31,0.839,86,33,91,0.363,26,75,0.347,7,16,0.438,8,16,0.5,81,2013-11-18,CHI,CHA
12211,11,@,L 86-92 ,240,33,76,0.434,27,52,0.519,6,24,0.25,14,18,0.778,86,35,70,0.5,28,51,0.549,7,19,0.368,15,21,0.714,92,2013-11-19,NYK,DET
12212,12,Home,L 86-102 ,240,35,80,0.438,32,69,0.464,3,11,0.273,13,17,0.765,86,42,79,0.532,35,62,0.565,7,17,0.412,11,16,0.688,102,2013-11-22,MEM,SAS
12213,13,@,L 86-100 ,240,35,84,0.417,27,60,0.45,8,24,0.333,8,15,0.533,86,40,87,0.46,32,61,0.525,8,26,0.308,12,15,0.8,100,2013-11-24,SAC,LAL
12214,14,Home,L 86-96 ,240,33,74,0.446,30,65,0.462,3,9,0.333,17,20,0.85,86,35,80,0.438,26,60,0.433,9,20,0.45,17,21,0.81,96,2013-11-25,CHA,BOS
12215,15,Home,L 86-93 ,240,34,82,0.415,30,69,0.435,4,13,0.308,14,18,0.778,86,34,69,0.493,28,45,0.622,6,24,0.25,19,27,0.704,93,2013-11-25,MEM,HOU
12216,16,@,L 86-103 ,240,32,86,0.372,28,68,0.412,4,18,0.222,18,27,0.667,86,38,76,0.5,27,53,0.509,11,23,0.478,16,26,0.615,103,2013-11-29,CLE,BOS
12217,17,Home,L 86-95 ,240,33,80,0.413,29,69,0.42,4,11,0.364,16,18,0.889,86,40,84,0.476,37,68,0.544,3,16,0.188,12,15,0.8,95,2013-12-04,UTA,IND
12218,18,@,L 86-90 ,240,32,80,0.4,27,59,0.458,5,21,0.238,17,19,0.895,86,33,68,0.485,26,47,0.553,7,21,0.333,17,25,0.68,90,2013-12-13,NYK,BOS
12219,19,@,W 86-82 ,240,33,82,0.402,25,61,0.41,8,21,0.381,12,15,0.8,86,28,86,0.326,21,71,0.296,7,15,0.467,19,20,0.95,82,2013-12-18,UTA,ORL
12220,20,Home,L 86-103 ,240,29,76,0.382,23,50,0.46,6,26,0.231,22,25,0.88,86,38,83,0.458,29,55,0.527,9,28,0.321,18,19,0.947,103,2013-12-23,BRK,IND
12221,21,@,L 86-115 ,240,32,89,0.36,28,66,0.424,4,23,0.174,18,23,0.783,86,45,85,0.529,37,65,0.569,8,20,0.4,17,24,0.708,115,2013-12-27,PHO,GSW
12222,22,@,L 86-117 ,240,31,85,0.365,24,57,0.421,7,28,0.25,17,31,0.548,86,47,82,0.573,37,60,0.617,10,22,0.455,13,16,0.813,117,2013-12-29,HOU,OKC
12223,23,@,L 86-91 ,240,27,70,0.386,19,46,0.413,8,24,0.333,24,26,0.923,86,33,80,0.413,25,53,0.472,8,27,0.296,17,26,0.654,91,2014-01-06,ATL,BRK
12224,24,Home,W 86-79 ,240,32,75,0.427,31,64,0.484,1,11,0.091,21,26,0.808,86,30,81,0.37,25,62,0.403,5,19,0.263,14,18,0.778,79,2014-01-07,IND,TOR
12225,25,@,L 86-104 ,240,33,93,0.355,28,76,0.368,5,17,0.294,15,18,0.833,86,42,74,0.568,33,61,0.541,9,13,0.692,11,14,0.786,104,2014-01-12,MIN,SAS
12226,26,Home,L 86-101 ,240,31,84,0.369,29,64,0.453,2,20,0.1,22,37,0.595,86,38,80,0.475,30,57,0.526,8,23,0.348,17,20,0.85,101,2014-01-17,PHI,MIA
12227,27,@,L 86-93 ,240,33,84,0.393,28,57,0.491,5,27,0.185,15,18,0.833,86,38,74,0.514,33,54,0.611,5,20,0.25,12,16,0.75,93,2014-01-21,BOS,MIA
12228,28,Home,L 86-95 ,240,32,85,0.376,24,61,0.393,8,24,0.333,14,16,0.875,86,34,73,0.466,29,56,0.518,5,17,0.294,22,26,0.846,95,2014-01-27,CHI,MIN
12229,29,Home,L 86-114 ,240,34,89,0.382,30,67,0.448,4,22,0.182,14,22,0.636,86,43,79,0.544,29,51,0.569,14,28,0.5,14,19,0.737,114,2014-01-27,MIL,LAC
12230,30,Home,L 86-96 ,240,33,71,0.465,28,58,0.483,5,13,0.385,15,16,0.938,86,37,83,0.446,33,71,0.465,4,12,0.333,18,23,0.783,96,2014-01-29,SAS,CHI
12231,31,@,L 86-117 ,240,31,87,0.356,23,64,0.359,8,23,0.348,16,22,0.727,86,43,76,0.566,31,50,0.62,12,26,0.462,19,28,0.679,117,2014-01-30,CLE,NYK
12232,32,Home,W 86-77 ,240,34,76,0.447,30,58,0.517,4,18,0.222,14,23,0.609,86,32,81,0.395,30,65,0.462,2,16,0.125,11,15,0.733,77,2014-02-03,OKC,MEM
12233,33,Home,L 86-92 ,240,36,82,0.439,30,63,0.476,6,19,0.316,8,11,0.727,86,34,80,0.425,27,58,0.466,7,22,0.318,17,17,1.0,92,2014-02-09,LAL,CHI
12234,34,Home,L 86-102 ,240,31,72,0.431,25,56,0.446,6,16,0.375,18,25,0.72,86,42,88,0.477,35,68,0.515,7,20,0.35,11,14,0.786,102,2014-02-10,MIL,BOS
12235,35,@,W 86-81 ,240,36,77,0.468,34,65,0.523,2,12,0.167,12,18,0.667,86,34,83,0.41,30,70,0.429,4,13,0.308,9,10,0.9,81,2014-02-12,MEM,ORL
12236,36,@,L 86-93 ,240,32,78,0.41,30,57,0.526,2,21,0.095,20,24,0.833,86,37,85,0.435,31,65,0.477,6,20,0.3,13,17,0.765,93,2014-02-22,BRK,GSW
12237,37,@,L 86-109 ,240,31,80,0.388,25,61,0.41,6,19,0.316,18,29,0.621,86,42,74,0.568,33,56,0.589,9,18,0.5,16,24,0.667,109,2014-02-26,PHO,UTA
12238,38,@,L 86-112 ,240,34,74,0.459,27,58,0.466,7,16,0.438,11,15,0.733,86,40,76,0.526,27,48,0.563,13,28,0.464,19,25,0.76,112,2014-03-07,IND,HOU
12239,39,@,L 86-99 ,240,33,74,0.446,31,66,0.47,2,8,0.25,18,27,0.667,86,36,71,0.507,27,54,0.5,9,17,0.529,18,22,0.818,99,2014-03-14,MEM,TOR
12240,40,Home,L 86-109 ,240,29,79,0.367,20,50,0.4,9,29,0.31,19,27,0.704,86,40,75,0.533,27,51,0.529,13,24,0.542,16,20,0.8,109,2014-03-16,OKC,DAL
12241,41,@,L 86-124 ,240,34,83,0.41,30,65,0.462,4,18,0.222,14,18,0.778,86,46,79,0.582,33,54,0.611,13,25,0.52,19,26,0.731,124,2014-03-17,UTA,HOU
12242,42,@,L 86-96 ,240,37,84,0.44,30,66,0.455,7,18,0.389,5,10,0.5,86,36,81,0.444,34,70,0.486,2,11,0.182,22,25,0.88,96,2014-03-19,UTA,MEM
12243,43,@,L 86-92 ,240,31,73,0.425,26,50,0.52,5,23,0.217,19,27,0.704,86,32,82,0.39,28,65,0.431,4,17,0.235,24,29,0.828,92,2014-03-19,IND,NYK
12244,44,@,L 86-91 ,240,36,79,0.456,33,65,0.508,3,14,0.214,11,17,0.647,86,35,75,0.467,28,55,0.509,7,20,0.35,14,16,0.875,91,2014-03-21,MEM,MIA
12245,45,@,L 86-96 ,240,33,76,0.434,28,56,0.5,5,20,0.25,15,20,0.75,86,34,80,0.425,26,56,0.464,8,24,0.333,20,28,0.714,96,2014-03-23,ATL,TOR
12246,46,@,L 86-98 ,240,31,65,0.477,23,51,0.451,8,14,0.571,16,19,0.842,86,35,75,0.467,29,59,0.492,6,16,0.375,22,28,0.786,98,2014-04-11,IND,MIA
12247,47,Home,L 86-96 ,240,32,77,0.416,28,58,0.483,4,19,0.211,18,24,0.75,86,35,82,0.427,33,63,0.524,2,19,0.105,24,33,0.727,96,2014-04-11,ORL,WAS
12248,48,@,L 86-91 (OT),265,34,86,0.395,26,64,0.406,8,22,0.364,10,15,0.667,86,34,85,0.4,29,64,0.453,5,21,0.238,18,26,0.692,91,2014-04-16,CHI,CHA
12249,49,Home,L 86-101 ,240,32,79,0.405,27,64,0.422,5,15,0.333,17,24,0.708,86,41,88,0.466,30,65,0.462,11,23,0.478,8,11,0.727,101,2014-04-16,ORL,IND
12250,50,Home,L 86-95 ,240,33,89,0.371,30,74,0.405,3,15,0.2,17,20,0.85,86,34,73,0.466,29,57,0.509,5,16,0.313,22,30,0.733,95,2014-11-05,MIL,CHI
12251,51,@,L 86-97 ,240,32,74,0.432,26,53,0.491,6,21,0.286,16,21,0.762,86,39,90,0.433,33,75,0.44,6,15,0.4,13,15,0.867,97,2014-11-10,UTA,IND
12252,52,Home,L 86-88 ,240,33,87,0.379,26,62,0.419,7,25,0.28,13,19,0.684,86,37,75,0.493,33,60,0.55,4,15,0.267,10,13,0.769,88,2014-11-19,DET,PHO
12253,53,@,L 86-88 ,240,37,86,0.43,32,72,0.444,5,14,0.357,7,12,0.583,86,35,78,0.449,33,63,0.524,2,15,0.133,16,24,0.667,88,2014-11-19,CHA,IND
12254,54,Home,L 86-91 ,240,32,90,0.356,29,73,0.397,3,17,0.176,19,27,0.704,86,33,93,0.355,26,68,0.382,7,25,0.28,18,24,0.75,91,2014-11-23,OKC,GSW
12255,55,@,L 86-91 ,240,35,76,0.461,29,54,0.537,6,22,0.273,10,15,0.667,86,32,76,0.421,18,40,0.45,14,36,0.389,13,19,0.684,91,2014-11-24,NYK,HOU
12256,56,@,L 86-98 ,240,36,78,0.462,29,58,0.5,7,20,0.35,7,17,0.412,86,39,90,0.433,29,68,0.426,10,22,0.455,10,13,0.769,98,2014-11-25,DET,MIL
12257,57,Home,L 86-103 ,240,31,81,0.383,28,67,0.418,3,14,0.214,21,34,0.618,86,40,85,0.471,35,69,0.507,5,16,0.313,18,19,0.947,103,2014-11-26,MIN,MIL
12258,58,@,W 86-79 ,240,30,72,0.417,23,49,0.469,7,23,0.304,19,31,0.613,86,31,88,0.352,28,64,0.438,3,24,0.125,14,20,0.7,79,2014-11-30,MIA,NYK
12259,59,@,L 86-107 ,240,33,72,0.458,31,50,0.62,2,22,0.091,18,30,0.6,86,39,72,0.542,29,53,0.547,10,19,0.526,19,24,0.792,107,2014-12-01,MIA,WAS
12260,60,@,L 86-114 ,240,33,79,0.418,26,59,0.441,7,20,0.35,13,25,0.52,86,42,78,0.538,30,47,0.638,12,31,0.387,18,25,0.72,114,2014-12-03,ORL,LAC
12261,61,Home,L 86-102 ,240,32,88,0.364,30,77,0.39,2,11,0.182,20,29,0.69,86,42,91,0.462,37,69,0.536,5,22,0.227,13,14,0.929,102,2014-12-08,MIN,GSW
12262,62,Home,L 86-98 ,240,34,97,0.351,29,75,0.387,5,22,0.227,13,16,0.813,86,41,84,0.488,32,63,0.508,9,21,0.429,7,8,0.875,98,2014-12-09,DET,POR
12263,63,@,L 86-93 ,240,35,93,0.376,29,64,0.453,6,29,0.207,10,14,0.714,86,36,83,0.434,29,62,0.468,7,21,0.333,14,17,0.824,93,2014-12-15,CHI,ATL
12264,64,@,L 86-104 ,240,33,85,0.388,25,54,0.463,8,31,0.258,12,15,0.8,86,42,87,0.483,33,65,0.508,9,22,0.409,11,16,0.688,104,2014-12-20,UTA,CHO
12265,65,@,L 86-100 ,240,34,80,0.425,28,52,0.538,6,28,0.214,12,22,0.545,86,34,87,0.391,25,55,0.455,9,32,0.281,23,31,0.742,100,2014-12-25,GSW,LAC
12266,66,@,L 86-126 ,240,33,86,0.384,27,66,0.409,6,20,0.3,14,23,0.609,86,46,82,0.561,34,54,0.63,12,28,0.429,22,27,0.815,126,2014-12-30,PHI,GSW
12267,67,Home,L 86-109 ,240,38,85,0.447,34,65,0.523,4,20,0.2,6,10,0.6,86,40,86,0.465,26,53,0.491,14,33,0.424,15,29,0.517,109,2014-12-30,ORL,DET
12268,68,@,L 86-96 ,240,35,79,0.443,30,62,0.484,5,17,0.294,11,11,1.0,86,32,72,0.444,19,47,0.404,13,25,0.52,19,23,0.826,96,2015-01-07,MEM,ATL
12269,69,@,L 86-102 ,240,32,83,0.386,22,57,0.386,10,26,0.385,12,19,0.632,86,41,86,0.477,33,71,0.465,8,15,0.533,12,19,0.632,102,2015-01-09,CHI,WAS
12270,70,Home,L 86-94 ,240,32,68,0.471,24,46,0.522,8,22,0.364,14,19,0.737,86,41,92,0.446,35,66,0.53,6,26,0.231,6,10,0.6,94,2015-01-20,MIA,OKC
12271,71,@,L 86-92 ,240,27,85,0.318,22,57,0.386,5,28,0.179,27,32,0.844,86,34,74,0.459,33,67,0.493,1,7,0.143,23,29,0.793,92,2015-01-21,TOR,MEM
12272,72,Home,L 86-91 ,240,31,81,0.383,22,52,0.423,9,29,0.31,15,18,0.833,86,33,80,0.413,27,56,0.482,6,24,0.25,19,24,0.792,91,2015-01-23,PHI,TOR
12273,73,@,L 86-101 ,240,31,86,0.36,25,61,0.41,6,25,0.24,18,25,0.72,86,41,81,0.506,30,64,0.469,11,17,0.647,8,10,0.8,101,2015-01-24,DET,MIL
12274,74,@,L 86-95 ,240,34,83,0.41,28,65,0.431,6,18,0.333,12,14,0.857,86,35,83,0.422,25,54,0.463,10,29,0.345,15,18,0.833,95,2015-01-28,CHA,SAS
12275,75,Home,L 86-104 ,240,33,92,0.359,28,68,0.412,5,24,0.208,15,20,0.75,86,44,93,0.473,44,82,0.537,0,11,0.0,16,25,0.64,104,2015-01-31,DEN,CHO
12276,76,@,L 86-104 ,240,35,75,0.467,33,63,0.524,2,12,0.167,14,27,0.519,86,42,80,0.525,35,60,0.583,7,20,0.35,13,15,0.867,104,2015-02-10,SAC,CHI
12277,77,@,L 86-95 ,240,35,81,0.432,32,69,0.464,3,12,0.25,13,17,0.765,86,36,81,0.444,30,62,0.484,6,19,0.316,17,25,0.68,95,2015-02-10,BRK,MEM
12278,78,@,L 86-102 ,240,34,93,0.366,27,77,0.351,7,16,0.438,11,11,1.0,86,35,86,0.407,25,56,0.446,10,30,0.333,22,23,0.957,102,2015-02-11,LAL,POR
12279,79,Home,L 86-97 ,240,32,72,0.444,28,56,0.5,4,16,0.25,18,18,1.0,86,35,87,0.402,26,57,0.456,9,30,0.3,18,21,0.857,97,2015-02-22,MIL,ATL
12280,80,Home,L 86-98 ,240,34,77,0.442,31,60,0.517,3,17,0.176,15,23,0.652,86,39,84,0.464,35,70,0.5,4,14,0.286,16,21,0.762,98,2015-02-25,CHI,CHO
12281,81,@,L 86-93 ,240,33,92,0.359,24,63,0.381,9,29,0.31,11,14,0.786,86,34,80,0.425,28,63,0.444,6,17,0.353,19,29,0.655,93,2015-02-27,CLE,IND
12282,82,Home,L 86-96 ,240,27,87,0.31,17,61,0.279,10,26,0.385,22,30,0.733,86,38,87,0.437,31,60,0.517,7,27,0.259,13,24,0.542,96,2015-03-01,CHI,LAC
12283,83,Home,L 86-124 ,240,30,82,0.366,26,60,0.433,4,22,0.182,22,30,0.733,86,41,83,0.494,31,65,0.477,10,18,0.556,32,37,0.865,124,2015-03-03,NYK,SAC
12284,84,Home,L 86-92 ,240,30,78,0.385,27,63,0.429,3,15,0.2,23,30,0.767,86,30,79,0.38,23,61,0.377,7,18,0.389,25,30,0.833,92,2015-03-07,NYK,IND
12285,85,@,L 86-118 ,240,34,92,0.37,30,75,0.4,4,17,0.235,14,20,0.7,86,45,85,0.529,28,51,0.549,17,34,0.5,11,12,0.917,118,2015-03-10,ORL,IND
12286,86,Home,L 86-91 ,240,34,85,0.4,27,67,0.403,7,18,0.389,11,15,0.733,86,34,76,0.447,29,53,0.547,5,23,0.217,18,27,0.667,91,2015-03-15,LAL,ATL
12287,87,@,L 86-103 ,240,32,81,0.395,26,62,0.419,6,19,0.316,16,21,0.762,86,34,82,0.415,24,58,0.414,10,24,0.417,25,28,0.893,103,2015-03-18,IND,CHI
12288,88,@,L 86-97 ,240,33,76,0.434,27,54,0.5,6,22,0.273,14,15,0.933,86,37,89,0.416,26,71,0.366,11,18,0.611,12,16,0.75,97,2015-03-21,POR,MEM
12289,89,@,L 86-109 ,240,35,87,0.402,32,70,0.457,3,17,0.176,13,18,0.722,86,40,79,0.506,32,62,0.516,8,17,0.471,21,23,0.913,109,2015-03-22,WAS,SAC
12290,90,@,L 86-98 ,240,28,81,0.346,20,61,0.328,8,20,0.4,22,28,0.786,86,37,82,0.451,34,66,0.515,3,16,0.188,21,29,0.724,98,2015-03-23,CHA,CHI
12291,91,Home,L 86-93 ,240,28,69,0.406,23,50,0.46,5,19,0.263,25,37,0.676,86,34,77,0.442,25,53,0.472,9,24,0.375,16,23,0.696,93,2015-03-25,BOS,MIA
12292,92,@,L 86-99 ,240,32,82,0.39,21,47,0.447,11,35,0.314,11,15,0.733,86,37,72,0.514,31,54,0.574,6,18,0.333,19,24,0.792,99,2015-03-27,MIA,ATL
12293,93,@,L 86-87 ,240,34,84,0.405,24,54,0.444,10,30,0.333,8,15,0.533,86,33,85,0.388,24,62,0.387,9,23,0.391,12,18,0.667,87,2015-03-29,PHI,CLE
12294,94,@,L 86-109 ,240,38,87,0.437,35,71,0.493,3,16,0.188,7,10,0.7,86,44,86,0.512,32,59,0.542,12,27,0.444,9,10,0.9,109,2015-03-30,PHO,POR
12295,95,Home,L 86-102 ,240,29,84,0.345,22,67,0.328,7,17,0.412,21,26,0.808,86,38,77,0.494,34,55,0.618,4,22,0.182,22,27,0.815,102,2015-04-08,NYK,IND
12296,96,@,L 86-94 ,240,34,77,0.442,32,68,0.471,2,9,0.222,16,24,0.667,86,35,88,0.398,29,61,0.475,6,27,0.222,18,22,0.818,94,2015-04-11,MEM,LAC
12297,97,Home,L 86-113 ,240,32,87,0.368,29,75,0.387,3,12,0.25,19,22,0.864,86,44,88,0.5,32,58,0.552,12,30,0.4,13,17,0.765,113,2015-04-13,BRK,CHI
12298,98,@,L 86-96 ,240,33,84,0.393,25,60,0.417,8,24,0.333,12,15,0.8,86,33,83,0.398,26,56,0.464,7,27,0.259,23,32,0.719,96,2015-11-04,NYK,CLE
12299,99,@,L 86-94 ,240,34,82,0.415,31,73,0.425,3,9,0.333,15,19,0.789,86,37,82,0.451,29,62,0.468,8,20,0.4,12,16,0.75,94,2015-11-07,BRK,MIL
12300,0,Home,L 86-92 ,240,34,76,0.447,29,54,0.537,5,22,0.227,13,20,0.65,86,30,76,0.395,23,52,0.442,7,24,0.292,25,30,0.833,92,2015-11-16,PHI,DAL
12301,1,@,L 86-115 ,240,31,72,0.431,21,51,0.412,10,21,0.476,14,24,0.583,86,37,70,0.529,25,48,0.521,12,22,0.545,29,41,0.707,115,2015-11-17,MIL,WAS
12302,2,Home,L 86-96 ,240,33,77,0.429,30,64,0.469,3,13,0.231,17,25,0.68,86,40,87,0.46,34,59,0.576,6,28,0.214,10,13,0.769,96,2015-11-20,MIN,DET
12303,3,@,L 86-123 ,240,34,79,0.43,29,62,0.468,5,17,0.294,13,19,0.684,86,47,91,0.516,32,61,0.525,15,30,0.5,14,23,0.609,123,2015-11-21,MIL,IND
12304,4,Home,L 86-96 ,240,33,90,0.367,25,63,0.397,8,27,0.296,12,16,0.75,86,36,79,0.456,30,54,0.556,6,25,0.24,18,24,0.75,96,2015-12-02,ATL,TOR
12305,5,@,L 86-108 ,240,30,86,0.349,25,62,0.403,5,24,0.208,21,30,0.7,86,40,85,0.471,29,60,0.483,11,25,0.44,17,21,0.81,108,2015-12-20,PHI,CLE
12306,6,@,L 86-101 ,240,38,86,0.442,33,68,0.485,5,18,0.278,5,6,0.833,86,39,81,0.481,32,71,0.451,7,10,0.7,16,17,0.941,101,2015-12-26,DEN,SAS
12307,7,Home,L 86-95 ,240,32,79,0.405,26,48,0.542,6,31,0.194,16,17,0.941,86,32,76,0.421,26,54,0.481,6,22,0.273,25,29,0.862,95,2016-01-06,ORL,IND
12308,8,Home,L 86-91 ,240,31,83,0.373,22,54,0.407,9,29,0.31,15,20,0.75,86,36,81,0.444,31,60,0.517,5,21,0.238,14,19,0.737,91,2016-01-08,NOP,IND
12309,9,@,W 86-74 ,240,31,69,0.449,26,53,0.491,5,16,0.313,19,25,0.76,86,29,89,0.326,26,68,0.382,3,21,0.143,13,15,0.867,74,2016-01-10,UTA,LAL
12310,10,@,L 86-114 ,240,34,78,0.436,28,58,0.483,6,20,0.3,12,19,0.632,86,44,79,0.557,36,50,0.72,8,29,0.276,18,24,0.75,114,2016-01-16,BRK,ATL
12311,11,Home,L 86-108 ,240,33,75,0.44,27,59,0.458,6,16,0.375,14,18,0.778,86,43,75,0.573,34,59,0.576,9,16,0.563,13,15,0.867,108,2016-01-22,BRK,UTA
12312,12,Home,L 86-124 ,240,35,84,0.417,29,57,0.509,6,27,0.222,10,14,0.714,86,48,92,0.522,38,72,0.528,10,20,0.5,18,25,0.72,124,2016-02-03,PHI,ATL
12313,13,@,L 86-105 ,240,35,83,0.422,31,66,0.47,4,17,0.235,12,15,0.8,86,39,78,0.5,27,53,0.509,12,25,0.48,15,20,0.75,105,2016-02-18,SAS,LAC
12314,14,@,L 86-98 ,240,35,82,0.427,28,59,0.475,7,23,0.304,9,17,0.529,86,36,78,0.462,29,56,0.518,7,22,0.318,19,26,0.731,98,2016-02-19,DET,WAS
12315,15,Home,L 86-94 ,240,35,89,0.393,27,65,0.415,8,24,0.333,8,8,1.0,86,36,81,0.444,28,60,0.467,8,21,0.381,14,15,0.933,94,2016-03-03,NOP,SAS
12316,16,@,L 86-96 ,240,34,92,0.37,31,79,0.392,3,13,0.231,15,17,0.882,86,37,75,0.493,32,56,0.571,5,19,0.263,17,25,0.68,96,2016-03-17,MEM,MIL
12317,17,Home,L 86-101 ,240,33,78,0.423,25,51,0.49,8,27,0.296,12,19,0.632,86,39,81,0.481,29,54,0.537,10,27,0.37,13,17,0.765,101,2016-04-03,PHO,UTA
12318,18,Home,L 86-88 ,240,32,68,0.471,27,51,0.529,5,17,0.294,17,21,0.81,86,32,72,0.444,25,55,0.455,7,17,0.412,17,19,0.895,88,2016-04-05,UTA,SAS
12319,19,@,L 86-88 ,240,34,78,0.436,28,58,0.483,6,20,0.3,12,18,0.667,86,33,80,0.413,23,47,0.489,10,33,0.303,12,14,0.857,88,2016-04-06,HOU,DAL
12320,20,Home,L 86-92 ,240,34,90,0.378,31,73,0.425,3,17,0.176,15,19,0.789,86,34,77,0.442,24,50,0.48,10,27,0.37,14,18,0.778,92,2016-04-10,SAS,GSW
12321,21,Home,L 86-100 ,240,30,80,0.375,19,54,0.352,11,26,0.423,15,24,0.625,86,37,83,0.446,31,63,0.492,6,20,0.3,20,22,0.909,100,2016-11-04,UTA,SAS
12322,22,@,L 86-103 ,240,31,94,0.33,24,69,0.348,7,25,0.28,17,20,0.85,86,40,84,0.476,33,64,0.516,7,20,0.35,16,22,0.727,103,2016-11-05,DEN,DET
12323,23,@,L 86-88 ,240,34,86,0.395,28,69,0.406,6,17,0.353,12,17,0.706,86,31,78,0.397,22,50,0.44,9,28,0.321,17,27,0.63,88,2016-11-05,WAS,ORL
12324,24,Home,W 86-75 (OT),265,33,88,0.375,24,50,0.48,9,38,0.237,11,12,0.917,86,30,82,0.366,24,53,0.453,6,29,0.207,9,12,0.75,75,2016-11-06,DAL,MIL
12325,25,@,L 86-96 ,240,32,76,0.421,27,51,0.529,5,25,0.2,17,21,0.81,86,36,81,0.444,27,61,0.443,9,20,0.45,15,19,0.789,96,2016-11-11,DET,SAS
12326,26,@,L 86-110 ,240,31,83,0.373,22,51,0.431,9,32,0.281,15,19,0.789,86,43,84,0.512,37,59,0.627,6,25,0.24,18,20,0.9,110,2016-11-17,PHI,MIN
12327,27,@,L 86-88 ,240,25,82,0.305,18,54,0.333,7,28,0.25,29,40,0.725,86,31,87,0.356,25,67,0.373,6,20,0.3,20,30,0.667,88,2016-12-08,POR,MEM
12328,28,@,L 86-103 ,240,35,86,0.407,31,64,0.484,4,22,0.182,12,15,0.8,86,37,81,0.457,25,50,0.5,12,31,0.387,17,23,0.739,103,2016-12-13,MEM,CLE
12329,29,Home,L 86-98 ,240,26,72,0.361,20,49,0.408,6,23,0.261,28,37,0.757,86,35,82,0.427,23,52,0.442,12,30,0.4,16,19,0.842,98,2016-12-21,DET,MEM
12330,30,@,L 86-91 ,240,36,87,0.414,29,70,0.414,7,17,0.412,7,10,0.7,86,35,73,0.479,27,53,0.509,8,20,0.4,13,20,0.65,91,2016-12-31,PHO,UTA
12331,31,@,L 86-98 ,240,31,84,0.369,24,57,0.421,7,27,0.259,17,21,0.81,86,36,86,0.419,27,56,0.482,9,30,0.3,17,25,0.68,98,2017-01-08,MIA,LAC
12332,32,@,L 86-102 ,240,28,82,0.341,19,52,0.365,9,30,0.3,21,28,0.75,86,40,93,0.43,30,63,0.476,10,30,0.333,12,16,0.75,102,2017-01-11,CLE,POR
12333,33,@,L 86-96 ,240,33,85,0.388,30,65,0.462,3,20,0.15,17,21,0.81,86,39,86,0.453,34,68,0.5,5,18,0.278,13,14,0.929,96,2017-01-13,OKC,MIN
12334,34,Home,L 86-112 ,240,32,81,0.395,27,56,0.482,5,25,0.2,17,18,0.944,86,45,95,0.474,36,73,0.493,9,22,0.409,13,16,0.813,112,2017-01-23,BRK,SAS
12335,35,Home,L 86-112 ,240,30,83,0.361,21,52,0.404,9,31,0.29,17,25,0.68,86,43,89,0.483,30,58,0.517,13,31,0.419,13,19,0.684,112,2017-01-27,ATL,WAS
12336,36,@,L 86-102 ,240,31,80,0.388,24,57,0.421,7,23,0.304,17,24,0.708,86,37,84,0.44,27,59,0.458,10,25,0.4,18,23,0.783,102,2017-01-27,MIL,TOR
12337,37,@,L 86-102 ,240,30,88,0.341,21,63,0.333,9,25,0.36,17,23,0.739,86,38,89,0.427,32,68,0.471,6,21,0.286,20,27,0.741,102,2017-02-02,PHI,SAS
12338,38,@,L 86-113 ,240,27,78,0.346,20,51,0.392,7,27,0.259,25,28,0.893,86,41,78,0.526,31,50,0.62,10,28,0.357,21,27,0.778,113,2017-02-04,ORL,ATL
12339,39,@,L 86-109 ,240,33,89,0.371,26,65,0.4,7,24,0.292,13,17,0.765,86,41,84,0.488,28,48,0.583,13,36,0.361,14,21,0.667,109,2017-02-15,SAC,GSW
12340,40,@,L 86-105 ,240,32,85,0.376,24,60,0.4,8,25,0.32,14,26,0.538,86,37,81,0.457,29,54,0.537,8,27,0.296,23,24,0.958,105,2017-02-25,ATL,ORL
12341,41,@,L 86-109 ,240,40,103,0.388,37,80,0.463,3,23,0.13,3,17,0.176,86,39,78,0.5,30,53,0.566,9,25,0.36,22,23,0.957,109,2017-03-01,DET,NOP
12342,42,Home,L 86-99 ,240,37,84,0.44,31,54,0.574,6,30,0.2,6,9,0.667,86,37,84,0.44,27,55,0.491,10,29,0.345,15,19,0.789,99,2017-03-08,GSW,BOS
12343,43,@,W 85-84 ,240,35,79,0.443,33,63,0.524,2,16,0.125,13,21,0.619,85,32,81,0.395,27,56,0.482,5,25,0.2,15,19,0.789,84,2011-12-26,NOP,PHO
12344,44,Home,L 85-90 ,240,36,79,0.456,30,64,0.469,6,15,0.4,7,13,0.538,85,32,81,0.395,25,65,0.385,7,16,0.438,19,22,0.864,90,2011-12-28,TOR,IND
12345,45,@,L 85-105 ,240,35,93,0.376,33,76,0.434,2,17,0.118,13,20,0.65,85,43,85,0.506,34,59,0.576,9,26,0.346,10,13,0.769,105,2011-12-29,SAS,HOU
12346,46,@,L 85-96 ,240,34,79,0.43,31,63,0.492,3,16,0.188,14,15,0.933,85,35,67,0.522,28,51,0.549,7,16,0.438,19,19,1.0,96,2011-12-30,DET,BOS
12347,47,Home,L 85-90 ,240,28,78,0.359,18,43,0.419,10,35,0.286,19,25,0.76,85,30,68,0.441,23,51,0.451,7,17,0.412,23,29,0.793,90,2012-01-02,NYK,TOR
12348,48,Home,W 85-73 ,240,32,66,0.485,29,53,0.547,3,13,0.231,18,28,0.643,85,29,95,0.305,27,74,0.365,2,21,0.095,13,16,0.813,73,2012-01-03,UTA,MIL
12349,49,@,L 85-103 ,240,34,93,0.366,32,81,0.395,2,12,0.167,15,18,0.833,85,39,85,0.459,31,66,0.47,8,19,0.421,17,25,0.68,103,2012-01-04,WAS,ORL
12350,50,Home,L 85-97 ,240,33,73,0.452,27,56,0.482,6,17,0.353,13,19,0.684,85,31,80,0.388,16,49,0.327,15,31,0.484,20,27,0.741,97,2012-01-06,TOR,NJN
12351,51,@,L 85-94 ,240,33,80,0.413,29,63,0.46,4,17,0.235,15,21,0.714,85,36,71,0.507,34,63,0.54,2,8,0.25,20,30,0.667,94,2012-01-06,MEM,UTA
12352,52,@,L 85-112 ,240,34,86,0.395,30,67,0.448,4,19,0.211,13,21,0.619,85,47,83,0.566,42,70,0.6,5,13,0.385,13,19,0.684,112,2012-01-10,SAC,PHI
12353,53,Home,L 85-90 ,240,29,64,0.453,25,53,0.472,4,11,0.364,23,32,0.719,85,35,79,0.443,29,63,0.46,6,16,0.375,14,25,0.56,90,2012-01-11,BOS,DAL
12354,54,Home,L 85-95 ,240,36,80,0.45,35,64,0.547,1,16,0.063,12,17,0.706,85,35,73,0.479,28,53,0.528,7,20,0.35,18,26,0.692,95,2012-01-11,NOP,OKC
12355,55,Home,W 85-79 ,240,32,77,0.416,26,55,0.473,6,22,0.273,15,19,0.789,85,32,81,0.395,29,66,0.439,3,15,0.2,12,18,0.667,79,2012-01-11,NYK,PHI
12356,56,@,L 85-93 ,240,35,79,0.443,30,68,0.441,5,11,0.455,10,21,0.476,85,30,75,0.4,22,52,0.423,8,23,0.348,25,34,0.735,93,2012-01-18,DET,MIN
12357,57,@,W 85-83 (OT),265,36,84,0.429,34,67,0.507,2,17,0.118,11,18,0.611,85,29,87,0.333,25,66,0.379,4,21,0.19,21,27,0.778,83,2012-01-18,SAS,ORL
12358,58,@,L 85-92 ,240,34,68,0.5,28,52,0.538,6,16,0.375,11,17,0.647,85,32,70,0.457,27,52,0.519,5,18,0.278,23,26,0.885,92,2012-01-24,CLE,MIA
12359,59,Home,L 85-106 ,240,31,64,0.484,21,41,0.512,10,23,0.435,13,29,0.448,85,45,88,0.511,37,71,0.521,8,17,0.471,8,11,0.727,106,2012-01-29,ORL,IND
12360,60,@,W 85-81 ,240,29,72,0.403,20,47,0.426,9,25,0.36,18,23,0.783,85,29,85,0.341,25,63,0.397,4,22,0.182,19,21,0.905,81,2012-02-04,ORL,IND
12361,61,Home,W 85-80 ,240,35,94,0.372,31,83,0.373,4,11,0.364,11,15,0.733,85,31,79,0.392,27,60,0.45,4,19,0.211,14,19,0.737,80,2012-02-08,MEM,MIN
12362,62,@,L 85-92 ,240,30,80,0.375,24,56,0.429,6,24,0.25,19,23,0.826,85,33,77,0.429,28,56,0.5,5,21,0.238,21,34,0.618,92,2012-02-10,LAL,NYK
12363,63,@,L 85-111 ,240,32,90,0.356,29,77,0.377,3,13,0.231,18,24,0.75,85,42,77,0.545,37,63,0.587,5,14,0.357,22,34,0.647,111,2012-02-14,UTA,OKC
12364,64,@,L 85-100 ,240,33,87,0.379,29,69,0.42,4,18,0.222,15,20,0.75,85,39,77,0.506,32,53,0.604,7,24,0.292,15,17,0.882,100,2012-02-15,SAC,NYK
12365,65,Home,L 85-89 ,240,31,75,0.413,27,51,0.529,4,24,0.167,19,29,0.655,85,32,75,0.427,25,63,0.397,7,12,0.583,18,23,0.783,89,2012-02-17,NYK,NOH
12366,66,@,L 85-94 ,240,33,90,0.367,27,69,0.391,6,21,0.286,13,17,0.765,85,33,76,0.434,24,47,0.511,9,29,0.31,19,26,0.731,94,2012-02-17,MIL,ORL
12367,67,Home,L 85-97 ,240,33,84,0.393,30,71,0.423,3,13,0.231,16,27,0.593,85,34,85,0.4,24,63,0.381,10,22,0.455,19,25,0.76,97,2012-02-18,CHI,NJN
12368,68,@,L 85-101 ,240,32,81,0.395,27,67,0.403,5,14,0.357,16,20,0.8,85,37,72,0.514,27,53,0.509,10,19,0.526,17,24,0.708,101,2012-02-19,UTA,HOU
12369,69,Home,L 85-92 ,240,29,85,0.341,24,62,0.387,5,23,0.217,22,33,0.667,85,33,86,0.384,26,67,0.388,7,19,0.368,19,24,0.792,92,2012-02-19,BRK,MIL
12370,70,@,L 85-100 ,240,30,78,0.385,26,65,0.4,4,13,0.308,21,23,0.913,85,36,77,0.468,29,52,0.558,7,25,0.28,21,25,0.84,100,2012-02-23,LAL,OKC
12371,71,@,L 85-88 ,240,35,75,0.467,33,58,0.569,2,17,0.118,13,18,0.722,85,29,75,0.387,22,55,0.4,7,20,0.35,23,28,0.821,88,2012-02-28,TOR,HOU
12372,72,@,W 85-82 ,240,34,83,0.41,33,71,0.465,1,12,0.083,16,17,0.941,85,31,92,0.337,27,74,0.365,4,18,0.222,16,26,0.615,82,2012-02-29,GSW,ATL
12373,73,@,L 85-104 ,240,35,89,0.393,30,70,0.429,5,19,0.263,10,18,0.556,85,41,84,0.488,36,63,0.571,5,21,0.238,17,22,0.773,104,2012-02-29,MIN,LAL
12374,74,@,L 85-96 ,240,35,79,0.443,31,56,0.554,4,23,0.174,11,14,0.786,85,39,80,0.488,37,68,0.544,2,12,0.167,16,19,0.842,96,2012-02-29,DAL,MEM
12375,75,@,L 85-95 ,240,32,84,0.381,26,61,0.426,6,23,0.261,15,23,0.652,85,31,80,0.388,24,54,0.444,7,26,0.269,26,30,0.867,95,2012-03-06,NYK,DAL
12376,76,@,L 85-88 (OT),265,34,81,0.42,31,59,0.525,3,22,0.136,14,17,0.824,85,37,93,0.398,34,83,0.41,3,10,0.3,11,12,0.917,88,2012-03-06,LAL,DET
12377,77,@,L 85-86 ,240,31,73,0.425,23,54,0.426,8,19,0.421,15,22,0.682,85,38,68,0.559,37,60,0.617,1,8,0.125,9,15,0.6,86,2012-03-09,ATL,DET
12378,78,Home,L 85-94 ,240,31,83,0.373,26,60,0.433,5,23,0.217,18,21,0.857,85,33,67,0.493,28,54,0.519,5,13,0.385,23,27,0.852,94,2012-03-12,LAC,BOS
12379,79,@,W 85-59 ,240,35,79,0.443,28,61,0.459,7,18,0.389,8,11,0.727,85,24,68,0.353,20,48,0.417,4,20,0.2,7,18,0.389,59,2012-03-19,CHI,ORL
12380,80,@,W 85-83 ,240,31,74,0.419,27,56,0.482,4,18,0.222,19,28,0.679,85,30,71,0.423,25,53,0.472,5,18,0.278,18,23,0.783,83,2012-03-22,IND,WAS
12381,81,@,L 85-101 ,240,33,78,0.423,24,63,0.381,9,15,0.6,10,14,0.714,85,36,72,0.5,31,56,0.554,5,16,0.313,24,33,0.727,101,2012-03-24,MEM,LAC
12382,82,@,L 85-97 ,240,31,62,0.5,29,51,0.569,2,11,0.182,21,31,0.677,85,37,74,0.5,29,48,0.604,8,26,0.308,15,21,0.714,97,2012-03-26,NOP,LAC
12383,83,@,L 85-103 ,240,28,70,0.4,19,47,0.404,9,23,0.391,20,28,0.714,85,45,92,0.489,35,73,0.479,10,19,0.526,3,5,0.6,103,2012-03-27,CLE,PHI
12384,84,@,L 85-106 ,240,33,78,0.423,24,54,0.444,9,24,0.375,10,13,0.769,85,39,80,0.488,34,63,0.54,5,17,0.294,23,27,0.852,106,2012-03-29,DAL,MIA
12385,85,@,L 85-88 ,240,39,92,0.424,37,82,0.451,2,10,0.2,5,10,0.5,85,32,77,0.416,25,55,0.455,7,22,0.318,17,22,0.773,88,2012-03-31,NOP,LAL
12386,86,@,L 85-95 ,240,35,83,0.422,28,67,0.418,7,16,0.438,8,14,0.571,85,40,80,0.5,36,65,0.554,4,15,0.267,11,16,0.688,95,2012-04-04,MEM,DAL
12387,87,Home,L 85-93 ,240,35,84,0.417,31,67,0.463,4,17,0.235,11,15,0.733,85,36,80,0.45,31,61,0.508,5,19,0.263,16,24,0.667,93,2012-04-05,SAC,LAC
12388,88,Home,L 85-113 ,240,32,82,0.39,29,73,0.397,3,9,0.333,18,22,0.818,85,40,83,0.482,29,58,0.5,11,25,0.44,22,26,0.846,113,2012-04-09,CHA,WAS
12389,89,@,L 85-94 ,240,34,84,0.405,30,66,0.455,4,18,0.222,13,18,0.722,85,37,74,0.5,33,61,0.541,4,13,0.308,16,20,0.8,94,2012-04-09,LAC,MEM
12390,90,@,L 85-93 ,240,34,93,0.366,23,58,0.397,11,35,0.314,6,10,0.6,85,39,78,0.5,36,63,0.571,3,15,0.2,12,15,0.8,93,2012-04-10,ORL,WAS
12391,91,Home,L 85-109 ,240,31,70,0.443,25,59,0.424,6,11,0.545,17,23,0.739,85,43,82,0.524,38,69,0.551,5,13,0.385,18,21,0.857,109,2012-04-12,CHA,DET
12392,92,@,L 85-96 ,240,33,73,0.452,31,62,0.5,2,11,0.182,17,21,0.81,85,38,69,0.551,32,56,0.571,6,13,0.462,14,21,0.667,96,2012-04-13,UTA,NOH
12393,93,Home,L 85-93 ,240,31,73,0.425,22,43,0.512,9,30,0.3,14,23,0.609,85,36,78,0.462,32,61,0.525,4,17,0.235,17,21,0.81,93,2012-04-15,NYK,MIA
12394,94,@,W 85-80 ,240,34,75,0.453,32,67,0.478,2,8,0.25,15,21,0.714,85,32,79,0.405,29,70,0.414,3,9,0.333,13,18,0.722,80,2012-04-20,MEM,CHA
12395,95,Home,L 85-96 ,240,34,77,0.442,30,60,0.5,4,17,0.235,13,18,0.722,85,40,91,0.44,36,75,0.48,4,16,0.25,12,16,0.75,96,2012-04-25,CLE,WAS
12396,96,Home,L 85-90 ,240,36,81,0.444,30,65,0.462,6,16,0.375,7,9,0.778,85,36,101,0.356,31,85,0.365,5,16,0.313,13,18,0.722,90,2012-04-25,MIL,PHI
12397,97,Home,L 85-87 ,240,32,80,0.4,28,59,0.475,4,21,0.19,17,22,0.773,85,33,86,0.384,28,69,0.406,5,17,0.294,16,23,0.696,87,2012-10-31,PHO,GSW
12398,98,Home,L 85-95 (OT),265,34,96,0.354,29,70,0.414,5,26,0.192,12,18,0.667,85,39,93,0.419,29,69,0.42,10,24,0.417,7,12,0.583,95,2012-11-03,HOU,POR
12399,99,@,L 85-93 ,240,31,76,0.408,22,49,0.449,9,27,0.333,14,15,0.933,85,35,94,0.372,29,75,0.387,6,19,0.316,17,23,0.739,93,2012-11-09,HOU,MEM
12400,0,@,L 85-89 ,240,35,79,0.443,25,55,0.455,10,24,0.417,5,7,0.714,85,34,80,0.425,27,64,0.422,7,16,0.438,14,24,0.583,89,2012-11-10,WAS,IND
12401,1,@,L 85-99 ,240,30,80,0.375,25,60,0.417,5,20,0.25,20,31,0.645,85,38,91,0.418,35,75,0.467,3,16,0.188,20,25,0.8,99,2012-11-14,IND,MIL
12402,2,@,L 85-96 ,240,33,86,0.384,28,59,0.475,5,27,0.185,14,19,0.737,85,33,78,0.423,27,57,0.474,6,21,0.286,24,29,0.828,96,2012-11-24,MIN,GSW
12403,3,@,L 85-98 ,240,34,78,0.436,27,61,0.443,7,17,0.412,10,13,0.769,85,39,92,0.424,34,75,0.453,5,17,0.294,15,21,0.714,98,2012-11-25,POR,BRK
12404,4,@,L 85-95 ,240,34,93,0.366,29,75,0.387,5,18,0.278,12,16,0.75,85,34,87,0.391,26,68,0.382,8,19,0.421,19,27,0.704,95,2012-11-30,MIL,MIN
12405,5,Home,L 85-95 ,240,31,85,0.365,26,69,0.377,5,16,0.313,18,25,0.72,85,34,72,0.472,30,57,0.526,4,15,0.267,23,27,0.852,95,2012-12-05,CLE,CHI
12406,6,@,L 85-93 ,240,27,84,0.321,19,61,0.311,8,23,0.348,23,28,0.821,85,34,78,0.436,27,65,0.415,7,13,0.538,18,18,1.0,93,2012-12-08,NYK,CHI
12407,7,@,L 85-98 ,240,32,86,0.372,29,67,0.433,3,19,0.158,18,21,0.857,85,39,96,0.406,33,79,0.418,6,17,0.353,14,24,0.583,98,2012-12-12,SAC,MIL
12408,8,@,L 85-95 ,240,35,81,0.432,32,69,0.464,3,12,0.25,12,16,0.75,85,35,77,0.455,27,63,0.429,8,14,0.571,17,27,0.63,95,2012-12-14,PHI,IND
12409,9,@,L 85-99 ,240,34,92,0.37,27,72,0.375,7,20,0.35,10,11,0.909,85,41,86,0.477,32,65,0.492,9,21,0.429,8,11,0.727,99,2012-12-14,GSW,ORL
12410,10,Home,L 85-111 ,240,30,83,0.361,23,62,0.371,7,21,0.333,18,25,0.72,85,44,82,0.537,39,71,0.549,5,11,0.455,18,24,0.75,111,2012-12-15,MIL,LAC
12411,11,@,L 85-97 ,240,33,79,0.418,25,57,0.439,8,22,0.364,11,16,0.688,85,37,87,0.425,30,64,0.469,7,23,0.304,16,24,0.667,97,2012-12-21,SAC,LAC
12412,12,Home,L 85-106 ,240,33,88,0.375,28,63,0.444,5,25,0.2,14,21,0.667,85,43,94,0.457,31,66,0.47,12,28,0.429,8,14,0.571,106,2012-12-28,DAL,DEN
12413,13,@,L 85-104 ,240,33,76,0.434,29,63,0.46,4,13,0.308,15,24,0.625,85,40,98,0.408,32,77,0.416,8,21,0.381,16,17,0.941,104,2012-12-29,MIA,MIL
12414,14,@,L 85-89 ,240,36,85,0.424,32,68,0.471,4,17,0.235,9,11,0.818,85,34,76,0.447,26,53,0.491,8,23,0.348,13,16,0.813,89,2012-12-29,PHI,POR
12415,15,Home,W 85-84 ,240,35,85,0.412,32,70,0.457,3,15,0.2,12,21,0.571,85,31,75,0.413,21,46,0.457,10,29,0.345,12,20,0.6,84,2013-01-04,DET,ATL
12416,16,@,L 85-109 ,240,34,84,0.405,23,60,0.383,11,24,0.458,6,8,0.75,85,39,75,0.52,29,58,0.5,10,17,0.588,21,27,0.778,109,2013-01-04,PHI,OKC
12417,17,Home,W 85-69 ,240,34,78,0.436,31,71,0.437,3,7,0.429,14,20,0.7,85,29,85,0.341,27,75,0.36,2,10,0.2,9,15,0.6,69,2013-01-18,MEM,SAC
12418,18,@,W 85-82 (OT),265,34,84,0.405,34,79,0.43,0,5,0.0,17,28,0.607,85,31,85,0.365,28,71,0.394,3,14,0.214,17,21,0.81,82,2013-01-19,MEM,CHI
12419,19,Home,L 85-88 ,240,34,84,0.405,28,63,0.444,6,21,0.286,11,17,0.647,85,31,74,0.419,19,50,0.38,12,24,0.5,14,20,0.7,88,2013-01-21,NYK,BRK
12420,20,Home,L 85-90 ,240,37,84,0.44,33,70,0.471,4,14,0.286,7,11,0.636,85,34,81,0.42,31,63,0.492,3,18,0.167,19,26,0.731,90,2013-01-21,PHI,SAS
12421,21,Home,W 85-82 ,240,31,71,0.437,28,57,0.491,3,14,0.214,20,26,0.769,85,34,82,0.415,30,69,0.435,4,13,0.308,10,14,0.714,82,2013-01-23,CHI,DET
12422,22,@,L 85-93 ,240,32,81,0.395,26,69,0.377,6,12,0.5,15,21,0.714,85,35,78,0.449,28,60,0.467,7,18,0.389,16,25,0.64,93,2013-01-28,CHA,CHI
12423,23,Home,L 85-105 ,240,31,69,0.449,26,52,0.5,5,17,0.294,18,24,0.75,85,43,83,0.518,32,64,0.5,11,19,0.579,8,14,0.571,105,2013-01-30,BRK,MIA
12424,24,Home,W 85-76 ,240,35,78,0.449,34,71,0.479,1,7,0.143,14,17,0.824,85,34,83,0.41,29,63,0.46,5,20,0.25,3,3,1.0,76,2013-02-01,MEM,WAS
12425,25,Home,L 85-100 ,240,28,75,0.373,24,57,0.421,4,18,0.222,25,32,0.781,85,40,75,0.533,37,63,0.587,3,12,0.25,17,23,0.739,100,2013-02-03,TOR,MIA
12426,26,@,L 85-99 ,240,38,90,0.422,35,77,0.455,3,13,0.231,6,12,0.5,85,36,79,0.456,22,45,0.489,14,34,0.412,13,16,0.813,99,2013-02-04,DET,NYK
12427,27,@,L 85-91 ,240,35,85,0.412,32,72,0.444,3,13,0.231,12,17,0.706,85,36,83,0.434,29,62,0.468,7,21,0.333,12,18,0.667,91,2013-02-12,PHO,LAL
12428,28,@,L 85-96 ,240,34,70,0.486,31,59,0.525,3,11,0.273,14,22,0.636,85,35,79,0.443,26,61,0.426,9,18,0.5,17,25,0.68,96,2013-02-13,WAS,DET
12429,29,@,L 85-96 ,240,32,72,0.444,27,57,0.474,5,15,0.333,16,23,0.696,85,38,73,0.521,32,58,0.552,6,15,0.4,14,14,1.0,96,2013-03-02,BRK,CHI
12430,30,@,L 85-91 ,240,31,76,0.408,25,56,0.446,6,20,0.3,17,28,0.607,85,38,87,0.437,34,75,0.453,4,12,0.333,11,18,0.611,91,2013-03-06,POR,MEM
12431,31,@,L 85-96 ,240,34,79,0.43,32,67,0.478,2,12,0.167,15,17,0.882,85,38,81,0.469,34,68,0.5,4,13,0.308,16,20,0.8,96,2013-03-09,NOP,MEM
12432,32,Home,L 85-96 ,240,31,72,0.431,25,46,0.543,6,26,0.231,17,18,0.944,85,37,68,0.544,31,56,0.554,6,12,0.5,16,21,0.762,96,2013-03-13,LAC,MEM
12433,33,Home,L 85-100 ,240,31,69,0.449,25,49,0.51,6,20,0.3,17,22,0.773,85,39,90,0.433,31,62,0.5,8,28,0.286,14,18,0.778,100,2013-03-26,BOS,NYK
12434,34,@,L 85-104 ,240,35,86,0.407,32,66,0.485,3,20,0.15,12,15,0.8,85,39,79,0.494,35,67,0.522,4,12,0.333,22,31,0.71,104,2013-04-06,IND,WAS
12435,35,@,L 85-91 ,240,34,90,0.378,33,77,0.429,1,13,0.077,16,22,0.727,85,32,89,0.36,25,72,0.347,7,17,0.412,20,24,0.833,91,2013-04-07,ORL,CLE
12436,36,@,L 85-99 ,240,33,73,0.452,30,58,0.517,3,15,0.2,16,25,0.64,85,39,73,0.534,30,55,0.545,9,18,0.5,12,17,0.706,99,2013-04-07,CHI,DET
12437,37,@,L 85-95 ,240,34,87,0.391,25,58,0.431,9,29,0.31,8,12,0.667,85,37,80,0.463,33,71,0.465,4,9,0.444,17,24,0.708,95,2013-04-13,MIL,CHA
12438,38,Home,L 85-91 ,240,30,82,0.366,22,55,0.4,8,27,0.296,17,24,0.708,85,38,94,0.404,33,73,0.452,5,21,0.238,10,14,0.714,91,2013-11-01,LAL,SAS
12439,39,@,L 85-96 ,240,31,80,0.388,25,61,0.41,6,19,0.316,17,26,0.654,85,38,87,0.437,35,78,0.449,3,9,0.333,17,22,0.773,96,2013-11-08,LAL,NOP
12440,40,Home,L 85-96 ,240,36,78,0.462,33,66,0.5,3,12,0.25,10,14,0.714,85,36,82,0.439,27,62,0.435,9,20,0.45,15,22,0.682,96,2013-11-09,SAC,POR
12441,41,Home,L 85-109 ,240,34,82,0.415,29,63,0.46,5,19,0.263,12,16,0.75,85,44,89,0.494,31,61,0.508,13,28,0.464,8,11,0.727,109,2013-11-11,PHI,SAS
12442,42,@,L 85-109 ,240,32,99,0.323,25,79,0.316,7,20,0.35,14,20,0.7,85,41,72,0.569,32,51,0.627,9,21,0.429,18,24,0.75,109,2013-11-19,BOS,HOU
12443,43,@,L 85-93 ,240,35,87,0.402,29,65,0.446,6,22,0.273,9,12,0.75,85,36,71,0.507,32,56,0.571,4,15,0.267,17,24,0.708,93,2013-11-20,DET,ATL
12444,44,@,L 85-92 ,240,35,84,0.417,31,65,0.477,4,19,0.211,11,15,0.733,85,36,78,0.462,28,61,0.459,8,17,0.471,12,20,0.6,92,2013-11-30,BOS,MIL
12445,45,@,L 85-94 ,240,30,75,0.4,24,53,0.453,6,22,0.273,19,20,0.95,85,36,86,0.419,26,69,0.377,10,17,0.588,12,17,0.706,94,2013-12-09,ORL,MEM
12446,46,Home,L 85-88 ,240,39,89,0.438,37,76,0.487,2,13,0.154,5,8,0.625,85,30,77,0.39,23,57,0.404,7,20,0.35,21,23,0.913,88,2013-12-14,CHA,LAL
12447,47,@,L 85-118 ,240,35,94,0.372,32,76,0.421,3,18,0.167,12,15,0.8,85,45,86,0.523,35,60,0.583,10,26,0.385,18,24,0.75,118,2013-12-20,UTA,ATL
12448,48,Home,L 85-88 ,240,36,83,0.434,34,71,0.479,2,12,0.167,11,16,0.688,85,32,83,0.386,22,62,0.355,10,21,0.476,14,18,0.778,88,2013-12-21,CHA,UTA
12449,49,Home,L 85-89 ,240,30,80,0.375,21,57,0.368,9,23,0.391,16,20,0.8,85,33,80,0.413,25,55,0.455,8,25,0.32,15,24,0.625,89,2013-12-27,CHA,OKC
12450,50,@,W 85-79 ,240,29,69,0.42,25,55,0.455,4,14,0.286,23,31,0.742,85,30,82,0.366,28,73,0.384,2,9,0.222,17,21,0.81,79,2013-12-31,TOR,CHI
12451,51,@,L 85-112 ,240,29,76,0.382,23,55,0.418,6,21,0.286,21,22,0.955,85,47,85,0.553,36,51,0.706,11,34,0.324,7,10,0.7,112,2014-01-01,CHA,LAC
12452,52,@,L 85-89 ,240,32,86,0.372,29,67,0.433,3,19,0.158,18,23,0.783,85,33,81,0.407,24,55,0.436,9,26,0.346,14,20,0.7,89,2014-01-07,DET,NYK
12453,53,@,L 85-101 ,240,32,81,0.395,20,50,0.4,12,31,0.387,9,14,0.643,85,35,86,0.407,25,61,0.41,10,25,0.4,21,27,0.778,101,2014-01-11,MIL,OKC
12454,54,@,L 85-93 ,240,34,73,0.466,27,53,0.509,7,20,0.35,10,14,0.714,85,32,76,0.421,25,53,0.472,7,23,0.304,22,32,0.688,93,2014-01-22,DAL,TOR
12455,55,@,W 85-79 ,240,33,84,0.393,27,59,0.458,6,25,0.24,13,18,0.722,85,28,75,0.373,21,49,0.429,7,26,0.269,16,19,0.842,79,2014-01-26,BRK,BOS
12456,56,Home,L 85-88 ,240,30,80,0.375,23,57,0.404,7,23,0.304,18,23,0.783,85,34,90,0.378,24,68,0.353,10,22,0.455,10,15,0.667,88,2014-01-28,GSW,WAS
12457,57,Home,L 85-89 ,240,33,76,0.434,26,51,0.51,7,25,0.28,12,15,0.8,85,34,74,0.459,29,56,0.518,5,18,0.278,16,20,0.8,89,2014-02-04,ATL,IND
12458,58,@,L 85-100 ,240,35,80,0.438,25,57,0.439,10,23,0.435,5,9,0.556,85,43,85,0.506,35,65,0.538,8,20,0.4,6,13,0.462,100,2014-02-11,ATL,CHI
12459,59,Home,L 85-114 ,240,31,87,0.356,26,65,0.4,5,22,0.227,18,27,0.667,85,40,87,0.46,34,69,0.493,6,18,0.333,28,33,0.848,114,2014-02-18,PHI,CLE
12460,60,@,L 85-106 ,240,29,83,0.349,27,62,0.435,2,21,0.095,25,27,0.926,85,42,82,0.512,37,57,0.649,5,25,0.2,17,25,0.68,106,2014-02-21,SAS,PHO
12461,61,@,L 85-96 ,240,32,83,0.386,22,55,0.4,10,28,0.357,11,14,0.786,85,35,83,0.422,31,71,0.437,4,12,0.333,22,30,0.733,96,2014-03-03,NYK,DET
12462,62,@,W 85-77 ,240,35,78,0.449,30,70,0.429,5,8,0.625,10,18,0.556,85,31,75,0.413,29,62,0.468,2,13,0.154,13,14,0.929,77,2014-03-07,MEM,CHI
12463,63,@,L 85-108 ,240,30,82,0.366,25,64,0.391,5,18,0.278,20,31,0.645,85,41,80,0.513,29,55,0.527,12,25,0.48,14,17,0.824,108,2014-03-11,DAL,GSW
12464,64,Home,L 85-98 ,240,35,82,0.427,26,57,0.456,9,25,0.36,6,9,0.667,85,38,78,0.487,33,60,0.55,5,18,0.278,17,22,0.773,98,2014-03-12,WAS,CHA
12465,65,@,L 85-119 ,240,31,91,0.341,27,70,0.386,4,21,0.19,19,25,0.76,85,48,98,0.49,35,71,0.493,13,27,0.481,10,13,0.769,119,2014-03-14,LAL,SAS
12466,66,Home,L 85-97 ,240,29,84,0.345,24,62,0.387,5,22,0.227,22,31,0.71,85,31,75,0.413,18,50,0.36,13,25,0.52,22,28,0.786,97,2014-03-17,CHI,OKC
12467,67,@,L 85-95 ,240,32,86,0.372,25,60,0.417,7,26,0.269,14,17,0.824,85,37,85,0.435,31,68,0.456,6,17,0.353,15,22,0.682,95,2014-03-25,POR,ORL
12468,68,Home,L 85-100 ,240,34,84,0.405,30,62,0.484,4,22,0.182,13,17,0.765,85,37,80,0.463,27,54,0.5,10,26,0.385,16,21,0.762,100,2014-03-27,ATL,POR
12469,69,@,L 85-98 ,240,35,73,0.479,29,48,0.604,6,25,0.24,9,19,0.474,85,36,78,0.462,26,56,0.464,10,22,0.455,16,19,0.842,98,2014-04-12,MIA,ATL
12470,70,@,L 85-114 ,240,30,79,0.38,22,54,0.407,8,25,0.32,17,23,0.739,85,46,87,0.529,38,67,0.567,8,20,0.4,14,17,0.824,114,2014-04-16,BRK,CLE
12471,71,@,L 85-116 ,240,32,82,0.39,24,59,0.407,8,23,0.348,13,21,0.619,85,44,84,0.524,33,61,0.541,11,23,0.478,17,19,0.895,116,2014-11-03,OKC,BRK
12472,72,Home,L 85-89 ,240,33,74,0.446,28,52,0.538,5,22,0.227,14,17,0.824,85,33,83,0.398,31,64,0.484,2,19,0.105,21,27,0.778,89,2014-11-10,LAC,SAS
12473,73,Home,L 85-91 ,240,36,83,0.434,30,57,0.526,6,26,0.231,7,12,0.583,85,27,71,0.38,17,44,0.386,10,27,0.37,27,28,0.964,91,2014-11-10,NYK,ATL
12474,74,Home,W 85-78 ,240,33,81,0.407,30,66,0.455,3,15,0.2,16,24,0.667,85,29,87,0.333,23,67,0.343,6,20,0.3,14,19,0.737,78,2014-11-11,MIL,OKC
12475,75,@,L 85-101 ,240,36,80,0.45,34,61,0.557,2,19,0.105,11,14,0.786,85,35,80,0.438,25,56,0.446,10,24,0.417,21,27,0.778,101,2014-11-14,MIL,ORL
12476,76,Home,L 85-102 ,240,32,82,0.39,22,45,0.489,10,37,0.27,11,15,0.733,85,38,81,0.469,29,56,0.518,9,25,0.36,17,22,0.773,102,2014-11-28,HOU,LAC
12477,77,Home,L 85-97 ,240,33,70,0.471,32,59,0.542,1,11,0.091,18,27,0.667,85,38,79,0.481,35,66,0.53,3,13,0.231,18,28,0.643,97,2014-11-30,SAC,MEM
12478,78,@,W 85-77 ,240,32,82,0.39,27,58,0.466,5,24,0.208,16,25,0.64,85,30,84,0.357,27,67,0.403,3,17,0.176,14,17,0.824,77,2014-12-03,PHI,MIN
12479,79,@,L 85-112 ,240,37,89,0.416,34,74,0.459,3,15,0.2,8,13,0.615,85,47,100,0.47,37,78,0.474,10,22,0.455,8,17,0.471,112,2014-12-04,NOP,GSW
12480,80,@,L 85-109 ,240,30,68,0.441,23,50,0.46,7,18,0.389,18,27,0.667,85,39,69,0.565,30,53,0.566,9,16,0.563,22,26,0.846,109,2014-12-05,MIA,MIL
12481,81,Home,L 85-95 ,240,34,88,0.386,30,73,0.411,4,15,0.267,13,16,0.813,85,40,90,0.444,35,73,0.479,5,17,0.294,10,12,0.833,95,2014-12-13,IND,POR
12482,82,Home,L 85-110 ,240,28,77,0.364,21,52,0.404,7,25,0.28,22,27,0.815,85,44,86,0.512,35,68,0.515,9,18,0.5,13,18,0.722,110,2014-12-27,BRK,IND
12483,83,Home,L 85-90 ,240,31,80,0.388,19,50,0.38,12,30,0.4,11,14,0.786,85,33,90,0.367,24,61,0.393,9,29,0.31,15,19,0.789,90,2014-12-27,MIL,ATL
12484,84,@,L 85-114 ,240,37,86,0.43,35,72,0.486,2,14,0.143,9,13,0.692,85,41,79,0.519,34,64,0.531,7,15,0.467,25,31,0.806,114,2015-01-03,MEM,DEN
12485,85,Home,L 85-92 ,240,33,74,0.446,27,55,0.491,6,19,0.316,13,17,0.765,85,38,79,0.481,36,69,0.522,2,10,0.2,14,17,0.824,92,2015-01-05,NOP,WAS
12486,86,@,L 85-94 ,240,31,65,0.477,28,58,0.483,3,7,0.429,20,27,0.741,85,36,85,0.424,24,54,0.444,12,31,0.387,10,10,1.0,94,2015-01-16,LAL,UTA
12487,87,@,L 85-99 ,240,33,83,0.398,28,70,0.4,5,13,0.385,14,20,0.7,85,36,84,0.429,29,60,0.483,7,24,0.292,20,27,0.741,99,2015-01-23,LAL,SAS
12488,88,Home,L 85-93 ,240,32,82,0.39,29,67,0.433,3,15,0.2,18,24,0.75,85,39,85,0.459,29,68,0.426,10,17,0.588,5,7,0.714,93,2015-01-28,NOP,DEN
12489,89,@,L 85-91 ,240,31,81,0.383,17,46,0.37,14,35,0.4,9,15,0.6,85,34,78,0.436,24,50,0.48,10,28,0.357,13,18,0.722,91,2015-01-31,PHI,ATL
12490,90,Home,W 85-74 ,240,34,91,0.374,31,80,0.388,3,11,0.273,14,17,0.824,85,27,78,0.346,21,58,0.362,6,20,0.3,14,18,0.778,74,2015-01-31,MEM,OKC
12491,91,Home,L 85-105 ,240,28,75,0.373,18,45,0.4,10,30,0.333,19,28,0.679,85,40,91,0.44,32,69,0.464,8,22,0.364,17,18,0.944,105,2015-01-31,SAS,LAC
12492,92,@,L 85-98 ,240,36,80,0.45,31,64,0.484,5,16,0.313,8,9,0.889,85,40,83,0.482,29,54,0.537,11,29,0.379,7,9,0.778,98,2015-02-06,MIA,SAS
12493,93,Home,W 85-83 ,240,34,75,0.453,30,63,0.476,4,12,0.333,13,21,0.619,85,33,91,0.363,28,63,0.444,5,28,0.179,12,17,0.706,83,2015-02-08,SAC,PHO
12494,94,Home,W 85-84 ,240,33,88,0.375,25,61,0.41,8,27,0.296,11,20,0.55,85,34,75,0.453,31,56,0.554,3,19,0.158,13,21,0.619,84,2015-03-04,BOS,UTA
12495,95,Home,L 85-100 ,240,32,82,0.39,29,64,0.453,3,18,0.167,18,25,0.72,85,42,92,0.457,34,72,0.472,8,20,0.4,8,10,0.8,100,2015-03-04,MIN,DEN
12496,96,@,L 85-88 ,240,38,93,0.409,36,79,0.456,2,14,0.143,7,9,0.778,85,37,90,0.411,35,78,0.449,2,12,0.167,12,16,0.75,88,2015-03-04,DET,NOP
12497,97,@,L 85-112 ,240,29,78,0.372,26,69,0.377,3,9,0.333,24,34,0.706,85,45,85,0.529,35,62,0.565,10,23,0.435,12,16,0.75,112,2015-03-04,SAC,SAS
12498,98,@,L 85-91 ,240,31,81,0.383,22,53,0.415,9,28,0.321,14,22,0.636,85,36,78,0.462,26,58,0.448,10,20,0.5,9,15,0.6,91,2015-03-07,WAS,MIL
12499,99,@,L 85-93 ,240,32,84,0.381,24,49,0.49,8,35,0.229,13,19,0.684,85,32,75,0.427,29,62,0.468,3,13,0.231,26,30,0.867,93,2015-03-10,DET,LAL
12500,0,@,L 85-88 ,240,32,84,0.381,24,61,0.393,8,23,0.348,13,22,0.591,85,33,69,0.478,27,55,0.491,6,14,0.429,16,24,0.667,88,2015-03-14,DET,UTA
12501,1,Home,W 85-84 ,240,29,83,0.349,21,58,0.362,8,25,0.32,19,26,0.731,85,32,86,0.372,28,66,0.424,4,20,0.2,16,21,0.762,84,2015-03-17,NOP,MIL
12502,2,Home,L 85-99 ,240,29,84,0.345,21,55,0.382,8,29,0.276,19,27,0.704,85,35,84,0.417,21,50,0.42,14,34,0.412,15,22,0.682,99,2015-03-25,DEN,PHI
12503,3,@,L 85-87 ,240,29,74,0.392,22,53,0.415,7,21,0.333,20,24,0.833,85,30,69,0.435,25,55,0.455,5,14,0.357,22,29,0.759,87,2015-04-04,UTA,PHO
12504,4,@,L 85-91 ,240,36,92,0.391,28,63,0.444,8,29,0.276,5,7,0.714,85,31,77,0.403,24,53,0.453,7,24,0.292,22,26,0.846,91,2015-04-15,ATL,CHI
12505,5,Home,L 85-105 ,240,30,87,0.345,22,52,0.423,8,35,0.229,17,26,0.654,85,40,79,0.506,27,52,0.519,13,27,0.481,12,18,0.667,105,2015-10-28,HOU,DEN
12506,6,@,L 85-102 ,240,30,86,0.349,25,69,0.362,5,17,0.294,20,28,0.714,85,39,97,0.402,31,72,0.431,8,25,0.32,16,21,0.762,102,2015-11-13,PHI,OKC
12507,7,@,L 85-97 ,240,35,96,0.365,28,69,0.406,7,27,0.259,8,15,0.533,85,31,75,0.413,25,56,0.446,6,19,0.316,29,39,0.744,97,2015-11-15,DET,LAL
12508,8,Home,L 85-100 ,240,28,77,0.364,22,52,0.423,6,25,0.24,23,29,0.793,85,39,82,0.476,30,59,0.508,9,23,0.391,13,20,0.65,100,2015-11-15,OKC,BOS
12509,9,Home,L 85-112 ,240,35,76,0.461,30,51,0.588,5,25,0.2,10,16,0.625,85,42,92,0.457,30,65,0.462,12,27,0.444,16,20,0.8,112,2015-11-18,PHI,IND
12510,10,Home,L 85-97 ,240,28,83,0.337,19,53,0.358,9,30,0.3,20,23,0.87,85,39,83,0.47,32,55,0.582,7,28,0.25,12,16,0.75,97,2015-12-01,CLE,WAS
12511,11,@,W 85-74 ,240,38,88,0.432,37,72,0.514,1,16,0.063,8,10,0.8,85,28,84,0.333,21,60,0.35,7,24,0.292,11,20,0.55,74,2015-12-08,ORL,DEN
12512,12,@,L 85-106 ,240,31,78,0.397,23,57,0.404,8,21,0.381,15,27,0.556,85,39,80,0.488,30,59,0.508,9,21,0.429,19,23,0.826,106,2015-12-09,NYK,UTA
12513,13,@,L 85-98 ,240,32,76,0.421,27,57,0.474,5,19,0.263,16,28,0.571,85,38,86,0.442,29,62,0.468,9,24,0.375,13,19,0.684,98,2015-12-16,MEM,CHI
12514,14,Home,L 85-100 ,240,32,78,0.41,27,57,0.474,5,21,0.238,16,20,0.8,85,38,80,0.475,35,68,0.515,3,12,0.25,21,24,0.875,100,2015-12-20,BRK,MIN
12515,15,@,L 85-103 ,240,33,80,0.413,26,60,0.433,7,20,0.35,12,14,0.857,85,39,83,0.47,30,60,0.5,9,23,0.391,16,16,1.0,103,2015-12-23,UTA,GSW
12516,16,Home,L 85-120 ,240,32,89,0.36,25,64,0.391,7,25,0.28,14,22,0.636,85,51,95,0.537,46,76,0.605,5,19,0.263,13,17,0.765,120,2015-12-23,LAL,OKC
12517,17,Home,L 85-95 ,240,33,84,0.393,30,70,0.429,3,14,0.214,16,24,0.667,85,32,75,0.427,24,59,0.407,8,16,0.5,23,28,0.821,95,2016-01-02,MIN,MIL
12518,18,Home,L 85-95 ,240,35,77,0.455,29,59,0.492,6,18,0.333,9,19,0.474,85,35,90,0.389,26,58,0.448,9,32,0.281,16,23,0.696,95,2016-01-10,PHI,CLE
12519,19,@,L 85-99 ,240,31,76,0.408,23,57,0.404,8,19,0.421,15,22,0.682,85,39,88,0.443,28,62,0.452,11,26,0.423,10,15,0.667,99,2016-01-13,UTA,POR
12520,20,@,W 85-83 ,240,33,85,0.388,28,58,0.483,5,27,0.185,14,21,0.667,85,33,79,0.418,23,56,0.411,10,23,0.435,7,14,0.5,83,2016-01-27,LAC,ATL
12521,21,Home,W 85-81 ,240,33,74,0.446,28,52,0.538,5,22,0.227,14,20,0.7,85,26,70,0.371,22,52,0.423,4,18,0.222,25,33,0.758,81,2016-02-03,UTA,DEN
12522,22,Home,L 85-91 ,240,30,80,0.375,20,51,0.392,10,29,0.345,15,17,0.882,85,33,76,0.434,29,58,0.5,4,18,0.222,21,24,0.875,91,2016-02-05,NYK,MEM
12523,23,@,L 85-98 ,240,28,76,0.368,25,56,0.446,3,20,0.15,26,32,0.813,85,33,81,0.407,26,53,0.491,7,28,0.25,25,31,0.806,98,2016-02-21,MEM,TOR
12524,24,Home,L 85-104 ,240,33,88,0.375,27,67,0.403,6,21,0.286,13,18,0.722,85,37,88,0.42,25,58,0.431,12,30,0.4,18,20,0.9,104,2016-03-01,NYK,POR
12525,25,@,L 85-93 ,240,31,81,0.383,29,63,0.46,2,18,0.111,21,25,0.84,85,34,85,0.4,30,61,0.492,4,24,0.167,21,25,0.84,93,2016-03-12,OKC,SAS
12526,26,@,L 85-94 ,240,35,88,0.398,25,45,0.556,10,43,0.233,5,8,0.625,85,35,71,0.493,23,44,0.523,12,27,0.444,12,14,0.857,94,2016-03-14,CLE,UTA
12527,27,@,L 85-121 ,240,36,91,0.396,29,72,0.403,7,19,0.368,6,10,0.6,85,46,91,0.505,28,54,0.519,18,37,0.486,11,12,0.917,121,2016-03-16,NYK,GSW
12528,28,@,L 85-92 ,240,35,86,0.407,27,59,0.458,8,27,0.296,7,12,0.583,85,39,80,0.488,33,61,0.541,6,19,0.316,8,11,0.727,92,2016-03-19,UTA,CHI
12529,29,Home,L 85-94 ,240,34,65,0.523,31,57,0.544,3,8,0.375,14,17,0.824,85,34,83,0.41,21,45,0.467,13,38,0.342,13,14,0.929,94,2016-03-20,MIL,UTA
12530,30,Home,L 85-100 ,240,30,96,0.313,14,52,0.269,16,44,0.364,9,10,0.9,85,38,87,0.437,31,62,0.5,7,25,0.28,17,18,0.944,100,2016-03-29,PHI,CHO
12531,31,@,L 85-98 ,240,35,79,0.443,26,56,0.464,9,23,0.391,6,10,0.6,85,38,72,0.528,30,50,0.6,8,22,0.364,14,23,0.609,98,2016-04-01,MIN,UTA
12532,32,@,W 85-83 ,240,34,84,0.405,29,64,0.453,5,20,0.25,12,20,0.6,85,34,87,0.391,27,65,0.415,7,22,0.318,8,18,0.444,83,2016-11-02,OKC,LAC
12533,33,@,L 85-97 ,240,31,84,0.369,27,67,0.403,4,17,0.235,19,22,0.864,85,37,85,0.435,28,57,0.491,9,28,0.321,14,17,0.824,97,2016-11-07,MIA,OKC
12534,34,@,W 85-77 ,240,33,90,0.367,28,73,0.384,5,17,0.294,14,16,0.875,85,30,78,0.385,25,53,0.472,5,25,0.2,12,14,0.857,77,2016-11-17,CHI,UTA
12535,35,Home,L 85-96 ,240,34,84,0.405,27,57,0.474,7,27,0.259,10,14,0.714,85,36,85,0.424,31,65,0.477,5,20,0.25,19,22,0.864,96,2016-11-23,IND,ATL
12536,36,Home,L 85-109 ,240,32,90,0.356,27,68,0.397,5,22,0.227,16,23,0.696,85,43,83,0.518,32,55,0.582,11,28,0.393,12,17,0.706,109,2016-11-25,LAL,GSW
12537,37,Home,L 85-98 ,240,32,79,0.405,26,53,0.491,6,26,0.231,15,21,0.714,85,34,85,0.4,27,63,0.429,7,22,0.318,23,25,0.92,98,2016-11-25,PHO,MIN
12538,38,Home,L 85-104 ,240,36,89,0.404,29,60,0.483,7,29,0.241,6,13,0.462,85,36,82,0.439,27,56,0.482,9,26,0.346,23,31,0.742,104,2016-11-28,MEM,CHO
12539,39,Home,L 85-121 ,240,32,88,0.364,26,64,0.406,6,24,0.25,15,20,0.75,85,48,89,0.539,31,60,0.517,17,29,0.586,8,12,0.667,121,2016-12-02,ATL,DET
12540,40,@,L 85-92 ,240,31,76,0.408,24,44,0.545,7,32,0.219,16,24,0.667,85,35,78,0.449,29,59,0.492,6,19,0.316,16,17,0.941,92,2016-12-08,DEN,WAS
12541,41,Home,L 85-95 ,240,32,78,0.41,24,53,0.453,8,25,0.32,13,16,0.813,85,36,71,0.507,31,54,0.574,5,17,0.294,18,22,0.818,95,2016-12-14,DAL,DET
12542,42,@,L 85-93 ,240,28,75,0.373,19,50,0.38,9,25,0.36,20,31,0.645,85,35,81,0.432,23,58,0.397,12,23,0.522,11,16,0.688,93,2016-12-14,CLE,MEM
12543,43,@,L 85-90 ,240,34,81,0.42,25,56,0.446,9,25,0.36,8,10,0.8,85,32,83,0.386,26,58,0.448,6,25,0.24,20,28,0.714,90,2016-12-26,IND,CHI
12544,44,@,L 85-102 ,240,30,75,0.4,26,54,0.481,4,21,0.19,21,25,0.84,85,36,89,0.404,23,55,0.418,13,34,0.382,17,20,0.85,102,2017-01-07,CHA,SAS
12545,45,@,L 85-107 ,240,33,94,0.351,25,63,0.397,8,31,0.258,11,11,1.0,85,41,87,0.471,30,61,0.492,11,26,0.423,14,17,0.824,107,2017-01-18,POR,CHO
12546,46,@,L 85-90 ,240,32,76,0.421,19,38,0.5,13,38,0.342,8,9,0.889,85,32,84,0.381,20,52,0.385,12,32,0.375,14,19,0.737,90,2017-02-15,CHA,TOR
12547,47,Home,L 85-99 ,240,31,79,0.392,20,51,0.392,11,28,0.393,12,15,0.8,85,34,85,0.4,20,47,0.426,14,38,0.368,17,18,0.944,99,2017-02-25,SAC,CHO
12548,48,Home,L 84-85 ,240,32,81,0.395,27,56,0.482,5,25,0.2,15,19,0.789,84,35,79,0.443,33,63,0.524,2,16,0.125,13,21,0.619,85,2011-12-26,PHO,NOH
12549,49,Home,L 84-90 ,240,31,74,0.419,30,67,0.448,1,7,0.143,21,34,0.618,84,34,86,0.395,28,60,0.467,6,26,0.231,16,20,0.8,90,2011-12-26,WAS,NJN
12550,50,@,L 84-95 ,240,35,80,0.438,31,64,0.484,4,16,0.25,10,16,0.625,84,38,82,0.463,29,63,0.46,9,19,0.474,10,13,0.769,95,2011-12-31,ATL,HOU
12551,51,@,L 84-96 ,240,30,80,0.375,25,67,0.373,5,13,0.385,19,27,0.704,84,39,85,0.459,33,71,0.465,6,14,0.429,12,16,0.75,96,2012-01-11,ATL,IND
12552,52,@,L 84-93 ,240,33,78,0.423,30,66,0.455,3,12,0.25,15,22,0.682,84,32,71,0.451,27,58,0.466,5,13,0.385,24,31,0.774,93,2012-01-16,TOR,ATL
12553,53,@,W 84-77 ,240,34,72,0.472,28,52,0.538,6,20,0.3,10,15,0.667,84,28,68,0.412,28,59,0.475,0,9,0.0,21,28,0.75,77,2012-01-16,POR,NOH
12554,54,Home,L 84-94 ,240,30,82,0.366,25,67,0.373,5,15,0.333,19,25,0.76,84,33,82,0.402,28,67,0.418,5,15,0.333,23,31,0.742,94,2012-01-20,TOR,POR
12555,55,@,W 84-74 ,240,32,77,0.416,28,60,0.467,4,17,0.235,16,24,0.667,84,27,87,0.31,24,64,0.375,3,23,0.13,17,19,0.895,74,2012-01-21,OKC,NJN
12556,56,@,L 84-97 ,240,34,90,0.378,31,76,0.408,3,14,0.214,13,17,0.765,84,31,72,0.431,26,50,0.52,5,22,0.227,30,36,0.833,97,2012-01-24,MEM,POR
12557,57,@,L 84-97 ,240,34,89,0.382,29,63,0.46,5,26,0.192,11,15,0.733,84,38,77,0.494,34,65,0.523,4,12,0.333,17,22,0.773,97,2012-01-28,NYK,HOU
12558,58,@,L 84-86 ,240,33,76,0.434,32,73,0.438,1,3,0.333,17,20,0.85,84,32,88,0.364,27,70,0.386,5,18,0.278,17,24,0.708,86,2012-01-28,MEM,PHO
12559,59,Home,L 84-89 ,240,31,83,0.373,27,70,0.386,4,13,0.308,18,21,0.857,84,34,73,0.466,27,57,0.474,7,16,0.438,14,21,0.667,89,2012-02-06,MEM,SAS
12560,60,@,L 84-94 ,240,32,71,0.451,28,55,0.509,4,16,0.25,16,20,0.8,84,41,81,0.506,37,58,0.638,4,23,0.174,8,8,1.0,94,2012-02-07,CHA,BOS
12561,61,@,L 84-86 ,240,31,82,0.378,23,59,0.39,8,23,0.348,14,21,0.667,84,32,79,0.405,28,65,0.431,4,14,0.286,18,28,0.643,86,2012-02-07,SAC,MIN
12562,62,Home,L 84-99 ,240,31,84,0.369,28,70,0.4,3,14,0.214,19,25,0.76,84,35,79,0.443,29,65,0.446,6,14,0.429,23,30,0.767,99,2012-02-11,CLE,PHI
12563,63,Home,L 84-98 ,240,27,77,0.351,19,56,0.339,8,21,0.381,22,28,0.786,84,39,78,0.5,31,55,0.564,8,23,0.348,12,15,0.8,98,2012-02-11,SAC,PHO
12564,64,@,L 84-102 ,240,30,84,0.357,24,57,0.421,6,27,0.222,18,31,0.581,84,37,80,0.463,27,54,0.5,10,26,0.385,18,22,0.818,102,2012-02-15,DEN,DAL
12565,65,@,L 84-102 ,240,30,76,0.395,25,54,0.463,5,22,0.227,19,28,0.679,84,35,83,0.422,24,62,0.387,11,21,0.524,21,28,0.75,102,2012-02-15,WAS,LAC
12566,66,Home,L 84-89 ,240,27,85,0.318,21,58,0.362,6,27,0.222,24,37,0.649,84,36,89,0.404,34,79,0.43,2,10,0.2,15,20,0.75,89,2012-02-22,CLE,NOH
12567,67,Home,L 84-95 ,240,30,80,0.375,27,64,0.422,3,16,0.188,21,27,0.778,84,34,77,0.442,25,62,0.403,9,15,0.6,18,23,0.783,95,2012-02-29,NOP,TOR
12568,68,Home,L 84-102 ,240,33,81,0.407,29,69,0.42,4,12,0.333,14,21,0.667,84,35,80,0.438,26,61,0.426,9,19,0.474,23,32,0.719,102,2012-03-03,NOP,IND
12569,69,@,L 84-100 ,240,31,80,0.388,18,45,0.4,13,35,0.371,9,17,0.529,84,38,80,0.475,34,70,0.486,4,10,0.4,20,27,0.741,100,2012-03-06,ORL,CHA
12570,70,@,L 84-98 ,240,31,81,0.383,30,71,0.423,1,10,0.1,21,25,0.84,84,38,79,0.481,31,62,0.5,7,17,0.412,15,17,0.882,98,2012-03-14,TOR,NJN
12571,71,@,W 84-78 ,240,35,74,0.473,31,62,0.5,4,12,0.333,10,19,0.526,84,33,93,0.355,28,75,0.373,5,18,0.278,7,14,0.5,78,2012-03-16,MIA,PHI
12572,72,@,L 84-93 ,240,32,80,0.4,26,55,0.473,6,25,0.24,14,21,0.667,84,36,77,0.468,29,56,0.518,7,21,0.333,14,20,0.7,93,2012-03-23,BRK,ATL
12573,73,Home,L 84-105 ,240,29,81,0.358,24,60,0.4,5,21,0.238,21,35,0.6,84,42,81,0.519,37,67,0.552,5,14,0.357,16,18,0.889,105,2012-03-26,BRK,UTA
12574,74,@,L 84-100 ,240,35,77,0.455,29,57,0.509,6,20,0.3,8,13,0.615,84,40,82,0.488,33,66,0.5,7,16,0.438,13,15,0.867,100,2012-03-28,IND,NJN
12575,75,Home,L 84-121 ,240,34,85,0.4,28,63,0.444,6,22,0.273,10,19,0.526,84,50,88,0.568,40,72,0.556,10,16,0.625,11,18,0.611,121,2012-03-30,CLE,MIL
12576,76,@,W 84-80 ,240,25,73,0.342,20,56,0.357,5,17,0.294,29,40,0.725,84,31,73,0.425,28,58,0.483,3,15,0.2,15,24,0.625,80,2012-04-06,CLE,TOR
12577,77,@,L 84-123 ,240,31,84,0.369,19,59,0.322,12,25,0.48,10,14,0.714,84,48,88,0.545,39,70,0.557,9,18,0.5,18,24,0.75,123,2012-04-09,GSW,DEN
12578,78,@,L 84-91 ,240,35,87,0.402,28,63,0.444,7,24,0.292,7,10,0.7,84,31,73,0.425,27,59,0.458,4,14,0.286,25,33,0.758,91,2012-04-09,SAS,UTA
12579,79,Home,L 84-98 ,240,33,81,0.407,20,57,0.351,13,24,0.542,5,9,0.556,84,40,89,0.449,29,66,0.439,11,23,0.478,7,12,0.583,98,2012-04-11,SAS,LAL
12580,80,Home,W 84-79 ,240,25,72,0.347,18,54,0.333,7,18,0.389,27,31,0.871,84,30,80,0.375,26,61,0.426,4,19,0.211,15,19,0.789,79,2012-04-13,TOR,BOS
12581,81,Home,L 84-100 ,240,28,75,0.373,22,56,0.393,6,19,0.316,22,29,0.759,84,36,79,0.456,25,50,0.5,11,29,0.379,17,21,0.81,100,2012-04-15,CLE,ORL
12582,82,Home,L 84-87 ,240,32,84,0.381,28,70,0.4,4,14,0.286,16,22,0.727,84,34,89,0.382,30,71,0.423,4,18,0.222,15,19,0.789,87,2012-04-16,CHI,WAS
12583,83,Home,L 84-91 ,240,26,73,0.356,19,51,0.373,7,22,0.318,25,30,0.833,84,40,91,0.44,35,78,0.449,5,13,0.385,6,11,0.545,91,2012-04-17,MIN,MEM
12584,84,@,L 84-116 ,240,32,92,0.348,25,67,0.373,7,25,0.28,13,19,0.684,84,42,85,0.494,34,57,0.596,8,28,0.286,24,29,0.828,116,2012-04-18,DET,ATL
12585,85,Home,L 84-86 ,240,31,77,0.403,22,52,0.423,9,25,0.36,13,16,0.813,84,36,87,0.414,29,69,0.42,7,18,0.389,7,9,0.778,86,2012-04-21,MIA,WAS
12586,86,Home,L 84-104 ,240,32,74,0.432,26,58,0.448,6,16,0.375,14,26,0.538,84,44,85,0.518,36,65,0.554,8,20,0.4,8,15,0.533,104,2012-04-26,CHA,NYK
12587,87,Home,W 84-77 ,240,32,91,0.352,23,63,0.365,9,28,0.321,11,14,0.786,84,27,68,0.397,22,53,0.415,5,15,0.333,18,30,0.6,77,2012-04-26,HOU,NOH
12588,88,@,L 84-94 ,240,32,90,0.356,24,58,0.414,8,32,0.25,12,20,0.6,84,36,79,0.456,29,59,0.492,7,20,0.35,15,22,0.682,94,2012-10-30,WAS,CLE
12589,89,Home,W 84-75 ,240,30,85,0.353,23,60,0.383,7,25,0.28,17,21,0.81,84,33,88,0.375,29,70,0.414,4,18,0.222,5,11,0.455,75,2012-10-31,PHI,DEN
12590,90,@,L 84-86 ,240,29,77,0.377,22,60,0.367,7,17,0.412,19,23,0.826,84,35,79,0.443,30,60,0.5,5,19,0.263,11,16,0.688,86,2012-11-01,OKC,SAS
12591,91,@,L 84-104 ,240,33,71,0.465,26,51,0.51,7,20,0.35,11,13,0.846,84,36,84,0.429,17,48,0.354,19,36,0.528,13,15,0.867,104,2012-11-02,MIA,NYK
12592,92,@,L 84-100 ,240,34,79,0.43,26,62,0.419,8,17,0.471,8,10,0.8,84,39,77,0.506,28,50,0.56,11,27,0.407,11,18,0.611,100,2012-11-04,PHI,NYK
12593,93,@,L 84-106 ,240,30,73,0.411,22,50,0.44,8,23,0.348,16,24,0.667,84,46,83,0.554,40,66,0.606,6,17,0.353,8,9,0.889,106,2012-11-07,SAS,LAC
12594,94,@,L 84-104 ,240,32,87,0.368,28,64,0.438,4,23,0.174,16,22,0.727,84,40,92,0.435,34,75,0.453,6,17,0.353,18,25,0.72,104,2012-11-09,UTA,DEN
12595,95,@,W 84-82 ,240,35,90,0.389,28,70,0.4,7,20,0.35,7,11,0.636,84,31,74,0.419,25,54,0.463,6,20,0.3,14,22,0.636,82,2012-11-13,SAS,LAL
12596,96,@,L 84-102 ,240,33,85,0.388,27,72,0.375,6,13,0.462,12,20,0.6,84,40,75,0.533,35,62,0.565,5,13,0.385,17,21,0.81,102,2012-11-25,NOP,DEN
12597,97,Home,W 84-78 ,240,33,71,0.465,29,60,0.483,4,11,0.364,14,18,0.778,84,31,76,0.408,27,60,0.45,4,16,0.25,12,15,0.8,78,2012-11-26,MEM,CLE
12598,98,Home,L 84-96 ,240,31,73,0.425,26,52,0.5,5,21,0.238,17,21,0.81,84,31,63,0.492,25,52,0.481,6,11,0.545,28,38,0.737,96,2012-11-28,NOP,UTA
12599,99,Home,W 84-82 ,240,31,71,0.437,26,59,0.441,5,12,0.417,17,19,0.895,84,30,86,0.349,20,55,0.364,10,31,0.323,12,18,0.667,82,2012-11-28,WAS,POR
12600,0,@,L 84-99 ,240,33,82,0.402,30,71,0.423,3,11,0.273,15,21,0.714,84,38,83,0.458,32,70,0.457,6,13,0.462,17,22,0.773,99,2012-12-14,UTA,PHO
12601,1,@,L 84-104 ,240,32,86,0.372,30,71,0.423,2,15,0.133,18,25,0.72,84,41,80,0.513,32,64,0.5,9,16,0.563,13,18,0.722,104,2012-12-19,UTA,IND
12602,2,Home,L 84-87 ,240,32,84,0.381,25,56,0.446,7,28,0.25,13,17,0.765,84,33,81,0.407,24,50,0.48,9,31,0.29,12,15,0.8,87,2012-12-26,MIN,HOU
12603,3,Home,L 84-87 ,240,35,76,0.461,31,58,0.534,4,18,0.222,10,14,0.714,84,31,82,0.378,21,55,0.382,10,27,0.37,15,23,0.652,87,2012-12-26,WAS,CLE
12604,4,@,L 84-106 ,240,29,84,0.345,27,67,0.403,2,17,0.118,24,30,0.8,84,43,87,0.494,39,75,0.52,4,12,0.333,16,19,0.842,106,2013-01-02,MIN,UTA
12605,5,@,L 84-85 ,240,31,75,0.413,21,46,0.457,10,29,0.345,12,20,0.6,84,35,85,0.412,32,70,0.457,3,15,0.2,12,21,0.571,85,2013-01-04,ATL,DET
12606,6,Home,L 84-86 ,240,32,81,0.395,30,76,0.395,2,5,0.4,18,18,1.0,84,33,81,0.407,23,54,0.426,10,27,0.37,10,15,0.667,86,2013-01-04,MEM,POR
12607,7,@,L 84-106 ,240,31,72,0.431,28,60,0.467,3,12,0.25,19,24,0.792,84,36,76,0.474,25,56,0.446,11,20,0.55,23,27,0.852,106,2013-01-09,MIN,OKC
12608,8,@,L 84-102 ,240,34,81,0.42,31,67,0.463,3,14,0.214,13,16,0.813,84,43,80,0.538,34,59,0.576,9,21,0.429,7,13,0.538,102,2013-01-25,UTA,LAL
12609,9,@,L 84-92 ,240,30,75,0.4,23,53,0.434,7,22,0.318,17,21,0.81,84,40,95,0.421,34,82,0.415,6,13,0.462,6,10,0.6,92,2013-01-30,WAS,PHI
12610,10,@,L 84-97 ,240,36,95,0.379,33,76,0.434,3,19,0.158,9,9,1.0,84,42,84,0.5,38,66,0.576,4,18,0.222,9,14,0.643,97,2013-02-01,ORL,BOS
12611,11,@,L 84-93 ,240,35,78,0.449,34,63,0.54,1,15,0.067,13,15,0.867,84,39,75,0.52,35,61,0.574,4,14,0.286,11,17,0.647,93,2013-02-06,PHO,NOH
12612,12,Home,L 84-89 (OT),265,33,96,0.344,28,74,0.378,5,22,0.227,13,18,0.722,84,31,80,0.388,27,68,0.397,4,12,0.333,23,32,0.719,89,2013-02-11,IND,BRK
12613,13,Home,L 84-90 ,240,29,79,0.367,24,60,0.4,5,19,0.263,21,27,0.778,84,34,81,0.42,27,69,0.391,7,12,0.583,15,17,0.882,90,2013-02-25,TOR,WAS
12614,14,@,L 84-106 ,240,33,81,0.407,27,65,0.415,6,16,0.375,12,14,0.857,84,41,76,0.539,29,54,0.537,12,22,0.545,12,26,0.462,106,2013-02-26,CHA,LAC
12615,15,Home,L 84-98 ,240,32,81,0.395,25,60,0.417,7,21,0.333,13,18,0.722,84,41,76,0.539,36,63,0.571,5,13,0.385,11,16,0.688,98,2013-02-26,PHI,ORL
12616,16,Home,W 84-83 (OT),265,37,91,0.407,32,78,0.41,5,13,0.385,5,14,0.357,84,31,90,0.344,26,71,0.366,5,19,0.263,16,25,0.64,83,2013-02-26,PHO,MIN
12617,17,@,L 84-90 ,240,33,76,0.434,30,64,0.469,3,12,0.25,15,19,0.789,84,29,78,0.372,24,64,0.375,5,14,0.357,27,34,0.794,90,2013-02-27,DAL,MEM
12618,18,@,L 84-113 ,240,30,78,0.385,22,52,0.423,8,26,0.308,16,21,0.762,84,38,75,0.507,25,43,0.581,13,32,0.406,24,30,0.8,113,2013-03-09,UTA,NYK
12619,19,@,L 84-90 ,240,33,77,0.429,29,65,0.446,4,12,0.333,14,22,0.636,84,31,71,0.437,26,55,0.473,5,16,0.313,23,31,0.742,90,2013-03-16,MEM,UTA
12620,20,@,L 84-87 ,240,30,78,0.385,25,64,0.391,5,14,0.357,19,24,0.792,84,35,81,0.432,32,70,0.457,3,11,0.273,14,22,0.636,87,2013-03-23,IND,CHI
12621,21,@,L 84-110 ,240,34,76,0.447,30,53,0.566,4,23,0.174,12,18,0.667,84,41,79,0.519,34,60,0.567,7,19,0.368,21,23,0.913,110,2013-03-23,TOR,NYK
12622,22,@,L 84-98 ,240,35,90,0.389,29,73,0.397,6,17,0.353,8,9,0.889,84,40,90,0.444,30,61,0.492,10,29,0.345,8,13,0.615,98,2013-04-03,ORL,SAS
12623,23,@,L 84-86 ,240,38,86,0.442,35,72,0.486,3,14,0.214,5,7,0.714,84,34,74,0.459,29,54,0.537,5,20,0.25,13,18,0.722,86,2013-04-05,MEM,LAL
12624,24,Home,L 84-102 ,240,31,74,0.419,29,64,0.453,2,10,0.2,20,33,0.606,84,42,75,0.56,33,58,0.569,9,17,0.529,9,13,0.692,102,2013-04-15,ORL,CHI
12625,25,@,L 84-90 ,240,32,84,0.381,28,66,0.424,4,18,0.222,16,22,0.727,84,33,73,0.452,30,61,0.492,3,12,0.25,21,34,0.618,90,2013-11-01,CLE,CHA
12626,26,@,L 84-87 ,240,31,85,0.365,26,68,0.382,5,17,0.294,17,27,0.63,84,31,83,0.373,25,61,0.41,6,22,0.273,19,24,0.792,87,2013-11-01,UTA,PHO
12627,27,@,L 84-105 ,240,30,80,0.375,27,59,0.458,3,21,0.143,21,36,0.583,84,37,75,0.493,30,62,0.484,7,13,0.538,24,28,0.857,105,2013-11-02,CHA,NOP
12628,28,Home,L 84-99 ,240,34,71,0.479,30,56,0.536,4,15,0.267,12,14,0.857,84,38,78,0.487,34,65,0.523,4,13,0.308,19,21,0.905,99,2013-11-06,MEM,NOP
12629,29,@,L 84-91 ,240,32,81,0.395,26,63,0.413,6,18,0.333,14,16,0.875,84,36,78,0.462,30,57,0.526,6,21,0.286,13,16,0.813,91,2013-11-08,TOR,IND
12630,30,@,L 84-98 ,240,29,88,0.33,26,69,0.377,3,19,0.158,23,28,0.821,84,40,80,0.5,32,65,0.492,8,15,0.533,10,17,0.588,98,2013-11-25,MIN,IND
12631,31,Home,L 84-95 ,240,29,83,0.349,19,55,0.345,10,28,0.357,16,24,0.667,84,35,72,0.486,31,53,0.585,4,19,0.211,21,25,0.84,95,2013-11-27,CLE,MIA
12632,32,@,L 84-113 ,240,32,75,0.427,24,53,0.453,8,22,0.364,12,15,0.8,84,43,78,0.551,29,51,0.569,14,27,0.519,13,21,0.619,113,2013-11-27,ATL,HOU
12633,33,@,L 84-90 ,240,33,77,0.429,29,56,0.518,4,21,0.19,14,20,0.7,84,34,67,0.507,29,52,0.558,5,15,0.333,17,25,0.68,90,2013-12-10,MIA,IND
12634,34,Home,L 84-100 ,240,35,89,0.393,29,69,0.42,6,20,0.3,8,11,0.727,84,41,88,0.466,33,68,0.485,8,20,0.4,10,12,0.833,100,2013-12-14,UTA,SAS
12635,35,@,L 84-100 ,240,36,90,0.4,32,72,0.444,4,18,0.222,8,9,0.889,84,37,69,0.536,27,54,0.5,10,15,0.667,16,24,0.667,100,2013-12-21,CLE,CHI
12636,36,@,L 84-91 ,240,32,86,0.372,24,58,0.414,8,28,0.286,12,14,0.857,84,33,81,0.407,27,64,0.422,6,17,0.353,19,24,0.792,91,2014-01-04,ATL,CHI
12637,37,Home,L 84-112 ,240,35,86,0.407,31,69,0.449,4,17,0.235,10,20,0.5,84,43,92,0.467,35,77,0.455,8,15,0.533,18,22,0.818,112,2014-01-05,DET,MEM
12638,38,@,L 84-93 ,240,29,82,0.354,27,71,0.38,2,11,0.182,24,28,0.857,84,34,79,0.43,26,58,0.448,8,21,0.381,17,22,0.773,93,2014-02-09,SAC,WAS
12639,39,@,L 84-91 ,240,29,80,0.363,25,50,0.5,4,30,0.133,22,26,0.846,84,31,70,0.443,23,49,0.469,8,21,0.381,21,26,0.808,91,2014-03-07,BRK,BOS
12640,40,Home,W 84-83 ,240,30,81,0.37,23,67,0.343,7,14,0.5,17,21,0.81,84,28,61,0.459,22,42,0.524,6,19,0.316,21,29,0.724,83,2014-03-26,IND,MIA
12641,41,Home,L 84-89 ,240,28,79,0.354,18,48,0.375,10,31,0.323,18,22,0.818,84,32,80,0.4,23,55,0.418,9,25,0.36,16,18,0.889,89,2014-03-30,GSW,NYK
12642,42,@,L 84-101 ,240,32,84,0.381,28,73,0.384,4,11,0.364,16,21,0.762,84,41,101,0.406,37,84,0.44,4,17,0.235,15,31,0.484,101,2014-10-28,ORL,NOP
12643,43,@,L 84-103 ,240,30,83,0.361,27,64,0.422,3,19,0.158,21,32,0.656,84,35,80,0.438,26,58,0.448,9,22,0.409,24,31,0.774,103,2014-11-07,WAS,TOR
12644,44,Home,L 84-91 ,240,30,73,0.411,19,48,0.396,11,25,0.44,13,22,0.591,84,35,74,0.473,30,56,0.536,5,18,0.278,16,26,0.615,91,2014-11-16,MIA,MIL
12645,45,Home,L 84-102 ,240,32,86,0.372,30,72,0.417,2,14,0.143,18,24,0.75,84,34,69,0.493,27,45,0.6,7,24,0.292,27,34,0.794,102,2014-11-30,BRK,CHI
12646,46,@,L 84-96 ,240,34,93,0.366,28,58,0.483,6,35,0.171,10,13,0.769,84,36,87,0.414,26,60,0.433,10,27,0.37,14,19,0.737,96,2014-12-07,DEN,ATL
12647,47,@,L 84-93 ,240,30,78,0.385,25,61,0.41,5,17,0.294,19,28,0.679,84,41,84,0.488,37,71,0.521,4,13,0.308,7,12,0.583,93,2014-12-14,UTA,WAS
12648,48,@,L 84-100 ,240,33,83,0.398,27,60,0.45,6,23,0.261,12,15,0.8,84,37,78,0.474,31,57,0.544,6,21,0.286,20,26,0.769,100,2014-12-21,BOS,MIA
12649,49,@,L 84-96 ,240,33,83,0.398,29,63,0.46,4,20,0.2,14,19,0.737,84,39,78,0.5,34,63,0.54,5,15,0.333,13,18,0.722,96,2014-12-23,NOP,IND
12650,50,@,L 84-106 ,240,32,87,0.368,30,72,0.417,2,15,0.133,18,28,0.643,84,44,94,0.468,39,73,0.534,5,21,0.238,13,15,0.867,106,2014-12-31,SAC,BOS
12651,51,@,L 84-88 ,240,34,86,0.395,27,62,0.435,7,24,0.292,9,13,0.692,84,31,67,0.463,26,53,0.491,5,14,0.357,21,28,0.75,88,2015-01-04,BRK,MIA
12652,52,@,L 84-101 ,240,30,76,0.395,24,62,0.387,6,14,0.429,18,23,0.783,84,36,90,0.4,29,69,0.42,7,21,0.333,22,31,0.71,101,2015-01-09,ORL,LAL
12653,53,@,L 84-98 ,240,32,79,0.405,26,57,0.456,6,22,0.273,14,17,0.824,84,39,75,0.52,27,56,0.482,12,19,0.632,8,10,0.8,98,2015-01-09,MIN,MIL
12654,54,@,L 84-103 ,240,33,78,0.423,22,46,0.478,11,32,0.344,7,12,0.583,84,42,86,0.488,36,69,0.522,6,17,0.353,13,17,0.765,103,2015-01-11,CLE,SAC
12655,55,@,L 84-100 ,240,31,80,0.388,28,61,0.459,3,19,0.158,19,31,0.613,84,38,82,0.463,28,53,0.528,10,29,0.345,14,22,0.636,100,2015-01-14,PHI,TOR
12656,56,@,L 84-123 ,240,33,88,0.375,29,67,0.433,4,21,0.19,14,25,0.56,84,49,83,0.59,38,58,0.655,11,25,0.44,14,21,0.667,123,2015-01-22,BRK,LAC
12657,57,Home,L 84-92 ,240,35,84,0.417,33,75,0.44,2,9,0.222,12,17,0.706,84,40,80,0.5,37,76,0.487,3,4,0.75,9,14,0.643,92,2015-01-23,MIN,NOP
12658,58,Home,L 84-96 ,240,31,87,0.356,24,63,0.381,7,24,0.292,15,19,0.789,84,38,84,0.452,37,71,0.521,1,13,0.077,19,23,0.826,96,2015-01-25,CHI,MIA
12659,59,@,L 84-92 ,240,29,85,0.341,27,72,0.375,2,13,0.154,24,32,0.75,84,36,86,0.419,32,66,0.485,4,20,0.2,16,24,0.667,92,2015-01-26,MIN,OKC
12660,60,@,L 84-97 ,240,31,78,0.397,19,45,0.422,12,33,0.364,10,14,0.714,84,35,78,0.449,23,51,0.451,12,27,0.444,15,22,0.682,97,2015-02-02,PHI,CLE
12661,61,Home,L 84-89 ,240,33,79,0.418,26,55,0.473,7,24,0.292,11,14,0.786,84,34,85,0.4,27,56,0.482,7,29,0.241,14,19,0.737,89,2015-02-09,PHI,GSW
12662,62,@,L 84-95 ,240,29,69,0.42,24,50,0.48,5,19,0.263,21,28,0.75,84,44,88,0.5,40,70,0.571,4,18,0.222,3,6,0.5,95,2015-02-20,NOP,ORL
12663,63,@,L 84-85 ,240,34,75,0.453,31,56,0.554,3,19,0.158,13,21,0.619,84,33,88,0.375,25,61,0.41,8,27,0.296,11,20,0.55,85,2015-03-04,UTA,BOS
12664,64,@,L 84-98 ,240,31,86,0.36,26,63,0.413,5,23,0.217,17,19,0.895,84,34,80,0.425,28,60,0.467,6,20,0.3,24,33,0.727,98,2015-03-06,CHI,IND
12665,65,@,L 84-92 ,240,30,77,0.39,19,52,0.365,11,25,0.44,13,16,0.813,84,35,95,0.368,22,58,0.379,13,37,0.351,9,17,0.529,92,2015-03-07,ATL,PHI
12666,66,@,L 84-85 ,240,32,86,0.372,28,66,0.424,4,20,0.2,16,21,0.762,84,29,83,0.349,21,58,0.362,8,25,0.32,19,26,0.731,85,2015-03-17,MIL,NOP
12667,67,Home,L 84-88 ,240,34,82,0.415,30,60,0.5,4,22,0.182,12,24,0.5,84,33,63,0.524,27,52,0.519,6,11,0.545,16,23,0.696,88,2015-03-18,UTA,WAS
12668,68,Home,L 84-107 ,240,34,76,0.447,29,63,0.46,5,13,0.385,11,15,0.733,84,39,90,0.433,23,59,0.39,16,31,0.516,13,17,0.765,107,2015-03-27,MEM,GSW
12669,69,Home,L 84-104 ,240,28,76,0.368,22,60,0.367,6,16,0.375,22,27,0.815,84,39,82,0.476,29,49,0.592,10,33,0.303,16,18,0.889,104,2015-03-30,MIN,UTA
12670,70,@,L 84-98 ,240,33,95,0.347,26,62,0.419,7,33,0.212,11,12,0.917,84,37,77,0.481,28,54,0.519,9,23,0.391,15,24,0.625,98,2015-04-01,DEN,UTA
12671,71,Home,L 84-97 ,240,29,64,0.453,28,53,0.528,1,11,0.091,25,32,0.781,84,40,92,0.435,34,71,0.479,6,21,0.286,11,17,0.647,97,2015-04-03,MIN,ORL
12672,72,Home,L 84-94 ,240,32,89,0.36,28,76,0.368,4,13,0.308,16,21,0.762,84,39,79,0.494,35,66,0.53,4,13,0.308,12,17,0.706,94,2015-11-02,NYK,SAS
12673,73,Home,L 84-96 ,240,28,72,0.389,23,52,0.442,5,20,0.25,23,34,0.676,84,37,85,0.435,26,61,0.426,11,24,0.458,11,17,0.647,96,2015-11-05,DEN,UTA
12674,74,Home,L 84-96 ,240,30,85,0.353,26,73,0.356,4,12,0.333,20,22,0.909,84,37,76,0.487,33,62,0.532,4,14,0.286,18,25,0.72,96,2015-11-05,MIN,MIA
12675,75,@,L 84-97 ,240,31,78,0.397,21,45,0.467,10,33,0.303,12,17,0.706,84,34,77,0.442,23,52,0.442,11,25,0.44,18,22,0.818,97,2015-11-09,ORL,IND
12676,76,Home,L 84-100 ,240,24,70,0.343,21,55,0.382,3,15,0.2,33,36,0.917,84,36,75,0.48,25,48,0.521,11,27,0.407,17,23,0.739,100,2015-11-11,MEM,GSW
12677,77,Home,L 84-90 ,240,29,79,0.367,20,52,0.385,9,27,0.333,17,21,0.81,84,33,78,0.423,27,50,0.54,6,28,0.214,18,31,0.581,90,2015-11-13,NYK,CLE
12678,78,@,L 84-96 ,240,28,74,0.378,22,45,0.489,6,29,0.207,22,37,0.595,84,36,85,0.424,28,61,0.459,8,24,0.333,16,19,0.842,96,2015-11-20,HOU,MEM
12679,79,@,L 84-98 ,240,34,73,0.466,27,54,0.5,7,19,0.368,9,10,0.9,84,42,82,0.512,33,62,0.532,9,20,0.45,5,10,0.5,98,2015-11-23,PHO,SAS
12680,80,Home,W 84-80 ,240,31,91,0.341,22,62,0.355,9,29,0.31,13,18,0.722,84,31,83,0.373,24,56,0.429,7,27,0.259,11,15,0.733,80,2015-11-25,BOS,PHI
12681,81,@,W 84-82 ,240,31,72,0.431,20,48,0.417,11,24,0.458,11,14,0.786,84,27,82,0.329,20,59,0.339,7,23,0.304,21,27,0.778,82,2015-11-28,TOR,WAS
12682,82,@,L 84-92 ,240,30,77,0.39,18,41,0.439,12,36,0.333,12,16,0.75,84,34,81,0.42,30,68,0.441,4,13,0.308,20,27,0.741,92,2015-11-29,PHI,MEM
12683,83,@,L 84-99 ,240,31,85,0.365,25,57,0.439,6,28,0.214,16,24,0.667,84,37,68,0.544,30,52,0.577,7,16,0.438,18,29,0.621,99,2015-12-05,CLE,MIA
12684,84,@,L 84-104 ,240,32,87,0.368,22,53,0.415,10,34,0.294,10,22,0.455,84,36,84,0.429,28,58,0.483,8,26,0.308,24,35,0.686,104,2015-12-07,DET,CHO
12685,85,@,L 84-96 ,240,30,77,0.39,25,49,0.51,5,28,0.179,19,25,0.76,84,37,83,0.446,32,64,0.5,5,19,0.263,17,21,0.81,96,2015-12-19,IND,MEM
12686,86,@,L 84-91 ,240,32,82,0.39,27,66,0.409,5,16,0.313,15,16,0.938,84,32,83,0.386,27,61,0.443,5,22,0.227,22,25,0.88,91,2015-12-23,NYK,CLE
12687,87,@,L 84-88 ,240,36,88,0.409,31,68,0.456,5,20,0.25,7,8,0.875,84,32,74,0.432,25,59,0.424,7,15,0.467,17,26,0.654,88,2015-12-25,SAS,HOU
12688,88,Home,L 84-94 ,240,32,77,0.416,25,54,0.463,7,23,0.304,13,25,0.52,84,38,85,0.447,28,59,0.475,10,26,0.385,8,11,0.727,94,2015-12-25,LAL,LAC
12689,89,@,L 84-93 ,240,31,84,0.369,27,60,0.45,4,24,0.167,18,25,0.72,84,33,87,0.379,28,71,0.394,5,16,0.313,22,29,0.759,93,2016-01-01,PHI,LAL
12690,90,@,L 84-91 ,240,32,87,0.368,28,68,0.412,4,19,0.211,16,19,0.842,84,30,82,0.366,22,64,0.344,8,18,0.444,23,30,0.767,91,2016-01-08,DEN,MEM
12691,91,@,L 84-107 ,240,30,81,0.37,23,56,0.411,7,25,0.28,17,21,0.81,84,36,82,0.439,23,43,0.535,13,39,0.333,22,26,0.846,107,2016-01-13,ATL,CHO
12692,92,@,L 84-97 ,240,29,77,0.377,22,53,0.415,7,24,0.292,19,32,0.594,84,28,82,0.341,19,51,0.373,9,31,0.29,32,37,0.865,97,2016-01-23,NYK,CHO
12693,93,Home,L 84-89 ,240,35,88,0.398,30,70,0.429,5,18,0.278,9,12,0.75,84,37,81,0.457,34,67,0.507,3,14,0.214,12,17,0.706,89,2016-01-25,CHI,MIA
12694,94,@,L 84-102 ,240,35,85,0.412,28,59,0.475,7,26,0.269,7,12,0.583,84,36,84,0.429,29,64,0.453,7,20,0.35,23,26,0.885,102,2016-01-29,PHO,NYK
12695,95,Home,W 84-81 ,240,30,77,0.39,22,50,0.44,8,27,0.296,16,23,0.696,84,30,71,0.423,23,57,0.404,7,14,0.5,14,21,0.667,81,2016-02-05,UTA,MIL
12696,96,@,L 84-99 ,240,34,87,0.391,29,64,0.453,5,23,0.217,11,16,0.688,84,39,90,0.433,25,49,0.51,14,41,0.341,7,7,1.0,99,2016-02-06,NOP,CLE
12697,97,@,L 84-124 ,240,31,88,0.352,24,64,0.375,7,24,0.292,15,20,0.75,84,44,80,0.55,31,56,0.554,13,24,0.542,23,35,0.657,124,2016-02-22,PHO,LAC
12698,98,Home,L 84-102 ,240,35,101,0.347,28,74,0.378,7,27,0.259,7,14,0.5,84,35,78,0.449,30,64,0.469,5,14,0.357,27,39,0.692,102,2016-03-04,ORL,PHO
12699,99,Home,L 84-91 ,240,30,86,0.349,23,60,0.383,7,26,0.269,17,23,0.739,84,38,80,0.475,30,55,0.545,8,25,0.32,7,14,0.5,91,2016-03-08,UTA,ATL
12700,0,@,L 84-121 ,240,34,91,0.374,27,65,0.415,7,26,0.269,9,18,0.5,84,47,84,0.56,30,49,0.612,17,35,0.486,10,11,0.909,121,2016-03-12,ORL,POR
12701,1,@,L 84-92 ,240,35,85,0.412,31,69,0.449,4,16,0.25,10,14,0.714,84,36,79,0.456,29,59,0.492,7,20,0.35,13,15,0.867,92,2016-03-24,NOP,IND
12702,2,Home,L 84-93 ,240,32,84,0.381,28,73,0.384,4,11,0.364,16,19,0.842,84,39,83,0.47,30,62,0.484,9,21,0.429,6,7,0.857,93,2016-03-26,MIN,UTA
12703,3,Home,L 84-100 ,240,32,80,0.4,26,53,0.491,6,27,0.222,14,19,0.737,84,36,79,0.456,24,48,0.5,12,31,0.387,16,21,0.762,100,2016-04-10,DEN,UTA
12704,4,@,L 84-110 ,240,35,86,0.407,30,66,0.455,5,20,0.25,9,14,0.643,84,41,75,0.547,29,50,0.58,12,25,0.48,16,21,0.762,110,2016-04-12,MEM,LAC
12705,5,Home,L 84-109 ,240,31,77,0.403,24,56,0.429,7,21,0.333,15,22,0.682,84,43,85,0.506,32,66,0.485,11,19,0.579,12,20,0.6,109,2016-11-07,PHI,UTA
12706,6,@,L 84-107 ,240,27,75,0.36,20,49,0.408,7,26,0.269,23,30,0.767,84,40,81,0.494,34,62,0.548,6,19,0.316,21,25,0.84,107,2016-11-23,MIA,DET
12707,7,@,L 84-128 ,240,35,88,0.398,28,60,0.467,7,28,0.25,7,14,0.5,84,53,92,0.576,40,68,0.588,13,24,0.542,9,11,0.818,128,2016-12-03,ATL,TOR
12708,8,@,L 84-114 ,240,31,90,0.344,25,63,0.397,6,27,0.222,16,21,0.762,84,46,83,0.554,37,59,0.627,9,24,0.375,13,19,0.684,114,2016-12-09,MIA,CLE
12709,9,@,L 84-104 ,240,34,90,0.378,25,64,0.391,9,26,0.346,7,13,0.538,84,37,77,0.481,24,48,0.5,13,29,0.448,17,18,0.944,104,2016-12-10,SAC,UTA
12710,10,Home,L 84-92 ,240,34,82,0.415,27,56,0.482,7,26,0.269,9,13,0.692,84,35,83,0.422,26,54,0.481,9,29,0.31,13,14,0.929,92,2016-12-21,ATL,MIN
12711,11,@,L 84-105 ,240,31,75,0.413,25,58,0.431,6,17,0.353,16,20,0.8,84,44,91,0.484,37,67,0.552,7,24,0.292,10,15,0.667,105,2017-02-04,DET,IND
12712,12,@,L 84-99 ,240,32,79,0.405,25,53,0.472,7,26,0.269,13,19,0.684,84,37,79,0.468,23,42,0.548,14,37,0.378,11,12,0.917,99,2017-02-15,ATL,LAC
12713,13,@,L 84-97 ,240,35,83,0.422,27,50,0.54,8,33,0.242,6,9,0.667,84,41,78,0.526,36,65,0.554,5,13,0.385,10,14,0.714,97,2017-02-24,DAL,MIN
12714,14,@,L 83-101 ,240,30,77,0.39,24,61,0.393,6,16,0.375,17,22,0.773,83,32,75,0.427,23,52,0.442,9,23,0.391,28,35,0.8,101,2011-12-28,WAS,ATL
12715,15,Home,L 83-103 ,240,33,80,0.413,31,69,0.449,2,11,0.182,15,18,0.833,83,41,86,0.477,34,69,0.493,7,17,0.412,14,18,0.778,103,2011-12-28,PHO,PHI
12716,16,@,L 83-110 ,240,30,93,0.323,28,72,0.389,2,21,0.095,21,24,0.875,83,46,76,0.605,43,67,0.642,3,9,0.333,15,22,0.682,110,2012-01-04,SAC,DEN
12717,17,Home,L 83-99 ,240,36,88,0.409,35,82,0.427,1,6,0.167,10,12,0.833,83,40,76,0.526,35,64,0.547,5,12,0.417,14,21,0.667,99,2012-01-04,DET,CHI
12718,18,@,L 83-118 ,240,24,69,0.348,19,50,0.38,5,19,0.263,30,39,0.769,83,42,80,0.525,34,59,0.576,8,21,0.381,26,28,0.929,118,2012-01-04,IND,MIA
12719,19,Home,L 83-97 ,240,30,75,0.4,23,55,0.418,7,20,0.35,16,21,0.762,83,38,86,0.442,30,72,0.417,8,14,0.571,13,17,0.765,97,2012-01-06,ORL,CHI
12720,20,@,L 83-99 ,240,34,80,0.425,27,60,0.45,7,20,0.35,8,12,0.667,83,39,80,0.488,37,63,0.587,2,17,0.118,19,23,0.826,99,2012-01-10,PHO,LAL
12721,21,@,L 83-94 ,240,31,83,0.373,20,57,0.351,11,26,0.423,10,11,0.909,83,34,75,0.453,28,63,0.444,6,12,0.5,20,30,0.667,94,2012-01-12,NYK,MEM
12722,22,@,L 83-99 ,240,34,84,0.405,29,66,0.439,5,18,0.278,10,14,0.714,83,38,74,0.514,32,57,0.561,6,17,0.353,17,25,0.68,99,2012-01-13,POR,SAS
12723,23,@,L 83-97 ,240,32,83,0.386,27,68,0.397,5,15,0.333,14,18,0.778,83,35,94,0.372,30,78,0.385,5,16,0.313,22,23,0.957,97,2012-01-14,BOS,IND
12724,24,Home,L 83-85 (OT),265,29,87,0.333,25,66,0.379,4,21,0.19,21,27,0.778,83,36,84,0.429,34,67,0.507,2,17,0.118,11,18,0.611,85,2012-01-18,ORL,SAS
12725,25,@,W 83-81 ,240,32,79,0.405,28,53,0.528,4,26,0.154,15,20,0.75,83,29,79,0.367,27,60,0.45,2,19,0.105,21,32,0.656,81,2012-01-21,DAL,NOH
12726,26,@,L 83-103 ,240,32,74,0.432,32,67,0.478,0,7,0.0,19,27,0.704,83,43,83,0.518,37,67,0.552,6,16,0.375,11,20,0.55,103,2012-01-23,WAS,PHI
12727,27,Home,L 83-102 ,240,31,78,0.397,28,67,0.418,3,11,0.273,18,18,1.0,83,38,83,0.458,25,51,0.49,13,32,0.406,13,19,0.684,102,2012-01-24,IND,ORL
12728,28,@,L 83-105 ,240,35,80,0.438,29,63,0.46,6,17,0.353,7,10,0.7,83,42,82,0.512,31,59,0.525,11,23,0.478,10,15,0.667,105,2012-01-25,ATL,SAS
12729,29,Home,L 83-91 ,240,30,79,0.38,25,62,0.403,5,17,0.294,18,31,0.581,83,34,73,0.466,24,52,0.462,10,21,0.476,13,19,0.684,91,2012-01-26,ORL,BOS
12730,30,@,W 83-73 ,240,32,80,0.4,22,56,0.393,10,24,0.417,9,15,0.6,83,27,73,0.37,24,64,0.375,3,9,0.333,16,20,0.8,73,2012-01-30,SAS,MEM
12731,31,@,L 83-93 ,240,30,78,0.385,27,68,0.397,3,10,0.3,20,24,0.833,83,35,73,0.479,30,64,0.469,5,9,0.556,18,21,0.857,93,2012-02-14,HOU,MEM
12732,32,Home,W 83-78 ,240,31,78,0.397,24,61,0.393,7,17,0.412,14,20,0.7,83,31,82,0.378,24,50,0.48,7,32,0.219,9,13,0.692,78,2012-02-23,ATL,ORL
12733,33,Home,L 83-86 ,240,31,78,0.397,27,61,0.443,4,17,0.235,17,25,0.68,83,33,74,0.446,26,57,0.456,7,17,0.412,13,14,0.929,86,2012-02-28,CLE,BOS
12734,34,@,L 83-104 ,240,32,82,0.39,26,59,0.441,6,23,0.261,13,16,0.813,83,42,87,0.483,38,75,0.507,4,12,0.333,16,16,1.0,104,2012-02-29,HOU,UTA
12735,35,@,L 83-105 ,240,33,82,0.402,28,64,0.438,5,18,0.278,12,14,0.857,83,42,89,0.472,34,72,0.472,8,17,0.471,13,16,0.813,105,2012-03-02,GSW,PHI
12736,36,@,L 83-100 ,240,29,76,0.382,27,67,0.403,2,9,0.222,23,29,0.793,83,37,75,0.493,31,64,0.484,6,11,0.545,20,22,0.909,100,2012-03-03,DET,MEM
12737,37,@,L 83-93 ,240,33,88,0.375,26,64,0.406,7,24,0.292,10,15,0.667,83,35,71,0.493,30,54,0.556,5,17,0.294,18,25,0.72,93,2012-03-04,MIA,LAL
12738,38,Home,W 83-75 ,240,29,78,0.372,25,68,0.368,4,10,0.4,21,24,0.875,83,29,80,0.363,25,61,0.41,4,19,0.211,13,19,0.684,75,2012-03-04,TOR,GSW
12739,39,@,W 83-74 ,240,30,83,0.361,26,61,0.426,4,22,0.182,19,26,0.731,83,30,86,0.349,28,75,0.373,2,11,0.182,12,21,0.571,74,2012-03-09,BRK,CHA
12740,40,@,L 83-87 (OT),265,31,81,0.383,29,65,0.446,2,16,0.125,19,23,0.826,83,35,87,0.402,31,67,0.463,4,20,0.2,13,19,0.684,87,2012-03-18,DET,LAC
12741,41,@,L 83-109 ,240,34,82,0.415,28,66,0.424,6,16,0.375,9,10,0.9,83,40,85,0.471,34,68,0.5,6,17,0.353,23,27,0.852,109,2012-03-22,GSW,HOU
12742,42,Home,L 83-85 ,240,30,71,0.423,25,53,0.472,5,18,0.278,18,23,0.783,83,31,74,0.419,27,56,0.482,4,18,0.222,19,28,0.679,85,2012-03-22,WAS,IND
12743,43,Home,L 83-108 ,240,27,70,0.386,23,54,0.426,4,16,0.25,25,30,0.833,83,42,82,0.512,36,65,0.554,6,17,0.353,18,26,0.692,108,2012-03-25,CLE,PHO
12744,44,Home,L 83-88 ,240,31,78,0.397,28,65,0.431,3,13,0.231,18,22,0.818,83,33,81,0.407,25,60,0.417,8,21,0.381,14,20,0.7,88,2012-03-28,CHA,MIN
12745,45,Home,W 83-71 ,240,32,75,0.427,30,63,0.476,2,12,0.167,17,21,0.81,83,31,84,0.369,28,73,0.384,3,11,0.273,6,7,0.857,71,2012-03-30,CHI,DET
12746,46,@,L 83-102 ,240,28,79,0.354,21,58,0.362,7,21,0.333,20,22,0.909,83,37,90,0.411,31,70,0.443,6,20,0.3,22,26,0.846,102,2012-04-13,CLE,IND
12747,47,Home,W 83-72 ,240,32,76,0.421,28,63,0.444,4,13,0.308,15,21,0.714,83,25,70,0.357,23,54,0.426,2,16,0.125,20,28,0.714,72,2012-04-19,MIA,CHI
12748,48,@,L 83-93 ,240,31,79,0.392,27,64,0.422,4,15,0.267,17,19,0.895,83,38,84,0.452,29,64,0.453,9,20,0.45,8,12,0.667,93,2012-04-21,DAL,CHI
12749,49,@,W 83-81 ,240,31,71,0.437,29,66,0.439,2,5,0.4,19,31,0.613,83,33,79,0.418,27,65,0.415,6,14,0.429,9,13,0.692,81,2012-04-24,NOP,GSW
12750,50,Home,L 83-93 ,240,30,79,0.38,18,53,0.34,12,26,0.462,11,16,0.688,83,34,73,0.466,28,59,0.475,6,14,0.429,19,25,0.76,93,2012-11-10,TOR,PHI
12751,51,@,L 83-103 ,240,30,81,0.37,28,68,0.412,2,13,0.154,21,25,0.84,83,39,83,0.47,33,67,0.493,6,16,0.375,19,31,0.613,103,2012-11-16,DAL,IND
12752,52,@,W 83-76 ,240,31,82,0.378,29,73,0.397,2,9,0.222,19,27,0.704,83,31,85,0.365,26,69,0.377,5,16,0.313,9,12,0.75,76,2012-11-17,UTA,WAS
12753,53,@,L 83-103 ,240,32,71,0.451,28,54,0.519,4,17,0.235,15,19,0.789,83,39,72,0.542,35,61,0.574,4,11,0.364,21,26,0.808,103,2012-11-18,BOS,DET
12754,54,@,L 83-92 ,240,31,86,0.36,27,69,0.391,4,17,0.235,17,22,0.773,83,35,86,0.407,22,63,0.349,13,23,0.565,9,14,0.643,92,2012-11-21,PHI,CLE
12755,55,Home,L 83-95 ,240,32,75,0.427,31,68,0.456,1,7,0.143,18,24,0.75,83,33,82,0.402,23,58,0.397,10,24,0.417,19,29,0.655,95,2012-11-28,BOS,BRK
12756,56,Home,L 83-93 ,240,33,77,0.429,27,61,0.443,6,16,0.375,11,18,0.611,83,34,77,0.442,27,60,0.45,7,17,0.412,18,25,0.72,93,2012-12-08,MEM,ATL
12757,57,@,L 83-102 ,240,30,77,0.39,20,51,0.392,10,26,0.385,13,17,0.765,83,36,79,0.456,30,60,0.5,6,19,0.316,24,34,0.706,102,2012-12-09,TOR,LAC
12758,58,Home,W 83-82 ,240,33,75,0.44,31,65,0.477,2,10,0.2,15,19,0.789,83,29,75,0.387,22,56,0.393,7,19,0.368,17,22,0.773,82,2012-12-15,CHI,BRK
12759,59,@,L 83-90 ,240,34,77,0.442,25,60,0.417,9,17,0.529,6,8,0.75,83,34,81,0.42,26,61,0.426,8,20,0.4,14,17,0.824,90,2012-12-19,WAS,ORL
12760,60,Home,L 83-94 ,240,32,83,0.386,28,66,0.424,4,17,0.235,15,22,0.682,83,33,82,0.402,24,64,0.375,9,18,0.5,19,20,0.95,94,2012-12-26,UTA,GSW
12761,61,@,L 83-101 ,240,31,86,0.36,26,64,0.406,5,22,0.227,16,21,0.762,83,38,73,0.521,26,54,0.481,12,19,0.632,13,16,0.813,101,2012-12-29,BOS,GSW
12762,62,@,L 83-88 ,240,31,82,0.378,28,71,0.394,3,11,0.273,18,24,0.75,83,28,70,0.4,16,45,0.356,12,25,0.48,20,24,0.833,88,2012-12-31,MEM,IND
12763,63,Home,L 83-93 ,240,32,71,0.451,24,49,0.49,8,22,0.364,11,16,0.688,83,34,71,0.479,26,53,0.491,8,18,0.444,17,22,0.773,93,2013-01-02,BOS,MEM
12764,64,@,L 83-100 ,240,28,77,0.364,19,43,0.442,9,34,0.265,18,21,0.857,83,39,82,0.476,27,55,0.491,12,27,0.444,10,16,0.625,100,2013-01-03,SAS,NYK
12765,65,@,L 83-99 ,240,37,84,0.44,30,62,0.484,7,22,0.318,2,5,0.4,83,37,81,0.457,25,58,0.431,12,23,0.522,13,20,0.65,99,2013-01-09,ATL,CLE
12766,66,@,L 83-104 ,240,32,84,0.381,29,76,0.382,3,8,0.375,16,26,0.615,83,39,80,0.488,28,63,0.444,11,17,0.647,15,21,0.714,104,2013-01-12,MEM,DAL
12767,67,@,L 83-93 ,240,30,78,0.385,23,54,0.426,7,24,0.292,16,25,0.64,83,36,79,0.456,34,68,0.5,2,11,0.182,19,27,0.704,93,2013-01-12,ATL,WAS
12768,68,Home,L 83-87 ,240,31,86,0.36,25,65,0.385,6,21,0.286,15,18,0.833,83,32,71,0.451,26,48,0.542,6,23,0.261,17,22,0.773,87,2013-01-13,POR,OKC
12769,69,@,L 83-95 ,240,32,81,0.395,29,64,0.453,3,17,0.176,16,23,0.696,83,39,93,0.419,30,76,0.395,9,17,0.529,8,12,0.667,95,2013-01-21,LAL,CHI
12770,70,Home,L 83-91 ,240,38,83,0.458,35,68,0.515,3,15,0.2,4,6,0.667,83,37,84,0.44,31,64,0.484,6,20,0.3,11,16,0.688,91,2013-01-23,MIN,BRK
12771,71,@,L 83-96 ,240,29,66,0.439,26,51,0.51,3,15,0.2,22,29,0.759,83,42,82,0.512,36,65,0.554,6,17,0.353,6,9,0.667,96,2013-01-27,POR,LAC
12772,72,Home,L 83-91 ,240,32,88,0.364,29,72,0.403,3,16,0.188,16,18,0.889,83,33,77,0.429,24,57,0.421,9,20,0.45,16,23,0.696,91,2013-01-27,MEM,NOH
12773,73,Home,L 83-92 ,240,31,89,0.348,25,66,0.379,6,23,0.261,15,19,0.789,83,37,82,0.451,34,69,0.493,3,13,0.231,15,18,0.833,92,2013-02-05,BRK,LAL
12774,74,@,L 83-84 (OT),265,31,90,0.344,26,71,0.366,5,19,0.263,16,25,0.64,83,37,91,0.407,32,78,0.41,5,13,0.385,5,14,0.357,84,2013-02-26,MIN,PHO
12775,75,@,L 83-119 ,240,28,77,0.364,22,54,0.407,6,23,0.261,21,27,0.778,83,42,90,0.467,29,57,0.509,13,33,0.394,22,27,0.815,119,2013-03-03,CHA,SAC
12776,76,@,L 83-87 ,240,33,83,0.398,25,59,0.424,8,24,0.333,9,12,0.75,83,27,75,0.36,19,52,0.365,8,23,0.348,25,29,0.862,87,2013-03-06,SAC,GSW
12777,77,@,W 83-81 ,240,34,83,0.41,27,66,0.409,7,17,0.412,8,9,0.889,83,32,88,0.364,26,61,0.426,6,27,0.222,11,14,0.786,81,2013-03-06,BOS,IND
12778,78,@,L 83-101 ,240,33,90,0.367,24,70,0.343,9,20,0.45,8,8,1.0,83,40,74,0.541,32,60,0.533,8,14,0.571,13,18,0.722,101,2013-03-06,CHI,SAS
12779,79,@,L 83-107 ,240,29,82,0.354,20,53,0.377,9,29,0.31,16,18,0.889,83,44,82,0.537,32,62,0.516,12,20,0.6,7,18,0.389,107,2013-03-12,SAS,MIN
12780,80,Home,L 83-90 ,240,29,76,0.382,20,57,0.351,9,19,0.474,16,24,0.667,83,32,69,0.464,24,46,0.522,8,23,0.348,18,25,0.72,90,2013-03-18,UTA,NYK
12781,81,@,L 83-90 ,240,30,73,0.411,27,63,0.429,3,10,0.3,20,25,0.8,83,36,76,0.474,32,62,0.516,4,14,0.286,14,18,0.778,90,2013-03-22,MEM,NOH
12782,82,@,L 83-103 ,240,32,79,0.405,22,53,0.415,10,26,0.385,9,13,0.692,83,43,82,0.524,39,71,0.549,4,11,0.364,13,18,0.722,103,2013-03-24,POR,OKC
12783,83,@,L 83-88 ,240,33,94,0.351,29,78,0.372,4,16,0.25,13,16,0.813,83,35,81,0.432,31,67,0.463,4,14,0.286,14,16,0.875,88,2013-04-03,PHI,CHA
12784,84,@,L 83-101 ,240,29,76,0.382,17,46,0.37,12,30,0.4,13,18,0.722,83,41,89,0.461,29,53,0.547,12,36,0.333,7,8,0.875,101,2013-04-05,MIL,NYK
12785,85,@,L 83-95 ,240,32,77,0.416,30,65,0.462,2,12,0.167,17,20,0.85,83,39,77,0.506,28,51,0.549,11,26,0.423,6,11,0.545,95,2013-04-05,NOP,UTA
12786,86,@,L 83-100 ,240,30,83,0.361,27,73,0.37,3,10,0.3,20,23,0.87,83,36,76,0.474,30,57,0.526,6,19,0.316,22,29,0.759,100,2013-04-06,TOR,MIL
12787,87,@,L 83-104 ,240,30,80,0.375,23,66,0.348,7,14,0.5,16,20,0.8,83,42,93,0.452,37,73,0.507,5,20,0.25,15,23,0.652,104,2013-04-09,PHI,BRK
12788,88,@,L 83-94 ,240,33,75,0.44,24,50,0.48,9,25,0.36,8,14,0.571,83,38,88,0.432,30,53,0.566,8,35,0.229,10,10,1.0,94,2013-04-09,MIL,MIA
12789,89,@,L 83-96 ,240,33,90,0.367,29,80,0.363,4,10,0.4,13,20,0.65,83,36,76,0.474,27,51,0.529,9,25,0.36,15,24,0.625,96,2013-10-30,CHA,HOU
12790,90,@,L 83-90 ,240,34,74,0.459,29,58,0.5,5,16,0.313,10,12,0.833,83,36,71,0.507,33,58,0.569,3,13,0.231,15,17,0.882,90,2013-10-30,MIL,NYK
12791,91,Home,L 83-91 ,240,31,81,0.383,20,58,0.345,11,23,0.478,10,16,0.625,83,33,78,0.423,27,59,0.458,6,19,0.316,19,21,0.905,91,2013-11-09,MIL,DAL
12792,92,Home,L 83-89 ,240,29,77,0.377,22,56,0.393,7,21,0.333,18,25,0.72,83,30,82,0.366,27,70,0.386,3,12,0.25,26,30,0.867,89,2013-11-13,BOS,CHA
12793,93,@,L 83-89 (OT),265,31,79,0.392,30,66,0.455,1,13,0.077,20,28,0.714,83,33,85,0.388,26,68,0.382,7,17,0.412,16,19,0.842,89,2013-11-25,CHI,UTA
12794,94,Home,L 83-90 ,240,28,73,0.384,20,43,0.465,8,30,0.267,19,32,0.594,83,36,76,0.474,27,54,0.5,9,22,0.409,9,13,0.692,90,2013-11-29,TOR,MIA
12795,95,Home,L 83-113 ,240,29,73,0.397,25,57,0.439,4,16,0.25,21,31,0.677,83,44,77,0.571,28,50,0.56,16,27,0.593,9,11,0.818,113,2013-12-05,BRK,NYK
12796,96,@,L 83-105 ,240,27,76,0.355,25,60,0.417,2,16,0.125,27,34,0.794,83,37,83,0.446,31,55,0.564,6,28,0.214,25,39,0.641,105,2013-12-06,GSW,HOU
12797,97,@,L 83-121 ,240,30,70,0.429,20,45,0.444,10,25,0.4,13,20,0.65,83,44,83,0.53,27,49,0.551,17,34,0.5,16,19,0.842,121,2013-12-06,ORL,NYK
12798,98,Home,L 83-94 ,240,33,92,0.359,30,71,0.423,3,21,0.143,14,19,0.737,83,35,82,0.427,30,55,0.545,5,27,0.185,19,29,0.655,94,2013-12-09,PHI,LAC
12799,99,Home,L 83-92 ,240,31,84,0.369,27,67,0.403,4,17,0.235,17,18,0.944,83,38,90,0.422,31,71,0.437,7,19,0.368,9,9,1.0,92,2013-12-11,CHA,ORL
12800,0,Home,W 83-78 ,240,31,76,0.408,26,57,0.456,5,19,0.263,16,19,0.842,83,24,72,0.333,18,51,0.353,6,21,0.286,24,29,0.828,78,2013-12-11,NYK,CHI
12801,1,@,W 83-82 ,240,33,83,0.398,28,71,0.394,5,12,0.417,12,16,0.75,83,28,81,0.346,23,63,0.365,5,18,0.278,21,26,0.808,82,2013-12-16,ORL,CHI
12802,2,@,L 83-102 ,240,26,80,0.325,22,60,0.367,4,20,0.2,27,33,0.818,83,38,98,0.388,26,67,0.388,12,31,0.387,14,19,0.737,102,2013-12-21,LAL,GSW
12803,3,Home,L 83-95 ,240,30,79,0.38,20,60,0.333,10,19,0.526,13,21,0.619,83,31,73,0.425,21,45,0.467,10,28,0.357,23,33,0.697,95,2013-12-27,NYK,TOR
12804,4,Home,L 83-105 ,240,32,74,0.432,29,57,0.509,3,17,0.176,16,19,0.842,83,41,78,0.526,28,52,0.538,13,26,0.5,10,11,0.909,105,2013-12-28,CHI,DAL
12805,5,Home,W 83-80 ,240,34,80,0.425,26,59,0.441,8,21,0.381,7,9,0.778,83,31,84,0.369,24,70,0.343,7,14,0.5,11,15,0.733,80,2013-12-30,UTA,CHA
12806,6,Home,L 83-97 ,240,31,72,0.431,25,56,0.446,6,16,0.375,15,24,0.625,83,40,85,0.471,35,68,0.515,5,17,0.294,12,15,0.8,97,2014-01-07,CHA,WAS
12807,7,Home,W 83-80 ,240,32,86,0.372,23,54,0.426,9,32,0.281,10,11,0.909,83,29,70,0.414,23,51,0.451,6,19,0.316,16,22,0.727,80,2014-01-10,ATL,HOU
12808,8,@,L 83-103 ,240,26,78,0.333,18,51,0.353,8,27,0.296,23,29,0.793,83,41,80,0.513,38,66,0.576,3,14,0.214,18,19,0.947,103,2014-01-10,ORL,SAC
12809,9,@,L 83-88 ,240,30,78,0.385,19,54,0.352,11,24,0.458,12,25,0.48,83,29,84,0.345,25,67,0.373,4,17,0.235,26,36,0.722,88,2014-01-15,TOR,BOS
12810,10,Home,L 83-101 ,240,32,75,0.427,27,48,0.563,5,27,0.185,14,19,0.737,83,43,80,0.538,38,67,0.567,5,13,0.385,10,13,0.769,101,2014-01-24,BOS,OKC
12811,11,@,L 83-98 ,240,28,84,0.333,22,65,0.338,6,19,0.316,21,26,0.808,83,37,87,0.425,23,56,0.411,14,31,0.452,10,13,0.769,98,2014-01-29,ORL,TOR
12812,12,@,L 83-91 (OT),265,33,86,0.384,30,72,0.417,3,14,0.214,14,16,0.875,83,35,88,0.398,25,68,0.368,10,20,0.5,11,18,0.611,91,2014-02-09,MEM,CLE
12813,13,@,L 83-104 ,240,30,78,0.385,26,58,0.448,4,20,0.2,19,23,0.826,83,38,94,0.404,27,61,0.443,11,33,0.333,17,22,0.773,104,2014-02-12,ATL,TOR
12814,14,Home,L 83-96 ,240,30,78,0.385,28,60,0.467,2,18,0.111,21,26,0.808,83,41,96,0.427,33,76,0.434,8,20,0.4,6,10,0.6,96,2014-02-23,CLE,WAS
12815,15,@,L 83-103 ,240,30,84,0.357,25,63,0.397,5,21,0.238,18,22,0.818,83,37,83,0.446,32,69,0.464,5,14,0.357,24,30,0.8,103,2014-02-26,GSW,CHI
12816,16,@,L 83-94 ,240,32,91,0.352,29,72,0.403,3,19,0.158,16,19,0.842,83,40,73,0.548,36,57,0.632,4,16,0.25,10,13,0.769,94,2014-03-11,BOS,IND
12817,17,Home,L 83-97 ,240,30,85,0.353,21,60,0.35,9,25,0.36,14,16,0.875,83,39,85,0.459,26,51,0.51,13,34,0.382,6,7,0.857,97,2014-03-17,CHA,ATL
12818,18,@,L 83-84 ,240,28,61,0.459,22,42,0.524,6,19,0.316,21,29,0.724,83,30,81,0.37,23,67,0.343,7,14,0.5,17,21,0.81,84,2014-03-26,MIA,IND
12819,19,@,L 83-107 ,240,31,82,0.378,24,54,0.444,7,28,0.25,14,16,0.875,83,43,86,0.5,34,64,0.531,9,22,0.409,12,16,0.75,107,2014-03-26,ATL,MIN
12820,20,@,L 83-93 ,240,35,70,0.5,27,44,0.614,8,26,0.308,5,10,0.5,83,34,66,0.515,27,41,0.659,7,25,0.28,18,22,0.818,93,2014-03-31,TOR,MIA
12821,21,Home,L 83-92 ,240,33,85,0.388,25,61,0.41,8,24,0.333,9,15,0.6,83,33,70,0.471,24,41,0.585,9,29,0.31,17,24,0.708,92,2014-03-31,UTA,NYK
12822,22,Home,L 83-95 ,240,36,87,0.414,32,63,0.508,4,24,0.167,7,13,0.538,83,40,72,0.556,31,49,0.633,9,23,0.391,6,11,0.545,95,2014-04-08,UTA,DAL
12823,23,Home,L 83-98 ,240,30,81,0.37,22,66,0.333,8,15,0.533,15,19,0.789,83,39,80,0.488,31,62,0.5,8,18,0.444,12,19,0.632,98,2014-11-04,NYK,WAS
12824,24,Home,L 83-95 ,240,29,70,0.414,20,47,0.426,9,23,0.391,16,26,0.615,83,31,72,0.431,22,45,0.489,9,27,0.333,24,27,0.889,95,2014-11-17,BRK,MIA
12825,25,Home,L 83-106 ,240,31,84,0.369,24,61,0.393,7,23,0.304,14,20,0.7,83,38,85,0.447,26,54,0.481,12,31,0.387,18,20,0.9,106,2014-11-22,IND,PHO
12826,26,@,L 83-91 ,240,30,75,0.4,22,49,0.449,8,26,0.308,15,25,0.6,83,33,66,0.5,27,49,0.551,6,17,0.353,19,21,0.905,91,2014-11-22,PHI,NYK
12827,27,@,L 83-98 ,240,31,70,0.443,24,52,0.462,7,18,0.389,14,16,0.875,83,41,94,0.436,37,78,0.474,4,16,0.25,12,14,0.857,98,2014-11-28,ORL,IND
12828,28,Home,W 83-80 ,240,35,76,0.461,30,64,0.469,5,12,0.417,8,12,0.667,83,30,81,0.37,24,64,0.375,6,17,0.353,14,21,0.667,80,2014-11-29,WAS,NOP
12829,29,@,L 83-102 ,240,29,76,0.382,26,58,0.448,3,18,0.167,22,26,0.846,83,38,88,0.432,21,45,0.467,17,43,0.395,9,14,0.643,102,2014-12-31,CHA,HOU
12830,30,@,L 83-111 ,240,35,88,0.398,29,59,0.492,6,29,0.207,7,11,0.636,83,44,83,0.53,37,68,0.544,7,15,0.467,16,20,0.8,111,2015-01-02,HOU,NOP
12831,31,@,L 83-105 ,240,33,76,0.434,25,50,0.5,8,26,0.308,9,13,0.692,83,43,82,0.524,36,67,0.537,7,15,0.467,12,19,0.632,105,2015-01-05,NYK,MEM
12832,32,@,L 83-104 ,240,29,89,0.326,20,59,0.339,9,30,0.3,16,23,0.696,83,36,92,0.391,26,73,0.356,10,19,0.526,22,28,0.786,104,2015-01-07,OKC,SAC
12833,33,@,L 83-99 ,240,29,77,0.377,26,63,0.413,3,14,0.214,22,30,0.733,83,40,95,0.421,32,68,0.471,8,27,0.296,11,15,0.733,99,2015-01-08,MIA,POR
12834,34,Home,L 83-95 ,240,32,75,0.427,25,59,0.424,7,16,0.438,12,14,0.857,83,35,74,0.473,27,57,0.474,8,17,0.471,17,21,0.81,95,2015-01-16,SAC,MIA
12835,35,@,L 83-101 ,240,31,81,0.383,22,57,0.386,9,24,0.375,12,22,0.545,83,37,79,0.468,31,65,0.477,6,14,0.429,21,25,0.84,101,2015-01-24,PHI,MEM
12836,36,@,W 83-75 ,240,32,77,0.416,28,56,0.5,4,21,0.19,15,21,0.714,83,30,81,0.37,26,62,0.419,4,19,0.211,11,18,0.611,75,2015-02-01,MIA,BOS
12837,37,@,L 83-85 ,240,33,91,0.363,28,63,0.444,5,28,0.179,12,17,0.706,83,34,75,0.453,30,63,0.476,4,12,0.333,13,21,0.619,85,2015-02-08,PHO,SAC
12838,38,@,L 83-89 ,240,25,73,0.342,20,58,0.345,5,15,0.333,28,36,0.778,83,31,67,0.463,27,56,0.482,4,11,0.364,23,28,0.821,89,2015-02-11,NYK,ORL
12839,39,Home,L 83-101 ,240,37,99,0.374,34,80,0.425,3,19,0.158,6,7,0.857,83,40,79,0.506,28,46,0.609,12,33,0.364,9,15,0.6,101,2015-02-22,NYK,CLE
12840,40,Home,L 83-98 ,240,31,85,0.365,25,70,0.357,6,15,0.4,15,20,0.75,83,40,80,0.5,32,62,0.516,8,18,0.444,10,14,0.714,98,2015-03-01,ORL,CHO
12841,41,Home,L 83-89 ,240,32,88,0.364,22,56,0.393,10,32,0.313,9,18,0.5,83,27,71,0.38,21,59,0.356,6,12,0.5,29,41,0.707,89,2015-03-06,PHI,UTA
12842,42,@,L 83-96 ,240,30,72,0.417,25,53,0.472,5,19,0.263,18,27,0.667,83,37,78,0.474,29,64,0.453,8,14,0.571,14,16,0.875,96,2015-03-14,MIL,MEM
12843,43,@,L 83-94 ,240,29,88,0.33,21,62,0.339,8,26,0.308,17,19,0.895,83,36,84,0.429,25,57,0.439,11,27,0.407,11,18,0.611,94,2015-03-18,DET,PHI
12844,44,Home,L 83-95 ,240,32,78,0.41,29,62,0.468,3,16,0.188,16,20,0.8,83,39,90,0.433,29,59,0.492,10,31,0.323,7,10,0.7,95,2015-03-25,ORL,ATL
12845,45,@,L 83-94 ,240,29,84,0.345,25,67,0.373,4,17,0.235,21,29,0.724,83,36,75,0.48,29,57,0.509,7,18,0.389,15,21,0.714,94,2015-03-27,LAL,TOR
12846,46,@,L 83-97 ,240,33,81,0.407,28,65,0.431,5,16,0.313,12,20,0.6,83,38,83,0.458,30,60,0.5,8,23,0.348,13,17,0.765,97,2015-03-30,SAC,MEM
12847,47,Home,L 83-92 ,240,34,81,0.42,33,66,0.5,1,15,0.067,14,18,0.778,83,38,79,0.481,30,57,0.526,8,22,0.364,8,10,0.8,92,2015-04-04,MEM,WAS
12848,48,@,L 83-95 ,240,32,78,0.41,24,54,0.444,8,24,0.333,11,15,0.733,83,36,76,0.474,34,67,0.507,2,9,0.222,21,26,0.808,95,2015-04-15,IND,MEM
12849,49,Home,L 83-99 ,240,30,73,0.411,24,56,0.429,6,17,0.353,17,23,0.739,83,38,86,0.442,31,56,0.554,7,30,0.233,16,19,0.842,99,2015-11-10,MIL,BOS
12850,50,@,L 83-92 ,240,33,82,0.402,25,60,0.417,8,22,0.364,9,11,0.818,83,33,85,0.388,28,69,0.406,5,16,0.313,21,25,0.84,92,2015-11-14,PHI,SAS
12851,51,@,L 83-88 ,240,34,83,0.41,28,61,0.459,6,22,0.273,9,12,0.75,83,33,81,0.407,25,53,0.472,8,28,0.286,14,19,0.737,88,2015-11-25,DAL,SAS
12852,52,@,L 83-87 ,240,34,101,0.337,28,77,0.364,6,24,0.25,9,21,0.429,83,35,81,0.432,31,69,0.449,4,12,0.333,13,16,0.813,87,2015-11-29,DET,BRK
12853,53,Home,L 83-103 ,240,30,80,0.375,28,64,0.438,2,16,0.125,21,25,0.84,83,40,80,0.5,30,62,0.484,10,18,0.556,13,18,0.722,103,2015-12-03,MEM,SAS
12854,54,Home,W 83-80 ,240,31,87,0.356,24,64,0.375,7,23,0.304,14,16,0.875,83,30,88,0.341,20,66,0.303,10,22,0.455,10,12,0.833,80,2015-12-10,CHI,LAC
12855,55,@,L 83-96 ,240,35,81,0.432,30,61,0.492,5,20,0.25,8,13,0.615,83,36,86,0.419,30,58,0.517,6,28,0.214,18,20,0.9,96,2015-12-11,MIA,IND
12856,56,@,L 83-90 ,240,33,80,0.413,29,69,0.42,4,11,0.364,13,16,0.813,83,34,70,0.486,27,50,0.54,7,20,0.35,15,23,0.652,90,2015-12-11,MIL,TOR
12857,57,Home,L 83-108 ,240,30,72,0.417,27,62,0.435,3,10,0.3,20,25,0.8,83,44,82,0.537,34,58,0.586,10,24,0.417,10,14,0.714,108,2015-12-23,MIN,SAS
12858,58,@,L 83-89 ,240,30,95,0.316,25,65,0.385,5,30,0.167,18,25,0.72,83,32,78,0.41,27,60,0.45,5,18,0.278,20,27,0.741,89,2015-12-25,CLE,GSW
12859,59,@,W 83-77 ,240,33,83,0.398,20,55,0.364,13,28,0.464,4,6,0.667,83,29,73,0.397,22,51,0.431,7,22,0.318,12,20,0.6,77,2016-01-08,ORL,BRK
12860,60,@,L 83-97 ,240,31,84,0.369,24,61,0.393,7,23,0.304,14,19,0.737,83,40,91,0.44,32,60,0.533,8,31,0.258,9,10,0.9,97,2016-01-09,CHA,LAC
12861,61,@,L 83-98 ,240,34,82,0.415,28,63,0.444,6,19,0.316,9,17,0.529,83,39,71,0.549,30,51,0.588,9,20,0.45,11,18,0.611,98,2016-01-09,MIA,UTA
12862,62,@,W 83-77 ,240,30,77,0.39,22,55,0.4,8,22,0.364,15,17,0.882,83,31,86,0.36,29,67,0.433,2,19,0.105,13,15,0.867,77,2016-01-15,DAL,CHI
12863,63,@,L 83-112 ,240,29,81,0.358,23,58,0.397,6,23,0.261,19,25,0.76,83,42,90,0.467,37,70,0.529,5,20,0.25,23,28,0.821,112,2016-01-17,DAL,SAS
12864,64,Home,L 83-96 ,240,35,94,0.372,31,70,0.443,4,24,0.167,9,22,0.409,83,38,87,0.437,31,70,0.443,7,17,0.412,13,15,0.867,96,2016-01-23,CLE,CHI
12865,65,Home,L 83-85 ,240,33,79,0.418,23,56,0.411,10,23,0.435,7,14,0.5,83,33,85,0.388,28,58,0.483,5,27,0.185,14,21,0.667,85,2016-01-27,ATL,LAC
12866,66,@,L 83-103 ,240,29,79,0.367,28,63,0.444,1,16,0.063,24,27,0.889,83,38,80,0.475,28,52,0.538,10,28,0.357,17,20,0.85,103,2016-01-28,MIL,MEM
12867,67,@,L 83-108 ,240,32,81,0.395,29,61,0.475,3,20,0.15,16,24,0.667,83,42,90,0.467,30,63,0.476,12,27,0.444,12,16,0.75,108,2016-03-04,WAS,CLE
12868,68,@,L 83-95 ,240,33,95,0.347,27,72,0.375,6,23,0.261,11,14,0.786,83,36,84,0.429,25,50,0.5,11,34,0.324,12,17,0.706,95,2016-03-12,MEM,ATL
12869,69,@,L 83-98 ,240,34,87,0.391,30,70,0.429,4,17,0.235,11,14,0.786,83,39,88,0.443,34,68,0.5,5,20,0.25,15,20,0.75,98,2016-10-30,MIL,DET
12870,70,Home,L 83-85 ,240,34,87,0.391,27,65,0.415,7,22,0.318,8,18,0.444,83,34,84,0.405,29,64,0.453,5,20,0.25,12,20,0.6,85,2016-11-02,LAC,OKC
12871,71,@,L 83-89 (OT),265,30,81,0.37,19,47,0.404,11,34,0.324,12,16,0.75,83,33,94,0.351,25,67,0.373,8,27,0.296,15,20,0.75,89,2016-11-02,NOP,MEM
12872,72,@,L 83-90 ,240,34,83,0.41,26,60,0.433,8,23,0.348,7,10,0.7,83,33,76,0.434,26,55,0.473,7,21,0.333,17,23,0.739,90,2016-11-16,DAL,BOS
12873,73,Home,L 83-120 ,240,33,103,0.32,27,80,0.338,6,23,0.261,11,12,0.917,83,40,90,0.444,27,54,0.5,13,36,0.361,27,32,0.844,120,2016-11-21,IND,GSW
12874,74,@,L 83-108 ,240,28,88,0.318,19,61,0.311,9,27,0.333,18,31,0.581,83,39,79,0.494,31,53,0.585,8,26,0.308,22,31,0.71,108,2016-11-23,DEN,UTA
12875,75,Home,L 83-95 ,240,28,76,0.368,23,56,0.411,5,20,0.25,22,26,0.846,83,39,86,0.453,33,71,0.465,6,15,0.4,11,12,0.917,95,2016-11-29,SAS,ORL
12876,76,@,L 83-100 ,240,35,87,0.402,29,63,0.46,6,24,0.25,7,8,0.875,83,35,73,0.479,20,47,0.426,15,26,0.577,15,28,0.536,100,2016-12-29,PHI,UTA
12877,77,@,L 83-105 ,240,30,86,0.349,22,57,0.386,8,29,0.276,15,26,0.577,83,38,85,0.447,24,40,0.6,14,45,0.311,15,22,0.682,105,2017-01-31,SAC,HOU
12878,78,@,L 83-96 ,240,31,77,0.403,26,54,0.481,5,23,0.217,16,25,0.64,83,36,78,0.462,24,52,0.462,12,26,0.462,12,16,0.75,96,2017-02-25,NOP,DAL
12879,79,@,L 83-88 ,240,30,84,0.357,20,51,0.392,10,33,0.303,13,18,0.722,83,33,81,0.407,23,54,0.426,10,27,0.37,12,15,0.8,88,2017-03-06,NOP,UTA
12880,80,@,L 82-95 ,240,34,73,0.466,31,66,0.47,3,7,0.429,11,19,0.579,82,35,88,0.398,25,55,0.455,10,33,0.303,15,22,0.682,95,2011-12-26,MEM,SAS
12881,81,@,L 82-99 ,240,21,67,0.313,15,45,0.333,6,22,0.273,34,41,0.829,82,38,73,0.521,29,57,0.509,9,16,0.563,14,22,0.636,99,2011-12-29,NYK,LAL
12882,82,@,L 82-98 ,240,27,71,0.38,20,49,0.408,7,22,0.318,21,28,0.75,82,38,78,0.487,22,52,0.423,16,26,0.615,6,11,0.545,98,2012-01-01,BRK,CLE
12883,83,@,L 82-99 ,240,29,77,0.377,22,53,0.415,7,24,0.292,17,21,0.81,82,36,85,0.424,26,63,0.413,10,22,0.455,17,24,0.708,99,2012-01-01,DAL,MIN
12884,84,@,L 82-90 ,240,38,93,0.409,37,84,0.44,1,9,0.111,5,10,0.5,82,35,74,0.473,29,55,0.527,6,19,0.316,14,21,0.667,90,2012-01-08,MEM,LAL
12885,85,@,W 82-70 ,240,32,83,0.386,26,66,0.394,6,17,0.353,12,16,0.75,82,30,88,0.341,29,75,0.387,1,13,0.077,9,11,0.818,70,2012-01-10,HOU,CHA
12886,86,@,L 82-94 ,240,35,75,0.467,32,61,0.525,3,14,0.214,9,14,0.643,82,37,84,0.44,26,61,0.426,11,23,0.478,9,13,0.692,94,2012-01-16,MIL,PHI
12887,87,Home,L 82-91 ,240,25,67,0.373,22,55,0.4,3,12,0.25,29,35,0.829,82,28,80,0.35,23,50,0.46,5,30,0.167,30,34,0.882,91,2012-01-22,MIA,MIL
12888,88,@,L 82-103 ,240,32,83,0.386,31,74,0.419,1,9,0.111,17,20,0.85,82,36,70,0.514,26,53,0.491,10,17,0.588,21,26,0.808,103,2012-01-30,DET,MIL
12889,89,@,L 82-98 ,240,32,74,0.432,25,57,0.439,7,17,0.412,11,16,0.688,82,40,84,0.476,36,73,0.493,4,11,0.364,14,19,0.737,98,2012-02-01,CHI,PHI
12890,90,@,W 82-75 ,240,31,81,0.383,26,67,0.388,5,14,0.357,15,18,0.833,82,29,86,0.337,28,72,0.389,1,14,0.071,16,19,0.842,75,2012-02-17,DAL,PHI
12891,91,@,L 82-99 ,240,32,81,0.395,24,52,0.462,8,29,0.276,10,18,0.556,82,38,80,0.475,30,58,0.517,8,22,0.364,15,24,0.625,99,2012-02-22,ATL,NYK
12892,92,Home,L 82-85 ,240,31,92,0.337,27,74,0.365,4,18,0.222,16,26,0.615,82,34,83,0.41,33,71,0.465,1,12,0.083,16,17,0.941,85,2012-02-29,ATL,GSW
12893,93,@,L 82-96 ,240,29,68,0.426,21,43,0.488,8,25,0.32,16,20,0.8,82,38,70,0.543,28,50,0.56,10,20,0.5,10,17,0.588,96,2012-03-14,ATL,LAC
12894,94,@,W 82-79 ,240,29,79,0.367,27,66,0.409,2,13,0.154,22,28,0.786,82,29,75,0.387,21,58,0.362,8,17,0.471,13,18,0.722,79,2012-03-21,NYK,PHI
12895,95,Home,L 82-94 ,240,35,85,0.412,34,77,0.442,1,8,0.125,11,11,1.0,82,36,82,0.439,29,66,0.439,7,16,0.438,15,23,0.652,94,2012-03-21,TOR,CHI
12896,96,@,L 82-94 ,240,32,82,0.39,29,72,0.403,3,10,0.3,15,24,0.625,82,36,77,0.468,32,62,0.516,4,15,0.267,18,21,0.857,94,2012-03-28,UTA,BOS
12897,97,Home,L 82-97 ,240,33,82,0.402,29,64,0.453,4,18,0.222,12,16,0.75,82,38,82,0.463,30,65,0.462,8,17,0.471,13,17,0.765,97,2012-04-06,MIA,MEM
12898,98,Home,L 82-88 ,240,31,78,0.397,26,65,0.4,5,13,0.385,15,20,0.75,82,29,80,0.363,23,60,0.383,6,20,0.3,24,31,0.774,88,2012-04-07,PHI,ORL
12899,99,Home,L 82-95 ,240,31,77,0.403,26,56,0.464,5,21,0.238,15,22,0.682,82,39,91,0.429,27,60,0.45,12,31,0.387,5,10,0.5,95,2012-04-12,MIN,LAC
12900,0,@,L 82-105 ,240,33,74,0.446,28,57,0.491,5,17,0.294,11,19,0.579,82,44,85,0.518,42,71,0.592,2,14,0.143,15,17,0.882,105,2012-04-13,CHA,MIA
12901,1,Home,L 82-94 ,240,32,87,0.368,26,65,0.4,6,22,0.273,12,14,0.857,82,37,81,0.457,32,67,0.478,5,14,0.357,15,22,0.682,94,2012-04-14,BRK,BOS
12902,2,Home,L 82-94 ,240,32,79,0.405,29,66,0.439,3,13,0.231,15,20,0.75,82,39,80,0.488,34,65,0.523,5,15,0.333,11,17,0.647,94,2012-04-15,CHA,BOS
12903,3,Home,L 82-89 ,240,29,88,0.33,26,71,0.366,3,17,0.176,21,25,0.84,82,32,75,0.427,27,57,0.474,5,18,0.278,20,23,0.87,89,2012-11-03,CHI,NOH
12904,4,@,L 82-96 ,240,32,80,0.4,25,60,0.417,7,20,0.35,11,16,0.688,82,33,82,0.402,24,56,0.429,9,26,0.346,21,26,0.808,96,2012-11-10,DET,HOU
12905,5,Home,W 82-74 ,240,29,78,0.372,22,54,0.407,7,24,0.292,17,25,0.68,82,30,84,0.357,29,71,0.408,1,13,0.077,13,18,0.722,74,2012-11-11,BRK,ORL
12906,6,Home,L 82-90 ,240,29,80,0.363,25,64,0.391,4,16,0.25,20,25,0.8,82,30,65,0.462,26,50,0.52,4,15,0.267,26,32,0.813,90,2012-11-12,DAL,MIN
12907,7,Home,L 82-84 ,240,31,74,0.419,25,54,0.463,6,20,0.3,14,22,0.636,82,35,90,0.389,28,70,0.4,7,20,0.35,7,11,0.636,84,2012-11-13,LAL,SAS
12908,8,@,L 82-103 ,240,29,74,0.392,24,57,0.421,5,17,0.294,19,24,0.792,82,38,80,0.475,30,62,0.484,8,18,0.444,19,28,0.679,103,2012-11-28,TOR,MEM
12909,9,@,L 82-84 ,240,30,86,0.349,20,55,0.364,10,31,0.323,12,18,0.667,82,31,71,0.437,26,59,0.441,5,12,0.417,17,19,0.895,84,2012-11-28,POR,WAS
12910,10,@,L 82-91 ,240,30,80,0.375,26,65,0.4,4,15,0.267,18,21,0.857,82,32,79,0.405,28,58,0.483,4,21,0.19,23,28,0.821,91,2012-12-07,ORL,SAC
12911,11,Home,W 82-80 ,240,34,89,0.382,29,67,0.433,5,22,0.227,9,11,0.818,82,33,73,0.452,31,63,0.492,2,10,0.2,12,12,1.0,80,2012-12-12,PHO,MEM
12912,12,@,L 82-83 ,240,29,75,0.387,22,56,0.393,7,19,0.368,17,22,0.773,82,33,75,0.44,31,65,0.477,2,10,0.2,15,19,0.789,83,2012-12-15,BRK,CHI
12913,13,@,L 82-92 ,240,31,76,0.408,25,55,0.455,6,21,0.286,14,17,0.824,82,36,89,0.404,33,76,0.434,3,13,0.231,17,20,0.85,92,2012-12-21,DAL,MEM
12914,14,Home,L 82-94 ,240,31,79,0.392,27,59,0.458,4,20,0.2,16,23,0.696,82,38,88,0.432,33,71,0.465,5,17,0.294,13,16,0.813,94,2012-12-22,MIL,CLE
12915,15,@,L 82-103 ,240,29,69,0.42,28,60,0.467,1,9,0.111,23,28,0.821,82,44,76,0.579,35,58,0.603,9,18,0.5,6,10,0.6,103,2013-01-16,MEM,SAS
12916,16,Home,L 82-85 (OT),265,31,85,0.365,28,71,0.394,3,14,0.214,17,21,0.81,82,34,84,0.405,34,79,0.43,0,5,0.0,17,28,0.607,85,2013-01-19,CHI,MEM
12917,17,@,W 82-81 ,240,34,69,0.493,26,52,0.5,8,17,0.471,6,11,0.545,82,35,83,0.422,31,73,0.425,4,10,0.4,7,7,1.0,81,2013-01-21,IND,MEM
12918,18,@,L 82-85 ,240,34,82,0.415,30,69,0.435,4,13,0.308,10,14,0.714,82,31,71,0.437,28,57,0.491,3,14,0.214,20,26,0.769,85,2013-01-23,DET,CHI
12919,19,Home,L 82-100 ,240,31,80,0.388,28,60,0.467,3,20,0.15,17,20,0.85,82,34,71,0.479,23,50,0.46,11,21,0.524,21,26,0.808,100,2013-01-25,NOP,HOU
12920,20,Home,L 82-88 ,240,26,71,0.366,18,53,0.34,8,18,0.444,22,26,0.846,82,29,80,0.363,23,67,0.343,6,13,0.462,24,34,0.706,88,2013-02-20,TOR,MEM
12921,21,@,L 82-114 ,240,29,82,0.354,26,63,0.413,3,19,0.158,21,37,0.568,82,41,73,0.562,31,59,0.525,10,14,0.714,22,33,0.667,114,2013-02-22,DET,IND
12922,22,@,L 82-88 ,240,35,84,0.417,30,69,0.435,5,15,0.333,7,9,0.778,82,34,76,0.447,31,60,0.517,3,16,0.188,17,29,0.586,88,2013-02-22,ORL,MEM
12923,23,@,L 82-93 ,240,33,85,0.388,29,74,0.392,4,11,0.364,12,21,0.571,82,32,83,0.386,29,69,0.42,3,14,0.214,26,33,0.788,93,2013-02-28,PHI,CHI
12924,24,Home,L 82-108 ,240,29,73,0.397,27,58,0.466,2,15,0.133,22,26,0.846,82,44,83,0.53,33,59,0.559,11,24,0.458,9,15,0.6,108,2013-03-03,ORL,MEM
12925,25,@,L 82-87 ,240,29,65,0.446,23,46,0.5,6,19,0.316,18,22,0.818,82,31,76,0.408,27,62,0.435,4,14,0.286,21,31,0.677,87,2013-03-06,WAS,MIN
12926,26,Home,L 82-119 ,240,34,78,0.436,33,60,0.55,1,18,0.056,13,15,0.867,82,45,83,0.542,36,62,0.581,9,21,0.429,20,23,0.87,119,2013-03-18,DET,BRK
12927,27,Home,L 82-105 ,240,32,79,0.405,25,59,0.424,7,20,0.35,11,13,0.846,82,42,79,0.532,28,53,0.528,14,26,0.538,7,8,0.875,105,2013-03-26,DET,MIN
12928,28,Home,L 82-99 ,240,31,76,0.408,26,58,0.448,5,18,0.278,15,23,0.652,82,44,82,0.537,40,69,0.58,4,13,0.308,7,9,0.778,99,2013-03-29,DET,TOR
12929,29,Home,L 82-95 ,240,32,66,0.485,23,40,0.575,9,26,0.346,9,19,0.474,82,40,77,0.519,33,55,0.6,7,22,0.318,8,12,0.667,95,2013-04-03,ATL,NYK
12930,30,@,W 82-78 ,240,29,83,0.349,24,66,0.364,5,17,0.294,19,28,0.679,82,23,74,0.311,12,42,0.286,11,32,0.344,21,28,0.75,78,2013-04-12,MEM,HOU
12931,31,Home,W 82-81 ,240,31,76,0.408,28,60,0.467,3,16,0.188,17,19,0.895,82,31,86,0.36,22,62,0.355,9,24,0.375,10,14,0.714,81,2013-10-31,CHI,NYK
12932,32,Home,L 82-91 ,240,35,91,0.385,30,75,0.4,5,16,0.313,7,11,0.636,82,35,76,0.461,31,61,0.508,4,15,0.267,17,22,0.773,91,2013-11-15,UTA,SAS
12933,33,Home,L 82-91 ,240,35,80,0.438,30,66,0.455,5,14,0.357,7,12,0.583,82,35,86,0.407,24,55,0.436,11,31,0.355,10,15,0.667,91,2013-11-20,MIL,POR
12934,34,Home,L 82-97 ,240,35,69,0.507,30,58,0.517,5,11,0.455,7,9,0.778,82,38,81,0.469,32,64,0.5,6,17,0.353,15,18,0.833,97,2013-11-22,BOS,IND
12935,35,@,L 82-121 ,240,32,81,0.395,28,69,0.406,4,12,0.333,14,23,0.609,82,48,82,0.585,40,61,0.656,8,21,0.381,17,19,0.895,121,2013-11-24,CHI,LAC
12936,36,@,L 82-89 ,240,30,78,0.385,27,61,0.443,3,17,0.176,19,25,0.76,82,33,82,0.402,25,61,0.41,8,21,0.381,15,17,0.882,89,2013-12-03,CHA,DAL
12937,37,@,L 82-88 ,240,28,87,0.322,21,52,0.404,7,35,0.2,19,26,0.731,82,31,83,0.373,27,69,0.391,4,14,0.286,22,30,0.733,88,2013-12-07,LAC,CLE
12938,38,Home,L 82-108 ,240,31,85,0.365,29,75,0.387,2,10,0.2,18,22,0.818,82,44,88,0.5,36,70,0.514,8,18,0.444,12,14,0.857,108,2013-12-07,MEM,GSW
12939,39,Home,L 82-90 ,240,30,73,0.411,23,53,0.434,7,20,0.35,15,22,0.682,82,34,74,0.459,29,56,0.518,5,18,0.278,17,23,0.739,90,2013-12-07,MIL,BRK
12940,40,Home,L 82-103 ,240,24,82,0.293,19,60,0.317,5,22,0.227,29,39,0.744,82,43,78,0.551,39,60,0.65,4,18,0.222,13,19,0.684,103,2013-12-07,MIN,MIA
12941,41,Home,L 82-83 ,240,28,81,0.346,23,63,0.365,5,18,0.278,21,26,0.808,82,33,83,0.398,28,71,0.394,5,12,0.417,12,16,0.75,83,2013-12-16,CHI,ORL
12942,42,Home,L 82-86 ,240,28,86,0.326,21,71,0.296,7,15,0.467,19,20,0.95,82,33,82,0.402,25,61,0.41,8,21,0.381,12,15,0.8,86,2013-12-18,ORL,UTA
12943,43,@,L 82-106 ,240,31,77,0.403,24,56,0.429,7,21,0.333,13,17,0.765,82,43,86,0.5,34,67,0.507,9,19,0.474,11,17,0.647,106,2013-12-28,DET,WAS
12944,44,@,L 82-95 ,240,32,74,0.432,27,60,0.45,5,14,0.357,13,20,0.65,82,34,78,0.436,27,59,0.458,7,19,0.368,20,23,0.87,95,2014-01-01,IND,TOR
12945,45,@,L 82-94 ,240,32,81,0.395,30,69,0.435,2,12,0.167,16,23,0.696,82,35,84,0.417,33,69,0.478,2,15,0.133,22,28,0.786,94,2014-01-02,BOS,CHI
12946,46,@,L 82-89 ,240,29,79,0.367,19,57,0.333,10,22,0.455,14,20,0.7,82,31,71,0.437,23,47,0.489,8,24,0.333,19,22,0.864,89,2014-01-04,CLE,BRK
12947,47,@,L 82-99 ,240,31,68,0.456,28,59,0.475,3,9,0.333,17,26,0.654,82,39,83,0.47,32,61,0.525,7,22,0.318,14,19,0.737,99,2014-01-04,NOP,IND
12948,48,@,W 82-78 ,240,28,77,0.364,20,53,0.377,8,24,0.333,18,22,0.818,82,27,79,0.342,21,59,0.356,6,20,0.3,18,20,0.9,78,2014-01-05,IND,CLE
12949,49,@,W 82-77 ,240,33,82,0.402,28,62,0.452,5,20,0.25,11,18,0.611,82,31,82,0.378,25,62,0.403,6,20,0.3,9,12,0.75,77,2014-01-15,MEM,MIL
12950,50,@,L 82-110 ,240,33,88,0.375,27,67,0.403,6,21,0.286,10,17,0.588,82,43,76,0.566,32,58,0.552,11,18,0.611,13,21,0.619,110,2014-01-19,MIL,SAS
12951,51,@,L 82-108 ,240,31,83,0.373,27,60,0.45,4,23,0.174,16,22,0.727,82,45,74,0.608,39,59,0.661,6,15,0.4,12,18,0.667,108,2014-02-27,NYK,MIA
12952,52,@,L 82-92 ,240,33,90,0.367,30,73,0.411,3,17,0.176,13,15,0.867,82,34,73,0.466,25,53,0.472,9,20,0.45,15,15,1.0,92,2014-02-28,CHA,SAS
12953,53,Home,W 82-71 ,240,33,75,0.44,28,62,0.452,5,13,0.385,11,17,0.647,82,27,74,0.365,21,59,0.356,6,15,0.4,11,14,0.786,71,2014-03-22,MEM,IND
12954,54,@,L 82-101 ,240,31,85,0.365,22,64,0.344,9,21,0.429,11,14,0.786,82,37,75,0.493,29,50,0.58,8,25,0.32,19,25,0.76,101,2014-11-04,CLE,POR
12955,55,Home,L 82-105 ,240,29,68,0.426,20,40,0.5,9,28,0.321,15,19,0.789,82,42,88,0.477,33,64,0.516,9,24,0.375,12,14,0.857,105,2014-11-07,UTA,DAL
12956,56,@,L 82-124 ,240,27,74,0.365,21,54,0.389,6,20,0.3,22,32,0.688,82,45,86,0.523,30,61,0.492,15,25,0.6,19,24,0.792,124,2014-11-21,MIL,TOR
12957,57,@,L 82-97 ,240,31,70,0.443,28,54,0.519,3,16,0.188,17,28,0.607,82,40,83,0.482,28,57,0.491,12,26,0.462,5,10,0.5,97,2014-11-26,UTA,OKC
12958,58,@,L 82-88 ,240,36,91,0.396,31,73,0.425,5,18,0.278,5,8,0.625,82,33,83,0.398,29,62,0.468,4,21,0.19,18,23,0.783,88,2014-12-04,IND,POR
12959,59,@,L 82-102 ,240,30,82,0.366,23,60,0.383,7,22,0.318,15,21,0.714,82,38,85,0.447,30,62,0.484,8,23,0.348,18,27,0.667,102,2014-12-10,MIA,DEN
12960,60,@,L 82-90 ,240,31,80,0.388,21,45,0.467,10,35,0.286,10,12,0.833,82,32,81,0.395,31,69,0.449,1,12,0.083,25,33,0.758,90,2014-12-10,POR,MIN
12961,61,@,L 82-95 ,240,36,74,0.486,32,59,0.542,4,15,0.267,6,8,0.75,82,37,83,0.446,26,53,0.491,11,30,0.367,10,15,0.667,95,2014-12-15,ORL,TOR
12962,62,@,L 82-110 ,240,31,82,0.378,29,64,0.453,2,18,0.111,18,24,0.75,82,43,80,0.538,35,61,0.574,8,19,0.421,16,24,0.667,110,2014-12-22,DEN,CHO
12963,63,Home,L 82-96 ,240,33,86,0.384,25,61,0.41,8,25,0.32,8,15,0.533,82,36,83,0.434,30,69,0.435,6,14,0.429,18,21,0.857,96,2014-12-30,CHI,BRK
12964,64,Home,L 82-95 ,240,31,76,0.408,22,51,0.431,9,25,0.36,11,14,0.786,82,35,77,0.455,31,61,0.508,4,16,0.25,21,27,0.778,95,2015-01-04,NYK,MIL
12965,65,@,L 82-97 ,240,29,70,0.414,24,53,0.453,5,17,0.294,19,21,0.905,82,33,77,0.429,20,43,0.465,13,34,0.382,18,21,0.857,97,2015-01-10,UTA,HOU
12966,66,Home,L 82-110 ,240,33,85,0.388,25,56,0.446,8,29,0.276,8,9,0.889,82,39,78,0.5,32,62,0.516,7,16,0.438,25,33,0.758,110,2015-01-10,NYK,CHO
12967,67,@,L 82-93 ,240,29,82,0.354,20,47,0.426,9,35,0.257,15,26,0.577,82,37,84,0.44,28,54,0.519,9,30,0.3,10,14,0.714,93,2015-01-19,DET,ATL
12968,68,@,L 82-103 ,240,34,81,0.42,29,65,0.446,5,16,0.313,9,13,0.692,82,42,79,0.532,36,61,0.59,6,18,0.333,13,18,0.722,103,2015-01-29,NYK,IND
12969,69,@,W 82-75 ,240,33,80,0.413,26,64,0.406,7,16,0.438,9,17,0.529,82,25,78,0.321,18,51,0.353,7,27,0.259,18,22,0.818,75,2015-02-02,MIL,TOR
12970,70,@,L 82-87 ,240,31,93,0.333,24,65,0.369,7,28,0.25,13,16,0.813,82,32,74,0.432,28,61,0.459,4,13,0.308,19,24,0.792,87,2015-02-08,SAS,TOR
12971,71,@,L 82-87 ,240,30,80,0.375,19,51,0.373,11,29,0.379,11,21,0.524,82,28,75,0.373,18,47,0.383,10,28,0.357,21,26,0.808,87,2015-02-11,UTA,DAL
12972,72,Home,L 82-110 ,240,31,94,0.33,24,67,0.358,7,27,0.259,13,22,0.591,82,43,92,0.467,39,71,0.549,4,21,0.19,20,23,0.87,110,2015-02-23,DEN,BRK
12973,73,Home,L 82-104 ,240,28,84,0.333,20,52,0.385,8,32,0.25,18,29,0.621,82,39,68,0.574,30,47,0.638,9,21,0.429,17,21,0.81,104,2015-02-27,DEN,UTA
12974,74,Home,W 82-75 ,240,29,76,0.382,23,54,0.426,6,22,0.273,18,23,0.783,82,29,74,0.392,24,59,0.407,5,15,0.333,12,14,0.857,75,2015-02-28,UTA,MIL
12975,75,Home,L 82-93 ,240,33,82,0.402,30,71,0.423,3,11,0.273,13,19,0.684,82,36,80,0.45,31,55,0.564,5,25,0.2,16,19,0.842,93,2015-03-03,MEM,UTA
12976,76,@,L 82-105 ,240,30,76,0.395,24,60,0.4,6,16,0.375,16,23,0.696,82,38,80,0.475,28,58,0.483,10,22,0.455,19,24,0.792,105,2015-03-04,NYK,IND
12977,77,@,L 82-87 ,240,31,79,0.392,26,66,0.394,5,13,0.385,15,17,0.882,82,30,70,0.429,24,52,0.462,6,18,0.333,21,29,0.724,87,2015-03-10,NYK,UTA
12978,78,Home,L 82-103 ,240,32,76,0.421,28,58,0.483,4,18,0.222,14,17,0.824,82,41,79,0.519,34,67,0.507,7,12,0.583,14,19,0.737,103,2015-03-23,NYK,MEM
12979,79,@,L 82-88 ,240,32,74,0.432,26,55,0.473,6,19,0.316,12,15,0.8,82,33,85,0.388,29,68,0.426,4,17,0.235,18,21,0.857,88,2015-04-03,DET,CHI
12980,80,Home,L 82-94 ,240,33,86,0.384,28,64,0.438,5,22,0.227,11,17,0.647,82,38,88,0.432,31,65,0.477,7,23,0.304,11,12,0.917,94,2015-11-03,DET,IND
12981,81,@,L 82-90 ,240,29,88,0.33,20,61,0.328,9,27,0.333,15,18,0.833,82,30,82,0.366,23,55,0.418,7,27,0.259,23,29,0.793,90,2015-11-13,LAL,DAL
12982,82,@,L 82-92 ,240,32,74,0.432,31,65,0.477,1,9,0.111,17,17,1.0,82,34,72,0.472,27,51,0.529,7,21,0.333,17,22,0.773,92,2015-11-21,MEM,SAS
12983,83,Home,L 82-84 ,240,27,82,0.329,20,59,0.339,7,23,0.304,21,27,0.778,82,31,72,0.431,20,48,0.417,11,24,0.458,11,14,0.786,84,2015-11-28,WAS,TOR
12984,84,@,L 82-87 ,240,33,82,0.402,25,54,0.463,8,28,0.286,8,14,0.571,82,27,70,0.386,12,39,0.308,15,31,0.484,18,22,0.818,87,2015-11-29,MIL,CHO
12985,85,Home,L 82-105 ,240,31,80,0.388,24,61,0.393,7,19,0.368,13,16,0.813,82,41,76,0.539,32,55,0.582,9,21,0.429,14,20,0.7,105,2015-12-14,BRK,ORL
12986,86,@,L 82-106 ,240,32,88,0.364,25,57,0.439,7,31,0.226,11,14,0.786,82,46,82,0.561,38,64,0.594,8,18,0.444,6,9,0.667,106,2016-01-01,DAL,MIA
12987,87,@,L 82-94 ,240,33,93,0.355,30,73,0.411,3,20,0.15,13,23,0.565,82,33,73,0.452,26,55,0.473,7,18,0.389,21,29,0.724,94,2016-01-02,DET,IND
12988,88,@,L 82-109 ,240,31,90,0.344,22,67,0.328,9,23,0.391,11,18,0.611,82,41,83,0.494,29,59,0.492,12,24,0.5,15,18,0.833,109,2016-01-16,LAL,UTA
12989,89,Home,L 82-101 ,240,27,80,0.338,19,51,0.373,8,29,0.276,20,23,0.87,82,36,96,0.375,23,60,0.383,13,36,0.361,16,26,0.615,101,2016-01-31,LAL,CHO
12990,90,@,L 82-88 ,240,31,82,0.378,25,61,0.41,6,21,0.286,14,22,0.636,82,33,87,0.379,29,68,0.426,4,19,0.211,18,20,0.9,88,2016-03-29,OKC,DET
12991,91,@,L 82-108 ,240,33,95,0.347,25,69,0.362,8,26,0.308,8,12,0.667,82,48,95,0.505,41,76,0.539,7,19,0.368,5,6,0.833,108,2016-10-28,ORL,DET
12992,92,@,L 82-114 ,240,30,82,0.366,26,70,0.371,4,12,0.333,18,26,0.692,82,41,76,0.539,28,51,0.549,13,25,0.52,19,22,0.864,114,2016-11-07,DET,LAC
12993,93,@,L 82-89 ,240,30,82,0.366,23,61,0.377,7,21,0.333,15,19,0.789,82,34,88,0.386,24,61,0.393,10,27,0.37,11,19,0.579,89,2016-11-16,NOP,ORL
12994,94,@,L 82-107 ,240,32,71,0.451,29,58,0.5,3,13,0.231,15,21,0.714,82,40,87,0.46,27,56,0.482,13,31,0.419,14,18,0.778,107,2016-12-03,CHI,DAL
12995,95,@,W 82-73 ,240,30,66,0.455,22,39,0.564,8,27,0.296,14,25,0.56,82,28,93,0.301,26,70,0.371,2,23,0.087,15,18,0.833,73,2016-12-18,UTA,MEM
12996,96,@,L 82-113 ,240,34,83,0.41,31,60,0.517,3,23,0.13,11,13,0.846,82,49,82,0.598,41,66,0.621,8,16,0.5,7,7,1.0,113,2016-12-19,DET,CHI
12997,97,@,L 82-91 ,240,33,82,0.402,23,54,0.426,10,28,0.357,6,13,0.462,82,36,93,0.387,31,67,0.463,5,26,0.192,14,18,0.778,91,2016-12-29,MIA,CHO
12998,98,@,L 82-90 ,240,32,88,0.364,21,62,0.339,11,26,0.423,7,10,0.7,82,34,90,0.378,28,59,0.475,6,31,0.194,16,22,0.727,90,2017-01-02,NOP,CLE
12999,99,@,L 82-110 ,240,31,83,0.373,27,65,0.415,4,18,0.222,16,22,0.727,82,43,78,0.551,30,54,0.556,13,24,0.542,11,15,0.733,110,2017-01-03,TOR,SAS
13000,0,Home,L 82-97 ,240,32,82,0.39,23,46,0.5,9,36,0.25,9,10,0.9,82,30,74,0.405,19,52,0.365,11,22,0.5,26,32,0.813,97,2017-01-07,DAL,ATL
13001,1,@,L 81-102 ,240,30,85,0.353,23,67,0.343,7,18,0.389,14,19,0.737,81,39,73,0.534,31,53,0.585,8,20,0.4,16,25,0.64,102,2011-12-30,WAS,MIL
13002,2,@,L 81-96 ,240,26,64,0.406,20,53,0.377,6,11,0.545,23,28,0.821,81,32,74,0.432,24,55,0.436,8,19,0.421,24,29,0.828,96,2012-01-07,NOP,DAL
13003,3,Home,L 81-94 ,240,29,71,0.408,21,48,0.438,8,23,0.348,15,21,0.714,81,39,75,0.52,33,65,0.508,6,10,0.6,10,14,0.714,94,2012-01-09,DEN,NOH
13004,4,@,L 81-111 ,240,33,78,0.423,32,70,0.457,1,8,0.125,14,16,0.875,81,42,90,0.467,36,71,0.507,6,19,0.316,21,28,0.75,111,2012-01-12,CHA,ATL
13005,5,Home,L 81-98 ,240,33,74,0.446,32,66,0.485,1,8,0.125,14,16,0.875,81,40,82,0.488,33,68,0.485,7,14,0.5,11,16,0.688,98,2012-01-13,CHA,DET
13006,6,Home,L 81-98 ,240,29,66,0.439,25,56,0.446,4,10,0.4,19,26,0.731,81,39,68,0.574,34,59,0.576,5,9,0.556,15,20,0.75,98,2012-01-20,DET,MEM
13007,7,Home,L 81-83 ,240,29,79,0.367,27,60,0.45,2,19,0.105,21,32,0.656,81,32,79,0.405,28,53,0.528,4,26,0.154,15,20,0.75,83,2012-01-21,NOP,DAL
13008,8,@,L 81-91 ,240,32,76,0.421,29,56,0.518,3,20,0.15,14,20,0.7,81,34,78,0.436,25,58,0.431,9,20,0.45,14,26,0.538,91,2012-01-25,NYK,CLE
13009,9,@,L 81-96 ,240,32,82,0.39,25,63,0.397,7,19,0.368,10,14,0.714,81,32,70,0.457,24,43,0.558,8,27,0.296,24,32,0.75,96,2012-01-27,TOR,DEN
13010,10,@,L 81-93 ,240,33,74,0.446,30,66,0.455,3,8,0.375,12,16,0.75,81,34,74,0.459,30,55,0.545,4,19,0.211,21,27,0.778,93,2012-02-02,NOP,SAS
13011,11,@,L 81-99 ,240,34,83,0.41,30,64,0.469,4,19,0.211,9,14,0.643,81,39,89,0.438,35,74,0.473,4,15,0.267,17,17,1.0,99,2012-02-03,PHO,HOU
13012,12,Home,L 81-85 ,240,29,85,0.341,25,63,0.397,4,22,0.182,19,21,0.905,81,29,72,0.403,20,47,0.426,9,25,0.36,18,23,0.783,85,2012-02-04,IND,ORL
13013,13,Home,L 81-107 ,240,30,80,0.375,23,62,0.371,7,18,0.389,14,23,0.609,81,45,83,0.542,34,60,0.567,11,23,0.478,6,17,0.353,107,2012-02-04,WAS,LAC
13014,14,@,L 81-96 ,240,32,72,0.444,26,56,0.464,6,16,0.375,11,15,0.733,81,31,82,0.378,26,73,0.356,5,9,0.556,29,46,0.63,96,2012-02-19,BOS,DET
13015,15,Home,W 81-78 ,240,28,80,0.35,21,59,0.356,7,21,0.333,18,29,0.621,81,32,87,0.368,26,71,0.366,6,16,0.375,8,9,0.889,78,2012-03-02,PHO,LAC
13016,16,@,L 81-91 ,240,30,76,0.395,21,51,0.412,9,25,0.36,12,21,0.571,81,34,74,0.459,32,66,0.485,2,8,0.25,21,27,0.778,91,2012-03-18,ORL,MIA
13017,17,@,L 81-90 ,240,33,79,0.418,27,58,0.466,6,21,0.286,9,12,0.75,81,34,73,0.466,28,54,0.519,6,19,0.316,16,20,0.8,90,2012-03-27,HOU,DAL
13018,18,Home,L 81-109 ,240,33,85,0.388,27,57,0.474,6,28,0.214,9,14,0.643,81,40,79,0.506,26,44,0.591,14,35,0.4,15,16,0.938,109,2012-04-13,ORL,ATL
13019,19,Home,L 81-83 ,240,33,79,0.418,27,65,0.415,6,14,0.429,9,13,0.692,81,31,71,0.437,29,66,0.439,2,5,0.4,19,31,0.613,83,2012-04-24,GSW,NOH
13020,20,@,L 81-94 ,240,32,87,0.368,28,71,0.394,4,16,0.25,13,17,0.765,81,38,78,0.487,36,64,0.563,2,14,0.143,16,24,0.667,94,2012-11-10,PHO,UTA
13021,21,Home,W 81-72 ,240,34,89,0.382,29,64,0.453,5,25,0.2,8,13,0.615,81,31,82,0.378,29,72,0.403,2,10,0.2,8,14,0.571,72,2012-11-19,ATL,ORL
13022,22,@,L 81-116 ,240,29,76,0.382,20,53,0.377,9,23,0.391,14,18,0.778,81,47,86,0.547,35,62,0.565,12,24,0.5,10,16,0.625,116,2012-12-01,SAC,LAC
13023,23,@,L 81-102 ,240,29,76,0.382,21,57,0.368,8,19,0.421,15,23,0.652,81,43,82,0.524,38,70,0.543,5,12,0.417,11,11,1.0,102,2012-12-03,MIL,NOH
13024,24,@,L 81-87 ,240,34,77,0.442,33,62,0.532,1,15,0.067,12,17,0.706,81,32,77,0.416,31,67,0.463,1,10,0.1,22,27,0.815,87,2012-12-05,ORL,UTA
13025,25,@,L 81-96 ,240,27,81,0.333,18,59,0.305,9,22,0.409,18,25,0.72,81,34,83,0.41,29,65,0.446,5,18,0.278,23,28,0.821,96,2012-12-12,CLE,IND
13026,26,@,W 81-75 ,240,33,77,0.429,29,60,0.483,4,17,0.235,11,18,0.611,81,33,82,0.402,29,71,0.408,4,11,0.364,5,7,0.714,75,2012-12-22,IND,NOH
13027,27,@,L 81-97 ,240,28,73,0.384,25,63,0.397,3,10,0.3,22,32,0.688,81,34,76,0.447,25,49,0.51,9,27,0.333,20,26,0.769,97,2012-12-28,CHA,BRK
13028,28,Home,W 81-72 ,240,36,89,0.404,31,70,0.443,5,19,0.263,4,7,0.571,81,29,68,0.426,26,52,0.5,3,16,0.188,11,18,0.611,72,2012-12-29,MEM,DEN
13029,29,Home,L 81-91 ,240,33,94,0.351,29,78,0.372,4,16,0.25,11,18,0.611,81,33,70,0.471,29,60,0.483,4,10,0.4,21,38,0.553,91,2012-12-31,CHI,CHA
13030,30,@,L 81-89 ,240,35,83,0.422,32,70,0.457,3,13,0.231,8,10,0.8,81,29,77,0.377,24,61,0.393,5,16,0.313,26,31,0.839,89,2013-01-02,WAS,IND
13031,31,Home,L 81-89 ,240,28,68,0.412,18,39,0.462,10,29,0.345,15,19,0.789,81,39,85,0.459,36,69,0.522,3,16,0.188,8,12,0.667,89,2013-01-05,ATL,BOS
13032,32,Home,L 81-92 ,240,31,79,0.392,26,65,0.4,5,14,0.357,14,18,0.778,81,37,69,0.536,35,61,0.574,2,8,0.25,16,20,0.8,92,2013-01-06,PHO,MEM
13033,33,Home,L 81-113 ,240,28,76,0.368,23,55,0.418,5,21,0.238,20,23,0.87,81,39,80,0.488,28,60,0.467,11,20,0.55,24,27,0.889,113,2013-01-07,SAC,MEM
13034,34,Home,W 81-76 ,240,31,79,0.392,26,58,0.448,5,21,0.238,14,16,0.875,81,31,89,0.348,27,69,0.391,4,20,0.2,10,13,0.769,76,2013-01-10,IND,NYK
13035,35,Home,L 81-97 ,240,32,88,0.364,30,77,0.39,2,11,0.182,15,21,0.714,81,36,73,0.493,30,59,0.508,6,14,0.429,19,25,0.76,97,2013-01-12,CHI,PHO
13036,36,Home,L 81-82 ,240,35,83,0.422,31,73,0.425,4,10,0.4,7,7,1.0,81,34,69,0.493,26,52,0.5,8,17,0.471,6,11,0.545,82,2013-01-21,MEM,IND
13037,37,@,L 81-99 ,240,29,73,0.397,23,56,0.411,6,17,0.353,17,26,0.654,81,39,73,0.534,34,57,0.596,5,16,0.313,16,20,0.8,99,2013-01-30,SAC,BOS
13038,38,@,L 81-120 ,240,32,76,0.421,26,55,0.473,6,21,0.286,11,15,0.733,81,47,86,0.547,28,43,0.651,19,43,0.442,7,13,0.538,120,2013-02-02,SAC,NYK
13039,39,Home,L 81-93 ,240,29,72,0.403,26,61,0.426,3,11,0.273,20,25,0.8,81,34,70,0.486,27,50,0.54,7,20,0.35,18,22,0.818,93,2013-03-01,TOR,IND
13040,40,Home,L 81-97 ,240,33,88,0.375,28,68,0.412,5,20,0.25,10,15,0.667,81,38,74,0.514,33,53,0.623,5,21,0.238,16,19,0.842,97,2013-03-04,MIN,MIA
13041,41,Home,L 81-83 ,240,32,88,0.364,26,61,0.426,6,27,0.222,11,14,0.786,81,34,83,0.41,27,66,0.409,7,17,0.412,8,9,0.889,83,2013-03-06,IND,BOS
13042,42,@,L 81-90 ,240,33,89,0.371,29,73,0.397,4,16,0.25,11,12,0.917,81,39,86,0.453,34,60,0.567,5,26,0.192,7,14,0.5,90,2013-03-10,CHI,LAL
13043,43,@,L 81-98 ,240,33,78,0.423,28,56,0.5,5,22,0.227,10,14,0.714,81,35,82,0.427,29,62,0.468,6,20,0.3,22,30,0.733,98,2013-03-12,ATL,MIA
13044,44,@,L 81-111 ,240,34,81,0.42,28,60,0.467,6,21,0.286,7,10,0.7,81,39,76,0.513,29,55,0.527,10,21,0.476,23,30,0.767,111,2013-03-13,PHO,HOU
13045,45,@,L 81-98 ,240,31,78,0.397,24,56,0.429,7,22,0.318,12,14,0.857,81,35,80,0.438,26,56,0.464,9,24,0.375,19,27,0.704,98,2013-03-30,LAC,HOU
13046,46,@,L 81-101 ,240,34,81,0.42,27,62,0.435,7,19,0.368,6,12,0.5,81,36,81,0.444,28,57,0.491,8,24,0.333,21,33,0.636,101,2013-04-02,DAL,LAL
13047,47,@,L 81-82 ,240,31,86,0.36,22,62,0.355,9,24,0.375,10,14,0.714,81,31,76,0.408,28,60,0.467,3,16,0.188,17,19,0.895,82,2013-10-31,NYK,CHI
13048,48,@,L 81-100 ,240,29,83,0.349,22,52,0.423,7,31,0.226,16,19,0.842,81,33,77,0.429,25,57,0.439,8,20,0.4,26,33,0.788,100,2013-11-01,OKC,MIN
13049,49,@,L 81-96 ,240,31,75,0.413,26,61,0.426,5,14,0.357,14,20,0.7,81,34,83,0.41,30,67,0.448,4,16,0.25,24,26,0.923,96,2013-11-11,CLE,CHI
13050,50,Home,L 81-100 ,240,31,77,0.403,28,60,0.467,3,17,0.176,16,23,0.696,81,36,80,0.45,31,63,0.492,5,17,0.294,23,27,0.852,100,2013-11-11,UTA,DEN
13051,51,Home,L 81-97 ,240,29,83,0.349,21,56,0.375,8,27,0.296,15,20,0.75,81,35,69,0.507,29,54,0.537,6,15,0.4,21,23,0.913,97,2013-11-16,CHA,MIA
13052,52,@,L 81-86 ,240,33,91,0.363,26,75,0.347,7,16,0.438,8,16,0.5,81,27,75,0.36,21,63,0.333,6,12,0.5,26,31,0.839,86,2013-11-18,CHA,CHI
13053,53,Home,L 81-88 (OT),265,36,82,0.439,31,64,0.484,5,18,0.278,4,8,0.5,81,34,88,0.386,31,76,0.408,3,12,0.25,17,19,0.895,88,2013-11-20,GSW,MEM
13054,54,@,L 81-111 ,240,31,78,0.397,26,62,0.419,5,16,0.313,14,20,0.7,81,40,97,0.412,29,61,0.475,11,36,0.306,20,23,0.87,111,2013-11-22,BRK,MIN
13055,55,Home,L 81-101 ,240,29,77,0.377,26,64,0.406,3,13,0.231,20,26,0.769,81,38,80,0.475,27,60,0.45,11,20,0.55,14,18,0.778,101,2013-12-05,MEM,LAC
13056,56,@,L 81-114 ,240,32,84,0.381,28,62,0.452,4,22,0.182,13,24,0.542,81,43,81,0.531,31,55,0.564,12,26,0.462,16,22,0.727,114,2013-12-20,HOU,IND
13057,57,Home,L 81-89 ,240,31,81,0.383,28,68,0.412,3,13,0.231,16,21,0.762,81,36,84,0.429,29,68,0.426,7,16,0.438,10,18,0.556,89,2013-12-23,DEN,GSW
13058,58,Home,L 81-94 ,240,34,89,0.382,29,70,0.414,5,19,0.263,8,13,0.615,81,41,85,0.482,35,58,0.603,6,27,0.222,6,10,0.6,94,2013-12-31,ORL,GSW
13059,59,@,L 81-87 (OT),265,32,84,0.381,25,59,0.424,7,25,0.28,10,18,0.556,81,33,96,0.344,29,77,0.377,4,19,0.211,17,24,0.708,87,2014-01-02,ORL,CLE
13060,60,@,L 81-101 ,240,30,84,0.357,23,65,0.354,7,19,0.368,14,21,0.667,81,35,83,0.422,24,52,0.462,11,31,0.355,20,24,0.833,101,2014-01-06,ORL,LAC
13061,61,@,W 81-72 ,240,24,62,0.387,18,46,0.391,6,16,0.375,27,39,0.692,81,28,88,0.318,21,67,0.313,7,21,0.333,9,12,0.75,72,2014-01-10,CHI,MIL
13062,62,@,L 81-99 ,240,30,81,0.37,21,49,0.429,9,32,0.281,12,17,0.706,81,41,88,0.466,34,69,0.493,7,19,0.368,10,14,0.714,99,2014-01-25,HOU,MEM
13063,63,Home,L 81-98 ,240,30,87,0.345,26,63,0.413,4,24,0.167,17,22,0.773,81,43,83,0.518,37,70,0.529,6,13,0.462,6,10,0.6,98,2014-01-28,POR,MEM
13064,64,@,L 81-96 ,240,31,78,0.397,27,54,0.5,4,24,0.167,15,17,0.882,81,41,89,0.461,33,65,0.508,8,24,0.333,6,9,0.667,96,2014-02-01,OKC,WAS
13065,65,@,L 81-103 ,240,31,76,0.408,19,41,0.463,12,35,0.343,7,14,0.5,81,38,81,0.469,28,63,0.444,10,18,0.556,17,22,0.773,103,2014-02-07,UTA,DAL
13066,66,@,L 81-93 ,240,30,83,0.361,24,65,0.369,6,18,0.333,15,27,0.556,81,35,66,0.53,29,38,0.763,6,28,0.214,17,29,0.586,93,2014-02-09,NOP,BRK
13067,67,@,W 81-73 ,240,30,84,0.357,25,65,0.385,5,19,0.263,16,21,0.762,81,27,84,0.321,20,60,0.333,7,24,0.292,12,14,0.857,73,2014-02-12,DAL,IND
13068,68,Home,L 81-86 ,240,34,83,0.41,30,70,0.429,4,13,0.308,9,10,0.9,81,36,77,0.468,34,65,0.523,2,12,0.167,12,18,0.667,86,2014-02-12,ORL,MEM
13069,69,Home,L 81-103 ,240,28,74,0.378,26,54,0.481,2,20,0.1,23,30,0.767,81,41,75,0.547,36,54,0.667,5,21,0.238,16,21,0.762,103,2014-02-20,OKC,MIA
13070,70,@,L 81-92 ,240,32,86,0.372,27,62,0.435,5,24,0.208,12,18,0.667,81,35,83,0.422,34,70,0.486,1,13,0.077,21,27,0.778,92,2014-03-02,PHI,ORL
13071,71,@,L 81-108 ,240,30,73,0.411,24,46,0.522,6,27,0.222,15,20,0.75,81,42,85,0.494,30,54,0.556,12,31,0.387,12,18,0.667,108,2014-03-07,UTA,NYK
13072,72,@,L 81-91 ,240,30,87,0.345,29,67,0.433,1,20,0.05,20,22,0.909,81,31,70,0.443,26,56,0.464,5,14,0.357,24,31,0.774,91,2014-03-22,PHI,CHI
13073,73,@,L 81-94 ,240,31,85,0.365,22,67,0.328,9,18,0.5,10,16,0.625,81,33,69,0.478,24,46,0.522,9,23,0.391,19,25,0.76,94,2014-03-28,SAC,OKC
13074,74,@,L 81-110 ,240,26,65,0.4,18,39,0.462,8,26,0.308,21,28,0.75,81,42,70,0.6,31,45,0.689,11,25,0.44,15,20,0.75,110,2014-04-02,BRK,NYK
13075,75,@,L 81-93 ,240,32,86,0.372,27,63,0.429,5,23,0.217,12,22,0.545,81,36,88,0.409,27,64,0.422,9,24,0.375,12,21,0.571,93,2014-10-31,PHI,MIL
13076,76,@,L 81-93 ,240,29,86,0.337,25,62,0.403,4,24,0.167,19,29,0.655,81,31,76,0.408,27,62,0.435,4,14,0.286,27,37,0.73,93,2014-11-03,NOP,MEM
13077,77,Home,L 81-87 ,240,31,78,0.397,25,54,0.463,6,24,0.25,13,22,0.591,81,37,83,0.446,30,62,0.484,7,21,0.333,6,7,0.857,87,2014-11-04,IND,MIL
13078,78,@,L 81-98 ,240,31,90,0.344,29,70,0.414,2,20,0.1,17,19,0.895,81,34,72,0.472,24,45,0.533,10,27,0.37,20,33,0.606,98,2014-11-06,SAS,HOU
13079,79,@,W 81-75 ,240,30,80,0.375,22,54,0.407,8,26,0.308,13,15,0.867,81,29,68,0.426,20,48,0.417,9,20,0.45,8,18,0.444,75,2014-11-12,IND,MIA
13080,80,@,L 81-98 ,240,30,84,0.357,22,61,0.361,8,23,0.348,13,19,0.684,81,35,81,0.432,25,57,0.439,10,24,0.417,18,26,0.692,98,2014-11-18,OKC,UTA
13081,81,@,L 81-87 ,240,30,77,0.39,21,51,0.412,9,26,0.346,12,16,0.75,81,29,78,0.372,20,49,0.408,9,29,0.31,20,27,0.741,87,2014-12-12,ORL,ATL
13082,82,Home,L 81-97 ,240,32,91,0.352,22,67,0.328,10,24,0.417,7,14,0.5,81,38,76,0.5,25,43,0.581,13,33,0.394,8,14,0.571,97,2015-01-02,NYK,DET
13083,83,Home,L 81-89 ,240,30,74,0.405,27,60,0.45,3,14,0.214,18,26,0.692,81,35,88,0.398,30,70,0.429,5,18,0.278,14,17,0.824,89,2015-01-07,BRK,BOS
13084,84,@,L 81-96 ,240,29,75,0.387,25,58,0.431,4,17,0.235,19,29,0.655,81,36,80,0.45,29,58,0.5,7,22,0.318,17,27,0.63,96,2015-01-16,NOP,PHI
13085,85,@,L 81-104 ,240,30,81,0.37,24,60,0.4,6,21,0.286,15,18,0.833,81,36,76,0.474,30,57,0.526,6,19,0.316,26,32,0.813,104,2015-01-22,SAS,CHI
13086,86,@,L 81-89 ,240,29,84,0.345,23,61,0.377,6,23,0.261,17,20,0.85,81,29,74,0.392,20,51,0.392,9,23,0.391,22,30,0.733,89,2015-02-07,CHA,PHI
13087,87,@,L 81-89 ,240,30,84,0.357,23,58,0.397,7,26,0.269,14,21,0.667,81,33,78,0.423,28,63,0.444,5,15,0.333,18,22,0.818,89,2015-02-20,DEN,MIL
13088,88,@,L 81-92 ,240,33,90,0.367,27,71,0.38,6,19,0.316,9,13,0.692,81,36,78,0.462,31,60,0.517,5,18,0.278,15,19,0.789,92,2015-02-22,CHA,DAL
13089,89,@,L 81-90 ,240,32,79,0.405,27,60,0.45,5,19,0.263,12,21,0.571,81,34,83,0.41,30,68,0.441,4,15,0.267,18,23,0.783,90,2015-02-23,SAS,UTA
13090,90,@,L 81-89 ,240,30,93,0.323,26,76,0.342,4,17,0.235,17,22,0.773,81,28,80,0.35,16,47,0.34,12,33,0.364,21,34,0.618,89,2015-02-27,WAS,PHI
13091,91,@,L 81-92 ,240,30,81,0.37,22,63,0.349,8,18,0.444,13,21,0.619,81,33,80,0.413,31,71,0.437,2,9,0.222,24,28,0.857,92,2015-03-16,DEN,MEM
13092,92,@,L 81-97 ,240,25,69,0.362,17,53,0.321,8,16,0.5,23,26,0.885,81,37,88,0.42,26,58,0.448,11,30,0.367,12,15,0.8,97,2015-03-20,NYK,PHI
13093,93,Home,L 81-87 ,240,32,87,0.368,26,67,0.388,6,20,0.3,11,12,0.917,81,36,89,0.404,29,63,0.46,7,26,0.269,8,18,0.444,87,2015-03-27,PHO,POR
13094,94,Home,L 81-95 ,240,32,79,0.405,27,64,0.422,5,15,0.333,12,12,1.0,81,37,74,0.5,29,56,0.518,8,18,0.444,13,17,0.765,95,2015-03-31,MIA,SAS
13095,95,@,L 81-100 ,240,30,82,0.366,23,59,0.39,7,23,0.304,14,20,0.7,81,34,77,0.442,25,56,0.446,9,21,0.429,23,27,0.852,100,2015-11-13,NOP,TOR
13096,96,@,L 81-105 ,240,34,98,0.347,28,63,0.444,6,35,0.171,7,8,0.875,81,37,84,0.44,26,60,0.433,11,24,0.458,20,26,0.769,105,2015-11-14,DEN,PHO
13097,97,@,L 81-104 ,240,32,79,0.405,26,59,0.441,6,20,0.3,11,16,0.688,81,41,98,0.418,25,67,0.373,16,31,0.516,6,7,0.857,104,2015-11-25,MIA,DET
13098,98,@,L 81-92 ,240,30,75,0.4,22,50,0.44,8,25,0.32,13,17,0.765,81,33,77,0.429,26,51,0.51,7,26,0.269,19,27,0.704,92,2015-11-28,DEN,DAL
13099,99,@,L 81-99 ,240,29,75,0.387,23,54,0.426,6,21,0.286,17,24,0.708,81,40,81,0.494,29,54,0.537,11,27,0.407,8,17,0.471,99,2015-12-09,MIA,CHO
13100,0,@,L 81-118 ,240,32,79,0.405,29,68,0.426,3,11,0.273,14,17,0.824,81,42,75,0.56,33,54,0.611,9,21,0.429,25,27,0.926,118,2015-12-14,UTA,SAS
13101,1,@,L 81-107 ,240,33,90,0.367,25,57,0.439,8,33,0.242,7,10,0.7,81,43,89,0.483,32,60,0.533,11,29,0.379,10,17,0.588,107,2015-12-16,DAL,IND
13102,2,@,L 81-108 ,240,31,84,0.369,25,65,0.385,6,19,0.316,13,17,0.765,81,39,85,0.459,29,69,0.42,10,16,0.625,20,25,0.8,108,2016-01-01,NYK,CHI
13103,3,@,L 81-98 ,240,30,87,0.345,24,65,0.369,6,22,0.273,15,20,0.75,81,41,80,0.513,32,61,0.525,9,19,0.474,7,10,0.7,98,2016-01-18,ORL,ATL
13104,4,@,L 81-101 ,240,33,81,0.407,29,64,0.453,4,17,0.235,11,17,0.647,81,35,75,0.467,22,50,0.44,13,25,0.52,18,21,0.857,101,2016-01-22,MIA,TOR
13105,5,@,L 81-85 ,240,26,70,0.371,22,52,0.423,4,18,0.222,25,33,0.758,81,33,74,0.446,28,52,0.538,5,22,0.227,14,20,0.7,85,2016-02-03,DEN,UTA
13106,6,@,L 81-84 ,240,30,71,0.423,23,57,0.404,7,14,0.5,14,21,0.667,81,30,77,0.39,22,50,0.44,8,27,0.296,16,23,0.696,84,2016-02-05,MIL,UTA
13107,7,Home,L 81-87 ,240,30,85,0.353,17,39,0.436,13,46,0.283,8,14,0.571,81,34,90,0.378,28,66,0.424,6,24,0.25,13,17,0.765,87,2016-02-24,LAC,DEN
13108,8,Home,L 81-98 ,240,32,87,0.368,26,72,0.361,6,15,0.4,11,12,0.917,81,40,84,0.476,39,76,0.513,1,8,0.125,17,21,0.81,98,2016-02-28,NYK,MIA
13109,9,@,L 81-97 ,240,31,78,0.397,25,59,0.424,6,19,0.316,13,23,0.565,81,43,84,0.512,40,70,0.571,3,14,0.214,8,9,0.889,97,2016-03-02,DET,SAS
13110,10,@,L 81-130 ,240,30,101,0.297,26,84,0.31,4,17,0.235,17,28,0.607,81,46,85,0.541,30,52,0.577,16,33,0.485,22,34,0.647,130,2016-03-14,MEM,HOU
13111,11,@,L 81-124 ,240,32,79,0.405,29,56,0.518,3,23,0.13,14,22,0.636,81,51,90,0.567,43,72,0.597,8,18,0.444,14,18,0.778,124,2016-03-14,DET,WAS
13112,12,@,L 81-103 ,240,26,83,0.313,20,63,0.317,6,20,0.3,23,25,0.92,81,40,78,0.513,33,58,0.569,7,20,0.35,16,26,0.615,103,2016-04-05,LAL,LAC
13113,13,Home,L 81-91 ,240,32,90,0.356,28,71,0.394,4,19,0.211,13,17,0.765,81,37,83,0.446,30,58,0.517,7,25,0.28,10,14,0.714,91,2016-04-06,LAL,LAC
13114,14,@,L 81-116 ,240,32,96,0.333,21,59,0.356,11,37,0.297,6,13,0.462,81,47,97,0.485,37,62,0.597,10,35,0.286,12,19,0.632,116,2016-04-13,SAC,HOU
13115,15,@,L 81-97 ,240,33,77,0.429,26,51,0.51,7,26,0.269,8,10,0.8,81,35,77,0.455,23,52,0.442,12,25,0.48,15,26,0.577,97,2016-11-02,DAL,UTA
13116,16,@,L 81-104 ,240,29,93,0.312,23,74,0.311,6,19,0.316,17,20,0.85,81,40,83,0.482,29,58,0.5,11,25,0.44,13,14,0.929,104,2016-11-18,DET,CLE
13117,17,Home,L 81-90 ,240,29,82,0.354,25,63,0.397,4,19,0.211,19,23,0.826,81,33,85,0.388,21,54,0.389,12,31,0.387,12,18,0.667,90,2016-11-25,MEM,MIA
13118,18,@,L 81-91 ,240,30,77,0.39,25,57,0.439,5,20,0.25,16,18,0.889,81,32,77,0.416,22,50,0.44,10,27,0.37,17,20,0.85,91,2016-11-27,NOP,DAL
13119,19,@,L 80-96 ,240,36,89,0.404,36,74,0.486,0,15,0.0,8,16,0.5,80,35,85,0.412,27,62,0.435,8,23,0.348,18,21,0.857,96,2012-01-01,NOP,SAC
13120,20,Home,L 80-103 ,240,29,78,0.372,20,52,0.385,9,26,0.346,13,22,0.591,80,39,83,0.47,31,55,0.564,8,28,0.286,17,20,0.85,103,2012-01-07,DET,NYK
13121,21,Home,L 80-87 ,240,34,90,0.378,30,74,0.405,4,16,0.25,8,16,0.5,80,24,70,0.343,18,45,0.4,6,25,0.24,33,38,0.868,87,2012-01-13,NOP,MIN
13122,22,@,L 80-97 ,240,34,83,0.41,30,70,0.429,4,13,0.308,8,9,0.889,80,40,81,0.494,32,62,0.516,8,19,0.421,9,12,0.75,97,2012-01-17,DET,HOU
13123,23,@,L 80-92 ,240,29,76,0.382,23,56,0.411,6,20,0.3,16,22,0.727,80,32,77,0.416,20,50,0.4,12,27,0.444,16,26,0.615,92,2012-01-20,LAL,ORL
13124,24,@,L 80-88 ,240,26,74,0.351,23,57,0.404,3,17,0.176,25,33,0.758,80,34,81,0.42,30,67,0.448,4,14,0.286,16,19,0.842,88,2012-02-03,MIL,DET
13125,25,@,L 80-98 ,240,32,87,0.368,29,73,0.397,3,14,0.214,13,16,0.813,80,36,73,0.493,29,53,0.547,7,20,0.35,19,21,0.905,98,2012-02-05,MEM,BOS
13126,26,@,L 80-85 ,240,31,79,0.392,27,60,0.45,4,19,0.211,14,19,0.737,80,35,94,0.372,31,83,0.373,4,11,0.364,11,15,0.733,85,2012-02-08,MIN,MEM
13127,27,@,L 80-86 ,240,30,73,0.411,26,59,0.441,4,14,0.286,16,23,0.696,80,32,75,0.427,29,64,0.453,3,11,0.273,19,28,0.679,86,2012-02-13,UTA,NOH
13128,28,@,L 80-89 ,240,31,78,0.397,28,63,0.444,3,15,0.2,15,18,0.833,80,30,76,0.395,20,55,0.364,10,21,0.476,19,28,0.679,89,2012-02-16,BOS,CHI
13129,29,@,L 80-89 ,240,33,79,0.418,30,66,0.455,3,13,0.231,11,15,0.733,80,31,77,0.403,25,56,0.446,6,21,0.286,21,31,0.677,89,2012-03-17,PHI,CHI
13130,30,Home,L 80-105 ,240,29,75,0.387,27,67,0.403,2,8,0.25,20,28,0.714,80,46,86,0.535,41,75,0.547,5,11,0.455,8,9,0.889,105,2012-03-19,CHA,PHI
13131,31,@,L 80-93 ,240,31,82,0.378,27,64,0.422,4,18,0.222,14,21,0.667,80,37,79,0.468,25,44,0.568,12,35,0.343,7,12,0.583,93,2012-03-23,CLE,ORL
13132,32,@,L 80-89 ,240,31,85,0.365,25,61,0.41,6,24,0.25,12,18,0.667,80,26,74,0.351,19,43,0.442,7,31,0.226,30,35,0.857,89,2012-03-26,MIL,NYK
13133,33,Home,L 80-96 ,240,30,72,0.417,21,48,0.438,9,24,0.375,11,16,0.688,80,38,78,0.487,25,53,0.472,13,25,0.52,7,15,0.467,96,2012-04-05,ORL,NYK
13134,34,Home,L 80-84 ,240,31,73,0.425,28,58,0.483,3,15,0.2,15,24,0.625,80,25,73,0.342,20,56,0.357,5,17,0.294,29,40,0.725,84,2012-04-06,TOR,CLE
13135,35,Home,L 80-91 ,240,33,91,0.363,26,72,0.361,7,19,0.368,7,9,0.778,80,34,73,0.466,31,58,0.534,3,15,0.2,20,28,0.714,91,2012-04-19,DET,MIN
13136,36,Home,L 80-85 ,240,32,79,0.405,29,70,0.414,3,9,0.333,13,18,0.722,80,34,75,0.453,32,67,0.478,2,8,0.25,15,21,0.714,85,2012-04-20,CHA,MEM
13137,37,@,L 80-92 ,240,32,89,0.36,29,73,0.397,3,16,0.188,13,16,0.813,80,32,87,0.368,30,70,0.429,2,17,0.118,26,36,0.722,92,2012-11-02,SAC,MIN
13138,38,@,L 80-87 ,240,33,85,0.388,30,72,0.417,3,13,0.231,11,15,0.733,80,34,80,0.425,28,67,0.418,6,13,0.462,13,16,0.813,87,2012-11-10,MIN,CHI
13139,39,@,L 80-101 ,240,30,89,0.337,28,75,0.373,2,14,0.143,18,22,0.818,80,37,75,0.493,32,59,0.542,5,16,0.313,22,30,0.733,101,2012-11-17,CHI,LAC
13140,40,Home,L 80-102 ,240,29,69,0.42,21,51,0.412,8,18,0.444,14,21,0.667,80,37,83,0.446,23,47,0.489,14,36,0.389,14,19,0.737,102,2012-11-20,NOP,NYK
13141,41,@,W 80-76 ,240,29,80,0.363,27,70,0.386,2,10,0.2,20,27,0.741,80,28,73,0.384,24,61,0.393,4,12,0.333,16,20,0.8,76,2012-12-04,IND,CHI
13142,42,Home,L 80-99 ,240,29,75,0.387,21,54,0.389,8,21,0.381,14,18,0.778,80,36,86,0.419,27,67,0.403,9,19,0.474,18,22,0.818,99,2012-12-08,POR,SAC
13143,43,Home,L 80-86 ,240,31,81,0.383,24,59,0.407,7,22,0.318,11,11,1.0,80,35,80,0.438,29,58,0.5,6,22,0.273,10,16,0.625,86,2012-12-12,ORL,ATL
13144,44,@,L 80-82 ,240,33,73,0.452,31,63,0.492,2,10,0.2,12,12,1.0,80,34,89,0.382,29,67,0.433,5,22,0.227,9,11,0.818,82,2012-12-12,MEM,PHO
13145,45,Home,W 80-71 ,240,30,80,0.375,24,69,0.348,6,11,0.545,14,19,0.737,80,28,75,0.373,26,64,0.406,2,11,0.182,13,20,0.65,71,2012-12-17,MEM,CHI
13146,46,@,L 80-90 ,240,30,85,0.353,25,65,0.385,5,20,0.25,15,19,0.789,80,36,88,0.409,33,80,0.413,3,8,0.375,15,19,0.789,90,2012-12-19,MIL,MEM
13147,47,@,L 80-99 ,240,31,79,0.392,22,54,0.407,9,25,0.36,9,12,0.75,80,44,86,0.512,36,67,0.537,8,19,0.421,3,7,0.429,99,2012-12-21,ATL,PHI
13148,48,@,L 80-100 ,240,33,78,0.423,26,60,0.433,7,18,0.389,7,12,0.583,80,34,71,0.479,26,52,0.5,8,19,0.421,24,29,0.828,100,2012-12-26,TOR,SAS
13149,49,Home,L 80-87 ,240,34,75,0.453,30,60,0.5,4,15,0.267,8,11,0.727,80,40,89,0.449,39,80,0.488,1,9,0.111,6,9,0.667,87,2013-01-04,PHO,UTA
13150,50,@,L 80-95 ,240,31,82,0.378,26,64,0.406,5,18,0.278,13,18,0.722,80,40,92,0.435,37,72,0.514,3,20,0.15,12,20,0.6,95,2013-01-05,MIL,IND
13151,51,@,L 80-100 ,240,30,80,0.375,24,57,0.421,6,23,0.261,14,17,0.824,80,44,78,0.564,42,67,0.627,2,11,0.182,10,12,0.833,100,2013-01-23,IND,POR
13152,52,@,L 80-97 ,240,28,81,0.346,24,54,0.444,4,27,0.148,20,23,0.87,80,38,75,0.507,32,56,0.571,6,19,0.316,15,22,0.682,97,2013-01-26,NYK,PHI
13153,53,Home,L 80-125 ,240,32,81,0.395,27,63,0.429,5,18,0.278,11,19,0.579,80,47,89,0.528,31,55,0.564,16,34,0.471,15,18,0.833,125,2013-01-28,UTA,HOU
13154,54,@,L 80-89 ,240,30,79,0.38,29,69,0.42,1,10,0.1,19,25,0.76,80,36,76,0.474,33,62,0.532,3,14,0.214,14,19,0.737,89,2013-02-01,SAC,PHI
13155,55,Home,L 80-93 ,240,32,77,0.416,27,59,0.458,5,18,0.278,11,16,0.688,80,36,83,0.434,30,60,0.5,6,23,0.261,15,22,0.682,93,2013-03-09,ATL,BRK
13156,56,@,L 80-87 ,240,30,85,0.353,26,73,0.356,4,12,0.333,16,19,0.842,80,35,77,0.455,34,65,0.523,1,12,0.083,16,22,0.727,87,2013-03-15,MEM,DEN
13157,57,@,L 80-93 ,240,29,81,0.358,17,55,0.309,12,26,0.462,10,14,0.714,80,34,75,0.453,26,47,0.553,8,28,0.286,17,31,0.548,93,2013-03-17,NYK,LAC
13158,58,@,L 80-103 ,240,27,84,0.321,22,64,0.344,5,20,0.25,21,29,0.724,80,29,63,0.46,21,49,0.429,8,14,0.571,37,41,0.902,103,2013-03-27,WAS,OKC
13159,59,Home,L 80-90 ,240,31,79,0.392,24,54,0.444,7,25,0.28,11,14,0.786,80,32,81,0.395,23,60,0.383,9,21,0.429,17,18,0.944,90,2013-04-09,UTA,OKC
13160,60,@,L 80-90 ,240,28,65,0.431,20,37,0.541,8,28,0.286,16,26,0.615,80,35,82,0.427,24,51,0.471,11,31,0.355,9,11,0.818,90,2013-04-14,IND,NYK
13161,61,Home,L 80-96 ,240,32,75,0.427,30,58,0.517,2,17,0.118,14,18,0.778,80,36,77,0.468,33,67,0.493,3,10,0.3,21,23,0.913,96,2013-04-15,MIN,UTA
13162,62,@,L 80-97 ,240,26,73,0.356,21,58,0.362,5,15,0.333,23,27,0.852,80,36,86,0.419,29,68,0.426,7,18,0.389,18,21,0.857,97,2013-11-06,CHI,IND
13163,63,Home,L 80-86 ,240,32,79,0.405,28,64,0.438,4,15,0.267,12,17,0.706,80,32,80,0.4,24,60,0.4,8,20,0.4,14,20,0.7,86,2013-11-15,CLE,CHA
13164,64,Home,L 80-96 ,240,29,82,0.354,24,61,0.393,5,21,0.238,17,22,0.773,80,36,80,0.45,29,64,0.453,7,16,0.438,17,19,0.895,96,2013-11-15,TOR,CHI
13165,65,@,L 80-93 ,240,32,83,0.386,29,63,0.46,3,20,0.15,13,15,0.867,80,32,74,0.432,26,49,0.531,6,25,0.24,23,31,0.742,93,2013-11-27,NYK,LAC
13166,66,@,L 80-98 ,240,30,77,0.39,27,62,0.435,3,15,0.2,17,19,0.895,80,33,73,0.452,24,60,0.4,9,13,0.692,23,29,0.793,98,2013-12-02,ORL,WAS
13167,67,@,L 80-83 ,240,31,84,0.369,24,70,0.343,7,14,0.5,11,15,0.733,80,34,80,0.425,26,59,0.441,8,21,0.381,7,9,0.778,83,2013-12-30,CHA,UTA
13168,68,Home,L 80-92 ,240,32,78,0.41,26,52,0.5,6,26,0.231,10,18,0.556,80,37,76,0.487,32,63,0.508,5,13,0.385,13,16,0.813,92,2014-01-05,DAL,NYK
13169,69,Home,L 80-101 ,240,31,80,0.388,26,65,0.4,5,15,0.333,13,18,0.722,80,39,85,0.459,29,53,0.547,10,32,0.313,13,20,0.65,101,2014-01-07,MIL,GSW
13170,70,@,L 80-83 ,240,29,70,0.414,23,51,0.451,6,19,0.316,16,22,0.727,80,32,86,0.372,23,54,0.426,9,32,0.281,10,11,0.909,83,2014-01-10,HOU,ATL
13171,71,@,L 80-96 ,240,30,75,0.4,22,50,0.44,8,25,0.32,12,18,0.667,80,32,79,0.405,21,54,0.389,11,25,0.44,21,28,0.75,96,2014-01-11,BRK,TOR
13172,72,@,L 80-124 ,240,31,80,0.388,24,59,0.407,7,21,0.333,11,23,0.478,80,42,81,0.519,27,51,0.529,15,30,0.5,25,30,0.833,124,2014-01-12,CLE,SAC
13173,73,Home,L 80-103 ,240,24,71,0.338,16,46,0.348,8,25,0.32,24,37,0.649,80,37,75,0.493,23,37,0.622,14,38,0.368,15,20,0.75,103,2014-01-20,NYK,BRK
13174,74,@,L 80-123 ,240,33,90,0.367,31,73,0.425,2,17,0.118,12,17,0.706,80,43,88,0.489,31,59,0.525,12,29,0.414,25,30,0.833,123,2014-02-10,PHI,GSW
13175,75,@,L 80-119 ,240,28,89,0.315,22,63,0.349,6,26,0.231,18,26,0.692,80,46,80,0.575,42,64,0.656,4,16,0.25,23,26,0.885,119,2014-02-10,DEN,IND
13176,76,@,L 80-124 ,240,32,81,0.395,28,59,0.475,4,22,0.182,12,17,0.706,80,46,86,0.535,33,55,0.6,13,31,0.419,19,21,0.905,124,2014-02-26,BRK,POR
13177,77,@,L 80-96 ,240,30,65,0.462,26,52,0.5,4,13,0.308,16,23,0.696,80,34,73,0.466,27,48,0.563,7,25,0.28,21,28,0.75,96,2014-03-03,CHI,BRK
13178,78,Home,L 80-87 ,240,29,94,0.309,26,73,0.356,3,21,0.143,19,21,0.905,80,34,80,0.425,29,54,0.537,5,26,0.192,14,20,0.7,87,2014-03-14,BOS,PHO
13179,79,@,L 80-102 ,240,29,83,0.349,21,59,0.356,8,24,0.333,14,20,0.7,80,42,94,0.447,34,66,0.515,8,28,0.286,10,15,0.667,102,2014-03-16,CLE,LAC
13180,80,@,L 80-96 ,240,32,81,0.395,29,69,0.42,3,12,0.25,13,16,0.813,80,37,78,0.474,28,57,0.491,9,21,0.429,13,20,0.65,96,2014-03-29,NOP,SAS
13181,81,@,L 80-94 ,240,31,77,0.403,24,52,0.462,7,25,0.28,11,15,0.733,80,38,80,0.475,35,64,0.547,3,16,0.188,15,16,0.938,94,2014-03-31,BOS,CHI
13182,82,@,L 80-91 ,240,31,87,0.356,28,76,0.368,3,11,0.273,15,18,0.833,80,33,78,0.423,27,62,0.435,6,16,0.375,19,23,0.826,91,2014-04-04,ORL,CHA
13183,83,Home,L 80-104 ,240,31,85,0.365,28,68,0.412,3,17,0.176,15,17,0.882,80,36,71,0.507,29,47,0.617,7,24,0.292,25,30,0.833,104,2014-10-29,NYK,CHI
13184,84,Home,L 80-93 ,240,28,75,0.373,26,63,0.413,2,12,0.167,22,31,0.71,80,33,80,0.413,23,57,0.404,10,23,0.435,17,20,0.85,93,2014-11-14,LAL,SAS
13185,85,Home,L 80-107 ,240,32,80,0.4,22,58,0.379,10,22,0.455,6,13,0.462,80,43,84,0.512,33,56,0.589,10,28,0.357,11,16,0.688,107,2014-11-17,CHA,DAL
13186,86,@,L 80-83 ,240,30,81,0.37,24,64,0.375,6,17,0.353,14,21,0.667,80,35,76,0.461,30,64,0.469,5,12,0.417,8,12,0.667,83,2014-11-29,NOP,WAS
13187,87,@,L 80-105 ,240,29,88,0.33,26,74,0.351,3,14,0.214,19,24,0.792,80,37,79,0.468,29,57,0.509,8,22,0.364,23,32,0.719,105,2014-12-10,BRK,CHI
13188,88,Home,L 80-103 ,240,31,82,0.378,26,53,0.491,5,29,0.172,13,17,0.765,80,41,91,0.451,24,60,0.4,17,31,0.548,4,9,0.444,103,2014-12-28,CLE,DET
13189,89,Home,L 80-96 ,240,29,85,0.341,21,54,0.389,8,31,0.258,14,16,0.875,80,40,90,0.444,29,65,0.446,11,25,0.44,5,10,0.5,96,2014-12-31,CLE,MIL
13190,90,Home,L 80-102 ,240,31,73,0.425,27,56,0.482,4,17,0.235,14,16,0.875,80,37,81,0.457,33,69,0.478,4,12,0.333,24,31,0.774,102,2015-01-16,WAS,BRK
13191,91,Home,W 80-71 (OT),265,31,101,0.307,29,86,0.337,2,15,0.133,16,25,0.64,80,30,84,0.357,28,63,0.444,2,21,0.095,9,13,0.692,71,2015-01-17,CHA,IND
13192,92,@,L 80-105 ,240,29,80,0.363,23,61,0.377,6,19,0.316,16,20,0.8,80,40,89,0.449,28,67,0.418,12,22,0.545,13,19,0.684,105,2015-01-19,MIN,CHO
13193,93,@,L 80-96 ,240,28,77,0.364,22,57,0.386,6,20,0.3,18,21,0.857,80,38,83,0.458,35,67,0.522,3,16,0.188,17,21,0.81,96,2015-01-21,LAL,NOP
13194,94,@,L 80-92 ,240,27,76,0.355,20,60,0.333,7,16,0.438,19,23,0.826,80,37,84,0.44,27,62,0.435,10,22,0.455,8,13,0.615,92,2015-02-01,LAL,NYK
13195,95,@,L 80-96 ,240,33,83,0.398,29,61,0.475,4,22,0.182,10,15,0.667,80,33,77,0.429,26,52,0.5,7,25,0.28,23,27,0.852,96,2015-02-09,ORL,WAS
13196,96,Home,L 80-105 ,240,29,88,0.33,21,50,0.42,8,38,0.211,14,21,0.667,80,43,96,0.448,30,66,0.455,13,30,0.433,6,8,0.75,105,2015-02-20,ATL,TOR
13197,97,Home,L 80-98 ,240,29,77,0.377,25,66,0.379,4,11,0.364,18,23,0.783,80,35,83,0.422,22,52,0.423,13,31,0.419,15,19,0.789,98,2015-03-09,PHO,GSW
13198,98,@,W 80-73 ,240,25,62,0.403,16,37,0.432,9,25,0.36,21,31,0.677,80,31,77,0.403,28,66,0.424,3,11,0.273,8,17,0.471,73,2015-03-19,UTA,LAL
13199,99,Home,L 80-111 ,240,29,82,0.354,24,59,0.407,5,23,0.217,17,19,0.895,80,44,78,0.564,33,50,0.66,11,28,0.393,12,18,0.667,111,2015-03-25,NYK,LAC
13200,0,@,L 80-111 ,240,30,79,0.38,26,62,0.419,4,17,0.235,16,19,0.842,80,43,84,0.512,37,67,0.552,6,17,0.353,19,22,0.864,111,2015-03-28,NYK,CHI
13201,1,@,L 80-104 ,240,30,83,0.361,22,53,0.415,8,30,0.267,12,18,0.667,80,41,82,0.5,31,54,0.574,10,28,0.357,12,16,0.75,104,2015-04-10,CHA,ATL
13202,2,@,L 80-117 ,240,32,82,0.39,27,67,0.403,5,15,0.333,11,17,0.647,80,45,89,0.506,33,69,0.478,12,20,0.6,15,23,0.652,117,2015-04-10,WAS,BRK
13203,3,@,W 80-79 ,240,31,82,0.378,25,62,0.403,6,20,0.3,12,13,0.923,80,30,84,0.357,24,62,0.387,6,22,0.273,13,18,0.722,79,2015-04-11,NYK,ORL
13204,4,@,L 80-93 ,240,31,75,0.413,24,56,0.429,7,19,0.368,11,13,0.846,80,38,89,0.427,31,66,0.47,7,23,0.304,10,13,0.769,93,2015-11-16,POR,SAS
13205,5,Home,L 80-91 ,240,29,74,0.392,22,42,0.524,7,32,0.219,15,20,0.75,80,29,78,0.372,25,61,0.41,4,17,0.235,29,31,0.935,91,2015-11-22,LAC,TOR
13206,6,@,L 80-84 ,240,31,83,0.373,24,56,0.429,7,27,0.259,11,15,0.733,80,31,91,0.341,22,62,0.355,9,29,0.31,13,18,0.722,84,2015-11-25,PHI,BOS
13207,7,Home,L 80-91 ,240,31,77,0.403,24,57,0.421,7,20,0.35,11,13,0.846,80,36,75,0.48,28,53,0.528,8,22,0.364,11,14,0.786,91,2015-11-27,DEN,SAS
13208,8,@,L 80-83 ,240,30,88,0.341,20,66,0.303,10,22,0.455,10,12,0.833,80,31,87,0.356,24,64,0.375,7,23,0.304,14,16,0.875,83,2015-12-10,LAC,CHI
13209,9,@,L 80-94 ,240,28,80,0.35,18,41,0.439,10,39,0.256,14,20,0.7,80,36,77,0.468,31,67,0.463,5,10,0.5,17,27,0.63,94,2015-12-30,UTA,MIN
13210,10,Home,L 80-88 ,240,32,91,0.352,28,72,0.389,4,19,0.211,12,15,0.8,80,35,88,0.398,28,63,0.444,7,25,0.28,11,14,0.786,88,2016-03-20,NYK,SAC
13211,11,Home,L 80-109 ,240,35,88,0.398,31,72,0.431,4,16,0.25,6,12,0.5,80,41,75,0.547,23,39,0.59,18,36,0.5,9,10,0.9,109,2016-04-05,MIL,CLE
13212,12,@,L 80-116 ,240,27,75,0.36,23,51,0.451,4,24,0.167,22,29,0.759,80,43,78,0.551,31,58,0.534,12,20,0.6,18,23,0.783,116,2016-11-01,MEM,MIN
13213,13,@,L 80-112 ,240,33,85,0.388,24,55,0.436,9,30,0.3,5,6,0.833,80,42,89,0.472,39,70,0.557,3,19,0.158,25,31,0.806,112,2016-11-07,ORL,CHI
13214,14,@,L 80-111 ,240,31,88,0.352,25,58,0.431,6,30,0.2,12,14,0.857,80,38,87,0.437,27,55,0.491,11,32,0.344,24,33,0.727,111,2016-11-09,POR,LAC
13215,15,@,W 80-64 ,240,31,77,0.403,22,52,0.423,9,25,0.36,9,12,0.75,80,21,73,0.288,16,48,0.333,5,25,0.2,17,22,0.773,64,2016-11-18,MEM,DAL
13216,16,@,L 80-113 ,240,32,93,0.344,26,67,0.388,6,26,0.231,10,17,0.588,80,45,83,0.542,33,54,0.611,12,29,0.414,11,13,0.846,113,2016-12-02,LAL,TOR
13217,17,@,L 80-114 ,240,25,74,0.338,21,52,0.404,4,22,0.182,26,38,0.684,80,43,82,0.524,30,60,0.5,13,22,0.591,15,20,0.75,114,2016-12-29,OKC,MEM
13218,18,@,L 80-112 ,240,32,82,0.39,29,59,0.492,3,23,0.13,13,18,0.722,80,45,91,0.495,28,56,0.5,17,35,0.486,5,6,0.833,112,2017-02-11,ORL,DAL
13219,19,Home,L 80-107 ,240,35,90,0.389,31,71,0.437,4,19,0.211,6,11,0.545,80,39,78,0.5,31,62,0.5,8,16,0.5,21,26,0.808,107,2017-03-01,UTA,MIN
13220,20,@,L 79-91 ,240,27,75,0.36,20,56,0.357,7,19,0.368,18,21,0.857,79,32,87,0.368,25,72,0.347,7,15,0.467,20,25,0.8,91,2011-12-26,DET,IND
13221,21,@,L 79-101 ,240,31,82,0.378,28,66,0.424,3,16,0.188,14,22,0.636,79,38,85,0.447,35,67,0.522,3,18,0.167,22,28,0.786,101,2011-12-27,SAC,POR
13222,22,Home,L 79-100 ,240,30,83,0.361,25,68,0.368,5,15,0.333,14,18,0.778,79,37,84,0.44,25,56,0.446,12,28,0.429,14,24,0.583,100,2011-12-30,CHA,ORL
13223,23,Home,L 79-107 ,240,34,89,0.382,30,72,0.417,4,17,0.235,7,12,0.583,79,39,79,0.494,28,59,0.475,11,20,0.55,18,31,0.581,107,2011-12-31,GSW,PHI
13224,24,@,L 79-85 ,240,32,81,0.395,29,66,0.439,3,15,0.2,12,18,0.667,79,32,77,0.416,26,55,0.473,6,22,0.273,15,19,0.789,85,2012-01-11,PHI,NYK
13225,25,Home,L 79-88 ,240,31,75,0.413,25,61,0.41,6,14,0.429,11,13,0.846,79,34,76,0.447,30,63,0.476,4,13,0.308,16,21,0.762,88,2012-01-13,BOS,CHI
13226,26,@,L 79-108 ,240,31,85,0.365,27,65,0.415,4,20,0.2,13,21,0.619,79,39,82,0.476,36,74,0.486,3,8,0.375,27,31,0.871,108,2012-01-17,LAC,UTA
13227,27,@,W 79-71 ,240,31,69,0.449,26,50,0.52,5,19,0.263,12,16,0.75,79,30,74,0.405,26,64,0.406,4,10,0.4,7,9,0.778,71,2012-01-20,PHO,BOS
13228,28,@,L 79-99 ,240,28,82,0.341,24,68,0.353,4,14,0.286,19,27,0.704,79,41,77,0.532,34,61,0.557,7,16,0.438,10,14,0.714,99,2012-01-23,DET,OKC
13229,29,@,L 79-87 ,240,31,75,0.413,24,59,0.407,7,16,0.438,10,11,0.909,79,36,82,0.439,34,73,0.466,2,9,0.222,13,18,0.722,87,2012-01-27,SAS,MIN
13230,30,Home,L 79-99 ,240,32,81,0.395,27,69,0.391,5,12,0.417,10,14,0.714,79,40,77,0.519,32,64,0.5,8,13,0.615,11,20,0.55,99,2012-02-03,PHI,MIA
13231,31,@,L 79-90 ,240,30,74,0.405,21,49,0.429,9,25,0.36,10,21,0.476,79,34,88,0.386,26,68,0.382,8,20,0.4,14,19,0.737,90,2012-02-20,ATL,CHI
13232,32,@,L 79-121 ,240,28,75,0.373,23,58,0.397,5,17,0.294,18,23,0.783,79,43,80,0.538,24,42,0.571,19,38,0.5,16,26,0.615,121,2012-03-14,POR,NYK
13233,33,@,W 79-76 ,240,29,74,0.392,23,58,0.397,6,16,0.375,15,17,0.882,79,29,75,0.387,24,60,0.4,5,15,0.333,13,19,0.684,76,2012-03-19,BOS,ATL
13234,34,Home,L 79-82 ,240,29,75,0.387,21,58,0.362,8,17,0.471,13,18,0.722,79,29,79,0.367,27,66,0.409,2,13,0.154,22,28,0.786,82,2012-03-21,PHI,NYK
13235,35,@,L 79-96 ,240,32,85,0.376,27,57,0.474,5,28,0.179,10,18,0.556,79,38,83,0.458,37,70,0.529,1,13,0.077,19,26,0.731,96,2012-03-23,NYK,TOR
13236,36,@,L 79-101 ,240,28,76,0.368,22,57,0.386,6,19,0.316,17,22,0.773,79,38,78,0.487,32,58,0.552,6,20,0.3,19,30,0.633,101,2012-03-24,DET,NYK
13237,37,@,W 79-77 ,240,28,76,0.368,25,63,0.397,3,13,0.231,20,27,0.741,79,32,78,0.41,28,61,0.459,4,17,0.235,9,14,0.643,77,2012-03-26,DET,WAS
13238,38,Home,L 79-100 ,240,26,75,0.347,20,51,0.392,6,24,0.25,21,25,0.84,79,44,90,0.489,40,78,0.513,4,12,0.333,8,11,0.727,100,2012-03-30,MIN,BOS
13239,39,@,L 79-103 ,240,29,76,0.382,27,65,0.415,2,11,0.182,19,24,0.792,79,40,68,0.588,33,53,0.623,7,15,0.467,16,19,0.842,103,2012-04-08,PHI,BOS
13240,40,@,L 79-84 ,240,30,80,0.375,26,61,0.426,4,19,0.211,15,19,0.789,79,25,72,0.347,18,54,0.333,7,18,0.389,27,31,0.871,84,2012-04-13,BOS,TOR
13241,41,@,L 79-108 ,240,28,79,0.354,24,66,0.364,4,13,0.308,19,23,0.826,79,40,77,0.519,30,55,0.545,10,22,0.455,18,26,0.692,108,2012-11-04,DET,LAL
13242,42,@,L 79-101 ,240,27,79,0.342,21,59,0.356,6,20,0.3,19,22,0.864,79,41,87,0.471,33,69,0.478,8,18,0.444,11,13,0.846,101,2012-11-05,IND,SAS
13243,43,@,L 79-86 ,240,30,84,0.357,25,64,0.391,5,20,0.25,14,15,0.933,79,34,80,0.425,25,60,0.417,9,20,0.45,9,12,0.75,86,2012-11-18,CLE,PHI
13244,44,@,W 79-77 ,240,29,79,0.367,25,60,0.417,4,19,0.211,17,27,0.63,79,24,76,0.316,18,48,0.375,6,28,0.214,23,43,0.535,77,2012-11-27,IND,LAL
13245,45,Home,L 79-100 ,240,30,81,0.37,24,57,0.421,6,24,0.25,13,18,0.722,79,40,79,0.506,33,63,0.524,7,16,0.438,13,17,0.765,100,2012-12-01,NOP,OKC
13246,46,@,L 79-89 ,240,32,95,0.337,29,75,0.387,3,20,0.15,12,17,0.706,79,36,84,0.429,32,66,0.485,4,18,0.222,13,19,0.684,89,2012-12-03,CLE,DET
13247,47,@,L 79-92 ,240,31,79,0.392,27,62,0.435,4,17,0.235,13,16,0.813,79,40,75,0.533,36,61,0.59,4,14,0.286,8,12,0.667,92,2012-12-08,PHI,BOS
13248,48,@,L 79-102 ,240,31,70,0.443,27,48,0.563,4,22,0.182,13,16,0.813,79,41,77,0.532,33,54,0.611,8,23,0.348,12,17,0.706,102,2013-01-02,POR,TOR
13249,49,@,L 79-87 ,240,33,84,0.393,31,72,0.431,2,12,0.167,11,18,0.611,79,37,81,0.457,34,67,0.507,3,14,0.214,10,12,0.833,87,2013-01-09,PHO,BOS
13250,50,@,L 79-88 ,240,30,75,0.4,21,48,0.438,9,27,0.333,10,13,0.769,79,35,84,0.417,30,65,0.462,5,19,0.263,13,16,0.813,88,2013-01-09,HOU,NOH
13251,51,@,L 79-99 ,240,31,79,0.392,24,65,0.369,7,14,0.5,10,16,0.625,79,34,75,0.453,28,62,0.452,6,13,0.462,25,32,0.781,99,2013-01-11,PHO,BRK
13252,52,@,L 79-92 ,240,25,78,0.321,17,47,0.362,8,31,0.258,21,28,0.75,79,30,64,0.469,27,50,0.54,3,14,0.214,29,36,0.806,92,2013-01-19,HOU,MIN
13253,53,@,L 79-98 ,240,32,88,0.364,29,70,0.414,3,18,0.167,12,27,0.444,79,36,81,0.444,29,67,0.433,7,14,0.5,19,21,0.905,98,2013-01-30,DET,IND
13254,54,@,L 79-91 ,240,29,77,0.377,22,57,0.386,7,20,0.35,14,20,0.7,79,30,68,0.441,26,52,0.5,4,16,0.25,27,33,0.818,91,2013-03-10,BOS,OKC
13255,55,@,L 79-121 ,240,32,83,0.386,30,62,0.484,2,21,0.095,13,15,0.867,79,45,83,0.542,36,60,0.6,9,23,0.391,22,26,0.846,121,2013-03-13,CHI,SAC
13256,56,Home,L 79-88 ,240,28,83,0.337,25,68,0.368,3,15,0.2,20,22,0.909,79,33,68,0.485,27,53,0.509,6,15,0.4,16,25,0.64,88,2013-03-20,PHO,WAS
13257,57,Home,L 79-89 ,240,28,88,0.318,25,72,0.347,3,16,0.188,20,22,0.909,79,31,69,0.449,18,36,0.5,13,33,0.394,14,17,0.824,89,2013-04-05,CHA,MIA
13258,58,@,L 79-94 ,240,30,90,0.333,21,64,0.328,9,26,0.346,10,14,0.714,79,40,84,0.476,33,63,0.524,7,21,0.333,7,9,0.778,94,2013-11-08,CLE,PHI
13259,59,@,L 79-95 ,240,31,75,0.413,27,67,0.403,4,8,0.5,13,19,0.684,79,37,76,0.487,31,57,0.544,6,19,0.316,15,18,0.833,95,2013-11-11,MEM,IND
13260,60,@,L 79-92 ,240,33,91,0.363,28,76,0.368,5,15,0.333,8,11,0.727,79,39,77,0.506,31,55,0.564,8,22,0.364,6,8,0.75,92,2013-11-13,WAS,SAS
13261,61,Home,L 79-92 ,240,30,86,0.349,22,64,0.344,8,22,0.364,11,15,0.733,79,34,82,0.415,29,65,0.446,5,17,0.294,19,27,0.704,92,2013-11-16,MIL,OKC
13262,62,Home,L 79-99 ,240,34,77,0.442,32,65,0.492,2,12,0.167,9,19,0.474,79,42,79,0.532,36,62,0.581,6,17,0.353,9,12,0.75,99,2013-11-27,DET,CHI
13263,63,@,L 79-106 ,240,32,84,0.381,26,70,0.371,6,14,0.429,9,13,0.692,79,41,83,0.494,32,64,0.5,9,19,0.474,15,22,0.682,106,2013-12-22,BOS,IND
13264,64,Home,L 79-85 ,240,30,82,0.366,28,73,0.384,2,9,0.222,17,21,0.81,79,29,69,0.42,25,55,0.455,4,14,0.286,23,31,0.742,85,2013-12-31,CHI,TOR
13265,65,Home,L 79-94 ,240,29,81,0.358,22,57,0.386,7,24,0.292,14,18,0.778,79,40,91,0.44,34,68,0.5,6,23,0.261,8,14,0.571,94,2013-12-31,LAL,MIL
13266,66,@,L 79-86 ,240,30,81,0.37,25,62,0.403,5,19,0.263,14,18,0.778,79,32,75,0.427,31,64,0.484,1,11,0.091,21,26,0.808,86,2014-01-07,TOR,IND
13267,67,Home,L 79-105 ,240,29,76,0.382,27,63,0.429,2,13,0.154,19,27,0.704,79,41,84,0.488,30,66,0.455,11,18,0.611,12,17,0.706,105,2014-01-24,ATL,SAS
13268,68,Home,L 79-85 ,240,28,75,0.373,21,49,0.429,7,26,0.269,16,19,0.842,79,33,84,0.393,27,59,0.458,6,25,0.24,13,18,0.722,85,2014-01-26,BOS,BRK
13269,69,@,L 79-88 ,240,27,70,0.386,24,54,0.444,3,16,0.188,22,33,0.667,79,38,80,0.475,34,71,0.479,4,9,0.444,8,10,0.8,88,2014-02-01,CHI,NOP
13270,70,@,L 79-98 ,240,33,83,0.398,26,67,0.388,7,16,0.438,6,10,0.6,79,38,90,0.422,30,65,0.462,8,25,0.32,14,17,0.824,98,2014-02-03,ORL,IND
13271,71,Home,L 79-94 ,240,32,78,0.41,29,61,0.475,3,17,0.176,12,13,0.923,79,37,84,0.44,31,63,0.492,6,21,0.286,14,16,0.875,94,2014-02-03,UTA,TOR
13272,72,@,W 79-76 ,240,37,90,0.411,33,78,0.423,4,12,0.333,1,1,1.0,79,30,70,0.429,22,50,0.44,8,20,0.4,8,15,0.533,76,2014-02-08,MEM,ATL
13273,73,Home,L 79-96 ,240,33,85,0.388,29,69,0.42,4,16,0.25,9,13,0.692,79,37,85,0.435,31,68,0.456,6,17,0.353,16,25,0.64,96,2014-02-11,LAL,UTA
13274,74,@,L 79-93 ,240,29,81,0.358,23,60,0.383,6,21,0.286,15,17,0.882,79,37,88,0.42,28,65,0.431,9,23,0.391,10,14,0.714,93,2014-02-23,CHI,MIA
13275,75,@,L 79-99 ,240,28,80,0.35,14,51,0.275,14,29,0.483,9,14,0.643,79,43,88,0.489,39,73,0.534,4,15,0.267,9,12,0.75,99,2014-02-28,UTA,CLE
13276,76,@,L 79-91 ,240,28,77,0.364,23,66,0.348,5,11,0.455,18,24,0.75,79,34,79,0.43,32,68,0.471,2,11,0.182,21,25,0.84,91,2014-03-21,CHI,IND
13277,77,Home,L 79-99 ,240,32,80,0.4,28,66,0.424,4,14,0.286,11,18,0.611,79,36,93,0.387,31,68,0.456,5,25,0.2,22,27,0.815,99,2014-03-21,SAC,SAS
13278,78,@,L 79-89 ,240,31,84,0.369,25,58,0.431,6,26,0.231,11,19,0.579,79,30,85,0.353,24,61,0.393,6,24,0.25,23,31,0.742,89,2014-10-29,DET,DEN
13279,79,Home,L 79-86 ,240,31,88,0.352,28,64,0.438,3,24,0.125,14,20,0.7,79,30,72,0.417,23,49,0.469,7,23,0.304,19,31,0.613,86,2014-11-30,NYK,MIA
13280,80,@,L 79-95 ,240,30,72,0.417,24,47,0.511,6,25,0.24,13,22,0.591,79,38,91,0.418,28,61,0.459,10,30,0.333,9,13,0.692,95,2014-12-10,PHI,ATL
13281,81,@,L 79-101 ,240,31,93,0.333,24,66,0.364,7,27,0.259,10,15,0.667,79,38,81,0.469,22,45,0.489,16,36,0.444,9,12,0.75,101,2014-12-28,NYK,POR
13282,82,@,L 79-115 ,240,30,68,0.441,26,51,0.51,4,17,0.235,15,25,0.6,79,41,83,0.494,28,52,0.538,13,31,0.419,20,28,0.714,115,2015-01-03,MIA,HOU
13283,83,@,L 79-95 ,240,28,68,0.412,20,46,0.435,8,22,0.364,15,20,0.75,79,28,72,0.389,20,54,0.37,8,18,0.444,31,42,0.738,95,2015-01-15,NYK,MIL
13284,84,@,L 79-122 ,240,30,87,0.345,23,63,0.365,7,24,0.292,12,19,0.632,79,44,81,0.543,31,54,0.574,13,27,0.481,21,27,0.778,122,2015-01-19,DEN,GSW
13285,85,Home,L 79-97 ,240,33,87,0.379,30,75,0.4,3,12,0.25,10,15,0.667,79,36,78,0.462,27,52,0.519,9,26,0.346,16,28,0.571,97,2015-02-27,MEM,LAC
13286,86,@,L 79-110 ,240,31,88,0.352,24,60,0.4,7,28,0.25,10,13,0.769,79,43,89,0.483,33,61,0.541,10,28,0.357,14,14,1.0,110,2015-03-03,BOS,CLE
13287,87,@,L 79-89 ,240,30,84,0.357,21,59,0.356,9,25,0.36,10,14,0.714,79,31,75,0.413,23,55,0.418,8,20,0.4,19,23,0.826,89,2015-03-07,PHO,CLE
13288,88,Home,L 79-80 ,240,30,84,0.357,24,62,0.387,6,22,0.273,13,18,0.722,79,31,82,0.378,25,62,0.403,6,20,0.3,12,13,0.923,80,2015-04-11,ORL,NYK
13289,89,@,L 79-89 ,240,30,91,0.33,24,72,0.333,6,19,0.316,13,14,0.929,79,31,74,0.419,19,47,0.404,12,27,0.444,15,18,0.833,89,2015-11-07,MEM,UTA
13290,90,@,L 79-112 ,240,32,81,0.395,27,63,0.429,5,18,0.278,10,18,0.556,79,43,76,0.566,37,62,0.597,6,14,0.429,20,33,0.606,112,2015-12-30,PHO,SAS
13291,91,@,L 79-104 ,240,29,76,0.382,23,51,0.451,6,25,0.24,15,17,0.882,79,34,82,0.415,22,45,0.489,12,37,0.324,24,39,0.615,104,2016-01-02,ORL,CLE
13292,92,Home,L 79-106 ,240,33,73,0.452,31,61,0.508,2,12,0.167,11,13,0.846,79,44,82,0.537,40,69,0.58,4,13,0.308,14,19,0.737,106,2016-01-11,BRK,SAS
13293,93,Home,L 79-91 ,240,27,74,0.365,22,52,0.423,5,22,0.227,20,26,0.769,79,36,74,0.486,31,62,0.5,5,12,0.417,14,16,0.875,91,2016-01-19,MIA,MIL
13294,94,@,L 79-91 ,240,28,78,0.359,24,58,0.414,4,20,0.2,19,23,0.826,79,37,80,0.463,29,59,0.492,8,21,0.381,9,15,0.6,91,2016-01-29,BRK,DAL
13295,95,Home,L 79-96 ,240,25,77,0.325,18,41,0.439,7,36,0.194,22,30,0.733,79,35,87,0.402,24,52,0.462,11,35,0.314,15,23,0.652,96,2016-02-06,HOU,POR
13296,96,@,L 79-87 ,240,31,82,0.378,22,46,0.478,9,36,0.25,8,10,0.8,79,32,78,0.41,24,57,0.421,8,21,0.381,15,18,0.833,87,2016-03-19,GSW,SAS
13297,97,@,L 79-91 ,240,31,89,0.348,25,67,0.373,6,22,0.273,11,20,0.55,79,35,80,0.438,27,60,0.45,8,20,0.4,13,21,0.619,91,2016-03-23,TOR,BOS
13298,98,Home,L 79-99 ,240,30,87,0.345,22,64,0.344,8,23,0.348,11,17,0.647,79,37,84,0.44,28,53,0.528,9,31,0.29,16,18,0.889,99,2016-03-30,MIN,LAC
13299,99,@,L 79-112 ,240,23,81,0.284,16,50,0.32,7,31,0.226,26,30,0.867,79,42,96,0.438,30,59,0.508,12,37,0.324,16,27,0.593,112,2016-04-11,LAL,OKC
13300,0,@,L 79-98 ,240,32,86,0.372,28,64,0.438,4,22,0.182,11,15,0.733,79,35,83,0.422,25,59,0.424,10,24,0.417,18,23,0.783,98,2016-10-29,NOP,SAS
13301,1,Home,L 79-97 ,240,32,82,0.39,27,63,0.429,5,19,0.263,10,14,0.714,79,38,68,0.559,31,51,0.608,7,17,0.412,14,17,0.824,97,2016-12-11,DET,PHI
13302,2,@,L 79-99 ,240,30,76,0.395,22,45,0.489,8,31,0.258,11,17,0.647,79,34,77,0.442,21,44,0.477,13,33,0.394,18,22,0.818,99,2016-12-18,SAC,DAL
13303,3,Home,L 79-109 ,240,34,83,0.41,31,62,0.5,3,21,0.143,8,9,0.889,79,43,87,0.494,36,60,0.6,7,27,0.259,16,21,0.762,109,2016-12-18,ORL,TOR
13304,4,@,L 79-88 ,240,28,72,0.389,19,49,0.388,9,23,0.391,14,23,0.609,79,34,78,0.436,25,54,0.463,9,24,0.375,11,14,0.786,88,2017-01-08,UTA,MEM
13305,5,Home,L 79-107 ,240,30,76,0.395,26,58,0.448,4,18,0.222,15,19,0.789,79,42,89,0.472,34,58,0.586,8,31,0.258,15,19,0.789,107,2017-02-15,ORL,SAS
13306,6,@,L 78-92 ,240,28,70,0.4,24,49,0.49,4,21,0.19,18,25,0.72,78,35,77,0.455,29,61,0.475,6,16,0.375,16,24,0.667,92,2011-12-28,NYK,GSW
13307,7,@,L 78-97 ,240,29,78,0.372,22,61,0.361,7,17,0.412,13,18,0.722,78,36,79,0.456,32,67,0.478,4,12,0.333,21,25,0.84,97,2011-12-28,BOS,NOH
13308,8,@,L 78-94 ,240,29,77,0.377,23,60,0.383,6,17,0.353,14,21,0.667,78,36,81,0.444,27,60,0.45,9,21,0.429,13,25,0.52,94,2011-12-29,BRK,ORL
13309,9,Home,L 78-93 ,240,26,90,0.289,23,76,0.303,3,14,0.214,23,28,0.821,78,33,78,0.423,26,55,0.473,7,23,0.304,20,22,0.909,93,2011-12-30,NOP,PHO
13310,10,@,L 78-89 ,240,28,63,0.444,20,41,0.488,8,22,0.364,14,21,0.667,78,31,62,0.5,29,54,0.537,2,8,0.25,25,33,0.758,89,2012-01-02,ORL,DET
13311,11,@,L 78-98 ,240,29,79,0.367,26,55,0.473,3,24,0.125,17,24,0.708,78,38,92,0.413,32,69,0.464,6,23,0.261,16,18,0.889,98,2012-01-08,CLE,POR
13312,12,@,L 78-93 ,240,30,76,0.395,26,56,0.464,4,20,0.2,14,17,0.824,78,40,82,0.488,36,69,0.522,4,13,0.308,9,17,0.529,93,2012-01-10,TOR,WAS
13313,13,Home,W 78-64 ,240,33,90,0.367,30,78,0.385,3,12,0.25,9,16,0.563,78,26,84,0.31,23,75,0.307,3,9,0.333,9,12,0.75,64,2012-01-11,CHI,WAS
13314,14,Home,L 78-111 ,240,27,82,0.329,24,71,0.338,3,11,0.273,21,22,0.955,78,39,78,0.5,32,59,0.542,7,19,0.368,26,33,0.788,111,2012-01-24,CHA,NYK
13315,15,@,W 78-77 ,240,33,85,0.388,31,66,0.47,2,19,0.105,10,15,0.667,78,29,71,0.408,25,56,0.446,4,15,0.267,15,23,0.652,77,2012-02-10,LAC,PHI
13316,16,@,L 78-86 ,240,31,90,0.344,24,63,0.381,7,27,0.259,9,14,0.643,78,37,84,0.44,29,67,0.433,8,17,0.471,4,9,0.444,86,2012-02-14,ATL,LAL
13317,17,@,L 78-90 ,240,27,74,0.365,16,45,0.356,11,29,0.379,13,25,0.52,78,38,80,0.475,35,68,0.515,3,12,0.25,11,14,0.786,90,2012-02-19,ORL,MIA
13318,18,@,L 78-83 ,240,31,82,0.378,24,50,0.48,7,32,0.219,9,13,0.692,78,31,78,0.397,24,61,0.393,7,17,0.412,14,20,0.7,83,2012-02-23,ORL,ATL
13319,19,@,L 78-102 ,240,29,85,0.341,26,63,0.413,3,22,0.136,17,24,0.708,78,37,84,0.44,32,73,0.438,5,11,0.455,23,32,0.719,102,2012-02-28,GSW,IND
13320,20,@,L 78-81 ,240,32,87,0.368,26,71,0.366,6,16,0.375,8,9,0.889,78,28,80,0.35,21,59,0.356,7,21,0.333,18,29,0.621,81,2012-03-02,LAC,PHO
13321,21,@,L 78-108 ,240,31,83,0.373,23,61,0.377,8,22,0.364,8,12,0.667,78,45,77,0.584,35,60,0.583,10,17,0.588,8,9,0.889,108,2012-03-06,BRK,MIA
13322,22,Home,L 78-84 ,240,33,93,0.355,28,75,0.373,5,18,0.278,7,14,0.5,78,35,74,0.473,31,62,0.5,4,12,0.333,10,19,0.526,84,2012-03-16,PHI,MIA
13323,23,@,L 78-92 ,240,30,91,0.33,22,67,0.328,8,24,0.333,10,15,0.667,78,36,74,0.486,32,65,0.492,4,9,0.444,16,17,0.941,92,2012-04-01,CHI,OKC
13324,24,Home,L 78-99 ,240,34,79,0.43,31,67,0.463,3,12,0.25,7,8,0.875,78,39,77,0.506,30,56,0.536,9,21,0.429,12,12,1.0,99,2012-04-04,PHI,TOR
13325,25,Home,W 78-66 ,240,32,74,0.432,28,62,0.452,4,12,0.333,10,16,0.625,78,28,73,0.384,22,56,0.393,6,17,0.353,4,7,0.571,66,2012-04-24,BOS,MIA
13326,26,@,L 78-84 ,240,31,76,0.408,27,60,0.45,4,16,0.25,12,15,0.8,78,33,71,0.465,29,60,0.483,4,11,0.364,14,18,0.778,84,2012-11-26,CLE,MEM
13327,27,Home,L 78-91 ,240,30,84,0.357,28,69,0.406,2,15,0.133,16,22,0.727,78,37,79,0.468,31,62,0.5,6,17,0.353,11,18,0.611,91,2012-11-27,CLE,PHO
13328,28,@,L 78-101 ,240,28,81,0.346,24,63,0.381,4,18,0.222,18,20,0.9,78,34,69,0.493,28,59,0.475,6,10,0.6,27,33,0.818,101,2012-11-28,DAL,CHI
13329,29,@,L 78-96 ,240,24,69,0.348,21,54,0.389,3,15,0.2,27,37,0.73,78,36,73,0.493,30,57,0.526,6,16,0.375,18,20,0.9,96,2012-11-30,POR,BOS
13330,30,@,L 78-90 ,240,29,72,0.403,25,56,0.446,4,16,0.25,16,20,0.8,78,34,85,0.4,30,73,0.411,4,12,0.333,18,21,0.857,90,2012-11-30,DET,MEM
13331,31,@,L 78-92 ,240,30,78,0.385,25,49,0.51,5,29,0.172,13,29,0.448,78,37,82,0.451,30,59,0.508,7,23,0.304,11,21,0.524,92,2013-01-01,LAC,DEN
13332,32,@,L 78-99 ,240,28,75,0.373,25,63,0.397,3,12,0.25,19,22,0.864,78,39,86,0.453,27,59,0.458,12,27,0.444,9,11,0.818,99,2013-01-11,CHA,TOR
13333,33,Home,L 78-90 ,240,34,74,0.459,30,56,0.536,4,18,0.222,6,16,0.375,78,31,71,0.437,29,54,0.537,2,17,0.118,26,31,0.839,90,2013-01-16,BOS,NOH
13334,34,@,L 78-102 ,240,30,73,0.411,26,54,0.481,4,19,0.211,14,17,0.824,78,38,69,0.551,29,53,0.547,9,16,0.563,17,21,0.81,102,2013-01-30,CHA,SAS
13335,35,Home,W 78-61 ,240,36,79,0.456,33,59,0.559,3,20,0.15,3,5,0.6,78,27,80,0.338,26,68,0.382,1,12,0.083,6,8,0.75,61,2013-02-04,PHI,ORL
13336,36,Home,L 78-99 ,240,32,84,0.381,28,66,0.424,4,18,0.222,10,15,0.667,78,34,67,0.507,21,40,0.525,13,27,0.481,18,22,0.818,99,2013-03-06,CHA,BRK
13337,37,@,L 78-95 ,240,32,90,0.356,29,73,0.397,3,17,0.176,11,17,0.647,78,32,81,0.395,20,54,0.37,12,27,0.444,19,33,0.576,95,2013-03-08,WAS,BRK
13338,38,@,L 78-92 ,240,26,80,0.325,20,58,0.345,6,22,0.273,20,29,0.69,78,33,68,0.485,30,58,0.517,3,10,0.3,23,27,0.852,92,2013-03-15,CHA,TOR
13339,39,Home,L 78-108 ,240,28,86,0.326,19,51,0.373,9,35,0.257,13,16,0.813,78,44,96,0.458,31,70,0.443,13,26,0.5,7,9,0.778,108,2013-03-17,HOU,GSW
13340,40,@,L 78-116 ,240,31,86,0.36,27,66,0.409,4,20,0.2,12,15,0.8,78,44,77,0.571,34,48,0.708,10,29,0.345,18,27,0.667,116,2013-03-22,CLE,HOU
13341,41,@,L 78-102 ,240,31,101,0.307,28,82,0.341,3,19,0.158,13,22,0.591,78,38,79,0.481,35,67,0.522,3,12,0.25,23,30,0.767,102,2013-03-22,MIL,IND
13342,42,Home,L 78-103 ,240,32,83,0.386,28,69,0.406,4,14,0.286,10,14,0.714,78,40,84,0.476,33,69,0.478,7,15,0.467,16,26,0.615,103,2013-03-28,DAL,IND
13343,43,@,L 78-88 ,240,26,80,0.325,21,61,0.344,5,19,0.263,21,29,0.724,78,30,66,0.455,29,58,0.5,1,8,0.125,27,36,0.75,88,2013-04-03,WAS,TOR
13344,44,Home,L 78-82 ,240,23,74,0.311,12,42,0.286,11,32,0.344,21,28,0.75,78,29,83,0.349,24,66,0.364,5,17,0.294,19,28,0.679,82,2013-04-12,HOU,MEM
13345,45,@,W 78-74 ,240,30,75,0.4,28,64,0.438,2,11,0.182,16,20,0.8,78,31,83,0.373,28,68,0.412,3,15,0.2,9,14,0.643,74,2013-12-10,MIL,CHI
13346,46,@,L 78-83 ,240,24,72,0.333,18,51,0.353,6,21,0.286,24,29,0.828,78,31,76,0.408,26,57,0.456,5,19,0.263,16,19,0.842,83,2013-12-11,CHI,NYK
13347,47,Home,L 78-95 ,240,25,71,0.352,20,54,0.37,5,17,0.294,23,31,0.742,78,36,74,0.486,31,57,0.544,5,17,0.294,18,20,0.9,95,2013-12-25,BRK,CHI
13348,48,Home,L 78-87 ,240,33,88,0.375,28,64,0.438,5,24,0.208,7,10,0.7,78,30,78,0.385,24,54,0.444,6,24,0.25,21,23,0.913,87,2014-01-01,WAS,DAL
13349,49,Home,L 78-82 ,240,27,79,0.342,21,59,0.356,6,20,0.3,18,20,0.9,78,28,77,0.364,20,53,0.377,8,24,0.333,18,22,0.818,82,2014-01-05,CLE,IND
13350,50,@,L 78-103 ,240,34,97,0.351,32,78,0.41,2,19,0.105,8,12,0.667,78,40,82,0.488,34,62,0.548,6,20,0.3,17,20,0.85,103,2014-01-18,PHI,CHI
13351,51,@,L 78-93 ,240,30,74,0.405,23,50,0.46,7,24,0.292,11,14,0.786,78,37,88,0.42,33,74,0.446,4,14,0.286,15,23,0.652,93,2014-01-24,MIL,CLE
13352,52,@,L 78-123 ,240,27,100,0.27,24,72,0.333,3,28,0.107,21,25,0.84,78,50,89,0.562,41,61,0.672,9,28,0.321,14,17,0.824,123,2014-02-09,PHI,LAC
13353,53,@,L 78-102 ,240,29,88,0.33,25,61,0.41,4,27,0.148,16,19,0.842,78,35,79,0.443,22,50,0.44,13,29,0.448,19,21,0.905,102,2014-03-05,ATL,POR
13354,54,Home,L 78-110 ,240,30,79,0.38,27,55,0.491,3,24,0.125,15,21,0.714,78,43,79,0.544,35,60,0.583,8,19,0.421,16,22,0.727,110,2014-03-28,DET,MIA
13355,55,@,L 78-91 ,240,28,79,0.354,26,66,0.394,2,13,0.154,20,25,0.8,78,34,87,0.391,27,64,0.422,7,23,0.304,16,17,0.941,91,2014-03-28,IND,WAS
13356,56,Home,L 78-96 ,240,34,86,0.395,31,70,0.443,3,16,0.188,7,12,0.583,78,35,79,0.443,26,56,0.464,9,23,0.391,17,21,0.81,96,2014-04-05,WAS,CHI
13357,57,@,L 78-85 ,240,29,87,0.333,23,67,0.343,6,20,0.3,14,19,0.737,78,33,81,0.407,30,66,0.455,3,15,0.2,16,24,0.667,85,2014-11-11,OKC,MIL
13358,58,@,L 78-91 ,240,27,75,0.36,21,48,0.438,6,27,0.222,18,23,0.783,78,41,84,0.488,37,74,0.5,4,10,0.4,5,9,0.556,91,2014-11-21,CLE,WAS
13359,59,@,L 78-105 ,240,29,75,0.387,27,56,0.482,2,19,0.105,18,24,0.75,78,38,86,0.442,28,62,0.452,10,24,0.417,19,23,0.826,105,2014-11-28,NYK,OKC
13360,60,@,L 78-99 ,240,32,84,0.381,28,67,0.418,4,17,0.235,10,15,0.667,78,36,82,0.439,21,48,0.438,15,34,0.441,12,20,0.6,99,2014-12-31,NYK,LAC
13361,61,@,W 78-75 ,240,33,78,0.423,31,62,0.5,2,16,0.125,10,15,0.667,78,29,92,0.315,25,69,0.362,4,23,0.174,13,18,0.722,75,2015-01-13,MIA,LAL
13362,62,Home,W 78-76 ,240,27,80,0.338,23,61,0.377,4,19,0.211,20,30,0.667,78,29,84,0.345,24,66,0.364,5,18,0.278,13,15,0.867,76,2015-01-21,CHA,MIA
13363,63,Home,L 78-101 ,240,29,79,0.367,26,58,0.448,3,21,0.143,17,22,0.773,78,41,96,0.427,29,62,0.468,12,34,0.353,7,10,0.7,101,2015-02-05,SAC,DAL
13364,64,Home,L 78-106 ,240,29,81,0.358,20,57,0.351,9,24,0.375,11,14,0.786,78,37,83,0.446,32,64,0.5,5,19,0.263,27,30,0.9,106,2015-02-10,CHA,DET
13365,65,@,L 78-106 ,240,29,75,0.387,24,62,0.387,5,13,0.385,15,25,0.6,78,38,87,0.437,30,63,0.476,8,24,0.333,22,29,0.759,106,2015-03-09,NYK,DEN
13366,66,@,L 78-102 ,240,31,88,0.352,26,66,0.394,5,22,0.227,11,18,0.611,78,38,90,0.422,29,68,0.426,9,22,0.409,17,24,0.708,102,2015-04-01,DET,CHO
13367,67,Home,L 78-106 ,240,29,75,0.387,22,58,0.379,7,17,0.412,13,22,0.591,78,40,75,0.533,25,48,0.521,15,27,0.556,11,18,0.611,106,2015-04-05,LAL,LAC
13368,68,Home,L 78-89 ,240,34,88,0.386,29,70,0.414,5,18,0.278,5,7,0.714,78,35,91,0.385,29,68,0.426,6,23,0.261,13,17,0.765,89,2015-04-09,MIA,CHI
13369,69,@,L 78-117 ,240,31,79,0.392,28,57,0.491,3,22,0.136,13,19,0.684,78,46,84,0.548,36,60,0.6,10,24,0.417,15,22,0.682,117,2015-04-12,CLE,BOS
13370,70,Home,L 78-95 ,240,29,95,0.305,24,70,0.343,5,25,0.2,15,20,0.75,78,30,71,0.423,28,60,0.467,2,11,0.182,33,41,0.805,95,2015-10-30,DEN,MIN
13371,71,@,L 78-95 ,240,28,87,0.322,24,63,0.381,4,24,0.167,18,21,0.857,78,31,81,0.383,26,62,0.419,5,19,0.263,28,36,0.778,95,2015-11-23,NYK,MIA
13372,72,@,L 78-111 ,240,27,84,0.321,22,66,0.333,5,18,0.278,19,22,0.864,78,42,97,0.433,30,64,0.469,12,33,0.364,15,19,0.789,111,2015-11-27,WAS,BOS
13373,73,Home,L 78-97 ,240,32,85,0.376,29,71,0.408,3,14,0.214,11,15,0.733,78,33,76,0.434,26,59,0.441,7,17,0.412,24,28,0.857,97,2015-11-27,NYK,MIA
13374,74,Home,L 78-103 ,240,30,80,0.375,25,56,0.446,5,24,0.208,13,16,0.813,78,36,74,0.486,26,54,0.481,10,20,0.5,21,22,0.955,103,2015-12-12,ATL,SAS
13375,75,@,L 78-118 ,240,30,86,0.349,22,58,0.379,8,28,0.286,10,17,0.588,78,46,84,0.548,37,65,0.569,9,19,0.474,17,25,0.68,118,2015-12-19,LAL,OKC
13376,76,Home,L 78-91 ,240,28,72,0.389,21,44,0.477,7,28,0.25,15,24,0.625,78,35,91,0.385,32,76,0.421,3,15,0.2,18,26,0.692,91,2016-01-04,POR,MEM
13377,77,@,W 78-74 ,240,29,81,0.358,21,61,0.344,8,20,0.4,12,17,0.706,78,28,73,0.384,25,62,0.403,3,11,0.273,15,20,0.75,74,2016-01-06,DEN,MIN
13378,78,Home,L 78-91 ,240,35,84,0.417,31,65,0.477,4,19,0.211,4,8,0.5,78,36,77,0.468,31,60,0.517,5,17,0.294,14,20,0.7,91,2016-01-20,BRK,CLE
13379,79,@,L 78-91 ,240,27,74,0.365,22,51,0.431,5,23,0.217,19,24,0.792,78,31,78,0.397,23,49,0.469,8,29,0.276,21,23,0.913,91,2016-01-31,PHO,DAL
13380,80,Home,L 78-96 ,240,33,77,0.429,30,60,0.5,3,17,0.176,9,12,0.75,78,38,79,0.481,29,61,0.475,9,18,0.5,11,12,0.917,96,2016-02-25,UTA,SAS
13381,81,Home,L 78-88 ,240,29,71,0.408,25,50,0.5,4,21,0.19,16,18,0.889,78,32,83,0.386,18,43,0.419,14,40,0.35,10,17,0.588,88,2016-04-03,MIN,DAL
13382,82,@,L 78-113 ,240,29,86,0.337,22,56,0.393,7,30,0.233,13,14,0.929,78,40,80,0.5,28,55,0.509,12,25,0.48,21,25,0.84,113,2017-01-20,TOR,CHO
13383,83,@,L 77-92 ,240,24,81,0.296,17,58,0.293,7,23,0.304,22,26,0.846,77,36,77,0.468,26,50,0.52,10,27,0.37,10,13,0.769,92,2012-01-04,CLE,TOR
13384,84,@,L 77-102 ,240,25,77,0.325,23,58,0.397,2,19,0.105,25,35,0.714,77,37,79,0.468,30,59,0.508,7,20,0.35,21,25,0.84,102,2012-01-06,POR,PHO
13385,85,@,L 77-99 ,240,29,89,0.326,24,73,0.329,5,16,0.313,14,21,0.667,77,39,77,0.506,37,68,0.544,2,9,0.222,19,26,0.731,99,2012-01-07,CHA,IND
13386,86,Home,W 77-64 ,240,33,82,0.402,29,67,0.433,4,15,0.267,7,12,0.583,77,30,86,0.349,27,76,0.355,3,10,0.3,1,7,0.143,64,2012-01-14,CHI,TOR
13387,87,Home,L 77-84 ,240,28,68,0.412,28,59,0.475,0,9,0.0,21,28,0.75,77,34,72,0.472,28,52,0.538,6,20,0.3,10,15,0.667,84,2012-01-16,NOP,POR
13388,88,Home,L 77-100 ,240,27,73,0.37,23,53,0.434,4,20,0.2,19,23,0.826,77,41,80,0.513,34,62,0.548,7,18,0.389,11,13,0.846,100,2012-01-31,TOR,ATL
13389,89,Home,L 77-96 ,240,33,75,0.44,28,60,0.467,5,15,0.333,6,9,0.667,77,41,85,0.482,39,78,0.5,2,7,0.286,12,19,0.632,96,2012-02-02,ATL,MEM
13390,90,Home,L 77-78 ,240,29,71,0.408,25,56,0.446,4,15,0.267,15,23,0.652,77,33,85,0.388,31,66,0.47,2,19,0.105,10,15,0.667,78,2012-02-10,PHI,LAC
13391,91,Home,L 77-98 ,240,29,89,0.326,28,78,0.359,1,11,0.091,18,19,0.947,77,37,79,0.468,31,64,0.484,6,15,0.4,18,21,0.857,98,2012-02-12,DET,WAS
13392,92,@,L 77-97 ,240,30,73,0.411,23,46,0.5,7,27,0.259,10,13,0.769,77,38,81,0.469,29,59,0.492,9,22,0.409,12,16,0.75,97,2012-02-18,ATL,POR
13393,93,Home,L 77-79 ,240,32,78,0.41,28,61,0.459,4,17,0.235,9,14,0.643,77,28,76,0.368,25,63,0.397,3,13,0.231,20,27,0.741,79,2012-03-26,WAS,DET
13394,94,Home,L 77-98 ,240,32,80,0.4,27,63,0.429,5,17,0.294,8,9,0.889,77,38,81,0.469,29,65,0.446,9,16,0.563,13,20,0.65,98,2012-03-28,ATL,CHI
13395,95,@,L 77-92 ,240,27,72,0.375,22,50,0.44,5,22,0.227,18,29,0.621,77,36,81,0.444,27,61,0.443,9,20,0.45,11,16,0.688,92,2012-04-16,OKC,LAC
13396,96,@,L 77-116 ,240,27,78,0.346,20,57,0.351,7,21,0.333,16,21,0.762,77,45,75,0.6,37,57,0.649,8,18,0.444,18,20,0.9,116,2012-04-17,CLE,DET
13397,97,@,L 77-84 ,240,27,68,0.397,22,53,0.415,5,15,0.333,18,30,0.6,77,32,91,0.352,23,63,0.365,9,28,0.321,11,14,0.786,84,2012-04-26,NOP,HOU
13398,98,@,W 77-62 ,240,35,84,0.417,31,62,0.5,4,22,0.182,3,5,0.6,77,23,69,0.333,19,50,0.38,4,19,0.211,12,16,0.75,62,2012-11-07,PHI,NOH
13399,99,@,L 77-101 ,240,29,86,0.337,22,61,0.361,7,25,0.28,12,20,0.6,77,36,90,0.4,28,62,0.452,8,28,0.286,21,28,0.75,101,2012-11-09,GSW,LAL
13400,0,Home,L 77-79 ,240,24,76,0.316,18,48,0.375,6,28,0.214,23,43,0.535,77,29,79,0.367,25,60,0.417,4,19,0.211,17,27,0.63,79,2012-11-27,LAL,IND
13401,1,@,L 77-117 ,240,28,82,0.341,22,61,0.361,6,21,0.286,15,20,0.75,77,40,76,0.526,28,60,0.467,12,16,0.75,25,35,0.714,117,2012-11-28,PHO,DET
13402,2,@,L 77-92 ,240,29,85,0.341,24,64,0.375,5,21,0.238,14,18,0.778,77,38,93,0.409,27,68,0.397,11,25,0.44,5,8,0.625,92,2012-12-01,DET,DAL
13403,3,@,W 77-70 ,240,27,82,0.329,22,63,0.349,5,19,0.263,18,23,0.783,77,26,80,0.325,22,64,0.344,4,16,0.25,14,22,0.636,70,2012-12-11,WAS,NOH
13404,4,Home,L 77-88 ,240,32,83,0.386,29,70,0.414,3,13,0.231,10,15,0.667,77,35,72,0.486,28,48,0.583,7,24,0.292,11,16,0.688,88,2012-12-15,DET,IND
13405,5,@,L 77-93 ,240,29,75,0.387,27,56,0.482,2,19,0.105,17,22,0.773,77,37,74,0.5,33,54,0.611,4,20,0.2,15,19,0.789,93,2012-12-19,NOP,LAC
13406,6,Home,L 77-103 ,240,29,80,0.363,26,63,0.413,3,17,0.176,16,24,0.667,77,38,71,0.535,27,50,0.54,11,21,0.524,16,29,0.552,103,2012-12-23,PHO,LAC
13407,7,@,L 77-106 ,240,29,72,0.403,23,56,0.411,6,16,0.375,13,15,0.867,77,41,85,0.482,29,55,0.527,12,30,0.4,12,24,0.5,106,2012-12-27,BOS,LAC
13408,8,@,L 77-87 ,240,31,85,0.365,28,75,0.373,3,10,0.3,12,18,0.667,77,34,87,0.391,27,71,0.38,7,16,0.438,12,18,0.667,87,2012-12-29,WAS,CHI
13409,9,@,L 77-87 ,240,28,68,0.412,20,49,0.408,8,19,0.421,13,18,0.722,77,33,91,0.363,24,69,0.348,9,22,0.409,12,19,0.632,87,2013-01-08,MIA,IND
13410,10,Home,L 77-90 ,240,30,84,0.357,26,65,0.4,4,19,0.211,13,20,0.65,77,35,77,0.455,30,64,0.469,5,13,0.385,15,23,0.652,90,2013-01-17,MIN,LAC
13411,11,@,L 77-101 ,240,29,71,0.408,26,54,0.481,3,17,0.176,16,25,0.64,77,47,90,0.522,43,81,0.531,4,9,0.444,3,8,0.375,101,2013-01-25,BRK,MEM
13412,12,@,L 77-97 ,240,32,79,0.405,26,52,0.5,6,27,0.222,7,9,0.778,77,37,74,0.5,24,45,0.533,13,29,0.448,10,12,0.833,97,2013-01-28,ORL,BRK
13413,13,@,L 77-86 ,240,29,79,0.367,22,59,0.373,7,20,0.35,12,16,0.75,77,35,81,0.432,31,66,0.47,4,15,0.267,12,17,0.706,86,2013-02-01,POR,UTA
13414,14,@,L 77-101 ,240,26,82,0.317,21,66,0.318,5,16,0.313,20,28,0.714,77,41,95,0.432,35,76,0.461,6,19,0.316,13,19,0.684,101,2013-02-13,CHA,IND
13415,15,Home,L 77-87 ,240,32,74,0.432,25,54,0.463,7,20,0.35,6,10,0.6,77,31,75,0.413,18,40,0.45,13,35,0.371,12,15,0.8,87,2013-03-06,DET,NYK
13416,16,Home,L 77-100 ,240,32,88,0.364,30,70,0.429,2,18,0.111,11,14,0.786,77,42,92,0.457,34,71,0.479,8,21,0.381,8,10,0.8,100,2013-03-10,MIN,DAL
13417,17,@,L 77-92 ,240,29,86,0.337,23,62,0.371,6,24,0.25,13,18,0.722,77,40,82,0.488,35,66,0.53,5,16,0.313,7,11,0.636,92,2013-03-18,MIN,MEM
13418,18,@,L 77-109 ,240,30,89,0.337,25,64,0.391,5,25,0.2,12,18,0.667,77,38,76,0.5,25,46,0.543,13,30,0.433,20,23,0.87,109,2013-03-24,CHA,MIA
13419,19,@,L 77-91 ,240,31,85,0.365,26,69,0.377,5,16,0.313,10,15,0.667,77,38,86,0.442,30,65,0.462,8,21,0.381,7,11,0.636,91,2013-04-14,CLE,PHI
13420,20,@,L 77-93 ,240,30,73,0.411,23,52,0.442,7,21,0.333,10,15,0.667,77,37,79,0.468,30,52,0.577,7,27,0.259,12,15,0.8,93,2013-04-16,POR,LAC
13421,21,@,L 77-87 ,240,31,74,0.419,28,58,0.483,3,16,0.188,12,12,1.0,77,34,76,0.447,32,63,0.508,2,13,0.154,17,29,0.586,87,2013-11-03,BOS,DET
13422,22,@,L 77-104 ,240,30,88,0.341,22,72,0.306,8,16,0.5,9,11,0.818,77,40,79,0.506,35,63,0.556,5,16,0.313,19,21,0.905,104,2013-11-15,MIL,IND
13423,23,Home,L 77-109 ,240,29,84,0.345,27,69,0.391,2,15,0.133,17,23,0.739,77,46,88,0.523,42,71,0.592,4,17,0.235,13,17,0.765,109,2013-12-11,MIL,SAS
13424,24,Home,L 77-99 ,240,31,86,0.36,25,68,0.368,6,18,0.333,9,12,0.75,77,40,83,0.482,35,68,0.515,5,15,0.333,14,18,0.778,99,2013-12-14,CHI,TOR
13425,25,Home,L 77-82 ,240,31,82,0.378,25,62,0.403,6,20,0.3,9,12,0.75,77,33,82,0.402,28,62,0.452,5,20,0.25,11,18,0.611,82,2014-01-15,MIL,MEM
13426,26,@,L 77-88 ,240,29,82,0.354,27,61,0.443,2,21,0.095,17,23,0.739,77,33,82,0.402,29,62,0.468,4,20,0.2,18,25,0.72,88,2014-01-29,NOP,MIN
13427,27,@,L 77-86 ,240,32,81,0.395,30,65,0.462,2,16,0.125,11,15,0.733,77,34,76,0.447,30,58,0.517,4,18,0.222,14,23,0.609,86,2014-02-03,MEM,OKC
13428,28,Home,L 77-85 ,240,31,75,0.413,29,62,0.468,2,13,0.154,13,14,0.929,77,35,78,0.449,30,70,0.429,5,8,0.625,10,18,0.556,85,2014-03-07,CHI,MEM
13429,29,Home,L 77-103 ,240,31,83,0.373,25,60,0.417,6,23,0.261,9,19,0.474,77,38,70,0.543,34,55,0.618,4,15,0.267,23,32,0.719,103,2014-03-15,PHI,MEM
13430,30,@,L 77-89 ,240,27,73,0.37,23,63,0.365,4,10,0.4,19,21,0.905,77,35,84,0.417,31,69,0.449,4,15,0.267,15,16,0.938,89,2014-03-24,IND,CHI
13431,31,Home,L 77-103 ,240,26,69,0.377,20,55,0.364,6,14,0.429,19,24,0.792,77,37,80,0.463,29,63,0.46,8,17,0.471,21,25,0.84,103,2014-03-31,IND,SAS
13432,32,@,L 77-96 ,240,32,73,0.438,28,55,0.509,4,18,0.222,9,9,1.0,77,39,77,0.506,30,51,0.588,9,26,0.346,9,14,0.643,96,2014-04-02,MIL,MIA
13433,33,Home,L 77-95 ,240,24,78,0.308,21,60,0.35,3,18,0.167,26,35,0.743,77,33,75,0.44,27,48,0.563,6,27,0.222,23,32,0.719,95,2014-10-29,SAC,GSW
13434,34,Home,L 77-85 ,240,30,84,0.357,27,67,0.403,3,17,0.176,14,17,0.824,77,32,82,0.39,27,58,0.466,5,24,0.208,16,25,0.64,85,2014-12-03,MIN,PHI
13435,35,Home,L 77-107 ,240,31,76,0.408,27,53,0.509,4,23,0.174,11,14,0.786,77,40,79,0.506,32,60,0.533,8,19,0.421,19,23,0.826,107,2014-12-26,ATL,MIL
13436,36,Home,L 77-97 ,240,28,84,0.333,22,64,0.344,6,20,0.3,15,20,0.75,77,37,78,0.474,32,62,0.516,5,16,0.313,18,24,0.75,97,2015-01-07,CHI,UTA
13437,37,Home,L 77-97 ,240,25,83,0.301,23,58,0.397,2,25,0.08,25,29,0.862,77,41,76,0.539,33,59,0.559,8,17,0.471,7,11,0.636,97,2015-01-07,PHI,MIL
13438,38,@,L 77-114 ,240,26,77,0.338,22,59,0.373,4,18,0.222,21,31,0.677,77,44,87,0.506,35,67,0.522,9,20,0.45,17,23,0.739,114,2015-02-07,BRK,WAS
13439,39,@,L 77-97 ,240,33,87,0.379,29,69,0.42,4,18,0.222,7,8,0.875,77,35,81,0.432,31,68,0.456,4,13,0.308,23,28,0.821,97,2015-02-25,WAS,MIN
13440,40,Home,L 77-107 ,240,31,82,0.378,26,68,0.382,5,14,0.357,10,17,0.588,77,43,88,0.489,33,62,0.532,10,26,0.385,11,11,1.0,107,2015-04-03,LAL,POR
13441,41,@,L 77-116 ,240,27,79,0.342,23,64,0.359,4,15,0.267,19,29,0.655,77,41,81,0.506,25,53,0.472,16,28,0.571,18,23,0.783,116,2015-04-12,CHA,DET
13442,42,@,L 77-111 ,240,31,83,0.373,28,62,0.452,3,21,0.143,12,16,0.75,77,45,92,0.489,33,57,0.579,12,35,0.343,9,15,0.6,111,2015-11-24,LAL,GSW
13443,43,Home,L 77-89 ,240,28,87,0.322,19,55,0.345,9,32,0.281,12,14,0.857,77,36,78,0.462,28,55,0.509,8,23,0.348,9,10,0.9,89,2015-12-15,BOS,CLE
13444,44,@,L 77-97 ,240,32,89,0.36,26,62,0.419,6,27,0.222,7,9,0.778,77,38,84,0.452,30,62,0.484,8,22,0.364,13,17,0.765,97,2016-01-03,PHO,LAL
13445,45,Home,L 77-83 ,240,29,73,0.397,22,51,0.431,7,22,0.318,12,20,0.6,77,33,83,0.398,20,55,0.364,13,28,0.464,4,6,0.667,83,2016-01-08,BRK,ORL
13446,46,Home,L 77-83 ,240,31,86,0.36,29,67,0.433,2,19,0.105,13,15,0.867,77,30,77,0.39,22,55,0.4,8,22,0.364,15,17,0.882,83,2016-01-15,CHI,DAL
13447,47,Home,L 77-91 ,240,26,74,0.351,20,49,0.408,6,25,0.24,19,29,0.655,77,34,87,0.391,26,52,0.5,8,35,0.229,15,23,0.652,91,2016-01-15,HOU,CLE
13448,48,Home,L 77-106 ,240,29,85,0.341,24,58,0.414,5,27,0.185,14,20,0.7,77,37,68,0.544,24,40,0.6,13,28,0.464,19,26,0.731,106,2016-03-04,LAL,ATL
13449,49,@,L 77-93 ,240,32,84,0.381,27,57,0.474,5,27,0.185,8,11,0.727,77,34,78,0.436,25,53,0.472,9,25,0.36,16,18,0.889,93,2016-11-14,DAL,NYK
13450,50,Home,L 77-85 ,240,30,78,0.385,25,53,0.472,5,25,0.2,12,14,0.857,77,33,90,0.367,28,73,0.384,5,17,0.294,14,16,0.875,85,2016-11-17,UTA,CHI
13451,51,@,L 77-87 ,240,34,89,0.382,30,62,0.484,4,27,0.148,5,8,0.625,77,30,88,0.341,24,67,0.358,6,21,0.286,21,29,0.724,87,2016-12-07,DET,CHO
13452,52,@,L 77-110 ,240,30,76,0.395,24,59,0.407,6,17,0.353,11,16,0.688,77,43,80,0.538,27,49,0.551,16,31,0.516,8,13,0.615,110,2017-01-13,DET,UTA
13453,53,Home,W 76-74 ,240,26,77,0.338,22,60,0.367,4,17,0.235,20,26,0.769,76,28,80,0.35,24,65,0.369,4,15,0.267,14,25,0.56,74,2012-01-03,CHI,ATL
13454,54,@,L 76-102 ,240,29,78,0.372,24,54,0.444,5,24,0.208,13,16,0.813,76,39,75,0.52,29,53,0.547,10,22,0.455,14,18,0.778,102,2012-01-13,MIL,DAL
13455,55,@,L 76-90 ,240,32,74,0.432,27,59,0.458,5,15,0.333,7,8,0.875,76,35,84,0.417,31,67,0.463,4,17,0.235,16,19,0.842,90,2012-01-20,ATL,PHI
13456,56,@,L 76-103 ,240,32,88,0.364,31,80,0.388,1,8,0.125,11,16,0.688,76,38,90,0.422,33,75,0.44,5,15,0.333,22,30,0.733,103,2012-01-27,WAS,HOU
13457,57,@,L 76-89 ,240,31,85,0.365,23,70,0.329,8,15,0.533,6,8,0.75,76,31,78,0.397,25,66,0.379,6,12,0.5,21,29,0.724,89,2012-02-21,PHI,MEM
13458,58,Home,L 76-79 ,240,29,75,0.387,24,60,0.4,5,15,0.333,13,19,0.684,76,29,74,0.392,23,58,0.397,6,16,0.375,15,17,0.882,79,2012-03-19,ATL,BOS
13459,59,@,L 76-88 ,240,30,87,0.345,27,73,0.37,3,14,0.214,13,19,0.684,76,34,70,0.486,31,60,0.517,3,10,0.3,17,18,0.944,88,2012-03-25,WAS,BOS
13460,60,@,L 76-93 ,240,35,85,0.412,34,76,0.447,1,9,0.111,5,11,0.455,76,37,81,0.457,30,53,0.566,7,28,0.25,12,18,0.667,93,2012-03-25,PHI,SAS
13461,61,@,L 76-97 ,240,30,82,0.366,27,68,0.397,3,14,0.214,13,17,0.765,76,42,87,0.483,35,70,0.5,7,17,0.412,6,6,1.0,97,2012-03-30,PHI,WAS
13462,62,Home,W 76-73 ,240,26,71,0.366,24,56,0.429,2,15,0.133,22,35,0.629,76,29,77,0.377,25,64,0.391,4,13,0.308,11,16,0.688,73,2012-04-22,DET,TOR
13463,63,@,L 76-88 ,240,30,73,0.411,23,47,0.489,7,26,0.269,9,15,0.6,76,34,72,0.472,32,60,0.533,2,12,0.167,18,22,0.818,88,2012-04-26,ORL,MEM
13464,64,@,L 76-89 ,240,30,72,0.417,21,47,0.447,9,25,0.36,7,16,0.438,76,38,82,0.463,33,67,0.493,5,15,0.333,8,8,1.0,89,2012-11-11,ATL,LAC
13465,65,@,L 76-92 ,240,25,84,0.298,20,53,0.377,5,31,0.161,21,32,0.656,76,31,78,0.397,28,65,0.431,3,13,0.231,27,32,0.844,92,2012-11-13,WAS,CHA
13466,66,Home,L 76-94 ,240,25,84,0.298,20,68,0.294,5,16,0.313,21,32,0.656,76,35,73,0.479,32,66,0.485,3,7,0.429,21,31,0.677,94,2012-11-14,PHI,DET
13467,67,Home,L 76-83 ,240,31,85,0.365,26,69,0.377,5,16,0.313,9,12,0.75,76,31,82,0.378,29,73,0.397,2,9,0.222,19,27,0.704,83,2012-11-17,WAS,UTA
13468,68,@,L 76-88 ,240,28,71,0.394,20,51,0.392,8,20,0.4,12,18,0.667,76,33,90,0.367,26,65,0.4,7,25,0.28,15,19,0.789,88,2012-11-18,IND,NYK
13469,69,@,L 76-86 ,240,29,72,0.403,25,55,0.455,4,17,0.235,14,22,0.636,76,34,73,0.466,29,60,0.483,5,13,0.385,13,19,0.684,86,2012-11-23,LAC,BRK
13470,70,Home,L 76-80 ,240,28,73,0.384,24,61,0.393,4,12,0.333,16,20,0.8,76,29,80,0.363,27,70,0.386,2,10,0.2,20,27,0.741,80,2012-12-04,CHI,IND
13471,71,Home,L 76-88 ,240,29,71,0.408,22,51,0.431,7,20,0.35,11,19,0.579,76,35,78,0.449,30,56,0.536,5,22,0.227,13,17,0.765,88,2012-12-17,DET,LAC
13472,72,Home,L 76-93 ,240,26,64,0.406,19,44,0.432,7,20,0.35,17,29,0.586,76,38,77,0.494,32,67,0.478,6,10,0.6,11,13,0.846,93,2012-12-25,BRK,BOS
13473,73,@,L 76-81 ,240,31,89,0.348,27,69,0.391,4,20,0.2,10,13,0.769,76,31,79,0.392,26,58,0.448,5,21,0.238,14,16,0.875,81,2013-01-10,NYK,IND
13474,74,Home,L 76-103 ,240,25,72,0.347,22,63,0.349,3,9,0.333,23,30,0.767,76,36,87,0.414,28,65,0.431,8,22,0.364,23,28,0.821,103,2013-01-15,CHA,IND
13475,75,@,L 76-85 ,240,34,83,0.41,29,63,0.46,5,20,0.25,3,3,1.0,76,35,78,0.449,34,71,0.479,1,7,0.143,14,17,0.824,85,2013-02-01,WAS,MEM
13476,76,Home,L 76-93 ,240,31,79,0.392,25,60,0.417,6,19,0.316,8,15,0.533,76,38,93,0.409,30,73,0.411,8,20,0.4,9,13,0.692,93,2013-02-02,ATL,CHI
13477,77,Home,L 76-86 ,240,30,87,0.345,24,67,0.358,6,20,0.3,10,14,0.714,76,33,82,0.402,27,64,0.422,6,18,0.333,14,22,0.636,86,2013-02-06,ORL,LAC
13478,78,@,L 76-87 ,240,27,88,0.307,25,72,0.347,2,16,0.125,20,23,0.87,76,39,93,0.419,37,77,0.481,2,16,0.125,7,10,0.7,87,2013-02-09,CHA,PHI
13479,79,Home,L 76-108 ,240,34,82,0.415,31,68,0.456,3,14,0.214,5,9,0.556,76,41,92,0.446,31,58,0.534,10,34,0.294,16,23,0.696,108,2013-02-13,ORL,ATL
13480,80,@,W 76-72 ,240,32,71,0.451,30,64,0.469,2,7,0.286,10,12,0.833,76,29,77,0.377,20,56,0.357,9,21,0.429,5,13,0.385,72,2013-02-24,MEM,BRK
13481,81,@,L 76-99 ,240,29,87,0.333,24,65,0.369,5,22,0.227,13,16,0.813,76,42,87,0.483,34,67,0.507,8,20,0.4,7,15,0.467,99,2013-03-18,LAL,PHO
13482,82,Home,L 76-94 ,240,33,80,0.413,29,51,0.569,4,29,0.138,6,10,0.6,76,34,67,0.507,30,55,0.545,4,12,0.333,22,28,0.786,94,2013-04-03,POR,MEM
13483,83,Home,W 76-74 ,240,31,79,0.392,26,60,0.433,5,19,0.263,9,18,0.5,76,29,71,0.408,21,51,0.412,8,20,0.4,8,10,0.8,74,2013-11-08,SAS,GSW
13484,84,@,L 76-92 ,240,28,84,0.333,23,67,0.343,5,17,0.294,15,20,0.75,76,35,79,0.443,32,64,0.5,3,15,0.2,19,31,0.613,92,2013-11-29,MIL,CHA
13485,85,@,L 76-91 ,240,29,80,0.363,28,68,0.412,1,12,0.083,17,23,0.739,76,34,77,0.442,29,52,0.558,5,25,0.2,18,22,0.818,91,2013-12-31,CLE,IND
13486,86,Home,L 76-79 ,240,30,70,0.429,22,50,0.44,8,20,0.4,8,15,0.533,76,37,90,0.411,33,78,0.423,4,12,0.333,1,1,1.0,79,2014-02-08,ATL,MEM
13487,87,@,L 76-92 ,240,26,67,0.388,21,50,0.42,5,17,0.294,19,28,0.679,76,35,70,0.5,31,56,0.554,4,14,0.286,18,21,0.857,92,2014-02-13,BRK,CHI
13488,88,@,L 76-108 ,240,28,85,0.329,25,63,0.397,3,22,0.136,17,19,0.895,76,38,81,0.469,29,56,0.518,9,25,0.36,23,32,0.719,108,2014-03-01,NOP,LAC
13489,89,@,L 76-90 ,240,29,78,0.372,21,56,0.375,8,22,0.364,10,16,0.625,76,34,76,0.447,29,62,0.468,5,14,0.357,17,21,0.81,90,2014-03-30,IND,CLE
13490,90,Home,W 76-73 ,240,30,82,0.366,28,66,0.424,2,16,0.125,14,19,0.737,76,27,88,0.307,20,65,0.308,7,23,0.304,12,17,0.706,73,2014-12-20,DEN,IND
13491,91,@,L 76-111 ,240,28,85,0.329,22,61,0.361,6,24,0.25,14,23,0.609,76,45,81,0.556,38,68,0.559,7,13,0.538,14,18,0.778,111,2015-01-19,PHI,WAS
13492,92,@,L 76-78 ,240,29,84,0.345,24,66,0.364,5,18,0.278,13,15,0.867,76,27,80,0.338,23,61,0.377,4,19,0.211,20,30,0.667,78,2015-01-21,MIA,CHO
13493,93,Home,W 76-71 ,240,25,76,0.329,23,69,0.333,2,7,0.286,24,37,0.649,76,28,79,0.354,22,64,0.344,6,15,0.4,9,18,0.5,71,2015-01-24,CHA,NYK
13494,94,@,L 76-92 ,240,26,72,0.361,22,50,0.44,4,22,0.182,20,22,0.909,76,37,83,0.446,27,58,0.466,10,25,0.4,8,17,0.471,92,2015-02-20,POR,UTA
13495,95,@,L 76-98 ,240,25,77,0.325,21,59,0.356,4,18,0.222,22,28,0.786,76,35,84,0.417,29,55,0.527,6,29,0.207,22,31,0.71,98,2015-02-21,TOR,HOU
13496,96,@,L 76-89 ,240,31,83,0.373,29,75,0.387,2,8,0.25,12,21,0.571,76,35,79,0.443,24,48,0.5,11,31,0.355,8,15,0.533,89,2015-03-09,MIN,LAC
13497,97,@,L 76-107 ,240,27,81,0.333,24,70,0.343,3,11,0.273,19,26,0.731,76,39,95,0.411,26,62,0.419,13,33,0.394,16,21,0.762,107,2015-03-23,WAS,GSW
13498,98,@,L 76-94 ,240,31,82,0.378,27,64,0.422,4,18,0.222,10,15,0.667,76,37,84,0.44,28,58,0.483,9,26,0.346,11,14,0.786,94,2015-03-27,DAL,SAS
13499,99,Home,L 76-106 ,240,29,82,0.354,27,66,0.409,2,16,0.125,16,22,0.727,76,41,84,0.488,28,55,0.509,13,29,0.448,11,17,0.647,106,2015-10-28,MEM,CLE
13500,0,Home,L 76-97 ,240,28,70,0.4,24,53,0.453,4,17,0.235,16,21,0.762,76,39,88,0.443,33,73,0.452,6,15,0.4,13,18,0.722,97,2015-10-31,IND,UTA
13501,1,@,L 76-96 ,240,28,71,0.394,25,52,0.481,3,19,0.158,17,22,0.773,76,35,83,0.422,27,63,0.429,8,20,0.4,18,25,0.72,96,2015-11-08,TOR,MIA
13502,2,Home,L 76-111 ,240,28,72,0.389,22,50,0.44,6,22,0.273,14,20,0.7,76,41,72,0.569,30,51,0.588,11,21,0.524,18,27,0.667,111,2015-12-11,ORL,CLE
13503,3,@,L 76-96 ,240,28,84,0.333,18,56,0.321,10,28,0.357,10,14,0.714,76,32,78,0.41,25,56,0.446,7,22,0.318,25,34,0.735,96,2015-12-13,PHI,TOR
13504,4,@,L 76-105 ,240,28,77,0.364,17,46,0.37,11,31,0.355,9,15,0.6,76,41,89,0.461,32,67,0.478,9,22,0.409,14,19,0.737,105,2015-12-26,CLE,POR
13505,5,@,L 76-87 ,240,27,81,0.333,20,49,0.408,7,32,0.219,15,23,0.652,76,38,77,0.494,30,60,0.5,8,17,0.471,3,5,0.6,87,2016-02-28,CHA,ATL
13506,6,Home,L 75-114 ,240,27,89,0.303,20,75,0.267,7,14,0.5,14,19,0.737,75,46,83,0.554,40,74,0.541,6,9,0.667,16,17,0.941,114,2012-01-20,CLE,CHI
13507,7,@,L 75-92 ,240,28,78,0.359,27,69,0.391,1,9,0.111,18,25,0.72,75,39,83,0.47,36,73,0.493,3,10,0.3,11,16,0.688,92,2012-01-25,CHA,WAS
13508,8,Home,L 75-82 ,240,29,86,0.337,28,72,0.389,1,14,0.071,16,19,0.842,75,31,81,0.383,26,67,0.388,5,14,0.357,15,18,0.833,82,2012-02-17,PHI,DAL
13509,9,@,L 75-83 ,240,29,80,0.363,25,61,0.41,4,19,0.211,13,19,0.684,75,29,78,0.372,25,68,0.368,4,10,0.4,21,24,0.875,83,2012-03-04,GSW,TOR
13510,10,@,L 75-92 ,240,20,64,0.313,15,42,0.357,5,22,0.227,30,38,0.789,75,40,82,0.488,36,71,0.507,4,11,0.364,8,15,0.533,92,2012-03-13,POR,IND
13511,11,Home,L 75-87 ,240,30,87,0.345,25,70,0.357,5,17,0.294,10,12,0.833,75,35,83,0.422,28,68,0.412,7,15,0.467,10,16,0.625,87,2012-03-28,CLE,DET
13512,12,@,L 75-91 ,240,28,72,0.389,26,59,0.441,2,13,0.154,17,27,0.63,75,30,76,0.395,21,48,0.438,9,28,0.321,22,32,0.688,91,2012-03-31,CLE,NYK
13513,13,@,L 75-92 ,240,32,77,0.416,28,68,0.412,4,9,0.444,7,9,0.778,75,35,71,0.493,32,56,0.571,3,15,0.2,19,21,0.905,92,2012-04-01,NOP,PHO
13514,14,Home,L 75-94 ,240,30,77,0.39,25,54,0.463,5,23,0.217,10,17,0.588,75,39,83,0.47,28,51,0.549,11,32,0.344,5,12,0.417,94,2012-04-02,DAL,LAC
13515,15,@,L 75-98 ,240,28,75,0.373,25,56,0.446,3,19,0.158,16,23,0.696,75,36,83,0.434,29,60,0.483,7,23,0.304,19,29,0.655,98,2012-04-08,DET,MIA
13516,16,@,L 75-91 ,240,29,78,0.372,23,62,0.371,6,16,0.375,11,16,0.688,75,30,72,0.417,20,49,0.408,10,23,0.435,21,26,0.808,91,2012-04-08,TOR,OKC
13517,17,Home,L 75-93 ,240,29,80,0.363,22,62,0.355,7,18,0.389,10,12,0.833,75,41,77,0.532,40,67,0.597,1,10,0.1,10,16,0.625,93,2012-04-11,TOR,PHI
13518,18,@,L 75-88 ,240,25,70,0.357,20,52,0.385,5,18,0.278,20,25,0.8,75,32,73,0.438,29,60,0.483,3,13,0.231,21,21,1.0,88,2012-04-15,MEM,NOH
13519,19,@,W 75-67 ,240,26,77,0.338,25,66,0.379,1,11,0.091,22,25,0.88,75,23,76,0.303,22,60,0.367,1,16,0.063,20,30,0.667,67,2012-04-16,NOP,CHA
13520,20,@,L 75-107 ,240,28,87,0.322,26,74,0.351,2,13,0.154,17,26,0.654,75,45,85,0.529,40,69,0.58,5,16,0.313,12,17,0.706,107,2012-04-26,CLE,CHI
13521,21,@,L 75-84 ,240,33,88,0.375,29,70,0.414,4,18,0.222,5,11,0.455,75,30,85,0.353,23,60,0.383,7,25,0.28,17,21,0.81,84,2012-10-31,DEN,PHI
13522,22,@,L 75-90 ,240,28,80,0.35,25,68,0.368,3,12,0.25,16,20,0.8,75,34,76,0.447,27,56,0.482,7,20,0.35,15,22,0.682,90,2012-11-07,ORL,MIN
13523,23,@,L 75-92 ,240,32,76,0.421,27,62,0.435,5,14,0.357,6,8,0.75,75,38,77,0.494,31,58,0.534,7,19,0.368,9,10,0.9,92,2012-12-22,CHI,ATL
13524,24,Home,L 75-81 ,240,33,82,0.402,29,71,0.408,4,11,0.364,5,7,0.714,75,33,77,0.429,29,60,0.483,4,17,0.235,11,18,0.611,81,2012-12-22,NOP,IND
13525,25,@,L 75-94 ,240,27,85,0.318,23,68,0.338,4,17,0.235,17,28,0.607,75,40,89,0.449,36,80,0.45,4,9,0.444,10,18,0.556,94,2013-01-04,IND,BOS
13526,26,Home,L 75-92 ,240,29,80,0.363,26,68,0.382,3,12,0.25,14,18,0.778,75,36,90,0.4,28,61,0.459,8,29,0.276,12,18,0.667,92,2013-01-16,GSW,MIA
13527,27,Home,L 75-105 ,240,25,75,0.333,21,59,0.356,4,16,0.25,21,35,0.6,75,42,83,0.506,37,69,0.536,5,14,0.357,16,20,0.8,105,2013-02-22,CHA,CHI
13528,28,@,L 75-114 ,240,28,86,0.326,22,67,0.328,6,19,0.316,13,18,0.722,75,45,89,0.506,36,69,0.522,9,20,0.45,15,20,0.75,114,2013-03-03,DET,SAS
13529,29,Home,L 75-97 ,240,27,72,0.375,25,51,0.49,2,21,0.095,19,24,0.792,75,37,78,0.474,33,66,0.5,4,12,0.333,19,23,0.826,97,2013-04-05,IND,OKC
13530,30,@,L 75-94 ,240,30,80,0.375,28,66,0.424,2,14,0.143,13,18,0.722,75,39,82,0.476,36,69,0.522,3,13,0.231,13,20,0.65,94,2013-04-09,CHA,MEM
13531,31,Home,L 75-92 ,240,30,90,0.333,27,72,0.375,3,18,0.167,12,15,0.8,75,34,80,0.425,22,61,0.361,12,19,0.632,12,15,0.8,92,2013-12-07,CHI,DET
13532,32,@,W 75-74 ,240,30,73,0.411,23,52,0.442,7,21,0.333,8,14,0.571,75,32,89,0.36,27,65,0.415,5,24,0.208,5,9,0.556,74,2013-12-09,DEN,WAS
13533,33,Home,L 75-91 ,240,29,93,0.312,25,73,0.342,4,20,0.2,13,16,0.813,75,37,78,0.474,32,65,0.492,5,13,0.385,12,19,0.632,91,2014-02-04,GSW,CHA
13534,34,Home,L 75-81 ,240,29,68,0.426,20,48,0.417,9,20,0.45,8,18,0.444,75,30,80,0.375,22,54,0.407,8,26,0.308,13,15,0.867,81,2014-11-12,MIA,IND
13535,35,@,L 75-100 ,240,27,83,0.325,23,57,0.404,4,26,0.154,17,24,0.708,75,36,81,0.444,26,55,0.473,10,26,0.385,18,21,0.857,100,2014-11-17,PHI,SAS
13536,36,@,L 75-105 ,240,29,88,0.33,24,65,0.369,5,23,0.217,12,16,0.75,75,40,75,0.533,28,52,0.538,12,23,0.522,13,16,0.813,105,2014-11-29,CHA,ATL
13537,37,Home,L 75-98 ,240,30,80,0.375,27,62,0.435,3,18,0.167,12,19,0.632,75,35,81,0.432,22,47,0.468,13,34,0.382,15,24,0.625,98,2014-12-05,BRK,ATL
13538,38,Home,L 75-93 ,240,28,80,0.35,24,58,0.414,4,22,0.182,15,18,0.833,75,33,71,0.465,24,53,0.453,9,18,0.5,18,21,0.857,93,2014-12-14,MIA,CHI
13539,39,@,L 75-98 ,240,25,87,0.287,20,63,0.317,5,24,0.208,20,26,0.769,75,36,88,0.409,28,61,0.459,8,27,0.296,18,21,0.857,98,2014-12-26,CHA,OKC
13540,40,Home,L 75-78 ,240,29,92,0.315,25,69,0.362,4,23,0.174,13,18,0.722,75,33,78,0.423,31,62,0.5,2,16,0.125,10,15,0.667,78,2015-01-13,LAL,MIA
13541,41,Home,L 75-98 ,240,31,89,0.348,29,74,0.392,2,15,0.133,11,15,0.733,75,39,76,0.513,28,49,0.571,11,27,0.407,9,14,0.643,98,2015-01-21,MIN,DAL
13542,42,Home,L 75-83 ,240,30,81,0.37,26,62,0.419,4,19,0.211,11,18,0.611,75,32,77,0.416,28,56,0.5,4,21,0.19,15,21,0.714,83,2015-02-01,BOS,MIA
13543,43,Home,L 75-82 ,240,25,78,0.321,18,51,0.353,7,27,0.259,18,22,0.818,75,33,80,0.413,26,64,0.406,7,16,0.438,9,17,0.529,82,2015-02-02,TOR,MIL
13544,44,@,L 75-82 ,240,29,74,0.392,24,59,0.407,5,15,0.333,12,14,0.857,75,29,76,0.382,23,54,0.426,6,22,0.273,18,23,0.783,82,2015-02-28,MIL,UTA
13545,45,@,L 75-94 ,240,33,88,0.375,31,72,0.431,2,16,0.125,7,8,0.875,75,34,82,0.415,27,60,0.45,7,22,0.318,19,21,0.905,94,2015-03-05,DAL,POR
13546,46,@,L 75-93 ,240,32,81,0.395,29,63,0.46,3,18,0.167,8,15,0.533,75,40,90,0.444,34,72,0.472,6,18,0.333,7,13,0.538,93,2015-03-22,MIA,OKC
13547,47,@,L 75-90 ,240,30,85,0.353,23,60,0.383,7,25,0.28,8,10,0.8,75,37,84,0.44,32,65,0.492,5,19,0.263,11,19,0.579,90,2015-04-10,PHO,NOP
13548,48,@,L 75-102 ,240,31,77,0.403,26,61,0.426,5,16,0.313,8,15,0.533,75,40,86,0.465,31,64,0.484,9,22,0.409,13,13,1.0,102,2015-10-30,BRK,SAS
13549,49,Home,L 75-97 ,240,31,91,0.341,27,61,0.443,4,30,0.133,9,13,0.692,75,39,86,0.453,30,63,0.476,9,23,0.391,10,12,0.833,97,2016-01-03,WAS,MIA
13550,50,@,L 75-104 ,240,33,87,0.379,28,63,0.444,5,24,0.208,4,7,0.571,75,40,85,0.471,25,55,0.455,15,30,0.5,9,10,0.9,104,2016-03-13,IND,ATL
13551,51,@,L 75-91 ,240,31,80,0.388,27,62,0.435,4,18,0.222,9,14,0.643,75,35,81,0.432,25,55,0.455,10,26,0.385,11,13,0.846,91,2016-03-21,PHI,IND
13552,52,@,L 75-123 ,240,26,85,0.306,19,65,0.292,7,20,0.35,16,22,0.727,75,46,89,0.517,29,57,0.509,17,32,0.531,14,19,0.737,123,2016-03-28,LAL,UTA
13553,53,@,L 75-88 ,240,29,73,0.397,22,54,0.407,7,19,0.368,10,13,0.769,75,34,83,0.41,28,56,0.5,6,27,0.222,14,20,0.7,88,2016-10-30,UTA,LAC
13554,54,@,L 75-86 (OT),265,30,82,0.366,24,53,0.453,6,29,0.207,9,12,0.75,75,33,88,0.375,24,50,0.48,9,38,0.237,11,12,0.917,86,2016-11-06,MIL,DAL
13555,55,@,L 74-76 ,240,28,80,0.35,24,65,0.369,4,15,0.267,14,25,0.56,74,26,77,0.338,22,60,0.367,4,17,0.235,20,26,0.769,76,2012-01-03,ATL,CHI
13556,56,Home,L 74-87 ,240,26,66,0.394,21,52,0.404,5,14,0.357,17,24,0.708,74,32,80,0.4,24,66,0.364,8,14,0.571,15,18,0.833,87,2012-01-06,BOS,IND
13557,57,Home,L 74-84 ,240,27,87,0.31,24,64,0.375,3,23,0.13,17,19,0.895,74,32,77,0.416,28,60,0.467,4,17,0.235,16,24,0.667,84,2012-01-21,BRK,OKC
13558,58,@,L 74-95 ,240,29,83,0.349,26,72,0.361,3,11,0.273,13,17,0.765,74,38,78,0.487,29,63,0.46,9,15,0.6,10,15,0.667,95,2012-01-28,DET,PHI
13559,59,Home,W 74-69 ,240,30,80,0.375,26,65,0.4,4,15,0.267,10,19,0.526,74,26,78,0.333,19,56,0.339,7,22,0.318,10,22,0.455,69,2012-01-30,PHI,ORL
13560,60,@,L 74-86 ,240,29,65,0.446,26,55,0.473,3,10,0.3,13,18,0.722,74,33,75,0.44,28,56,0.5,5,19,0.263,15,20,0.75,86,2012-02-10,BOS,TOR
13561,61,@,W 74-71 ,240,30,78,0.385,28,61,0.459,2,17,0.118,12,19,0.632,74,27,71,0.38,21,57,0.368,6,14,0.429,11,18,0.611,71,2012-02-16,LAC,POR
13562,62,@,L 74-86 ,240,29,70,0.414,26,61,0.426,3,9,0.333,13,22,0.591,74,31,72,0.431,25,50,0.5,6,22,0.273,18,24,0.75,86,2012-03-05,NOP,POR
13563,63,Home,L 74-83 ,240,30,86,0.349,28,75,0.373,2,11,0.182,12,21,0.571,74,30,83,0.361,26,61,0.426,4,22,0.182,19,26,0.731,83,2012-03-09,CHA,NJN
13564,64,@,L 74-101 ,240,28,75,0.373,22,52,0.423,6,23,0.261,12,17,0.706,74,44,78,0.564,39,63,0.619,5,15,0.333,8,11,0.727,101,2012-04-22,ORL,DEN
13565,65,@,L 74-87 ,240,29,78,0.372,27,69,0.391,2,9,0.222,14,23,0.609,74,35,87,0.402,27,63,0.429,8,24,0.333,9,11,0.818,87,2012-04-26,MIL,BOS
13566,66,@,L 74-82 ,240,30,84,0.357,29,71,0.408,1,13,0.077,13,18,0.722,74,29,78,0.372,22,54,0.407,7,24,0.292,17,25,0.68,82,2012-11-11,ORL,BRK
13567,67,@,W 74-72 ,240,26,72,0.361,20,60,0.333,6,12,0.5,16,19,0.842,74,24,75,0.32,19,60,0.317,5,15,0.333,19,25,0.76,72,2012-11-13,TOR,IND
13568,68,@,L 74-90 ,240,28,85,0.329,25,68,0.368,3,17,0.176,15,22,0.682,74,36,83,0.434,31,63,0.492,5,20,0.25,13,18,0.722,90,2012-11-21,DET,ORL
13569,69,@,L 74-92 ,240,26,74,0.351,23,53,0.434,3,21,0.143,19,21,0.905,74,36,89,0.404,36,69,0.522,0,20,0.0,20,22,0.909,92,2012-12-10,TOR,POR
13570,70,@,L 74-95 ,240,27,69,0.391,27,56,0.482,0,13,0.0,20,23,0.87,74,34,84,0.405,22,48,0.458,12,36,0.333,15,22,0.682,95,2012-12-14,DAL,TOR
13571,71,@,L 74-89 ,240,25,76,0.329,20,58,0.345,5,18,0.278,19,32,0.594,74,36,80,0.45,29,64,0.453,7,16,0.438,10,11,0.909,89,2013-02-08,BRK,WAS
13572,72,@,L 74-119 ,240,27,77,0.351,21,56,0.375,6,21,0.286,14,18,0.778,74,42,76,0.553,34,58,0.586,8,18,0.444,27,28,0.964,119,2013-02-27,NOP,OKC
13573,73,@,L 74-100 ,240,27,66,0.409,23,53,0.434,4,13,0.308,16,25,0.64,74,35,77,0.455,29,60,0.483,6,17,0.353,24,30,0.8,100,2013-03-12,BOS,CHA
13574,74,@,L 74-89 ,240,29,83,0.349,26,68,0.382,3,15,0.2,13,15,0.867,74,32,77,0.416,22,49,0.449,10,28,0.357,15,20,0.75,89,2013-11-02,CLE,IND
13575,75,@,L 74-76 ,240,29,71,0.408,21,51,0.412,8,20,0.4,8,10,0.8,74,31,79,0.392,26,60,0.433,5,19,0.263,9,18,0.5,76,2013-11-08,GSW,SAS
13576,76,Home,L 74-99 ,240,26,83,0.313,23,74,0.311,3,9,0.333,19,28,0.679,74,32,84,0.381,22,59,0.373,10,25,0.4,25,32,0.781,99,2013-11-27,CHA,IND
13577,77,Home,L 74-75 ,240,32,89,0.36,27,65,0.415,5,24,0.208,5,9,0.556,74,30,73,0.411,23,52,0.442,7,21,0.333,8,14,0.571,75,2013-12-09,WAS,DEN
13578,78,Home,L 74-78 ,240,31,83,0.373,28,68,0.412,3,15,0.2,9,14,0.643,74,30,75,0.4,28,64,0.438,2,11,0.182,16,20,0.8,78,2013-12-10,CHI,MIL
13579,79,Home,L 74-91 ,240,33,84,0.393,30,67,0.448,3,17,0.176,5,7,0.714,74,35,80,0.438,25,58,0.431,10,22,0.455,11,16,0.688,91,2014-03-28,CHI,POR
13580,80,@,L 74-106 ,240,29,80,0.363,24,63,0.381,5,17,0.294,11,15,0.733,74,42,81,0.519,36,65,0.554,6,16,0.375,16,22,0.727,106,2014-11-24,ORL,CLE
13581,81,@,L 74-99 ,240,28,81,0.346,26,66,0.394,2,15,0.133,16,21,0.762,74,39,86,0.453,32,70,0.457,7,16,0.438,14,19,0.737,99,2015-01-26,PHI,NOP
13582,82,@,L 74-85 ,240,27,78,0.346,21,58,0.362,6,20,0.3,14,18,0.778,74,34,91,0.374,31,80,0.388,3,11,0.273,14,17,0.824,85,2015-01-31,OKC,MEM
13583,83,Home,L 74-101 ,240,25,84,0.298,20,68,0.294,5,16,0.313,19,24,0.792,74,41,92,0.446,37,73,0.507,4,19,0.211,15,17,0.882,101,2015-02-28,PHO,SAS
13584,84,@,L 74-94 ,240,29,84,0.345,24,60,0.4,5,24,0.208,11,17,0.647,74,36,88,0.409,33,70,0.471,3,18,0.167,19,25,0.76,94,2015-03-01,PHI,IND
13585,85,Home,W 74-72 ,240,29,83,0.349,27,61,0.443,2,22,0.091,14,21,0.667,74,31,83,0.373,26,65,0.4,5,18,0.278,5,10,0.5,72,2015-03-19,PHO,NOP
13586,86,@,L 74-93 ,240,28,80,0.35,24,62,0.387,4,18,0.222,14,20,0.7,74,36,83,0.434,28,67,0.418,8,16,0.5,13,18,0.722,93,2015-04-03,CHA,IND
13587,87,Home,L 74-92 ,240,28,81,0.346,18,59,0.305,10,22,0.455,8,11,0.727,74,33,77,0.429,21,50,0.42,12,27,0.444,14,19,0.737,92,2015-04-08,CHA,TOR
13588,88,@,L 74-110 ,240,28,80,0.35,22,59,0.373,6,21,0.286,12,18,0.667,74,45,88,0.511,37,71,0.521,8,17,0.471,12,14,0.857,110,2015-04-08,NOP,MEM
13589,89,@,L 74-92 ,240,28,75,0.373,22,56,0.393,6,19,0.316,12,16,0.75,74,35,77,0.455,29,59,0.492,6,18,0.333,16,22,0.727,92,2015-11-30,DEN,MIL
13590,90,Home,L 74-85 ,240,28,84,0.333,21,60,0.35,7,24,0.292,11,20,0.55,74,38,88,0.432,37,72,0.514,1,16,0.063,8,10,0.8,85,2015-12-08,DEN,ORL
13591,91,Home,L 74-91 ,240,31,78,0.397,26,62,0.419,5,16,0.313,7,12,0.583,74,35,80,0.438,31,58,0.534,4,22,0.182,17,18,0.944,91,2016-01-06,BRK,TOR
13592,92,Home,L 74-78 ,240,28,73,0.384,25,62,0.403,3,11,0.273,15,20,0.75,74,29,81,0.358,21,61,0.344,8,20,0.4,12,17,0.706,78,2016-01-06,MIN,DEN
13593,93,Home,L 74-86 ,240,29,89,0.326,26,68,0.382,3,21,0.143,13,15,0.867,74,31,69,0.449,26,53,0.491,5,16,0.313,19,25,0.76,86,2016-01-10,LAL,UTA
13594,94,@,L 74-99 ,240,30,72,0.417,26,58,0.448,4,14,0.286,10,11,0.909,74,40,88,0.455,33,66,0.5,7,22,0.318,12,12,1.0,99,2016-01-17,MIA,OKC
13595,95,Home,L 74-87 ,240,26,78,0.333,18,58,0.31,8,20,0.4,14,19,0.737,74,33,81,0.407,26,53,0.491,7,28,0.25,14,16,0.875,87,2016-11-11,ORL,UTA
13596,96,@,L 74-104 ,240,27,76,0.355,18,46,0.391,9,30,0.3,11,20,0.55,74,40,90,0.444,31,67,0.463,9,23,0.391,15,17,0.882,104,2016-12-20,UTA,GSW
13597,97,@,L 74-89 ,240,30,82,0.366,26,63,0.413,4,19,0.211,10,18,0.556,74,32,81,0.395,28,62,0.452,4,19,0.211,21,25,0.84,89,2017-02-06,SAS,MEM
13598,98,@,L 73-85 ,240,29,95,0.305,27,74,0.365,2,21,0.095,13,16,0.813,73,32,66,0.485,29,53,0.547,3,13,0.231,18,28,0.643,85,2012-01-03,MIL,UTA
13599,99,@,L 73-96 ,240,31,86,0.36,31,76,0.408,0,10,0.0,11,14,0.786,73,39,85,0.459,34,67,0.507,5,18,0.278,13,16,0.813,96,2012-01-06,DET,PHI
13600,0,Home,W 73-70 ,240,29,76,0.382,28,66,0.424,1,10,0.1,14,19,0.737,73,28,80,0.35,24,54,0.444,4,26,0.154,10,16,0.625,70,2012-01-16,LAL,DAL
13601,1,@,L 73-96 ,240,26,69,0.377,22,54,0.407,4,15,0.267,17,20,0.85,73,34,71,0.479,28,55,0.509,6,16,0.375,22,32,0.688,96,2012-01-18,TOR,BOS
13602,2,Home,L 73-94 ,240,27,74,0.365,20,52,0.385,7,22,0.318,12,18,0.667,73,35,68,0.515,32,54,0.593,3,14,0.214,21,29,0.724,94,2012-01-29,BRK,TOR
13603,3,Home,L 73-83 ,240,27,73,0.37,24,64,0.375,3,9,0.333,16,20,0.8,73,32,80,0.4,22,56,0.393,10,24,0.417,9,15,0.6,83,2012-01-30,MEM,SAS
13604,4,@,L 73-106 ,240,31,89,0.348,29,80,0.363,2,9,0.222,9,13,0.692,73,42,76,0.553,30,50,0.6,12,26,0.462,10,11,0.909,106,2012-01-31,CHA,LAL
13605,5,@,L 73-108 ,240,28,75,0.373,24,58,0.414,4,17,0.235,13,22,0.591,73,39,78,0.5,33,62,0.532,6,16,0.375,24,32,0.75,108,2012-02-19,CHA,IND
13606,6,@,L 73-89 ,240,29,74,0.392,22,50,0.44,7,24,0.292,8,11,0.727,73,36,89,0.404,29,64,0.453,7,25,0.28,10,14,0.714,89,2012-02-20,BOS,DAL
13607,7,@,W 73-71 ,240,34,79,0.43,34,67,0.507,0,12,0.0,5,7,0.714,73,30,78,0.385,25,66,0.379,5,12,0.417,6,7,0.857,71,2012-03-12,CHA,NOH
13608,8,Home,L 73-88 ,240,29,75,0.387,23,60,0.383,6,15,0.4,9,17,0.529,73,34,77,0.442,32,61,0.525,2,16,0.125,18,20,0.9,88,2012-03-23,DET,MIA
13609,9,@,L 73-76 ,240,29,77,0.377,25,64,0.391,4,13,0.308,11,16,0.688,73,26,71,0.366,24,56,0.429,2,15,0.133,22,35,0.629,76,2012-04-22,TOR,DET
13610,10,@,L 73-101 ,240,25,73,0.342,21,58,0.362,4,15,0.267,19,23,0.826,73,46,83,0.554,44,65,0.677,2,18,0.111,7,12,0.583,101,2012-04-23,CHA,WAS
13611,11,@,L 73-103 ,240,30,80,0.375,27,59,0.458,3,21,0.143,10,17,0.588,73,40,77,0.519,30,53,0.566,10,24,0.417,13,16,0.813,103,2012-11-07,BRK,MIA
13612,12,@,L 73-91 ,240,30,87,0.345,23,63,0.365,7,24,0.292,6,9,0.667,73,30,70,0.429,26,51,0.51,4,19,0.211,27,35,0.771,91,2012-12-07,CLE,MIN
13613,13,@,L 73-104 ,240,28,74,0.378,24,57,0.421,4,17,0.235,13,17,0.765,73,43,73,0.589,37,59,0.627,6,14,0.429,12,16,0.75,104,2012-12-31,BRK,SAS
13614,14,Home,L 73-99 ,240,27,89,0.303,21,69,0.304,6,20,0.3,13,17,0.765,73,35,76,0.461,30,62,0.484,5,14,0.357,24,32,0.75,99,2013-01-14,MEM,LAC
13615,15,@,L 73-86 ,240,29,71,0.408,25,56,0.446,4,15,0.267,11,12,0.917,73,34,79,0.43,31,69,0.449,3,10,0.3,15,19,0.789,86,2013-01-26,CHI,WAS
13616,16,@,L 73-98 ,240,25,72,0.347,22,53,0.415,3,19,0.158,20,31,0.645,73,38,81,0.469,26,55,0.473,12,26,0.462,10,17,0.588,98,2013-02-01,LAC,TOR
13617,17,@,L 73-95 ,240,28,88,0.318,25,73,0.342,3,15,0.2,14,21,0.667,73,34,87,0.391,28,64,0.438,6,23,0.261,21,24,0.875,95,2013-03-19,ORL,IND
13618,18,@,L 73-97 ,240,25,85,0.294,18,65,0.277,7,20,0.35,16,25,0.64,73,38,72,0.528,35,64,0.547,3,8,0.375,18,25,0.72,97,2013-11-08,UTA,CHI
13619,19,@,L 73-95 ,240,28,71,0.394,24,53,0.453,4,18,0.222,13,29,0.448,73,36,71,0.507,31,59,0.525,5,12,0.417,18,22,0.818,95,2013-11-24,UTA,OKC
13620,20,@,L 73-93 ,240,29,73,0.397,23,55,0.418,6,18,0.333,9,13,0.692,73,38,85,0.447,29,63,0.46,9,22,0.409,8,10,0.8,93,2013-11-29,WAS,IND
13621,21,Home,L 73-114 ,240,25,73,0.342,19,57,0.333,6,16,0.375,17,23,0.739,73,39,72,0.542,25,47,0.532,14,25,0.56,22,27,0.815,114,2013-12-08,NYK,BOS
13622,22,Home,L 73-81 ,240,27,84,0.321,20,60,0.333,7,24,0.292,12,14,0.857,73,30,84,0.357,25,65,0.385,5,19,0.263,16,21,0.762,81,2014-02-12,IND,DAL
13623,23,@,L 73-76 ,240,27,88,0.307,20,65,0.308,7,23,0.304,12,17,0.706,73,30,82,0.366,28,66,0.424,2,16,0.125,14,19,0.737,76,2014-12-20,IND,DEN
13624,24,@,L 73-108 ,240,29,75,0.387,24,60,0.4,5,15,0.333,10,16,0.625,73,42,79,0.532,29,50,0.58,13,29,0.448,11,14,0.786,108,2015-01-24,BRK,UTA
13625,25,Home,L 73-80 ,240,31,77,0.403,28,66,0.424,3,11,0.273,8,17,0.471,73,25,62,0.403,16,37,0.432,9,25,0.36,21,31,0.677,80,2015-03-19,LAL,UTA
13626,26,@,L 73-96 ,240,27,83,0.325,24,65,0.369,3,18,0.167,16,22,0.727,73,41,83,0.494,35,63,0.556,6,20,0.3,8,12,0.667,96,2015-04-12,BRK,MIL
13627,27,@,L 73-102 ,240,25,68,0.368,19,43,0.442,6,25,0.24,17,21,0.81,73,40,81,0.494,28,50,0.56,12,31,0.387,10,15,0.667,102,2016-01-27,CHA,UTA
13628,28,@,L 73-96 ,240,28,85,0.329,21,62,0.339,7,23,0.304,10,13,0.769,73,39,97,0.402,32,67,0.478,7,30,0.233,11,21,0.524,96,2016-11-17,MIL,MIA
13629,29,Home,L 73-82 ,240,28,93,0.301,26,70,0.371,2,23,0.087,15,18,0.833,73,30,66,0.455,22,39,0.564,8,27,0.296,14,25,0.56,82,2016-12-18,MEM,UTA
13630,30,@,L 73-122 ,240,28,73,0.384,25,52,0.481,3,21,0.143,14,17,0.824,73,43,87,0.494,26,48,0.542,17,39,0.436,19,19,1.0,122,2017-01-22,LAL,DAL
13631,31,Home,L 72-93 ,240,30,87,0.345,27,77,0.351,3,10,0.3,9,16,0.563,72,36,80,0.45,26,54,0.481,10,26,0.385,11,15,0.733,93,2012-01-08,WAS,MIN
13632,32,@,L 72-89 ,240,27,70,0.386,23,55,0.418,4,15,0.267,14,21,0.667,72,35,78,0.449,29,63,0.46,6,15,0.4,13,16,0.813,89,2012-01-27,CHA,PHI
13633,33,Home,L 72-94 ,240,27,73,0.37,24,63,0.381,3,10,0.3,15,19,0.789,72,36,81,0.444,24,58,0.414,12,23,0.522,10,17,0.588,94,2012-01-29,NOP,ATL
13634,34,@,L 72-102 ,240,31,83,0.373,28,67,0.418,3,16,0.188,7,10,0.7,72,39,82,0.476,29,62,0.468,10,20,0.5,14,21,0.667,102,2012-03-02,CHA,SAS
13635,35,@,L 72-92 ,240,27,79,0.342,24,63,0.381,3,16,0.188,15,22,0.682,72,33,78,0.423,24,63,0.381,9,15,0.6,17,27,0.63,92,2012-03-05,IND,CHI
13636,36,@,L 72-91 ,240,31,89,0.348,28,73,0.384,3,16,0.188,7,17,0.412,72,33,70,0.471,28,57,0.491,5,13,0.385,20,22,0.909,91,2012-04-01,MIA,BOS
13637,37,Home,L 72-86 ,240,26,74,0.351,21,52,0.404,5,22,0.227,15,19,0.789,72,32,76,0.421,23,58,0.397,9,18,0.5,13,14,0.929,86,2012-04-07,IND,BOS
13638,38,@,L 72-96 ,240,30,72,0.417,29,56,0.518,1,16,0.063,11,15,0.733,72,40,76,0.526,33,59,0.559,7,17,0.412,9,15,0.6,96,2012-04-18,TOR,MIA
13639,39,@,L 72-83 ,240,25,70,0.357,23,54,0.426,2,16,0.125,20,28,0.714,72,32,76,0.421,28,63,0.444,4,13,0.308,15,21,0.714,83,2012-04-19,CHI,MIA
13640,40,Home,L 72-74 ,240,24,75,0.32,19,60,0.317,5,15,0.333,19,25,0.76,72,26,72,0.361,20,60,0.333,6,12,0.5,16,19,0.842,74,2012-11-13,IND,TOR
13641,41,@,L 72-81 ,240,31,82,0.378,29,72,0.403,2,10,0.2,8,14,0.571,72,34,89,0.382,29,64,0.453,5,25,0.2,8,13,0.615,81,2012-11-19,ORL,ATL
13642,42,@,L 72-102 ,240,27,72,0.375,20,52,0.385,7,20,0.35,11,15,0.733,72,40,79,0.506,32,52,0.615,8,27,0.296,14,21,0.667,102,2012-12-15,WAS,MIA
13643,43,@,L 72-81 ,240,29,68,0.426,26,52,0.5,3,16,0.188,11,18,0.611,72,36,89,0.404,31,70,0.443,5,19,0.263,4,7,0.571,81,2012-12-29,DEN,MEM
13644,44,@,L 72-90 ,240,29,74,0.392,27,64,0.422,2,10,0.2,12,19,0.632,72,39,80,0.488,38,69,0.551,1,11,0.091,11,13,0.846,90,2013-01-09,PHI,TOR
13645,45,Home,L 72-90 ,240,26,77,0.338,24,63,0.381,2,14,0.143,18,24,0.75,72,34,75,0.453,26,53,0.491,8,22,0.364,14,19,0.737,90,2013-02-23,DET,IND
13646,46,Home,L 72-76 ,240,29,77,0.377,20,56,0.357,9,21,0.429,5,13,0.385,72,32,71,0.451,30,64,0.469,2,7,0.286,10,12,0.833,76,2013-02-24,BRK,MEM
13647,47,@,L 72-102 ,240,25,86,0.291,21,68,0.309,4,18,0.222,18,24,0.75,72,36,79,0.456,30,62,0.484,6,17,0.353,24,27,0.889,102,2013-02-24,CHI,OKC
13648,48,Home,L 72-93 ,240,28,83,0.337,25,66,0.379,3,17,0.176,13,13,1.0,72,35,70,0.5,25,51,0.49,10,19,0.526,13,15,0.867,93,2013-03-18,NOP,GSW
13649,49,@,L 72-101 ,240,29,79,0.367,23,59,0.39,6,20,0.3,8,10,0.8,72,41,78,0.526,35,58,0.603,6,20,0.3,13,19,0.684,101,2013-03-20,PHI,LAC
13650,50,Home,L 72-96 ,240,30,85,0.353,25,67,0.373,5,18,0.278,7,9,0.778,72,38,77,0.494,33,63,0.524,5,14,0.357,15,27,0.556,96,2013-11-23,MIL,CHA
13651,51,Home,L 72-81 ,240,28,88,0.318,21,67,0.313,7,21,0.333,9,12,0.75,72,24,62,0.387,18,46,0.391,6,16,0.375,27,39,0.692,81,2014-01-10,MIL,CHI
13652,52,@,L 72-98 ,240,21,73,0.288,14,48,0.292,7,25,0.28,23,29,0.793,72,36,83,0.434,30,66,0.455,6,17,0.353,20,34,0.588,98,2014-01-18,UTA,MIN
13653,53,Home,L 72-93 ,240,29,88,0.33,20,59,0.339,9,29,0.31,5,10,0.5,72,34,82,0.415,21,53,0.396,13,29,0.448,12,20,0.6,93,2015-01-30,MIA,DAL
13654,54,Home,L 72-107 ,240,32,86,0.372,28,69,0.406,4,17,0.235,4,7,0.571,72,43,84,0.512,33,62,0.532,10,22,0.455,11,13,0.846,107,2015-02-07,NOP,CHI
13655,55,@,L 72-74 ,240,31,83,0.373,26,65,0.4,5,18,0.278,5,10,0.5,72,29,83,0.349,27,61,0.443,2,22,0.091,14,21,0.667,74,2015-03-19,NOP,PHO
13656,56,Home,L 72-104 ,240,28,80,0.35,23,62,0.371,5,18,0.278,11,15,0.733,72,42,85,0.494,37,65,0.569,5,20,0.25,15,23,0.652,104,2016-10-29,PHI,ATL
13657,57,Home,L 72-88 ,240,28,87,0.322,24,64,0.375,4,23,0.174,12,18,0.667,72,36,81,0.444,27,56,0.482,9,25,0.36,7,11,0.636,88,2017-02-13,UTA,LAC
13658,58,@,L 71-96 ,240,29,90,0.322,28,77,0.364,1,13,0.077,12,17,0.706,71,30,71,0.423,24,55,0.436,6,16,0.375,30,37,0.811,96,2011-12-27,UTA,LAL
13659,59,@,L 71-93 ,240,27,77,0.351,26,58,0.448,1,19,0.053,16,21,0.762,71,34,86,0.395,18,53,0.34,16,33,0.485,9,16,0.563,93,2012-01-05,DAL,SAS
13660,60,Home,L 71-79 ,240,30,74,0.405,26,64,0.406,4,10,0.4,7,9,0.778,71,31,69,0.449,26,50,0.52,5,19,0.263,12,16,0.75,79,2012-01-20,BOS,PHO
13661,61,@,L 71-109 ,240,29,78,0.372,25,65,0.385,4,13,0.308,9,18,0.5,71,43,91,0.473,36,71,0.507,7,20,0.35,16,19,0.842,109,2012-01-27,PHO,POR
13662,62,Home,L 71-74 ,240,27,71,0.38,21,57,0.368,6,14,0.429,11,18,0.611,71,30,78,0.385,28,61,0.459,2,17,0.118,12,19,0.632,74,2012-02-16,POR,LAC
13663,63,@,L 71-103 ,240,28,80,0.35,28,72,0.389,0,8,0.0,15,18,0.833,71,43,89,0.483,37,72,0.514,6,17,0.353,11,15,0.733,103,2012-03-07,BOS,PHI
13664,64,Home,L 71-73 ,240,30,78,0.385,25,66,0.379,5,12,0.417,6,7,0.857,71,34,79,0.43,34,67,0.507,0,12,0.0,5,7,0.714,73,2012-03-12,NOP,CHA
13665,65,@,L 71-83 ,240,31,84,0.369,28,73,0.384,3,11,0.273,6,7,0.857,71,32,75,0.427,30,63,0.476,2,12,0.167,17,21,0.81,83,2012-03-30,DET,CHI
13666,66,@,L 71-80 ,240,28,75,0.373,26,64,0.406,2,11,0.182,13,20,0.65,71,30,80,0.375,24,69,0.348,6,11,0.545,14,19,0.737,80,2012-12-17,CHI,MEM
13667,67,@,L 71-99 ,240,29,81,0.358,23,60,0.383,6,21,0.286,7,14,0.5,71,38,82,0.463,30,61,0.492,8,21,0.381,15,16,0.938,99,2013-01-06,WAS,MIA
13668,68,Home,W 71-69 ,240,28,76,0.368,23,61,0.377,5,15,0.333,10,12,0.833,71,27,74,0.365,24,57,0.421,3,17,0.176,12,17,0.706,69,2013-02-13,BOS,CHI
13669,69,Home,L 71-98 ,240,28,74,0.378,21,51,0.412,7,23,0.304,8,15,0.533,71,37,77,0.481,26,53,0.491,11,24,0.458,13,15,0.867,98,2013-03-06,PHO,TOR
13670,70,@,L 71-82 ,240,27,74,0.365,21,59,0.356,6,15,0.4,11,14,0.786,71,33,75,0.44,28,62,0.452,5,13,0.385,11,17,0.647,82,2014-03-22,IND,MEM
13671,71,@,W 71-69 ,240,29,80,0.363,26,69,0.377,3,11,0.273,10,13,0.769,71,26,72,0.361,22,58,0.379,4,14,0.286,13,18,0.722,69,2014-11-01,MEM,CHO
13672,72,@,L 71-88 ,240,24,74,0.324,19,48,0.396,5,26,0.192,18,28,0.643,71,30,84,0.357,26,61,0.426,4,23,0.174,24,28,0.857,88,2014-12-27,PHI,UTA
13673,73,@,L 71-80 (OT),265,30,84,0.357,28,63,0.444,2,21,0.095,9,13,0.692,71,31,101,0.307,29,86,0.337,2,15,0.133,16,25,0.64,80,2015-01-17,IND,CHO
13674,74,@,L 71-76 ,240,28,79,0.354,22,64,0.344,6,15,0.4,9,18,0.5,71,25,76,0.329,23,69,0.333,2,7,0.286,24,37,0.649,76,2015-01-24,NYK,CHO
13675,75,@,L 71-87 ,240,30,89,0.337,26,71,0.366,4,18,0.222,7,13,0.538,71,27,76,0.355,19,50,0.38,8,26,0.308,25,32,0.781,87,2015-02-23,MIL,CHI
13676,76,Home,L 71-99 ,240,19,63,0.302,13,48,0.271,6,15,0.4,27,37,0.73,71,36,88,0.409,29,75,0.387,7,13,0.538,20,25,0.8,99,2015-10-30,PHI,UTA
13677,77,@,L 71-93 ,240,25,64,0.391,18,42,0.429,7,22,0.318,14,22,0.636,71,29,76,0.382,27,58,0.466,2,18,0.111,33,38,0.868,93,2016-11-19,MIN,MEM
13678,78,Home,L 70-106 ,240,22,71,0.31,17,47,0.362,5,24,0.208,21,26,0.808,70,38,86,0.442,26,63,0.413,12,23,0.522,18,21,0.857,106,2011-12-27,BRK,ATL
13679,79,@,L 70-89 ,240,30,74,0.405,26,54,0.481,4,20,0.2,6,10,0.6,70,35,71,0.493,29,55,0.527,6,16,0.375,13,21,0.619,89,2012-01-04,BRK,BOS
13680,80,Home,L 70-82 ,240,30,88,0.341,29,75,0.387,1,13,0.077,9,11,0.818,70,32,83,0.386,26,66,0.394,6,17,0.353,12,16,0.75,82,2012-01-10,CHA,HOU
13681,81,@,L 70-73 ,240,28,80,0.35,24,54,0.444,4,26,0.154,10,16,0.625,70,29,76,0.382,28,66,0.424,1,10,0.1,14,19,0.737,73,2012-01-16,DAL,LAL
13682,82,@,L 70-86 ,240,28,83,0.337,22,63,0.349,6,20,0.3,8,10,0.8,70,34,67,0.507,26,38,0.684,8,29,0.276,10,14,0.714,86,2012-03-16,BRK,ORL
13683,83,@,L 70-104 ,240,24,67,0.358,20,49,0.408,4,18,0.222,18,24,0.75,70,42,76,0.553,37,66,0.561,5,10,0.5,15,24,0.625,104,2012-04-26,MIA,WAS
13684,84,Home,L 70-77 ,240,26,80,0.325,22,64,0.344,4,16,0.25,14,22,0.636,70,27,82,0.329,22,63,0.349,5,19,0.263,18,23,0.783,77,2012-12-11,NOP,WAS
13685,85,@,L 70-86 ,240,25,78,0.321,22,67,0.328,3,11,0.273,17,26,0.654,70,34,84,0.405,30,71,0.423,4,13,0.308,14,20,0.7,86,2013-04-17,UTA,MEM
13686,86,@,L 70-99 ,240,22,78,0.282,18,58,0.31,4,20,0.2,22,34,0.647,70,36,69,0.522,34,61,0.557,2,8,0.25,25,34,0.735,99,2014-02-03,CHI,SAC
13687,87,@,L 70-123 ,240,23,77,0.299,16,50,0.32,7,27,0.259,17,33,0.515,70,41,80,0.513,30,48,0.625,11,32,0.344,30,36,0.833,123,2014-11-13,PHI,DAL
13688,88,@,L 70-88 ,240,22,69,0.319,11,41,0.268,11,28,0.393,15,20,0.75,70,36,81,0.444,31,61,0.508,5,20,0.25,11,17,0.647,88,2014-12-12,PHI,BRK
13689,89,@,L 70-95 ,240,26,78,0.333,23,64,0.359,3,14,0.214,15,18,0.833,70,37,90,0.411,30,69,0.435,7,21,0.333,14,20,0.7,95,2015-12-02,MIL,SAS
13690,90,@,L 70-91 ,240,22,70,0.314,18,46,0.391,4,24,0.167,22,27,0.815,70,40,92,0.435,35,73,0.479,5,19,0.263,6,7,0.857,91,2016-11-27,LAC,IND
13691,91,@,L 69-74 ,240,26,78,0.333,19,56,0.339,7,22,0.318,10,22,0.455,69,30,80,0.375,26,65,0.4,4,15,0.267,10,19,0.526,74,2012-01-30,ORL,PHI
13692,92,@,L 69-114 ,240,23,79,0.291,17,57,0.298,6,22,0.273,17,22,0.773,69,40,78,0.513,27,51,0.529,13,27,0.481,21,23,0.913,114,2012-11-26,CHA,OKC
13693,93,@,L 69-85 ,240,29,85,0.341,27,75,0.36,2,10,0.2,9,15,0.6,69,34,78,0.436,31,71,0.437,3,7,0.429,14,20,0.7,85,2013-01-18,SAC,MEM
13694,94,Home,L 69-88 ,240,31,89,0.348,29,81,0.358,2,8,0.25,5,7,0.714,69,32,81,0.395,27,64,0.422,5,17,0.294,19,25,0.76,88,2013-02-06,PHI,IND
13695,95,Home,L 69-97 ,240,30,91,0.33,26,77,0.338,4,14,0.286,5,5,1.0,69,34,76,0.447,25,59,0.424,9,17,0.529,20,27,0.741,97,2013-02-10,PHO,OKC
13696,96,@,L 69-71 ,240,27,74,0.365,24,57,0.421,3,17,0.176,12,17,0.706,69,28,76,0.368,23,61,0.377,5,15,0.333,10,12,0.833,71,2013-02-13,CHI,BOS
13697,97,@,L 69-102 ,240,25,78,0.321,24,68,0.353,1,10,0.1,18,25,0.72,69,42,93,0.452,32,63,0.508,10,30,0.333,8,12,0.667,102,2014-04-04,SAC,GSW
13698,98,Home,L 69-71 ,240,26,72,0.361,22,58,0.379,4,14,0.286,13,18,0.722,69,29,80,0.363,26,69,0.377,3,11,0.273,10,13,0.769,71,2014-11-01,CHA,MEM
13699,99,@,W 69-65 ,240,23,80,0.288,16,45,0.356,7,35,0.2,16,30,0.533,69,20,68,0.294,17,49,0.347,3,19,0.158,22,28,0.786,65,2014-11-16,HOU,OKC
13700,0,@,L 69-89 ,240,28,84,0.333,25,74,0.338,3,10,0.3,10,16,0.625,69,31,80,0.388,23,63,0.365,8,17,0.471,19,23,0.826,89,2015-01-18,UTA,SAS
13701,1,@,L 69-89 ,240,23,75,0.307,21,55,0.382,2,20,0.1,21,23,0.913,69,37,78,0.474,30,57,0.526,7,21,0.333,8,12,0.667,89,2015-01-28,DET,PHI
13702,2,@,L 69-99 ,240,29,87,0.333,27,61,0.443,2,26,0.077,9,10,0.9,69,39,88,0.443,36,72,0.5,3,16,0.188,18,27,0.667,99,2015-01-29,DEN,MEM
13703,3,Home,L 69-95 ,240,25,77,0.325,21,55,0.382,4,22,0.182,15,20,0.75,69,44,85,0.518,42,71,0.592,2,14,0.143,5,5,1.0,95,2015-03-09,CHA,WAS
13704,4,@,L 69-96 ,240,26,83,0.313,22,63,0.349,4,20,0.2,13,18,0.722,69,41,83,0.494,37,58,0.638,4,25,0.16,10,14,0.714,96,2015-04-07,PHO,ATL
13705,5,@,L 69-119 ,240,26,96,0.271,23,73,0.315,3,23,0.13,14,20,0.7,69,43,84,0.512,32,59,0.542,11,25,0.44,22,30,0.733,119,2015-11-02,MEM,GSW
13706,6,@,L 69-103 ,240,28,82,0.341,22,56,0.393,6,26,0.231,7,14,0.5,69,43,88,0.489,32,63,0.508,11,25,0.44,6,9,0.667,103,2016-03-17,PHO,UTA
13707,7,@,L 69-88 ,240,27,84,0.321,22,59,0.373,5,25,0.2,10,13,0.769,69,35,90,0.389,27,65,0.415,8,25,0.32,10,10,1.0,88,2016-11-14,ORL,IND
13708,8,Home,L 69-95 ,240,28,92,0.304,23,71,0.324,5,21,0.238,8,15,0.533,69,38,82,0.463,28,57,0.491,10,25,0.4,9,13,0.692,95,2016-12-16,CHI,MIL
13709,9,@,L 68-92 ,240,28,71,0.394,27,67,0.403,1,4,0.25,11,14,0.786,68,34,74,0.459,31,58,0.534,3,16,0.188,21,25,0.84,92,2012-01-09,DET,CHI
13710,10,@,L 68-112 ,240,26,80,0.325,25,71,0.352,1,9,0.111,15,19,0.789,68,44,80,0.55,37,66,0.561,7,14,0.5,17,20,0.85,112,2012-02-01,CHA,POR
13711,11,Home,L 68-97 ,240,25,79,0.316,23,69,0.333,2,10,0.2,16,20,0.8,68,42,84,0.5,37,71,0.521,5,13,0.385,8,9,0.889,97,2012-02-28,DET,PHI
13712,12,Home,L 68-100 ,240,25,84,0.298,24,76,0.316,1,8,0.125,17,23,0.739,68,40,83,0.482,31,64,0.484,9,19,0.474,11,19,0.579,100,2012-04-18,CHA,CHI
13713,13,Home,L 68-107 ,240,30,70,0.429,26,59,0.441,4,11,0.364,4,8,0.5,68,41,82,0.5,32,59,0.542,9,23,0.391,16,25,0.64,107,2012-11-09,ORL,BRK
13714,14,@,L 68-100 ,240,28,85,0.329,26,73,0.356,2,12,0.167,10,13,0.769,68,38,90,0.422,28,66,0.424,10,24,0.417,14,21,0.667,100,2012-12-21,WAS,DET
13715,15,@,L 68-98 ,240,28,81,0.346,23,63,0.365,5,18,0.278,7,12,0.583,68,38,78,0.487,33,62,0.532,5,16,0.313,17,23,0.739,98,2013-03-01,CHA,UTA
13716,16,Home,L 68-119 ,240,26,75,0.347,22,51,0.431,4,24,0.167,12,21,0.571,68,47,76,0.618,43,65,0.662,4,11,0.364,21,25,0.84,119,2015-12-07,PHI,SAS
13717,17,@,L 68-95 ,240,26,83,0.313,18,58,0.31,8,25,0.32,8,12,0.667,68,35,80,0.438,25,46,0.543,10,34,0.294,15,18,0.833,95,2016-11-25,ATL,UTA
13718,18,@,L 67-93 ,240,24,61,0.393,18,40,0.45,6,21,0.286,13,21,0.619,67,41,81,0.506,36,67,0.537,5,14,0.357,6,16,0.375,93,2012-01-27,ORL,NOH
13719,19,Home,L 67-90 ,240,28,75,0.373,27,72,0.375,1,3,0.333,10,17,0.588,67,39,85,0.459,35,69,0.507,4,16,0.25,8,12,0.667,90,2012-02-08,NOP,CHI
13720,20,Home,L 67-75 ,240,23,76,0.303,22,60,0.367,1,16,0.063,20,30,0.667,67,26,77,0.338,25,66,0.379,1,11,0.091,22,25,0.88,75,2012-04-16,CHA,NOH
13721,21,@,L 67-98 ,240,25,83,0.301,19,65,0.292,6,18,0.333,11,16,0.688,67,37,88,0.42,27,69,0.391,10,19,0.526,14,18,0.778,98,2012-04-26,BRK,TOR
13722,22,Home,L 67-86 ,240,28,75,0.373,26,65,0.4,2,10,0.2,9,11,0.818,67,37,73,0.507,34,60,0.567,3,13,0.231,9,14,0.643,86,2013-02-21,CHI,MIA
13723,23,Home,L 67-88 ,240,27,79,0.342,23,65,0.354,4,14,0.286,9,14,0.643,67,32,74,0.432,25,51,0.49,7,23,0.304,17,21,0.81,88,2014-03-29,MIL,MIA
13724,24,@,L 66-78 ,240,28,73,0.384,22,56,0.393,6,17,0.353,4,7,0.571,66,32,74,0.432,28,62,0.452,4,12,0.333,10,16,0.625,78,2012-04-24,MIA,BOS
13725,25,@,L 66-93 ,240,26,81,0.321,21,67,0.313,5,14,0.357,9,23,0.391,66,37,83,0.446,31,70,0.443,6,13,0.462,13,22,0.591,93,2014-01-10,WAS,IND
13726,26,@,L 66-94 ,240,23,78,0.295,18,59,0.305,5,19,0.263,15,18,0.833,66,33,78,0.423,18,54,0.333,15,24,0.625,13,19,0.684,94,2015-03-16,CHA,UTA
13727,27,@,L 65-103 ,240,22,79,0.278,18,59,0.305,4,20,0.2,17,21,0.81,65,39,84,0.464,25,55,0.455,14,29,0.483,11,13,0.846,103,2012-04-13,WAS,NYK
13728,28,Home,L 65-69 ,240,20,68,0.294,17,49,0.347,3,19,0.158,22,28,0.786,65,23,80,0.288,16,45,0.356,7,35,0.2,16,30,0.533,69,2014-11-16,OKC,HOU
13729,29,@,L 64-104 ,240,26,84,0.31,25,75,0.333,1,9,0.111,11,14,0.786,64,39,84,0.464,34,71,0.479,5,13,0.385,21,29,0.724,104,2012-01-01,MEM,CHI
13730,30,@,L 64-78 ,240,26,84,0.31,23,75,0.307,3,9,0.333,9,12,0.75,64,33,90,0.367,30,78,0.385,3,12,0.25,9,16,0.563,78,2012-01-11,WAS,CHI
13731,31,@,L 64-77 ,240,30,86,0.349,27,76,0.355,3,10,0.3,1,7,0.143,64,33,82,0.402,29,67,0.433,4,15,0.267,7,12,0.583,77,2012-01-14,TOR,CHI
13732,32,@,L 64-100 ,240,25,73,0.342,19,59,0.322,6,14,0.429,8,18,0.444,64,39,75,0.52,27,51,0.529,12,24,0.5,10,12,0.833,100,2012-02-01,TOR,BOS
13733,33,Home,L 64-95 ,240,25,76,0.329,24,68,0.353,1,8,0.125,13,19,0.684,64,39,90,0.433,33,75,0.44,6,15,0.4,11,20,0.55,95,2012-02-10,CHA,CHI
13734,34,Home,L 64-80 ,240,21,73,0.288,16,48,0.333,5,25,0.2,17,22,0.773,64,31,77,0.403,22,52,0.423,9,25,0.36,9,12,0.75,80,2016-11-18,DAL,MEM
13735,35,@,L 63-99 ,240,24,74,0.324,22,57,0.386,2,17,0.118,13,13,1.0,63,41,87,0.471,36,75,0.48,5,12,0.417,12,18,0.667,99,2013-02-13,POR,NOH
13736,36,@,L 63-92 ,240,20,73,0.274,15,46,0.326,5,27,0.185,18,28,0.643,63,32,78,0.41,21,58,0.362,11,20,0.55,17,24,0.708,92,2013-03-11,NYK,GSW
13737,37,@,L 62-97 ,240,27,85,0.318,26,73,0.356,1,12,0.083,7,12,0.583,62,36,83,0.434,31,62,0.5,5,21,0.238,20,27,0.741,97,2012-01-07,TOR,PHI
13738,38,Home,L 62-77 ,240,23,69,0.333,19,50,0.38,4,19,0.211,12,16,0.75,62,35,84,0.417,31,62,0.5,4,22,0.182,3,5,0.6,77,2012-11-07,NOP,PHI
13739,39,@,L 61-78 ,240,27,80,0.338,26,68,0.382,1,12,0.083,6,8,0.75,61,36,79,0.456,33,59,0.559,3,20,0.15,3,5,0.6,78,2013-02-04,ORL,PHI
13740,40,@,L 60-99 ,240,22,86,0.256,20,65,0.308,2,21,0.095,14,18,0.778,60,37,81,0.457,30,65,0.462,7,16,0.438,18,25,0.72,99,2012-01-14,SAC,DAL
13741,41,Home,L 59-85 ,240,24,68,0.353,20,48,0.417,4,20,0.2,7,18,0.389,59,35,79,0.443,28,61,0.459,7,18,0.389,8,11,0.727,85,2012-03-19,ORL,CHI
13742,42,@,L 58-97 ,240,24,82,0.293,22,68,0.324,2,14,0.143,8,10,0.8,58,33,79,0.418,27,65,0.415,6,14,0.429,25,33,0.758,97,2013-01-14,ATL,CHI
13743,43,@,L 56-87 ,240,16,65,0.246,12,49,0.245,4,16,0.25,20,30,0.667,56,33,78,0.423,31,65,0.477,2,13,0.154,19,19,1.0,87,2012-01-23,ORL,BOS
