,Unnamed: 0,Unnamed: 0.1,game_location,game_result,mp,fg,fga,fg_pct,fg2,fg2a,fg2_pct,fg3,fg3a,fg3_pct,ft,fta,ft_pct,pts,opp_fg,opp_fga,opp_fg_pct,opp_fg2,opp_fg2a,opp_fg2_pct,opp_fg3,opp_fg3a,opp_fg3_pct,opp_ft,opp_fta,opp_ft_pct,opp_pts,date_game,team_id,opp_id,year,dk_points_allowed
0,0,0,Home,W 149-140 (2OT),290,60,113,0.531,50,86,0.581,10,27,0.37,19,20,0.95,149,49,100,0.49,35,64,0.547,14,36,0.389,28,36,0.778,140,2012-03-23,OKC,MIN,2012,147.0
1,1,1,Home,W 149-106 ,240,53,86,0.616,34,50,0.68,19,36,0.528,24,35,0.686,149,40,93,0.43,32,73,0.438,8,20,0.4,18,22,0.818,106,2016-11-23,GSW,LAL,2017,110.0
2,2,2,@,W 147-144 (4OT),340,56,124,0.452,48,95,0.505,8,29,0.276,27,46,0.587,147,50,120,0.417,45,98,0.459,5,22,0.227,39,44,0.886,144,2015-12-18,DET,CHI,2016,146.5
3,3,3,@,W 145-130 ,240,56,97,0.577,45,71,0.634,11,26,0.423,22,28,0.786,145,44,95,0.463,30,63,0.476,14,32,0.438,28,35,0.8,130,2014-04-08,HOU,LAL,2014,137.0
4,4,4,@,W 144-143 (2OT),290,57,109,0.523,46,80,0.575,11,29,0.379,19,24,0.792,144,53,125,0.424,38,82,0.463,15,43,0.349,22,25,0.88,143,2015-04-10,DAL,DEN,2015,150.5
5,5,5,Home,L 144-147 (4OT),340,50,120,0.417,45,98,0.459,5,22,0.227,39,44,0.886,144,56,124,0.452,48,95,0.505,8,29,0.276,27,46,0.587,147,2015-12-18,CHI,DET,2016,151.0
6,6,6,Home,W 144-109 ,240,56,86,0.651,43,58,0.741,13,28,0.464,19,23,0.826,144,40,92,0.435,29,62,0.468,11,30,0.367,18,22,0.818,109,2016-04-13,MIN,NOP,2016,114.5
7,7,7,Home,W 144-98 ,240,57,92,0.62,40,58,0.69,17,34,0.5,13,16,0.813,144,36,82,0.439,24,54,0.444,12,28,0.429,14,22,0.636,98,2017-01-28,GSW,LAC,2017,104.0
8,8,8,Home,W 143-107 ,240,51,76,0.671,43,58,0.741,8,18,0.444,33,40,0.825,143,44,102,0.431,37,77,0.481,7,25,0.28,12,15,0.8,107,2014-03-28,MIN,LAL,2014,110.5
9,9,9,Home,L 143-144 (2OT),290,53,125,0.424,38,82,0.463,15,43,0.349,22,25,0.88,143,57,109,0.523,46,80,0.575,11,29,0.379,19,24,0.792,144,2015-04-10,DEN,DAL,2015,149.5
10,10,10,@,W 143-114 ,240,48,83,0.578,33,53,0.623,15,30,0.5,32,35,0.914,143,43,105,0.41,32,71,0.451,11,34,0.324,17,23,0.739,114,2017-01-20,BRK,NOP,2017,119.5
11,11,11,@,W 142-94 ,240,57,103,0.553,45,77,0.584,12,26,0.462,16,22,0.727,142,34,86,0.395,26,56,0.464,8,30,0.267,18,26,0.692,94,2014-03-06,LAC,LAL,2014,98.0
12,12,12,Home,W 142-119 ,240,53,87,0.609,44,64,0.688,9,23,0.391,27,34,0.794,142,43,83,0.518,33,54,0.611,10,29,0.345,23,28,0.821,119,2016-01-02,SAC,PHO,2016,124.0
13,13,13,Home,W 142-106 ,240,54,104,0.519,40,67,0.597,14,37,0.378,20,26,0.769,142,35,85,0.412,32,70,0.457,3,15,0.2,33,35,0.943,106,2016-12-05,GSW,IND,2017,107.5
14,14,14,Home,W 142-139 (4OT),340,52,119,0.437,42,88,0.477,10,31,0.323,28,40,0.7,142,51,128,0.398,33,77,0.429,18,51,0.353,19,23,0.826,139,2017-01-29,ATL,NYK,2017,148.0
15,15,15,Home,W 142-130 ,240,44,94,0.468,22,36,0.611,22,58,0.379,32,42,0.762,142,49,94,0.521,40,68,0.588,9,26,0.346,23,28,0.821,130,2017-02-25,HOU,MIN,2017,134.5
16,16,16,Home,W 141-129 (2OT),290,56,101,0.554,46,78,0.59,10,23,0.435,19,24,0.792,141,48,93,0.516,34,66,0.515,14,27,0.519,19,26,0.731,129,2013-02-26,MIA,SAC,2013,136.0
17,17,17,@,L 140-149 (2OT),290,49,100,0.49,35,64,0.547,14,36,0.389,28,36,0.778,140,60,113,0.531,50,86,0.581,10,27,0.37,19,20,0.95,149,2012-03-23,MIN,OKC,2012,154.0
18,18,18,@,W 140-133 (3OT),315,46,93,0.495,32,67,0.478,14,26,0.538,34,43,0.791,140,51,108,0.472,43,84,0.512,8,24,0.333,23,30,0.767,133,2012-11-12,UTA,TOR,2013,137.0
19,19,19,Home,W 140-109 ,240,46,91,0.505,23,51,0.451,23,40,0.575,25,35,0.714,140,41,86,0.477,38,71,0.535,3,15,0.2,24,30,0.8,109,2013-02-05,HOU,GSW,2013,110.5
20,20,20,Home,W 140-106 ,240,51,82,0.622,33,47,0.702,18,35,0.514,20,28,0.714,140,44,85,0.518,39,72,0.542,5,13,0.385,13,21,0.619,106,2014-11-21,DAL,LAL,2015,108.5
21,21,21,Home,W 140-132 (OT),265,47,91,0.516,25,54,0.463,22,37,0.595,24,33,0.727,140,44,88,0.5,33,56,0.589,11,32,0.344,33,52,0.635,132,2016-01-18,LAC,HOU,2016,137.5
22,22,22,Home,W 140-116 ,240,45,81,0.556,31,41,0.756,14,40,0.35,36,43,0.837,140,45,96,0.469,32,63,0.508,13,33,0.394,13,16,0.813,116,2016-12-30,HOU,LAC,2017,122.5
23,23,23,Home,W 140-112 ,240,52,91,0.571,37,59,0.627,15,32,0.469,21,23,0.913,140,44,94,0.468,32,65,0.492,12,29,0.414,12,13,0.923,112,2017-01-12,DEN,IND,2017,118.0
24,24,24,@,W 140-135 (OT),265,49,92,0.533,30,54,0.556,19,38,0.5,23,28,0.821,140,50,99,0.505,38,70,0.543,12,29,0.414,23,26,0.885,135,2017-02-06,CLE,WAS,2017,141.0
25,25,25,Home,W 139-133 (4OT),340,48,107,0.449,42,88,0.477,6,19,0.316,37,47,0.787,139,49,126,0.389,43,105,0.41,6,21,0.286,29,35,0.829,133,2012-03-25,ATL,UTA,2012,136.0
26,26,26,@,W 139-105 ,240,52,93,0.559,31,56,0.554,21,37,0.568,14,20,0.7,139,39,87,0.448,30,72,0.417,9,15,0.6,18,26,0.692,105,2013-12-14,POR,PHI,2014,109.5
27,27,27,Home,W 139-91 ,240,56,84,0.667,41,64,0.641,15,20,0.75,12,16,0.75,139,29,72,0.403,26,58,0.448,3,14,0.214,30,41,0.732,91,2014-11-14,NOP,MIN,2015,92.5
28,28,28,@,W 139-136 (2OT),290,50,110,0.455,42,83,0.506,8,27,0.296,31,38,0.816,139,47,106,0.443,35,73,0.479,12,33,0.364,30,38,0.789,136,2015-10-30,OKC,ORL,2016,142.0
29,29,29,Home,W 139-134 (OT),265,47,95,0.495,34,62,0.548,13,33,0.394,32,37,0.865,139,44,85,0.518,32,55,0.582,12,30,0.4,34,50,0.68,134,2016-02-10,BOS,LAC,2016,140.0
30,30,30,Home,W 139-105 ,240,56,91,0.615,42,64,0.656,14,27,0.519,13,19,0.684,139,37,79,0.468,32,65,0.492,5,14,0.357,26,39,0.667,105,2016-03-29,ORL,BRK,2016,107.5
31,31,31,@,L 139-142 (4OT),340,51,128,0.398,33,77,0.429,18,51,0.353,19,23,0.826,139,52,119,0.437,42,88,0.477,10,31,0.323,28,40,0.7,142,2017-01-29,NYK,ATL,2017,147.0
32,32,32,@,W 138-113 ,240,52,95,0.547,40,67,0.597,12,28,0.429,22,31,0.71,138,39,84,0.464,33,65,0.508,6,19,0.316,29,35,0.829,113,2015-04-15,OKC,MIN,2015,116.0
33,33,33,Home,W 138-109 ,240,49,78,0.628,35,57,0.614,14,21,0.667,26,34,0.765,138,41,91,0.451,30,59,0.508,11,32,0.344,16,21,0.762,109,2016-12-03,GSW,PHO,2017,114.5
34,34,34,Home,W 137-97 ,240,51,86,0.593,36,58,0.621,15,28,0.536,20,24,0.833,137,32,84,0.381,24,64,0.375,8,20,0.4,25,32,0.781,97,2012-02-21,POR,SAS,2012,101.0
35,35,35,Home,W 137-118 ,240,49,94,0.521,34,56,0.607,15,38,0.395,24,28,0.857,137,41,82,0.5,34,57,0.596,7,25,0.28,29,43,0.674,118,2013-11-04,LAC,HOU,2014,121.5
36,36,36,@,W 137-115 ,240,53,99,0.535,41,70,0.586,12,29,0.414,19,24,0.792,137,42,89,0.472,39,68,0.574,3,21,0.143,28,36,0.778,115,2014-01-05,DEN,LAL,2014,116.5
37,37,37,Home,W 137-107 ,240,52,92,0.565,37,65,0.569,15,27,0.556,18,25,0.72,137,35,74,0.473,33,65,0.508,2,9,0.222,35,45,0.778,107,2014-04-02,DEN,NOP,2014,108.0
38,38,38,Home,W 137-134 (OT),265,41,99,0.414,30,64,0.469,11,35,0.314,44,49,0.898,137,46,90,0.511,33,63,0.524,13,27,0.481,29,35,0.829,134,2014-12-31,OKC,PHO,2015,140.5
39,39,39,Home,W 137-105 ,240,52,97,0.536,35,67,0.522,17,30,0.567,16,23,0.696,137,36,92,0.391,24,58,0.414,12,34,0.353,21,28,0.75,105,2016-02-19,POR,GSW,2016,111.0
40,40,40,Home,W 137-125 ,240,48,90,0.533,27,54,0.5,21,36,0.583,20,27,0.741,137,47,90,0.522,34,61,0.557,13,29,0.448,18,19,0.947,125,2016-11-23,CLE,POR,2017,131.5
41,41,41,@,W 137-112 ,240,46,92,0.5,25,48,0.521,21,44,0.477,24,32,0.75,137,41,93,0.441,26,49,0.531,15,44,0.341,15,19,0.789,112,2017-01-15,HOU,BRK,2017,119.5
42,42,42,@,W 137-112 ,240,52,82,0.634,45,65,0.692,7,17,0.412,26,35,0.743,137,38,91,0.418,27,63,0.429,11,28,0.393,25,30,0.833,112,2017-02-04,MIL,PHO,2017,117.5
43,43,43,Home,W 137-101 ,240,49,88,0.557,39,64,0.609,10,24,0.417,29,34,0.853,137,35,93,0.376,26,67,0.388,9,26,0.346,22,28,0.786,101,2017-02-15,PHO,LAL,2017,105.5
44,44,44,Home,W 136-103 ,240,46,80,0.575,32,46,0.696,14,34,0.412,30,40,0.75,136,38,80,0.475,26,53,0.491,12,27,0.444,15,24,0.625,103,2013-03-03,HOU,DAL,2013,109.0
45,45,45,@,W 136-106 ,240,53,86,0.616,40,65,0.615,13,21,0.619,17,21,0.81,136,44,84,0.524,38,65,0.585,6,19,0.316,12,15,0.8,106,2013-03-08,POR,SAS,2013,109.0
46,46,46,@,W 136-130 (2OT),290,53,108,0.491,47,84,0.56,6,24,0.25,24,29,0.828,136,40,97,0.412,32,72,0.444,8,25,0.32,42,54,0.778,130,2014-04-16,UTA,MIN,2014,134.0
47,47,47,@,W 136-115 ,240,46,86,0.535,32,58,0.552,14,28,0.5,30,34,0.882,136,39,99,0.394,36,83,0.434,3,16,0.188,34,43,0.791,115,2014-11-16,GSW,LAL,2015,116.5
48,48,48,Home,L 136-139 (2OT),290,47,106,0.443,35,73,0.479,12,33,0.364,30,38,0.789,136,50,110,0.455,42,83,0.506,8,27,0.296,31,38,0.816,139,2015-10-30,ORL,OKC,2016,143.0
49,49,49,Home,W 136-111 ,240,50,88,0.568,32,58,0.552,18,30,0.6,18,22,0.818,136,38,85,0.447,29,61,0.475,9,24,0.375,26,33,0.788,111,2016-04-03,GSW,POR,2016,115.5
50,50,50,@,W 136-130 (2OT),290,52,105,0.495,41,83,0.494,11,22,0.5,21,31,0.677,136,50,108,0.463,38,78,0.487,12,30,0.4,18,26,0.692,130,2016-12-20,ORL,MIA,2017,136.0
51,51,51,@,W 136-106 ,240,54,95,0.568,44,72,0.611,10,23,0.435,18,21,0.857,136,43,88,0.489,29,54,0.537,14,34,0.412,6,7,0.857,106,2017-03-04,DET,PHI,2017,113.0
52,52,52,Home,W 135-98 ,240,52,86,0.605,39,58,0.672,13,28,0.464,18,27,0.667,135,35,83,0.422,29,64,0.453,6,19,0.316,22,31,0.71,98,2013-11-16,NOP,PHI,2014,101.0
53,53,53,Home,W 135-129 (OT),265,49,89,0.551,41,73,0.562,8,16,0.5,29,33,0.879,135,48,97,0.495,42,77,0.545,6,20,0.3,27,32,0.844,129,2014-12-27,SAC,NYK,2015,132.0
54,54,54,@,W 135-131 ,240,56,91,0.615,52,76,0.684,4,15,0.267,19,24,0.792,135,45,93,0.484,31,62,0.5,14,31,0.452,27,33,0.818,131,2015-04-01,DAL,OKC,2015,138.0
55,55,55,@,W 135-116 ,240,46,81,0.568,24,43,0.558,22,38,0.579,21,31,0.677,135,45,92,0.489,35,66,0.53,10,26,0.385,16,23,0.696,116,2015-11-27,GSW,PHO,2016,121.0
56,56,56,Home,W 135-90 ,240,51,87,0.586,37,59,0.627,14,28,0.5,19,26,0.731,135,34,86,0.395,26,58,0.448,8,28,0.286,14,20,0.7,90,2016-12-17,GSW,POR,2017,94.0
57,57,57,Home,L 135-140 (OT),265,50,99,0.505,38,70,0.543,12,29,0.414,23,26,0.885,135,49,92,0.533,30,54,0.556,19,38,0.5,23,28,0.821,140,2017-02-06,WAS,CLE,2017,149.5
58,58,58,@,W 135-130 ,240,47,86,0.547,22,40,0.55,25,46,0.543,16,20,0.8,135,49,91,0.538,39,65,0.6,10,26,0.385,22,30,0.733,130,2017-03-03,CLE,ATL,2017,135.0
59,59,59,@,W 134-126 (OT),265,48,92,0.522,34,62,0.548,14,30,0.467,24,26,0.923,134,41,97,0.423,25,67,0.373,16,30,0.533,28,36,0.778,126,2012-12-10,SAS,HOU,2013,134.0
60,60,60,Home,W 134-104 ,240,54,93,0.581,33,60,0.55,21,33,0.636,5,7,0.714,134,34,79,0.43,27,63,0.429,7,16,0.438,29,36,0.806,104,2014-01-02,POR,CHA,2014,107.5
61,61,61,@,W 134-108 ,240,52,104,0.5,34,69,0.493,18,35,0.514,12,25,0.48,134,41,84,0.488,27,57,0.474,14,27,0.519,12,15,0.8,108,2014-02-19,HOU,LAL,2014,115.0
62,62,62,@,W 134-129 (3OT),315,51,108,0.472,46,86,0.535,5,22,0.227,27,37,0.73,134,45,100,0.45,33,70,0.471,12,30,0.4,27,36,0.75,129,2014-02-27,WAS,TOR,2014,135.0
63,63,63,Home,W 134-126 ,240,54,99,0.545,40,75,0.533,14,24,0.583,12,21,0.571,134,45,97,0.464,33,70,0.471,12,27,0.444,24,30,0.8,126,2014-03-07,DEN,LAL,2014,132.0
64,64,64,@,L 134-137 (OT),265,46,90,0.511,33,63,0.524,13,27,0.481,29,35,0.829,134,41,99,0.414,30,64,0.469,11,35,0.314,44,49,0.898,137,2014-12-31,PHO,OKC,2015,142.5
65,65,65,@,W 134-120 ,240,46,84,0.548,29,54,0.537,17,30,0.567,25,35,0.714,134,46,100,0.46,38,78,0.487,8,22,0.364,20,23,0.87,120,2015-10-31,GSW,NOP,2016,124.0
66,66,66,@,W 134-121 ,240,49,93,0.527,29,52,0.558,20,41,0.488,16,29,0.552,134,46,91,0.505,38,68,0.559,8,23,0.348,21,30,0.7,121,2016-02-03,GSW,WAS,2016,125.0
67,67,67,@,L 134-139 (OT),265,44,85,0.518,32,55,0.582,12,30,0.4,34,50,0.68,134,47,95,0.495,34,62,0.548,13,33,0.394,32,37,0.865,139,2016-02-10,LAC,BOS,2016,145.5
68,68,68,Home,W 134-95 ,240,51,94,0.543,36,58,0.621,15,36,0.417,17,21,0.81,134,34,87,0.391,29,67,0.433,5,20,0.25,22,27,0.815,95,2016-12-07,HOU,LAL,2017,97.5
69,69,69,Home,W 134-94 ,240,49,81,0.605,39,60,0.65,10,21,0.476,26,29,0.897,134,35,85,0.412,29,65,0.446,6,20,0.3,18,25,0.72,94,2017-01-12,SAS,LAL,2017,97.0
70,70,70,@,L 133-139 (4OT),340,49,126,0.389,43,105,0.41,6,21,0.286,29,35,0.829,133,48,107,0.449,42,88,0.477,6,19,0.316,37,47,0.787,139,2012-03-25,UTA,ATL,2012,142.0
71,71,71,Home,L 133-140 (3OT),315,51,108,0.472,43,84,0.512,8,24,0.333,23,30,0.767,133,46,93,0.495,32,67,0.478,14,26,0.538,34,43,0.791,140,2012-11-12,TOR,UTA,2013,147.0
72,72,72,@,W 133-102 ,240,55,98,0.561,42,74,0.568,13,24,0.542,10,14,0.714,133,35,87,0.402,29,64,0.453,6,23,0.261,26,35,0.743,102,2014-03-28,SAS,DEN,2014,105.0
73,73,73,Home,W 133-132 (2OT),290,49,94,0.521,42,78,0.538,7,16,0.438,28,34,0.824,133,47,102,0.461,38,80,0.475,9,22,0.409,29,32,0.906,132,2014-12-08,WAS,BOS,2015,136.5
74,74,74,Home,W 133-126 ,240,47,90,0.522,34,62,0.548,13,28,0.464,26,34,0.765,133,45,83,0.542,39,65,0.6,6,18,0.333,30,36,0.833,126,2015-04-15,GSW,DEN,2015,129.0
75,75,75,Home,W 133-111 ,240,51,82,0.622,42,62,0.677,9,20,0.45,22,30,0.733,133,42,88,0.477,34,64,0.531,8,24,0.333,19,24,0.792,111,2016-03-27,SAC,DAL,2016,115.0
76,76,76,Home,W 133-120 ,240,45,87,0.517,29,54,0.537,16,33,0.485,27,31,0.871,133,46,90,0.511,38,66,0.576,8,24,0.333,20,26,0.769,120,2016-11-13,GSW,PHO,2017,124.0
77,77,77,Home,W 133-105 ,240,54,94,0.574,37,58,0.638,17,36,0.472,8,9,0.889,133,40,83,0.482,32,64,0.5,8,19,0.421,17,26,0.654,105,2016-12-10,LAC,NOP,2017,109.0
78,78,78,@,W 133-120 ,240,52,99,0.525,38,65,0.585,14,34,0.412,15,18,0.833,133,40,80,0.5,30,55,0.545,10,25,0.4,30,39,0.769,120,2017-02-02,GSW,LAC,2017,125.0
79,79,79,Home,W 133-102 ,240,42,85,0.494,24,49,0.49,18,36,0.5,31,39,0.795,133,37,94,0.394,29,72,0.403,8,22,0.364,20,26,0.769,102,2017-02-11,HOU,PHO,2017,106.0
80,80,80,@,W 132-102 ,240,50,90,0.556,31,56,0.554,19,34,0.559,13,15,0.867,132,37,79,0.468,31,64,0.484,6,15,0.4,22,31,0.71,102,2012-12-08,SAS,CHA,2013,105.0
81,81,81,Home,W 132-114 ,240,54,99,0.545,43,74,0.581,11,25,0.44,13,21,0.619,132,39,83,0.47,25,49,0.51,14,34,0.412,22,32,0.688,114,2013-04-06,DEN,HOU,2013,121.0
82,82,82,@,W 132-128 ,240,38,80,0.475,34,64,0.531,4,16,0.25,52,64,0.813,132,50,95,0.526,38,62,0.613,12,33,0.364,16,25,0.64,128,2014-03-03,MIN,DEN,2014,134.0
83,83,83,@,W 132-125 ,240,46,77,0.597,39,60,0.65,7,17,0.412,33,40,0.825,132,46,85,0.541,36,63,0.571,10,22,0.455,23,31,0.742,125,2014-03-04,NOP,LAL,2014,130.0
84,84,84,@,W 132-129 (2OT),290,47,102,0.461,32,72,0.444,15,30,0.5,23,27,0.852,132,47,103,0.456,39,77,0.506,8,26,0.308,27,34,0.794,129,2014-12-02,DAL,CHI,2015,133.0
85,85,85,@,L 132-133 (2OT),290,47,102,0.461,38,80,0.475,9,22,0.409,29,32,0.906,132,49,94,0.521,42,78,0.538,7,16,0.438,28,34,0.824,133,2014-12-08,BOS,WAS,2015,136.5
86,86,86,Home,W 132-114 ,240,52,101,0.515,46,79,0.582,6,22,0.273,22,30,0.733,132,41,89,0.461,30,55,0.545,11,34,0.324,21,27,0.778,114,2015-10-30,SAC,LAL,2016,119.5
87,87,87,@,W 132-98 ,240,46,85,0.541,27,45,0.6,19,40,0.475,21,27,0.778,132,37,77,0.481,30,58,0.517,7,19,0.368,17,25,0.68,98,2016-01-18,GSW,CLE,2016,101.5
88,88,88,@,L 132-140 (OT),265,44,88,0.5,33,56,0.589,11,32,0.344,33,52,0.635,132,47,91,0.516,25,54,0.463,22,37,0.595,24,33,0.727,140,2016-01-18,HOU,LAC,2016,151.0
89,89,89,Home,W 132-118 ,240,52,76,0.684,42,58,0.724,10,18,0.556,18,22,0.818,132,45,92,0.489,36,66,0.545,9,26,0.346,19,26,0.731,118,2016-03-05,MIN,BRK,2016,122.5
90,90,90,Home,W 132-120 (OT),265,49,89,0.551,34,64,0.531,15,25,0.6,19,23,0.826,132,42,104,0.404,24,58,0.414,18,46,0.391,18,28,0.643,120,2016-03-20,DAL,POR,2016,129.0
91,91,91,@,W 132-129 (2OT),290,51,96,0.531,43,70,0.614,8,26,0.308,22,22,1.0,132,50,100,0.5,37,71,0.521,13,29,0.448,16,23,0.696,129,2016-03-25,MIN,WAS,2016,135.5
92,92,92,@,W 132-129 (OT),265,48,95,0.505,35,69,0.507,13,26,0.5,23,29,0.793,132,48,101,0.475,36,67,0.537,12,34,0.353,21,27,0.778,129,2016-11-25,OKC,DEN,2017,135.0
93,93,93,@,W 132-127 (2OT),290,48,108,0.444,34,64,0.531,14,44,0.318,22,30,0.733,132,43,104,0.413,31,60,0.517,12,44,0.273,29,37,0.784,127,2016-12-01,HOU,GSW,2017,133.0
94,94,94,Home,W 132-98 ,240,50,85,0.588,28,43,0.651,22,42,0.524,10,16,0.625,132,39,92,0.424,28,60,0.467,11,32,0.344,9,11,0.818,98,2016-12-14,HOU,SAC,2017,103.5
95,95,95,Home,W 132-120 ,240,43,84,0.512,28,53,0.528,15,31,0.484,31,35,0.886,132,41,88,0.466,33,65,0.508,8,23,0.348,30,36,0.833,120,2016-12-15,DEN,POR,2017,124.0
96,96,96,Home,W 132-113 ,240,52,97,0.536,41,69,0.594,11,28,0.393,17,21,0.81,132,40,86,0.465,23,50,0.46,17,36,0.472,16,20,0.8,113,2017-01-13,TOR,BRK,2017,121.5
97,97,97,@,W 132-117 ,240,46,84,0.548,30,48,0.625,16,36,0.444,24,26,0.923,132,41,82,0.5,28,57,0.491,13,25,0.52,22,26,0.846,117,2017-02-08,CLE,IND,2017,123.5
98,98,98,Home,W 132-110 ,240,48,88,0.545,24,47,0.511,24,41,0.585,12,16,0.75,132,45,92,0.489,37,60,0.617,8,32,0.25,12,13,0.923,110,2017-02-13,DEN,GSW,2017,114.0
99,99,99,@,W 131-102 ,240,56,89,0.629,51,79,0.646,5,10,0.5,14,20,0.7,131,40,89,0.449,30,62,0.484,10,27,0.37,12,19,0.632,102,2012-04-26,DEN,MIN,2012,107.0
100,100,0,Home,W 131-103 ,240,46,89,0.517,32,64,0.5,14,25,0.56,25,28,0.893,131,37,86,0.43,20,47,0.426,17,39,0.436,12,14,0.857,103,2012-11-23,HOU,NYK,2013,111.5
101,101,1,Home,W 131-99 ,240,45,91,0.495,32,68,0.471,13,23,0.565,28,35,0.8,131,33,82,0.402,26,58,0.448,7,24,0.292,26,31,0.839,99,2012-12-07,UTA,TOR,2013,102.5
102,102,2,Home,W 131-127 ,240,43,86,0.5,32,67,0.478,11,19,0.579,34,42,0.81,131,46,92,0.5,33,66,0.5,13,26,0.5,22,25,0.88,127,2012-12-19,SAC,GSW,2013,133.5
103,103,3,Home,W 131-102 ,240,51,100,0.51,37,73,0.507,14,27,0.519,15,17,0.882,131,37,73,0.507,31,54,0.574,6,19,0.316,22,28,0.786,102,2013-04-01,MIL,CHA,2013,105.0
104,104,4,@,W 131-128 (3OT),315,50,113,0.442,39,90,0.433,11,23,0.478,20,27,0.741,131,48,101,0.475,40,78,0.513,8,23,0.348,24,34,0.706,128,2013-12-02,NOP,CHI,2014,132.0
105,105,5,Home,W 131-102 ,240,45,89,0.506,32,59,0.542,13,30,0.433,28,30,0.933,131,37,94,0.394,24,67,0.358,13,27,0.481,15,25,0.6,102,2014-03-13,OKC,LAL,2014,108.5
106,106,6,Home,W 131-109 ,240,42,76,0.553,34,56,0.607,8,20,0.4,39,50,0.78,131,37,82,0.451,28,54,0.519,9,28,0.321,26,31,0.839,109,2014-11-05,SAC,DEN,2015,113.5
107,107,7,Home,W 131-117 ,240,52,94,0.553,44,68,0.647,8,26,0.308,19,23,0.826,131,43,86,0.5,36,69,0.522,7,17,0.412,24,29,0.828,117,2014-11-15,DAL,MIN,2015,120.5
108,108,8,@,W 131-106 ,240,50,91,0.549,41,69,0.594,9,22,0.409,22,33,0.667,131,37,88,0.42,30,65,0.462,7,23,0.304,25,34,0.735,106,2015-01-17,GSW,HOU,2015,109.5
109,109,9,Home,W 131-108 ,240,46,88,0.523,38,68,0.559,8,20,0.4,31,38,0.816,131,42,90,0.467,30,58,0.517,12,32,0.375,12,17,0.706,108,2015-02-08,OKC,LAC,2015,114.0
110,110,10,Home,L 131-135 ,240,45,93,0.484,31,62,0.5,14,31,0.452,27,33,0.818,131,56,91,0.615,52,76,0.684,4,15,0.267,19,24,0.792,135,2015-04-01,OKC,DAL,2015,137.0
111,111,11,Home,W 131-99 ,240,49,82,0.598,32,49,0.653,17,33,0.515,16,19,0.842,131,39,80,0.488,29,57,0.509,10,23,0.435,11,17,0.647,99,2015-04-04,ATL,BRK,2015,104.0
112,112,12,@,W 131-123 ,240,52,95,0.547,36,60,0.6,16,35,0.457,11,15,0.733,131,44,100,0.44,30,67,0.448,14,33,0.424,21,26,0.808,123,2015-12-08,GSW,IND,2016,130.0
113,113,13,Home,W 131-123 ,240,43,86,0.5,35,64,0.547,8,22,0.364,37,40,0.925,131,49,100,0.49,39,84,0.464,10,16,0.625,15,22,0.682,123,2015-12-29,OKC,MIL,2016,128.0
114,114,14,@,W 131-116 ,240,47,82,0.573,33,48,0.688,14,34,0.412,23,26,0.885,131,48,107,0.449,41,82,0.5,7,25,0.28,13,19,0.684,116,2016-02-29,OKC,SAC,2016,119.5
115,115,15,Home,W 131-114 ,240,47,90,0.522,37,66,0.561,10,24,0.417,27,31,0.871,131,41,88,0.466,30,58,0.517,11,30,0.367,21,26,0.808,114,2016-03-15,BRK,PHI,2016,119.5
116,116,16,Home,W 131-109 ,240,51,94,0.543,39,62,0.629,12,32,0.375,17,19,0.895,131,36,72,0.5,30,58,0.517,6,14,0.429,31,35,0.886,109,2016-11-30,POR,IND,2017,112.0
117,117,17,@,W 131-120 ,240,51,87,0.586,36,53,0.679,15,34,0.441,14,20,0.7,131,45,89,0.506,34,61,0.557,11,28,0.393,19,21,0.905,120,2016-12-13,ORL,ATL,2017,125.5
118,118,18,Home,W 131-115 ,240,46,92,0.5,31,49,0.633,15,43,0.349,24,30,0.8,131,43,101,0.426,36,71,0.507,7,30,0.233,22,27,0.815,115,2016-12-26,HOU,PHO,2017,118.5
119,119,19,@,W 131-123 ,240,54,95,0.568,38,63,0.603,16,32,0.5,7,10,0.7,131,52,93,0.559,36,55,0.655,16,38,0.421,3,5,0.6,123,2017-02-10,DEN,NYK,2017,131.0
120,120,20,@,W 131-127 ,240,41,90,0.456,34,72,0.472,7,18,0.389,42,53,0.792,131,44,88,0.5,31,61,0.508,13,27,0.481,26,33,0.788,127,2017-03-07,WAS,PHO,2017,133.5
121,121,21,Home,W 130-102 ,240,51,84,0.607,42,64,0.656,9,20,0.45,19,23,0.826,130,39,85,0.459,32,64,0.5,7,21,0.333,17,19,0.895,102,2013-03-01,SAS,SAC,2013,105.5
122,122,22,Home,W 130-98 ,240,46,83,0.554,29,60,0.483,17,23,0.739,21,24,0.875,130,39,93,0.419,35,82,0.427,4,11,0.364,16,19,0.842,98,2013-12-06,POR,UTA,2014,100.0
123,123,23,Home,W 130-94 ,240,47,78,0.603,26,43,0.605,21,35,0.6,15,26,0.577,130,37,90,0.411,29,60,0.483,8,30,0.267,12,20,0.6,94,2013-12-16,BRK,PHI,2014,98.0
124,124,24,@,W 130-110 ,240,48,84,0.571,36,64,0.563,12,20,0.6,22,29,0.759,130,43,88,0.489,35,64,0.547,8,24,0.333,16,23,0.696,110,2014-02-24,MIL,PHI,2014,114.0
125,125,25,Home,W 130-102 ,240,52,90,0.578,35,57,0.614,17,33,0.515,9,9,1.0,130,39,86,0.453,35,73,0.479,4,13,0.308,20,28,0.714,102,2014-04-06,GSW,UTA,2014,104.0
126,126,26,Home,W 130-125 (OT),265,45,98,0.459,32,62,0.516,13,36,0.361,27,40,0.675,130,51,107,0.477,37,76,0.487,14,31,0.452,9,13,0.692,125,2014-04-06,HOU,DEN,2014,132.0
127,127,27,Home,L 130-145 ,240,44,95,0.463,30,63,0.476,14,32,0.438,28,35,0.8,130,56,97,0.577,45,71,0.634,11,26,0.423,22,28,0.786,145,2014-04-08,LAL,HOU,2014,150.5
128,128,28,Home,W 130-120 ,240,49,101,0.485,34,64,0.531,15,37,0.405,17,19,0.895,130,43,81,0.531,35,66,0.53,8,15,0.533,26,33,0.788,120,2014-04-14,GSW,MIN,2014,124.0
129,129,29,Home,L 130-136 (2OT),290,40,97,0.412,32,72,0.444,8,25,0.32,42,54,0.778,130,53,108,0.491,47,84,0.56,6,24,0.25,24,29,0.828,136,2014-04-16,MIN,UTA,2014,139.0
130,130,30,@,W 130-113 ,240,45,88,0.511,29,55,0.527,16,33,0.485,24,29,0.828,130,39,90,0.433,31,67,0.463,8,23,0.348,27,33,0.818,113,2014-11-12,POR,DEN,2015,117.0
131,131,31,Home,W 130-105 ,240,53,88,0.602,33,52,0.635,20,36,0.556,4,7,0.571,130,39,81,0.481,31,61,0.508,8,20,0.4,19,20,0.95,105,2015-03-09,ATL,SAC,2015,109.0
132,132,32,Home,W 130-91 ,240,51,88,0.58,38,67,0.567,13,21,0.619,15,19,0.789,130,36,90,0.4,30,72,0.417,6,18,0.333,13,14,0.929,91,2015-03-25,SAS,OKC,2015,94.0
133,133,33,Home,W 130-105 ,240,47,91,0.516,33,68,0.485,14,23,0.609,22,23,0.957,130,44,90,0.489,30,60,0.5,14,30,0.467,3,8,0.375,105,2015-11-03,CHA,CHI,2016,112.0
134,134,34,@,W 130-125 ,240,44,78,0.564,33,54,0.611,11,24,0.458,31,39,0.795,130,45,96,0.469,28,61,0.459,17,35,0.486,18,22,0.818,125,2015-12-20,NOP,DEN,2016,133.5
135,135,35,Home,W 130-99 ,240,49,81,0.605,37,58,0.638,12,23,0.522,20,25,0.8,130,41,89,0.461,32,66,0.485,9,23,0.391,8,17,0.471,99,2016-01-02,LAC,PHI,2016,103.5
136,136,36,Home,W 130-99 ,240,50,90,0.556,38,67,0.567,12,23,0.522,18,21,0.857,130,28,73,0.384,20,43,0.465,8,30,0.267,35,52,0.673,99,2016-01-27,SAS,HOU,2016,103.0
137,137,37,@,W 130-114 ,240,53,88,0.602,40,63,0.635,13,25,0.52,11,16,0.688,130,41,90,0.456,31,64,0.484,10,26,0.385,22,28,0.786,114,2016-02-25,GSW,ORL,2016,119.0
138,138,38,Home,W 130-116 ,240,49,86,0.57,39,70,0.557,10,16,0.625,22,25,0.88,130,41,77,0.532,36,55,0.655,5,22,0.227,29,37,0.784,116,2016-02-28,ORL,PHI,2016,118.5
139,139,39,Home,W 130-81 ,240,46,85,0.541,30,52,0.577,16,33,0.485,22,34,0.647,130,30,101,0.297,26,84,0.31,4,17,0.235,17,28,0.607,81,2016-03-14,HOU,MEM,2016,83.0
140,140,40,@,W 130-109 ,240,47,96,0.49,35,67,0.522,12,29,0.414,24,30,0.8,130,40,93,0.43,35,74,0.473,5,19,0.263,24,27,0.889,109,2016-03-16,OKC,BOS,2016,111.5
141,141,41,@,W 130-112 ,240,48,95,0.505,26,57,0.456,22,38,0.579,12,14,0.857,130,41,93,0.441,32,64,0.5,9,29,0.31,21,22,0.955,112,2016-03-18,GSW,DAL,2016,116.5
142,142,42,Home,W 130-110 ,240,50,98,0.51,33,57,0.579,17,41,0.415,13,18,0.722,130,41,83,0.494,29,55,0.527,12,28,0.429,16,19,0.842,110,2016-04-10,HOU,LAL,2016,116.0
143,143,43,Home,W 130-121 (OT),265,47,93,0.505,37,74,0.5,10,19,0.526,26,34,0.765,130,45,104,0.433,27,56,0.482,18,48,0.375,13,18,0.722,121,2016-10-26,IND,DAL,2017,130.0
144,144,44,@,W 130-114 ,240,46,82,0.561,29,46,0.63,17,36,0.472,21,28,0.75,130,40,83,0.482,28,50,0.56,12,33,0.364,22,29,0.759,114,2016-11-27,HOU,POR,2017,120.0
145,145,45,Home,W 130-101 ,240,50,94,0.532,36,68,0.529,14,26,0.538,16,18,0.889,130,36,87,0.414,29,60,0.483,7,27,0.259,22,25,0.88,101,2016-12-10,SAS,BRK,2017,104.5
146,146,46,Home,L 130-136 (2OT),290,50,108,0.463,38,78,0.487,12,30,0.4,18,26,0.692,130,52,105,0.495,41,83,0.494,11,22,0.5,21,31,0.677,136,2016-12-20,MIA,ORL,2017,141.5
147,147,47,@,W 130-114 ,240,46,87,0.529,33,56,0.589,13,31,0.419,25,35,0.714,130,40,83,0.482,34,59,0.576,6,24,0.25,28,36,0.778,114,2017-02-11,GSW,OKC,2017,117.0
148,148,48,@,L 130-142 ,240,49,94,0.521,40,68,0.588,9,26,0.346,23,28,0.821,130,44,94,0.468,22,36,0.611,22,58,0.379,32,42,0.762,142,2017-02-25,MIN,HOU,2017,153.0
149,149,49,Home,W 130-112 ,240,48,86,0.558,36,61,0.59,12,25,0.48,22,29,0.759,130,43,83,0.518,36,62,0.581,7,21,0.333,19,24,0.792,112,2017-02-28,MEM,PHO,2017,115.5
150,150,50,Home,L 130-135 ,240,49,91,0.538,39,65,0.6,10,26,0.385,22,30,0.733,130,47,86,0.547,22,40,0.55,25,46,0.543,16,20,0.8,135,2017-03-03,ATL,CLE,2017,147.5
151,151,51,Home,W 130-116 ,240,49,86,0.57,33,61,0.541,16,25,0.64,16,22,0.727,130,45,86,0.523,31,56,0.554,14,30,0.467,12,17,0.706,116,2017-03-04,POR,BRK,2017,123.0
152,152,52,Home,W 129-90 ,240,48,80,0.6,41,69,0.594,7,11,0.636,26,31,0.839,129,35,92,0.38,29,74,0.392,6,18,0.333,14,21,0.667,90,2012-01-01,MIA,CHA,2012,93.0
153,153,53,Home,W 129-91 ,240,47,84,0.56,27,54,0.5,20,30,0.667,15,19,0.789,129,34,74,0.459,29,60,0.483,5,14,0.357,18,29,0.621,91,2012-12-23,SAS,DAL,2013,93.5
154,154,54,@,L 129-141 (2OT),290,48,93,0.516,34,66,0.515,14,27,0.519,19,26,0.731,129,56,101,0.554,46,78,0.59,10,23,0.435,19,24,0.792,141,2013-02-26,SAC,MIA,2013,146.0
155,155,55,Home,W 129-97 ,240,50,80,0.625,36,52,0.692,14,28,0.5,15,25,0.6,129,30,64,0.469,19,41,0.463,11,23,0.478,26,42,0.619,97,2013-03-10,LAC,DET,2013,102.5
156,156,56,Home,W 129-98 ,240,43,83,0.518,29,52,0.558,14,31,0.452,29,38,0.763,129,35,91,0.385,31,73,0.425,4,18,0.222,24,32,0.75,98,2014-01-07,DEN,BOS,2014,100.0
157,157,57,Home,W 129-127 ,240,42,83,0.506,25,49,0.51,17,34,0.5,28,37,0.757,129,51,97,0.526,39,72,0.542,12,25,0.48,13,21,0.619,127,2014-01-15,LAC,DAL,2014,133.0
158,158,58,Home,W 129-121 (2OT),290,49,99,0.495,40,83,0.482,9,16,0.563,22,26,0.846,129,45,95,0.474,30,61,0.492,15,34,0.441,16,23,0.696,121,2014-02-21,ORL,NYK,2014,128.5
159,159,59,@,W 129-103 ,240,41,72,0.569,30,50,0.6,11,22,0.5,36,42,0.857,129,36,90,0.4,31,72,0.431,5,18,0.278,26,31,0.839,103,2014-02-25,HOU,SAC,2014,105.5
160,160,60,Home,L 129-134 (3OT),315,45,100,0.45,33,70,0.471,12,30,0.4,27,36,0.75,129,51,108,0.472,46,86,0.535,5,22,0.227,27,37,0.73,134,2014-02-27,TOR,WAS,2014,136.5
161,161,61,Home,W 129-120 ,240,44,80,0.55,29,56,0.518,15,24,0.625,26,30,0.867,129,44,84,0.524,30,53,0.566,14,31,0.452,18,26,0.692,120,2014-03-02,PHO,ATL,2014,127.0
162,162,62,Home,W 129-106 ,240,49,85,0.576,33,47,0.702,16,38,0.421,15,19,0.789,129,38,87,0.437,26,59,0.441,12,28,0.429,18,23,0.783,106,2014-03-20,HOU,MIN,2014,112.0
163,163,63,Home,W 129-122 (OT),265,47,96,0.49,37,72,0.514,10,24,0.417,25,34,0.735,129,45,104,0.433,36,70,0.514,9,34,0.265,23,31,0.742,122,2014-11-30,LAL,TOR,2015,126.5
164,164,64,Home,L 129-132 (2OT),290,47,103,0.456,39,77,0.506,8,26,0.308,27,34,0.794,129,47,102,0.461,32,72,0.444,15,30,0.5,23,27,0.852,132,2014-12-02,CHI,DAL,2015,139.5
165,165,65,@,W 129-119 (3OT),315,47,110,0.427,34,75,0.453,13,35,0.371,22,23,0.957,129,45,109,0.413,37,89,0.416,8,20,0.4,21,26,0.808,119,2014-12-19,POR,SAS,2015,123.0
166,166,66,Home,W 129-120 ,240,40,74,0.541,34,62,0.548,6,12,0.5,43,47,0.915,129,44,100,0.44,35,70,0.5,9,30,0.3,23,32,0.719,120,2014-12-22,CHI,TOR,2015,124.5
167,167,67,@,L 129-135 (OT),265,48,97,0.495,42,77,0.545,6,20,0.3,27,32,0.844,129,49,89,0.551,41,73,0.562,8,16,0.5,29,33,0.879,135,2014-12-27,NYK,SAC,2015,139.0
168,168,68,Home,W 129-90 ,240,46,89,0.517,31,61,0.508,15,28,0.536,22,28,0.786,129,36,89,0.404,34,73,0.466,2,16,0.125,16,24,0.667,90,2015-01-23,CLE,CHO,2015,91.0
169,169,69,Home,W 129-99 ,240,51,84,0.607,35,56,0.625,16,28,0.571,11,16,0.688,129,41,82,0.5,29,50,0.58,12,32,0.375,5,12,0.417,99,2015-03-13,DAL,LAC,2015,105.0
170,170,70,Home,W 129-127 (3OT),315,46,107,0.43,35,82,0.427,11,25,0.44,26,34,0.765,129,49,129,0.38,41,113,0.363,8,16,0.5,21,29,0.724,127,2015-03-20,BRK,MIL,2015,131.0
171,171,71,@,W 129-116 ,240,48,89,0.539,30,51,0.588,18,38,0.474,15,16,0.938,129,43,87,0.494,40,78,0.513,3,9,0.333,27,36,0.75,116,2015-11-12,GSW,MIN,2016,117.5
172,172,72,@,W 129-118 ,240,44,77,0.571,34,54,0.63,10,23,0.435,31,37,0.838,129,42,88,0.477,29,57,0.509,13,31,0.419,21,27,0.778,118,2015-11-25,SAC,MIL,2016,124.5
173,173,73,Home,W 129-126 ,240,46,91,0.505,36,65,0.554,10,26,0.385,27,38,0.711,129,48,82,0.585,39,62,0.629,9,20,0.45,21,30,0.7,126,2016-01-17,DEN,IND,2016,130.5
174,174,74,@,W 129-128 (2OT),290,44,110,0.4,24,66,0.364,20,44,0.455,21,26,0.808,129,48,91,0.527,41,68,0.603,7,23,0.304,25,32,0.781,128,2016-01-25,CHA,SAC,2016,131.5
175,175,75,Home,W 129-103 ,240,41,85,0.482,28,51,0.549,13,34,0.382,34,36,0.944,129,37,77,0.481,25,49,0.51,12,28,0.429,17,27,0.63,103,2016-02-21,DAL,PHI,2016,109.0
176,176,76,Home,W 129-111 ,240,52,77,0.675,46,65,0.708,6,12,0.5,19,25,0.76,129,41,90,0.456,30,67,0.448,11,23,0.478,18,26,0.692,111,2016-03-01,MIA,CHI,2016,116.5
177,177,77,Home,L 129-132 (2OT),290,50,100,0.5,37,71,0.521,13,29,0.448,16,23,0.696,129,51,96,0.531,43,70,0.614,8,26,0.308,22,22,1.0,132,2016-03-25,WAS,MIN,2016,136.0
178,178,78,Home,W 129-105 ,240,48,86,0.558,37,59,0.627,11,27,0.407,22,27,0.815,129,35,91,0.385,21,54,0.389,14,37,0.378,21,26,0.808,105,2016-04-10,IND,BRK,2016,112.0
179,179,79,@,W 129-105 ,240,48,86,0.558,33,56,0.589,15,30,0.5,18,26,0.692,129,38,83,0.458,33,62,0.532,5,21,0.238,24,33,0.727,105,2016-04-11,HOU,MIN,2016,107.5
180,180,80,@,W 129-100 ,240,47,98,0.48,35,74,0.473,12,24,0.5,23,26,0.885,129,40,85,0.471,33,52,0.635,7,33,0.212,13,18,0.722,100,2016-10-25,SAS,GSW,2017,103.5
181,181,81,@,W 129-109 ,240,49,85,0.576,34,49,0.694,15,36,0.417,16,21,0.762,129,37,93,0.398,27,58,0.466,10,35,0.286,25,31,0.806,109,2016-11-20,POR,BRK,2017,114.0
182,182,82,Home,L 129-132 (OT),265,48,101,0.475,36,67,0.537,12,34,0.353,21,27,0.778,129,48,95,0.505,35,69,0.507,13,26,0.5,23,29,0.793,132,2016-11-25,DEN,OKC,2017,138.5
183,183,83,Home,W 129-122 ,240,42,92,0.457,21,37,0.568,21,55,0.382,24,29,0.828,129,47,105,0.448,37,73,0.507,10,32,0.313,18,25,0.72,122,2016-12-31,HOU,NYK,2017,127.0
184,184,84,@,W 129-122 ,240,46,89,0.517,35,51,0.686,11,38,0.289,26,31,0.839,129,42,78,0.538,31,53,0.585,11,25,0.44,27,30,0.9,122,2017-01-08,HOU,TOR,2017,127.5
185,185,85,Home,W 129-109 ,240,47,92,0.511,38,72,0.528,9,20,0.45,26,32,0.813,129,41,85,0.482,34,64,0.531,7,21,0.333,20,25,0.8,109,2017-01-28,MIN,BRK,2017,112.5
186,186,86,@,W 129-125 ,240,50,88,0.568,43,73,0.589,7,15,0.467,22,32,0.688,129,46,88,0.523,32,52,0.615,14,36,0.389,19,23,0.826,125,2017-02-15,MIL,BRK,2017,132.0
187,187,87,@,W 129-99 ,240,45,91,0.495,25,40,0.625,20,51,0.392,19,24,0.792,129,36,86,0.419,30,55,0.545,6,31,0.194,21,26,0.808,99,2017-02-23,HOU,NOP,2017,102.0
188,188,88,Home,W 129-109 ,240,49,97,0.505,35,66,0.53,14,31,0.452,17,24,0.708,129,41,83,0.494,31,53,0.585,10,30,0.333,17,31,0.548,109,2017-02-24,DEN,BRK,2017,114.0
189,189,89,Home,W 128-95 ,240,50,92,0.543,42,76,0.553,8,16,0.5,20,27,0.741,128,36,87,0.414,30,68,0.441,6,19,0.316,17,22,0.773,95,2012-01-21,MEM,SAC,2012,98.0
190,190,90,Home,W 128-103 ,240,51,84,0.607,42,66,0.636,9,18,0.5,17,21,0.81,128,36,77,0.468,31,65,0.477,5,12,0.417,26,35,0.743,103,2012-04-06,SAS,NOH,2012,105.5
191,191,91,@,W 128-99 ,240,45,80,0.563,28,43,0.651,17,37,0.459,21,24,0.875,128,38,87,0.437,29,69,0.42,9,18,0.5,14,19,0.737,99,2013-01-12,MIA,SAC,2013,103.5
192,192,92,Home,W 128-96 ,240,50,86,0.581,41,67,0.612,9,19,0.474,19,23,0.826,128,38,91,0.418,28,64,0.438,10,27,0.37,10,14,0.714,96,2013-02-07,DEN,CHI,2013,101.0
193,193,93,Home,L 128-131 (3OT),315,48,101,0.475,40,78,0.513,8,23,0.348,24,34,0.706,128,50,113,0.442,39,90,0.433,11,23,0.478,20,27,0.741,131,2013-12-02,CHI,NOP,2014,136.5
194,194,94,@,W 128-125 (3OT),315,48,113,0.425,36,80,0.45,12,33,0.364,20,23,0.87,128,53,104,0.51,47,78,0.603,6,26,0.231,13,16,0.813,125,2014-01-15,CHI,ORL,2014,128.0
195,195,95,Home,L 128-132 ,240,50,95,0.526,38,62,0.613,12,33,0.364,16,25,0.64,128,38,80,0.475,34,64,0.531,4,16,0.25,52,64,0.813,132,2014-03-03,DEN,MIN,2014,134.0
196,196,96,Home,W 128-122 ,240,42,80,0.525,27,53,0.509,15,27,0.556,29,39,0.744,128,45,90,0.5,32,57,0.561,13,33,0.394,19,19,1.0,122,2014-03-06,PHO,OKC,2014,128.5
197,197,97,Home,W 128-119 (OT),265,45,90,0.5,30,52,0.577,15,38,0.395,23,28,0.821,128,46,93,0.495,34,60,0.567,12,33,0.364,15,19,0.789,119,2014-03-25,DAL,OKC,2014,125.0
198,198,98,@,W 128-122 (OT),265,44,86,0.512,33,62,0.532,11,24,0.458,29,35,0.829,128,47,101,0.465,39,74,0.527,8,27,0.296,20,25,0.8,122,2014-12-14,GSW,NOP,2015,126.0
199,199,99,Home,W 128-108 ,240,49,91,0.538,40,66,0.606,9,25,0.36,21,24,0.875,128,43,90,0.478,35,73,0.479,8,17,0.471,14,21,0.667,108,2014-12-22,GSW,SAC,2015,112.0
200,200,0,Home,W 128-118 ,240,49,94,0.521,39,70,0.557,10,24,0.417,20,24,0.833,128,48,97,0.495,42,82,0.512,6,15,0.4,16,16,1.0,118,2015-01-21,DET,ORL,2015,121.0
201,201,1,Home,W 128-114 ,240,45,86,0.523,26,48,0.542,19,38,0.5,19,25,0.76,128,41,98,0.418,31,68,0.456,10,30,0.333,22,28,0.786,114,2015-02-04,GSW,DAL,2015,119.0
202,202,2,@,W 128-125 (OT),265,44,91,0.484,30,65,0.462,14,26,0.538,26,30,0.867,128,49,87,0.563,41,61,0.672,8,26,0.308,19,27,0.704,125,2015-03-12,CLE,SAS,2015,129.0
203,203,3,Home,W 128-103 ,240,46,88,0.523,31,56,0.554,15,32,0.469,21,27,0.778,128,41,91,0.451,36,69,0.522,5,22,0.227,16,18,0.889,103,2015-12-16,GSW,PHO,2016,105.5
204,204,4,@,W 128-108 ,240,46,87,0.529,28,55,0.509,18,32,0.563,18,21,0.857,128,38,96,0.396,26,63,0.413,12,33,0.364,20,28,0.714,108,2016-01-08,GSW,POR,2016,114.0
205,205,5,@,W 128-116 ,240,49,87,0.563,30,50,0.6,19,37,0.514,11,15,0.733,128,43,92,0.467,35,69,0.507,8,23,0.348,22,29,0.759,116,2016-01-09,GSW,SAC,2016,120.0
206,206,6,Home,L 128-129 (2OT),290,48,91,0.527,41,68,0.603,7,23,0.304,25,32,0.781,128,44,110,0.4,24,66,0.364,20,44,0.455,21,26,0.808,129,2016-01-25,SAC,CHO,2016,139.0
207,207,7,@,W 128-122 (OT),265,46,99,0.465,35,79,0.443,11,20,0.55,25,29,0.862,128,44,95,0.463,33,72,0.458,11,23,0.478,23,30,0.767,122,2016-01-26,OKC,NYK,2016,127.5
208,208,8,Home,W 128-119 ,240,48,86,0.558,30,58,0.517,18,28,0.643,14,15,0.933,128,45,89,0.506,37,63,0.587,8,26,0.308,21,22,0.955,119,2016-02-05,BRK,SAC,2016,123.0
209,209,9,Home,W 128-119 ,240,51,91,0.56,38,67,0.567,13,24,0.542,13,15,0.867,128,47,95,0.495,37,69,0.536,10,26,0.385,15,19,0.789,119,2016-02-07,BOS,SAC,2016,124.0
210,210,10,Home,W 128-119 ,240,48,85,0.565,35,58,0.603,13,27,0.481,19,29,0.655,128,39,88,0.443,22,49,0.449,17,39,0.436,24,33,0.727,119,2016-02-24,MEM,LAL,2016,127.5
211,211,11,Home,W 128-101 ,240,47,89,0.528,34,53,0.642,13,36,0.361,21,21,1.0,128,34,90,0.378,27,67,0.403,7,23,0.304,26,37,0.703,101,2016-02-28,DAL,MIN,2016,104.5
212,212,12,Home,W 128-121 ,240,48,81,0.593,40,66,0.606,8,15,0.533,24,33,0.727,128,41,87,0.471,26,51,0.51,15,36,0.417,24,35,0.686,121,2016-02-29,MIL,HOU,2016,128.5
213,213,13,@,W 128-97 ,240,46,82,0.561,30,58,0.517,16,24,0.667,20,24,0.833,128,39,89,0.438,30,60,0.5,9,29,0.31,10,15,0.667,97,2016-03-09,NYK,PHO,2016,101.5
214,214,14,Home,W 128-112 ,240,40,89,0.449,22,49,0.449,18,40,0.45,30,39,0.769,128,37,86,0.43,18,50,0.36,19,36,0.528,19,23,0.826,112,2016-03-11,GSW,POR,2016,121.5
215,215,15,Home,W 128-94 ,240,49,83,0.59,40,66,0.606,9,17,0.529,21,26,0.808,128,31,91,0.341,24,64,0.375,7,27,0.259,25,27,0.926,94,2016-03-14,OKC,POR,2016,97.5
216,216,16,Home,W 128-120 ,240,43,88,0.489,22,43,0.512,21,45,0.467,21,23,0.913,128,43,96,0.448,25,61,0.41,18,35,0.514,16,21,0.762,120,2016-03-25,GSW,DAL,2016,129.0
217,217,17,Home,W 128-120 ,240,43,83,0.518,27,51,0.529,16,32,0.5,26,31,0.839,128,43,90,0.478,26,46,0.565,17,44,0.386,17,25,0.68,120,2016-11-01,CLE,HOU,2017,128.5
218,218,18,Home,W 128-122 ,240,41,84,0.488,27,50,0.54,14,34,0.412,32,37,0.865,128,46,96,0.479,35,64,0.547,11,32,0.344,19,22,0.864,122,2016-11-03,CLE,BOS,2017,127.5
219,219,19,Home,W 128-90 ,240,43,85,0.506,23,42,0.548,20,43,0.465,22,24,0.917,128,37,91,0.407,29,56,0.518,8,35,0.229,8,12,0.667,90,2016-11-25,CLE,DAL,2017,94.0
220,220,20,@,W 128-110 ,240,45,88,0.511,28,51,0.549,17,37,0.459,21,25,0.84,128,46,104,0.442,37,73,0.507,9,31,0.29,9,16,0.563,110,2016-12-02,HOU,DEN,2017,114.5
221,221,21,Home,W 128-84 ,240,53,92,0.576,40,68,0.588,13,24,0.542,9,11,0.818,128,35,88,0.398,28,60,0.467,7,28,0.25,7,14,0.5,84,2016-12-03,TOR,ATL,2017,87.5
222,222,22,@,W 128-119 (OT),265,50,103,0.485,37,70,0.529,13,33,0.394,15,19,0.789,128,41,83,0.494,33,53,0.623,8,30,0.267,29,39,0.744,119,2017-01-06,MEM,GSW,2017,123.0
223,223,23,Home,W 128-98 ,240,50,89,0.562,34,55,0.618,16,34,0.471,12,15,0.8,128,38,87,0.437,29,62,0.468,9,25,0.36,13,18,0.722,98,2017-01-27,BOS,ORL,2017,102.5
224,224,24,@,W 128-100 ,240,49,81,0.605,43,66,0.652,6,15,0.4,24,30,0.8,128,38,100,0.38,28,63,0.444,10,37,0.27,14,17,0.824,100,2017-02-01,CHI,OKC,2017,105.0
225,225,25,Home,W 128-104 ,240,44,89,0.494,28,51,0.549,16,38,0.421,24,36,0.667,128,42,88,0.477,36,63,0.571,6,25,0.24,14,20,0.7,104,2017-02-07,HOU,ORL,2017,107.0
226,226,26,Home,W 128-121 (OT),265,46,98,0.469,34,72,0.472,12,26,0.462,24,31,0.774,128,49,93,0.527,41,69,0.594,8,24,0.333,15,25,0.6,121,2017-02-24,CHI,PHO,2017,125.0
227,227,27,@,W 127-124 ,240,50,89,0.562,36,67,0.537,14,22,0.636,13,21,0.619,127,46,89,0.517,37,68,0.544,9,21,0.429,23,29,0.793,124,2012-03-12,MIN,PHO,2012,128.5
228,228,28,@,W 127-102 ,240,47,80,0.588,39,59,0.661,8,21,0.381,25,31,0.806,127,41,92,0.446,35,71,0.493,6,21,0.286,14,20,0.7,102,2012-04-18,SAS,SAC,2012,105.0
229,229,29,@,L 127-131 ,240,46,92,0.5,33,66,0.5,13,26,0.5,22,25,0.88,127,43,86,0.5,32,67,0.478,11,19,0.579,34,42,0.81,131,2012-12-19,GSW,SAC,2013,136.5
230,230,30,Home,W 127-96 ,240,50,87,0.575,36,66,0.545,14,21,0.667,13,18,0.722,127,39,83,0.47,32,65,0.492,7,18,0.389,11,15,0.733,96,2013-02-08,OKC,PHO,2013,99.5
231,231,31,Home,W 127-111 ,240,48,83,0.578,39,69,0.565,9,14,0.643,22,22,1.0,127,41,85,0.482,35,68,0.515,6,17,0.353,23,29,0.793,111,2013-02-22,OKC,MIN,2013,114.0
232,232,32,Home,W 127-105 ,240,48,93,0.516,34,72,0.472,14,21,0.667,17,20,0.85,127,42,88,0.477,36,67,0.537,6,21,0.286,15,20,0.75,105,2013-03-16,WAS,PHO,2013,108.0
233,233,33,@,W 127-113 ,240,51,89,0.573,38,67,0.567,13,22,0.591,12,14,0.857,127,42,75,0.56,34,54,0.63,8,21,0.381,21,29,0.724,113,2013-03-18,DAL,ATL,2013,117.0
234,234,34,Home,W 127-125 (2OT),290,46,102,0.451,33,71,0.465,13,31,0.419,22,29,0.759,127,47,99,0.475,36,72,0.5,11,27,0.407,20,23,0.87,125,2013-11-09,CLE,PHI,2014,130.5
235,235,35,@,W 127-125 (2OT),290,51,103,0.495,40,69,0.58,11,34,0.324,14,19,0.737,127,49,94,0.521,41,73,0.562,8,21,0.381,19,26,0.731,125,2013-12-26,ATL,CLE,2014,129.0
236,236,36,@,L 127-129 ,240,51,97,0.526,39,72,0.542,12,25,0.48,13,21,0.619,127,42,83,0.506,25,49,0.51,17,34,0.5,28,37,0.757,129,2014-01-15,DAL,LAC,2014,137.5
237,237,37,@,W 127-110 ,240,53,91,0.582,37,64,0.578,16,27,0.593,5,7,0.714,127,40,81,0.494,32,56,0.571,8,25,0.32,22,22,1.0,110,2014-01-16,BRK,ATL,2014,114.0
238,238,38,Home,W 127-121 ,240,47,81,0.58,38,59,0.644,9,22,0.409,24,33,0.727,127,43,82,0.524,27,55,0.491,16,27,0.593,19,34,0.559,121,2014-01-17,OKC,GSW,2014,129.0
239,239,39,@,W 127-111 ,240,46,90,0.511,37,64,0.578,9,26,0.346,26,28,0.929,127,42,90,0.467,35,72,0.486,7,18,0.389,20,25,0.8,111,2014-01-18,POR,DAL,2014,114.5
240,240,40,@,W 127-120 ,240,46,80,0.575,34,53,0.642,12,27,0.444,23,29,0.793,127,40,91,0.44,32,68,0.471,8,23,0.348,32,37,0.865,120,2014-03-23,PHO,MIN,2014,124.0
241,241,41,Home,W 127-96 ,240,48,83,0.578,30,55,0.545,18,28,0.643,13,15,0.867,127,36,74,0.486,32,59,0.542,4,15,0.267,20,27,0.741,96,2014-03-25,LAL,NYK,2014,98.0
242,242,42,Home,W 127-104 ,240,46,83,0.554,35,60,0.583,11,23,0.478,24,28,0.857,127,41,88,0.466,37,74,0.5,4,14,0.286,18,25,0.72,104,2014-11-01,GSW,LAL,2015,106.0
243,243,43,Home,W 127-94 ,240,49,90,0.544,30,59,0.508,19,31,0.613,10,13,0.769,127,40,90,0.444,37,68,0.544,3,22,0.136,11,13,0.846,94,2014-11-15,CLE,ATL,2015,95.5
244,244,44,Home,W 127-101 ,240,41,80,0.513,26,46,0.565,15,34,0.441,30,36,0.833,127,35,82,0.427,33,70,0.471,2,12,0.167,29,40,0.725,101,2014-12-01,LAC,MIN,2015,102.0
245,245,45,@,W 127-98 ,240,49,76,0.645,33,48,0.688,16,28,0.571,13,16,0.813,127,37,82,0.451,29,52,0.558,8,30,0.267,16,21,0.762,98,2014-12-17,ATL,CLE,2015,102.0
246,246,46,Home,W 127-91 ,240,46,85,0.541,31,48,0.646,15,37,0.405,20,26,0.769,127,32,79,0.405,23,54,0.426,9,25,0.36,18,26,0.692,91,2015-01-03,LAC,PHI,2015,95.5
247,247,47,Home,W 127-115 ,240,51,97,0.526,41,75,0.547,10,22,0.455,15,19,0.789,127,42,92,0.457,33,68,0.485,9,24,0.375,22,28,0.786,115,2015-01-16,OKC,GSW,2015,119.5
248,248,48,@,W 127-99 ,240,48,83,0.578,39,58,0.672,9,25,0.36,22,32,0.688,127,35,88,0.398,27,65,0.415,8,23,0.348,21,27,0.778,99,2015-01-18,OKC,ORL,2015,103.0
249,249,49,@,W 127-122 (OT),265,47,92,0.511,40,66,0.606,7,26,0.269,26,30,0.867,127,49,101,0.485,45,82,0.549,4,19,0.211,20,26,0.769,122,2015-01-30,TOR,BRK,2015,124.0
250,250,50,@,W 127-118 ,240,48,95,0.505,33,58,0.569,15,37,0.405,16,23,0.696,127,41,87,0.471,29,61,0.475,12,26,0.462,24,30,0.8,118,2015-02-10,HOU,PHO,2015,124.0
251,251,51,@,W 127-89 ,240,46,90,0.511,32,57,0.561,14,33,0.424,21,28,0.75,127,38,86,0.442,37,70,0.529,1,16,0.063,12,16,0.75,89,2015-02-20,CLE,WAS,2015,89.5
252,252,52,@,W 127-94 ,240,44,87,0.506,29,55,0.527,15,32,0.469,24,29,0.828,127,33,81,0.407,28,61,0.459,5,20,0.25,23,33,0.697,94,2015-03-10,CLE,DAL,2015,96.5
253,253,53,@,L 127-129 (3OT),315,49,129,0.38,41,113,0.363,8,16,0.5,21,29,0.724,127,46,107,0.43,35,82,0.427,11,25,0.44,26,34,0.765,129,2015-03-20,MIL,BRK,2015,134.5
254,254,54,Home,W 127-117 ,240,48,86,0.558,37,65,0.569,11,21,0.524,20,23,0.87,127,44,85,0.518,35,66,0.53,9,19,0.474,20,27,0.741,117,2015-03-24,OKC,LAL,2015,121.5
255,255,55,Home,W 127-122 (OT),265,49,98,0.5,40,69,0.58,9,29,0.31,20,26,0.769,127,52,104,0.5,44,73,0.603,8,31,0.258,10,16,0.625,122,2015-11-23,CHA,SAC,2016,126.0
256,256,56,Home,W 127-122 (OT),265,44,87,0.506,32,60,0.533,12,27,0.444,27,44,0.614,127,47,97,0.485,33,64,0.516,14,33,0.424,14,15,0.933,122,2015-12-02,DET,PHO,2016,129.0
257,257,57,Home,W 127-106 ,240,48,78,0.615,38,57,0.667,10,21,0.476,21,24,0.875,127,39,75,0.52,27,49,0.551,12,26,0.462,16,24,0.667,106,2015-12-16,ATL,PHI,2016,112.0
258,258,58,Home,W 127-107 ,240,47,81,0.58,33,52,0.635,14,29,0.483,19,21,0.905,127,44,87,0.506,33,56,0.589,11,31,0.355,8,12,0.667,107,2016-01-27,GSW,DAL,2016,112.5
259,259,59,@,W 127-104 ,240,50,89,0.562,40,63,0.635,10,26,0.385,17,23,0.739,127,37,86,0.43,23,47,0.489,14,39,0.359,16,21,0.762,104,2016-11-01,GSW,POR,2017,111.0
260,260,60,Home,W 127-95 ,240,48,90,0.533,34,65,0.523,14,25,0.56,17,21,0.81,127,34,77,0.442,24,44,0.545,10,33,0.303,17,22,0.773,95,2016-11-14,LAC,BRK,2017,100.0
261,261,61,@,W 127-121 ,240,44,87,0.506,31,51,0.608,13,36,0.361,26,28,0.929,127,37,82,0.451,27,57,0.474,10,25,0.4,37,41,0.902,121,2016-11-16,GSW,TOR,2017,126.0
262,262,62,Home,W 127-122 (2OT),290,45,104,0.433,32,66,0.485,13,38,0.342,24,36,0.667,127,46,109,0.422,33,69,0.478,13,40,0.325,17,22,0.773,122,2016-11-29,BRK,LAC,2017,128.5
263,263,63,Home,L 127-132 (2OT),290,43,104,0.413,31,60,0.517,12,44,0.273,29,37,0.784,127,48,108,0.444,34,64,0.531,14,44,0.318,22,30,0.733,132,2016-12-01,GSW,HOU,2017,139.0
264,264,64,Home,W 127-114 ,240,50,90,0.556,40,63,0.635,10,27,0.37,17,29,0.586,127,35,80,0.438,27,57,0.474,8,23,0.348,36,39,0.923,114,2016-12-17,DEN,NYK,2017,118.0
265,265,65,Home,W 127-119 ,240,50,95,0.526,39,70,0.557,11,25,0.44,16,21,0.762,127,48,101,0.475,39,66,0.591,9,35,0.257,14,18,0.778,119,2017-01-02,GSW,DEN,2017,123.5
266,266,66,@,W 127-99 ,240,51,90,0.567,39,66,0.591,12,24,0.5,13,17,0.765,127,39,86,0.453,32,61,0.525,7,25,0.28,14,17,0.824,99,2017-01-05,SAS,DEN,2017,102.5
267,267,67,Home,W 127-100 ,240,48,96,0.5,38,68,0.559,10,28,0.357,21,29,0.724,127,38,92,0.413,30,60,0.5,8,32,0.25,16,27,0.593,100,2017-01-06,LAL,MIA,2017,104.0
268,268,68,Home,W 127-107 ,240,50,89,0.562,35,60,0.583,15,29,0.517,12,18,0.667,127,43,88,0.489,37,60,0.617,6,28,0.214,15,20,0.75,107,2017-01-12,GSW,DET,2017,110.0
269,269,69,@,W 127-121 ,240,50,88,0.568,39,62,0.629,11,26,0.423,16,26,0.615,127,47,108,0.435,36,78,0.462,11,30,0.367,16,18,0.889,121,2017-01-17,DEN,LAL,2017,126.5
270,270,70,@,W 127-123 (OT),265,43,92,0.467,33,67,0.493,10,25,0.4,31,36,0.861,127,42,92,0.457,29,57,0.509,13,35,0.371,26,31,0.839,123,2017-01-21,POR,BOS,2017,129.5
271,271,71,Home,W 127-114 ,240,47,80,0.588,36,57,0.632,11,23,0.478,22,27,0.815,127,39,77,0.506,25,42,0.595,14,35,0.4,22,28,0.786,114,2017-01-23,MIL,HOU,2017,121.0
272,272,72,Home,W 127-120 ,240,44,86,0.512,35,63,0.556,9,23,0.391,30,35,0.857,127,48,89,0.539,38,65,0.585,10,24,0.417,14,17,0.824,120,2017-01-26,DEN,PHO,2017,125.0
273,273,73,@,W 127-94 ,240,48,88,0.545,34,56,0.607,14,32,0.438,17,21,0.81,127,35,77,0.455,30,53,0.566,5,24,0.208,19,25,0.76,94,2017-02-08,UTA,NOP,2017,96.5
274,274,74,Home,L 127-131 ,240,44,88,0.5,31,61,0.508,13,27,0.481,26,33,0.788,127,41,90,0.456,34,72,0.472,7,18,0.389,42,53,0.792,131,2017-03-07,PHO,WAS,2017,134.5
275,275,75,Home,W 126-99 ,240,49,80,0.613,33,55,0.6,16,25,0.64,12,15,0.8,126,39,91,0.429,36,74,0.486,3,17,0.176,18,24,0.75,99,2012-11-03,DAL,CHA,2013,100.5
276,276,76,Home,W 126-100 ,240,47,88,0.534,31,61,0.508,16,27,0.593,16,20,0.8,126,39,78,0.5,35,67,0.522,4,11,0.364,18,26,0.692,100,2012-11-17,SAS,DEN,2013,102.0
277,277,77,Home,L 126-134 (OT),265,41,97,0.423,25,67,0.373,16,30,0.533,28,36,0.778,126,48,92,0.522,34,62,0.548,14,30,0.467,24,26,0.923,134,2012-12-10,HOU,SAS,2013,141.0
278,278,78,Home,W 126-119 (2OT),290,46,98,0.469,35,65,0.538,11,33,0.333,23,31,0.742,126,48,109,0.44,34,82,0.415,14,27,0.519,9,15,0.6,119,2012-12-26,ATL,DET,2013,126.0
279,279,79,Home,W 126-114 ,240,45,94,0.479,33,72,0.458,12,22,0.545,24,32,0.75,126,41,83,0.494,30,54,0.556,11,29,0.379,21,30,0.7,114,2012-12-26,DEN,LAL,2013,119.5
280,280,80,Home,W 126-101 ,240,52,93,0.559,43,72,0.597,9,21,0.429,13,18,0.722,126,35,77,0.455,28,60,0.467,7,17,0.412,24,25,0.96,101,2013-04-03,LAC,PHO,2013,104.5
281,281,81,Home,W 126-115 ,240,42,85,0.494,33,57,0.579,9,28,0.321,33,50,0.66,126,40,76,0.526,28,55,0.509,12,21,0.571,23,33,0.697,115,2013-10-31,LAC,GSW,2014,121.0
282,282,82,Home,W 126-96 ,240,46,80,0.575,30,56,0.536,16,24,0.667,18,23,0.783,126,39,83,0.47,35,70,0.5,4,13,0.308,14,20,0.7,96,2013-11-23,SAS,CLE,2014,98.0
283,283,83,Home,W 126-125 (2OT),290,46,96,0.479,35,67,0.522,11,29,0.379,23,33,0.697,126,47,94,0.5,41,68,0.603,6,26,0.231,25,32,0.781,125,2013-12-03,PHI,ORL,2014,128.0
284,284,84,@,W 126-95 ,240,46,100,0.46,30,74,0.405,16,26,0.615,18,23,0.783,126,38,80,0.475,30,62,0.484,8,18,0.444,11,16,0.688,95,2014-01-06,MIN,PHI,2014,99.0
285,285,85,Home,W 126-113 ,240,45,86,0.523,29,53,0.547,16,33,0.485,20,24,0.833,126,44,97,0.454,36,72,0.5,8,25,0.32,17,22,0.773,113,2014-01-20,HOU,POR,2014,117.0
286,286,86,@,W 126-118 ,240,46,84,0.548,34,62,0.548,12,22,0.545,22,25,0.88,126,36,74,0.486,22,45,0.489,14,29,0.483,32,38,0.842,118,2014-01-25,LAC,TOR,2014,125.0
287,287,87,@,W 126-117 ,240,42,78,0.538,30,55,0.545,12,23,0.522,30,32,0.938,126,38,89,0.427,31,70,0.443,7,19,0.368,34,36,0.944,117,2014-01-29,PHO,MIL,2014,120.5
288,288,88,Home,W 126-109 ,240,50,98,0.51,42,78,0.538,8,20,0.4,18,23,0.783,126,41,88,0.466,26,55,0.473,15,33,0.455,12,22,0.545,109,2014-02-08,DET,DEN,2014,116.5
289,289,89,Home,W 126-122 ,240,48,80,0.6,29,53,0.547,19,27,0.704,11,16,0.688,126,47,93,0.505,42,78,0.538,5,15,0.333,23,32,0.719,122,2014-02-28,LAL,SAC,2014,124.5
290,290,90,@,W 126-103 ,240,44,92,0.478,30,57,0.526,14,35,0.4,24,31,0.774,126,36,95,0.379,26,70,0.371,10,25,0.4,21,23,0.913,103,2014-02-28,GSW,NYK,2014,108.0
291,291,91,@,L 126-134 ,240,45,97,0.464,33,70,0.471,12,27,0.444,24,30,0.8,126,54,99,0.545,40,75,0.533,14,24,0.583,12,21,0.571,134,2014-03-07,LAL,DEN,2014,141.0
292,292,92,@,W 126-115 ,240,42,82,0.512,28,53,0.528,14,29,0.483,28,33,0.848,126,42,82,0.512,32,58,0.552,10,24,0.417,21,24,0.875,115,2014-11-26,TOR,ATL,2015,120.0
293,293,93,Home,W 126-86 ,240,46,82,0.561,34,54,0.63,12,28,0.429,22,27,0.815,126,33,86,0.384,27,66,0.409,6,20,0.3,14,23,0.609,86,2014-12-30,GSW,PHI,2015,89.0
294,294,94,Home,W 126-105 ,240,49,92,0.533,37,64,0.578,12,28,0.429,16,20,0.8,126,40,86,0.465,30,61,0.492,10,25,0.4,15,20,0.75,105,2015-01-02,GSW,TOR,2015,110.0
295,295,95,@,W 126-121 ,240,46,83,0.554,36,60,0.6,10,23,0.435,24,31,0.774,126,43,91,0.473,33,62,0.532,10,29,0.345,25,36,0.694,121,2015-01-16,CLE,LAC,2015,126.0
296,296,96,Home,W 126-113 ,240,49,98,0.5,36,69,0.522,13,29,0.448,15,18,0.833,126,37,87,0.425,24,55,0.436,13,32,0.406,26,31,0.839,113,2015-01-21,GSW,HOU,2015,119.5
297,297,97,Home,W 126-101 ,240,45,94,0.479,28,54,0.519,17,40,0.425,19,22,0.864,126,34,82,0.415,30,65,0.462,4,17,0.235,29,34,0.853,101,2015-01-23,GSW,SAC,2015,103.0
298,298,98,Home,W 126-99 ,240,46,95,0.484,32,60,0.533,14,35,0.4,20,28,0.714,126,30,88,0.341,26,72,0.361,4,16,0.25,35,46,0.761,99,2015-02-21,LAC,SAC,2015,101.0
299,299,99,@,W 126-122 ,240,46,86,0.535,31,58,0.534,15,28,0.536,19,24,0.792,126,45,89,0.506,32,64,0.5,13,25,0.52,19,25,0.76,122,2015-04-01,LAC,POR,2015,128.5
300,300,0,@,L 126-133 ,240,45,83,0.542,39,65,0.6,6,18,0.333,30,36,0.833,126,47,90,0.522,34,62,0.548,13,28,0.464,26,34,0.765,133,2015-04-15,DEN,GSW,2015,139.5
301,301,1,Home,W 126-97 ,240,47,90,0.522,32,57,0.561,15,33,0.455,17,28,0.607,126,35,88,0.398,25,56,0.446,10,32,0.313,17,20,0.85,97,2015-12-12,HOU,LAL,2016,102.0
302,302,2,@,W 126-98 ,240,49,92,0.533,36,60,0.6,13,32,0.406,15,19,0.789,126,39,86,0.453,34,68,0.5,5,18,0.278,15,25,0.6,98,2016-01-07,ATL,PHI,2016,100.5
303,303,3,@,L 126-129 ,240,48,82,0.585,39,62,0.629,9,20,0.45,21,30,0.7,126,46,91,0.505,36,65,0.554,10,26,0.385,27,38,0.711,129,2016-01-17,IND,DEN,2016,134.0
304,304,4,@,W 126-123 ,240,48,91,0.527,38,71,0.535,10,20,0.5,20,21,0.952,126,50,90,0.556,45,76,0.592,5,14,0.357,18,28,0.643,123,2016-01-27,OKC,MIN,2016,125.5
305,305,5,Home,W 126-115 ,240,44,79,0.557,31,60,0.517,13,19,0.684,25,26,0.962,126,43,93,0.462,36,72,0.5,7,21,0.333,22,33,0.667,115,2016-02-21,CHI,LAL,2016,118.5
306,306,6,Home,W 126-92 ,240,45,93,0.484,32,66,0.485,13,27,0.481,23,27,0.852,126,33,91,0.363,27,64,0.422,6,27,0.222,20,27,0.741,92,2016-03-01,CHA,PHO,2016,95.0
307,307,7,@,W 126-99 ,240,52,94,0.553,36,64,0.563,16,30,0.533,6,7,0.857,126,39,90,0.433,33,70,0.471,6,20,0.3,15,19,0.789,99,2016-11-12,LAL,NOP,2017,102.0
308,308,8,Home,W 126-109 ,240,46,95,0.484,32,63,0.508,14,32,0.438,20,25,0.8,126,41,90,0.456,31,62,0.5,10,28,0.357,17,21,0.81,109,2016-11-17,HOU,POR,2017,114.0
309,309,9,Home,W 126-115 (OT),265,46,95,0.484,34,65,0.523,12,30,0.4,22,31,0.71,126,44,98,0.449,34,70,0.486,10,28,0.357,17,26,0.654,115,2016-11-30,OKC,WAS,2017,120.0
310,310,10,@,W 126-94 ,240,39,80,0.488,17,40,0.425,22,40,0.55,26,31,0.839,126,35,87,0.402,24,56,0.429,11,31,0.355,13,15,0.867,94,2016-12-07,CLE,NYK,2017,99.5
311,311,11,Home,W 126-121 ,240,40,72,0.556,30,49,0.612,10,23,0.435,36,43,0.837,126,44,86,0.512,40,59,0.678,4,27,0.148,29,40,0.725,121,2016-12-20,SAC,POR,2017,123.0
312,312,12,Home,W 126-91 ,240,46,91,0.505,31,57,0.544,15,34,0.441,19,24,0.792,126,31,88,0.352,22,54,0.407,9,34,0.265,20,27,0.741,91,2017-01-16,GSW,CLE,2017,95.5
313,313,13,Home,W 126-111 ,240,47,96,0.49,26,48,0.542,21,48,0.438,11,14,0.786,126,39,88,0.443,30,57,0.526,9,31,0.29,24,26,0.923,111,2017-02-01,GSW,CHO,2017,115.5
314,314,14,@,W 126-121 ,240,47,85,0.553,36,62,0.581,11,23,0.478,21,27,0.778,126,44,85,0.518,34,60,0.567,10,25,0.4,23,30,0.767,121,2017-03-07,POR,OKC,2017,126.0
315,315,15,@,W 125-104 ,240,43,84,0.512,36,72,0.5,7,12,0.583,32,39,0.821,125,40,91,0.44,30,70,0.429,10,21,0.476,14,18,0.778,104,2012-03-24,IND,MIL,2012,109.0
316,316,16,@,W 125-90 ,240,48,81,0.593,37,58,0.638,11,23,0.478,18,21,0.857,125,34,82,0.415,25,58,0.431,9,24,0.375,13,15,0.867,90,2012-04-03,SAS,CLE,2012,94.5
317,317,17,Home,W 125-105 ,240,47,94,0.5,33,65,0.508,14,29,0.483,17,21,0.81,125,47,97,0.485,46,88,0.523,1,9,0.111,10,18,0.556,105,2012-04-07,PHO,LAL,2012,105.5
318,318,18,Home,W 125-107 ,240,51,85,0.6,44,70,0.629,7,15,0.467,16,19,0.842,125,41,89,0.461,33,68,0.485,8,21,0.381,17,23,0.739,107,2012-04-16,PHO,POR,2012,111.0
319,319,19,Home,W 125-103 ,240,42,75,0.56,31,48,0.646,11,27,0.407,30,36,0.833,125,40,89,0.449,34,72,0.472,6,17,0.353,17,24,0.708,103,2012-12-19,HOU,PHI,2013,106.0
320,320,20,Home,W 125-119 (OT),265,48,94,0.511,40,70,0.571,8,24,0.333,21,24,0.875,125,46,93,0.495,35,63,0.556,11,30,0.367,16,18,0.889,119,2013-01-07,POR,ORL,2013,124.5
321,321,21,Home,W 125-112 ,240,48,87,0.552,37,62,0.597,11,25,0.44,18,23,0.783,125,43,91,0.473,29,60,0.483,14,31,0.452,12,13,0.923,112,2013-01-08,HOU,LAL,2013,119.0
322,322,22,@,W 125-80 ,240,47,89,0.528,31,55,0.564,16,34,0.471,15,18,0.833,125,32,81,0.395,27,63,0.429,5,18,0.278,11,19,0.579,80,2013-01-28,HOU,UTA,2013,82.5
323,323,23,@,W 125-101 ,240,46,89,0.517,30,59,0.508,16,30,0.533,17,22,0.773,125,38,75,0.507,32,55,0.582,6,20,0.3,19,27,0.704,101,2013-02-14,LAC,LAL,2013,104.0
324,324,24,Home,W 125-91 ,240,42,79,0.532,31,55,0.564,11,24,0.458,30,39,0.769,125,29,86,0.337,24,58,0.414,5,28,0.179,28,36,0.778,91,2013-02-20,IND,NYK,2013,93.5
325,325,25,@,W 125-101 ,240,46,84,0.548,36,62,0.581,10,22,0.455,23,29,0.793,125,37,83,0.446,31,64,0.484,6,19,0.316,21,25,0.84,101,2013-02-27,SAC,ORL,2013,104.0
326,326,26,Home,W 125-118 ,240,47,82,0.573,39,65,0.6,8,17,0.471,23,28,0.821,125,41,94,0.436,32,68,0.471,9,26,0.346,27,35,0.771,118,2013-03-04,GSW,TOR,2013,122.5
327,327,27,Home,W 125-98 ,240,47,87,0.54,38,67,0.567,9,20,0.45,22,27,0.815,125,33,86,0.384,25,63,0.397,8,23,0.348,24,29,0.828,98,2013-03-30,GSW,POR,2013,102.0
328,328,28,@,W 125-120 ,240,46,93,0.495,31,59,0.525,15,34,0.441,18,24,0.75,125,45,78,0.577,36,61,0.59,9,17,0.529,21,25,0.84,120,2013-04-07,NYK,OKC,2013,124.5
329,329,29,Home,W 125-94 ,240,46,86,0.535,31,59,0.525,15,27,0.556,18,23,0.783,125,35,89,0.393,27,71,0.38,8,18,0.444,16,21,0.762,94,2013-10-30,GSW,LAL,2014,98.0
330,330,30,@,L 125-127 (2OT),290,47,99,0.475,36,72,0.5,11,27,0.407,20,23,0.87,125,46,102,0.451,33,71,0.465,13,31,0.419,22,29,0.759,127,2013-11-09,PHI,CLE,2014,133.5
331,331,31,@,L 125-126 (2OT),290,47,94,0.5,41,68,0.603,6,26,0.231,25,32,0.781,125,46,96,0.479,35,67,0.522,11,29,0.379,23,33,0.697,126,2013-12-03,ORL,PHI,2014,131.5
332,332,32,Home,L 125-127 (2OT),290,49,94,0.521,41,73,0.562,8,21,0.381,19,26,0.731,125,51,103,0.495,40,69,0.58,11,34,0.324,14,19,0.737,127,2013-12-26,CLE,ATL,2014,132.5
333,333,33,Home,L 125-128 (3OT),315,53,104,0.51,47,78,0.603,6,26,0.231,13,16,0.813,125,48,113,0.425,36,80,0.45,12,33,0.364,20,23,0.87,128,2014-01-15,ORL,CHI,2014,134.0
334,334,34,Home,W 125-96 ,240,50,90,0.556,36,63,0.571,14,27,0.519,11,11,1.0,125,37,76,0.487,27,52,0.519,10,24,0.417,12,14,0.857,96,2014-01-24,NYK,CHA,2014,101.0
335,335,35,@,W 125-117 ,240,42,81,0.519,32,56,0.571,10,25,0.4,31,40,0.775,125,42,81,0.519,38,65,0.585,4,16,0.25,29,34,0.853,117,2014-01-26,DEN,SAC,2014,119.0
336,336,36,@,W 125-99 ,240,45,89,0.506,37,73,0.507,8,16,0.5,27,34,0.794,125,32,87,0.368,26,65,0.4,6,22,0.273,29,37,0.784,99,2014-01-31,ATL,PHI,2014,102.0
337,337,37,@,W 125-118 (2OT),290,48,98,0.49,39,70,0.557,9,28,0.321,20,25,0.8,125,44,101,0.436,39,85,0.459,5,16,0.313,25,32,0.781,118,2014-02-05,SAS,WAS,2014,120.5
338,338,38,@,W 125-117 ,240,42,81,0.519,29,51,0.569,13,30,0.433,28,39,0.718,125,43,93,0.462,31,64,0.484,12,29,0.414,19,24,0.792,117,2014-02-23,LAC,OKC,2014,123.0
339,339,39,Home,L 125-132 ,240,46,85,0.541,36,63,0.571,10,22,0.455,23,31,0.742,125,46,77,0.597,39,60,0.65,7,17,0.412,33,40,0.825,132,2014-03-04,LAL,NOP,2014,135.5
340,340,40,Home,W 125-92 ,240,43,76,0.566,36,56,0.643,7,20,0.35,32,43,0.744,125,32,94,0.34,22,64,0.344,10,30,0.333,18,26,0.692,92,2014-03-04,OKC,PHI,2014,97.0
341,341,41,@,W 125-109 ,240,50,95,0.526,38,68,0.559,12,27,0.444,13,16,0.813,125,39,91,0.429,30,65,0.462,9,26,0.346,22,29,0.759,109,2014-03-19,SAS,LAL,2014,113.5
342,342,42,@,L 125-130 (OT),265,51,107,0.477,37,76,0.487,14,31,0.452,9,13,0.692,125,45,98,0.459,32,62,0.516,13,36,0.361,27,40,0.675,130,2014-04-06,DEN,HOU,2014,136.5
343,343,43,Home,W 125-114 ,240,41,82,0.5,29,57,0.509,12,25,0.48,31,37,0.838,125,44,85,0.518,36,64,0.563,8,21,0.381,18,21,0.857,114,2014-04-09,TOR,PHI,2014,118.0
344,344,44,Home,W 125-102 ,240,49,84,0.583,37,53,0.698,12,31,0.387,15,19,0.789,125,42,84,0.5,38,69,0.551,4,15,0.267,14,17,0.824,102,2014-12-07,DAL,MIL,2015,104.0
345,345,45,Home,W 125-118 ,240,49,77,0.636,36,54,0.667,13,23,0.565,14,22,0.636,125,43,86,0.5,33,62,0.532,10,24,0.417,22,29,0.759,118,2014-12-22,SAS,LAC,2015,123.0
346,346,46,Home,W 125-104 ,240,44,84,0.524,32,60,0.533,12,24,0.5,25,31,0.806,125,39,88,0.443,35,75,0.467,4,13,0.308,22,29,0.759,104,2014-12-23,CLE,MIN,2015,106.0
347,347,47,Home,W 125-109 ,240,48,89,0.539,40,66,0.606,8,23,0.348,21,28,0.75,125,38,83,0.458,29,57,0.509,9,26,0.346,24,29,0.828,109,2015-01-04,PHO,TOR,2015,113.5
348,348,48,Home,L 125-128 (OT),265,49,87,0.563,41,61,0.672,8,26,0.308,19,27,0.704,125,44,91,0.484,30,65,0.462,14,26,0.538,26,30,0.867,128,2015-03-12,SAS,CLE,2015,135.0
349,349,49,Home,W 125-94 ,240,45,90,0.5,26,56,0.464,19,34,0.559,16,17,0.941,125,38,96,0.396,29,71,0.408,9,25,0.36,9,16,0.563,94,2015-03-14,GSW,NYK,2015,98.5
350,350,50,@,W 125-101 ,240,44,86,0.512,29,63,0.46,15,23,0.652,22,29,0.759,125,38,97,0.392,33,73,0.452,5,24,0.208,20,26,0.769,101,2015-11-10,OKC,WAS,2016,103.5
351,351,51,@,W 125-88 ,240,47,84,0.56,34,58,0.586,13,26,0.5,18,23,0.783,125,33,81,0.407,30,67,0.448,3,14,0.214,19,22,0.864,88,2015-12-08,OKC,MEM,2016,89.5
352,352,52,Home,L 125-130 ,240,45,96,0.469,28,61,0.459,17,35,0.486,18,22,0.818,125,44,78,0.564,33,54,0.611,11,24,0.458,31,39,0.795,130,2015-12-20,DEN,NOP,2016,135.5
353,353,53,@,W 125-99 ,240,43,81,0.531,30,54,0.556,13,27,0.481,26,29,0.897,125,36,79,0.456,29,63,0.46,7,16,0.438,20,26,0.769,99,2016-01-08,CLE,MIN,2016,102.5
354,354,54,@,W 125-94 ,240,50,95,0.526,38,63,0.603,12,32,0.375,13,20,0.65,125,37,100,0.37,36,80,0.45,1,20,0.05,19,24,0.792,94,2016-01-20,GSW,CHI,2016,94.5
355,355,55,Home,W 125-109 ,240,48,88,0.545,33,57,0.579,15,31,0.484,14,16,0.875,125,43,93,0.462,38,67,0.567,5,26,0.192,18,28,0.643,109,2016-03-12,CHA,HOU,2016,111.5
356,356,56,@,W 125-111 ,240,49,91,0.538,40,73,0.548,9,18,0.5,18,22,0.818,125,39,84,0.464,29,59,0.492,10,25,0.4,23,27,0.852,111,2016-03-12,DET,PHI,2016,116.0
357,357,57,Home,W 125-107 ,240,47,81,0.58,35,56,0.625,12,25,0.48,19,23,0.826,125,35,93,0.376,28,68,0.412,7,25,0.28,30,34,0.882,107,2016-03-14,GSW,NOP,2016,110.5
358,358,58,Home,W 125-104 ,240,46,87,0.529,26,40,0.65,20,47,0.426,13,16,0.813,125,42,98,0.429,34,74,0.459,8,24,0.333,12,16,0.75,104,2016-04-13,GSW,MEM,2016,108.0
359,359,59,Home,W 125-107 ,240,47,82,0.573,35,55,0.636,12,27,0.444,19,24,0.792,125,38,81,0.469,28,58,0.483,10,23,0.435,21,27,0.778,107,2016-11-03,MIL,IND,2017,112.0
360,360,60,@,W 125-101 ,240,46,85,0.541,32,55,0.582,14,30,0.467,19,20,0.95,125,38,94,0.404,25,58,0.431,13,36,0.361,12,17,0.706,101,2016-11-10,GSW,DEN,2017,107.5
361,361,61,Home,W 125-99 ,240,42,80,0.525,29,53,0.547,13,27,0.481,28,42,0.667,125,33,71,0.465,25,47,0.532,8,24,0.333,25,30,0.833,99,2016-11-13,MIN,LAL,2017,103.0
362,362,62,Home,W 125-118 ,240,41,92,0.446,32,64,0.5,9,28,0.321,34,43,0.791,125,45,99,0.455,33,58,0.569,12,41,0.293,16,20,0.8,118,2016-11-15,LAL,BRK,2017,124.0
363,363,63,@,L 125-137 ,240,47,90,0.522,34,61,0.557,13,29,0.448,18,19,0.947,125,48,90,0.533,27,54,0.5,21,36,0.583,20,27,0.741,137,2016-11-23,POR,CLE,2017,147.5
364,364,64,@,W 125-120 (OT),265,48,106,0.453,38,79,0.481,10,27,0.37,19,22,0.864,125,44,101,0.436,30,65,0.462,14,36,0.389,18,26,0.692,120,2016-12-03,MIN,CHO,2017,127.0
365,365,65,@,W 125-121 ,240,46,86,0.535,35,61,0.574,11,25,0.44,22,32,0.688,125,47,86,0.547,37,65,0.569,10,21,0.476,17,26,0.654,121,2016-12-16,ATL,TOR,2017,126.0
366,366,66,@,W 125-111 ,240,46,86,0.535,28,48,0.583,18,38,0.474,15,26,0.577,125,44,93,0.473,35,68,0.515,9,25,0.36,14,20,0.7,111,2016-12-21,HOU,PHO,2017,115.5
367,367,67,Home,W 125-117 ,240,44,87,0.506,31,51,0.608,13,36,0.361,24,29,0.828,125,40,89,0.449,28,63,0.444,12,26,0.462,25,28,0.893,117,2017-01-04,GSW,POR,2017,123.0
368,368,68,@,W 125-124 (2OT),290,54,105,0.514,46,80,0.575,8,25,0.32,9,12,0.75,125,51,98,0.52,36,63,0.571,15,35,0.429,7,12,0.583,124,2017-01-08,DET,POR,2017,131.5
369,369,69,Home,W 125-112 ,240,52,89,0.584,43,62,0.694,9,27,0.333,12,15,0.8,125,45,88,0.511,37,63,0.587,8,25,0.32,14,18,0.778,112,2017-01-16,DEN,ORL,2017,116.0
370,370,70,@,W 125-108 ,240,47,89,0.528,32,51,0.627,15,38,0.395,16,21,0.762,125,43,96,0.448,36,61,0.59,7,35,0.2,15,18,0.833,108,2017-01-20,GSW,HOU,2017,111.5
371,371,71,Home,W 125-97 ,240,48,89,0.539,33,52,0.635,15,37,0.405,14,22,0.636,125,41,94,0.436,34,73,0.466,7,21,0.333,8,10,0.8,97,2017-02-01,CLE,MIN,2017,100.5
372,372,72,Home,W 125-102 ,240,48,82,0.585,36,60,0.6,12,22,0.545,17,23,0.739,125,35,84,0.417,29,61,0.475,6,23,0.261,26,31,0.839,102,2017-02-04,MIA,PHI,2017,105.0
373,373,73,Home,W 125-109 ,240,46,84,0.548,31,54,0.574,15,30,0.5,18,22,0.818,125,39,97,0.402,27,60,0.45,12,37,0.324,19,22,0.864,109,2017-02-11,CLE,DEN,2017,115.0
374,374,74,Home,L 125-129 ,240,46,88,0.523,32,52,0.615,14,36,0.389,19,23,0.826,125,50,88,0.568,43,73,0.589,7,15,0.467,22,32,0.688,129,2017-02-15,BRK,MIL,2017,132.5
375,375,75,@,W 125-107 ,240,45,80,0.563,32,50,0.64,13,30,0.433,22,24,0.917,125,44,96,0.458,34,70,0.486,10,26,0.385,9,10,0.9,107,2017-02-28,DEN,CHI,2017,112.0
376,376,76,Home,W 125-98 ,240,49,90,0.544,36,60,0.6,13,30,0.433,14,21,0.667,125,37,85,0.435,31,68,0.456,6,17,0.353,18,22,0.818,98,2017-03-01,MIA,PHI,2017,101.0
377,377,77,@,W 124-109 ,240,48,80,0.6,39,63,0.619,9,17,0.529,19,23,0.826,124,40,85,0.471,33,62,0.532,7,23,0.304,22,27,0.815,109,2012-02-14,WAS,POR,2012,112.5
378,378,78,Home,W 124-118 (OT),265,46,94,0.489,37,66,0.561,9,28,0.321,23,28,0.821,124,49,101,0.485,43,79,0.544,6,22,0.273,14,18,0.778,118,2012-02-19,OKC,DEN,2012,121.0
379,379,79,Home,L 124-127 ,240,46,89,0.517,37,68,0.544,9,21,0.429,23,29,0.793,124,50,89,0.562,36,67,0.537,14,22,0.636,13,21,0.619,127,2012-03-12,PHO,MIN,2012,134.0
380,380,80,@,W 124-112 ,240,50,86,0.581,42,73,0.575,8,13,0.615,16,20,0.8,124,45,87,0.517,40,68,0.588,5,19,0.263,17,24,0.708,112,2012-03-14,DET,SAC,2012,114.5
381,381,81,Home,W 124-89 ,240,48,81,0.593,36,59,0.61,12,22,0.545,16,21,0.762,124,37,96,0.385,31,80,0.388,6,16,0.375,9,11,0.818,89,2012-04-23,SAS,POR,2012,92.0
382,382,82,Home,W 124-99 ,240,47,86,0.547,32,60,0.533,15,26,0.577,15,19,0.789,124,35,88,0.398,28,67,0.418,7,21,0.333,22,29,0.759,99,2012-11-05,MIA,PHO,2013,102.5
383,383,83,Home,W 124-116 ,240,46,83,0.554,35,61,0.574,11,22,0.5,21,26,0.808,124,48,94,0.511,37,74,0.5,11,20,0.55,9,11,0.818,116,2012-12-01,HOU,UTA,2013,121.5
384,384,84,@,W 124-94 ,240,45,94,0.479,32,65,0.492,13,29,0.448,21,23,0.913,124,33,83,0.398,25,53,0.472,8,30,0.267,20,27,0.741,94,2012-12-29,OKC,HOU,2013,98.0
385,385,85,Home,W 124-118 ,240,43,84,0.512,34,65,0.523,9,19,0.474,29,33,0.879,124,44,92,0.478,36,76,0.474,8,16,0.5,22,30,0.733,118,2013-01-14,SAC,CLE,2013,122.0
386,386,86,@,W 124-101 ,240,49,91,0.538,41,69,0.594,8,22,0.364,18,19,0.947,124,37,88,0.42,30,67,0.448,7,21,0.333,20,22,0.909,101,2013-04-10,ATL,PHI,2013,104.5
387,387,87,Home,W 124-95 ,240,45,82,0.549,34,60,0.567,11,22,0.5,23,26,0.885,124,36,87,0.414,31,71,0.437,5,16,0.313,18,21,0.857,95,2013-11-13,MIN,CLE,2014,97.5
388,388,88,Home,W 124-107 ,240,47,81,0.58,32,56,0.571,15,25,0.6,15,18,0.833,124,40,84,0.476,34,69,0.493,6,15,0.4,21,25,0.84,107,2013-12-18,ATL,SAC,2014,110.0
389,389,89,Home,W 124-112 ,240,44,79,0.557,36,57,0.632,8,22,0.364,28,35,0.8,124,45,87,0.517,39,67,0.582,6,20,0.3,16,22,0.727,112,2014-01-01,MIN,NOP,2014,115.0
390,390,90,Home,W 124-80 ,240,42,81,0.519,27,51,0.529,15,30,0.5,25,30,0.833,124,31,80,0.388,24,59,0.407,7,21,0.333,11,23,0.478,80,2014-01-12,SAC,CLE,2014,83.5
391,391,91,Home,W 124-100 ,240,45,83,0.542,34,67,0.507,11,16,0.688,23,32,0.719,124,38,75,0.507,33,60,0.55,5,15,0.333,19,28,0.679,100,2014-01-22,PHO,IND,2014,102.5
392,392,92,@,W 124-113 ,240,43,80,0.538,34,60,0.567,9,20,0.45,29,35,0.829,124,40,87,0.46,32,67,0.478,8,20,0.4,25,26,0.962,113,2014-01-27,PHO,PHI,2014,117.0
393,393,93,Home,W 124-107 ,240,44,80,0.55,32,54,0.593,12,26,0.462,24,26,0.923,124,37,80,0.463,29,56,0.518,8,24,0.333,25,33,0.758,107,2014-02-03,DAL,CLE,2014,111.0
394,394,94,@,W 124-112 ,240,48,77,0.623,39,54,0.722,9,23,0.391,19,25,0.76,124,42,94,0.447,37,69,0.536,5,25,0.2,23,32,0.719,112,2014-02-21,DAL,PHI,2014,114.5
395,395,95,Home,W 124-80 ,240,46,86,0.535,33,55,0.6,13,31,0.419,19,21,0.905,124,32,81,0.395,28,59,0.475,4,22,0.182,12,17,0.706,80,2014-02-26,POR,BRK,2014,82.0
396,396,96,Home,W 124-107 ,240,46,83,0.554,30,55,0.545,16,28,0.571,16,20,0.8,124,42,82,0.512,33,59,0.559,9,23,0.391,14,21,0.667,107,2014-03-03,MIA,CHA,2014,111.5
397,397,97,Home,W 124-86 ,240,46,79,0.582,33,54,0.611,13,25,0.52,19,26,0.731,124,34,83,0.41,30,65,0.462,4,18,0.222,14,18,0.778,86,2014-03-17,HOU,UTA,2014,88.0
398,398,98,Home,W 124-94 ,240,49,94,0.521,41,75,0.547,8,19,0.421,18,19,0.947,124,34,84,0.405,25,57,0.439,9,27,0.333,17,22,0.773,94,2014-03-22,CHA,POR,2014,98.5
399,399,99,Home,W 124-107 ,240,44,86,0.512,37,66,0.561,7,20,0.35,29,36,0.806,124,42,85,0.494,38,67,0.567,4,18,0.222,19,30,0.633,107,2014-03-23,SAC,MIL,2014,109.0
400,400,0,@,W 124-112 ,240,46,99,0.465,33,70,0.471,13,29,0.448,19,21,0.905,124,41,92,0.446,30,67,0.448,11,25,0.44,19,22,0.864,112,2014-04-01,POR,LAL,2014,117.5
401,401,1,Home,W 124-82 ,240,45,86,0.523,30,61,0.492,15,25,0.6,19,24,0.792,124,27,74,0.365,21,54,0.389,6,20,0.3,22,32,0.688,82,2014-11-21,TOR,MIL,2015,85.0
402,402,2,Home,W 124-115 ,240,44,97,0.454,31,64,0.484,13,33,0.394,23,32,0.719,124,41,88,0.466,32,63,0.508,9,25,0.36,24,29,0.828,115,2014-12-23,PHO,DAL,2015,119.5
403,403,3,Home,W 124-116 ,240,38,77,0.494,23,50,0.46,15,27,0.556,33,37,0.892,124,47,103,0.456,35,70,0.5,12,33,0.364,10,15,0.667,116,2015-02-06,ATL,GSW,2015,122.0
404,404,4,@,W 124-114 ,240,43,80,0.538,31,56,0.554,12,24,0.5,26,35,0.743,124,42,87,0.483,33,59,0.559,9,28,0.321,21,29,0.724,114,2015-02-09,OKC,DEN,2015,118.5
405,405,5,@,W 124-86 ,240,41,83,0.494,31,65,0.477,10,18,0.556,32,37,0.865,124,30,82,0.366,26,60,0.433,4,22,0.182,22,30,0.733,86,2015-03-03,SAC,NYK,2015,88.0
406,406,6,Home,W 124-103 ,240,49,94,0.521,45,74,0.608,4,20,0.2,22,30,0.733,124,38,84,0.452,31,68,0.456,7,16,0.438,20,26,0.769,103,2015-11-08,OKC,PHO,2016,106.5
407,407,7,@,W 124-117 ,240,38,73,0.521,21,43,0.488,17,30,0.567,31,36,0.861,124,44,88,0.5,31,59,0.525,13,29,0.448,16,24,0.667,117,2015-11-19,GSW,LAC,2016,123.5
408,408,8,@,W 124-119 (2OT),290,42,107,0.393,33,76,0.434,9,31,0.29,31,39,0.795,124,49,114,0.43,37,81,0.457,12,33,0.364,9,16,0.563,119,2015-12-11,GSW,BOS,2016,125.0
409,409,9,Home,W 124-119 (2OT),290,41,88,0.466,27,61,0.443,14,27,0.519,28,32,0.875,124,44,104,0.423,29,59,0.492,15,45,0.333,16,20,0.8,119,2016-01-18,CHA,UTA,2016,126.5
410,410,10,@,W 124-86 ,240,48,92,0.522,38,72,0.528,10,20,0.5,18,25,0.72,124,35,84,0.417,29,57,0.509,6,27,0.222,10,14,0.714,86,2016-02-03,ATL,PHI,2016,89.0
411,411,11,Home,W 124-84 ,240,44,80,0.55,31,56,0.554,13,24,0.542,23,35,0.657,124,31,88,0.352,24,64,0.375,7,24,0.292,15,20,0.75,84,2016-02-22,LAC,PHO,2016,87.5
412,412,12,Home,W 124-122 ,240,43,83,0.518,35,68,0.515,8,15,0.533,30,40,0.75,124,49,101,0.485,39,73,0.534,10,28,0.357,14,17,0.824,122,2016-02-22,MIN,BOS,2016,127.0
413,413,13,@,W 124-115 ,240,41,85,0.482,34,71,0.479,7,14,0.5,35,41,0.854,124,43,79,0.544,33,58,0.569,10,21,0.476,19,26,0.731,115,2016-02-23,ORL,PHI,2016,120.0
414,414,14,Home,W 124-119 ,240,47,79,0.595,39,62,0.629,8,17,0.471,22,28,0.786,124,49,93,0.527,42,73,0.575,7,20,0.35,14,20,0.7,119,2016-03-14,MIA,DEN,2016,122.5
415,415,15,Home,W 124-81 ,240,51,90,0.567,43,72,0.597,8,18,0.444,14,18,0.778,124,32,79,0.405,29,56,0.518,3,23,0.13,14,22,0.636,81,2016-03-14,WAS,DET,2016,82.5
416,416,16,Home,W 124-91 ,240,48,86,0.558,33,55,0.6,15,31,0.484,13,17,0.765,124,32,81,0.395,24,59,0.407,8,22,0.364,19,25,0.76,91,2016-03-21,CLE,DEN,2016,95.0
417,417,17,@,W 124-102 ,240,46,87,0.529,31,54,0.574,15,33,0.455,17,24,0.708,124,37,88,0.42,27,58,0.466,10,30,0.333,18,27,0.667,102,2016-04-05,OKC,DEN,2016,107.0
418,418,18,@,W 124-117 (OT),265,44,86,0.512,36,69,0.522,8,17,0.471,28,36,0.778,124,49,98,0.5,37,63,0.587,12,35,0.343,7,8,0.875,117,2016-04-05,MIN,GSW,2016,123.0
419,419,19,@,W 124-115 ,240,44,94,0.468,32,63,0.508,12,31,0.387,24,29,0.828,124,42,74,0.568,28,41,0.683,14,33,0.424,17,28,0.607,115,2016-04-07,PHO,HOU,2016,122.0
420,420,20,Home,W 124-109 ,240,44,78,0.564,38,64,0.594,6,14,0.429,30,38,0.789,124,41,84,0.488,34,67,0.507,7,17,0.412,20,29,0.69,109,2016-04-08,BOS,MIL,2016,112.5
421,421,21,Home,W 124-121 ,240,45,81,0.556,31,50,0.62,14,31,0.452,20,28,0.714,124,43,86,0.5,36,65,0.554,7,21,0.333,28,33,0.848,121,2016-11-08,POR,PHO,2017,124.5
422,422,22,Home,W 124-105 ,240,49,89,0.551,42,63,0.667,7,26,0.269,19,24,0.792,124,35,83,0.422,24,54,0.444,11,29,0.379,24,30,0.8,105,2016-11-18,OKC,BRK,2017,110.5
423,423,23,@,W 124-121 ,240,42,95,0.442,28,57,0.491,14,38,0.368,26,32,0.813,124,46,89,0.517,36,69,0.522,10,20,0.5,19,25,0.76,121,2016-11-19,GSW,MIL,2017,126.0
424,424,24,@,W 124-104 ,240,43,85,0.506,28,53,0.528,15,32,0.469,23,31,0.742,124,38,84,0.452,27,60,0.45,11,24,0.458,17,18,0.944,104,2016-11-23,LAC,DAL,2017,109.5
425,425,25,@,W 124-116 ,240,43,83,0.518,31,57,0.544,12,26,0.462,26,36,0.722,124,44,93,0.473,33,70,0.471,11,23,0.478,17,24,0.708,116,2016-12-06,ORL,WAS,2017,121.5
426,426,26,Home,W 124-110 ,240,43,87,0.494,31,60,0.517,12,27,0.444,26,33,0.788,124,45,88,0.511,36,60,0.6,9,28,0.321,11,15,0.733,110,2016-12-08,TOR,MIN,2017,114.5
427,427,27,Home,W 124-118 ,240,43,83,0.518,29,45,0.644,14,38,0.368,24,33,0.727,124,43,85,0.506,31,48,0.646,12,37,0.324,20,21,0.952,118,2016-12-29,CLE,BOS,2017,124.0
428,428,28,@,W 124-122 ,240,38,87,0.437,22,54,0.407,16,33,0.485,32,40,0.8,124,39,84,0.464,28,57,0.491,11,27,0.407,33,41,0.805,122,2016-12-30,PHI,DEN,2017,127.5
429,429,29,Home,L 124-125 (2OT),290,51,98,0.52,36,63,0.571,15,35,0.429,7,12,0.583,124,54,105,0.514,46,80,0.575,8,25,0.32,9,12,0.75,125,2017-01-08,POR,DET,2017,129.0
430,430,30,Home,W 124-122 ,240,43,87,0.494,27,48,0.563,16,39,0.41,22,30,0.733,124,43,93,0.462,28,56,0.5,15,37,0.405,21,25,0.84,122,2017-01-23,NOP,CLE,2017,129.5
431,431,31,Home,W 124-116 ,240,49,92,0.533,36,56,0.643,13,36,0.361,13,20,0.65,124,43,87,0.494,27,54,0.5,16,33,0.485,14,16,0.875,116,2017-01-27,CLE,BRK,2017,124.0
432,432,32,@,W 124-114 ,240,44,84,0.524,39,65,0.6,5,19,0.263,31,38,0.816,124,39,96,0.406,32,76,0.421,7,20,0.35,29,35,0.829,114,2017-02-01,LAC,PHO,2017,117.5
433,433,33,Home,W 124-121 (OT),265,45,97,0.464,35,65,0.538,10,32,0.313,24,34,0.706,124,38,80,0.475,20,40,0.5,18,40,0.45,27,30,0.9,121,2017-02-26,LAC,CHO,2017,130.0
434,434,34,Home,W 123-115 ,240,44,74,0.595,33,56,0.589,11,18,0.611,24,30,0.8,123,43,83,0.518,23,48,0.479,20,35,0.571,9,12,0.75,115,2012-01-11,DEN,NJN,2012,125.0
435,435,35,Home,W 123-84 ,240,48,88,0.545,39,70,0.557,9,18,0.5,18,24,0.75,123,31,84,0.369,19,59,0.322,12,25,0.48,10,14,0.714,84,2012-04-09,DEN,GSW,2012,90.0
436,436,36,Home,W 123-121 (3OT),315,41,95,0.432,29,67,0.433,12,28,0.429,29,37,0.784,123,42,98,0.429,28,64,0.438,14,34,0.412,23,25,0.92,121,2012-04-16,UTA,DAL,2012,128.0
437,437,37,@,W 123-88 ,240,46,82,0.561,31,55,0.564,15,27,0.556,16,21,0.762,123,36,81,0.444,31,63,0.492,5,18,0.278,11,22,0.5,88,2012-12-29,TOR,ORL,2013,90.5
438,438,38,Home,W 123-104 ,240,45,84,0.536,29,55,0.527,16,29,0.552,17,22,0.773,123,43,90,0.478,31,67,0.463,12,23,0.522,6,7,0.857,104,2012-12-31,HOU,ATL,2013,110.0
439,439,39,Home,W 123-116 (OT),265,45,82,0.549,36,60,0.6,9,22,0.409,24,38,0.632,123,44,88,0.5,30,57,0.526,14,31,0.452,14,18,0.778,116,2013-01-23,MIA,TOR,2013,123.0
440,440,40,Home,W 123-111 (2OT),290,42,94,0.447,30,58,0.517,12,36,0.333,27,36,0.75,123,42,93,0.452,35,74,0.473,7,19,0.368,20,20,1.0,111,2013-01-25,ATL,BOS,2013,114.5
441,441,41,Home,W 123-100 ,240,43,92,0.467,30,58,0.517,13,34,0.382,24,26,0.923,123,33,80,0.413,29,64,0.453,4,16,0.25,30,36,0.833,100,2013-02-13,DAL,SAC,2013,102.0
442,442,42,Home,W 123-104 ,240,49,94,0.521,36,67,0.537,13,27,0.481,12,14,0.857,123,39,88,0.443,27,57,0.474,12,31,0.387,14,20,0.7,104,2013-11-05,DAL,LAL,2014,110.0
443,443,43,Home,W 123-117 (OT),265,43,103,0.417,32,78,0.41,11,25,0.44,26,34,0.765,123,43,96,0.448,28,55,0.509,15,41,0.366,16,25,0.64,117,2013-11-13,PHI,HOU,2014,124.5
444,444,44,Home,W 123-120 ,240,42,72,0.583,31,50,0.62,11,22,0.5,28,33,0.848,123,42,76,0.553,30,45,0.667,12,31,0.387,24,33,0.727,120,2013-11-20,DAL,HOU,2014,126.0
445,445,45,Home,W 123-108 ,240,44,86,0.512,29,56,0.518,15,30,0.5,20,22,0.909,123,44,91,0.484,41,74,0.554,3,17,0.176,17,23,0.739,108,2013-12-21,PHO,DAL,2014,109.5
446,446,46,@,W 123-94 ,240,45,84,0.536,32,60,0.533,13,24,0.542,20,26,0.769,123,38,90,0.422,32,67,0.478,6,23,0.261,12,19,0.632,94,2013-12-25,OKC,NYK,2014,97.0
447,447,47,@,W 123-114 ,240,46,82,0.561,31,53,0.585,15,29,0.517,16,19,0.842,123,40,78,0.513,32,60,0.533,8,18,0.444,26,31,0.839,114,2014-01-02,GSW,MIA,2014,118.0
448,448,48,Home,W 123-119 ,240,40,85,0.471,33,70,0.471,7,15,0.467,36,50,0.72,123,39,90,0.433,29,63,0.46,10,27,0.37,31,36,0.861,119,2014-01-07,SAC,POR,2014,124.0
449,449,49,Home,W 123-87 ,240,45,92,0.489,38,69,0.551,7,23,0.304,26,35,0.743,123,29,84,0.345,25,68,0.368,4,16,0.25,25,28,0.893,87,2014-01-10,LAC,LAL,2014,89.0
450,450,50,@,W 123-116 ,240,45,83,0.542,33,59,0.559,12,24,0.5,21,29,0.724,123,39,90,0.433,30,62,0.484,9,28,0.321,29,33,0.879,116,2014-01-15,DEN,GSW,2014,120.5
451,451,51,Home,W 123-78 ,240,50,89,0.562,41,61,0.672,9,28,0.321,14,17,0.824,123,27,100,0.27,24,72,0.333,3,28,0.107,21,25,0.84,78,2014-02-09,LAC,PHI,2014,79.5
452,452,52,Home,W 123-80 ,240,43,88,0.489,31,59,0.525,12,29,0.414,25,30,0.833,123,33,90,0.367,31,73,0.425,2,17,0.118,12,17,0.706,80,2014-02-10,GSW,PHI,2014,81.0
453,453,53,@,W 123-110 ,240,43,83,0.518,27,55,0.491,16,28,0.571,21,26,0.808,123,37,87,0.425,30,69,0.435,7,18,0.389,29,35,0.829,110,2014-02-24,LAC,NOP,2014,113.5
454,454,54,Home,W 123-110 ,240,44,81,0.543,31,49,0.633,13,32,0.406,22,34,0.647,123,43,84,0.512,37,64,0.578,6,20,0.3,18,25,0.72,110,2014-03-10,NYK,PHI,2014,113.0
455,455,55,@,W 123-122 (OT),265,44,92,0.478,34,63,0.54,10,29,0.345,25,31,0.806,123,47,95,0.495,38,68,0.559,9,27,0.333,19,25,0.76,122,2014-03-19,MIN,DAL,2014,126.5
456,456,56,Home,W 123-98 ,240,48,92,0.522,36,71,0.507,12,21,0.571,15,19,0.789,123,33,85,0.388,27,64,0.422,6,21,0.286,26,32,0.813,98,2014-03-29,PHI,DET,2014,101.0
457,457,57,@,W 123-93 ,240,42,79,0.532,30,57,0.526,12,22,0.545,27,35,0.771,123,35,83,0.422,31,65,0.477,4,18,0.222,19,26,0.731,93,2014-04-02,CHA,PHI,2014,95.0
458,458,58,Home,W 123-116 ,240,50,101,0.495,39,73,0.534,11,28,0.393,12,14,0.857,123,40,92,0.435,25,52,0.481,15,40,0.375,21,25,0.84,116,2014-04-09,DEN,HOU,2014,123.5
459,459,59,Home,W 123-70 ,240,41,80,0.513,30,48,0.625,11,32,0.344,30,36,0.833,123,23,77,0.299,16,50,0.32,7,27,0.259,17,33,0.515,70,2014-11-13,DAL,PHI,2015,73.5
460,460,60,@,W 123-104 ,240,45,79,0.57,33,58,0.569,12,21,0.571,21,24,0.875,123,42,87,0.483,34,59,0.576,8,28,0.286,12,15,0.8,104,2014-12-03,TOR,UTA,2015,108.0
461,461,61,Home,W 123-101 ,240,47,82,0.573,40,64,0.625,7,18,0.389,22,25,0.88,123,35,83,0.422,29,67,0.433,6,16,0.375,25,32,0.781,101,2014-12-06,SAS,MIN,2015,104.0
462,462,62,Home,W 123-84 ,240,49,83,0.59,38,58,0.655,11,25,0.44,14,21,0.667,123,33,88,0.375,29,67,0.433,4,21,0.19,14,25,0.56,84,2015-01-22,LAC,BRK,2015,86.0
463,463,63,Home,W 123-118 (2OT),290,50,106,0.472,47,97,0.485,3,9,0.333,20,25,0.8,123,43,104,0.413,37,79,0.468,6,25,0.24,26,32,0.813,118,2015-01-29,LAL,CHI,2015,121.0
464,464,64,Home,W 123-107 ,240,40,75,0.533,27,45,0.6,13,30,0.433,30,37,0.811,123,38,78,0.487,32,55,0.582,6,23,0.261,25,31,0.806,107,2015-02-06,TOR,LAC,2015,110.0
465,465,65,Home,W 123-118 (OT),265,44,96,0.458,37,75,0.493,7,21,0.333,28,34,0.824,123,34,96,0.354,19,61,0.311,15,35,0.429,35,44,0.795,118,2015-03-04,OKC,PHI,2015,125.5
466,466,66,@,W 123-108 ,240,45,76,0.592,27,41,0.659,18,35,0.514,15,19,0.789,123,42,88,0.477,33,69,0.478,9,19,0.474,15,27,0.556,108,2015-03-15,CLE,ORL,2015,112.5
467,467,67,Home,W 123-97 ,240,49,84,0.583,37,62,0.597,12,22,0.545,13,15,0.867,123,38,86,0.442,31,71,0.437,7,15,0.467,14,18,0.778,97,2015-03-15,SAS,MIN,2015,100.5
468,468,68,Home,W 123-115 ,240,43,84,0.512,30,54,0.556,13,30,0.433,24,26,0.923,123,41,82,0.5,28,53,0.528,13,29,0.448,20,25,0.8,115,2015-03-20,OKC,ATL,2015,121.5
469,469,69,@,W 123-111 ,240,46,75,0.613,40,63,0.635,6,12,0.5,25,31,0.806,123,45,90,0.5,37,67,0.552,8,23,0.348,13,18,0.722,111,2015-03-21,BRK,IND,2015,115.0
470,470,70,Home,W 123-93 ,240,47,85,0.553,33,51,0.647,14,34,0.412,15,17,0.882,123,40,87,0.46,34,70,0.486,6,17,0.353,7,11,0.636,93,2015-04-03,SAS,DEN,2015,96.0
471,471,71,@,W 123-110 ,240,43,95,0.453,29,59,0.492,14,36,0.389,23,32,0.719,123,34,80,0.425,31,64,0.484,3,16,0.188,39,54,0.722,110,2015-04-04,GSW,DAL,2015,111.5
472,472,72,Home,W 123-86 ,240,47,91,0.516,32,61,0.525,15,30,0.5,14,23,0.609,123,34,79,0.43,29,62,0.468,5,17,0.294,13,19,0.684,86,2015-11-21,IND,MIL,2016,88.5
473,473,73,@,W 123-106 ,240,44,80,0.55,25,54,0.463,19,26,0.731,16,23,0.696,123,38,83,0.458,25,50,0.5,13,33,0.394,17,24,0.708,106,2015-11-24,IND,WAS,2016,112.5
474,474,74,Home,W 123-111 ,240,44,85,0.518,26,49,0.531,18,36,0.5,17,20,0.85,123,38,88,0.432,25,58,0.431,13,30,0.433,22,24,0.917,111,2015-12-03,POR,IND,2016,117.5
475,475,75,Home,L 123-131 ,240,44,100,0.44,30,67,0.448,14,33,0.424,21,26,0.808,123,52,95,0.547,36,60,0.6,16,35,0.457,11,15,0.733,131,2015-12-08,IND,GSW,2016,139.0
476,476,76,Home,W 123-122 (OT),265,46,93,0.495,39,74,0.527,7,19,0.368,24,31,0.774,123,48,93,0.516,39,70,0.557,9,23,0.391,17,27,0.63,122,2015-12-09,MIN,LAL,2016,126.5
477,477,77,@,W 123-99 ,240,39,78,0.5,21,41,0.512,18,37,0.486,27,30,0.9,123,32,80,0.4,25,60,0.417,7,20,0.35,28,37,0.757,99,2015-12-11,CHA,MEM,2016,102.5
478,478,78,@,L 123-131 ,240,49,100,0.49,39,84,0.464,10,16,0.625,15,22,0.682,123,43,86,0.5,35,64,0.547,8,22,0.364,37,40,0.925,131,2015-12-29,MIL,OKC,2016,135.0
479,479,79,@,W 123-98 ,240,49,90,0.544,40,70,0.571,9,20,0.45,16,20,0.8,123,37,77,0.481,34,65,0.523,3,12,0.25,21,30,0.7,98,2016-01-04,SAS,MIL,2016,99.5
480,480,80,Home,W 123-98 ,240,52,86,0.605,43,65,0.662,9,21,0.429,10,13,0.769,123,37,79,0.468,30,61,0.492,7,18,0.389,17,18,0.944,98,2016-01-06,SAS,UTA,2016,101.5
481,481,81,@,W 123-114 ,240,38,80,0.475,26,50,0.52,12,30,0.4,35,59,0.593,123,43,95,0.453,31,71,0.437,12,24,0.5,16,18,0.889,114,2016-01-20,DET,HOU,2016,120.0
482,482,82,Home,L 123-126 ,240,50,90,0.556,45,76,0.592,5,14,0.357,18,28,0.643,123,48,91,0.527,38,71,0.535,10,20,0.5,20,21,0.952,126,2016-01-27,MIN,OKC,2016,131.0
483,483,83,@,W 123-122 ,240,45,86,0.523,34,54,0.63,11,32,0.344,22,30,0.733,123,41,86,0.477,24,51,0.471,17,35,0.486,23,33,0.697,122,2016-01-30,WAS,HOU,2016,130.5
484,484,84,Home,W 123-110 ,240,44,94,0.468,32,60,0.533,12,34,0.353,23,26,0.885,123,37,87,0.425,24,54,0.444,13,33,0.394,23,35,0.657,110,2016-02-09,GSW,HOU,2016,116.5
485,485,85,Home,W 123-119 ,240,47,90,0.522,35,70,0.5,12,20,0.6,17,18,0.944,123,47,86,0.547,39,67,0.582,8,19,0.421,17,22,0.773,119,2016-02-25,NOP,OKC,2016,123.0
486,486,86,Home,W 123-103 ,240,44,84,0.524,32,62,0.516,12,22,0.545,23,28,0.821,123,35,78,0.449,24,47,0.511,11,31,0.355,22,23,0.957,103,2016-03-06,DET,POR,2016,108.5
487,487,87,Home,W 123-116 ,240,42,84,0.5,31,51,0.608,11,33,0.333,28,33,0.848,123,45,92,0.489,34,63,0.54,11,29,0.379,15,20,0.75,116,2016-03-12,GSW,PHO,2016,121.5
488,488,88,@,W 123-108 ,240,49,90,0.544,37,69,0.536,12,21,0.571,13,16,0.813,123,42,90,0.467,33,72,0.458,9,18,0.5,15,17,0.882,108,2016-03-16,NOP,SAC,2016,112.5
489,489,89,Home,W 123-75 ,240,46,89,0.517,29,57,0.509,17,32,0.531,14,19,0.737,123,26,85,0.306,19,65,0.292,7,20,0.35,16,22,0.727,75,2016-03-28,UTA,LAL,2016,78.5
490,490,90,Home,W 123-109 ,240,45,80,0.563,29,49,0.592,16,31,0.516,17,22,0.773,123,35,74,0.473,27,45,0.6,8,29,0.276,31,34,0.912,109,2016-04-06,IND,CLE,2016,113.0
491,491,91,@,W 123-116 ,240,48,90,0.533,39,68,0.574,9,22,0.409,18,20,0.9,123,41,85,0.482,30,53,0.566,11,32,0.344,23,29,0.793,116,2016-11-02,LAL,ATL,2017,121.5
492,492,92,@,W 123-107 ,240,44,84,0.524,33,61,0.541,11,23,0.478,24,31,0.774,123,41,90,0.456,33,65,0.508,8,25,0.32,17,21,0.81,107,2016-11-06,DEN,BOS,2017,111.0
493,493,93,@,W 123-107 ,240,45,87,0.517,32,64,0.5,13,23,0.565,20,26,0.769,123,38,85,0.447,30,61,0.492,8,24,0.333,23,30,0.767,107,2016-11-09,MIN,ORL,2017,111.0
494,494,94,Home,W 123-115 ,240,39,74,0.527,29,49,0.592,10,25,0.4,35,42,0.833,123,40,80,0.5,32,61,0.525,8,19,0.421,27,32,0.844,115,2016-11-21,LAC,TOR,2017,119.0
495,495,95,@,W 123-114 ,240,41,87,0.471,31,58,0.534,10,29,0.345,31,36,0.861,123,43,86,0.5,34,57,0.596,9,29,0.31,19,25,0.76,114,2016-12-14,TOR,PHI,2017,118.5
496,496,96,Home,W 123-96 ,240,45,80,0.563,36,55,0.655,9,25,0.36,24,27,0.889,123,37,79,0.468,30,55,0.545,7,24,0.292,15,18,0.833,96,2016-12-23,MIL,WAS,2017,99.5
497,497,97,Home,W 123-116 ,240,42,79,0.532,30,53,0.566,12,26,0.462,27,37,0.73,123,42,83,0.506,29,52,0.558,13,31,0.419,19,22,0.864,116,2016-12-23,PHO,PHI,2017,122.5
498,498,98,@,W 123-107 ,240,41,78,0.526,24,46,0.522,17,32,0.531,24,28,0.857,123,36,87,0.414,21,49,0.429,15,38,0.395,20,25,0.8,107,2016-12-27,HOU,DAL,2017,114.5
499,499,99,@,W 123-114 ,240,42,75,0.56,32,58,0.552,10,17,0.588,29,32,0.906,123,37,92,0.402,22,60,0.367,15,32,0.469,25,31,0.806,114,2017-01-01,TOR,LAL,2017,121.5
500,500,0,Home,W 123-112 ,240,37,80,0.463,28,56,0.5,9,24,0.375,40,49,0.816,123,42,96,0.438,33,66,0.5,9,30,0.3,19,23,0.826,112,2017-01-04,CHA,OKC,2017,116.5
501,501,1,Home,W 123-118 (OT),265,38,97,0.392,27,69,0.391,11,28,0.393,36,39,0.923,123,37,85,0.435,29,54,0.537,8,31,0.258,36,43,0.837,118,2017-01-07,CHI,TOR,2017,122.0
502,502,2,Home,W 123-109 ,240,43,86,0.5,32,62,0.516,11,24,0.458,26,28,0.929,123,40,87,0.46,28,56,0.5,12,31,0.387,17,24,0.708,109,2017-01-07,IND,NYK,2017,115.0
503,503,3,Home,L 123-127 (OT),265,42,92,0.457,29,57,0.509,13,35,0.371,26,31,0.839,123,43,92,0.467,33,67,0.493,10,25,0.4,31,36,0.861,127,2017-01-21,BOS,POR,2017,132.0
504,504,4,Home,W 123-98 ,240,46,87,0.529,36,63,0.571,10,24,0.417,21,26,0.808,123,40,96,0.417,30,64,0.469,10,32,0.313,8,8,1.0,98,2017-01-21,DEN,LAC,2017,103.0
505,505,5,Home,W 123-108 ,240,48,83,0.578,39,63,0.619,9,20,0.45,18,21,0.857,123,38,84,0.452,28,51,0.549,10,33,0.303,22,24,0.917,108,2017-01-24,WAS,BOS,2017,113.0
506,506,6,@,W 123-118 ,240,42,81,0.519,30,50,0.6,12,31,0.387,27,28,0.964,123,42,78,0.538,32,53,0.604,10,25,0.4,24,32,0.75,118,2017-01-27,HOU,PHI,2017,123.0
507,507,7,@,W 123-112 ,240,39,80,0.488,31,55,0.564,8,25,0.32,37,42,0.881,123,41,91,0.451,35,70,0.5,6,21,0.286,24,32,0.75,112,2017-01-28,DEN,PHO,2017,115.0
508,508,8,Home,W 123-92 ,240,48,85,0.565,33,57,0.579,15,28,0.536,12,13,0.923,123,37,92,0.402,33,68,0.485,4,24,0.167,14,19,0.737,92,2017-02-08,GSW,CHI,2017,94.0
509,509,9,Home,L 123-131 ,240,52,93,0.559,36,55,0.655,16,38,0.421,3,5,0.6,123,54,95,0.568,38,63,0.603,16,32,0.5,7,10,0.7,131,2017-02-10,NYK,DEN,2017,139.0
510,510,10,Home,W 123-113 ,240,43,81,0.531,30,55,0.545,13,26,0.5,24,26,0.923,123,38,93,0.409,27,65,0.415,11,28,0.393,26,37,0.703,113,2017-02-23,GSW,LAC,2017,118.5
511,511,11,Home,W 123-108 ,240,39,78,0.5,21,36,0.583,18,42,0.429,27,36,0.75,123,43,97,0.443,35,69,0.507,8,28,0.286,14,21,0.667,108,2017-03-04,HOU,MEM,2017,112.0
512,512,12,@,W 123-113 ,240,50,88,0.568,39,62,0.629,11,26,0.423,12,19,0.632,123,46,87,0.529,33,59,0.559,13,28,0.464,8,17,0.471,113,2017-03-08,WAS,DEN,2017,119.5
513,513,13,@,W 122-93 ,240,50,91,0.549,48,78,0.615,2,13,0.154,20,25,0.8,122,34,78,0.436,25,58,0.431,9,20,0.45,16,22,0.727,93,2012-01-25,DEN,SAC,2012,97.5
514,514,14,@,W 122-99 ,240,48,87,0.552,34,60,0.567,14,27,0.519,12,18,0.667,122,35,80,0.438,23,59,0.39,12,21,0.571,17,20,0.85,99,2012-01-30,DAL,PHO,2012,105.0
515,515,15,@,W 122-110 ,240,43,80,0.538,31,57,0.544,12,23,0.522,24,28,0.857,122,40,83,0.482,30,57,0.526,10,26,0.385,20,28,0.714,110,2012-03-03,MIN,POR,2012,115.0
516,516,16,Home,W 122-95 ,240,46,73,0.63,36,50,0.72,10,23,0.435,20,26,0.769,122,36,88,0.409,29,74,0.392,7,14,0.5,16,19,0.842,95,2012-03-10,OKC,CHA,2012,98.5
517,517,17,Home,W 122-111 ,240,43,83,0.518,30,57,0.526,13,26,0.5,23,27,0.852,122,45,86,0.523,34,59,0.576,11,27,0.407,10,16,0.625,111,2012-03-14,SAS,ORL,2012,116.5
518,518,18,Home,W 122-117 (OT),265,44,98,0.449,36,72,0.5,8,26,0.308,26,32,0.813,122,43,96,0.448,31,72,0.431,12,24,0.5,19,25,0.76,117,2012-04-08,BRK,CLE,2012,123.0
519,519,19,Home,W 122-103 ,240,47,87,0.54,30,54,0.556,17,33,0.515,11,17,0.647,122,40,86,0.465,32,62,0.516,8,24,0.333,15,22,0.682,103,2012-11-30,LAL,DEN,2013,107.0
520,520,20,@,W 122-97 ,240,46,85,0.541,38,67,0.567,8,18,0.444,22,29,0.759,122,31,91,0.341,25,67,0.373,6,24,0.25,29,34,0.853,97,2012-12-16,DEN,SAC,2013,100.0
521,521,21,Home,W 122-116 ,240,44,77,0.571,32,54,0.593,12,23,0.522,22,24,0.917,122,45,86,0.523,34,54,0.63,11,32,0.344,15,26,0.577,116,2012-12-28,SAS,HOU,2013,121.5
522,522,22,Home,W 122-95 ,240,52,92,0.565,43,68,0.632,9,24,0.375,9,13,0.692,122,37,79,0.468,31,64,0.484,6,15,0.4,15,25,0.6,95,2013-02-06,CLE,CHA,2013,98.0
523,523,23,Home,W 122-119 ,240,44,92,0.478,29,59,0.492,15,33,0.455,19,23,0.826,122,42,87,0.483,31,59,0.525,11,28,0.393,24,27,0.889,119,2013-02-20,HOU,OKC,2013,124.5
524,524,24,Home,W 122-108 ,240,49,92,0.533,37,65,0.569,12,27,0.444,12,19,0.632,122,38,88,0.432,26,66,0.394,12,22,0.545,20,25,0.8,108,2013-02-22,ATL,SAC,2013,114.0
525,525,25,Home,W 122-114 (OT),265,46,92,0.5,41,78,0.526,5,14,0.357,25,30,0.833,122,46,100,0.46,38,78,0.487,8,22,0.364,14,18,0.778,114,2013-03-02,MIL,TOR,2013,118.0
526,526,26,Home,W 122-105 ,240,49,82,0.598,37,58,0.638,12,24,0.5,12,17,0.706,122,45,97,0.464,44,87,0.506,1,10,0.1,14,18,0.778,105,2013-03-04,POR,CHA,2013,105.5
527,527,27,Home,W 122-105 ,240,46,96,0.479,38,73,0.521,8,23,0.348,22,24,0.917,122,31,77,0.403,19,48,0.396,12,29,0.414,31,40,0.775,105,2013-03-05,OKC,LAL,2013,111.0
528,528,28,Home,W 122-111 ,240,41,81,0.506,32,60,0.533,9,21,0.429,31,44,0.705,122,45,99,0.455,37,75,0.493,8,24,0.333,13,18,0.722,111,2013-11-16,HOU,DEN,2014,115.0
529,529,29,@,W 122-101 ,240,48,89,0.539,35,66,0.53,13,23,0.565,13,15,0.867,122,35,78,0.449,31,65,0.477,4,13,0.308,27,33,0.818,101,2013-12-11,UTA,SAC,2014,103.0
530,530,30,Home,W 122-97 ,240,47,99,0.475,39,74,0.527,8,25,0.32,20,23,0.87,122,36,87,0.414,29,62,0.468,7,25,0.28,18,31,0.581,97,2013-12-13,OKC,LAL,2014,100.5
531,531,31,Home,W 122-103 ,240,51,83,0.614,41,60,0.683,10,23,0.435,10,14,0.714,122,43,74,0.581,36,52,0.692,7,22,0.318,10,24,0.417,103,2013-12-20,MIA,SAC,2014,106.5
532,532,32,Home,W 122-108 ,240,39,71,0.549,28,55,0.509,11,16,0.688,33,42,0.786,122,42,90,0.467,34,60,0.567,8,30,0.267,16,21,0.762,108,2014-02-05,HOU,PHO,2014,112.0
533,533,33,Home,W 122-109 ,240,43,80,0.538,32,59,0.542,11,21,0.524,25,30,0.833,122,41,84,0.488,33,59,0.559,8,25,0.32,19,26,0.731,109,2014-02-08,PHO,GSW,2014,113.0
534,534,34,Home,W 122-117 ,240,46,79,0.582,42,69,0.609,4,10,0.4,26,31,0.839,122,43,84,0.512,30,53,0.566,13,31,0.419,18,22,0.818,117,2014-02-12,LAC,POR,2014,123.5
535,535,35,@,L 122-126 ,240,47,93,0.505,42,78,0.538,5,15,0.333,23,32,0.719,122,48,80,0.6,29,53,0.547,19,27,0.704,11,16,0.688,126,2014-02-28,SAC,LAL,2014,135.5
536,536,36,@,W 122-103 ,240,45,89,0.506,33,63,0.524,12,26,0.462,20,28,0.714,122,38,84,0.452,33,62,0.532,5,22,0.227,22,32,0.688,103,2014-03-01,WAS,PHI,2014,105.5
537,537,37,@,W 122-101 ,240,43,90,0.478,29,57,0.509,14,33,0.424,22,24,0.917,122,38,79,0.481,28,60,0.467,10,19,0.526,15,20,0.75,101,2014-03-04,SAS,CLE,2014,106.0
538,538,38,@,L 122-128 ,240,45,90,0.5,32,57,0.561,13,33,0.394,19,19,1.0,122,42,80,0.525,27,53,0.509,15,27,0.556,29,39,0.744,128,2014-03-06,OKC,PHO,2014,135.5
539,539,39,Home,W 122-104 ,240,49,78,0.628,39,62,0.629,10,16,0.625,14,19,0.737,122,42,91,0.462,37,80,0.463,5,11,0.455,15,21,0.714,104,2014-03-16,SAS,UTA,2014,106.5
540,540,40,Home,L 122-123 (OT),265,47,95,0.495,38,68,0.559,9,27,0.333,19,25,0.76,122,44,92,0.478,34,63,0.54,10,29,0.345,25,31,0.806,123,2014-03-19,DAL,MIN,2014,128.0
541,541,41,Home,W 122-106 ,240,48,89,0.539,36,67,0.537,12,22,0.545,14,17,0.824,122,40,81,0.494,27,51,0.529,13,30,0.433,13,21,0.619,106,2014-03-21,DAL,DEN,2014,112.5
542,542,42,@,W 122-120 (OT),265,52,91,0.571,37,60,0.617,15,31,0.484,3,6,0.5,122,47,96,0.49,33,66,0.5,14,30,0.467,12,16,0.75,120,2014-04-01,GSW,DAL,2014,127.0
543,543,43,@,W 122-121 (2OT),290,43,93,0.462,31,61,0.508,12,32,0.375,24,34,0.706,122,43,99,0.434,32,63,0.508,11,36,0.306,24,30,0.8,121,2014-04-04,MIN,MIA,2014,126.5
544,544,44,Home,W 122-115 ,240,45,77,0.584,34,54,0.63,11,23,0.478,21,31,0.677,122,40,84,0.476,31,52,0.596,9,32,0.281,26,32,0.813,115,2014-04-06,PHO,OKC,2014,119.5
545,545,45,Home,W 122-100 ,240,53,93,0.57,42,67,0.627,11,26,0.423,5,9,0.556,122,34,96,0.354,25,68,0.368,9,28,0.321,23,32,0.719,100,2014-04-09,CLE,DET,2014,104.5
546,546,46,Home,W 122-119 (2OT),290,48,97,0.495,42,76,0.553,6,21,0.286,20,27,0.741,122,43,93,0.462,30,60,0.5,13,33,0.394,20,26,0.769,119,2014-11-07,CHA,ATL,2015,125.5
547,547,47,@,W 122-121 ,240,43,85,0.506,35,62,0.565,8,23,0.348,28,37,0.757,122,48,88,0.545,42,68,0.618,6,20,0.3,19,23,0.826,121,2014-11-14,CLE,BOS,2015,124.0
548,548,48,@,W 122-118 (3OT),315,48,108,0.444,43,84,0.512,5,24,0.208,21,28,0.75,122,44,92,0.478,35,61,0.574,9,31,0.29,21,29,0.724,118,2014-11-19,MIL,BRK,2015,122.5
549,549,49,@,W 122-96 ,240,44,86,0.512,31,55,0.564,13,31,0.419,21,23,0.913,122,36,78,0.462,32,55,0.582,4,23,0.174,20,33,0.606,96,2014-11-21,PHO,PHI,2015,98.0
550,550,50,Home,W 122-97 ,240,41,88,0.466,33,67,0.493,8,21,0.381,32,36,0.889,122,33,85,0.388,25,62,0.403,8,23,0.348,23,29,0.793,97,2014-11-28,DEN,PHO,2015,101.0
551,551,51,@,L 122-129 (OT),265,45,104,0.433,36,70,0.514,9,34,0.265,23,31,0.742,122,47,96,0.49,37,72,0.514,10,24,0.417,25,34,0.735,129,2014-11-30,TOR,LAL,2015,134.0
552,552,52,Home,L 122-128 (OT),265,47,101,0.465,39,74,0.527,8,27,0.296,20,25,0.8,122,44,86,0.512,33,62,0.532,11,24,0.458,29,35,0.829,128,2014-12-14,NOP,GSW,2015,133.5
553,553,53,Home,W 122-110 (2OT),290,48,100,0.48,39,79,0.494,9,21,0.429,17,24,0.708,122,42,100,0.42,34,65,0.523,8,35,0.229,18,23,0.783,110,2015-01-11,MEM,PHO,2015,114.0
554,554,54,Home,W 122-79 ,240,44,81,0.543,31,54,0.574,13,27,0.481,21,27,0.778,122,30,87,0.345,23,63,0.365,7,24,0.292,12,19,0.632,79,2015-01-19,GSW,DEN,2015,82.5
555,555,55,Home,L 122-127 (OT),265,49,101,0.485,45,82,0.549,4,19,0.211,20,26,0.769,122,47,92,0.511,40,66,0.606,7,26,0.269,26,30,0.867,127,2015-01-30,BRK,TOR,2015,130.5
556,556,56,@,W 122-106 ,240,52,90,0.578,47,77,0.61,5,13,0.385,13,17,0.765,122,41,88,0.466,32,73,0.438,9,15,0.6,15,17,0.882,106,2015-03-16,BRK,MIN,2015,110.5
557,557,57,Home,W 122-118 ,240,42,88,0.477,37,69,0.536,5,19,0.263,33,39,0.846,122,44,84,0.524,31,50,0.62,13,34,0.382,17,28,0.607,118,2015-03-18,OKC,BOS,2015,124.5
558,558,58,@,W 122-108 ,240,50,83,0.602,38,57,0.667,12,26,0.462,10,11,0.909,122,39,92,0.424,24,58,0.414,15,34,0.441,15,19,0.789,108,2015-03-24,GSW,POR,2015,115.5
559,559,59,Home,L 122-126 ,240,45,89,0.506,32,64,0.5,13,25,0.52,19,25,0.76,122,46,86,0.535,31,58,0.534,15,28,0.536,19,24,0.792,126,2015-04-01,POR,LAC,2015,133.5
560,560,60,Home,W 122-111 ,240,45,82,0.549,36,56,0.643,9,26,0.346,23,30,0.767,122,38,74,0.514,33,56,0.589,5,18,0.278,30,42,0.714,111,2015-04-12,DEN,SAC,2015,113.5
561,561,61,@,W 122-99 ,240,46,84,0.548,38,67,0.567,8,17,0.471,22,41,0.537,122,36,94,0.383,29,70,0.414,7,24,0.292,20,25,0.8,99,2015-04-15,SAC,LAL,2015,102.5
562,562,62,@,W 122-97 ,240,42,93,0.452,33,70,0.471,9,23,0.391,29,35,0.829,122,30,86,0.349,21,68,0.309,9,18,0.5,28,31,0.903,97,2015-10-28,NYK,MIL,2016,101.5
563,563,63,Home,W 122-114 ,240,37,84,0.44,25,67,0.373,12,17,0.706,36,39,0.923,122,41,81,0.506,31,57,0.544,10,24,0.417,22,31,0.71,114,2015-11-16,MEM,OKC,2016,119.0
564,564,64,Home,W 122-116 ,240,39,85,0.459,28,55,0.509,11,30,0.367,33,40,0.825,122,35,90,0.389,18,54,0.333,17,36,0.472,29,33,0.879,116,2015-11-22,NOP,PHO,2016,124.5
565,565,65,@,L 122-127 (OT),265,52,104,0.5,44,73,0.603,8,31,0.258,10,16,0.625,122,49,98,0.5,40,69,0.58,9,29,0.31,20,26,0.769,127,2015-11-23,SAC,CHO,2016,131.5
566,566,66,@,L 122-127 (OT),265,47,97,0.485,33,64,0.516,14,33,0.424,14,15,0.933,122,44,87,0.506,32,60,0.533,12,27,0.444,27,44,0.614,127,2015-12-02,PHO,DET,2016,133.0
567,567,67,Home,W 122-119 (OT),265,43,92,0.467,35,69,0.507,8,23,0.348,28,37,0.757,122,40,93,0.43,28,64,0.438,12,29,0.414,27,34,0.794,119,2015-12-05,UTA,IND,2016,125.0
568,568,68,@,L 122-123 (OT),265,48,93,0.516,39,70,0.557,9,23,0.391,17,27,0.63,122,46,93,0.495,39,74,0.527,7,19,0.368,24,31,0.774,123,2015-12-09,LAL,MIN,2016,126.5
569,569,69,Home,W 122-112 ,240,48,83,0.578,40,68,0.588,8,15,0.533,18,21,0.857,122,46,94,0.489,37,69,0.536,9,25,0.36,11,15,0.733,112,2015-12-27,OKC,DEN,2016,116.5
570,570,70,Home,W 122-103 ,240,43,89,0.483,23,47,0.489,20,42,0.476,16,24,0.667,122,37,95,0.389,24,64,0.375,13,31,0.419,16,28,0.571,103,2015-12-28,GSW,SAC,2016,109.5
571,571,71,@,W 122-117 ,240,37,71,0.521,22,41,0.537,15,30,0.5,33,41,0.805,122,38,88,0.432,29,58,0.5,9,30,0.3,32,36,0.889,117,2015-12-30,LAC,CHO,2016,121.5
572,572,72,Home,W 122-100 ,240,41,74,0.554,24,41,0.585,17,33,0.515,23,26,0.885,122,36,73,0.493,28,54,0.519,8,19,0.421,20,29,0.69,100,2016-01-04,CLE,TOR,2016,104.0
573,573,73,Home,W 122-110 ,240,43,90,0.478,29,57,0.509,14,33,0.424,22,25,0.88,122,44,95,0.463,41,78,0.526,3,17,0.176,19,27,0.704,110,2016-01-22,GSW,IND,2016,111.5
574,574,74,Home,L 122-128 (OT),265,44,95,0.463,33,72,0.458,11,23,0.478,23,30,0.767,122,46,99,0.465,35,79,0.443,11,20,0.55,25,29,0.862,128,2016-01-26,NYK,OKC,2016,133.5
575,575,75,Home,L 122-123 ,240,41,86,0.477,24,51,0.471,17,35,0.486,23,33,0.697,122,45,86,0.523,34,54,0.63,11,32,0.344,22,30,0.733,123,2016-01-30,HOU,WAS,2016,128.5
576,576,76,@,W 122-106 ,240,42,85,0.494,27,52,0.519,15,33,0.455,23,30,0.767,122,37,73,0.507,36,62,0.581,1,11,0.091,31,39,0.795,106,2016-02-08,OKC,PHO,2016,106.5
577,577,77,@,L 122-124 ,240,49,101,0.485,39,73,0.534,10,28,0.357,14,17,0.824,122,43,83,0.518,35,68,0.515,8,15,0.533,30,40,0.75,124,2016-02-22,BOS,MIN,2016,128.0
578,578,78,@,W 122-95 ,240,46,87,0.529,35,62,0.565,11,25,0.44,19,25,0.76,122,37,84,0.44,31,64,0.484,6,20,0.3,15,23,0.652,95,2016-02-22,TOR,NYK,2016,98.0
579,579,79,Home,W 122-116 (OT),265,45,88,0.511,34,59,0.576,11,29,0.379,21,27,0.778,122,43,93,0.462,34,64,0.531,9,29,0.31,21,31,0.677,116,2016-02-26,DAL,DEN,2016,120.5
580,580,80,Home,W 122-113 ,240,38,82,0.463,23,47,0.489,15,35,0.429,31,38,0.816,122,40,85,0.471,30,52,0.577,10,33,0.303,23,28,0.821,113,2016-03-09,CHA,NOP,2016,118.0
581,581,81,@,W 122-106 ,240,43,76,0.566,31,46,0.674,12,30,0.4,24,32,0.75,122,40,82,0.488,31,57,0.544,9,25,0.36,17,24,0.708,106,2016-03-16,LAC,HOU,2016,110.5
582,582,82,Home,W 122-101 ,240,46,84,0.548,35,65,0.538,11,19,0.579,19,23,0.826,122,40,76,0.526,30,52,0.577,10,24,0.417,11,13,0.846,101,2016-03-19,MIA,CLE,2016,106.0
583,583,83,@,W 122-101 ,240,45,84,0.536,28,42,0.667,17,42,0.405,15,22,0.682,122,39,92,0.424,27,62,0.435,12,30,0.4,11,12,0.917,101,2016-03-23,ATL,WAS,2016,107.0
584,584,84,Home,W 122-98 ,240,48,95,0.505,38,70,0.543,10,25,0.4,16,19,0.842,122,35,77,0.455,20,42,0.476,15,35,0.429,13,25,0.52,98,2016-04-12,TOR,PHI,2016,105.5
585,585,85,Home,W 122-117 ,240,48,89,0.539,37,57,0.649,11,32,0.344,15,18,0.833,122,43,97,0.443,28,53,0.528,15,44,0.341,16,20,0.8,117,2016-10-26,BOS,BRK,2017,124.5
586,586,86,@,W 122-114 ,240,44,91,0.484,35,63,0.556,9,28,0.321,25,28,0.893,122,47,100,0.47,42,78,0.538,5,22,0.227,15,23,0.652,114,2016-10-28,GSW,NOP,2017,116.5
587,587,87,@,L 122-128 ,240,46,96,0.479,35,64,0.547,11,32,0.344,19,22,0.864,122,41,84,0.488,27,50,0.54,14,34,0.412,32,37,0.865,128,2016-11-03,BOS,CLE,2017,135.0
588,588,88,Home,W 122-96 ,240,46,89,0.517,32,59,0.542,14,30,0.467,16,20,0.8,122,35,87,0.402,25,60,0.417,10,27,0.37,16,28,0.571,96,2016-11-03,GSW,OKC,2017,101.0
589,589,89,Home,W 122-100 ,240,41,84,0.488,29,52,0.558,12,32,0.375,28,32,0.875,122,40,94,0.426,31,61,0.508,9,33,0.273,11,15,0.733,100,2016-11-07,CHA,IND,2017,104.5
590,590,90,Home,W 122-115 (OT),265,49,90,0.544,40,71,0.563,9,19,0.474,15,20,0.75,122,46,95,0.484,32,59,0.542,14,36,0.389,9,19,0.474,115,2016-11-09,IND,PHI,2017,122.0
591,591,91,Home,W 122-120 (OT),265,45,86,0.523,32,53,0.604,13,33,0.394,19,27,0.704,122,43,88,0.489,37,67,0.552,6,21,0.286,28,35,0.8,120,2016-11-11,POR,SAC,2017,123.0
592,592,92,@,W 122-104 ,240,40,84,0.476,24,47,0.511,16,37,0.432,26,30,0.867,122,40,107,0.374,32,74,0.432,8,33,0.242,16,21,0.762,104,2016-11-12,BRK,PHO,2017,108.0
593,593,93,@,W 122-105 ,240,46,86,0.535,33,63,0.524,13,23,0.565,17,22,0.773,122,38,87,0.437,22,48,0.458,16,39,0.41,13,14,0.929,105,2016-11-27,SAC,BRK,2017,113.0
594,594,94,Home,W 122-95 ,240,42,77,0.545,29,58,0.5,13,19,0.684,25,31,0.806,122,36,86,0.419,22,52,0.423,14,34,0.412,9,13,0.692,95,2016-11-28,TOR,PHI,2017,102.0
595,595,95,@,L 122-127 (2OT),290,46,109,0.422,33,69,0.478,13,40,0.325,17,22,0.773,122,45,104,0.433,32,66,0.485,13,38,0.342,24,36,0.667,127,2016-11-29,LAC,BRK,2017,133.5
596,596,96,Home,W 122-118 ,240,42,91,0.462,25,48,0.521,17,43,0.395,21,36,0.583,122,42,80,0.525,35,60,0.583,7,20,0.35,27,36,0.75,118,2016-12-12,HOU,BRK,2017,121.5
597,597,97,Home,W 122-100 ,240,42,81,0.519,28,56,0.5,14,25,0.56,24,28,0.857,122,42,89,0.472,38,65,0.585,4,24,0.167,12,17,0.706,100,2016-12-12,TOR,MIL,2017,102.0
598,598,98,Home,W 122-100 ,240,42,94,0.447,18,33,0.545,24,61,0.393,14,19,0.737,122,40,98,0.408,31,71,0.437,9,27,0.333,11,20,0.55,100,2016-12-16,HOU,NOP,2017,104.5
599,599,99,Home,W 122-108 ,240,44,77,0.571,32,52,0.615,12,25,0.48,22,27,0.815,122,42,86,0.488,32,58,0.552,10,28,0.357,14,21,0.667,108,2016-12-16,WAS,DET,2017,113.0
600,600,0,Home,L 122-124 ,240,39,84,0.464,28,57,0.491,11,27,0.407,33,41,0.805,122,38,87,0.437,22,54,0.407,16,33,0.485,32,40,0.8,124,2016-12-30,DEN,PHI,2017,132.0
601,601,1,@,L 122-129 ,240,47,105,0.448,37,73,0.507,10,32,0.313,18,25,0.72,122,42,92,0.457,21,37,0.568,21,55,0.382,24,29,0.828,129,2016-12-31,NYK,HOU,2017,139.5
602,602,2,Home,L 122-129 ,240,42,78,0.538,31,53,0.585,11,25,0.44,27,30,0.9,122,46,89,0.517,35,51,0.686,11,38,0.289,26,31,0.839,129,2017-01-08,TOR,HOU,2017,134.5
603,603,3,@,W 122-118 ,240,40,90,0.444,31,62,0.5,9,28,0.321,33,41,0.805,122,37,81,0.457,28,56,0.5,9,25,0.36,35,40,0.875,118,2017-01-15,OKC,SAC,2017,122.5
604,604,4,Home,W 122-114 ,240,43,84,0.512,35,66,0.53,8,18,0.444,28,35,0.8,122,36,73,0.493,30,60,0.5,6,13,0.462,36,41,0.878,114,2017-01-17,SAS,MIN,2017,117.0
605,605,5,Home,W 122-73 ,240,43,87,0.494,26,48,0.542,17,39,0.436,19,19,1.0,122,28,73,0.384,25,52,0.481,3,21,0.143,14,17,0.824,73,2017-01-22,DAL,LAL,2017,74.5
606,606,6,@,L 122-124 ,240,43,93,0.462,28,56,0.5,15,37,0.405,21,25,0.84,122,43,87,0.494,27,48,0.563,16,39,0.41,22,30,0.733,124,2017-01-23,CLE,NOP,2017,132.0
607,607,7,Home,W 122-119 ,240,45,83,0.542,34,52,0.654,11,31,0.355,21,26,0.808,122,41,74,0.554,28,45,0.622,13,29,0.448,24,29,0.828,119,2017-01-30,PHI,SAC,2017,125.5
608,608,8,@,W 122-107 ,240,39,77,0.506,24,44,0.545,15,33,0.455,29,38,0.763,122,34,87,0.391,25,61,0.41,9,26,0.346,30,37,0.811,107,2017-02-10,GSW,MEM,2017,111.5
609,609,9,@,W 122-114 ,240,39,75,0.52,24,45,0.533,15,30,0.5,29,35,0.829,122,40,76,0.526,32,48,0.667,8,28,0.286,26,31,0.839,114,2017-02-10,LAL,MIL,2017,118.0
610,610,10,@,W 122-106 ,240,45,75,0.6,33,50,0.66,12,25,0.48,20,27,0.741,122,38,82,0.463,32,55,0.582,6,27,0.222,24,32,0.75,106,2017-02-10,NOP,MIN,2017,109.0
611,611,11,@,W 122-103 ,240,37,87,0.425,17,35,0.486,20,52,0.385,28,33,0.848,122,42,94,0.447,30,60,0.5,12,34,0.353,7,13,0.538,103,2017-03-01,HOU,LAC,2017,109.0
612,612,12,@,W 122-109 ,240,39,73,0.534,25,43,0.581,14,30,0.467,30,38,0.789,122,34,77,0.442,24,52,0.462,10,25,0.4,31,39,0.795,109,2017-03-06,BRK,MEM,2017,114.0
613,613,13,Home,W 122-111 ,240,45,83,0.542,28,52,0.538,17,31,0.548,15,19,0.789,122,42,90,0.467,31,60,0.517,11,30,0.367,16,22,0.727,111,2017-03-07,DAL,LAL,2017,116.5
614,614,14,@,W 122-110 ,240,47,98,0.48,35,71,0.493,12,27,0.444,16,24,0.667,122,42,91,0.462,36,72,0.5,6,19,0.316,20,25,0.8,110,2017-03-09,LAL,PHO,2017,113.0
615,615,15,Home,W 121-117 ,240,49,89,0.551,40,69,0.58,9,20,0.45,14,18,0.778,121,46,81,0.568,38,65,0.585,8,16,0.5,17,26,0.654,117,2012-01-07,SAS,DEN,2012,121.0
616,616,16,Home,W 121-94 ,240,46,83,0.554,35,59,0.593,11,24,0.458,18,24,0.75,121,34,70,0.486,27,50,0.54,7,20,0.35,19,27,0.704,94,2012-01-21,ATL,CLE,2012,97.5
617,617,17,Home,W 121-115 ,240,44,84,0.524,35,65,0.538,9,19,0.474,24,26,0.923,121,42,89,0.472,33,72,0.458,9,17,0.529,22,28,0.786,115,2012-02-14,CHI,SAC,2012,119.5
618,618,18,Home,W 121-79 ,240,43,80,0.538,24,42,0.571,19,38,0.5,16,26,0.615,121,28,75,0.373,23,58,0.397,5,17,0.294,18,23,0.783,79,2012-03-14,NYK,POR,2012,81.5
619,619,19,Home,W 121-102 ,240,48,81,0.593,41,66,0.621,7,15,0.467,18,29,0.621,121,36,78,0.462,30,60,0.5,6,18,0.333,24,32,0.75,102,2012-03-23,UTA,DEN,2012,105.0
620,620,20,@,W 121-84 ,240,50,88,0.568,40,72,0.556,10,16,0.625,11,18,0.611,121,34,85,0.4,28,63,0.444,6,22,0.273,10,19,0.526,84,2012-03-30,MIL,CLE,2012,87.0
621,621,21,@,L 121-123 (3OT),315,42,98,0.429,28,64,0.438,14,34,0.412,23,25,0.92,121,41,95,0.432,29,67,0.433,12,28,0.429,29,37,0.784,123,2012-04-16,DAL,UTA,2012,129.0
622,622,22,Home,W 121-112 ,240,49,88,0.557,42,75,0.56,7,13,0.538,16,25,0.64,121,42,93,0.452,37,74,0.5,5,19,0.263,23,27,0.852,112,2012-04-18,WAS,MIL,2012,114.5
623,623,23,Home,W 121-97 ,240,47,77,0.61,37,62,0.597,10,15,0.667,17,18,0.944,121,33,76,0.434,27,62,0.435,6,14,0.429,25,30,0.833,97,2012-04-20,SAS,LAL,2012,100.0
624,624,24,Home,W 121-100 ,240,38,79,0.481,21,46,0.457,17,33,0.515,28,31,0.903,121,37,78,0.474,28,58,0.483,9,20,0.45,17,22,0.773,100,2012-11-25,NYK,DET,2013,104.5
625,625,25,Home,W 121-104 ,240,47,85,0.553,30,57,0.526,17,28,0.607,10,11,0.909,121,40,86,0.465,34,76,0.447,6,10,0.6,18,22,0.818,104,2012-12-19,PHO,CHA,2013,107.0
626,626,26,Home,W 121-96 ,240,44,82,0.537,32,54,0.593,12,28,0.429,21,26,0.808,121,42,79,0.532,40,66,0.606,2,13,0.154,10,14,0.714,96,2012-12-22,HOU,MEM,2013,97.0
627,627,27,Home,W 121-118 (OT),265,45,93,0.484,37,75,0.493,8,18,0.444,23,34,0.676,121,35,76,0.461,27,52,0.519,8,24,0.333,40,48,0.833,118,2013-01-20,DEN,OKC,2013,122.0
628,628,28,Home,W 121-93 ,240,47,89,0.528,34,58,0.586,13,31,0.419,14,17,0.824,121,37,88,0.42,29,66,0.439,8,22,0.364,11,22,0.5,93,2013-01-26,DEN,SAC,2013,97.0
629,629,29,Home,W 121-112 ,240,45,82,0.549,32,55,0.582,13,27,0.481,18,21,0.857,121,43,90,0.478,36,67,0.537,7,23,0.304,19,23,0.826,112,2013-03-08,SAC,PHO,2013,115.5
630,630,30,Home,W 121-79 ,240,45,83,0.542,36,60,0.6,9,23,0.391,22,26,0.846,121,32,83,0.386,30,62,0.484,2,21,0.095,13,15,0.867,79,2013-03-13,SAC,CHI,2013,80.0
631,631,31,Home,W 121-110 ,240,47,85,0.553,37,65,0.569,10,20,0.5,17,23,0.739,121,38,78,0.487,32,60,0.533,6,18,0.333,28,35,0.8,110,2013-04-10,SAC,NOH,2013,113.0
632,632,32,Home,W 121-100 ,240,45,83,0.542,32,56,0.571,13,27,0.481,18,24,0.75,121,39,100,0.39,31,75,0.413,8,25,0.32,14,17,0.824,100,2013-04-14,HOU,SAC,2013,104.0
633,633,33,Home,W 121-82 ,240,48,82,0.585,40,61,0.656,8,21,0.381,17,19,0.895,121,32,81,0.395,28,69,0.406,4,12,0.333,14,23,0.609,82,2013-11-24,LAC,CHI,2014,84.0
634,634,34,@,W 121-105 ,240,51,93,0.548,43,73,0.589,8,20,0.4,11,14,0.786,121,42,92,0.457,30,61,0.492,12,31,0.387,9,21,0.429,105,2013-11-29,NOP,PHI,2014,111.0
635,635,35,Home,W 121-83 ,240,44,83,0.53,27,49,0.551,17,34,0.5,16,19,0.842,121,30,70,0.429,20,45,0.444,10,25,0.4,13,20,0.65,83,2013-12-06,NYK,ORL,2014,88.0
636,636,36,@,W 121-94 ,240,41,85,0.482,30,61,0.492,11,24,0.458,28,33,0.848,121,39,83,0.47,31,55,0.564,8,28,0.286,8,16,0.5,94,2013-12-10,MIN,DET,2014,98.0
637,637,37,Home,W 121-120 (OT),265,51,100,0.51,42,71,0.592,9,29,0.31,10,15,0.667,121,42,85,0.494,27,52,0.519,15,33,0.455,21,30,0.7,120,2013-12-20,PHI,BRK,2014,127.5
638,638,38,Home,W 121-119 (OT),265,46,91,0.505,36,62,0.581,10,29,0.345,19,29,0.655,121,44,91,0.484,27,57,0.474,17,34,0.5,14,19,0.737,119,2013-12-23,MIA,ATL,2014,127.5
639,639,39,Home,W 121-114 ,240,49,100,0.49,45,81,0.556,4,19,0.211,19,25,0.76,121,43,91,0.473,37,71,0.521,6,20,0.3,22,24,0.917,114,2014-01-15,PHO,LAL,2014,117.0
640,640,40,@,L 121-127 ,240,43,82,0.524,27,55,0.491,16,27,0.593,19,34,0.559,121,47,81,0.58,38,59,0.644,9,22,0.409,24,33,0.727,127,2014-01-17,GSW,OKC,2014,131.5
641,641,41,Home,W 121-114 ,240,42,81,0.519,30,50,0.6,12,31,0.387,25,27,0.926,121,38,78,0.487,23,45,0.511,15,33,0.455,23,28,0.821,114,2014-01-20,ATL,MIA,2014,121.5
642,642,42,@,W 121-120 ,240,47,94,0.5,38,72,0.528,9,22,0.409,18,28,0.643,121,49,89,0.551,40,67,0.597,9,22,0.409,13,15,0.867,120,2014-01-24,MIN,GSW,2014,124.5
643,643,43,@,L 121-129 (2OT),290,45,95,0.474,30,61,0.492,15,34,0.441,16,23,0.696,121,49,99,0.495,40,83,0.482,9,16,0.563,22,26,0.846,129,2014-02-21,NYK,ORL,2014,133.5
644,644,44,@,W 121-104 ,240,43,84,0.512,32,62,0.516,11,22,0.5,24,33,0.727,121,37,79,0.468,34,60,0.567,3,19,0.158,27,36,0.75,104,2014-02-22,MIN,UTA,2014,105.5
645,645,45,Home,W 121-112 ,240,43,81,0.531,34,61,0.557,9,20,0.45,26,35,0.743,121,46,96,0.479,39,78,0.5,7,18,0.389,13,17,0.765,112,2014-03-08,SAS,ORL,2014,115.5
646,646,46,Home,W 121-120 (OT),265,47,94,0.5,44,79,0.557,3,15,0.2,24,28,0.857,121,45,97,0.464,33,71,0.465,12,26,0.462,18,23,0.783,120,2014-03-16,NOP,BOS,2014,126.0
647,647,47,@,W 121-113 ,240,38,75,0.507,27,52,0.519,11,23,0.478,34,38,0.895,121,42,85,0.494,35,62,0.565,7,23,0.304,22,25,0.88,113,2014-03-16,PHO,TOR,2014,116.5
648,648,48,Home,L 121-122 (2OT),290,43,99,0.434,32,63,0.508,11,36,0.306,24,30,0.8,121,43,93,0.462,31,61,0.508,12,32,0.375,24,34,0.706,122,2014-04-04,MIA,MIN,2014,128.0
649,649,49,Home,W 121-105 ,240,49,88,0.557,41,66,0.621,8,22,0.364,15,23,0.652,121,39,80,0.488,32,61,0.525,7,19,0.368,20,26,0.769,105,2014-10-29,BOS,BRK,2015,108.5
650,650,50,Home,W 121-104 ,240,43,74,0.581,28,49,0.571,15,25,0.6,20,20,1.0,121,38,82,0.463,31,63,0.492,7,19,0.368,21,27,0.778,104,2014-11-05,GSW,LAC,2015,107.5
651,651,51,Home,L 121-122 ,240,48,88,0.545,42,68,0.618,6,20,0.3,19,23,0.826,121,43,85,0.506,35,62,0.565,8,23,0.348,28,37,0.757,122,2014-11-14,BOS,CLE,2015,126.0
652,652,52,@,W 121-92 ,240,46,84,0.548,33,63,0.524,13,21,0.619,16,18,0.889,121,37,90,0.411,33,77,0.429,4,13,0.308,14,22,0.636,92,2014-11-21,SAS,MIN,2015,94.0
653,653,53,Home,W 121-120 (OT),265,44,96,0.458,35,65,0.538,9,31,0.29,24,30,0.8,121,44,91,0.484,28,54,0.519,16,37,0.432,16,20,0.8,120,2014-12-08,LAC,PHO,2015,128.0
654,654,54,@,W 121-114 ,240,48,81,0.593,41,63,0.651,7,18,0.389,18,29,0.621,121,41,84,0.488,33,57,0.579,8,27,0.296,24,33,0.727,114,2015-01-12,ORL,CHI,2015,118.0
655,655,55,Home,L 121-126 ,240,43,91,0.473,33,62,0.532,10,29,0.345,25,36,0.694,121,46,83,0.554,36,60,0.6,10,23,0.435,24,31,0.774,126,2015-01-16,LAC,CLE,2015,131.0
656,656,56,@,W 121-96 ,240,46,91,0.505,36,68,0.529,10,23,0.435,19,26,0.731,121,35,79,0.443,28,63,0.444,7,16,0.438,19,24,0.792,96,2015-02-03,GSW,SAC,2015,99.5
657,657,57,@,W 121-115 (2OT),290,45,109,0.413,39,91,0.429,6,18,0.333,25,26,0.962,121,39,97,0.402,31,66,0.47,8,31,0.258,29,40,0.725,115,2015-02-27,NYK,DET,2015,119.0
658,658,58,Home,W 121-113 ,240,46,85,0.541,42,78,0.538,4,7,0.571,25,31,0.806,121,43,88,0.489,29,61,0.475,14,27,0.519,13,17,0.765,113,2015-03-07,MIN,POR,2015,120.0
659,659,59,Home,W 121-114 ,240,39,73,0.534,30,49,0.612,9,24,0.375,34,48,0.708,121,44,91,0.484,33,64,0.516,11,27,0.407,15,22,0.682,114,2015-04-12,HOU,NOP,2015,119.5
660,660,60,@,W 121-115 ,240,41,77,0.532,32,56,0.571,9,21,0.429,30,35,0.857,121,42,84,0.5,32,54,0.593,10,30,0.333,21,24,0.875,115,2015-11-06,ATL,NOP,2016,120.0
661,661,61,Home,W 121-97 ,240,45,80,0.563,33,56,0.589,12,24,0.5,19,22,0.864,121,34,82,0.415,25,61,0.41,9,21,0.429,20,26,0.769,97,2015-11-24,ATL,BOS,2016,101.5
662,662,62,Home,W 121-112 ,240,42,87,0.483,33,61,0.541,9,26,0.346,28,37,0.757,121,42,91,0.462,38,73,0.521,4,18,0.222,24,28,0.857,112,2015-12-18,GSW,MIL,2016,114.0
663,663,63,@,W 121-115 ,240,43,99,0.434,29,58,0.5,14,41,0.341,21,25,0.84,121,39,72,0.542,28,52,0.538,11,20,0.55,26,39,0.667,115,2015-12-29,ATL,HOU,2016,120.5
664,664,64,Home,W 121-103 ,240,45,86,0.523,32,62,0.516,13,24,0.542,18,19,0.947,121,37,74,0.5,28,52,0.538,9,22,0.409,20,33,0.606,103,2016-01-02,SAS,HOU,2016,107.5
665,665,65,@,W 121-115 ,240,48,89,0.539,36,60,0.6,12,29,0.414,13,19,0.684,121,42,76,0.553,28,52,0.538,14,24,0.583,17,27,0.63,115,2016-01-06,CLE,WAS,2016,122.0
666,666,66,Home,W 121-103 ,240,47,93,0.505,37,62,0.597,10,31,0.323,17,22,0.773,121,34,69,0.493,27,52,0.519,7,17,0.412,28,32,0.875,103,2016-01-23,POR,LAL,2016,106.5
667,667,67,Home,W 121-117 ,240,41,79,0.519,33,61,0.541,8,18,0.444,31,37,0.838,121,38,92,0.413,29,68,0.426,9,24,0.375,32,38,0.842,117,2016-01-30,MEM,SAC,2016,121.5
668,668,68,Home,L 121-134 ,240,46,91,0.505,38,68,0.559,8,23,0.348,21,30,0.7,121,49,93,0.527,29,52,0.558,20,41,0.488,16,29,0.552,134,2016-02-03,WAS,GSW,2016,144.0
669,669,69,@,W 121-119 (OT),265,48,92,0.522,42,66,0.636,6,26,0.231,19,27,0.704,121,36,75,0.48,25,46,0.543,11,29,0.379,36,41,0.878,119,2016-02-09,UTA,DAL,2016,124.5
670,670,70,Home,W 121-95 ,240,45,86,0.523,33,54,0.611,12,32,0.375,19,23,0.826,121,38,88,0.432,35,72,0.486,3,16,0.188,16,24,0.667,95,2016-02-11,OKC,NOP,2016,96.5
671,671,71,Home,W 121-114 ,240,41,81,0.506,34,64,0.531,7,17,0.412,32,40,0.8,121,40,76,0.526,28,49,0.571,12,27,0.444,22,26,0.846,114,2016-02-19,NOP,PHI,2016,120.0
672,672,72,@,W 121-101 ,240,47,97,0.485,37,65,0.569,10,32,0.313,17,20,0.85,121,34,73,0.466,28,52,0.538,6,21,0.286,27,34,0.794,101,2016-02-21,BOS,DEN,2016,104.0
673,673,73,@,W 121-118 (OT),265,45,95,0.474,31,63,0.492,14,32,0.438,17,25,0.68,121,46,96,0.479,37,70,0.529,9,26,0.346,17,26,0.654,118,2016-02-27,GSW,OKC,2016,122.5
674,674,74,@,L 121-128 ,240,41,87,0.471,26,51,0.51,15,36,0.417,24,35,0.686,121,48,81,0.593,40,66,0.606,8,15,0.533,24,33,0.727,128,2016-02-29,HOU,MIL,2016,132.0
675,675,75,Home,W 121-108 ,240,43,77,0.558,34,58,0.586,9,19,0.474,26,31,0.839,121,41,91,0.451,32,61,0.525,9,30,0.3,17,20,0.85,108,2016-03-01,DAL,ORL,2016,112.5
676,676,76,Home,W 121-106 ,240,47,87,0.54,36,53,0.679,11,34,0.324,16,21,0.762,121,40,86,0.465,36,66,0.545,4,20,0.2,22,27,0.815,106,2016-03-03,GSW,OKC,2016,108.0
677,677,77,@,W 121-120 (OT),265,46,91,0.505,33,69,0.478,13,22,0.591,16,21,0.762,121,46,96,0.479,40,70,0.571,6,26,0.231,22,25,0.88,120,2016-03-04,BRK,DEN,2016,123.0
678,678,78,Home,W 121-114 (OT),265,47,96,0.49,41,82,0.5,6,14,0.429,21,32,0.656,121,42,96,0.438,35,72,0.486,7,24,0.292,23,34,0.676,114,2016-03-11,MEM,NOP,2016,117.5
679,679,79,Home,W 121-84 ,240,47,84,0.56,30,49,0.612,17,35,0.486,10,11,0.909,121,34,91,0.374,27,65,0.415,7,26,0.269,9,18,0.5,84,2016-03-12,POR,ORL,2016,87.5
680,680,80,Home,W 121-85 ,240,46,91,0.505,28,54,0.519,18,37,0.486,11,12,0.917,121,36,91,0.396,29,72,0.403,7,19,0.368,6,10,0.6,85,2016-03-16,GSW,NYK,2016,88.5
681,681,81,Home,W 121-116 ,240,41,81,0.506,34,55,0.618,7,26,0.269,32,40,0.8,121,41,84,0.488,26,51,0.51,15,33,0.455,19,23,0.826,116,2016-03-28,MIN,PHO,2016,123.5
682,682,82,Home,W 121-103 ,240,48,95,0.505,40,67,0.597,8,28,0.286,17,20,0.85,121,39,92,0.424,32,75,0.427,7,17,0.412,18,24,0.75,103,2016-04-06,WAS,BRK,2016,106.5
683,683,83,@,W 121-100 ,240,43,83,0.518,33,58,0.569,10,25,0.4,25,31,0.806,121,39,95,0.411,32,74,0.432,7,21,0.333,15,20,0.75,100,2016-04-09,PHO,NOP,2016,103.5
684,684,84,@,W 121-116 ,240,44,77,0.571,34,54,0.63,10,23,0.435,23,26,0.885,121,41,80,0.513,29,54,0.537,12,26,0.462,22,28,0.786,116,2016-04-11,CHI,NOP,2016,122.0
685,685,85,@,L 121-130 (OT),265,45,104,0.433,27,56,0.482,18,48,0.375,13,18,0.722,121,47,93,0.505,37,74,0.5,10,19,0.526,26,34,0.765,130,2016-10-26,DAL,IND,2017,135.0
686,686,86,@,L 121-124 ,240,43,86,0.5,36,65,0.554,7,21,0.333,28,33,0.848,121,45,81,0.556,31,50,0.62,14,31,0.452,20,28,0.714,124,2016-11-08,PHO,POR,2017,131.0
687,687,87,Home,W 121-117 ,240,44,83,0.53,31,50,0.62,13,33,0.394,20,28,0.714,121,46,96,0.479,33,67,0.493,13,29,0.448,12,18,0.667,117,2016-11-15,CLE,TOR,2017,123.5
688,688,88,Home,L 121-127 ,240,37,82,0.451,27,57,0.474,10,25,0.4,37,41,0.902,121,44,87,0.506,31,51,0.608,13,36,0.361,26,28,0.929,127,2016-11-16,TOR,GSW,2017,133.5
689,689,89,@,W 121-115 ,240,40,76,0.526,27,47,0.574,13,29,0.448,28,34,0.824,121,38,86,0.442,28,60,0.467,10,26,0.385,29,35,0.829,115,2016-11-18,LAC,SAC,2017,120.0
690,690,90,Home,L 121-124 ,240,46,89,0.517,36,69,0.522,10,20,0.5,19,25,0.76,121,42,95,0.442,28,57,0.491,14,38,0.368,26,32,0.813,124,2016-11-19,MIL,GSW,2017,131.0
691,691,91,Home,W 121-116 (OT),265,43,98,0.439,29,62,0.468,14,36,0.389,21,25,0.84,121,40,97,0.412,25,54,0.463,15,43,0.349,21,28,0.75,116,2016-11-19,NOP,CHO,2017,123.5
692,692,92,@,W 121-114 ,240,48,87,0.552,39,67,0.582,9,20,0.45,16,21,0.762,121,40,91,0.44,25,49,0.51,15,42,0.357,19,20,0.95,114,2016-11-30,DET,BOS,2017,121.5
693,693,93,@,W 121-85 ,240,48,89,0.539,31,60,0.517,17,29,0.586,8,12,0.667,121,32,88,0.364,26,64,0.406,6,24,0.25,15,20,0.75,85,2016-12-02,DET,ATL,2017,88.0
694,694,94,@,W 121-113 ,240,47,83,0.566,39,64,0.609,8,19,0.421,19,25,0.76,121,43,88,0.489,32,61,0.525,11,27,0.407,16,24,0.667,113,2016-12-10,DEN,ORL,2017,118.5
695,695,95,Home,W 121-120 ,240,42,89,0.472,31,66,0.47,11,23,0.478,26,28,0.929,121,44,87,0.506,34,66,0.515,10,21,0.476,22,25,0.88,120,2016-12-12,LAC,POR,2017,125.0
696,696,96,Home,L 121-125 ,240,47,86,0.547,37,65,0.569,10,21,0.476,17,26,0.654,121,46,86,0.535,35,61,0.574,11,25,0.44,22,32,0.688,125,2016-12-16,TOR,ATL,2017,130.5
697,697,97,@,L 121-126 ,240,44,86,0.512,40,59,0.678,4,27,0.148,29,40,0.725,121,40,72,0.556,30,49,0.612,10,23,0.435,36,43,0.837,126,2016-12-20,POR,SAC,2017,131.0
698,698,98,@,W 121-110 ,240,45,88,0.511,34,60,0.567,11,28,0.393,20,24,0.833,121,42,88,0.477,34,68,0.5,8,20,0.4,18,23,0.783,110,2016-12-21,OKC,NOP,2017,114.0
699,699,99,Home,W 121-111 ,240,46,81,0.568,32,58,0.552,14,23,0.609,15,18,0.833,121,40,103,0.388,27,68,0.397,13,35,0.371,18,22,0.818,111,2016-12-28,GSW,TOR,2017,117.5
700,700,0,@,W 121-109 ,240,43,85,0.506,29,54,0.537,14,31,0.452,21,25,0.84,121,40,78,0.513,31,54,0.574,9,24,0.375,20,23,0.87,109,2016-12-31,CLE,CHO,2017,113.5
701,701,1,@,W 121-116 ,240,43,74,0.581,34,58,0.586,9,16,0.563,26,30,0.867,121,48,97,0.495,38,68,0.559,10,29,0.345,10,12,0.833,116,2017-01-03,IND,DET,2017,121.0
702,702,2,Home,W 121-109 ,240,48,93,0.516,38,71,0.535,10,22,0.455,15,19,0.789,121,41,90,0.456,24,52,0.462,17,38,0.447,10,13,0.769,109,2017-01-05,IND,BRK,2017,117.5
703,703,3,Home,W 121-106 ,240,43,89,0.483,31,53,0.585,12,36,0.333,23,29,0.793,121,40,99,0.404,31,75,0.413,9,24,0.375,17,24,0.708,106,2017-01-07,OKC,DEN,2017,110.5
704,704,4,Home,W 121-114 ,240,40,82,0.488,23,43,0.535,17,39,0.436,24,33,0.727,121,44,92,0.478,25,49,0.51,19,43,0.442,7,9,0.778,114,2017-01-10,HOU,CHO,2017,123.5
705,705,5,Home,L 121-127 ,240,47,108,0.435,36,78,0.462,11,30,0.367,16,18,0.889,121,50,88,0.568,39,62,0.629,11,26,0.423,16,26,0.615,127,2017-01-17,LAL,DEN,2017,132.5
706,706,6,Home,W 121-100 ,240,46,85,0.541,36,64,0.563,10,21,0.476,19,27,0.704,121,38,90,0.422,30,62,0.484,8,28,0.286,16,19,0.842,100,2017-01-18,GSW,OKC,2017,104.0
707,707,7,Home,W 121-110 ,240,45,90,0.5,35,61,0.574,10,29,0.345,21,22,0.955,121,33,71,0.465,15,37,0.405,18,34,0.529,26,41,0.634,110,2017-01-24,PHI,LAC,2017,119.0
708,708,8,Home,W 121-108 ,240,45,89,0.506,37,75,0.493,8,14,0.571,23,28,0.821,121,44,99,0.444,34,71,0.479,10,28,0.357,10,14,0.714,108,2017-01-29,CHI,PHI,2017,113.0
709,709,9,Home,W 121-117 ,240,40,89,0.449,31,61,0.508,9,28,0.321,32,44,0.727,121,45,83,0.542,36,59,0.61,9,24,0.375,18,23,0.783,117,2017-02-03,DEN,MIL,2017,121.5
710,710,10,Home,W 121-117 (OT),265,44,98,0.449,28,55,0.509,16,43,0.372,17,25,0.68,121,48,100,0.48,40,75,0.533,8,25,0.32,13,18,0.722,117,2017-02-03,HOU,CHI,2017,121.0
711,711,11,Home,W 121-97 ,240,45,79,0.57,35,58,0.603,10,21,0.476,21,26,0.808,121,41,92,0.446,31,66,0.47,10,26,0.385,5,10,0.5,97,2017-02-04,SAS,DEN,2017,102.0
712,712,12,@,W 121-107 ,240,44,102,0.431,36,74,0.486,8,28,0.286,25,31,0.806,121,37,82,0.451,30,61,0.492,7,21,0.333,26,33,0.788,107,2017-02-06,LAL,NYK,2017,110.5
713,713,13,Home,W 121-102 ,240,51,97,0.526,47,81,0.58,4,16,0.25,15,24,0.625,121,37,86,0.43,31,63,0.492,6,23,0.261,22,26,0.846,102,2017-02-08,DET,LAL,2017,105.0
714,714,14,@,L 121-128 (OT),265,49,93,0.527,41,69,0.594,8,24,0.333,15,25,0.6,121,46,98,0.469,34,72,0.472,12,26,0.462,24,31,0.774,128,2017-02-24,PHO,CHI,2017,134.0
715,715,15,@,L 121-124 (OT),265,38,80,0.475,20,40,0.5,18,40,0.45,27,30,0.9,121,45,97,0.464,35,65,0.538,10,32,0.313,24,34,0.706,124,2017-02-26,CHA,LAC,2017,129.0
716,716,16,Home,L 121-126 ,240,44,85,0.518,34,60,0.567,10,25,0.4,23,30,0.767,121,47,85,0.553,36,62,0.581,11,23,0.478,21,27,0.778,126,2017-03-07,OKC,POR,2017,131.5
717,717,17,Home,W 120-89 ,240,47,85,0.553,35,67,0.522,12,18,0.667,14,19,0.737,120,36,81,0.444,32,64,0.5,4,17,0.235,13,20,0.65,89,2012-01-13,PHI,WAS,2012,91.0
718,718,18,Home,W 120-98 ,240,46,79,0.582,30,53,0.566,16,26,0.615,12,19,0.632,120,38,80,0.475,28,55,0.509,10,25,0.4,12,17,0.706,98,2012-01-17,MIA,SAS,2012,103.0
719,719,19,@,W 120-109 ,240,42,88,0.477,38,71,0.535,4,17,0.235,32,37,0.865,120,41,87,0.471,29,59,0.492,12,28,0.429,15,19,0.789,109,2012-01-27,OKC,GSW,2012,115.0
720,720,20,@,W 120-108 ,240,43,74,0.581,37,57,0.649,6,17,0.353,28,31,0.903,120,40,85,0.471,33,66,0.5,7,19,0.368,21,30,0.7,108,2012-01-30,MIN,HOU,2012,111.5
721,721,21,@,W 120-103 ,240,41,78,0.526,35,63,0.556,6,15,0.4,32,39,0.821,120,40,77,0.519,31,61,0.508,9,16,0.563,14,17,0.824,103,2012-02-01,PHO,NOH,2012,107.5
722,722,22,Home,W 120-108 ,240,45,81,0.556,35,58,0.603,10,23,0.435,20,23,0.87,120,40,89,0.449,27,62,0.435,13,27,0.481,15,19,0.789,108,2012-02-21,MIA,SAC,2012,114.5
723,723,23,Home,W 120-103 ,240,43,85,0.506,37,65,0.569,6,20,0.3,28,42,0.667,120,38,82,0.463,29,62,0.468,9,20,0.45,18,27,0.667,103,2012-02-29,NYK,CLE,2012,107.5
724,724,24,@,W 120-100 ,240,45,83,0.542,30,60,0.5,15,23,0.652,15,16,0.938,120,36,85,0.424,28,63,0.444,8,22,0.364,20,36,0.556,100,2012-03-05,GSW,WAS,2012,104.0
725,725,25,@,W 120-108 ,240,43,84,0.512,29,57,0.509,14,27,0.519,20,24,0.833,120,38,78,0.487,26,48,0.542,12,30,0.4,20,32,0.625,108,2012-03-09,LAC,SAS,2012,114.0
726,726,26,Home,W 120-111 ,240,44,78,0.564,35,59,0.593,9,19,0.474,23,32,0.719,120,47,90,0.522,42,77,0.545,5,13,0.385,12,17,0.706,111,2012-03-14,PHO,UTA,2012,113.5
727,727,27,@,W 120-98 ,240,45,93,0.484,35,71,0.493,10,22,0.455,20,22,0.909,120,35,79,0.443,25,57,0.439,10,22,0.455,18,20,0.9,98,2012-03-16,MIL,GSW,2012,103.0
728,728,28,Home,W 120-95 ,240,46,86,0.535,37,65,0.569,9,21,0.429,19,21,0.905,120,36,80,0.45,30,61,0.492,6,19,0.316,17,21,0.81,95,2012-03-16,SAC,BOS,2012,98.0
729,729,29,Home,W 120-112 ,240,44,82,0.537,34,63,0.54,10,19,0.526,22,31,0.71,120,44,90,0.489,33,69,0.478,11,21,0.524,13,15,0.867,112,2012-04-01,LAL,GSW,2012,117.5
730,730,30,Home,W 120-93 ,240,47,83,0.566,38,64,0.594,9,19,0.474,17,19,0.895,120,36,79,0.456,31,65,0.477,5,14,0.357,16,20,0.8,93,2012-04-04,ATL,CHA,2012,95.5
731,731,31,@,W 120-99 ,240,36,92,0.391,24,65,0.369,12,27,0.444,36,43,0.837,120,38,93,0.409,30,73,0.411,8,20,0.4,15,17,0.882,99,2012-04-16,SAS,GSW,2012,103.0
732,732,32,Home,W 120-107 ,240,43,79,0.544,35,63,0.556,8,16,0.5,26,32,0.813,120,39,75,0.52,33,62,0.532,6,13,0.462,23,28,0.821,107,2012-10-30,MIA,BOS,2013,110.0
733,733,33,Home,W 120-98 ,240,47,87,0.54,38,65,0.585,9,22,0.409,17,22,0.773,120,36,87,0.414,28,66,0.424,8,21,0.381,18,30,0.6,98,2012-11-28,OKC,HOU,2013,102.0
734,734,34,@,W 120-97 ,240,46,82,0.561,38,62,0.613,8,20,0.4,20,24,0.833,120,37,83,0.446,31,63,0.492,6,20,0.3,17,20,0.85,97,2012-12-25,HOU,CHI,2013,100.0
735,735,35,Home,W 120-91 ,240,46,82,0.561,39,71,0.549,7,11,0.636,21,25,0.84,120,37,87,0.425,32,69,0.464,5,18,0.278,12,15,0.8,91,2013-01-14,WAS,ORL,2013,93.5
736,736,36,Home,W 120-81 ,240,47,86,0.547,28,43,0.651,19,43,0.442,7,13,0.538,120,32,76,0.421,26,55,0.473,6,21,0.286,11,15,0.733,81,2013-02-02,NYK,SAC,2013,84.0
737,737,37,Home,W 120-109 ,240,44,85,0.518,36,66,0.545,8,19,0.421,24,35,0.686,120,40,82,0.488,36,67,0.537,4,15,0.267,25,26,0.962,109,2013-02-09,SAC,UTA,2013,111.0
738,738,38,@,W 120-113 ,240,46,85,0.541,38,69,0.551,8,16,0.5,20,32,0.625,120,39,85,0.459,27,54,0.5,12,31,0.387,23,28,0.821,113,2013-03-05,DEN,SAC,2013,119.0
739,739,39,@,W 120-117 ,240,44,82,0.537,34,60,0.567,10,22,0.455,22,38,0.579,120,45,97,0.464,40,80,0.5,5,17,0.294,22,30,0.733,117,2013-03-27,LAL,MIN,2013,119.5
740,740,40,Home,L 120-125 ,240,45,78,0.577,36,61,0.59,9,17,0.529,21,25,0.84,120,46,93,0.495,31,59,0.525,15,34,0.441,18,24,0.75,125,2013-04-07,OKC,NYK,2013,132.5
741,741,41,Home,W 120-99 ,240,45,80,0.563,25,44,0.568,20,36,0.556,10,14,0.714,120,35,77,0.455,27,57,0.474,8,20,0.4,21,30,0.7,99,2013-04-09,NYK,WAS,2013,103.0
742,742,42,@,W 120-88 ,240,48,81,0.593,38,65,0.585,10,16,0.625,14,19,0.737,120,35,83,0.422,30,69,0.435,5,14,0.357,13,15,0.867,88,2013-04-13,BOS,ORL,2013,90.5
743,743,43,Home,W 120-115 (OT),265,42,100,0.42,34,75,0.453,8,25,0.32,28,34,0.824,120,47,100,0.47,37,73,0.507,10,27,0.37,11,18,0.611,115,2013-10-30,MIN,ORL,2014,120.0
744,744,44,@,W 120-89 ,240,41,76,0.539,29,48,0.604,12,28,0.429,26,30,0.867,120,31,82,0.378,25,60,0.417,6,22,0.273,21,29,0.724,89,2013-11-10,SAS,NYK,2014,92.0
745,745,45,Home,W 120-105 ,240,51,85,0.6,46,73,0.63,5,12,0.417,13,15,0.867,120,39,85,0.459,32,67,0.478,7,18,0.389,20,23,0.87,105,2013-11-11,BOS,ORL,2014,108.5
746,746,46,@,L 120-123 ,240,42,76,0.553,30,45,0.667,12,31,0.387,24,33,0.727,120,42,72,0.583,31,50,0.62,11,22,0.5,28,33,0.848,123,2013-11-20,HOU,DAL,2014,128.5
747,747,47,@,W 120-92 ,240,38,74,0.514,23,50,0.46,15,24,0.625,29,32,0.906,120,29,71,0.408,14,42,0.333,15,29,0.517,19,21,0.905,92,2013-11-20,MIA,ORL,2014,99.5
748,748,48,Home,W 120-106 ,240,42,81,0.519,32,57,0.561,10,24,0.417,26,31,0.839,120,39,86,0.453,32,67,0.478,7,19,0.368,21,24,0.875,106,2013-11-27,PHO,POR,2014,109.5
749,749,49,Home,W 120-109 ,240,46,93,0.495,39,74,0.527,7,19,0.368,21,26,0.808,120,40,94,0.426,26,54,0.481,14,40,0.35,15,19,0.789,109,2013-12-18,MIN,POR,2014,116.0
750,750,50,@,L 120-121 (OT),265,42,85,0.494,27,52,0.519,15,33,0.455,21,30,0.7,120,51,100,0.51,42,71,0.592,9,29,0.31,10,15,0.667,121,2013-12-20,BRK,PHI,2014,125.5
751,751,51,Home,W 120-116 (OT),265,46,97,0.474,39,68,0.574,7,29,0.241,21,27,0.778,120,45,96,0.469,39,74,0.527,6,22,0.273,20,27,0.741,116,2013-12-22,LAC,MIN,2014,119.0
752,752,52,Home,W 120-98 ,240,42,85,0.494,37,70,0.529,5,15,0.333,31,38,0.816,120,38,83,0.458,30,62,0.484,8,21,0.381,14,17,0.824,98,2013-12-27,MIN,WAS,2014,102.0
753,753,53,Home,W 120-99 ,240,47,91,0.516,39,72,0.542,8,19,0.421,18,25,0.72,120,33,70,0.471,23,48,0.479,10,22,0.455,23,28,0.821,99,2013-12-28,MEM,DEN,2014,104.0
754,754,54,Home,W 120-94 ,240,44,87,0.506,32,59,0.542,12,28,0.429,20,26,0.769,120,37,84,0.44,33,64,0.516,4,20,0.2,16,23,0.696,94,2014-01-11,DEN,ORL,2014,96.0
755,755,55,@,W 120-118 ,240,41,88,0.466,28,71,0.394,13,17,0.765,25,32,0.781,120,44,84,0.524,31,50,0.62,13,34,0.382,17,23,0.739,118,2014-01-14,CLE,LAL,2014,124.5
756,756,56,Home,L 120-121 ,240,49,89,0.551,40,67,0.597,9,22,0.409,13,15,0.867,120,47,94,0.5,38,72,0.528,9,22,0.409,18,28,0.643,121,2014-01-24,GSW,MIN,2014,125.5
757,757,57,@,W 120-95 ,240,49,77,0.636,44,62,0.71,5,15,0.333,17,20,0.85,120,35,74,0.473,24,50,0.48,11,24,0.458,14,17,0.824,95,2014-01-31,OKC,BRK,2014,100.5
758,758,58,Home,W 120-113 ,240,43,92,0.467,34,69,0.493,9,23,0.391,25,30,0.833,120,37,84,0.44,31,68,0.456,6,16,0.375,33,39,0.846,113,2014-02-01,ATL,MIN,2014,116.0
759,759,59,Home,W 120-110 ,240,44,82,0.537,35,63,0.556,9,19,0.474,23,25,0.92,120,45,90,0.5,40,80,0.5,5,10,0.5,15,17,0.882,110,2014-02-26,SAS,DET,2014,112.5
760,760,60,@,L 120-129 ,240,44,84,0.524,30,53,0.566,14,31,0.452,18,26,0.692,120,44,80,0.55,29,56,0.518,15,24,0.625,26,30,0.867,129,2014-03-02,ATL,PHO,2014,136.5
761,761,61,@,W 120-112 ,240,47,92,0.511,37,70,0.529,10,22,0.455,16,24,0.667,120,45,93,0.484,36,69,0.522,9,24,0.375,13,13,1.0,112,2014-03-12,DEN,ORL,2014,116.5
762,762,62,@,L 120-121 (OT),265,45,97,0.464,33,71,0.465,12,26,0.462,18,23,0.783,120,47,94,0.5,44,79,0.557,3,15,0.2,24,28,0.857,121,2014-03-16,BOS,NOP,2014,122.5
763,763,63,Home,W 120-115 (OT),265,42,97,0.433,30,58,0.517,12,39,0.308,24,27,0.889,120,45,98,0.459,37,81,0.457,8,17,0.471,17,26,0.654,115,2014-03-18,POR,MIL,2014,119.0
764,764,64,Home,L 120-127 ,240,40,91,0.44,32,68,0.471,8,23,0.348,32,37,0.865,120,46,80,0.575,34,53,0.642,12,27,0.444,23,29,0.793,127,2014-03-23,MIN,PHO,2014,133.0
765,765,65,Home,W 120-98 ,240,44,90,0.489,35,64,0.547,9,26,0.346,23,34,0.676,120,35,90,0.389,21,54,0.389,14,36,0.389,14,22,0.636,98,2014-03-27,HOU,PHI,2014,105.0
766,766,66,Home,L 120-122 (OT),265,47,96,0.49,33,66,0.5,14,30,0.467,12,16,0.75,120,52,91,0.571,37,60,0.617,15,31,0.484,3,6,0.5,122,2014-04-01,DAL,GSW,2014,129.5
767,767,67,Home,W 120-97 ,240,47,83,0.566,37,64,0.578,10,19,0.526,16,26,0.615,120,36,86,0.419,29,55,0.527,7,31,0.226,18,23,0.783,97,2014-04-06,LAC,LAL,2014,100.5
768,768,68,@,L 120-130 ,240,43,81,0.531,35,66,0.53,8,15,0.533,26,33,0.788,120,49,101,0.485,34,64,0.531,15,37,0.405,17,19,0.895,130,2014-04-14,MIN,GSW,2014,137.5
769,769,69,Home,W 120-102 ,240,47,85,0.553,39,64,0.609,8,21,0.381,18,23,0.783,120,36,83,0.434,22,48,0.458,14,35,0.4,16,18,0.889,102,2014-10-30,DAL,UTA,2015,109.0
770,770,70,Home,W 120-88 ,240,43,76,0.566,36,59,0.61,7,17,0.412,27,30,0.9,120,33,87,0.379,23,53,0.434,10,34,0.294,12,18,0.667,88,2014-11-09,TOR,PHI,2015,93.0
771,771,71,Home,W 120-107 ,240,36,68,0.529,22,39,0.564,14,29,0.483,34,43,0.791,120,38,99,0.384,27,69,0.391,11,30,0.367,20,23,0.87,107,2014-11-15,LAC,PHO,2015,112.5
772,772,72,Home,W 120-112 ,240,45,88,0.511,32,63,0.508,13,25,0.52,17,21,0.81,120,39,90,0.433,31,65,0.477,8,25,0.32,26,34,0.765,112,2014-11-26,PHO,DEN,2015,116.0
773,773,73,@,W 120-119 ,240,45,79,0.57,35,61,0.574,10,18,0.556,20,24,0.833,120,48,89,0.539,40,68,0.588,8,21,0.381,15,22,0.682,119,2014-11-28,MIN,LAL,2015,123.0
774,774,74,Home,W 120-100 ,240,43,78,0.551,26,46,0.565,17,32,0.531,17,24,0.708,120,38,80,0.475,30,57,0.526,8,23,0.348,16,25,0.64,100,2014-12-06,LAC,NOP,2015,104.0
775,775,75,@,L 120-121 (OT),265,44,91,0.484,28,54,0.519,16,37,0.432,16,20,0.8,120,44,96,0.458,35,65,0.538,9,31,0.29,24,30,0.8,121,2014-12-08,PHO,LAC,2015,125.5
776,776,76,@,W 120-115 (OT),265,45,93,0.484,34,67,0.507,11,26,0.423,19,27,0.704,120,40,82,0.488,29,54,0.537,11,28,0.393,24,34,0.706,115,2014-12-13,MEM,PHI,2015,120.5
777,777,77,@,L 120-129 ,240,44,100,0.44,35,70,0.5,9,30,0.3,23,32,0.719,120,40,74,0.541,34,62,0.548,6,12,0.5,43,47,0.915,129,2014-12-22,TOR,CHI,2015,132.0
778,778,78,@,W 120-96 ,240,41,77,0.532,25,41,0.61,16,36,0.444,22,32,0.688,120,37,80,0.463,26,54,0.481,11,26,0.423,11,21,0.524,96,2015-01-08,HOU,NYK,2015,101.5
779,779,79,Home,W 120-100 ,240,46,88,0.523,33,57,0.579,13,31,0.419,15,21,0.714,120,38,86,0.442,26,56,0.464,12,30,0.4,12,17,0.706,100,2015-01-10,LAC,DAL,2015,106.0
780,780,80,Home,W 120-89 ,240,42,89,0.472,26,58,0.448,16,31,0.516,20,24,0.833,120,36,76,0.474,31,56,0.554,5,20,0.25,12,15,0.8,89,2015-01-11,ATL,WAS,2015,91.5
781,781,81,Home,W 120-113 ,240,44,90,0.489,35,64,0.547,9,26,0.346,23,26,0.885,120,42,83,0.506,33,57,0.579,9,26,0.346,20,23,0.87,113,2015-01-14,ORL,HOU,2015,117.5
782,782,82,@,W 120-100 ,240,43,87,0.494,33,64,0.516,10,23,0.435,24,36,0.667,120,34,80,0.425,24,51,0.471,10,29,0.345,22,27,0.815,100,2015-01-25,LAC,PHO,2015,105.0
783,783,83,@,W 120-116 (OT),265,44,88,0.5,33,62,0.532,11,26,0.423,21,30,0.7,120,37,79,0.468,27,55,0.491,10,24,0.417,32,41,0.78,116,2015-01-31,TOR,WAS,2015,121.0
784,784,84,Home,W 120-105 ,240,45,82,0.549,27,49,0.551,18,33,0.545,12,20,0.6,120,41,100,0.41,34,77,0.442,7,23,0.304,16,19,0.842,105,2015-02-08,CLE,LAL,2015,108.5
785,785,85,@,W 120-112 ,240,40,78,0.513,25,42,0.595,15,36,0.417,25,34,0.735,120,43,79,0.544,33,58,0.569,10,21,0.476,16,17,0.941,112,2015-03-04,CLE,TOR,2015,117.0
786,786,86,Home,W 120-111 ,240,43,79,0.544,34,55,0.618,9,24,0.375,25,33,0.758,120,45,86,0.523,39,69,0.565,6,17,0.353,15,23,0.652,111,2015-03-06,SAS,DEN,2015,114.0
787,787,87,@,W 120-108 ,240,35,76,0.461,20,46,0.435,15,30,0.5,35,47,0.745,120,33,76,0.434,21,51,0.412,12,25,0.48,30,36,0.833,108,2015-03-11,LAC,OKC,2015,114.0
788,788,88,Home,W 120-110 ,240,44,83,0.53,24,39,0.615,20,44,0.455,12,17,0.706,120,37,76,0.487,31,62,0.5,6,14,0.429,30,34,0.882,110,2015-03-27,HOU,MIN,2015,113.0
789,789,89,Home,W 120-114 ,240,48,85,0.565,40,67,0.597,8,18,0.444,16,18,0.889,120,43,92,0.467,34,68,0.5,9,24,0.375,19,22,0.864,114,2015-03-28,POR,DEN,2015,118.5
790,790,90,@,W 120-106 ,240,45,83,0.542,35,62,0.565,10,21,0.476,20,26,0.769,120,34,78,0.436,25,54,0.463,9,24,0.375,29,36,0.806,106,2015-04-12,DAL,LAL,2015,110.5
791,791,91,Home,L 120-134 ,240,46,100,0.46,38,78,0.487,8,22,0.364,20,23,0.87,120,46,84,0.548,29,54,0.537,17,30,0.567,25,35,0.714,134,2015-10-31,NOP,GSW,2016,142.5
792,792,92,@,W 120-109 ,240,43,85,0.506,36,65,0.554,7,20,0.35,27,31,0.871,120,36,86,0.419,30,60,0.5,6,26,0.231,31,38,0.816,109,2015-11-03,DEN,LAL,2016,112.0
793,793,93,@,W 120-103 ,240,47,96,0.49,36,66,0.545,11,30,0.367,15,22,0.682,120,41,76,0.539,32,51,0.627,9,25,0.36,12,18,0.667,103,2015-11-08,DET,POR,2016,107.5
794,794,94,Home,W 120-105 ,240,46,92,0.5,32,59,0.542,14,33,0.424,14,18,0.778,120,39,88,0.443,34,68,0.5,5,20,0.25,22,26,0.846,105,2015-11-10,NOP,DAL,2016,107.5
795,795,95,Home,W 120-101 ,240,45,93,0.484,34,63,0.54,11,30,0.367,19,25,0.76,120,37,77,0.481,28,57,0.491,9,20,0.45,18,20,0.9,101,2015-11-16,PHO,LAL,2016,105.5
796,796,96,Home,W 120-95 ,240,51,87,0.586,41,58,0.707,10,29,0.345,8,10,0.8,120,35,89,0.393,27,70,0.386,8,19,0.421,17,24,0.708,95,2015-11-20,BOS,BRK,2016,99.0
797,797,97,@,W 120-114 ,240,42,81,0.519,32,59,0.542,10,22,0.455,26,34,0.765,120,44,96,0.458,34,70,0.486,10,26,0.385,16,20,0.8,114,2015-11-25,NOP,PHO,2016,119.0
798,798,98,Home,W 120-101 ,240,39,80,0.488,23,50,0.46,16,30,0.533,26,31,0.839,120,39,100,0.39,29,75,0.387,10,25,0.4,13,15,0.867,101,2015-11-28,GSW,SAC,2016,106.0
799,799,99,Home,W 120-113 ,240,36,78,0.462,20,44,0.455,16,34,0.471,32,43,0.744,120,46,98,0.469,36,72,0.5,10,26,0.385,11,13,0.846,113,2015-12-05,HOU,SAC,2016,118.0
800,800,0,@,W 120-85 ,240,51,95,0.537,46,76,0.605,5,19,0.263,13,17,0.765,120,32,89,0.36,25,64,0.391,7,25,0.28,14,22,0.636,85,2015-12-23,OKC,LAL,2016,88.5
801,801,1,@,W 120-116 ,240,45,77,0.584,39,63,0.619,6,14,0.429,24,35,0.686,120,41,82,0.5,28,52,0.538,13,30,0.433,21,26,0.808,116,2015-12-31,MIL,IND,2016,122.5
802,802,2,Home,W 120-105 ,240,49,94,0.521,39,70,0.557,10,24,0.417,12,15,0.8,120,36,83,0.434,29,65,0.446,7,18,0.389,26,31,0.839,105,2016-01-09,ATL,CHI,2016,108.5
803,803,3,Home,W 120-114 ,240,43,81,0.531,36,61,0.59,7,20,0.35,27,30,0.9,120,42,86,0.488,33,57,0.579,9,29,0.31,21,26,0.808,114,2016-01-12,NYK,BOS,2016,118.5
804,804,4,@,W 120-116 (OT),265,45,101,0.446,35,74,0.473,10,27,0.37,20,22,0.909,120,45,91,0.495,34,68,0.5,11,23,0.478,15,19,0.789,116,2016-01-22,CHA,ORL,2016,121.5
805,805,5,Home,W 120-90 ,240,44,85,0.518,33,59,0.559,11,26,0.423,21,25,0.84,120,31,74,0.419,26,60,0.433,5,14,0.357,23,31,0.742,90,2016-01-25,GSW,SAS,2016,92.5
806,806,6,Home,W 120-93 ,240,45,84,0.536,28,52,0.538,17,32,0.531,13,19,0.684,120,40,93,0.43,35,78,0.449,5,15,0.333,8,11,0.727,93,2016-01-31,LAC,CHI,2016,95.5
807,807,7,Home,W 120-100 ,240,45,94,0.479,29,59,0.492,16,35,0.457,14,19,0.737,120,36,82,0.439,27,59,0.458,9,23,0.391,19,29,0.655,100,2016-02-08,CLE,SAC,2016,104.5
808,808,8,Home,W 120-111 ,240,48,94,0.511,35,63,0.556,13,31,0.419,11,18,0.611,120,38,86,0.442,25,58,0.431,13,28,0.464,22,27,0.815,111,2016-02-10,CLE,LAL,2016,117.5
809,809,9,Home,L 120-121 (OT),265,46,96,0.479,40,70,0.571,6,26,0.231,22,25,0.88,120,46,91,0.505,33,69,0.478,13,22,0.591,16,21,0.762,121,2016-03-04,DEN,BRK,2016,127.5
810,810,10,Home,W 120-103 ,240,42,82,0.512,32,52,0.615,10,30,0.333,26,34,0.765,120,37,80,0.463,27,57,0.474,10,23,0.435,19,27,0.704,103,2016-03-05,CLE,BOS,2016,108.0
811,811,11,Home,W 120-108 ,240,48,91,0.527,39,67,0.582,9,24,0.375,15,18,0.833,120,41,81,0.506,29,47,0.617,12,34,0.353,14,23,0.609,108,2016-03-09,OKC,LAC,2016,114.0
812,812,12,@,W 120-111 ,240,39,90,0.433,26,46,0.565,13,44,0.295,29,35,0.829,120,40,84,0.476,32,62,0.516,8,22,0.364,23,32,0.719,111,2016-03-09,CLE,SAC,2016,115.0
813,813,13,@,W 120-108 ,240,45,85,0.529,29,50,0.58,16,35,0.457,14,20,0.7,120,42,80,0.525,35,58,0.603,7,22,0.318,17,21,0.81,108,2016-03-10,CLE,LAL,2016,111.5
814,814,14,@,L 120-132 (OT),265,42,104,0.404,24,58,0.414,18,46,0.391,18,28,0.643,120,49,89,0.551,34,64,0.531,15,25,0.6,19,23,0.826,132,2016-03-20,POR,DAL,2016,139.5
815,815,15,@,W 120-105 ,240,46,94,0.489,36,69,0.522,10,25,0.4,18,21,0.857,120,39,92,0.424,31,71,0.437,8,21,0.381,19,27,0.704,105,2016-03-20,BOS,PHI,2016,109.0
816,816,16,@,L 120-128 ,240,43,96,0.448,25,61,0.41,18,35,0.514,16,21,0.762,120,43,88,0.489,22,43,0.512,21,45,0.467,21,23,0.913,128,2016-03-25,DAL,GSW,2016,138.5
817,817,17,Home,W 120-110 ,240,42,77,0.545,37,66,0.561,5,11,0.455,31,36,0.861,120,37,77,0.481,26,53,0.491,11,24,0.458,25,30,0.833,110,2016-03-26,BRK,IND,2016,115.5
818,818,18,Home,W 120-111 ,240,47,84,0.56,39,66,0.591,8,18,0.444,18,25,0.72,120,43,89,0.483,34,63,0.54,9,26,0.346,16,20,0.8,111,2016-03-30,SAC,WAS,2016,115.5
819,819,19,Home,W 120-115 ,240,43,84,0.512,28,51,0.549,15,33,0.455,19,24,0.792,120,43,91,0.473,34,69,0.493,9,22,0.409,20,31,0.645,115,2016-04-06,POR,OKC,2016,119.5
820,820,20,@,W 120-111 ,240,46,89,0.517,37,64,0.578,9,25,0.36,19,24,0.792,120,44,98,0.449,34,67,0.507,10,31,0.323,13,21,0.619,111,2016-04-11,WAS,BRK,2016,116.0
821,821,21,Home,W 120-114 ,240,45,89,0.506,33,54,0.611,12,35,0.343,18,22,0.818,120,44,86,0.512,37,57,0.649,7,29,0.241,19,27,0.704,114,2016-10-26,LAL,HOU,2017,117.5
822,822,22,@,L 120-128 ,240,43,90,0.478,26,46,0.565,17,44,0.386,17,25,0.68,120,43,83,0.518,27,51,0.529,16,32,0.5,26,31,0.839,128,2016-11-01,HOU,CLE,2017,136.0
823,823,23,@,L 120-122 (OT),265,43,88,0.489,37,67,0.552,6,21,0.286,28,35,0.8,120,45,86,0.523,32,53,0.604,13,33,0.394,19,27,0.704,122,2016-11-11,SAC,POR,2017,128.5
824,824,24,@,L 120-133 ,240,46,90,0.511,38,66,0.576,8,24,0.333,20,26,0.769,120,45,87,0.517,29,54,0.537,16,33,0.485,27,31,0.871,133,2016-11-13,PHO,GSW,2017,141.0
825,825,25,Home,W 120-104 ,240,45,93,0.484,37,76,0.487,8,17,0.471,22,24,0.917,120,39,79,0.494,31,59,0.525,8,20,0.4,18,29,0.621,104,2016-11-16,DEN,PHO,2017,108.0
826,826,26,Home,W 120-105 ,240,45,86,0.523,28,51,0.549,17,35,0.486,13,20,0.65,120,39,92,0.424,33,71,0.465,6,21,0.286,21,34,0.618,105,2016-11-19,PHI,PHO,2017,108.0
827,827,27,@,W 120-83 ,240,40,90,0.444,27,54,0.5,13,36,0.361,27,32,0.844,120,33,103,0.32,27,80,0.338,6,23,0.261,11,12,0.917,83,2016-11-21,GSW,IND,2017,86.0
828,828,28,@,W 120-114 ,240,39,89,0.438,26,60,0.433,13,29,0.448,29,32,0.906,120,36,89,0.404,25,64,0.391,11,25,0.44,31,36,0.861,114,2016-11-27,DEN,PHO,2017,119.5
829,829,29,Home,W 120-101 ,240,41,74,0.554,26,46,0.565,15,28,0.536,23,27,0.852,120,37,91,0.407,26,61,0.426,11,30,0.367,16,22,0.727,101,2016-11-29,UTA,HOU,2017,106.5
830,830,30,Home,W 120-105 ,240,38,69,0.551,22,37,0.595,16,32,0.5,28,33,0.848,120,36,81,0.444,25,54,0.463,11,27,0.407,22,26,0.846,105,2016-11-30,TOR,MEM,2017,110.5
831,831,31,Home,L 120-125 (OT),265,44,101,0.436,30,65,0.462,14,36,0.389,18,26,0.692,120,48,106,0.453,38,79,0.481,10,27,0.37,19,22,0.864,125,2016-12-03,CHA,MIN,2017,130.0
832,832,32,@,W 120-89 ,240,47,84,0.56,37,62,0.597,10,22,0.455,16,21,0.762,120,32,78,0.41,22,48,0.458,10,30,0.333,15,20,0.75,89,2016-12-07,SAC,DAL,2017,94.0
833,833,33,@,W 120-119 (OT),265,38,97,0.392,22,57,0.386,16,40,0.4,28,35,0.8,120,44,96,0.458,30,55,0.545,14,41,0.341,17,26,0.654,119,2016-12-11,NOP,PHO,2017,126.0
834,834,34,@,L 120-121 ,240,44,87,0.506,34,66,0.515,10,21,0.476,22,25,0.88,120,42,89,0.472,31,66,0.47,11,23,0.478,26,28,0.929,121,2016-12-12,POR,LAC,2017,126.5
835,835,35,Home,L 120-131 ,240,45,89,0.506,34,61,0.557,11,28,0.393,19,21,0.905,120,51,87,0.586,36,53,0.679,15,34,0.441,14,20,0.7,131,2016-12-13,ATL,ORL,2017,138.5
836,836,36,@,L 120-132 ,240,41,88,0.466,33,65,0.508,8,23,0.348,30,36,0.833,120,43,84,0.512,28,53,0.528,15,31,0.484,31,35,0.886,132,2016-12-15,POR,DEN,2017,139.5
837,837,37,Home,W 120-118 ,240,40,75,0.533,25,44,0.568,15,31,0.484,25,31,0.806,120,44,94,0.468,36,68,0.529,8,26,0.308,22,25,0.88,118,2016-12-26,BRK,CHO,2017,122.0
838,838,38,@,W 120-101 ,240,46,84,0.548,36,60,0.6,10,24,0.417,18,19,0.947,120,42,86,0.488,33,52,0.635,9,34,0.265,8,10,0.8,101,2016-12-28,CHA,ORL,2017,105.5
839,839,39,@,W 120-113 ,240,46,88,0.523,35,59,0.593,11,29,0.379,17,18,0.944,120,41,82,0.5,23,44,0.523,18,38,0.474,13,13,1.0,113,2017-01-03,SAC,DEN,2017,122.0
840,840,40,@,W 120-116 ,240,44,82,0.537,29,48,0.604,15,34,0.441,17,19,0.895,120,46,87,0.529,37,60,0.617,9,27,0.333,15,19,0.789,116,2017-01-08,CLE,PHO,2017,120.5
841,841,41,@,W 120-108 ,240,44,87,0.506,29,50,0.58,15,37,0.405,17,22,0.773,120,42,80,0.525,33,55,0.6,9,25,0.36,15,19,0.789,108,2017-01-13,CLE,SAC,2017,112.5
842,842,42,Home,W 120-98 ,240,45,82,0.549,33,54,0.611,12,28,0.429,18,22,0.818,120,36,85,0.424,26,55,0.473,10,30,0.333,16,19,0.842,98,2017-01-16,LAC,OKC,2017,103.0
843,843,43,Home,W 120-101 ,240,42,86,0.488,29,63,0.46,13,23,0.565,23,25,0.92,120,37,88,0.42,29,62,0.468,8,26,0.308,19,25,0.76,101,2017-01-16,WAS,POR,2017,105.0
844,844,44,Home,W 120-109 ,240,47,91,0.516,36,59,0.61,11,32,0.344,15,16,0.938,120,36,77,0.468,26,46,0.565,10,31,0.323,27,38,0.711,109,2017-01-25,BOS,HOU,2017,114.0
845,845,45,@,L 120-127 ,240,48,89,0.539,38,65,0.585,10,24,0.417,14,17,0.824,120,44,86,0.512,35,63,0.556,9,23,0.391,30,35,0.857,127,2017-01-26,PHO,DEN,2017,131.5
846,846,46,Home,W 120-101 ,240,47,87,0.54,42,66,0.636,5,21,0.238,21,26,0.808,120,34,83,0.41,23,44,0.523,11,39,0.282,22,25,0.88,101,2017-01-29,IND,HOU,2017,106.5
847,847,47,Home,W 120-116 ,240,47,89,0.528,35,63,0.556,12,26,0.462,14,18,0.778,120,41,99,0.414,26,72,0.361,15,27,0.556,19,23,0.826,116,2017-01-31,LAL,DEN,2017,123.5
848,848,48,Home,L 120-133 ,240,40,80,0.5,30,55,0.545,10,25,0.4,30,39,0.769,120,52,99,0.525,38,65,0.585,14,34,0.412,15,18,0.833,133,2017-02-02,LAC,GSW,2017,140.0
849,849,49,@,W 120-95 ,240,49,80,0.613,39,54,0.722,10,26,0.385,12,18,0.667,120,33,74,0.446,27,57,0.474,6,17,0.353,23,32,0.719,95,2017-02-06,UTA,ATL,2017,98.0
850,850,50,@,W 120-111 ,240,44,91,0.484,34,61,0.557,10,30,0.333,22,27,0.815,120,39,77,0.506,30,51,0.588,9,26,0.346,24,31,0.774,111,2017-02-09,BOS,POR,2017,115.5
851,851,51,Home,W 120-98 ,240,42,73,0.575,29,53,0.547,13,20,0.65,23,28,0.821,120,34,96,0.354,27,62,0.435,7,34,0.206,23,30,0.767,98,2017-02-13,WAS,OKC,2017,101.5
852,852,52,Home,W 120-112 ,240,43,87,0.494,33,58,0.569,10,29,0.345,24,30,0.8,120,38,90,0.422,33,66,0.5,5,24,0.208,31,40,0.775,112,2017-02-24,PHI,WAS,2017,114.5
853,853,53,Home,W 120-113 (OT),265,45,104,0.433,38,79,0.481,7,25,0.28,23,31,0.742,120,44,84,0.524,34,59,0.576,10,25,0.4,15,22,0.682,113,2017-02-28,DET,POR,2017,118.0
854,854,54,Home,W 120-103 ,240,46,77,0.597,39,58,0.672,7,19,0.368,21,25,0.84,120,35,89,0.393,25,55,0.455,10,34,0.294,23,28,0.821,103,2017-03-02,PHO,CHO,2017,108.0
855,855,55,Home,W 120-92 ,240,46,88,0.523,28,54,0.519,18,34,0.529,10,12,0.833,120,35,73,0.479,24,46,0.522,11,27,0.407,11,18,0.611,92,2017-03-04,MIA,CLE,2017,97.5
856,856,56,@,W 119-114 (2OT),290,41,98,0.418,35,74,0.473,6,24,0.25,31,43,0.721,119,44,97,0.454,33,64,0.516,11,33,0.333,15,21,0.714,114,2012-01-21,DEN,NYK,2012,119.5
857,857,57,Home,W 119-101 ,240,45,96,0.469,37,72,0.514,8,24,0.333,21,25,0.84,119,36,79,0.456,33,67,0.493,3,12,0.25,26,34,0.765,101,2012-02-02,GSW,UTA,2012,102.5
858,858,58,@,W 119-116 ,240,44,84,0.524,33,58,0.569,11,26,0.423,20,21,0.952,119,44,80,0.55,35,59,0.593,9,21,0.429,19,23,0.826,116,2012-02-07,OKC,GSW,2012,120.5
859,859,59,Home,W 119-104 ,240,42,84,0.5,33,65,0.508,9,19,0.474,26,35,0.743,119,34,70,0.486,27,52,0.519,7,18,0.389,29,34,0.853,104,2012-02-22,OKC,BOS,2012,107.5
860,860,60,Home,W 119-118 ,240,41,91,0.451,33,66,0.5,8,25,0.32,29,37,0.784,119,42,87,0.483,29,63,0.46,13,24,0.542,21,21,1.0,118,2012-02-28,MIL,WAS,2012,124.5
861,861,61,Home,W 119-116 (OT),265,40,88,0.455,29,61,0.475,11,27,0.407,28,35,0.8,119,45,98,0.459,33,71,0.465,12,27,0.444,14,21,0.667,116,2012-03-05,DEN,SAC,2012,122.0
862,862,62,Home,W 119-114 ,240,45,93,0.484,32,67,0.478,13,26,0.5,16,21,0.762,119,46,83,0.554,39,66,0.591,7,17,0.412,15,21,0.714,114,2012-03-09,MIL,NYK,2012,117.5
863,863,63,Home,W 119-110 ,240,47,88,0.534,43,71,0.606,4,17,0.235,21,32,0.656,119,43,90,0.478,39,74,0.527,4,16,0.25,20,25,0.8,110,2012-03-20,SAC,MEM,2012,112.0
864,864,64,Home,W 119-106 ,240,46,88,0.523,37,60,0.617,9,28,0.321,18,20,0.9,119,36,78,0.462,31,57,0.544,5,21,0.238,29,35,0.829,106,2012-04-01,POR,MIN,2012,108.5
865,865,65,Home,W 119-89 ,240,42,80,0.525,27,52,0.519,15,28,0.536,20,24,0.833,119,30,74,0.405,23,54,0.426,7,20,0.35,22,26,0.846,89,2012-04-09,ORL,DET,2012,92.5
866,866,66,Home,W 119-116 ,240,43,83,0.518,33,58,0.569,10,25,0.4,23,27,0.852,119,49,95,0.516,44,74,0.595,5,21,0.238,13,20,0.65,116,2012-11-03,MIA,DEN,2013,118.5
867,867,67,Home,W 119-117 (OT),265,44,86,0.512,34,61,0.557,10,25,0.4,21,29,0.724,119,41,88,0.466,32,63,0.508,9,25,0.36,26,31,0.839,117,2012-11-16,POR,HOU,2013,121.5
868,868,68,Home,W 119-108 ,240,46,85,0.541,37,65,0.569,9,20,0.45,18,28,0.643,119,44,90,0.489,35,67,0.522,9,23,0.391,11,18,0.611,108,2012-11-18,LAL,HOU,2013,112.5
869,869,69,Home,W 119-109 ,240,42,83,0.506,29,63,0.46,13,20,0.65,22,26,0.846,119,43,82,0.524,38,66,0.576,5,16,0.313,18,22,0.818,109,2012-11-18,OKC,GSW,2013,111.5
870,870,70,Home,W 119-96 ,240,48,87,0.552,41,67,0.612,7,20,0.35,16,21,0.762,119,37,84,0.44,25,57,0.439,12,27,0.444,10,16,0.625,96,2012-12-10,DAL,SAC,2013,102.0
871,871,71,@,L 119-126 (2OT),290,48,109,0.44,34,82,0.415,14,27,0.519,9,15,0.6,119,46,98,0.469,35,65,0.538,11,33,0.333,23,31,0.742,126,2012-12-26,DET,ATL,2013,131.5
872,872,72,Home,W 119-109 (OT),265,42,89,0.472,32,63,0.508,10,26,0.385,25,31,0.806,119,41,94,0.436,31,66,0.47,10,28,0.357,17,20,0.85,109,2013-01-02,MIA,DAL,2013,114.0
873,873,73,@,L 119-125 (OT),265,46,93,0.495,35,63,0.556,11,30,0.367,16,18,0.889,119,48,94,0.511,40,70,0.571,8,24,0.333,21,24,0.875,125,2013-01-07,ORL,POR,2013,129.0
874,874,74,Home,W 119-106 ,240,43,87,0.494,31,59,0.525,12,28,0.429,21,27,0.778,119,36,80,0.45,20,44,0.455,16,36,0.444,18,21,0.857,106,2013-01-26,HOU,BRK,2013,114.0
875,875,75,Home,W 119-98 ,240,48,95,0.505,40,72,0.556,8,23,0.348,15,20,0.75,119,38,93,0.409,28,73,0.384,10,20,0.5,12,16,0.75,98,2013-02-06,OKC,GSW,2013,103.0
876,876,76,Home,W 119-108 ,240,39,80,0.488,32,66,0.485,7,14,0.5,34,41,0.829,119,45,86,0.523,37,65,0.569,8,21,0.381,10,13,0.769,108,2013-02-08,CLE,ORL,2013,112.0
877,877,77,Home,W 119-109 ,240,46,89,0.517,36,67,0.537,10,22,0.455,17,20,0.85,119,37,81,0.457,27,57,0.474,10,24,0.417,25,30,0.833,109,2013-02-08,DET,SAS,2013,114.0
878,878,78,Home,W 119-108 ,240,41,75,0.547,25,48,0.521,16,27,0.593,21,30,0.7,119,42,79,0.532,30,62,0.484,12,17,0.706,12,22,0.545,108,2013-02-13,BRK,DEN,2013,114.0
879,879,79,@,L 119-122 ,240,42,87,0.483,31,59,0.525,11,28,0.393,24,27,0.889,119,44,92,0.478,29,59,0.492,15,33,0.455,19,23,0.826,122,2013-02-20,OKC,HOU,2013,129.5
880,880,80,Home,W 119-113 ,240,42,88,0.477,31,64,0.484,11,24,0.458,24,33,0.727,119,39,81,0.481,35,59,0.593,4,22,0.182,31,37,0.838,113,2013-02-22,WAS,DEN,2013,115.0
881,881,81,Home,W 119-108 ,240,49,88,0.557,44,70,0.629,5,18,0.278,16,27,0.593,119,43,78,0.551,35,59,0.593,8,19,0.421,14,31,0.452,108,2013-02-25,DEN,LAL,2013,112.0
882,882,82,Home,W 119-74 ,240,42,76,0.553,34,58,0.586,8,18,0.444,27,28,0.964,119,27,77,0.351,21,56,0.375,6,21,0.286,14,18,0.778,74,2013-02-27,OKC,NOH,2013,77.0
883,883,83,Home,W 119-83 ,240,42,90,0.467,29,57,0.509,13,33,0.394,22,27,0.815,119,28,77,0.364,22,54,0.407,6,23,0.261,21,27,0.778,83,2013-03-03,SAC,CHA,2013,86.0
884,884,84,Home,W 119-113 ,240,45,78,0.577,39,61,0.639,6,17,0.353,23,29,0.793,119,43,85,0.506,36,70,0.514,7,15,0.467,20,31,0.645,113,2013-03-16,SAS,CLE,2013,116.5
885,885,85,Home,W 119-114 ,240,42,79,0.532,33,57,0.579,9,22,0.409,26,33,0.788,119,43,81,0.531,37,66,0.561,6,15,0.4,22,29,0.759,114,2013-03-18,CHA,WAS,2013,117.0
886,886,86,@,W 119-118 (OT),265,46,100,0.46,39,80,0.488,7,20,0.35,20,27,0.741,119,47,96,0.49,39,75,0.52,8,21,0.381,16,19,0.842,118,2013-03-18,DEN,CHI,2013,122.0
887,887,87,@,W 119-82 ,240,45,83,0.542,36,62,0.581,9,21,0.429,20,23,0.87,119,34,78,0.436,33,60,0.55,1,18,0.056,13,15,0.867,82,2013-03-18,BRK,DET,2013,82.5
888,888,88,Home,W 119-112 ,240,47,95,0.495,40,72,0.556,7,23,0.304,18,23,0.783,119,43,92,0.467,32,63,0.508,11,29,0.379,15,23,0.652,112,2013-04-15,PHO,HOU,2013,117.5
889,889,89,@,W 119-110 ,240,37,82,0.451,31,65,0.477,6,17,0.353,39,44,0.886,119,39,91,0.429,28,60,0.467,11,31,0.355,21,27,0.778,110,2013-11-08,OKC,DET,2014,115.5
890,890,90,@,W 119-116 ,240,41,92,0.446,26,59,0.441,15,33,0.455,22,25,0.88,119,48,102,0.471,39,85,0.459,9,17,0.529,11,16,0.688,116,2013-12-17,POR,CLE,2014,120.5
891,891,91,@,L 119-121 (OT),265,44,91,0.484,27,57,0.474,17,34,0.5,14,19,0.737,119,46,91,0.505,36,62,0.581,10,29,0.345,19,29,0.655,121,2013-12-23,ATL,MIA,2014,126.0
892,892,92,@,W 119-112 ,240,40,82,0.488,31,59,0.525,9,23,0.391,30,38,0.789,119,45,88,0.511,33,60,0.55,12,28,0.429,10,14,0.714,112,2014-01-03,LAC,DAL,2014,118.0
893,893,93,Home,W 119-96 ,240,43,83,0.518,34,64,0.531,9,19,0.474,24,31,0.774,119,35,80,0.438,24,57,0.421,11,23,0.478,15,24,0.625,96,2014-01-05,OKC,BOS,2014,101.5
894,894,94,@,L 119-123 ,240,39,90,0.433,29,63,0.46,10,27,0.37,31,36,0.861,119,40,85,0.471,33,70,0.471,7,15,0.467,36,50,0.72,123,2014-01-07,POR,SAC,2014,126.5
895,895,95,Home,W 119-92 ,240,48,88,0.545,39,69,0.565,9,19,0.474,14,19,0.737,119,37,84,0.44,29,65,0.446,8,19,0.421,10,14,0.714,92,2014-01-10,MIN,CHA,2014,96.0
896,896,96,Home,W 119-98 ,240,43,90,0.478,35,59,0.593,8,31,0.258,25,40,0.625,119,34,86,0.395,22,56,0.393,12,30,0.4,18,30,0.6,98,2014-01-22,HOU,SAC,2014,104.0
897,897,97,@,W 119-108 ,240,42,79,0.532,24,42,0.571,18,37,0.486,17,22,0.773,119,38,101,0.376,33,68,0.485,5,33,0.152,27,37,0.73,108,2014-02-05,LAL,CLE,2014,110.5
898,898,98,Home,W 119-80 ,240,46,80,0.575,42,64,0.656,4,16,0.25,23,26,0.885,119,28,89,0.315,22,63,0.349,6,26,0.231,18,26,0.692,80,2014-02-10,IND,DEN,2014,83.0
899,899,99,Home,W 119-85 ,240,48,98,0.49,35,71,0.493,13,27,0.481,10,13,0.769,119,31,91,0.341,27,70,0.386,4,21,0.19,19,25,0.76,85,2014-03-14,SAS,LAL,2014,87.0
900,900,0,@,W 119-118 (2OT),290,38,98,0.388,26,62,0.419,12,36,0.333,31,38,0.816,119,41,101,0.406,33,72,0.458,8,29,0.276,28,33,0.848,118,2014-03-21,OKC,TOR,2014,122.0
901,901,1,@,L 119-128 (OT),265,46,93,0.495,34,60,0.567,12,33,0.364,15,19,0.789,119,45,90,0.5,30,52,0.577,15,38,0.395,23,28,0.821,128,2014-03-25,OKC,DAL,2014,135.5
902,902,2,@,W 119-98 ,240,45,78,0.577,36,60,0.6,9,18,0.5,20,24,0.833,119,35,79,0.443,24,51,0.471,11,28,0.393,17,20,0.85,98,2014-04-02,CLE,ORL,2014,103.5
903,903,3,Home,W 119-116 ,240,44,84,0.524,38,68,0.559,6,16,0.375,25,38,0.658,119,42,85,0.494,38,65,0.585,4,20,0.2,28,35,0.8,116,2014-04-11,MIL,CLE,2014,118.0
904,904,4,Home,W 119-117 (OT),265,43,86,0.5,33,62,0.532,10,24,0.417,23,32,0.719,119,44,91,0.484,27,54,0.5,17,37,0.459,12,16,0.75,117,2014-04-13,POR,GSW,2014,125.5
905,905,5,@,W 119-104 ,240,45,82,0.549,35,58,0.603,10,24,0.417,19,22,0.864,119,42,81,0.519,36,62,0.581,6,19,0.316,14,20,0.7,104,2014-04-14,LAL,UTA,2014,107.0
906,906,6,Home,W 119-99 ,240,45,82,0.549,29,50,0.58,16,32,0.5,13,18,0.722,119,37,86,0.43,33,73,0.452,4,13,0.308,21,25,0.84,99,2014-10-29,PHO,LAL,2015,101.0
907,907,7,@,L 119-122 (2OT),290,43,93,0.462,30,60,0.5,13,33,0.394,20,26,0.769,119,48,97,0.495,42,76,0.553,6,21,0.286,20,27,0.741,122,2014-11-07,ATL,CHO,2015,125.0
908,908,8,Home,W 119-93 ,240,46,86,0.535,39,69,0.565,7,17,0.412,20,22,0.909,119,34,78,0.436,26,44,0.591,8,34,0.235,17,21,0.81,93,2014-11-17,MEM,HOU,2015,97.0
909,909,9,Home,L 119-120 ,240,48,89,0.539,40,68,0.588,8,21,0.381,15,22,0.682,119,45,79,0.57,35,61,0.574,10,18,0.556,20,24,0.833,120,2014-11-28,LAL,MIN,2015,125.0
910,910,10,Home,W 119-89 ,240,45,85,0.529,38,65,0.585,7,20,0.35,22,27,0.815,119,31,82,0.378,26,60,0.433,5,22,0.227,22,30,0.733,89,2014-12-05,WAS,DEN,2015,91.5
911,911,11,Home,W 119-114 ,240,44,79,0.557,32,51,0.627,12,28,0.429,19,25,0.76,119,44,89,0.494,36,67,0.537,8,22,0.364,18,23,0.783,114,2014-12-12,NOP,CLE,2015,118.0
912,912,12,Home,W 119-111 ,240,47,79,0.595,39,63,0.619,8,16,0.5,17,18,0.944,119,45,90,0.5,40,75,0.533,5,15,0.333,16,19,0.842,111,2014-12-16,NOP,UTA,2015,113.5
913,913,13,Home,L 119-129 (3OT),315,45,109,0.413,37,89,0.416,8,20,0.4,21,26,0.808,119,47,110,0.427,34,75,0.453,13,35,0.371,22,23,0.957,129,2014-12-19,SAS,POR,2015,135.5
914,914,14,Home,W 119-109 ,240,47,86,0.547,37,60,0.617,10,26,0.385,15,29,0.517,119,42,83,0.506,33,63,0.524,9,20,0.45,16,22,0.727,109,2014-12-26,DET,IND,2015,113.5
915,915,15,@,W 119-101 ,240,45,96,0.469,32,69,0.464,13,27,0.481,16,17,0.941,119,38,89,0.427,26,55,0.473,12,34,0.353,13,19,0.684,101,2015-01-02,DAL,BOS,2015,107.0
916,916,16,@,W 119-103 ,240,48,89,0.539,35,64,0.547,13,25,0.52,10,12,0.833,119,42,85,0.494,37,69,0.536,5,16,0.313,14,16,0.875,103,2015-01-16,CHI,BOS,2015,105.5
917,917,17,Home,W 119-102 ,240,43,84,0.512,26,50,0.52,17,34,0.5,16,19,0.842,119,35,73,0.479,28,56,0.5,7,17,0.412,25,29,0.862,102,2015-01-28,TOR,SAC,2015,105.5
918,918,18,Home,W 119-115 ,240,42,77,0.545,34,58,0.586,8,19,0.421,27,52,0.519,119,43,84,0.512,33,56,0.589,10,28,0.357,19,23,0.826,115,2015-02-19,LAC,SAS,2015,120.0
919,919,19,Home,W 119-94 ,240,48,92,0.522,40,72,0.556,8,20,0.4,15,23,0.652,119,35,97,0.361,28,70,0.4,7,27,0.259,17,20,0.85,94,2015-02-22,OKC,DEN,2015,97.5
920,920,20,Home,W 119-108 ,240,46,83,0.554,35,62,0.565,11,21,0.524,16,22,0.727,119,40,84,0.476,27,53,0.509,13,31,0.419,15,28,0.536,108,2015-02-23,MIA,PHI,2015,114.5
921,921,21,Home,W 119-114 ,240,48,85,0.565,35,61,0.574,13,24,0.542,10,12,0.833,119,38,85,0.447,28,58,0.483,10,27,0.37,28,38,0.737,114,2015-03-06,ORL,SAC,2015,119.0
922,922,22,Home,W 119-115 ,240,42,89,0.472,32,64,0.5,10,25,0.4,25,35,0.714,119,40,90,0.444,33,64,0.516,7,26,0.269,28,35,0.8,115,2015-03-16,DAL,OKC,2015,118.5
923,923,23,@,W 119-100 ,240,42,90,0.467,30,62,0.484,12,28,0.429,23,30,0.767,119,41,85,0.482,37,68,0.544,4,17,0.235,14,17,0.824,100,2015-03-22,DEN,ORL,2015,102.0
924,924,24,@,W 119-98 ,240,44,82,0.537,32,53,0.604,12,29,0.414,19,31,0.613,119,36,86,0.419,25,55,0.455,11,31,0.355,15,27,0.556,98,2015-03-27,LAC,PHI,2015,103.5
925,925,25,@,W 119-106 ,240,41,84,0.488,28,52,0.538,13,32,0.406,24,40,0.6,119,39,93,0.419,31,62,0.5,8,31,0.258,20,23,0.87,106,2015-03-29,LAC,BOS,2015,110.0
926,926,26,Home,W 119-101 ,240,44,88,0.5,31,58,0.534,13,30,0.433,18,24,0.75,119,36,75,0.48,31,59,0.525,5,16,0.313,24,35,0.686,101,2015-04-08,DEN,LAL,2015,103.5
927,927,27,@,W 119-90 ,240,47,72,0.653,39,57,0.684,8,15,0.533,17,23,0.739,119,31,89,0.348,22,62,0.355,9,27,0.333,19,27,0.704,90,2015-04-08,WAS,PHI,2015,94.5
928,928,28,Home,W 119-69 ,240,43,84,0.512,32,59,0.542,11,25,0.44,22,30,0.733,119,26,96,0.271,23,73,0.315,3,23,0.13,14,20,0.7,69,2015-11-02,GSW,MEM,2016,70.5
929,929,29,Home,W 119-114 (OT),265,42,88,0.477,31,54,0.574,11,34,0.324,24,34,0.706,119,46,91,0.505,39,71,0.549,7,20,0.35,15,19,0.789,114,2015-11-04,HOU,ORL,2016,117.5
930,930,30,Home,W 119-104 ,240,46,93,0.495,29,56,0.518,17,37,0.459,10,18,0.556,119,39,92,0.424,31,68,0.456,8,24,0.333,18,22,0.818,104,2015-11-06,GSW,DEN,2016,108.0
931,931,31,@,W 119-103 ,240,43,89,0.483,38,71,0.535,5,18,0.278,28,31,0.903,119,40,87,0.46,28,58,0.483,12,29,0.414,11,17,0.647,103,2015-11-11,TOR,PHI,2016,109.0
932,932,32,@,L 119-122 (OT),265,40,93,0.43,28,64,0.438,12,29,0.414,27,34,0.794,119,43,92,0.467,35,69,0.507,8,23,0.348,28,37,0.757,122,2015-12-05,IND,UTA,2016,126.0
933,933,33,@,W 119-68 ,240,47,76,0.618,43,65,0.662,4,11,0.364,21,25,0.84,119,26,75,0.347,22,51,0.431,4,24,0.167,12,21,0.571,68,2015-12-07,SAS,PHI,2016,70.0
934,934,34,Home,L 119-124 (2OT),290,49,114,0.43,37,81,0.457,12,33,0.364,9,16,0.563,119,42,107,0.393,33,76,0.434,9,31,0.29,31,39,0.795,124,2015-12-11,BOS,GSW,2016,128.5
935,935,35,Home,W 119-116 ,240,38,78,0.487,27,57,0.474,11,21,0.524,32,43,0.744,119,43,89,0.483,33,64,0.516,10,25,0.4,20,24,0.833,116,2015-12-16,DET,BOS,2016,121.0
936,936,36,@,W 119-118 (OT),265,45,82,0.549,29,48,0.604,16,34,0.471,13,15,0.867,119,51,101,0.505,41,82,0.5,10,19,0.526,6,14,0.429,118,2015-12-23,DAL,BRK,2016,123.0
937,937,37,@,L 119-142 ,240,43,83,0.518,33,54,0.611,10,29,0.345,23,28,0.821,119,53,87,0.609,44,64,0.688,9,23,0.391,27,34,0.794,142,2016-01-02,PHO,SAC,2016,146.5
938,938,38,@,W 119-117 ,240,39,88,0.443,30,59,0.508,9,29,0.31,32,36,0.889,119,40,89,0.449,34,67,0.507,6,22,0.273,31,36,0.861,117,2016-01-16,BOS,WAS,2016,120.0
939,939,39,@,L 119-124 (2OT),290,44,104,0.423,29,59,0.492,15,45,0.333,16,20,0.8,119,41,88,0.466,27,61,0.443,14,27,0.519,28,32,0.875,124,2016-01-18,UTA,CHO,2016,131.0
940,940,40,Home,W 119-113 (2OT),290,43,97,0.443,35,77,0.455,8,20,0.4,25,30,0.833,119,45,102,0.441,35,74,0.473,10,28,0.357,13,25,0.52,113,2016-01-18,NYK,PHI,2016,118.0
941,941,41,@,W 119-105 ,240,43,86,0.5,34,59,0.576,9,27,0.333,24,26,0.923,119,33,84,0.393,27,64,0.422,6,20,0.3,33,37,0.892,105,2016-01-25,ATL,DEN,2016,108.0
942,942,42,Home,W 119-114 ,240,44,82,0.537,34,58,0.586,10,24,0.417,21,35,0.6,119,39,93,0.419,23,47,0.489,16,46,0.348,20,25,0.8,114,2016-01-31,ORL,BOS,2016,122.0
943,943,43,Home,W 119-115 ,240,40,80,0.5,28,54,0.519,12,26,0.462,27,35,0.771,119,46,80,0.575,42,63,0.667,4,17,0.235,19,25,0.76,115,2016-02-02,LAL,MIN,2016,117.0
944,944,44,@,L 119-128 ,240,45,89,0.506,37,63,0.587,8,26,0.308,21,22,0.955,119,48,86,0.558,30,58,0.517,18,28,0.643,14,15,0.933,128,2016-02-05,SAC,BRK,2016,137.0
945,945,45,@,L 119-128 ,240,47,95,0.495,37,69,0.536,10,26,0.385,15,19,0.789,119,51,91,0.56,38,67,0.567,13,24,0.542,13,15,0.867,128,2016-02-07,SAC,BOS,2016,134.5
946,946,46,Home,L 119-121 (OT),265,36,75,0.48,25,46,0.543,11,29,0.379,36,41,0.878,119,48,92,0.522,42,66,0.636,6,26,0.231,19,27,0.704,121,2016-02-09,DAL,UTA,2016,124.0
947,947,47,@,W 119-101 ,240,47,89,0.528,41,75,0.547,6,14,0.429,19,26,0.731,119,40,70,0.571,36,58,0.621,4,12,0.333,17,24,0.708,101,2016-02-09,SAS,MIA,2016,103.0
948,948,48,@,W 119-113 ,240,48,88,0.545,42,76,0.553,6,12,0.5,17,18,0.944,119,40,81,0.494,30,59,0.508,10,22,0.455,23,26,0.885,113,2016-02-19,SAS,LAL,2016,118.0
949,949,49,@,L 119-128 ,240,39,88,0.443,22,49,0.449,17,39,0.436,24,33,0.727,119,48,85,0.565,35,58,0.603,13,27,0.481,19,29,0.655,128,2016-02-24,LAL,MEM,2016,134.5
950,950,50,@,L 119-123 ,240,47,86,0.547,39,67,0.582,8,19,0.421,17,22,0.773,119,47,90,0.522,35,70,0.5,12,20,0.6,17,18,0.944,123,2016-02-25,OKC,NOP,2016,129.0
951,951,51,@,W 119-105 ,240,44,82,0.537,34,53,0.642,10,29,0.345,21,35,0.6,119,37,80,0.463,24,45,0.533,13,35,0.371,18,22,0.818,105,2016-02-25,HOU,POR,2016,111.5
952,952,52,@,W 119-99 ,240,40,81,0.494,30,56,0.536,10,25,0.4,29,35,0.829,119,34,85,0.4,21,52,0.404,13,33,0.394,18,26,0.692,99,2016-03-02,CHA,PHI,2016,105.5
953,953,53,Home,W 119-113 ,240,42,84,0.5,26,49,0.531,16,35,0.457,19,27,0.704,119,40,90,0.444,35,69,0.507,5,21,0.238,28,34,0.824,113,2016-03-07,GSW,ORL,2016,115.5
954,954,54,@,L 119-124 ,240,49,93,0.527,42,73,0.575,7,20,0.35,14,20,0.7,119,47,79,0.595,39,62,0.629,8,17,0.471,22,28,0.786,124,2016-03-14,DEN,MIA,2016,128.0
955,955,55,Home,W 119-107 ,240,47,93,0.505,34,65,0.523,13,28,0.464,12,20,0.6,119,39,93,0.419,32,66,0.485,7,27,0.259,22,26,0.846,107,2016-03-23,PHO,LAL,2016,110.5
956,956,56,@,W 119-100 ,240,41,86,0.477,30,60,0.5,11,26,0.423,26,32,0.813,119,38,93,0.409,30,69,0.435,8,24,0.333,16,23,0.696,100,2016-03-28,OKC,TOR,2016,104.0
957,957,57,Home,W 119-117 ,240,45,87,0.517,35,55,0.636,10,32,0.313,19,24,0.792,119,42,76,0.553,26,47,0.553,16,29,0.552,17,22,0.773,117,2016-03-31,OKC,LAC,2016,125.0
958,958,58,Home,W 119-107 ,240,43,90,0.478,33,64,0.516,10,26,0.385,23,29,0.793,119,41,89,0.461,33,68,0.485,8,21,0.381,17,26,0.654,107,2016-04-03,ORL,MEM,2016,111.0
959,959,59,Home,W 119-108 ,240,41,90,0.456,31,67,0.463,10,23,0.435,27,35,0.771,119,40,91,0.44,34,71,0.479,6,20,0.3,22,28,0.786,108,2016-11-06,LAL,PHO,2017,111.0
960,960,60,Home,W 119-110 ,240,42,76,0.553,30,43,0.698,12,33,0.364,23,26,0.885,119,39,92,0.424,27,64,0.422,12,28,0.429,20,28,0.714,110,2016-11-08,BRK,MIN,2017,116.0
961,961,61,@,W 119-105 ,240,40,76,0.526,29,52,0.558,11,24,0.458,28,37,0.757,119,40,89,0.449,32,67,0.478,8,22,0.364,17,21,0.81,105,2016-11-12,LAC,MIN,2017,109.0
962,962,62,@,W 119-117 ,240,46,86,0.535,35,62,0.565,11,24,0.458,16,20,0.8,119,47,92,0.511,40,67,0.597,7,25,0.28,16,26,0.615,117,2016-11-13,ORL,OKC,2017,120.5
963,963,63,Home,W 119-112 ,240,44,81,0.543,29,56,0.518,15,25,0.6,16,18,0.889,119,41,86,0.477,29,57,0.509,12,29,0.414,18,20,0.9,112,2016-11-17,WAS,NYK,2017,118.0
964,964,64,@,W 119-114 ,240,44,86,0.512,31,55,0.564,13,31,0.419,18,20,0.9,119,45,89,0.506,34,69,0.493,11,20,0.55,13,18,0.722,114,2016-11-23,SAS,CHO,2017,119.5
965,965,65,Home,W 119-104 ,240,47,100,0.47,35,68,0.515,12,32,0.375,13,17,0.765,119,36,76,0.474,23,53,0.434,13,23,0.565,19,29,0.655,104,2016-11-25,POR,NOP,2017,110.5
966,966,66,@,W 119-115 ,240,45,95,0.474,32,65,0.492,13,30,0.433,16,21,0.762,119,40,87,0.46,31,61,0.508,9,26,0.346,26,34,0.765,115,2016-12-09,PHO,LAL,2017,119.5
967,967,67,Home,L 119-120 (OT),265,44,96,0.458,30,55,0.545,14,41,0.341,17,26,0.654,119,38,97,0.392,22,57,0.386,16,40,0.4,28,35,0.8,120,2016-12-11,PHO,NOP,2017,128.0
968,968,68,Home,W 119-108 ,240,46,89,0.517,31,56,0.554,15,33,0.455,12,18,0.667,119,41,86,0.477,25,49,0.51,16,37,0.432,10,13,0.769,108,2016-12-17,CLE,LAL,2017,116.0
969,969,69,Home,W 119-102 ,240,47,86,0.547,31,50,0.62,16,36,0.444,9,13,0.692,119,39,90,0.433,28,51,0.549,11,39,0.282,13,20,0.65,102,2016-12-20,LAC,DEN,2017,107.5
970,970,70,Home,W 119-99 ,240,45,99,0.455,37,64,0.578,8,35,0.229,21,24,0.875,119,38,85,0.447,30,55,0.545,8,30,0.267,15,18,0.833,99,2016-12-23,CLE,BRK,2017,103.0
971,971,71,@,W 119-113 ,240,43,77,0.558,32,50,0.64,11,27,0.407,22,24,0.917,119,43,85,0.506,33,56,0.589,10,29,0.345,17,28,0.607,113,2016-12-23,GSW,DET,2017,118.0
972,972,72,@,W 119-114 ,240,45,93,0.484,31,57,0.544,14,36,0.389,15,20,0.75,119,41,87,0.471,33,64,0.516,8,23,0.348,24,27,0.889,114,2016-12-25,BOS,NYK,2017,118.0
973,973,73,Home,W 119-100 ,240,48,85,0.565,39,67,0.582,9,18,0.5,14,19,0.737,119,39,86,0.453,32,68,0.471,7,18,0.389,15,20,0.75,100,2016-12-25,SAS,CHI,2017,103.5
974,974,74,@,W 119-94 ,240,48,84,0.571,37,62,0.597,11,22,0.5,12,16,0.75,119,39,88,0.443,33,64,0.516,6,24,0.25,10,16,0.625,94,2016-12-28,MIL,DET,2017,97.0
975,975,75,Home,W 119-98 ,240,47,87,0.54,42,70,0.6,5,17,0.294,20,25,0.8,119,36,74,0.486,29,58,0.5,7,16,0.438,19,24,0.792,98,2016-12-28,SAS,PHO,2017,101.5
976,976,76,@,L 119-127 ,240,48,101,0.475,39,66,0.591,9,35,0.257,14,18,0.778,119,50,95,0.526,39,70,0.557,11,25,0.44,16,21,0.762,127,2017-01-02,DEN,GSW,2017,132.5
977,977,77,Home,L 119-128 (OT),265,41,83,0.494,33,53,0.623,8,30,0.267,29,39,0.744,119,50,103,0.485,37,70,0.529,13,33,0.394,15,19,0.789,128,2017-01-06,GSW,MEM,2017,134.5
978,978,78,Home,W 119-105 ,240,44,81,0.543,36,58,0.621,8,23,0.348,23,25,0.92,119,36,87,0.414,21,45,0.467,15,42,0.357,18,22,0.818,105,2017-01-11,MIN,HOU,2017,112.5
979,979,79,@,W 119-109 ,240,48,92,0.522,38,73,0.521,10,19,0.526,13,16,0.813,119,40,89,0.449,33,63,0.524,7,26,0.269,22,24,0.917,109,2017-01-17,TOR,BRK,2017,112.5
980,980,80,@,W 119-95 ,240,41,80,0.513,25,38,0.658,16,42,0.381,21,25,0.84,119,33,89,0.371,24,55,0.436,9,34,0.265,20,28,0.714,95,2017-01-21,HOU,MEM,2017,99.5
981,981,81,@,W 119-114 ,240,43,83,0.518,26,53,0.491,17,30,0.567,16,19,0.842,119,43,94,0.457,35,67,0.522,8,27,0.296,20,26,0.769,114,2017-01-25,ATL,CHI,2017,118.0
982,982,82,Home,W 119-103 ,240,48,93,0.516,35,63,0.556,13,30,0.433,10,14,0.714,119,33,85,0.388,21,57,0.368,12,28,0.429,25,29,0.862,103,2017-01-27,NOP,SAS,2017,109.0
983,983,83,@,L 119-122 ,240,41,74,0.554,28,45,0.622,13,29,0.448,24,29,0.828,119,45,83,0.542,34,52,0.654,11,31,0.355,21,26,0.808,122,2017-01-30,SAC,PHI,2017,127.5
984,984,84,@,W 119-99 ,240,45,92,0.489,31,62,0.5,14,30,0.467,15,20,0.75,119,32,80,0.4,23,55,0.418,9,25,0.36,26,35,0.743,99,2017-02-01,MEM,DEN,2017,103.5
985,985,85,@,W 119-115 ,240,45,92,0.489,35,67,0.522,10,25,0.4,19,28,0.679,119,46,92,0.5,38,65,0.585,8,27,0.296,15,18,0.833,115,2017-02-08,LAC,NYK,2017,119.0
986,986,86,Home,W 119-104 ,240,46,87,0.529,31,49,0.633,15,38,0.395,12,15,0.8,119,42,100,0.42,34,74,0.459,8,26,0.308,12,17,0.706,104,2017-02-23,CLE,NYK,2017,108.0
987,987,87,@,W 119-98 ,240,49,94,0.521,39,73,0.534,10,21,0.476,11,13,0.846,119,40,87,0.46,33,65,0.508,7,22,0.318,11,18,0.611,98,2017-02-26,SAS,LAL,2017,101.5
988,988,88,@,W 119-108 ,240,40,89,0.449,34,60,0.567,6,29,0.207,33,39,0.846,119,37,82,0.451,27,48,0.563,10,34,0.294,24,27,0.889,108,2017-02-27,GSW,PHI,2017,113.0
989,989,89,@,W 119-111 ,240,41,87,0.471,21,43,0.488,20,44,0.455,17,22,0.773,119,38,82,0.463,25,54,0.463,13,28,0.464,22,31,0.71,111,2017-03-06,GSW,ATL,2017,117.5
990,990,90,Home,W 118-83 ,240,42,80,0.525,34,59,0.576,8,21,0.381,26,28,0.929,118,24,69,0.348,19,50,0.38,5,19,0.263,30,39,0.769,83,2012-01-04,MIA,IND,2012,85.5
991,991,91,@,W 118-110 ,240,47,85,0.553,40,74,0.541,7,11,0.636,17,21,0.81,118,42,85,0.494,31,56,0.554,11,29,0.379,15,20,0.75,110,2012-01-04,CHA,NYK,2012,115.5
992,992,92,Home,W 118-97 ,240,47,88,0.534,42,78,0.538,5,10,0.5,19,24,0.792,118,38,74,0.514,33,63,0.524,5,11,0.455,16,19,0.842,97,2012-01-17,CHI,PHO,2012,99.5
993,993,93,@,L 118-124 (OT),265,49,101,0.485,43,79,0.544,6,22,0.273,14,18,0.778,118,46,94,0.489,37,66,0.561,9,28,0.321,23,28,0.821,124,2012-02-19,DEN,OKC,2012,128.5
994,994,94,@,L 118-119 ,240,42,87,0.483,29,63,0.46,13,24,0.542,21,21,1.0,118,41,91,0.451,33,66,0.5,8,25,0.32,29,37,0.784,119,2012-02-28,WAS,MIL,2012,123.0
995,995,95,Home,W 118-105 ,240,46,85,0.541,39,66,0.591,7,19,0.368,19,25,0.76,118,41,96,0.427,31,68,0.456,10,28,0.357,13,17,0.765,105,2012-03-07,SAS,NYK,2012,110.0
996,996,96,Home,W 118-107 ,240,39,82,0.476,28,62,0.452,11,20,0.55,29,36,0.806,118,44,86,0.512,36,69,0.522,8,17,0.471,11,17,0.647,107,2012-03-11,CLE,HOU,2012,111.0
997,997,97,Home,W 118-117 (OT),265,45,87,0.517,38,67,0.567,7,20,0.35,21,26,0.808,118,43,92,0.467,29,63,0.46,14,29,0.483,17,19,0.895,117,2012-03-13,DEN,ATL,2012,124.0
998,998,98,Home,W 118-110 ,240,42,88,0.477,32,65,0.492,10,23,0.435,24,28,0.857,118,47,90,0.522,39,74,0.527,8,16,0.5,8,11,0.727,110,2012-04-11,POR,GSW,2012,114.0
999,999,99,Home,W 118-110 ,240,42,74,0.568,23,42,0.548,19,32,0.594,15,17,0.882,118,36,66,0.545,25,45,0.556,11,21,0.524,27,34,0.794,110,2012-04-17,NYK,BOS,2012,115.5
1000,1000,0,Home,W 118-109 ,240,43,91,0.473,36,74,0.486,7,17,0.412,25,32,0.781,118,37,88,0.42,31,68,0.456,6,20,0.3,29,33,0.879,109,2012-04-19,IND,MIL,2012,112.0
1001,1001,1,@,W 118-107 ,240,48,87,0.552,42,74,0.568,6,13,0.462,16,17,0.941,118,44,95,0.463,33,69,0.478,11,26,0.423,8,11,0.727,107,2012-04-21,DEN,PHO,2012,112.5
1002,1002,2,Home,W 118-110 ,240,38,81,0.469,29,61,0.475,9,20,0.45,33,36,0.917,118,43,82,0.524,39,66,0.591,4,16,0.25,20,27,0.741,110,2012-04-24,OKC,SAC,2012,112.0
1003,1003,3,@,W 118-92 ,240,45,80,0.563,32,57,0.561,13,23,0.565,15,20,0.75,118,37,90,0.411,33,76,0.434,4,14,0.286,14,17,0.824,92,2012-11-26,SAS,WAS,2013,94.0
1004,1004,4,@,W 118-117 (2OT),290,46,94,0.489,37,69,0.536,9,25,0.36,17,21,0.81,118,43,99,0.434,30,64,0.469,13,35,0.371,18,22,0.818,117,2012-12-01,POR,CLE,2013,123.5
1005,1005,5,@,W 118-112 (OT),265,43,92,0.467,31,57,0.544,12,35,0.343,20,26,0.769,118,41,88,0.466,28,61,0.459,13,27,0.481,17,22,0.773,112,2012-12-03,POR,CHA,2013,118.5
1006,1006,6,@,W 118-115 (OT),265,49,107,0.458,40,80,0.5,9,27,0.333,11,14,0.786,118,46,103,0.447,36,74,0.486,10,29,0.345,13,15,0.867,115,2012-12-22,LAL,GSW,2013,120.0
1007,1007,7,Home,W 118-96 ,240,44,82,0.537,34,62,0.548,10,20,0.5,20,25,0.8,118,36,86,0.419,29,64,0.453,7,22,0.318,17,19,0.895,96,2012-12-30,SAC,BOS,2013,99.5
1008,1008,8,Home,W 118-92 ,240,44,82,0.537,34,68,0.5,10,14,0.714,20,24,0.833,118,33,78,0.423,26,64,0.406,7,14,0.5,19,23,0.826,92,2013-01-07,CHI,CLE,2013,95.5
1009,1009,9,@,L 118-124 ,240,44,92,0.478,36,76,0.474,8,16,0.5,22,30,0.733,118,43,84,0.512,34,65,0.523,9,19,0.474,29,33,0.879,124,2013-01-14,CLE,SAC,2013,128.5
1010,1010,10,@,L 118-121 (OT),265,35,76,0.461,27,52,0.519,8,24,0.333,40,48,0.833,118,45,93,0.484,37,75,0.493,8,18,0.444,23,34,0.676,121,2013-01-20,OKC,DEN,2013,125.0
1011,1011,11,Home,W 118-110 ,240,42,82,0.512,34,54,0.63,8,28,0.286,26,36,0.722,118,39,81,0.481,31,54,0.574,8,27,0.296,24,35,0.686,110,2013-01-30,DEN,HOU,2013,114.0
1012,1012,12,Home,W 118-103 ,240,47,79,0.595,35,53,0.66,12,26,0.462,12,16,0.75,118,40,88,0.455,32,62,0.516,8,26,0.308,15,20,0.75,103,2013-02-08,HOU,POR,2013,107.0
1013,1013,13,Home,W 118-114 (3OT),315,43,108,0.398,30,78,0.385,13,30,0.433,19,24,0.792,118,48,113,0.425,40,87,0.46,8,26,0.308,10,17,0.588,114,2013-02-10,BOS,DEN,2013,118.0
1014,1014,14,@,W 118-94 ,240,43,87,0.494,34,66,0.515,9,21,0.429,23,28,0.821,118,38,79,0.481,34,65,0.523,4,14,0.286,14,22,0.636,94,2013-02-23,CLE,ORL,2013,96.0
1015,1015,15,@,W 118-110 ,240,42,77,0.545,27,45,0.6,15,32,0.469,19,28,0.679,118,44,78,0.564,35,56,0.625,9,22,0.409,13,16,0.813,110,2013-03-01,HOU,ORL,2013,114.5
1016,1016,16,@,L 118-125 ,240,41,94,0.436,32,68,0.471,9,26,0.346,27,35,0.771,118,47,82,0.573,39,65,0.6,8,17,0.471,23,28,0.821,125,2013-03-04,TOR,GSW,2013,129.0
1017,1017,17,Home,W 118-116 (OT),265,39,91,0.429,25,52,0.481,14,39,0.359,26,36,0.722,118,48,93,0.516,40,71,0.563,8,22,0.364,12,16,0.75,116,2013-03-08,LAL,TOR,2013,120.0
1018,1018,18,Home,L 118-119 (OT),265,47,96,0.49,39,75,0.52,8,21,0.381,16,19,0.842,118,46,100,0.46,39,80,0.488,7,20,0.35,20,27,0.741,119,2013-03-18,CHI,DEN,2013,122.5
1019,1019,19,Home,W 118-107 ,240,45,83,0.542,34,60,0.567,11,23,0.478,17,21,0.81,118,40,88,0.455,32,68,0.471,8,20,0.4,19,24,0.792,107,2013-03-29,BOS,ATL,2013,111.0
1020,1020,20,Home,W 118-111 (OT),265,39,87,0.448,29,60,0.483,10,27,0.37,30,37,0.811,118,42,104,0.404,32,74,0.432,10,30,0.333,17,22,0.773,111,2013-04-11,CHI,NYK,2013,116.0
1021,1021,21,Home,W 118-116 ,240,34,66,0.515,22,41,0.537,12,25,0.48,38,50,0.76,118,46,97,0.474,35,71,0.493,11,26,0.423,13,16,0.813,116,2013-04-12,LAL,GSW,2013,121.5
1022,1022,22,Home,W 118-109 ,240,43,81,0.531,35,59,0.593,8,22,0.364,24,27,0.889,118,38,82,0.463,26,50,0.52,12,32,0.375,21,26,0.808,109,2013-04-14,DEN,POR,2013,115.0
1023,1023,23,Home,W 118-98 ,240,49,93,0.527,45,77,0.584,4,16,0.25,16,20,0.8,118,40,104,0.385,33,79,0.418,7,25,0.28,11,17,0.647,98,2013-04-17,DEN,PHO,2013,101.5
1024,1024,24,Home,W 118-109 ,240,44,77,0.571,33,53,0.623,11,24,0.458,19,24,0.792,118,37,76,0.487,29,52,0.558,8,24,0.333,27,35,0.771,109,2013-10-30,DAL,ATL,2014,113.0
1025,1025,25,@,L 118-137 ,240,41,82,0.5,34,57,0.596,7,25,0.28,29,43,0.674,118,49,94,0.521,34,56,0.607,15,38,0.395,24,28,0.857,137,2013-11-04,HOU,LAC,2014,144.5
1026,1026,26,Home,W 118-95 ,240,46,79,0.582,34,56,0.607,12,23,0.522,14,24,0.583,118,33,79,0.418,22,49,0.449,11,30,0.367,18,21,0.857,95,2013-11-12,MIA,MIL,2014,100.5
1027,1027,27,@,W 118-110 (OT),265,44,99,0.444,29,67,0.433,15,32,0.469,15,20,0.75,118,42,94,0.447,39,77,0.506,3,17,0.176,23,31,0.742,110,2013-11-17,POR,TOR,2014,111.5
1028,1028,28,Home,W 118-94 ,240,47,77,0.61,42,64,0.656,5,13,0.385,19,20,0.95,118,34,85,0.4,27,64,0.422,7,21,0.333,19,21,0.905,94,2013-12-08,OKC,IND,2014,97.5
1029,1029,29,Home,W 118-85 ,240,45,86,0.523,35,60,0.583,10,26,0.385,18,24,0.75,118,35,94,0.372,32,76,0.421,3,18,0.167,12,15,0.8,85,2013-12-20,ATL,UTA,2014,86.5
1030,1030,30,Home,W 118-116 (OT),265,37,91,0.407,21,52,0.404,16,39,0.41,28,34,0.824,118,45,104,0.433,35,78,0.449,10,26,0.385,16,22,0.727,116,2013-12-28,ATL,CHA,2014,121.0
1031,1031,31,Home,W 118-103 ,240,44,79,0.557,36,61,0.59,8,18,0.444,22,29,0.759,118,37,84,0.44,30,58,0.517,7,26,0.269,22,35,0.629,103,2014-01-13,UTA,DEN,2014,106.5
1032,1032,32,Home,L 118-120 ,240,44,84,0.524,31,50,0.62,13,34,0.382,17,23,0.739,118,41,88,0.466,28,71,0.394,13,17,0.765,25,32,0.781,120,2014-01-14,LAL,CLE,2014,126.5
1033,1033,33,Home,L 118-126 ,240,36,74,0.486,22,45,0.489,14,29,0.483,32,38,0.842,118,46,84,0.548,34,62,0.548,12,22,0.545,22,25,0.88,126,2014-01-25,TOR,LAC,2014,132.0
1034,1034,34,Home,L 118-125 (2OT),290,44,101,0.436,39,85,0.459,5,16,0.313,25,32,0.781,118,48,98,0.49,39,70,0.557,9,28,0.321,20,25,0.8,125,2014-02-05,WAS,SAS,2014,129.5
1035,1035,35,Home,W 118-113 (OT),265,42,92,0.457,37,79,0.468,5,13,0.385,29,35,0.829,118,45,104,0.433,38,84,0.452,7,20,0.35,16,20,0.8,113,2014-02-07,IND,POR,2014,116.5
1036,1036,36,Home,W 118-105 ,240,36,71,0.507,27,47,0.574,9,24,0.375,37,54,0.685,118,34,85,0.4,27,59,0.458,7,26,0.269,30,40,0.75,105,2014-02-07,LAC,TOR,2014,108.5
1037,1037,37,Home,W 118-98 ,240,47,101,0.465,42,85,0.494,5,16,0.313,19,25,0.76,118,39,90,0.433,31,67,0.463,8,23,0.348,12,20,0.6,98,2014-02-25,IND,LAL,2014,102.0
1038,1038,38,Home,W 118-110 ,240,42,84,0.5,31,51,0.608,11,33,0.333,23,33,0.697,118,45,100,0.45,41,81,0.506,4,19,0.211,16,19,0.842,110,2014-03-01,HOU,DET,2014,112.0
1039,1039,39,@,W 118-106 ,240,47,90,0.522,36,63,0.571,11,27,0.407,13,19,0.684,118,39,90,0.433,32,64,0.5,7,26,0.269,21,24,0.875,106,2014-03-05,NYK,MIN,2014,109.5
1040,1040,40,Home,W 118-111 ,240,47,97,0.485,37,66,0.561,10,31,0.323,14,21,0.667,118,40,86,0.465,36,71,0.507,4,15,0.267,27,39,0.692,111,2014-03-09,BOS,DET,2014,113.0
1041,1041,41,Home,W 118-113 (OT),265,38,89,0.427,29,60,0.483,9,29,0.31,33,45,0.733,118,39,96,0.406,30,71,0.423,9,25,0.36,26,33,0.788,113,2014-03-09,HOU,POR,2014,117.5
1042,1042,42,Home,W 118-113 (OT),265,40,94,0.426,29,60,0.483,11,34,0.324,27,31,0.871,118,40,81,0.494,33,57,0.579,7,24,0.292,26,29,0.897,113,2014-03-18,ATL,TOR,2014,116.5
1043,1043,43,Home,W 118-109 ,240,44,86,0.512,33,59,0.559,11,27,0.407,19,27,0.704,118,43,95,0.453,33,69,0.478,10,26,0.385,13,19,0.684,109,2014-03-19,DEN,DET,2014,114.0
1044,1044,44,Home,L 118-119 (2OT),290,41,101,0.406,33,72,0.458,8,29,0.276,28,33,0.848,118,38,98,0.388,26,62,0.419,12,36,0.333,31,38,0.816,119,2014-03-21,TOR,OKC,2014,125.0
1045,1045,45,@,W 118-111 ,240,38,79,0.481,26,44,0.591,12,35,0.343,30,34,0.882,118,46,92,0.5,40,75,0.533,6,17,0.353,13,17,0.765,111,2014-03-22,HOU,CLE,2014,114.0
1046,1046,46,@,W 118-107 ,240,42,89,0.472,30,48,0.625,12,41,0.293,22,36,0.611,118,32,79,0.405,25,54,0.463,7,25,0.28,36,45,0.8,107,2014-03-29,LAC,HOU,2014,110.5
1047,1047,47,Home,W 118-92 ,240,45,72,0.625,35,53,0.66,10,19,0.526,18,21,0.857,118,32,81,0.395,29,57,0.509,3,24,0.125,25,30,0.833,92,2014-04-02,WAS,BOS,2014,93.5
1048,1048,48,@,W 118-102 ,240,50,88,0.568,44,70,0.629,6,18,0.333,12,17,0.706,118,39,84,0.464,32,54,0.593,7,30,0.233,17,23,0.739,102,2014-04-16,WAS,BOS,2014,105.5
1049,1049,49,@,W 118-111 ,240,34,71,0.479,22,38,0.579,12,33,0.364,38,44,0.864,118,42,82,0.512,35,62,0.565,7,20,0.35,20,28,0.714,111,2014-10-31,LAC,LAL,2015,114.5
1050,1050,50,Home,W 118-91 ,240,42,88,0.477,35,62,0.565,7,26,0.269,27,33,0.818,118,36,87,0.414,29,56,0.518,7,31,0.226,12,15,0.8,91,2014-11-01,UTA,PHO,2015,94.5
1051,1051,51,Home,W 118-113 ,240,44,82,0.537,30,57,0.526,14,25,0.56,16,20,0.8,118,45,102,0.441,34,71,0.479,11,31,0.355,12,16,0.75,113,2014-11-03,DAL,BOS,2015,118.5
1052,1052,52,@,W 118-115 ,240,40,78,0.513,28,54,0.519,12,24,0.5,26,34,0.765,118,43,91,0.473,31,61,0.508,12,30,0.4,17,25,0.68,115,2014-11-07,CHI,PHI,2015,121.0
1053,1053,53,Home,W 118-111 ,240,40,81,0.494,27,54,0.5,13,27,0.481,25,30,0.833,118,41,93,0.441,29,66,0.439,12,27,0.444,17,20,0.85,111,2014-11-10,CLE,NOP,2015,117.0
1054,1054,54,@,W 118-114 ,240,48,93,0.516,39,72,0.542,9,21,0.429,13,16,0.813,118,45,87,0.517,41,77,0.532,4,10,0.4,20,31,0.645,114,2014-11-17,PHO,BOS,2015,116.0
1055,1055,55,Home,L 118-122 (3OT),315,44,92,0.478,35,61,0.574,9,31,0.29,21,29,0.724,118,48,108,0.444,43,84,0.512,5,24,0.208,21,28,0.75,122,2014-11-19,BRK,MIL,2015,124.5
1056,1056,56,@,W 118-106 ,240,45,80,0.563,32,54,0.593,13,26,0.5,15,17,0.882,118,40,88,0.455,36,69,0.522,4,19,0.211,22,30,0.733,106,2014-12-05,PHO,DAL,2015,108.0
1057,1057,57,Home,W 118-108 ,240,42,86,0.488,28,53,0.528,14,33,0.424,20,27,0.741,118,40,82,0.488,35,68,0.515,5,14,0.357,23,26,0.885,108,2014-12-21,TOR,NYK,2015,110.5
1058,1058,58,@,L 118-125 ,240,43,86,0.5,33,62,0.532,10,24,0.417,22,29,0.759,118,49,77,0.636,36,54,0.667,13,23,0.565,14,22,0.636,125,2014-12-22,LAC,SAS,2015,131.5
1059,1059,59,@,W 118-108 ,240,47,85,0.553,42,68,0.618,5,17,0.294,19,28,0.679,118,42,86,0.488,36,67,0.537,6,19,0.316,18,24,0.75,108,2015-01-09,DEN,SAC,2015,111.0
1060,1060,60,@,L 118-128 ,240,48,97,0.495,42,82,0.512,6,15,0.4,16,16,1.0,118,49,94,0.521,39,70,0.557,10,24,0.417,20,24,0.833,128,2015-01-21,ORL,DET,2015,133.0
1061,1061,61,Home,W 118-113 ,240,47,92,0.511,38,65,0.585,9,27,0.333,15,24,0.625,118,39,87,0.448,26,55,0.473,13,32,0.406,22,28,0.786,113,2015-01-21,PHO,POR,2015,119.5
1062,1062,62,@,L 118-123 (2OT),290,43,104,0.413,37,79,0.468,6,25,0.24,26,32,0.813,118,50,106,0.472,47,97,0.485,3,9,0.333,20,25,0.8,123,2015-01-29,CHI,LAL,2015,124.5
1063,1063,63,Home,L 118-127 ,240,41,87,0.471,29,61,0.475,12,26,0.462,24,30,0.8,118,48,95,0.505,33,58,0.569,15,37,0.405,16,23,0.696,127,2015-02-10,PHO,HOU,2015,134.5
1064,1064,64,Home,W 118-111 (OT),265,43,84,0.512,36,66,0.545,7,18,0.389,25,38,0.658,118,42,98,0.429,34,65,0.523,8,33,0.242,19,27,0.704,111,2015-02-22,LAL,BOS,2015,115.0
1065,1065,65,@,L 118-123 (OT),265,34,96,0.354,19,61,0.311,15,35,0.429,35,44,0.795,118,44,96,0.458,37,75,0.493,7,21,0.333,28,34,0.824,123,2015-03-04,PHI,OKC,2015,126.5
1066,1066,66,Home,W 118-86 ,240,45,85,0.529,28,51,0.549,17,34,0.5,11,12,0.917,118,34,92,0.37,30,75,0.4,4,17,0.235,14,20,0.7,86,2015-03-10,IND,ORL,2015,88.0
1067,1067,67,Home,W 118-99 ,240,46,80,0.575,35,59,0.593,11,21,0.524,15,17,0.882,118,41,91,0.451,34,66,0.515,7,25,0.28,10,12,0.833,99,2015-03-13,POR,DET,2015,102.5
1068,1068,68,@,W 118-111 (2OT),290,46,104,0.442,36,73,0.493,10,31,0.323,16,20,0.8,118,46,99,0.465,40,77,0.519,6,22,0.273,13,21,0.619,111,2015-03-15,DEN,NOP,2015,114.0
1069,1069,69,@,L 118-122 ,240,44,84,0.524,31,50,0.62,13,34,0.382,17,28,0.607,118,42,88,0.477,37,69,0.536,5,19,0.263,33,39,0.846,122,2015-03-18,BOS,OKC,2015,124.5
1070,1070,70,Home,W 118-108 ,240,37,83,0.446,25,53,0.472,12,30,0.4,32,40,0.8,118,42,93,0.452,29,57,0.509,13,36,0.361,11,19,0.579,108,2015-03-19,HOU,DEN,2015,114.5
1071,1071,71,@,W 118-113 ,240,35,68,0.515,23,47,0.489,12,21,0.571,36,44,0.818,118,42,82,0.512,35,58,0.603,7,24,0.292,22,28,0.786,113,2015-10-30,WAS,MIL,2016,116.5
1072,1072,72,Home,W 118-97 ,240,45,83,0.542,31,60,0.517,14,23,0.609,14,22,0.636,118,40,84,0.476,29,60,0.483,11,24,0.458,6,12,0.5,97,2015-11-04,PHO,SAC,2016,102.5
1073,1073,73,Home,W 118-98 ,240,44,97,0.454,32,67,0.478,12,30,0.4,18,23,0.783,118,36,88,0.409,28,63,0.444,8,25,0.32,18,23,0.783,98,2015-11-06,BOS,WAS,2016,102.0
1074,1074,74,Home,W 118-114 ,240,37,74,0.5,26,50,0.52,11,24,0.458,33,43,0.767,118,40,82,0.488,30,60,0.5,10,22,0.455,24,28,0.857,114,2015-11-10,CLE,UTA,2016,119.0
1075,1075,75,Home,W 118-108 ,240,42,76,0.553,31,52,0.596,11,24,0.458,23,30,0.767,118,37,86,0.43,25,59,0.424,12,27,0.444,22,33,0.667,108,2015-11-11,DAL,LAC,2016,114.0
1076,1076,76,Home,W 118-104 ,240,44,83,0.53,30,53,0.566,14,30,0.467,16,21,0.762,118,40,90,0.444,31,64,0.484,9,26,0.346,15,28,0.536,104,2015-11-12,PHO,LAC,2016,108.5
1077,1077,77,@,W 118-105 ,240,47,89,0.528,32,60,0.533,15,29,0.517,9,13,0.692,118,37,86,0.43,33,71,0.465,4,15,0.267,27,35,0.771,105,2015-11-22,GSW,DEN,2016,107.0
1078,1078,78,Home,L 118-129 ,240,42,88,0.477,29,57,0.509,13,31,0.419,21,27,0.778,118,44,77,0.571,34,54,0.63,10,23,0.435,31,37,0.838,129,2015-11-25,MIL,SAC,2016,134.0
1079,1079,79,Home,W 118-96 ,240,45,90,0.5,32,61,0.525,13,29,0.448,15,19,0.789,118,41,82,0.5,38,66,0.576,3,16,0.188,11,18,0.611,96,2015-12-12,DET,IND,2016,97.5
1080,1080,80,Home,W 118-81 ,240,42,75,0.56,33,54,0.611,9,21,0.429,25,27,0.926,118,32,79,0.405,29,68,0.426,3,11,0.273,14,17,0.824,81,2015-12-14,SAS,UTA,2016,82.5
1081,1081,81,Home,W 118-78 ,240,46,84,0.548,37,65,0.569,9,19,0.474,17,25,0.68,118,30,86,0.349,22,58,0.379,8,28,0.286,10,17,0.588,78,2015-12-19,OKC,LAL,2016,82.0
1082,1082,82,Home,L 118-119 (OT),265,51,101,0.505,41,82,0.5,10,19,0.526,6,14,0.429,118,45,82,0.549,29,48,0.604,16,34,0.471,13,15,0.867,119,2015-12-23,BRK,DAL,2016,127.0
1083,1083,83,Home,W 118-111 ,240,40,87,0.46,24,54,0.444,16,33,0.485,22,28,0.786,118,42,78,0.538,34,57,0.596,8,21,0.381,19,26,0.731,111,2015-12-26,DAL,CHI,2016,115.0
1084,1084,84,Home,W 118-115 ,240,47,85,0.553,41,64,0.641,6,21,0.286,18,27,0.667,118,41,76,0.539,33,52,0.635,8,24,0.333,25,29,0.862,115,2016-01-07,SAC,LAL,2016,119.0
1085,1085,85,@,W 118-104 ,240,51,98,0.52,40,73,0.548,11,25,0.44,5,10,0.5,118,38,80,0.475,35,63,0.556,3,17,0.176,25,32,0.781,104,2016-01-15,WAS,IND,2016,105.5
1086,1086,86,Home,W 118-113 (OT),265,40,93,0.43,24,59,0.407,16,34,0.471,22,24,0.917,118,40,94,0.426,28,64,0.438,12,30,0.4,21,26,0.808,113,2016-01-18,DAL,BOS,2016,119.0
1087,1087,87,Home,W 118-111 (OT),265,47,90,0.522,40,73,0.548,7,17,0.412,17,18,0.944,118,37,86,0.43,25,59,0.424,12,27,0.444,25,31,0.806,111,2016-01-20,NYK,UTA,2016,117.0
1088,1088,88,@,W 118-111 ,240,43,82,0.524,33,66,0.5,10,16,0.625,22,34,0.647,118,43,93,0.462,34,69,0.493,9,24,0.375,16,22,0.727,111,2016-02-21,SAS,PHO,2016,115.5
1089,1089,89,@,W 118-112 ,240,42,90,0.467,29,62,0.468,13,28,0.464,21,25,0.84,118,40,86,0.465,34,72,0.472,6,14,0.429,26,31,0.839,112,2016-02-24,GSW,MIA,2016,115.0
1090,1090,90,Home,L 118-121 (OT),265,46,96,0.479,37,70,0.529,9,26,0.346,17,26,0.654,118,45,95,0.474,31,63,0.492,14,32,0.438,17,25,0.68,121,2016-02-27,OKC,GSW,2016,128.0
1091,1091,91,@,L 118-132 ,240,45,92,0.489,36,66,0.545,9,26,0.346,19,26,0.731,118,52,76,0.684,42,58,0.724,10,18,0.556,18,22,0.818,132,2016-03-05,BRK,MIN,2016,137.0
1092,1092,92,@,W 118-104 ,240,38,86,0.442,27,53,0.509,11,33,0.333,31,41,0.756,118,35,86,0.407,23,53,0.434,12,33,0.364,22,32,0.688,104,2016-03-09,HOU,PHI,2016,110.0
1093,1093,93,@,W 118-96 ,240,47,91,0.516,37,73,0.507,10,18,0.556,14,20,0.7,118,38,81,0.469,30,60,0.5,8,21,0.381,12,15,0.8,96,2016-03-11,MIA,CHI,2016,100.0
1094,1094,94,Home,W 118-103 ,240,42,83,0.506,32,58,0.552,10,25,0.4,24,29,0.828,118,36,76,0.474,27,46,0.587,9,30,0.3,22,27,0.815,103,2016-03-11,CHA,DET,2016,107.5
1095,1095,95,@,W 118-114 ,240,39,89,0.438,27,55,0.491,12,34,0.353,28,34,0.824,118,39,84,0.464,31,59,0.525,8,25,0.32,28,39,0.718,114,2016-03-16,ATL,DET,2016,118.0
1096,1096,96,Home,W 118-102 ,240,46,94,0.489,35,70,0.5,11,24,0.458,15,15,1.0,118,40,86,0.465,34,65,0.523,6,21,0.286,16,20,0.8,102,2016-03-17,CHI,BRK,2016,105.0
1097,1097,97,Home,W 118-110 ,240,45,86,0.523,37,70,0.529,8,16,0.5,20,22,0.909,118,39,89,0.438,29,67,0.433,10,22,0.455,22,30,0.733,110,2016-03-17,SAS,POR,2016,115.0
1098,1098,98,Home,W 118-102 ,240,43,80,0.538,32,56,0.571,11,24,0.458,21,25,0.84,118,39,98,0.398,31,73,0.425,8,25,0.32,16,19,0.842,102,2016-03-23,DET,ORL,2016,106.0
1099,1099,99,Home,W 118-110 ,240,41,102,0.402,28,60,0.467,13,42,0.31,23,26,0.885,118,38,82,0.463,31,55,0.564,7,27,0.259,27,32,0.844,110,2016-04-03,HOU,OKC,2016,113.5
1100,1100,0,Home,W 118-107 ,240,46,88,0.523,29,55,0.527,17,33,0.515,9,11,0.818,118,40,90,0.444,29,62,0.468,11,28,0.393,16,24,0.667,107,2016-04-09,ATL,BOS,2016,112.5
1101,1101,1,Home,W 118-96 ,240,43,77,0.558,37,57,0.649,6,20,0.3,26,30,0.867,118,37,83,0.446,30,65,0.462,7,18,0.389,15,19,0.789,96,2016-04-10,MIA,ORL,2016,99.5
1102,1102,2,Home,W 118-101 ,240,45,86,0.523,36,65,0.554,9,21,0.429,19,21,0.905,118,43,88,0.489,36,70,0.514,7,18,0.389,8,9,0.889,101,2016-10-29,CHI,IND,2017,104.5
1103,1103,3,@,W 118-88 ,240,45,89,0.506,34,62,0.548,11,27,0.407,17,18,0.944,118,33,96,0.344,28,65,0.431,5,31,0.161,17,21,0.81,88,2016-10-31,CHI,BRK,2017,90.5
1104,1104,4,@,W 118-99 ,240,42,89,0.472,27,49,0.551,15,40,0.375,19,27,0.704,118,37,85,0.435,29,65,0.446,8,20,0.4,17,25,0.68,99,2016-11-02,HOU,NYK,2017,103.0
1105,1105,5,Home,W 118-115 (OT),265,44,103,0.427,39,87,0.448,5,16,0.313,25,30,0.833,118,42,101,0.416,30,68,0.441,12,33,0.364,19,21,0.905,115,2016-11-02,PHO,POR,2017,121.0
1106,1106,6,Home,W 118-93 ,240,46,92,0.5,36,71,0.507,10,21,0.476,16,20,0.8,118,35,81,0.432,25,50,0.5,10,31,0.323,13,22,0.591,93,2016-11-09,WAS,BOS,2017,98.0
1107,1107,7,Home,W 118-107 ,240,39,83,0.47,32,61,0.525,7,22,0.318,33,38,0.868,118,44,97,0.454,37,74,0.5,7,23,0.304,12,16,0.75,107,2016-11-12,TOR,NYK,2017,110.5
1108,1108,8,@,L 118-125 ,240,45,99,0.455,33,58,0.569,12,41,0.293,16,20,0.8,118,41,92,0.446,32,64,0.5,9,28,0.321,34,43,0.791,125,2016-11-15,BRK,LAL,2017,129.5
1109,1109,9,@,W 118-110 ,240,45,87,0.517,37,65,0.569,8,22,0.364,20,28,0.714,118,41,93,0.441,28,62,0.452,13,31,0.419,15,21,0.714,110,2016-11-20,CHI,LAL,2017,116.5
1110,1110,10,Home,W 118-97 ,240,48,87,0.552,37,61,0.607,11,26,0.423,11,16,0.688,118,36,79,0.456,25,45,0.556,11,34,0.324,14,23,0.609,97,2016-11-25,IND,BRK,2017,102.5
1111,1111,11,Home,W 118-101 ,240,46,86,0.535,39,67,0.582,7,19,0.368,19,23,0.826,118,32,75,0.427,18,36,0.5,14,39,0.359,23,31,0.742,101,2016-11-29,MIL,CLE,2017,108.0
1112,1112,12,Home,W 118-114 ,240,41,86,0.477,29,55,0.527,12,31,0.387,24,30,0.8,118,41,88,0.466,31,60,0.517,10,28,0.357,22,24,0.917,114,2016-12-02,NYK,MIN,2017,119.0
1113,1113,13,@,W 118-113 ,240,45,92,0.489,31,58,0.534,14,34,0.412,14,18,0.778,118,40,81,0.494,29,54,0.537,11,27,0.407,22,30,0.733,113,2016-12-05,WAS,BRK,2017,118.5
1114,1114,14,Home,W 118-111 ,240,40,83,0.482,25,54,0.463,15,29,0.517,23,28,0.821,118,40,82,0.488,24,45,0.533,16,37,0.432,15,16,0.938,111,2016-12-10,IND,POR,2017,119.0
1115,1115,15,@,W 118-112 ,240,41,84,0.488,31,62,0.5,10,22,0.455,26,31,0.839,118,42,88,0.477,32,60,0.533,10,28,0.357,18,22,0.818,112,2016-12-11,NYK,LAL,2017,117.0
1116,1116,16,@,L 118-122 ,240,42,80,0.525,35,60,0.583,7,20,0.35,27,36,0.75,118,42,91,0.462,25,48,0.521,17,43,0.395,21,36,0.583,122,2016-12-12,BRK,HOU,2017,130.5
1117,1117,17,Home,W 118-111 ,240,39,97,0.402,32,68,0.471,7,29,0.241,33,42,0.786,118,39,83,0.47,28,56,0.5,11,27,0.407,22,26,0.846,111,2016-12-16,ORL,BRK,2017,116.5
1118,1118,18,Home,W 118-111 ,240,44,88,0.5,31,65,0.477,13,23,0.565,17,21,0.81,118,39,91,0.429,33,68,0.485,6,23,0.261,27,33,0.818,111,2016-12-20,NYK,IND,2017,114.0
1119,1119,19,@,L 118-120 ,240,44,94,0.468,36,68,0.529,8,26,0.308,22,25,0.88,118,40,75,0.533,25,44,0.568,15,31,0.484,25,31,0.806,120,2016-12-26,CHA,BRK,2017,127.5
1120,1120,20,@,L 118-124 ,240,43,85,0.506,31,48,0.646,12,37,0.324,20,21,0.952,118,43,83,0.518,29,45,0.644,14,38,0.368,24,33,0.727,124,2016-12-29,BOS,CLE,2017,131.0
1121,1121,21,Home,W 118-95 ,240,47,83,0.566,36,61,0.59,11,22,0.5,13,14,0.929,118,32,74,0.432,22,49,0.449,10,25,0.4,21,25,0.84,95,2016-12-30,WAS,BRK,2017,100.0
1122,1122,22,Home,W 118-111 ,240,42,90,0.467,35,67,0.522,7,23,0.304,27,29,0.931,118,41,83,0.494,32,64,0.5,9,19,0.474,20,22,0.909,111,2017-01-02,CHI,CHO,2017,115.5
1123,1123,23,Home,W 118-116 ,240,41,86,0.477,26,47,0.553,15,39,0.385,21,30,0.7,118,41,91,0.451,29,61,0.475,12,30,0.4,22,27,0.815,116,2017-01-05,HOU,OKC,2017,122.0
1124,1124,24,Home,W 118-109 ,240,43,81,0.531,31,48,0.646,12,33,0.364,20,30,0.667,118,36,86,0.419,26,55,0.473,10,31,0.323,27,33,0.818,109,2017-01-05,POR,LAL,2017,114.0
1125,1125,25,@,L 118-123 (OT),265,37,85,0.435,29,54,0.537,8,31,0.258,36,43,0.837,118,38,97,0.392,27,69,0.391,11,28,0.393,36,39,0.923,123,2017-01-07,TOR,CHI,2017,128.5
1126,1126,26,Home,L 118-122 ,240,37,81,0.457,28,56,0.5,9,25,0.36,35,40,0.875,118,40,90,0.444,31,62,0.5,9,28,0.321,33,41,0.805,122,2017-01-15,SAC,OKC,2017,126.5
1127,1127,27,Home,W 118-95 ,240,45,91,0.495,35,66,0.53,10,25,0.4,18,28,0.643,118,30,78,0.385,24,53,0.453,6,25,0.24,29,37,0.784,95,2017-01-18,DET,ATL,2017,98.0
1128,1128,28,Home,W 118-98 ,240,46,93,0.495,31,57,0.544,15,36,0.417,11,15,0.733,118,39,88,0.443,28,56,0.5,11,32,0.344,9,11,0.818,98,2017-01-18,NOP,ORL,2017,103.5
1129,1129,29,Home,W 118-103 ,240,43,85,0.506,24,43,0.558,19,42,0.452,13,19,0.684,118,37,85,0.435,33,66,0.5,4,19,0.211,25,31,0.806,103,2017-01-19,CLE,PHO,2017,105.0
1130,1130,30,Home,W 118-104 ,240,44,86,0.512,35,64,0.547,9,22,0.409,21,25,0.84,118,37,91,0.407,27,60,0.45,10,31,0.323,20,26,0.769,104,2017-01-19,SAS,DEN,2017,109.0
1131,1131,31,@,W 118-115 (OT),265,48,96,0.5,38,70,0.543,10,26,0.385,12,14,0.857,118,45,91,0.495,32,57,0.561,13,34,0.382,12,22,0.545,115,2017-01-21,SAS,CLE,2017,121.5
1132,1132,32,@,W 118-98 ,240,42,89,0.472,23,47,0.489,19,42,0.452,15,19,0.789,118,42,96,0.438,35,68,0.515,7,28,0.25,7,16,0.438,98,2017-01-22,GSW,ORL,2017,101.5
1133,1133,33,Home,L 118-123 ,240,42,78,0.538,32,53,0.604,10,25,0.4,24,32,0.75,118,42,81,0.519,30,50,0.6,12,31,0.387,27,28,0.964,123,2017-01-27,PHI,HOU,2017,129.0
1134,1134,34,Home,W 118-98 ,240,48,88,0.545,38,62,0.613,10,26,0.385,12,17,0.706,118,41,82,0.5,36,61,0.59,5,21,0.238,11,14,0.786,98,2017-02-01,DET,NOP,2017,100.5
1135,1135,35,Home,W 118-109 ,240,41,84,0.488,31,60,0.517,10,24,0.417,26,29,0.897,118,42,90,0.467,29,55,0.527,13,35,0.371,12,18,0.667,109,2017-02-06,TOR,LAC,2017,115.5
1136,1136,36,Home,W 118-109 ,240,50,106,0.472,42,79,0.532,8,27,0.296,10,13,0.769,118,38,79,0.481,28,58,0.483,10,21,0.476,23,30,0.767,109,2017-02-09,OKC,CLE,2017,114.0
1137,1137,37,Home,W 118-110 ,240,42,88,0.477,36,67,0.537,6,21,0.286,28,37,0.757,118,36,80,0.45,28,59,0.475,8,21,0.381,30,37,0.811,110,2017-02-26,OKC,NOP,2017,114.0
1138,1138,38,Home,W 118-111 ,240,44,89,0.494,39,68,0.574,5,21,0.238,25,31,0.806,118,37,87,0.425,28,52,0.538,9,35,0.257,28,35,0.8,111,2017-03-03,PHO,OKC,2017,115.5
1139,1139,39,Home,W 117-100 ,240,46,86,0.535,40,67,0.597,6,19,0.316,19,26,0.731,117,38,79,0.481,31,63,0.492,7,16,0.438,17,25,0.68,100,2011-12-28,DEN,UTA,2012,103.5
1140,1140,40,Home,W 117-89 ,240,47,82,0.573,41,66,0.621,6,16,0.375,17,24,0.708,117,35,76,0.461,28,60,0.467,7,16,0.438,12,17,0.706,89,2012-01-04,LAC,HOU,2012,92.5
1141,1141,41,@,L 117-121 ,240,46,81,0.568,38,65,0.585,8,16,0.5,17,26,0.654,117,49,89,0.551,40,69,0.58,9,20,0.45,14,18,0.778,121,2012-01-07,DEN,SAS,2012,125.5
1142,1142,42,@,W 117-109 ,240,35,68,0.515,24,45,0.533,11,23,0.478,36,55,0.655,117,43,82,0.524,33,59,0.559,10,23,0.435,13,19,0.684,109,2012-01-12,ORL,GSW,2012,114.0
1143,1143,43,Home,W 117-104 ,240,43,78,0.551,31,53,0.585,12,25,0.48,19,26,0.731,117,38,81,0.469,31,65,0.477,7,16,0.438,21,29,0.724,104,2012-01-13,DEN,MIA,2012,107.5
1144,1144,44,Home,W 117-97 ,240,46,86,0.535,31,53,0.585,15,33,0.455,10,12,0.833,117,35,79,0.443,30,57,0.526,5,22,0.227,22,24,0.917,97,2012-02-04,POR,DEN,2012,99.5
1145,1145,45,Home,W 117-108 (OT),265,44,88,0.5,37,69,0.536,7,19,0.368,22,31,0.71,117,42,79,0.532,33,58,0.569,9,21,0.429,15,23,0.652,108,2012-02-21,IND,NOH,2012,112.5
1146,1146,46,@,W 117-105 ,240,43,97,0.443,35,75,0.467,8,22,0.364,23,35,0.657,117,36,76,0.474,26,47,0.553,10,29,0.345,23,29,0.793,105,2012-03-02,DEN,HOU,2012,110.0
1147,1147,47,@,L 117-118 (OT),265,43,92,0.467,29,63,0.46,14,29,0.483,17,19,0.895,117,45,87,0.517,38,67,0.567,7,20,0.35,21,26,0.808,118,2012-03-13,ATL,DEN,2012,121.5
1148,1148,48,Home,W 117-100 ,240,45,99,0.455,33,64,0.516,12,35,0.343,15,15,1.0,117,41,81,0.506,38,66,0.576,3,15,0.2,15,22,0.682,100,2012-03-25,MIN,DEN,2012,101.5
1149,1149,49,@,W 117-101 ,240,44,81,0.543,29,47,0.617,15,34,0.441,14,19,0.737,117,35,74,0.473,24,52,0.462,11,22,0.5,20,24,0.833,101,2012-03-26,ORL,TOR,2012,106.5
1150,1150,50,@,W 117-112 ,240,49,91,0.538,39,71,0.549,10,20,0.5,9,12,0.75,117,47,86,0.547,39,65,0.6,8,21,0.381,10,13,0.769,112,2012-03-28,SAS,SAC,2012,116.0
1151,1151,51,@,L 117-122 (OT),265,43,96,0.448,31,72,0.431,12,24,0.5,19,25,0.76,117,44,98,0.449,36,72,0.5,8,26,0.308,26,32,0.813,122,2012-04-08,CLE,NJN,2012,126.0
1152,1152,52,Home,W 117-110 ,240,41,79,0.519,30,53,0.566,11,26,0.423,24,26,0.923,117,43,86,0.5,31,58,0.534,12,28,0.429,12,15,0.8,110,2012-04-18,DAL,HOU,2012,116.0
1153,1153,53,Home,W 117-107 (OT),265,47,88,0.534,43,80,0.538,4,8,0.5,19,23,0.826,117,42,96,0.438,27,58,0.466,15,38,0.395,8,13,0.615,107,2012-04-21,UTA,ORL,2012,114.5
1154,1154,54,@,W 117-110 ,240,43,93,0.462,31,66,0.47,12,27,0.444,19,28,0.679,117,38,87,0.437,28,65,0.431,10,22,0.455,24,27,0.889,110,2012-11-07,PHO,CHA,2013,115.0
1155,1155,55,@,L 117-119 (OT),265,41,88,0.466,32,63,0.508,9,25,0.36,26,31,0.839,117,44,86,0.512,34,61,0.557,10,25,0.4,21,29,0.724,119,2012-11-16,HOU,POR,2013,124.0
1156,1156,56,Home,W 117-113 ,240,43,93,0.462,30,68,0.441,13,25,0.52,18,24,0.75,117,41,77,0.532,31,56,0.554,10,21,0.476,21,22,0.955,113,2012-11-17,MIL,NOH,2013,118.0
1157,1157,57,Home,W 117-111 (OT),265,36,79,0.456,25,56,0.446,11,23,0.478,34,39,0.872,117,40,93,0.43,33,73,0.452,7,20,0.35,24,33,0.727,111,2012-11-21,OKC,LAC,2013,114.5
1158,1158,58,Home,W 117-101 ,240,44,83,0.53,31,57,0.544,13,26,0.5,16,21,0.762,117,42,86,0.488,34,63,0.54,8,23,0.348,9,12,0.75,101,2012-11-27,HOU,TOR,2013,105.0
1159,1159,59,Home,W 117-77 ,240,40,76,0.526,28,60,0.467,12,16,0.75,25,35,0.714,117,28,82,0.341,22,61,0.361,6,21,0.286,15,20,0.75,77,2012-11-28,DET,PHO,2013,80.0
1160,1160,60,Home,L 117-118 (2OT),290,43,99,0.434,30,64,0.469,13,35,0.371,18,22,0.818,117,46,94,0.489,37,69,0.536,9,25,0.36,17,21,0.81,118,2012-12-01,CLE,POR,2013,122.5
1161,1161,61,@,W 117-111 ,240,40,66,0.606,33,52,0.635,7,14,0.5,30,34,0.882,117,39,91,0.429,25,57,0.439,14,34,0.412,19,23,0.826,111,2012-12-04,OKC,BRK,2013,118.0
1162,1162,62,Home,W 117-99 ,240,48,93,0.516,41,70,0.586,7,23,0.304,14,24,0.583,117,36,78,0.462,27,54,0.5,9,24,0.375,18,20,0.9,99,2012-12-08,LAC,PHO,2013,103.5
1163,1163,63,@,W 117-110 ,240,45,83,0.542,39,65,0.6,6,18,0.333,21,27,0.778,117,40,85,0.471,25,57,0.439,15,28,0.536,15,18,0.833,110,2012-12-09,UTA,LAL,2013,117.5
1164,1164,64,Home,W 117-115 (2OT),290,43,100,0.43,37,78,0.474,6,22,0.273,25,30,0.833,117,47,92,0.511,39,69,0.565,8,23,0.348,13,17,0.765,115,2012-12-12,BOS,DAL,2013,119.0
1165,1165,65,@,W 117-110 ,240,46,89,0.517,37,72,0.514,9,17,0.529,16,23,0.696,117,43,88,0.489,38,71,0.535,5,17,0.294,19,24,0.792,110,2013-01-02,SAS,MIL,2013,112.5
1166,1166,66,@,W 117-112 (OT),265,41,96,0.427,36,75,0.48,5,21,0.238,30,35,0.857,117,40,81,0.494,33,54,0.611,7,27,0.259,25,32,0.781,112,2013-01-10,DAL,SAC,2013,115.5
1167,1167,67,@,W 117-109 ,240,42,78,0.538,31,59,0.525,11,19,0.579,22,26,0.846,117,41,82,0.5,28,45,0.622,13,37,0.351,14,25,0.56,109,2013-01-15,LAC,HOU,2013,115.5
1168,1168,68,Home,W 117-97 ,240,44,85,0.518,35,66,0.53,9,19,0.474,20,26,0.769,117,33,73,0.452,31,58,0.534,2,15,0.133,29,37,0.784,97,2013-01-16,OKC,DEN,2013,98.0
1169,1169,69,@,W 117-114 (OT),265,39,95,0.411,33,75,0.44,6,20,0.3,33,36,0.917,117,41,91,0.451,34,71,0.479,7,20,0.35,25,30,0.833,114,2013-01-18,OKC,DAL,2013,117.5
1170,1170,70,@,W 117-90 ,240,46,98,0.469,35,75,0.467,11,23,0.478,14,22,0.636,117,34,84,0.405,32,73,0.438,2,11,0.182,20,28,0.714,90,2013-01-29,MIL,DET,2013,91.0
1171,1171,71,Home,W 117-99 ,240,45,83,0.542,41,69,0.594,4,14,0.286,23,43,0.535,117,35,88,0.398,29,68,0.426,6,20,0.3,23,26,0.885,99,2013-02-01,DET,CLE,2013,102.0
1172,1172,72,Home,W 117-111 ,240,40,87,0.46,29,67,0.433,11,20,0.55,26,27,0.963,117,44,89,0.494,34,56,0.607,10,33,0.303,13,17,0.765,111,2013-02-10,SAC,HOU,2013,116.0
1173,1173,73,Home,W 117-104 ,240,43,74,0.581,35,55,0.636,8,19,0.421,23,27,0.852,117,39,73,0.534,31,49,0.633,8,24,0.333,18,20,0.9,104,2013-02-12,MIA,POR,2013,108.0
1174,1174,74,Home,W 117-101 ,240,47,87,0.54,35,58,0.603,12,29,0.414,11,14,0.786,117,38,79,0.481,25,50,0.5,13,29,0.448,12,15,0.8,101,2013-03-06,LAC,MIL,2013,107.5
1175,1175,75,Home,W 117-94 ,240,41,84,0.488,32,63,0.508,9,21,0.429,26,37,0.703,117,34,79,0.43,23,51,0.451,11,28,0.393,15,22,0.682,94,2013-03-13,DEN,NYK,2013,99.5
1176,1176,76,Home,W 117-104 ,240,42,76,0.553,38,63,0.603,4,13,0.308,29,43,0.674,117,40,92,0.435,33,65,0.508,7,27,0.259,17,21,0.81,104,2013-03-15,OKC,ORL,2013,107.5
1177,1177,77,@,W 117-86 ,240,42,79,0.532,40,67,0.597,2,12,0.167,31,40,0.775,117,36,95,0.379,32,73,0.438,4,22,0.182,10,21,0.476,86,2013-03-22,MIN,PHO,2013,88.0
1178,1178,78,@,W 117-103 ,240,47,96,0.49,39,75,0.52,8,21,0.381,15,21,0.714,117,42,85,0.494,33,61,0.541,9,24,0.375,10,12,0.833,103,2013-03-24,PHI,SAC,2013,107.5
1179,1179,79,Home,L 117-120 ,240,45,97,0.464,40,80,0.5,5,17,0.294,22,30,0.733,117,44,82,0.537,34,60,0.567,10,22,0.455,22,38,0.579,120,2013-03-27,MIN,LAL,2013,125.0
1180,1180,80,@,W 117-103 ,240,44,83,0.53,37,65,0.569,7,18,0.389,22,24,0.917,117,42,94,0.447,35,74,0.473,7,20,0.35,12,23,0.522,103,2013-03-28,SAC,PHO,2013,106.5
1181,1181,81,@,W 117-108 ,240,46,90,0.511,40,70,0.571,6,20,0.3,19,19,1.0,117,39,87,0.448,33,61,0.541,6,26,0.231,24,31,0.774,108,2013-04-05,DAL,SAC,2013,111.0
1182,1182,82,@,W 117-109 ,240,42,82,0.512,30,57,0.526,12,25,0.48,21,26,0.808,117,40,80,0.5,32,61,0.525,8,19,0.421,21,26,0.808,109,2013-04-12,BRK,IND,2013,113.0
1183,1183,83,@,L 117-123 (OT),265,43,96,0.448,28,55,0.509,15,41,0.366,16,25,0.64,117,43,103,0.417,32,78,0.41,11,25,0.44,26,34,0.765,123,2013-11-13,HOU,PHI,2014,128.5
1184,1184,84,Home,W 117-113 ,240,47,97,0.485,40,77,0.519,7,20,0.35,16,21,0.762,117,46,94,0.489,40,72,0.556,6,22,0.273,15,19,0.789,113,2013-11-15,DEN,MIN,2014,116.0
1185,1185,85,@,W 117-110 ,240,45,88,0.511,37,72,0.514,8,16,0.5,19,25,0.76,117,40,88,0.455,35,68,0.515,5,20,0.25,25,28,0.893,110,2013-11-27,DEN,MIN,2014,112.5
1186,1186,86,Home,W 117-110 ,240,48,87,0.552,38,65,0.585,10,22,0.455,11,13,0.846,117,38,88,0.432,27,65,0.415,11,23,0.478,23,26,0.885,110,2013-12-13,SAS,MIN,2014,115.5
1187,1187,87,Home,W 117-94 ,240,45,71,0.634,39,56,0.696,6,15,0.4,21,26,0.808,117,39,84,0.464,34,66,0.515,5,18,0.278,11,17,0.647,94,2013-12-16,MIA,UTA,2014,96.5
1188,1188,88,Home,W 117-90 ,240,42,90,0.467,28,58,0.483,14,32,0.438,19,25,0.76,117,30,81,0.37,24,61,0.393,6,20,0.3,24,37,0.649,90,2013-12-23,PHO,LAL,2014,93.0
1189,1189,89,@,W 117-95 ,240,43,90,0.478,32,66,0.485,11,24,0.458,20,29,0.69,117,40,89,0.449,35,67,0.522,5,22,0.227,10,17,0.588,95,2013-12-28,MIN,MIL,2014,97.5
1190,1190,90,Home,W 117-86 ,240,47,82,0.573,37,60,0.617,10,22,0.455,13,16,0.813,117,31,85,0.365,24,57,0.421,7,28,0.25,17,31,0.548,86,2013-12-29,OKC,HOU,2014,89.5
1191,1191,91,Home,W 117-89 ,240,43,86,0.5,33,63,0.524,10,23,0.435,21,23,0.913,117,34,85,0.4,30,66,0.455,4,19,0.211,17,22,0.773,89,2014-01-16,IND,NYK,2014,91.0
1192,1192,92,@,W 117-109 ,240,42,88,0.477,37,72,0.514,5,16,0.313,28,35,0.8,117,40,92,0.435,26,55,0.473,14,37,0.378,15,19,0.789,109,2014-01-17,CLE,DEN,2014,116.0
1193,1193,93,Home,W 117-103 ,240,46,91,0.505,38,72,0.528,8,19,0.421,17,26,0.654,117,36,82,0.439,27,54,0.5,9,28,0.321,22,30,0.733,103,2014-01-19,PHO,DEN,2014,107.5
1194,1194,94,Home,L 117-125 ,240,42,81,0.519,38,65,0.585,4,16,0.25,29,34,0.853,117,42,81,0.519,32,56,0.571,10,25,0.4,31,40,0.775,125,2014-01-26,SAC,DEN,2014,130.0
1195,1195,95,@,W 117-115 ,240,41,74,0.554,32,53,0.604,9,21,0.429,26,36,0.722,117,40,86,0.465,35,67,0.522,5,19,0.263,30,36,0.833,115,2014-01-29,HOU,DAL,2014,117.5
1196,1196,96,Home,L 117-126 ,240,38,89,0.427,31,70,0.443,7,19,0.368,34,36,0.944,117,42,78,0.538,30,55,0.545,12,23,0.522,30,32,0.938,126,2014-01-29,MIL,PHO,2014,132.0
1197,1197,97,Home,W 117-86 ,240,43,76,0.566,31,50,0.62,12,26,0.462,19,28,0.679,117,31,87,0.356,23,64,0.359,8,23,0.348,16,22,0.727,86,2014-01-30,NYK,CLE,2014,90.0
1198,1198,98,Home,W 117-90 ,240,48,85,0.565,37,57,0.649,11,28,0.393,10,14,0.714,117,32,76,0.421,25,50,0.5,7,26,0.269,19,26,0.731,90,2014-02-07,NYK,DEN,2014,93.5
1199,1199,99,@,W 117-110 ,240,40,83,0.482,32,60,0.533,8,23,0.348,29,38,0.763,117,40,97,0.412,35,80,0.438,5,17,0.294,25,34,0.735,110,2014-02-08,POR,MIN,2014,112.5
1200,1200,0,@,L 117-122 ,240,43,84,0.512,30,53,0.566,13,31,0.419,18,22,0.818,117,46,79,0.582,42,69,0.609,4,10,0.4,26,31,0.839,122,2014-02-12,POR,LAC,2014,124.0
1201,1201,1,Home,W 117-90 ,240,45,86,0.523,33,60,0.55,12,26,0.462,15,23,0.652,117,33,84,0.393,24,60,0.4,9,24,0.375,15,20,0.75,90,2014-02-12,MIN,DEN,2014,94.5
1202,1202,2,@,W 117-106 ,240,44,77,0.571,34,51,0.667,10,26,0.385,19,24,0.792,117,34,85,0.4,25,58,0.431,9,27,0.333,29,32,0.906,106,2014-02-18,MIA,DAL,2014,110.5
1203,1203,3,Home,W 117-89 ,240,42,84,0.5,32,67,0.478,10,17,0.588,23,27,0.852,117,35,87,0.402,28,72,0.389,7,15,0.467,12,22,0.545,89,2014-02-21,CHI,DEN,2014,92.5
1204,1204,4,Home,L 117-125 ,240,43,93,0.462,31,64,0.484,12,29,0.414,19,24,0.792,117,42,81,0.519,29,51,0.569,13,30,0.433,28,39,0.718,125,2014-02-23,OKC,LAC,2014,131.5
1205,1205,5,Home,W 117-111 (OT),265,40,87,0.46,34,69,0.493,6,18,0.333,31,40,0.775,117,40,91,0.44,29,63,0.46,11,28,0.393,20,30,0.667,111,2014-03-18,SAC,WAS,2014,116.5
1206,1206,6,@,W 117-107 ,240,42,87,0.483,32,62,0.516,10,25,0.4,23,29,0.793,117,43,91,0.473,36,72,0.5,7,19,0.368,14,23,0.609,107,2014-03-21,WAS,LAL,2014,110.5
1207,1207,7,Home,W 117-96 ,240,45,89,0.506,34,67,0.507,11,22,0.5,16,21,0.762,117,30,77,0.39,21,49,0.429,9,28,0.321,27,40,0.675,96,2014-03-24,OKC,DEN,2014,100.5
1208,1208,8,Home,W 117-98 ,240,48,82,0.585,35,53,0.66,13,29,0.448,8,10,0.8,117,36,91,0.396,31,70,0.443,5,21,0.238,21,25,0.84,98,2014-04-04,ATL,CLE,2014,100.5
1209,1209,9,Home,W 117-95 ,240,44,81,0.543,39,68,0.574,5,13,0.385,24,32,0.75,117,39,88,0.443,33,70,0.471,6,18,0.333,11,17,0.647,95,2014-04-11,MEM,PHI,2014,98.0
1210,1210,10,Home,W 117-101 ,240,41,81,0.506,32,62,0.516,9,19,0.474,26,36,0.722,117,35,82,0.427,31,73,0.425,4,9,0.444,27,33,0.818,101,2014-04-12,LAC,SAC,2014,103.0
1211,1211,11,@,L 117-119 (OT),265,44,91,0.484,27,54,0.5,17,37,0.459,12,16,0.75,117,43,86,0.5,33,62,0.532,10,24,0.417,23,32,0.719,119,2014-04-13,GSW,POR,2014,124.0
1212,1212,12,Home,W 117-105 ,240,44,83,0.53,35,59,0.593,9,24,0.375,20,30,0.667,117,35,82,0.427,27,53,0.509,8,29,0.276,27,30,0.9,105,2014-04-15,LAC,DEN,2014,109.0
1213,1213,13,@,L 117-131 ,240,43,86,0.5,36,69,0.522,7,17,0.412,24,29,0.828,117,52,94,0.553,44,68,0.647,8,26,0.308,19,23,0.826,131,2014-11-15,MIN,DAL,2015,135.0
1214,1214,14,Home,W 117-113 ,240,43,78,0.551,34,61,0.557,9,17,0.529,22,27,0.815,117,44,80,0.55,33,55,0.6,11,25,0.44,14,19,0.737,113,2014-11-18,MIL,NYK,2015,118.5
1215,1215,15,Home,W 117-97 ,240,43,82,0.524,32,58,0.552,11,24,0.458,20,25,0.8,117,31,78,0.397,26,62,0.419,5,16,0.313,30,34,0.882,97,2014-11-21,DEN,NOP,2015,99.5
1216,1216,16,Home,W 117-100 ,240,48,91,0.527,40,75,0.533,8,16,0.5,13,14,0.929,117,38,88,0.432,29,61,0.475,9,27,0.333,15,21,0.714,100,2014-11-21,MEM,BOS,2015,104.5
1217,1217,17,@,W 117-103 ,240,44,87,0.506,29,49,0.592,15,38,0.395,14,16,0.875,117,33,74,0.446,27,55,0.491,6,19,0.316,31,35,0.886,103,2014-11-29,HOU,MIL,2015,106.0
1218,1218,18,@,W 117-109 ,240,44,88,0.5,34,65,0.523,10,23,0.435,19,21,0.905,117,39,75,0.52,36,65,0.554,3,10,0.3,28,37,0.757,109,2014-12-02,TOR,SAC,2015,110.5
1219,1219,19,@,W 117-106 ,240,40,79,0.506,30,57,0.526,10,22,0.455,27,35,0.771,117,40,89,0.449,27,56,0.482,13,33,0.394,13,19,0.684,106,2014-12-17,DAL,DET,2015,112.5
1220,1220,20,@,W 117-116 (3OT),315,48,107,0.449,38,80,0.475,10,27,0.37,11,14,0.786,117,43,105,0.41,26,70,0.371,17,35,0.486,13,27,0.481,116,2014-12-17,MEM,SAS,2015,124.5
1221,1221,21,@,W 117-111 (OT),265,41,91,0.451,27,57,0.474,14,34,0.412,21,28,0.75,117,43,104,0.413,36,80,0.45,7,24,0.292,18,23,0.783,111,2014-12-26,HOU,MEM,2015,114.5
1222,1222,22,Home,W 117-91 ,240,41,88,0.466,26,60,0.433,15,28,0.536,20,32,0.625,117,30,98,0.306,25,70,0.357,5,28,0.179,26,34,0.765,91,2015-01-05,GSW,OKC,2015,93.5
1223,1223,23,Home,W 117-102 ,240,45,91,0.495,33,63,0.524,12,28,0.429,15,20,0.75,117,37,81,0.457,31,55,0.564,6,26,0.231,22,23,0.957,102,2015-01-07,GSW,IND,2015,105.0
1224,1224,24,@,W 117-108 ,240,44,92,0.478,35,64,0.547,9,28,0.321,20,31,0.645,117,41,89,0.461,36,71,0.507,5,18,0.278,21,26,0.808,108,2015-01-17,LAC,SAC,2015,110.5
1225,1225,25,@,W 117-115 (OT),265,48,90,0.533,44,76,0.579,4,14,0.286,17,23,0.739,117,41,101,0.406,29,72,0.403,12,29,0.414,21,28,0.75,115,2015-01-25,WAS,DEN,2015,121.0
1226,1226,26,Home,W 117-111 ,240,41,81,0.506,26,49,0.531,15,32,0.469,20,29,0.69,117,48,95,0.505,44,78,0.564,4,17,0.235,11,15,0.733,111,2015-02-06,HOU,MIL,2015,113.0
1227,1227,27,@,W 117-105 ,240,44,86,0.512,34,65,0.523,10,21,0.476,19,20,0.95,117,42,93,0.452,37,77,0.481,5,16,0.313,16,22,0.727,105,2015-02-09,ATL,MIN,2015,107.5
1228,1228,28,Home,W 117-113 (OT),265,48,97,0.495,39,71,0.549,9,26,0.346,12,21,0.571,117,39,101,0.386,31,77,0.403,8,24,0.333,27,30,0.9,113,2015-02-26,PHO,OKC,2015,117.0
1229,1229,29,Home,W 117-107 ,240,41,85,0.482,30,67,0.448,11,18,0.611,24,30,0.8,117,43,97,0.443,35,71,0.493,8,26,0.308,13,18,0.722,107,2015-03-10,SAS,TOR,2015,111.0
1230,1230,30,@,W 117-98 ,240,39,82,0.476,27,59,0.458,12,23,0.522,27,33,0.818,117,38,88,0.432,36,69,0.522,2,19,0.105,20,25,0.8,98,2015-03-16,TOR,IND,2015,99.0
1231,1231,31,Home,W 117-92 ,240,45,82,0.549,30,53,0.566,15,29,0.517,12,20,0.6,117,36,80,0.45,31,60,0.517,5,20,0.25,15,21,0.714,92,2015-03-18,CLE,BRK,2015,94.5
1232,1232,32,@,W 117-102 ,240,46,92,0.5,38,77,0.494,8,15,0.533,17,24,0.708,117,41,87,0.471,31,53,0.585,10,34,0.294,10,12,0.833,102,2015-03-21,PHO,HOU,2015,107.0
1233,1233,33,@,L 117-127 ,240,44,85,0.518,35,66,0.53,9,19,0.474,20,27,0.741,117,48,86,0.558,37,65,0.569,11,21,0.524,20,23,0.87,127,2015-03-24,LAL,OKC,2015,132.5
1234,1234,34,@,W 117-116 (OT),265,47,97,0.485,39,71,0.549,8,26,0.308,15,22,0.682,117,40,83,0.482,34,60,0.567,6,23,0.261,30,38,0.789,116,2015-04-04,BOS,TOR,2015,119.0
1235,1235,35,Home,W 117-80 ,240,45,89,0.506,33,69,0.478,12,20,0.6,15,23,0.652,117,32,82,0.39,27,67,0.403,5,15,0.333,11,17,0.647,80,2015-04-10,BRK,WAS,2015,82.5
1236,1236,36,Home,W 117-78 ,240,46,84,0.548,36,60,0.6,10,24,0.417,15,22,0.682,117,31,79,0.392,28,57,0.491,3,22,0.136,13,19,0.684,78,2015-04-12,BOS,CLE,2015,79.5
1237,1237,37,Home,W 117-91 ,240,41,76,0.539,29,48,0.604,12,28,0.429,23,34,0.676,117,38,101,0.376,33,74,0.446,5,27,0.185,10,18,0.556,91,2015-04-15,HOU,UTA,2015,93.5
1238,1238,38,@,W 117-110 ,240,41,86,0.477,32,67,0.478,9,19,0.474,26,32,0.813,117,38,90,0.422,32,68,0.471,6,22,0.273,28,33,0.848,110,2015-10-31,NYK,WAS,2016,113.0
1239,1239,39,Home,W 117-93 ,240,45,86,0.523,32,61,0.525,13,25,0.52,14,18,0.778,117,35,92,0.38,26,66,0.394,9,26,0.346,14,19,0.737,93,2015-11-01,OKC,DEN,2016,97.5
1240,1240,40,@,W 117-107 ,240,46,80,0.575,39,65,0.6,7,15,0.467,18,22,0.818,117,44,86,0.512,31,55,0.564,13,31,0.419,6,7,0.857,107,2015-11-09,MIN,ATL,2016,113.5
1241,1241,41,Home,L 117-124 ,240,44,88,0.5,31,59,0.525,13,29,0.448,16,24,0.667,117,38,73,0.521,21,43,0.488,17,30,0.567,31,36,0.861,124,2015-11-19,LAC,GSW,2016,132.5
1242,1242,42,Home,W 117-114 ,240,47,90,0.522,38,68,0.559,9,22,0.409,14,18,0.778,117,44,83,0.53,34,64,0.531,10,19,0.526,16,28,0.571,114,2015-11-22,OKC,DAL,2016,119.0
1243,1243,43,Home,W 117-103 ,240,43,81,0.531,25,46,0.543,18,35,0.514,13,22,0.591,117,40,81,0.494,30,59,0.508,10,22,0.455,13,21,0.619,103,2015-11-23,CLE,ORL,2016,108.0
1244,1244,44,Home,W 117-98 ,240,47,88,0.534,39,63,0.619,8,25,0.32,15,18,0.833,117,39,81,0.481,32,57,0.561,7,24,0.292,13,17,0.765,98,2015-12-26,ATL,NYK,2016,101.5
1245,1245,45,Home,L 117-122 ,240,38,88,0.432,29,58,0.5,9,30,0.3,32,36,0.889,117,37,71,0.521,22,41,0.537,15,30,0.5,33,41,0.805,122,2015-12-30,CHA,LAC,2016,129.5
1246,1246,46,Home,W 117-106 ,240,46,83,0.554,41,64,0.641,5,19,0.263,20,20,1.0,117,46,102,0.451,40,86,0.465,6,16,0.375,8,14,0.571,106,2016-01-05,CHI,MIL,2016,109.0
1247,1247,47,Home,W 117-116 (2OT),290,45,98,0.459,33,69,0.478,12,29,0.414,15,23,0.652,117,47,99,0.475,35,67,0.522,12,32,0.375,10,14,0.714,116,2016-01-05,DAL,SAC,2016,122.0
1248,1248,48,@,W 117-113 ,240,45,89,0.506,40,72,0.556,5,17,0.294,22,26,0.846,117,40,84,0.476,31,58,0.534,9,26,0.346,24,25,0.96,113,2016-01-08,OKC,LAL,2016,117.5
1249,1249,49,Home,W 117-103 ,240,42,96,0.438,28,66,0.424,14,30,0.467,19,29,0.655,117,35,89,0.393,25,62,0.403,10,27,0.37,23,28,0.821,103,2016-01-15,BOS,PHO,2016,108.0
1250,1250,50,Home,L 117-119 ,240,40,89,0.449,34,67,0.507,6,22,0.273,31,36,0.861,117,39,88,0.443,30,59,0.508,9,29,0.31,32,36,0.889,119,2016-01-16,WAS,BOS,2016,123.5
1251,1251,51,Home,W 117-87 ,240,39,69,0.565,32,51,0.627,7,18,0.389,32,40,0.8,117,35,81,0.432,32,66,0.485,3,15,0.2,14,25,0.56,87,2016-01-17,MIN,PHO,2016,88.5
1252,1252,52,@,W 117-89 ,240,42,86,0.488,33,72,0.458,9,14,0.643,24,28,0.857,117,32,81,0.395,26,63,0.413,6,18,0.333,19,23,0.826,89,2016-01-21,SAS,PHO,2016,92.0
1253,1253,53,@,W 117-113 ,240,41,81,0.506,32,63,0.508,9,18,0.5,26,33,0.788,117,39,88,0.443,28,60,0.467,11,28,0.393,24,30,0.8,113,2016-01-28,DEN,WAS,2016,118.5
1254,1254,54,Home,W 117-103 ,240,45,82,0.549,36,59,0.61,9,23,0.391,18,21,0.857,117,40,81,0.494,34,63,0.54,6,18,0.333,17,21,0.81,103,2016-01-30,CLE,SAS,2016,106.0
1255,1255,55,@,L 117-121 ,240,38,92,0.413,29,68,0.426,9,24,0.375,32,38,0.842,117,41,79,0.519,33,61,0.541,8,18,0.444,31,37,0.838,121,2016-01-30,SAC,MEM,2016,125.0
1256,1256,56,Home,W 117-114 ,240,44,93,0.473,35,66,0.53,9,27,0.333,20,25,0.8,117,47,95,0.495,37,72,0.514,10,23,0.435,10,12,0.833,114,2016-02-03,OKC,ORL,2016,119.0
1257,1257,57,@,W 117-110 (OT),265,46,93,0.495,37,64,0.578,9,29,0.31,16,22,0.727,117,43,92,0.467,31,63,0.492,12,29,0.414,12,20,0.6,110,2016-02-08,ORL,ATL,2016,116.0
1258,1258,58,@,W 117-95 ,240,45,87,0.517,33,59,0.559,12,28,0.429,15,19,0.789,117,40,92,0.435,36,74,0.486,4,18,0.222,11,15,0.733,95,2016-02-10,CHA,IND,2016,97.0
1259,1259,59,Home,W 117-112 ,240,35,76,0.461,31,62,0.5,4,14,0.286,43,53,0.811,117,39,86,0.453,29,55,0.527,10,31,0.323,24,32,0.75,112,2016-02-10,MIN,TOR,2016,117.0
1260,1260,60,@,W 117-109 (2OT),290,46,104,0.442,43,87,0.494,3,17,0.176,22,32,0.688,117,44,106,0.415,35,65,0.538,9,41,0.22,12,18,0.667,109,2016-02-20,MIL,ATL,2016,113.5
1261,1261,61,Home,W 117-114 (OT),265,38,74,0.514,28,50,0.56,10,24,0.417,31,38,0.816,117,36,87,0.414,25,53,0.472,11,34,0.324,31,41,0.756,114,2016-02-23,UTA,HOU,2016,119.5
1262,1262,62,@,W 117-107 ,240,43,89,0.483,34,60,0.567,9,29,0.31,22,26,0.846,117,34,78,0.436,22,54,0.407,12,24,0.5,27,37,0.73,107,2016-02-26,LAC,SAC,2016,113.0
1263,1263,63,Home,W 117-107 ,240,38,78,0.487,26,55,0.473,12,23,0.522,29,38,0.763,117,35,79,0.443,24,48,0.5,11,31,0.355,26,32,0.813,107,2016-03-02,DEN,LAL,2016,112.5
1264,1264,64,Home,W 117-115 ,240,34,67,0.507,28,55,0.509,6,12,0.5,43,54,0.796,117,39,83,0.47,28,56,0.5,11,27,0.407,26,35,0.743,115,2016-03-04,TOR,POR,2016,120.5
1265,1265,65,Home,W 117-96 ,240,43,88,0.489,30,67,0.448,13,21,0.619,18,24,0.75,117,35,87,0.402,29,67,0.433,6,20,0.3,20,23,0.87,96,2016-03-16,WAS,CHI,2016,99.0
1266,1266,66,@,W 117-112 ,240,36,78,0.462,27,51,0.529,9,27,0.333,36,40,0.9,117,40,83,0.482,30,62,0.484,10,21,0.476,22,28,0.786,112,2016-03-18,POR,NOP,2016,117.0
1267,1267,67,@,W 117-102 ,240,46,91,0.505,33,66,0.5,13,25,0.52,12,20,0.6,117,38,78,0.487,25,45,0.556,13,33,0.394,13,17,0.765,102,2016-03-21,WAS,ATL,2016,108.5
1268,1268,68,Home,W 117-105 ,240,44,83,0.53,30,50,0.6,14,33,0.424,15,20,0.75,117,42,90,0.467,32,60,0.533,10,30,0.333,11,12,0.917,105,2016-03-27,GSW,PHI,2016,110.0
1269,1269,69,@,L 117-119 ,240,42,76,0.553,26,47,0.553,16,29,0.552,17,22,0.773,117,45,87,0.517,35,55,0.636,10,32,0.313,19,24,0.792,119,2016-03-31,LAC,OKC,2016,124.0
1270,1270,70,Home,L 117-124 (OT),265,49,98,0.5,37,63,0.587,12,35,0.343,7,8,0.875,117,44,86,0.512,36,69,0.522,8,17,0.471,28,36,0.778,124,2016-04-05,GSW,MIN,2016,128.0
1271,1271,71,Home,W 117-103 ,240,47,86,0.547,36,57,0.632,11,29,0.379,12,19,0.632,117,42,91,0.462,34,64,0.531,8,27,0.296,11,18,0.611,103,2016-04-13,CHA,ORL,2016,107.0
1272,1272,72,Home,W 117-88 ,240,45,94,0.479,32,59,0.542,13,35,0.371,14,19,0.737,117,32,87,0.368,23,60,0.383,9,27,0.333,15,20,0.75,88,2016-10-25,CLE,NYK,2017,92.5
1273,1273,73,@,L 117-122 ,240,43,97,0.443,28,53,0.528,15,44,0.341,16,20,0.8,117,48,89,0.539,37,57,0.649,11,32,0.344,15,18,0.833,122,2016-10-26,BRK,BOS,2017,127.5
1274,1274,74,@,W 117-113 ,240,44,91,0.484,34,59,0.576,10,32,0.313,19,21,0.905,117,36,82,0.439,27,56,0.482,9,26,0.346,32,41,0.78,113,2016-11-01,MIL,NOP,2017,117.5
1275,1275,75,@,W 117-104 ,240,46,89,0.517,37,68,0.544,9,21,0.429,16,21,0.762,117,37,84,0.44,29,61,0.475,8,23,0.348,22,27,0.815,104,2016-11-04,NYK,CHI,2017,108.0
1276,1276,76,Home,W 117-97 ,240,45,95,0.474,37,65,0.569,8,30,0.267,19,21,0.905,117,39,86,0.453,34,54,0.63,5,32,0.156,14,20,0.7,97,2016-11-04,LAL,GSW,2017,99.5
1277,1277,77,Home,W 117-91 ,240,41,82,0.5,27,49,0.551,14,33,0.424,21,25,0.84,117,33,84,0.393,23,56,0.411,10,28,0.357,15,19,0.789,91,2016-11-05,MIL,SAC,2017,96.0
1278,1278,78,Home,W 117-96 ,240,48,95,0.505,35,63,0.556,13,32,0.406,8,14,0.571,117,36,83,0.434,25,54,0.463,11,29,0.379,13,20,0.65,96,2016-11-12,ATL,PHI,2017,101.5
1279,1279,79,Home,L 117-119 ,240,47,92,0.511,40,67,0.597,7,25,0.28,16,26,0.615,117,46,86,0.535,35,62,0.565,11,24,0.458,16,20,0.8,119,2016-11-13,OKC,ORL,2017,124.5
1280,1280,80,@,L 117-121 ,240,46,96,0.479,33,67,0.493,13,29,0.448,12,18,0.667,117,44,83,0.53,31,50,0.62,13,33,0.394,20,28,0.714,121,2016-11-15,TOR,CLE,2017,127.5
1281,1281,81,Home,W 117-96 ,240,45,83,0.542,36,59,0.61,9,24,0.375,18,23,0.783,117,33,86,0.384,30,69,0.435,3,17,0.176,27,33,0.818,96,2016-11-23,NOP,MIN,2017,97.5
1282,1282,82,@,W 117-104 ,240,40,85,0.471,19,35,0.543,21,50,0.42,16,20,0.8,117,39,80,0.488,30,48,0.625,9,32,0.281,17,21,0.81,104,2016-11-25,HOU,SAC,2017,108.5
1283,1283,83,@,W 117-87 ,240,43,84,0.512,36,58,0.621,7,26,0.269,24,29,0.828,117,30,81,0.37,19,55,0.345,11,26,0.423,16,24,0.667,87,2016-12-07,BOS,ORL,2017,92.5
1284,1284,84,@,W 117-90 ,240,42,84,0.5,28,55,0.509,14,29,0.483,19,23,0.826,117,37,78,0.474,34,62,0.548,3,16,0.188,13,20,0.65,90,2016-12-09,DET,MIN,2017,91.5
1285,1285,85,Home,W 117-110 ,240,43,81,0.531,33,62,0.532,10,19,0.526,21,30,0.7,117,43,87,0.494,36,64,0.563,7,23,0.304,17,24,0.708,110,2016-12-18,WAS,LAC,2017,113.5
1286,1286,86,Home,W 117-107 ,240,45,79,0.57,32,55,0.582,13,24,0.542,14,18,0.778,117,43,81,0.531,29,56,0.518,14,25,0.56,7,9,0.778,107,2016-12-19,DEN,DAL,2017,114.0
1287,1287,87,Home,W 117-113 ,240,43,94,0.457,32,69,0.464,11,25,0.44,20,24,0.833,117,44,90,0.489,28,57,0.491,16,33,0.485,9,11,0.818,113,2016-12-20,CHA,LAL,2017,121.0
1288,1288,88,@,W 117-101 ,240,47,104,0.452,35,67,0.522,12,37,0.324,11,14,0.786,117,38,86,0.442,25,51,0.49,13,35,0.371,12,16,0.75,101,2016-12-22,GSW,BRK,2017,107.5
1289,1289,89,@,W 117-112 ,240,41,80,0.513,30,54,0.556,11,26,0.423,24,36,0.667,117,41,93,0.441,32,65,0.492,9,28,0.321,21,26,0.808,112,2016-12-23,OKC,BOS,2017,116.5
1290,1290,90,Home,W 117-114 ,240,38,74,0.514,21,42,0.5,17,32,0.531,24,29,0.828,117,48,90,0.533,37,62,0.597,11,28,0.393,7,10,0.7,114,2016-12-30,BOS,MIA,2017,119.5
1291,1291,91,Home,W 117-104 ,240,43,86,0.5,34,64,0.531,9,22,0.409,22,24,0.917,117,42,97,0.433,32,59,0.542,10,38,0.263,10,11,0.909,104,2017-01-01,IND,ORL,2017,109.0
1292,1292,92,@,L 117-125 ,240,40,89,0.449,28,63,0.444,12,26,0.462,25,28,0.893,117,44,87,0.506,31,51,0.608,13,36,0.361,24,29,0.828,125,2017-01-04,POR,GSW,2017,131.5
1293,1293,93,Home,W 117-108 ,240,40,93,0.43,22,57,0.386,18,36,0.5,19,21,0.905,117,40,85,0.471,30,54,0.556,10,31,0.323,18,23,0.783,108,2017-01-07,BOS,NOP,2017,113.0
1294,1294,94,@,W 117-106 ,240,45,89,0.506,35,60,0.583,10,29,0.345,17,20,0.85,117,36,74,0.486,25,46,0.543,11,28,0.393,23,29,0.793,106,2017-01-08,GSW,SAC,2017,111.5
1295,1295,95,@,W 117-97 ,240,44,92,0.478,37,69,0.536,7,23,0.304,22,38,0.579,117,35,87,0.402,25,58,0.431,10,29,0.345,17,23,0.739,97,2017-01-10,ATL,BRK,2017,102.0
1296,1296,96,Home,W 117-108 ,240,43,85,0.506,26,44,0.591,17,41,0.415,14,18,0.778,117,45,105,0.429,35,79,0.443,10,26,0.385,8,12,0.667,108,2017-01-11,BOS,WAS,2017,113.0
1297,1297,97,@,W 117-106 ,240,46,91,0.505,36,66,0.545,10,25,0.4,15,18,0.833,117,35,91,0.385,26,58,0.448,9,33,0.273,27,29,0.931,106,2017-01-18,NYK,BOS,2017,110.5
1298,1298,98,Home,W 117-101 ,240,49,88,0.557,42,66,0.636,7,22,0.318,12,15,0.8,117,34,93,0.366,29,69,0.42,5,24,0.208,28,35,0.8,101,2017-01-31,WAS,NYK,2017,103.5
1299,1299,99,@,L 117-121 ,240,45,83,0.542,36,59,0.61,9,24,0.375,18,23,0.783,117,40,89,0.449,31,61,0.508,9,28,0.321,32,44,0.727,121,2017-02-03,MIL,DEN,2017,125.5
1300,1300,0,@,L 117-121 (OT),265,48,100,0.48,40,75,0.533,8,25,0.32,13,18,0.722,117,44,98,0.449,28,55,0.509,16,43,0.372,17,25,0.68,121,2017-02-03,CHI,HOU,2017,129.0
1301,1301,1,Home,W 117-106 ,240,47,93,0.505,39,66,0.591,8,27,0.296,15,18,0.833,117,40,100,0.4,27,56,0.482,13,44,0.295,13,21,0.619,106,2017-02-08,ATL,DEN,2017,112.5
1302,1302,2,Home,L 117-132 ,240,41,82,0.5,28,57,0.491,13,25,0.52,22,26,0.846,117,46,84,0.548,30,48,0.625,16,36,0.444,24,26,0.923,132,2017-02-08,IND,CLE,2017,140.0
1303,1303,3,Home,W 117-109 ,240,39,86,0.453,30,61,0.492,9,25,0.36,30,38,0.789,117,39,85,0.459,32,62,0.516,7,23,0.304,24,28,0.857,109,2017-02-11,PHI,MIA,2017,112.5
1304,1304,4,Home,W 117-89 ,240,44,81,0.543,38,57,0.667,6,24,0.25,23,26,0.885,117,35,84,0.417,25,59,0.424,10,25,0.4,9,13,0.692,89,2017-02-12,MIN,CHI,2017,94.0
1305,1305,5,@,W 117-109 ,240,44,84,0.524,31,49,0.633,13,35,0.371,16,24,0.667,117,36,87,0.414,23,47,0.489,13,40,0.325,24,31,0.774,109,2017-02-15,MIA,HOU,2017,115.5
1306,1306,6,@,W 117-99 ,240,46,93,0.495,31,63,0.492,15,30,0.5,10,16,0.625,117,37,80,0.463,23,43,0.535,14,37,0.378,11,15,0.733,99,2017-02-25,CHI,CLE,2017,106.0
1307,1307,7,@,W 117-108 ,240,41,91,0.451,28,61,0.459,13,30,0.433,22,25,0.88,117,32,88,0.364,22,43,0.512,10,45,0.222,34,42,0.81,108,2017-02-27,IND,HOU,2017,113.0
1308,1308,8,@,W 116-109 (3OT),315,45,102,0.441,37,74,0.5,8,28,0.286,18,23,0.783,116,36,94,0.383,30,72,0.417,6,22,0.273,31,46,0.674,109,2012-01-05,MIA,ATL,2012,112.0
1309,1309,9,Home,W 116-101 ,240,45,82,0.549,34,63,0.54,11,19,0.579,15,22,0.682,116,39,84,0.464,34,72,0.472,5,12,0.417,18,22,0.818,101,2012-01-27,DAL,UTA,2012,103.5
1310,1310,10,Home,L 116-119 ,240,44,80,0.55,35,59,0.593,9,21,0.429,19,23,0.826,116,44,84,0.524,33,58,0.569,11,26,0.423,20,21,0.952,119,2012-02-07,GSW,OKC,2012,124.5
1311,1311,11,@,L 116-119 (OT),265,45,98,0.459,33,71,0.465,12,27,0.444,14,21,0.667,116,40,88,0.455,29,61,0.475,11,27,0.407,28,35,0.8,119,2012-03-05,SAC,DEN,2012,124.5
1312,1312,12,Home,W 116-98 ,240,45,76,0.592,39,64,0.609,6,12,0.5,20,24,0.833,116,29,70,0.414,26,59,0.441,3,11,0.273,37,44,0.841,98,2012-03-07,TOR,HOU,2012,99.5
1313,1313,13,@,W 116-111 (2OT),290,41,83,0.494,35,63,0.556,6,20,0.3,28,34,0.824,116,52,116,0.448,50,97,0.515,2,19,0.105,5,5,1.0,111,2012-03-13,LAL,MEM,2012,112.0
1314,1314,14,@,W 116-87 ,240,48,83,0.578,37,62,0.597,11,21,0.524,9,13,0.692,116,29,82,0.354,22,58,0.379,7,24,0.292,22,26,0.846,87,2012-03-20,MIL,POR,2012,90.5
1315,1315,15,Home,W 116-115 ,240,46,79,0.582,37,62,0.597,9,17,0.529,15,22,0.682,116,40,79,0.506,26,61,0.426,14,18,0.778,21,30,0.7,115,2012-03-21,DEN,DET,2012,122.0
1316,1316,16,Home,W 116-100 ,240,45,95,0.474,38,76,0.5,7,19,0.368,19,25,0.76,116,39,88,0.443,32,66,0.485,7,22,0.318,15,20,0.75,100,2012-03-21,SAS,MIN,2012,103.5
1317,1317,17,Home,W 116-108 ,240,43,85,0.506,36,62,0.581,7,23,0.304,23,28,0.821,116,39,81,0.481,28,60,0.467,11,21,0.524,19,26,0.731,108,2012-04-02,SAC,MIN,2012,113.5
1318,1318,18,@,W 116-96 ,240,43,82,0.524,34,62,0.548,9,20,0.45,21,23,0.913,116,38,81,0.469,35,74,0.473,3,7,0.429,17,24,0.708,96,2012-04-07,ATL,CHA,2012,97.5
1319,1319,19,Home,W 116-94 ,240,47,94,0.5,35,69,0.507,12,25,0.48,10,11,0.909,116,34,78,0.436,28,56,0.5,6,22,0.273,20,23,0.87,94,2012-04-07,MIL,POR,2012,97.0
1320,1320,20,Home,W 116-77 ,240,45,75,0.6,37,57,0.649,8,18,0.444,18,20,0.9,116,27,78,0.346,20,57,0.351,7,21,0.333,16,21,0.762,77,2012-04-17,DET,CLE,2012,80.5
1321,1321,21,Home,W 116-84 ,240,42,85,0.494,34,57,0.596,8,28,0.286,24,29,0.828,116,32,92,0.348,25,67,0.373,7,25,0.28,13,19,0.684,84,2012-04-18,ATL,DET,2012,87.5
1322,1322,22,Home,W 116-106 ,240,42,83,0.506,33,63,0.524,9,20,0.45,23,28,0.821,116,36,72,0.5,28,54,0.519,8,18,0.444,26,32,0.813,106,2012-10-31,POR,LAL,2013,110.0
1323,1323,23,@,L 116-119 ,240,49,95,0.516,44,74,0.595,5,21,0.238,13,20,0.65,116,43,83,0.518,33,58,0.569,10,25,0.4,23,27,0.852,119,2012-11-03,DEN,MIA,2013,124.0
1324,1324,24,@,W 116-109 (OT),265,39,88,0.443,33,67,0.493,6,21,0.286,32,37,0.865,116,45,91,0.495,38,71,0.535,7,20,0.35,12,17,0.706,109,2012-11-24,OKC,PHI,2013,112.5
1325,1325,25,@,W 116-110 (OT),265,47,105,0.448,40,87,0.46,7,18,0.389,15,19,0.789,116,41,90,0.456,30,64,0.469,11,26,0.423,17,19,0.895,110,2012-11-25,BOS,ORL,2013,115.5
1326,1326,26,@,L 116-124 ,240,48,94,0.511,37,74,0.5,11,20,0.55,9,11,0.818,116,46,83,0.554,35,61,0.574,11,22,0.5,21,26,0.808,124,2012-12-01,UTA,HOU,2013,129.5
1327,1327,27,Home,W 116-81 ,240,47,86,0.547,35,62,0.565,12,24,0.5,10,16,0.625,116,29,76,0.382,20,53,0.377,9,23,0.391,14,18,0.778,81,2012-12-01,LAC,SAC,2013,85.5
1328,1328,28,@,W 116-109 ,240,43,91,0.473,33,67,0.493,10,24,0.417,20,25,0.8,116,35,72,0.486,23,37,0.622,12,35,0.343,27,38,0.711,109,2012-12-08,DAL,HOU,2013,115.0
1329,1329,29,Home,W 116-107 ,240,42,79,0.532,30,54,0.556,12,25,0.48,20,30,0.667,116,35,84,0.417,23,47,0.489,12,37,0.324,25,29,0.862,107,2012-12-13,NYK,LAL,2013,113.0
1330,1330,30,@,L 116-122 ,240,45,86,0.523,34,54,0.63,11,32,0.344,15,26,0.577,116,44,77,0.571,32,54,0.593,12,23,0.522,22,24,0.917,122,2012-12-28,HOU,SAS,2013,128.0
1331,1331,31,@,W 116-114 ,240,38,77,0.494,31,54,0.574,7,23,0.304,33,41,0.805,116,34,71,0.479,25,56,0.446,9,15,0.6,37,40,0.925,114,2012-12-28,LAC,UTA,2013,118.5
1332,1332,32,@,W 116-101 ,240,44,87,0.506,35,58,0.603,9,29,0.31,19,28,0.679,116,39,98,0.398,33,70,0.471,6,28,0.214,17,22,0.773,101,2013-01-11,OKC,LAL,2013,104.0
1333,1333,33,Home,W 116-105 ,240,43,90,0.478,34,63,0.54,9,27,0.333,21,27,0.778,116,43,83,0.518,30,59,0.508,13,24,0.542,6,8,0.75,105,2013-01-13,DEN,GSW,2013,111.5
1334,1334,34,@,W 116-112 ,240,38,77,0.494,28,55,0.509,10,22,0.455,30,35,0.857,116,45,79,0.57,36,55,0.655,9,24,0.375,13,23,0.565,112,2013-01-19,GSW,NOH,2013,116.5
1335,1335,35,@,L 116-123 (OT),265,44,88,0.5,30,57,0.526,14,31,0.452,14,18,0.778,116,45,82,0.549,36,60,0.6,9,22,0.409,24,38,0.632,123,2013-01-23,TOR,MIA,2013,127.5
1336,1336,36,Home,W 116-95 ,240,46,87,0.529,41,76,0.539,5,11,0.455,19,25,0.76,116,36,87,0.414,31,64,0.484,5,23,0.217,18,30,0.6,95,2013-02-07,BOS,LAL,2013,97.5
1337,1337,37,Home,W 116-91 ,240,38,77,0.494,27,57,0.474,11,20,0.55,29,38,0.763,116,34,89,0.382,28,73,0.384,6,16,0.375,17,24,0.708,91,2013-02-09,DAL,GSW,2013,94.0
1338,1338,38,@,W 116-107 ,240,43,91,0.473,33,57,0.579,10,34,0.294,20,25,0.8,116,38,84,0.452,30,64,0.469,8,20,0.4,23,31,0.742,107,2013-02-12,HOU,GSW,2013,111.0
1339,1339,39,@,W 116-90 ,240,43,73,0.589,35,56,0.625,8,17,0.471,22,28,0.786,116,32,76,0.421,27,60,0.45,5,16,0.313,21,25,0.84,90,2013-02-21,SAS,LAC,2013,92.5
1340,1340,40,Home,W 116-94 ,240,44,83,0.53,28,51,0.549,16,32,0.5,12,21,0.571,116,37,81,0.457,30,60,0.5,7,21,0.333,13,15,0.867,94,2013-02-28,LAL,MIN,2013,97.5
1341,1341,41,@,W 116-94 ,240,46,81,0.568,34,57,0.596,12,24,0.5,12,16,0.75,116,35,85,0.412,28,62,0.452,7,23,0.304,17,25,0.68,94,2013-03-08,OKC,CHA,2013,97.5
1342,1342,42,@,L 116-118 (OT),265,48,93,0.516,40,71,0.563,8,22,0.364,12,16,0.75,116,39,91,0.429,25,52,0.481,14,39,0.359,26,36,0.722,118,2013-03-08,TOR,LAL,2013,125.0
1343,1343,43,Home,W 116-101 ,240,37,73,0.507,23,45,0.511,14,28,0.5,28,34,0.824,116,36,80,0.45,27,54,0.5,9,26,0.346,20,26,0.769,101,2013-03-19,SAC,LAC,2013,105.5
1344,1344,44,Home,W 116-78 ,240,44,77,0.571,34,48,0.708,10,29,0.345,18,27,0.667,116,31,86,0.36,27,66,0.409,4,20,0.2,12,15,0.8,78,2013-03-22,HOU,CLE,2013,80.0
1345,1345,45,Home,W 116-107 ,240,45,81,0.556,35,64,0.547,10,17,0.588,16,24,0.667,116,42,81,0.519,34,58,0.586,8,23,0.348,15,19,0.789,107,2013-03-30,UTA,BRK,2013,111.0
1346,1346,46,@,W 116-98 ,240,39,76,0.513,27,48,0.563,12,28,0.429,26,35,0.743,116,38,91,0.418,36,71,0.507,2,20,0.1,20,24,0.833,98,2013-04-05,HOU,POR,2013,99.0
1347,1347,47,@,W 116-97 ,240,42,83,0.506,30,56,0.536,12,27,0.444,20,23,0.87,116,37,84,0.44,30,68,0.441,7,16,0.438,16,26,0.615,97,2013-04-11,OKC,GSW,2013,100.5
1348,1348,48,@,L 116-118 ,240,46,97,0.474,35,71,0.493,11,26,0.423,13,16,0.813,116,34,66,0.515,22,41,0.537,12,25,0.48,38,50,0.76,118,2013-04-12,GSW,LAL,2013,124.0
1349,1349,49,Home,W 116-106 ,240,46,85,0.541,37,65,0.569,9,20,0.45,15,18,0.833,116,45,98,0.459,37,74,0.5,8,24,0.333,8,13,0.615,106,2013-04-15,GSW,SAS,2013,110.0
1350,1350,50,Home,W 116-103 ,240,42,93,0.452,28,64,0.438,14,29,0.483,18,28,0.643,116,41,83,0.494,33,62,0.532,8,21,0.381,13,23,0.565,103,2013-10-29,LAL,LAC,2014,107.0
1351,1351,51,@,W 116-101 ,240,41,75,0.547,35,53,0.66,6,22,0.273,28,34,0.824,116,36,87,0.414,26,56,0.464,10,31,0.323,19,29,0.655,101,2013-11-05,HOU,POR,2014,106.0
1352,1352,52,@,W 116-102 ,240,43,98,0.439,25,65,0.385,18,33,0.545,12,16,0.75,116,39,83,0.47,33,65,0.508,6,18,0.333,18,26,0.692,102,2013-11-06,WAS,PHI,2014,105.0
1353,1353,53,Home,W 116-108 ,240,41,89,0.461,33,69,0.478,8,20,0.4,26,30,0.867,116,44,90,0.489,34,68,0.5,10,22,0.455,10,15,0.667,108,2013-11-08,MIN,DAL,2014,113.0
1354,1354,54,Home,W 116-95 ,240,44,79,0.557,33,59,0.559,11,20,0.55,17,21,0.81,116,34,84,0.405,31,74,0.419,3,10,0.3,24,33,0.727,95,2013-11-12,LAL,NOP,2014,96.5
1355,1355,55,Home,W 116-115 ,240,45,94,0.479,31,71,0.437,14,23,0.609,12,14,0.857,116,41,80,0.513,32,58,0.552,9,22,0.409,24,28,0.857,115,2013-11-14,GSW,OKC,2014,119.5
1356,1356,56,Home,W 116-111 ,240,46,87,0.529,40,66,0.606,6,21,0.286,18,22,0.818,116,44,83,0.53,31,55,0.564,13,28,0.464,10,13,0.769,111,2013-11-26,WAS,LAL,2014,117.5
1357,1357,57,@,W 116-103 ,240,45,82,0.549,32,59,0.542,13,23,0.565,13,16,0.813,116,38,83,0.458,28,60,0.467,10,23,0.435,17,19,0.895,103,2013-12-10,SAS,TOR,2014,108.0
1358,1358,58,@,W 116-100 ,240,40,71,0.563,31,53,0.585,9,18,0.5,27,33,0.818,116,34,81,0.42,28,66,0.424,6,15,0.4,26,34,0.765,100,2013-12-11,OKC,MEM,2014,103.0
1359,1359,59,@,W 116-112 ,240,39,79,0.494,27,50,0.54,12,29,0.414,26,35,0.743,116,43,90,0.478,37,68,0.544,6,22,0.273,20,24,0.833,112,2013-12-13,HOU,GSW,2014,115.0
1360,1360,60,Home,W 116-107 ,240,41,83,0.494,29,59,0.492,12,24,0.5,22,29,0.759,116,38,87,0.437,32,68,0.471,6,19,0.316,25,29,0.862,107,2013-12-13,PHO,SAC,2014,110.0
1361,1361,61,Home,L 116-119 ,240,48,102,0.471,39,85,0.459,9,17,0.529,11,16,0.688,116,41,92,0.446,26,59,0.441,15,33,0.455,22,25,0.88,119,2013-12-17,CLE,POR,2014,126.5
1362,1362,62,@,W 116-106 ,240,44,84,0.524,41,74,0.554,3,10,0.3,25,28,0.893,116,42,90,0.467,30,67,0.448,12,23,0.522,10,17,0.588,106,2013-12-20,CHA,DET,2014,112.0
1363,1363,63,Home,W 116-106 ,240,43,82,0.524,36,57,0.632,7,25,0.28,23,25,0.92,116,38,93,0.409,28,70,0.4,10,23,0.435,20,22,0.909,106,2013-12-21,MIL,PHI,2014,111.0
1364,1364,64,@,L 116-120 (OT),265,45,96,0.469,39,74,0.527,6,22,0.273,20,27,0.741,116,46,97,0.474,39,68,0.574,7,29,0.241,21,27,0.778,120,2013-12-22,MIN,LAC,2014,123.5
1365,1365,65,@,W 116-107 ,240,37,75,0.493,30,59,0.508,7,16,0.438,35,42,0.833,116,39,85,0.459,34,68,0.5,5,17,0.294,24,31,0.774,107,2013-12-26,SAS,DAL,2014,109.5
1366,1366,66,Home,W 116-112 (OT),265,42,96,0.438,29,60,0.483,13,36,0.361,19,22,0.864,116,49,110,0.445,41,90,0.456,8,20,0.4,6,12,0.5,112,2013-12-26,POR,LAC,2014,116.0
1367,1367,67,@,L 116-118 (OT),265,45,104,0.433,35,78,0.449,10,26,0.385,16,22,0.727,116,37,91,0.407,21,52,0.404,16,39,0.41,28,34,0.824,118,2013-12-28,CHA,ATL,2014,126.0
1368,1368,68,Home,W 116-100 ,240,41,85,0.482,29,58,0.5,12,27,0.444,22,25,0.88,116,37,68,0.544,27,47,0.574,10,21,0.476,16,20,0.8,100,2014-01-04,PHO,MIL,2014,105.0
1369,1369,69,Home,W 116-92 ,240,50,90,0.556,46,72,0.639,4,18,0.222,12,16,0.75,116,37,79,0.468,34,64,0.531,3,15,0.2,15,21,0.714,92,2014-01-04,SAS,LAC,2014,93.5
1370,1370,70,Home,W 116-94 ,240,40,79,0.506,28,56,0.5,12,23,0.522,24,30,0.8,116,35,83,0.422,26,64,0.406,9,19,0.474,15,22,0.682,94,2014-01-13,TOR,MIL,2014,98.5
1371,1371,71,Home,W 116-92 ,240,45,82,0.549,39,66,0.591,6,16,0.375,20,25,0.8,116,39,92,0.424,35,79,0.443,4,13,0.308,10,17,0.588,92,2014-01-14,IND,SAC,2014,94.0
1372,1372,72,Home,L 116-123 ,240,39,90,0.433,30,62,0.484,9,28,0.321,29,33,0.879,116,45,83,0.542,33,59,0.559,12,24,0.5,21,29,0.724,123,2014-01-15,GSW,DEN,2014,129.0
1373,1373,73,@,W 116-111 (OT),265,41,95,0.432,33,71,0.465,8,24,0.333,26,33,0.788,116,39,101,0.386,27,69,0.391,12,32,0.375,21,29,0.724,111,2014-01-24,IND,SAC,2014,117.0
1374,1374,74,Home,W 116-106 ,240,43,74,0.581,36,53,0.679,7,21,0.333,23,28,0.821,116,43,91,0.473,39,78,0.5,4,13,0.308,16,28,0.571,106,2014-01-26,DAL,DET,2014,108.0
1375,1375,75,Home,W 116-115 ,240,40,83,0.482,35,65,0.538,5,18,0.278,31,44,0.705,116,42,84,0.5,36,63,0.571,6,21,0.286,25,34,0.735,115,2014-02-03,DEN,LAC,2014,118.0
1376,1376,76,@,W 116-112 ,240,41,78,0.526,28,47,0.596,13,31,0.419,21,26,0.808,116,37,86,0.43,30,61,0.492,7,25,0.28,31,42,0.738,112,2014-02-05,MIA,LAC,2014,115.5
1377,1377,77,Home,W 116-98 ,240,42,82,0.512,34,62,0.548,8,20,0.4,24,31,0.774,116,38,90,0.422,30,72,0.417,8,18,0.444,14,20,0.7,98,2014-02-19,CHA,DET,2014,102.0
1378,1378,78,Home,W 116-104 ,240,40,74,0.541,30,51,0.588,10,23,0.435,26,32,0.813,116,42,78,0.538,37,65,0.569,5,13,0.385,15,17,0.882,104,2014-02-28,PHO,NOP,2014,106.5
1379,1379,79,Home,W 116-99 ,240,41,82,0.5,33,60,0.55,8,22,0.364,26,30,0.867,116,30,68,0.441,22,46,0.478,8,22,0.364,31,40,0.775,99,2014-03-02,OKC,CHA,2014,103.0
1380,1380,80,@,W 116-102 ,240,43,83,0.518,39,69,0.565,4,14,0.286,26,32,0.813,116,36,82,0.439,30,65,0.462,6,17,0.353,24,29,0.828,102,2014-03-05,SAC,MIL,2014,105.0
1381,1381,81,@,W 116-92 ,240,42,80,0.525,31,61,0.508,11,19,0.579,21,24,0.875,116,34,81,0.42,26,62,0.419,8,19,0.421,16,23,0.696,92,2014-03-12,NYK,BOS,2014,96.0
1382,1382,82,Home,W 116-103 ,240,41,81,0.506,27,46,0.587,14,35,0.4,20,25,0.8,116,38,90,0.422,26,63,0.413,12,27,0.444,15,17,0.882,103,2014-03-20,POR,WAS,2014,109.0
1383,1383,83,Home,W 116-111 (OT),265,46,92,0.5,38,71,0.535,8,21,0.381,16,23,0.696,116,40,83,0.482,23,46,0.5,17,37,0.459,14,16,0.875,111,2014-03-26,CHA,BRK,2014,119.5
1384,1384,84,Home,W 116-96 ,240,41,74,0.554,30,56,0.536,11,18,0.611,23,26,0.885,116,36,86,0.419,30,65,0.462,6,21,0.286,18,24,0.75,96,2014-03-30,OKC,UTA,2014,99.0
1385,1385,85,Home,W 116-111 ,240,46,97,0.474,37,74,0.5,9,23,0.391,15,21,0.714,116,39,88,0.443,34,71,0.479,5,17,0.294,28,36,0.778,111,2014-03-31,DET,MIL,2014,113.5
1386,1386,86,Home,W 116-104 ,240,46,76,0.605,31,45,0.689,15,31,0.484,9,11,0.818,116,41,88,0.466,32,61,0.525,9,27,0.333,13,21,0.619,104,2014-04-04,BRK,DET,2014,108.5
1387,1387,87,@,L 116-123 ,240,40,92,0.435,25,52,0.481,15,40,0.375,21,25,0.84,116,50,101,0.495,39,73,0.534,11,28,0.393,12,14,0.857,123,2014-04-09,HOU,DEN,2014,128.5
1388,1388,88,@,L 116-119 ,240,42,85,0.494,38,65,0.585,4,20,0.2,28,35,0.8,116,44,84,0.524,38,68,0.559,6,16,0.375,25,38,0.658,119,2014-04-11,CLE,MIL,2014,122.0
1389,1389,89,Home,W 116-94 ,240,44,82,0.537,39,69,0.565,5,13,0.385,23,27,0.852,116,35,86,0.407,26,68,0.382,9,18,0.5,15,19,0.789,94,2014-04-11,OKC,NOP,2014,98.5
1390,1390,90,@,W 116-107 ,240,39,81,0.481,30,58,0.517,9,23,0.391,29,35,0.829,116,35,84,0.417,30,64,0.469,5,20,0.25,32,48,0.667,107,2014-04-13,TOR,DET,2014,109.5
1391,1391,91,@,W 116-112 ,240,44,90,0.489,36,67,0.537,8,23,0.348,20,35,0.571,116,37,84,0.44,28,50,0.56,9,34,0.265,29,35,0.829,112,2014-04-16,GSW,DEN,2014,116.5
1392,1392,92,Home,W 116-85 ,240,44,84,0.524,33,61,0.541,11,23,0.478,17,19,0.895,116,32,82,0.39,24,59,0.407,8,23,0.348,13,21,0.619,85,2014-11-03,BRK,OKC,2015,89.0
1393,1393,93,Home,W 116-100 ,240,45,100,0.45,29,69,0.42,16,31,0.516,10,14,0.714,116,36,91,0.396,31,78,0.397,5,13,0.385,23,30,0.767,100,2014-11-09,POR,DEN,2015,102.5
1394,1394,94,Home,W 116-99 ,240,43,86,0.5,31,61,0.508,12,25,0.48,18,26,0.692,116,41,85,0.482,37,72,0.514,4,13,0.308,13,17,0.765,99,2014-12-02,PHO,IND,2015,101.0
1395,1395,95,Home,L 116-117 (3OT),315,43,105,0.41,26,70,0.371,17,35,0.486,13,27,0.481,116,48,107,0.449,38,80,0.475,10,27,0.37,11,14,0.786,117,2014-12-17,SAS,MEM,2015,122.0
1396,1396,96,@,W 116-102 ,240,43,88,0.489,33,65,0.508,10,23,0.435,20,32,0.625,116,37,87,0.425,33,70,0.471,4,17,0.235,24,34,0.706,102,2014-12-28,TOR,DEN,2015,104.0
1397,1397,97,@,W 116-107 ,240,44,87,0.506,35,65,0.538,9,22,0.409,19,24,0.792,116,42,81,0.519,30,61,0.492,12,20,0.6,11,20,0.55,107,2014-12-28,PHO,LAL,2015,113.0
1398,1398,98,@,W 116-105 ,240,46,91,0.505,33,66,0.5,13,25,0.52,11,13,0.846,116,39,81,0.481,32,60,0.533,7,21,0.333,20,24,0.833,105,2015-01-13,GSW,UTA,2015,108.5
1399,1399,99,Home,L 116-120 (OT),265,37,79,0.468,27,55,0.491,10,24,0.417,32,41,0.78,116,44,88,0.5,33,62,0.532,11,26,0.423,21,30,0.7,120,2015-01-31,WAS,TOR,2015,125.5
1400,1400,0,@,L 116-124 ,240,47,103,0.456,35,70,0.5,12,33,0.364,10,15,0.667,116,38,77,0.494,23,50,0.46,15,27,0.556,33,37,0.892,124,2015-02-06,GSW,ATL,2015,131.5
1401,1401,1,@,W 116-113 ,240,40,83,0.482,29,63,0.46,11,20,0.55,25,30,0.833,116,40,89,0.449,32,65,0.492,8,24,0.333,25,28,0.893,113,2015-02-06,NOP,OKC,2015,117.0
1402,1402,2,Home,W 116-105 ,240,44,90,0.489,35,68,0.515,9,22,0.409,19,24,0.792,116,37,73,0.507,32,58,0.552,5,15,0.333,26,29,0.897,105,2015-03-08,SAS,CHI,2015,107.5
1403,1403,3,@,W 116-105 ,240,45,88,0.511,28,51,0.549,17,37,0.459,9,13,0.692,116,38,79,0.481,35,62,0.565,3,17,0.176,26,32,0.813,105,2015-03-18,LAC,SAC,2015,106.5
1404,1404,4,@,W 116-103 ,240,45,74,0.608,33,51,0.647,12,23,0.522,14,17,0.824,116,39,83,0.47,30,62,0.484,9,21,0.429,16,19,0.842,103,2015-03-25,CHI,TOR,2015,107.5
1405,1405,5,@,W 116-104 ,240,45,89,0.506,36,63,0.571,9,26,0.346,17,23,0.739,116,40,85,0.471,33,59,0.559,7,26,0.269,17,19,0.895,104,2015-03-30,BOS,CHO,2015,107.5
1406,1406,6,Home,L 116-117 (OT),265,40,83,0.482,34,60,0.567,6,23,0.261,30,38,0.789,116,47,97,0.485,39,71,0.549,8,26,0.308,15,22,0.682,117,2015-04-04,TOR,BOS,2015,121.0
1407,1407,7,Home,W 116-111 ,240,42,80,0.525,33,56,0.589,9,24,0.375,23,34,0.676,116,45,93,0.484,39,74,0.527,6,19,0.316,15,21,0.714,111,2015-04-07,SAC,MIN,2015,114.0
1408,1408,8,Home,W 116-91 ,240,42,85,0.494,30,52,0.577,12,33,0.364,20,23,0.87,116,32,85,0.376,29,74,0.392,3,11,0.273,24,29,0.828,91,2015-04-08,POR,MIN,2015,92.5
1409,1409,9,Home,W 116-105 ,240,48,90,0.533,36,64,0.563,12,26,0.462,8,9,0.889,116,46,98,0.469,39,74,0.527,7,24,0.292,6,8,0.75,105,2015-04-09,GSW,POR,2015,108.5
1410,1410,10,Home,W 116-103 ,240,44,97,0.454,34,66,0.515,10,31,0.323,18,24,0.75,116,37,81,0.457,28,57,0.491,9,24,0.375,20,28,0.714,103,2015-04-10,OKC,SAC,2015,107.5
1411,1411,11,Home,W 116-77 ,240,41,81,0.506,25,53,0.472,16,28,0.571,18,23,0.783,116,27,79,0.342,23,64,0.359,4,15,0.267,19,29,0.655,77,2015-04-12,DET,CHO,2015,79.0
1412,1412,12,Home,W 116-104 ,240,42,79,0.532,32,59,0.542,10,20,0.5,22,35,0.629,116,41,95,0.432,30,67,0.448,11,28,0.393,11,28,0.393,104,2015-04-12,IND,OKC,2015,109.5
1413,1413,13,@,W 116-110 ,240,40,82,0.488,25,46,0.543,15,36,0.417,21,27,0.778,116,40,93,0.43,31,65,0.477,9,28,0.321,21,29,0.724,110,2015-11-06,HOU,SAC,2016,114.5
1414,1414,14,Home,L 116-129 ,240,43,87,0.494,40,78,0.513,3,9,0.333,27,36,0.75,116,48,89,0.539,30,51,0.588,18,38,0.474,15,16,0.938,129,2015-11-12,MIN,GSW,2016,138.0
1415,1415,15,Home,W 116-111 ,240,39,80,0.488,28,55,0.509,11,25,0.44,27,36,0.75,116,44,91,0.484,39,76,0.513,5,15,0.333,18,22,0.818,111,2015-11-18,CHA,BRK,2016,113.5
1416,1416,16,Home,W 116-109 ,240,42,89,0.472,35,65,0.538,7,24,0.292,25,33,0.758,116,43,84,0.512,31,61,0.508,12,23,0.522,11,20,0.55,109,2015-11-19,MIA,SAC,2016,115.0
1417,1417,17,@,L 116-122 ,240,35,90,0.389,18,54,0.333,17,36,0.472,29,33,0.879,116,39,85,0.459,28,55,0.509,11,30,0.367,33,40,0.825,122,2015-11-22,PHO,NOP,2016,127.5
1418,1418,18,Home,W 116-114 ,240,38,73,0.521,27,53,0.509,11,20,0.55,29,37,0.784,116,40,83,0.482,24,48,0.5,16,35,0.457,18,26,0.692,114,2015-11-27,HOU,PHI,2016,122.0
1419,1419,19,@,W 116-101 ,240,35,75,0.467,21,36,0.583,14,39,0.359,32,36,0.889,116,35,80,0.438,23,50,0.46,12,30,0.4,19,21,0.905,101,2015-11-27,ATL,MEM,2016,107.0
1420,1420,20,Home,L 116-135 ,240,45,92,0.489,35,66,0.53,10,26,0.385,16,23,0.696,116,46,81,0.568,24,43,0.558,22,38,0.579,21,31,0.677,135,2015-11-27,PHO,GSW,2016,146.0
1421,1421,21,@,W 116-111 (OT),265,43,95,0.453,36,70,0.514,7,25,0.28,23,36,0.639,116,45,78,0.577,39,60,0.65,6,18,0.333,15,17,0.882,111,2015-11-29,HOU,NYK,2016,114.0
1422,1422,22,Home,W 116-105 ,240,45,85,0.529,37,62,0.597,8,23,0.348,18,37,0.486,116,35,88,0.398,24,61,0.393,11,27,0.407,24,28,0.857,105,2015-11-30,DET,HOU,2016,110.5
1423,1423,23,@,W 116-99 ,240,46,88,0.523,30,54,0.556,16,34,0.471,8,11,0.727,116,35,94,0.372,26,63,0.413,9,31,0.29,20,30,0.667,99,2015-12-02,GSW,CHO,2016,103.5
1424,1424,24,@,W 116-104 ,240,38,76,0.5,22,45,0.489,16,31,0.516,24,27,0.889,116,42,89,0.472,34,62,0.548,8,27,0.296,12,21,0.571,104,2015-12-06,DAL,WAS,2016,108.0
1425,1425,25,@,L 116-119 ,240,43,89,0.483,33,64,0.516,10,25,0.4,20,24,0.833,116,38,78,0.487,27,57,0.474,11,21,0.524,32,43,0.744,119,2015-12-16,BOS,DET,2016,124.5
1426,1426,26,Home,W 116-109 ,240,43,75,0.573,31,52,0.596,12,23,0.522,18,26,0.692,116,39,80,0.488,26,46,0.565,13,34,0.382,18,22,0.818,109,2015-12-20,MIA,POR,2016,115.5
1427,1427,27,Home,L 116-120 ,240,41,82,0.5,28,52,0.538,13,30,0.433,21,26,0.808,116,45,77,0.584,39,63,0.619,6,14,0.429,24,35,0.686,120,2015-12-31,IND,MIL,2016,123.0
1428,1428,28,@,W 116-104 ,240,40,89,0.449,33,72,0.458,7,17,0.412,29,39,0.744,116,39,89,0.438,29,60,0.483,10,29,0.345,16,23,0.696,104,2016-01-04,SAC,OKC,2016,109.0
1429,1429,29,@,L 116-117 (2OT),290,47,99,0.475,35,67,0.522,12,32,0.375,10,14,0.714,116,45,98,0.459,33,69,0.478,12,29,0.414,15,23,0.652,117,2016-01-05,SAC,DAL,2016,123.0
1430,1430,30,Home,L 116-128 ,240,43,92,0.467,35,69,0.507,8,23,0.348,22,29,0.759,116,49,87,0.563,30,50,0.6,19,37,0.514,11,15,0.733,128,2016-01-09,SAC,GSW,2016,137.5
1431,1431,31,Home,W 116-97 ,240,41,79,0.519,31,55,0.564,10,24,0.417,24,31,0.774,116,36,89,0.404,28,64,0.438,8,25,0.32,17,27,0.63,97,2016-01-12,IND,PHO,2016,101.0
1432,1432,32,Home,W 116-98 ,240,43,86,0.5,30,53,0.566,13,33,0.394,17,20,0.85,116,40,90,0.444,36,67,0.537,4,23,0.174,14,24,0.583,98,2016-01-14,GSW,LAL,2016,100.0
1433,1433,33,@,W 116-104 ,240,47,93,0.505,32,58,0.552,15,35,0.429,7,11,0.636,116,38,85,0.447,30,66,0.455,8,19,0.421,20,28,0.714,104,2016-01-15,POR,BRK,2016,108.0
1434,1434,34,@,W 116-88 ,240,43,76,0.566,30,53,0.566,13,23,0.565,17,24,0.708,116,33,85,0.388,29,67,0.433,4,18,0.222,18,20,0.9,88,2016-01-22,LAC,NYK,2016,90.0
1435,1435,35,Home,L 116-120 (OT),265,45,91,0.495,34,68,0.5,11,23,0.478,15,19,0.789,116,45,101,0.446,35,74,0.473,10,27,0.37,20,22,0.909,120,2016-01-22,ORL,CHO,2016,125.0
1436,1436,36,Home,W 116-99 ,240,43,94,0.457,26,63,0.413,17,31,0.548,13,17,0.765,116,39,74,0.527,33,59,0.559,6,15,0.4,15,18,0.833,99,2016-01-23,NOP,MIL,2016,102.0
1437,1437,37,Home,W 116-106 ,240,45,94,0.479,37,77,0.481,8,17,0.471,18,25,0.72,116,43,93,0.462,35,67,0.522,8,26,0.308,12,19,0.632,106,2016-01-24,BRK,OKC,2016,110.0
1438,1438,38,@,W 116-91 ,240,44,90,0.489,35,68,0.515,9,22,0.409,19,23,0.826,116,32,75,0.427,25,51,0.49,7,24,0.292,20,30,0.667,91,2016-01-25,BOS,WAS,2016,94.5
1439,1439,39,Home,W 116-108 ,240,41,86,0.477,33,67,0.493,8,19,0.421,26,30,0.867,116,36,95,0.379,27,56,0.482,9,39,0.231,27,43,0.628,108,2016-01-29,OKC,HOU,2016,112.5
1440,1440,40,@,W 116-95 ,240,42,73,0.575,26,44,0.591,16,29,0.552,16,23,0.696,116,33,90,0.367,27,72,0.375,6,18,0.333,23,26,0.885,95,2016-01-31,GSW,NYK,2016,98.0
1441,1441,41,@,W 116-90 ,240,41,80,0.513,29,58,0.5,12,22,0.545,22,25,0.88,116,33,73,0.452,30,58,0.517,3,15,0.2,21,27,0.778,90,2016-02-05,SAS,DAL,2016,91.5
1442,1442,42,Home,W 116-108 ,240,48,97,0.495,41,71,0.577,7,26,0.269,13,20,0.65,116,36,85,0.424,29,63,0.46,7,22,0.318,29,37,0.784,108,2016-02-06,GSW,OKC,2016,111.5
1443,1443,43,@,W 116-102 ,240,47,97,0.485,37,73,0.507,10,24,0.417,12,20,0.6,116,36,81,0.444,34,69,0.493,2,12,0.167,28,35,0.8,102,2016-02-08,NOP,MIN,2016,103.0
1444,1444,44,Home,W 116-103 ,240,41,89,0.461,33,61,0.541,8,28,0.286,26,34,0.765,116,37,77,0.481,26,43,0.605,11,34,0.324,18,34,0.529,103,2016-02-10,POR,HOU,2016,108.5
1445,1445,45,Home,W 116-106 ,240,48,93,0.516,41,77,0.532,7,16,0.438,13,20,0.65,116,38,88,0.432,33,70,0.471,5,18,0.278,25,34,0.735,106,2016-02-19,CHI,TOR,2016,108.5
1446,1446,46,@,W 116-100 ,240,37,78,0.474,30,54,0.556,7,24,0.292,35,56,0.625,116,30,82,0.366,19,47,0.404,11,35,0.314,29,35,0.829,100,2016-02-19,HOU,PHO,2016,105.5
1447,1447,47,Home,W 116-110 ,240,41,83,0.494,31,62,0.5,10,21,0.476,24,31,0.774,116,42,90,0.467,34,66,0.515,8,24,0.333,18,26,0.692,110,2016-02-19,SAC,DEN,2016,114.0
1448,1448,48,@,W 116-103 ,240,43,89,0.483,31,56,0.554,12,33,0.364,18,22,0.818,116,35,86,0.407,26,58,0.448,9,28,0.321,24,30,0.8,103,2016-02-24,OKC,DAL,2016,107.5
1449,1449,49,@,W 116-106 ,240,37,75,0.493,29,57,0.509,8,18,0.444,34,42,0.81,116,42,98,0.429,33,71,0.465,9,27,0.333,13,23,0.565,106,2016-02-25,BRK,PHO,2016,110.5
1450,1450,50,@,L 116-122 (OT),265,43,93,0.462,34,64,0.531,9,29,0.31,21,31,0.677,116,45,88,0.511,34,59,0.576,11,29,0.379,21,27,0.778,122,2016-02-26,DEN,DAL,2016,127.5
1451,1451,51,@,L 116-130 ,240,41,77,0.532,36,55,0.655,5,22,0.227,29,37,0.784,116,49,86,0.57,39,70,0.557,10,16,0.625,22,25,0.88,130,2016-02-28,PHI,ORL,2016,135.0
1452,1452,52,Home,L 116-131 ,240,48,107,0.449,41,82,0.5,7,25,0.28,13,19,0.684,116,47,82,0.573,33,48,0.688,14,34,0.412,23,26,0.885,131,2016-02-29,SAC,OKC,2016,138.0
1453,1453,53,Home,W 116-108 ,240,43,89,0.483,37,69,0.536,6,20,0.3,24,31,0.774,116,43,89,0.483,33,57,0.579,10,32,0.313,12,21,0.571,108,2016-02-29,WAS,PHI,2016,113.0
1454,1454,54,Home,W 116-93 ,240,43,107,0.402,36,81,0.444,7,26,0.269,23,24,0.958,116,34,84,0.405,23,55,0.418,11,29,0.379,14,20,0.7,93,2016-03-02,BOS,POR,2016,98.5
1455,1455,55,Home,W 116-101 ,240,43,83,0.518,29,59,0.492,14,24,0.583,16,20,0.8,116,42,87,0.483,35,65,0.538,7,22,0.318,10,14,0.714,101,2016-03-04,MIL,MIN,2016,104.5
1456,1456,56,Home,W 116-114 (OT),265,44,107,0.411,35,81,0.432,9,26,0.346,19,25,0.76,116,41,93,0.441,25,52,0.481,16,41,0.39,16,20,0.8,114,2016-03-06,DEN,DAL,2016,122.0
1457,1457,57,@,W 116-91 ,240,47,85,0.553,43,66,0.652,4,19,0.211,18,19,0.947,116,36,79,0.456,32,64,0.5,4,15,0.267,15,19,0.789,91,2016-03-08,SAS,MIN,2016,93.0
1458,1458,58,Home,W 116-109 (OT),265,41,89,0.461,31,65,0.477,10,24,0.417,24,31,0.774,116,45,99,0.455,37,79,0.468,8,20,0.4,11,23,0.478,109,2016-03-08,POR,WAS,2016,113.0
1459,1459,59,Home,W 116-96 ,240,41,87,0.471,26,55,0.473,15,32,0.469,19,24,0.792,116,32,84,0.381,25,58,0.431,7,26,0.269,25,31,0.806,96,2016-03-09,BOS,MEM,2016,99.5
1460,1460,60,Home,W 116-98 ,240,44,91,0.484,31,63,0.492,13,28,0.464,15,19,0.789,116,33,89,0.371,27,61,0.443,6,28,0.214,26,33,0.788,98,2016-03-10,DEN,PHO,2016,101.0
1461,1461,61,Home,W 116-100 ,240,42,80,0.525,34,56,0.607,8,24,0.333,24,29,0.828,116,36,86,0.419,29,65,0.446,7,21,0.333,21,29,0.724,100,2016-03-12,DEN,WAS,2016,103.5
1462,1462,62,@,L 116-123 ,240,45,92,0.489,34,63,0.54,11,29,0.379,15,20,0.75,116,42,84,0.5,31,51,0.608,11,33,0.333,28,33,0.848,123,2016-03-12,PHO,GSW,2016,128.5
1463,1463,63,Home,W 116-110 ,240,44,81,0.543,36,56,0.643,8,25,0.32,20,25,0.8,116,40,80,0.5,31,56,0.554,9,24,0.375,21,24,0.875,110,2016-03-15,ORL,DEN,2016,114.5
1464,1464,64,Home,W 116-98 ,240,40,80,0.5,28,54,0.519,12,26,0.462,24,28,0.857,116,39,87,0.448,33,65,0.508,6,22,0.273,14,17,0.824,98,2016-03-17,ATL,DEN,2016,101.0
1465,1465,65,Home,W 116-111 ,240,48,85,0.565,37,56,0.661,11,29,0.379,9,14,0.643,116,43,85,0.506,37,69,0.536,6,16,0.375,19,24,0.792,111,2016-03-18,HOU,MIN,2016,114.0
1466,1466,66,@,W 116-105 ,240,45,94,0.479,35,68,0.515,10,26,0.385,16,24,0.667,116,37,85,0.435,27,62,0.435,10,23,0.435,21,26,0.808,105,2016-03-25,DEN,LAL,2016,110.0
1467,1467,67,Home,W 116-94 ,240,40,90,0.444,33,68,0.485,7,22,0.318,29,39,0.744,116,35,94,0.372,26,62,0.419,9,32,0.281,15,23,0.652,94,2016-03-25,SAC,PHO,2016,98.5
1468,1468,68,@,L 116-121 ,240,41,84,0.488,26,51,0.51,15,33,0.455,19,23,0.826,116,41,81,0.506,34,55,0.618,7,26,0.269,32,40,0.8,121,2016-03-28,PHO,MIN,2016,124.5
1469,1469,69,Home,W 116-109 ,240,41,90,0.456,27,56,0.482,14,34,0.412,20,27,0.741,116,37,88,0.42,28,64,0.438,9,24,0.375,26,34,0.765,109,2016-03-31,POR,BOS,2016,113.5
1470,1470,70,Home,L 116-121 ,240,41,80,0.513,29,54,0.537,12,26,0.462,22,28,0.786,116,44,77,0.571,34,54,0.63,10,23,0.435,23,26,0.885,121,2016-04-11,NOP,CHI,2016,126.0
1471,1471,71,Home,W 116-81 ,240,47,97,0.485,37,62,0.597,10,35,0.286,12,19,0.632,116,32,96,0.333,21,59,0.356,11,37,0.297,6,13,0.462,81,2016-04-13,HOU,SAC,2016,86.5
1472,1472,72,Home,W 116-98 ,240,40,80,0.5,34,64,0.531,6,16,0.375,30,38,0.789,116,35,84,0.417,30,69,0.435,5,15,0.333,23,31,0.742,98,2016-10-31,LAC,PHO,2017,100.5
1473,1473,73,Home,W 116-80 ,240,43,78,0.551,31,58,0.534,12,20,0.6,18,23,0.783,116,27,75,0.36,23,51,0.451,4,24,0.167,22,29,0.759,80,2016-11-01,MIN,MEM,2017,82.0
1474,1474,74,Home,L 116-123 ,240,41,85,0.482,30,53,0.566,11,32,0.344,23,29,0.793,116,48,90,0.533,39,68,0.574,9,22,0.409,18,20,0.9,123,2016-11-02,ATL,LAL,2017,127.5
1475,1475,75,@,W 116-92 ,240,47,91,0.516,38,68,0.559,9,23,0.391,13,14,0.929,116,30,74,0.405,20,49,0.408,10,25,0.4,22,25,0.88,92,2016-11-05,LAC,SAS,2017,97.0
1476,1476,76,Home,W 116-106 ,240,45,90,0.5,29,55,0.527,16,35,0.457,10,12,0.833,116,39,80,0.488,32,59,0.542,7,21,0.333,21,27,0.778,106,2016-11-07,GSW,NOP,2017,109.5
1477,1477,77,Home,W 116-95 ,240,43,74,0.581,26,41,0.634,17,33,0.515,13,22,0.591,116,34,86,0.395,28,58,0.483,6,28,0.214,21,28,0.75,95,2016-11-09,GSW,DAL,2017,98.0
1478,1478,78,@,W 116-96 ,240,46,97,0.474,37,71,0.521,9,26,0.346,15,18,0.833,116,36,76,0.474,35,69,0.507,1,7,0.143,23,29,0.793,96,2016-11-18,PHO,IND,2017,96.5
1479,1479,79,@,W 116-107 ,240,44,78,0.564,34,54,0.63,10,24,0.417,18,19,0.947,116,39,87,0.448,27,62,0.435,12,25,0.48,17,21,0.81,107,2016-11-18,SAS,LAL,2017,113.0
1480,1480,80,@,L 116-121 (OT),265,40,97,0.412,25,54,0.463,15,43,0.349,21,28,0.75,116,43,98,0.439,29,62,0.468,14,36,0.389,21,25,0.84,121,2016-11-19,CHA,NOP,2017,128.0
1481,1481,81,Home,W 116-101 ,240,44,94,0.468,32,66,0.485,12,28,0.429,16,17,0.941,116,32,76,0.421,25,51,0.49,7,25,0.28,30,38,0.789,101,2016-11-23,SAC,OKC,2017,104.5
1482,1482,82,@,W 116-112 ,240,40,84,0.476,26,52,0.5,14,32,0.438,22,27,0.815,116,38,88,0.432,25,56,0.446,13,32,0.406,23,27,0.852,112,2016-12-05,CLE,TOR,2017,118.5
1483,1483,83,Home,L 116-124 ,240,44,93,0.473,33,70,0.471,11,23,0.478,17,24,0.708,116,43,83,0.518,31,57,0.544,12,26,0.462,26,36,0.722,124,2016-12-06,WAS,ORL,2017,130.0
1484,1484,84,Home,W 116-111 ,240,41,85,0.482,32,59,0.542,9,26,0.346,25,31,0.806,116,42,105,0.4,31,68,0.456,11,37,0.297,16,21,0.762,111,2016-12-07,BRK,DEN,2017,116.5
1485,1485,85,Home,W 116-105 ,240,42,73,0.575,29,42,0.69,13,31,0.419,19,28,0.679,116,39,86,0.453,29,59,0.492,10,27,0.37,17,24,0.708,105,2016-12-10,CLE,CHO,2017,110.0
1486,1486,86,@,W 116-108 ,240,38,83,0.458,25,51,0.49,13,32,0.406,27,30,0.9,116,36,81,0.444,27,57,0.474,9,24,0.375,27,36,0.75,108,2016-12-11,GSW,MIN,2017,112.5
1487,1487,87,Home,W 116-92 ,240,47,84,0.56,37,61,0.607,10,23,0.435,12,21,0.571,116,33,84,0.393,23,61,0.377,10,23,0.435,16,21,0.762,92,2016-12-12,SAC,LAL,2017,97.0
1488,1488,88,Home,W 116-104 ,240,42,91,0.462,34,73,0.466,8,18,0.444,24,31,0.774,116,36,91,0.396,26,56,0.464,10,35,0.286,22,28,0.786,104,2016-12-20,TOR,BRK,2017,109.0
1489,1489,89,@,L 116-123 ,240,42,83,0.506,29,52,0.558,13,31,0.419,19,22,0.864,116,42,79,0.532,30,53,0.566,12,26,0.462,27,37,0.73,123,2016-12-23,PHI,PHO,2017,129.0
1490,1490,90,@,L 116-140 ,240,45,96,0.469,32,63,0.508,13,33,0.394,13,16,0.813,116,45,81,0.556,31,41,0.756,14,40,0.35,36,43,0.837,140,2016-12-30,LAC,HOU,2017,147.0
1491,1491,91,Home,W 116-99 ,240,43,77,0.558,30,52,0.577,13,25,0.52,17,21,0.81,116,40,74,0.541,32,56,0.571,8,18,0.444,11,17,0.647,99,2016-12-30,MIN,MIL,2017,103.0
1492,1492,92,@,W 116-96 ,240,43,76,0.566,34,61,0.557,9,15,0.6,21,27,0.778,116,33,83,0.398,23,56,0.411,10,27,0.37,20,28,0.714,96,2016-12-31,MIL,CHI,2017,101.0
1493,1493,93,Home,L 116-121 ,240,48,97,0.495,38,68,0.559,10,29,0.345,10,12,0.833,116,43,74,0.581,34,58,0.586,9,16,0.563,26,30,0.867,121,2017-01-03,DET,IND,2017,125.5
1494,1494,94,Home,W 116-102 ,240,42,82,0.512,25,49,0.51,17,33,0.515,15,28,0.536,116,30,77,0.39,20,46,0.435,10,31,0.323,32,35,0.914,102,2017-01-03,LAL,MEM,2017,107.0
1495,1495,95,@,L 116-118 ,240,41,91,0.451,29,61,0.475,12,30,0.4,22,27,0.815,116,41,86,0.477,26,47,0.553,15,39,0.385,21,30,0.7,118,2017-01-05,OKC,HOU,2017,125.5
1496,1496,96,@,W 116-108 ,240,38,88,0.432,29,55,0.527,9,33,0.273,31,43,0.721,116,41,91,0.451,32,61,0.525,9,30,0.3,17,19,0.895,108,2017-01-06,CLE,BRK,2017,112.5
1497,1497,97,@,W 116-111 ,240,41,83,0.494,28,60,0.467,13,23,0.565,21,27,0.778,116,39,78,0.5,27,56,0.482,12,22,0.545,21,28,0.75,111,2017-01-06,NYK,MIL,2017,117.0
1498,1498,98,Home,L 116-120 ,240,46,87,0.529,37,60,0.617,9,27,0.333,15,19,0.789,116,44,82,0.537,29,48,0.604,15,34,0.441,17,19,0.895,120,2017-01-08,PHO,CLE,2017,127.5
1499,1499,99,Home,W 116-108 ,240,40,80,0.5,31,65,0.477,9,15,0.6,27,31,0.871,116,41,83,0.494,29,51,0.569,12,32,0.375,14,18,0.778,108,2017-01-13,MIL,MIA,2017,114.0
1500,1500,0,Home,W 116-101 ,240,44,89,0.494,36,67,0.537,8,22,0.364,20,23,0.87,116,35,84,0.417,23,55,0.418,12,29,0.414,19,27,0.704,101,2017-01-15,TOR,NYK,2017,107.0
1501,1501,1,@,W 116-112 (OT),265,43,95,0.453,32,64,0.5,11,31,0.355,19,22,0.864,116,40,82,0.488,25,44,0.568,15,38,0.395,17,34,0.5,112,2017-01-25,SAC,CLE,2017,119.5
1502,1502,2,@,L 116-124 ,240,43,87,0.494,27,54,0.5,16,33,0.485,14,16,0.875,116,49,92,0.533,36,56,0.643,13,36,0.361,13,20,0.65,124,2017-01-27,BRK,CLE,2017,130.5
1503,1503,3,Home,W 116-103 ,240,42,80,0.525,28,52,0.538,14,28,0.5,18,23,0.783,116,46,89,0.517,42,77,0.545,4,12,0.333,7,12,0.583,103,2017-01-28,MIA,DET,2017,105.0
1504,1504,4,@,L 116-120 ,240,41,99,0.414,26,72,0.361,15,27,0.556,19,23,0.826,116,47,89,0.528,35,63,0.556,12,26,0.462,14,18,0.778,120,2017-01-31,DEN,LAL,2017,126.0
1505,1505,5,Home,W 116-93 ,240,45,93,0.484,33,61,0.541,12,32,0.375,14,19,0.737,116,34,86,0.395,27,60,0.45,7,26,0.269,18,21,0.857,93,2017-02-01,MIA,ATL,2017,96.5
1506,1506,6,Home,W 116-108 ,240,44,96,0.458,32,63,0.508,12,33,0.364,16,21,0.762,116,40,87,0.46,28,48,0.583,12,39,0.308,16,22,0.727,108,2017-02-02,WAS,LAL,2017,114.0
1507,1507,7,Home,W 116-108 ,240,44,98,0.449,33,72,0.458,11,26,0.423,17,22,0.773,116,44,89,0.494,39,72,0.542,5,17,0.294,15,19,0.789,108,2017-02-03,DET,MIN,2017,110.5
1508,1508,8,@,W 116-100 ,240,35,73,0.479,18,42,0.429,17,31,0.548,29,37,0.784,116,35,73,0.479,25,51,0.49,10,22,0.455,20,24,0.833,100,2017-02-11,MIL,IND,2017,105.0
1509,1509,9,@,W 116-107 ,240,44,90,0.489,36,76,0.474,8,14,0.571,20,29,0.69,116,39,83,0.47,33,61,0.541,6,22,0.273,23,27,0.852,107,2017-02-13,ORL,MIA,2017,110.0
1510,1510,10,@,W 116-108 ,240,44,86,0.512,31,47,0.66,13,39,0.333,15,22,0.682,116,42,86,0.488,33,63,0.524,9,23,0.391,15,19,0.789,108,2017-02-14,CLE,MIN,2017,112.5
1511,1511,11,Home,W 116-108 ,240,38,80,0.475,25,52,0.481,13,28,0.464,27,36,0.75,116,44,93,0.473,36,62,0.581,8,31,0.258,12,18,0.667,108,2017-02-15,BOS,PHI,2017,112.0
1512,1512,12,Home,W 116-105 ,240,41,88,0.466,29,65,0.446,12,23,0.522,22,31,0.71,116,41,86,0.477,30,65,0.462,11,21,0.524,12,14,0.857,105,2017-02-15,OKC,NYK,2017,110.5
1513,1513,13,Home,W 116-100 ,240,46,88,0.523,39,74,0.527,7,14,0.5,17,19,0.895,116,39,88,0.443,27,53,0.509,12,35,0.343,10,14,0.714,100,2017-02-23,SAC,DEN,2017,106.0
1514,1514,14,@,L 116-130 ,240,45,86,0.523,31,56,0.554,14,30,0.467,12,17,0.706,116,49,86,0.57,33,61,0.541,16,25,0.64,16,22,0.727,130,2017-03-04,BRK,POR,2017,138.0
1515,1515,15,Home,W 116-102 ,240,39,73,0.534,30,53,0.566,9,20,0.45,29,47,0.617,116,34,83,0.41,24,48,0.5,10,35,0.286,24,29,0.828,102,2017-03-06,LAC,BOS,2017,107.0
1516,1516,16,@,W 115-93 ,240,39,79,0.494,29,52,0.558,10,27,0.37,27,34,0.794,115,32,76,0.421,24,49,0.49,8,27,0.296,21,27,0.778,93,2011-12-26,DEN,DAL,2012,97.0
1517,1517,17,Home,W 115-107 ,240,42,75,0.56,36,65,0.554,6,10,0.6,25,35,0.714,115,37,72,0.514,25,53,0.472,12,19,0.632,21,27,0.778,107,2011-12-27,MIA,BOS,2012,113.0
1518,1518,18,Home,W 115-90 ,240,45,80,0.563,35,61,0.574,10,19,0.526,15,15,1.0,115,29,74,0.392,22,54,0.407,7,20,0.35,25,33,0.758,90,2011-12-28,SAS,LAC,2012,93.5
1519,1519,19,Home,W 115-101 ,240,45,90,0.5,35,69,0.507,10,21,0.476,15,26,0.577,115,40,90,0.444,36,76,0.474,4,14,0.286,17,19,0.895,101,2012-01-03,CLE,CHA,2012,103.0
1520,1520,20,@,L 115-123 ,240,43,83,0.518,23,48,0.479,20,35,0.571,9,12,0.75,115,44,74,0.595,33,56,0.589,11,18,0.611,24,30,0.8,123,2012-01-11,BRK,DEN,2012,128.5
1521,1521,21,@,L 115-121 ,240,42,89,0.472,33,72,0.458,9,17,0.529,22,28,0.786,115,44,84,0.524,35,65,0.538,9,19,0.474,24,26,0.923,121,2012-02-14,SAC,CHI,2012,125.5
1522,1522,22,@,W 115-107 ,240,43,96,0.448,39,79,0.494,4,17,0.235,25,27,0.926,115,41,84,0.488,32,61,0.525,9,23,0.391,16,27,0.593,107,2012-02-22,SAC,WAS,2012,111.5
1523,1523,23,Home,W 115-107 ,240,44,82,0.537,38,65,0.585,6,17,0.353,21,26,0.808,115,45,103,0.437,36,78,0.462,9,25,0.36,8,9,0.889,107,2012-03-02,LAL,SAC,2012,111.5
1524,1524,24,Home,W 115-111 (OT),265,45,103,0.437,38,85,0.447,7,18,0.389,18,22,0.818,115,41,94,0.436,33,76,0.434,8,18,0.444,21,26,0.808,111,2012-03-04,BOS,NYK,2012,115.0
1525,1525,25,Home,W 115-104 ,240,40,91,0.44,32,65,0.492,8,26,0.308,27,32,0.844,115,38,84,0.452,35,65,0.538,3,19,0.158,25,34,0.735,104,2012-03-07,OKC,PHO,2012,105.5
1526,1526,26,@,W 115-89 ,240,46,91,0.505,34,67,0.507,12,24,0.5,11,15,0.733,115,33,82,0.402,26,63,0.413,7,19,0.368,16,21,0.762,89,2012-03-13,GSW,SAC,2012,92.5
1527,1527,27,Home,W 115-105 ,240,46,86,0.535,39,63,0.619,7,23,0.304,16,21,0.762,115,38,85,0.447,27,61,0.443,11,24,0.458,18,25,0.72,105,2012-03-14,MIL,CLE,2012,110.5
1528,1528,28,Home,W 115-100 ,240,41,81,0.506,30,56,0.536,11,25,0.44,22,28,0.786,115,32,81,0.395,24,62,0.387,8,19,0.421,28,34,0.824,100,2012-03-16,NYK,IND,2012,104.0
1529,1529,29,Home,W 115-99 ,240,44,96,0.458,36,68,0.529,8,28,0.286,19,21,0.905,115,38,92,0.413,32,67,0.478,6,25,0.24,17,17,1.0,99,2012-03-18,SAC,MIN,2012,102.0
1530,1530,30,@,L 115-116 ,240,40,79,0.506,26,61,0.426,14,18,0.778,21,30,0.7,115,46,79,0.582,37,62,0.597,9,17,0.529,15,22,0.682,116,2012-03-21,DET,DEN,2012,120.5
1531,1531,31,@,W 115-107 ,240,43,71,0.606,34,57,0.596,9,14,0.643,20,25,0.8,115,39,87,0.448,31,69,0.449,8,18,0.444,21,27,0.778,107,2012-04-10,BOS,MIA,2012,111.0
1532,1532,32,Home,W 115-89 ,240,43,90,0.478,38,78,0.487,5,12,0.417,24,32,0.75,115,35,90,0.389,26,65,0.4,9,25,0.36,10,14,0.714,89,2012-04-13,OKC,SAC,2012,93.5
1533,1533,33,@,W 115-110 ,240,40,91,0.44,33,66,0.5,7,25,0.28,28,32,0.875,115,42,84,0.5,38,73,0.521,4,11,0.364,22,34,0.647,110,2012-04-14,OKC,MIN,2012,112.0
1534,1534,34,@,W 115-86 ,240,44,69,0.638,40,59,0.678,4,10,0.4,23,30,0.767,115,32,79,0.405,24,59,0.407,8,20,0.4,14,27,0.519,86,2012-11-02,CHI,CLE,2013,90.0
1535,1535,35,Home,W 115-94 ,240,45,92,0.489,36,81,0.444,9,11,0.818,16,19,0.842,115,39,91,0.429,34,72,0.472,5,19,0.263,11,18,0.611,94,2012-11-04,ORL,PHO,2013,96.5
1536,1536,36,Home,W 115-107 (OT),265,40,92,0.435,25,65,0.385,15,27,0.556,20,28,0.714,115,39,92,0.424,33,82,0.402,6,10,0.6,23,27,0.852,107,2012-11-21,IND,NOH,2013,110.0
1537,1537,37,@,W 115-89 ,240,40,82,0.488,28,60,0.467,12,22,0.545,23,34,0.676,115,34,92,0.37,24,64,0.375,10,28,0.357,11,20,0.55,89,2012-11-24,LAL,DAL,2013,94.0
1538,1538,38,@,L 115-117 (2OT),290,47,92,0.511,39,69,0.565,8,23,0.348,13,17,0.765,115,43,100,0.43,37,78,0.474,6,22,0.273,25,30,0.833,117,2012-12-12,DAL,BOS,2013,120.0
1539,1539,39,@,W 115-93 ,240,49,99,0.495,39,75,0.52,10,24,0.417,7,8,0.875,115,31,84,0.369,26,58,0.448,5,26,0.192,26,36,0.722,93,2012-12-15,GSW,ATL,2013,95.5
1540,1540,40,Home,W 115-100 ,240,44,85,0.518,30,58,0.517,14,27,0.519,13,16,0.813,115,33,90,0.367,25,69,0.362,8,21,0.381,26,35,0.743,100,2012-12-21,GSW,CHA,2013,104.0
1541,1541,41,Home,L 115-118 (OT),265,46,103,0.447,36,74,0.486,10,29,0.345,13,15,0.867,115,49,107,0.458,40,80,0.5,9,27,0.333,11,14,0.786,118,2012-12-22,GSW,LAL,2013,122.5
1542,1542,42,Home,W 115-94 ,240,42,84,0.5,30,61,0.492,12,23,0.522,19,22,0.864,115,29,80,0.363,21,51,0.412,8,29,0.276,28,39,0.718,94,2013-01-02,GSW,LAC,2013,98.0
1543,1543,43,@,W 115-101 ,240,45,83,0.542,32,50,0.64,13,33,0.394,12,19,0.632,115,39,87,0.448,33,73,0.452,6,14,0.429,17,23,0.739,101,2013-01-04,HOU,MIL,2013,104.0
1544,1544,44,@,W 115-113 (2OT),290,41,89,0.461,33,65,0.508,8,24,0.333,25,36,0.694,115,43,91,0.473,34,73,0.466,9,18,0.5,18,31,0.581,113,2013-01-04,BRK,WAS,2013,117.5
1545,1545,45,Home,W 115-89 ,240,47,90,0.522,37,62,0.597,10,28,0.357,11,15,0.733,115,32,72,0.444,27,52,0.519,5,20,0.25,20,26,0.769,89,2013-01-05,LAC,GSW,2013,91.5
1546,1546,46,Home,W 115-111 (OT),265,47,99,0.475,38,74,0.514,9,25,0.36,12,19,0.632,115,42,88,0.477,34,61,0.557,8,27,0.296,19,23,0.826,111,2013-01-15,DEN,POR,2013,115.0
1547,1547,47,Home,W 115-110 ,240,43,90,0.478,34,72,0.472,9,18,0.5,20,23,0.87,115,41,83,0.494,34,62,0.548,7,21,0.333,21,26,0.808,110,2013-02-02,CLE,OKC,2013,113.5
1548,1548,48,Home,W 115-86 ,240,45,77,0.584,40,62,0.645,5,15,0.333,20,29,0.69,115,28,70,0.4,25,56,0.446,3,14,0.214,27,33,0.818,86,2013-02-02,MIN,NOH,2013,87.5
1549,1549,49,Home,W 115-101 ,240,39,78,0.5,29,57,0.509,10,21,0.476,27,33,0.818,115,39,83,0.47,34,66,0.515,5,17,0.294,18,24,0.75,101,2013-02-19,UTA,GSW,2013,103.5
1550,1550,50,@,W 115-86 ,240,43,83,0.518,32,64,0.5,11,19,0.579,18,23,0.783,115,32,82,0.39,27,67,0.403,5,15,0.333,17,19,0.895,86,2013-03-08,IND,ORL,2013,88.5
1551,1551,51,@,W 115-113 ,240,40,87,0.46,33,68,0.485,7,19,0.368,28,38,0.737,115,44,94,0.468,38,72,0.528,6,22,0.273,19,25,0.76,113,2013-03-10,MIL,SAC,2013,116.0
1552,1552,52,@,W 115-108 ,240,41,82,0.5,30,53,0.566,11,29,0.379,22,27,0.815,115,43,89,0.483,35,68,0.515,8,21,0.381,14,17,0.824,108,2013-03-12,DAL,MIL,2013,112.0
1553,1553,53,Home,W 115-109 ,240,40,90,0.444,28,63,0.444,12,27,0.444,23,26,0.885,115,47,93,0.505,42,72,0.583,5,21,0.238,10,15,0.667,109,2013-03-17,MIL,ORL,2013,111.5
1554,1554,54,@,L 115-120 (OT),265,47,100,0.47,37,73,0.507,10,27,0.37,11,18,0.611,115,42,100,0.42,34,75,0.453,8,25,0.32,28,34,0.824,120,2013-10-30,ORL,MIN,2014,124.0
1555,1555,55,@,L 115-126 ,240,40,76,0.526,28,55,0.509,12,21,0.571,23,33,0.697,115,42,85,0.494,33,57,0.579,9,28,0.321,33,50,0.66,126,2013-10-31,GSW,LAC,2014,130.5
1556,1556,56,Home,W 115-105 ,240,45,81,0.556,37,61,0.607,8,20,0.4,17,19,0.895,115,47,94,0.5,41,82,0.5,6,12,0.5,5,8,0.625,105,2013-11-02,POR,SAS,2014,108.0
1557,1557,57,Home,W 115-91 ,240,40,83,0.482,30,58,0.517,10,25,0.4,25,29,0.862,115,34,77,0.442,31,59,0.525,3,18,0.167,20,24,0.833,91,2013-11-09,TOR,UTA,2014,92.5
1558,1558,58,@,L 115-116 ,240,41,80,0.513,32,58,0.552,9,22,0.409,24,28,0.857,115,45,94,0.479,31,71,0.437,14,23,0.609,12,14,0.857,116,2013-11-14,OKC,GSW,2014,123.0
1559,1559,59,Home,W 115-113 ,240,38,93,0.409,25,66,0.379,13,27,0.481,26,32,0.813,115,40,83,0.482,32,60,0.533,8,23,0.348,25,43,0.581,113,2013-11-18,OKC,DEN,2014,117.0
1560,1560,60,Home,W 115-107 (OT),265,45,79,0.57,38,59,0.644,7,20,0.35,18,29,0.621,115,41,93,0.441,33,64,0.516,8,29,0.276,17,24,0.708,107,2013-11-22,PHI,MIL,2014,111.0
1561,1561,61,Home,W 115-100 ,240,41,89,0.461,31,61,0.508,10,28,0.357,23,39,0.59,115,38,88,0.432,31,65,0.477,7,23,0.304,17,19,0.895,100,2013-12-01,DET,PHI,2014,103.5
1562,1562,62,@,W 115-113 ,240,42,82,0.512,27,57,0.474,15,25,0.6,16,22,0.727,115,40,76,0.526,31,57,0.544,9,19,0.474,24,28,0.857,113,2013-12-01,GSW,SAC,2014,117.5
1563,1563,63,Home,W 115-111 ,240,43,94,0.457,37,82,0.451,6,12,0.5,23,29,0.793,115,41,90,0.456,30,53,0.566,11,37,0.297,18,22,0.818,111,2013-12-09,CHA,GSW,2014,116.5
1564,1564,64,Home,W 115-92 ,240,39,76,0.513,28,53,0.528,11,23,0.478,26,35,0.743,115,37,76,0.487,31,58,0.534,6,18,0.333,12,21,0.571,92,2013-12-16,LAC,SAS,2014,95.0
1565,1565,65,@,W 115-92 ,240,46,96,0.479,36,72,0.5,10,24,0.417,13,18,0.722,115,34,88,0.386,26,60,0.433,8,28,0.286,16,24,0.667,92,2013-12-23,DET,CLE,2014,96.0
1566,1566,66,Home,W 115-86 ,240,45,85,0.529,37,65,0.569,8,20,0.4,17,24,0.708,115,32,89,0.36,28,66,0.424,4,23,0.174,18,23,0.783,86,2013-12-27,GSW,PHO,2014,88.0
1567,1567,67,Home,W 115-101 ,240,44,95,0.463,35,62,0.565,9,33,0.273,18,23,0.783,115,37,95,0.389,26,66,0.394,11,29,0.379,16,22,0.727,101,2013-12-28,PHO,PHI,2014,106.5
1568,1568,68,Home,W 115-100 ,240,36,80,0.45,21,48,0.438,15,32,0.469,28,34,0.824,115,39,80,0.488,32,59,0.542,7,21,0.333,15,20,0.75,100,2013-12-28,TOR,NYK,2014,103.5
1569,1569,69,@,W 115-111 ,240,40,83,0.482,32,59,0.542,8,24,0.333,27,28,0.964,115,43,94,0.457,36,74,0.486,7,20,0.35,18,29,0.621,111,2014-01-04,OKC,MIN,2014,114.5
1570,1570,70,Home,L 115-137 ,240,42,89,0.472,39,68,0.574,3,21,0.143,28,36,0.778,115,53,99,0.535,41,70,0.586,12,29,0.414,19,24,0.792,137,2014-01-05,LAL,DEN,2014,143.0
1571,1571,71,Home,W 115-104 ,240,46,95,0.484,42,79,0.532,4,16,0.25,19,24,0.792,115,38,89,0.427,29,67,0.433,9,22,0.409,19,22,0.864,104,2014-01-25,POR,MIN,2014,108.5
1572,1572,72,Home,L 115-117 ,240,40,86,0.465,35,67,0.522,5,19,0.263,30,36,0.833,115,41,74,0.554,32,53,0.604,9,21,0.429,26,36,0.722,117,2014-01-29,DAL,HOU,2014,121.5
1573,1573,73,@,L 115-116 ,240,42,84,0.5,36,63,0.571,6,21,0.286,25,34,0.735,115,40,83,0.482,35,65,0.538,5,18,0.278,31,44,0.705,116,2014-02-03,LAC,DEN,2014,118.5
1574,1574,74,@,W 115-113 ,240,40,77,0.519,34,62,0.548,6,15,0.4,29,33,0.879,115,43,85,0.506,32,65,0.492,11,20,0.55,16,23,0.696,113,2014-02-07,CLE,WAS,2014,118.5
1575,1575,75,Home,W 115-107 ,240,47,87,0.54,39,67,0.582,8,20,0.4,13,29,0.448,115,40,88,0.455,27,57,0.474,13,31,0.419,14,20,0.7,107,2014-02-21,DET,ATL,2014,113.5
1576,1576,76,@,W 115-112 ,240,41,78,0.526,36,62,0.581,5,16,0.313,28,32,0.875,115,42,86,0.488,31,60,0.517,11,26,0.423,17,24,0.708,112,2014-02-23,HOU,PHO,2014,117.5
1577,1577,77,Home,W 115-106 ,240,42,80,0.525,32,64,0.5,10,16,0.625,21,28,0.75,115,43,86,0.5,35,61,0.574,8,25,0.32,12,14,0.857,106,2014-02-25,WAS,ORL,2014,110.0
1578,1578,78,Home,W 115-104 ,240,43,90,0.478,35,68,0.515,8,22,0.364,21,23,0.913,115,38,76,0.5,29,57,0.509,9,19,0.474,19,24,0.792,104,2014-02-26,BOS,ATL,2014,108.5
1579,1579,79,Home,W 115-110 ,240,37,79,0.468,26,55,0.473,11,24,0.458,30,36,0.833,115,46,87,0.529,37,67,0.552,9,20,0.45,9,9,1.0,110,2014-03-05,DEN,DAL,2014,114.5
1580,1580,80,@,W 115-98 ,240,34,74,0.459,27,56,0.482,7,18,0.389,40,50,0.8,115,33,84,0.393,25,61,0.41,8,23,0.348,24,28,0.857,98,2014-03-12,SAC,PHI,2014,102.0
1581,1581,81,Home,W 115-94 ,240,42,76,0.553,34,56,0.607,8,20,0.4,23,28,0.821,115,35,81,0.432,31,71,0.437,4,10,0.4,20,27,0.741,94,2014-03-15,NYK,MIL,2014,96.0
1582,1582,82,@,L 115-120 (OT),265,45,98,0.459,37,81,0.457,8,17,0.471,17,26,0.654,115,42,97,0.433,30,58,0.517,12,39,0.308,24,27,0.889,120,2014-03-18,MIL,POR,2014,126.0
1583,1583,83,Home,W 115-110 ,240,43,80,0.538,35,53,0.66,8,27,0.296,21,25,0.84,115,39,80,0.488,36,68,0.529,3,12,0.25,29,39,0.744,110,2014-03-20,GSW,MIL,2014,111.5
1584,1584,84,Home,W 115-99 ,240,44,83,0.53,39,65,0.6,5,18,0.278,22,24,0.917,115,35,91,0.385,27,55,0.491,8,36,0.222,21,28,0.75,99,2014-03-30,LAL,PHO,2014,103.0
1585,1585,85,Home,W 115-111 ,240,38,79,0.481,29,56,0.518,9,23,0.391,30,36,0.833,115,42,88,0.477,28,57,0.491,14,31,0.452,13,16,0.813,111,2014-04-05,DET,BOS,2014,118.0
1586,1586,86,@,L 115-122 ,240,40,84,0.476,31,52,0.596,9,32,0.281,26,32,0.813,115,45,77,0.584,34,54,0.63,11,23,0.478,21,31,0.677,122,2014-04-06,OKC,PHO,2014,127.5
1587,1587,87,Home,W 115-111 ,240,43,77,0.558,32,53,0.604,11,24,0.458,18,30,0.6,115,38,79,0.481,28,50,0.56,10,29,0.345,25,34,0.735,111,2014-04-09,ORL,BRK,2014,116.0
1588,1588,88,Home,L 115-118 ,240,43,91,0.473,31,61,0.508,12,30,0.4,17,25,0.68,115,40,78,0.513,28,54,0.519,12,24,0.5,26,34,0.765,118,2014-11-07,PHI,CHI,2015,124.0
1589,1589,89,Home,L 115-136 ,240,39,99,0.394,36,83,0.434,3,16,0.188,34,43,0.791,115,46,86,0.535,32,58,0.552,14,28,0.5,30,34,0.882,136,2014-11-16,LAL,GSW,2015,143.0
1590,1590,90,Home,W 115-99 ,240,44,89,0.494,33,67,0.493,11,22,0.5,16,22,0.727,115,34,69,0.493,25,53,0.472,9,16,0.563,22,28,0.786,99,2014-11-19,MIN,NYK,2015,103.5
1591,1591,91,Home,L 115-126 ,240,42,82,0.512,32,58,0.552,10,24,0.417,21,24,0.875,115,42,82,0.512,28,53,0.528,14,29,0.483,28,33,0.848,126,2014-11-26,ATL,TOR,2015,133.0
1592,1592,92,Home,W 115-106 ,240,44,88,0.5,39,73,0.534,5,15,0.333,22,28,0.786,115,43,88,0.489,31,64,0.484,12,24,0.5,8,11,0.727,106,2014-12-12,CHI,POR,2015,112.0
1593,1593,93,Home,L 115-120 (OT),265,40,82,0.488,29,54,0.537,11,28,0.393,24,34,0.706,115,45,93,0.484,34,67,0.507,11,26,0.423,19,27,0.704,120,2014-12-13,PHI,MEM,2015,125.5
1594,1594,94,@,W 115-111 (OT),265,35,85,0.412,27,57,0.474,8,28,0.286,37,48,0.771,115,40,99,0.404,27,69,0.391,13,30,0.433,18,23,0.783,111,2014-12-17,HOU,DEN,2015,117.5
1595,1595,95,Home,W 115-105 ,240,46,89,0.517,34,63,0.54,12,26,0.462,11,17,0.647,115,39,84,0.464,27,58,0.466,12,26,0.462,15,17,0.882,105,2014-12-23,LAL,GSW,2015,111.0
1596,1596,96,@,W 115-111 (OT),265,38,91,0.418,21,60,0.35,17,31,0.548,22,24,0.917,115,46,101,0.455,40,82,0.488,6,19,0.316,13,15,0.867,111,2014-12-23,POR,OKC,2015,114.0
1597,1597,97,@,L 115-124 ,240,41,88,0.466,32,63,0.508,9,25,0.36,24,29,0.828,115,44,97,0.454,31,64,0.484,13,33,0.394,23,32,0.719,124,2014-12-23,DAL,PHO,2015,130.5
1598,1598,98,@,W 115-106 ,240,46,94,0.489,32,61,0.525,14,33,0.424,9,12,0.75,115,41,93,0.441,34,73,0.466,7,20,0.35,17,24,0.708,106,2014-12-26,PHO,SAC,2015,109.5
1599,1599,99,Home,W 115-79 ,240,41,83,0.494,28,52,0.538,13,31,0.419,20,28,0.714,115,30,68,0.441,26,51,0.51,4,17,0.235,15,25,0.6,79,2015-01-03,HOU,MIA,2015,81.0
1600,1600,0,@,W 115-107 ,240,43,84,0.512,37,67,0.552,6,17,0.353,23,31,0.742,115,42,93,0.452,29,60,0.483,13,33,0.394,10,12,0.833,107,2015-01-03,ATL,POR,2015,113.5
1601,1601,1,@,L 115-127 ,240,42,92,0.457,33,68,0.485,9,24,0.375,22,28,0.786,115,51,97,0.526,41,75,0.547,10,22,0.455,15,19,0.789,127,2015-01-16,GSW,OKC,2015,132.0
1602,1602,2,Home,W 115-100 ,240,43,86,0.5,30,54,0.556,13,32,0.406,16,22,0.727,115,34,75,0.453,26,58,0.448,8,17,0.471,24,35,0.686,100,2015-01-19,PHO,LAL,2015,104.0
1603,1603,3,Home,L 115-117 (OT),265,41,101,0.406,29,72,0.403,12,29,0.414,21,28,0.75,115,48,90,0.533,44,76,0.579,4,14,0.286,17,23,0.739,117,2015-01-25,DEN,WAS,2015,119.0
1604,1604,4,@,W 115-100 ,240,45,87,0.517,33,62,0.532,12,25,0.48,13,18,0.722,115,37,82,0.451,32,64,0.5,5,18,0.278,21,30,0.7,100,2015-01-29,MIL,ORL,2015,102.5
1605,1605,5,Home,W 115-100 ,240,43,86,0.5,34,63,0.54,9,23,0.391,20,23,0.87,115,40,89,0.449,33,67,0.493,7,22,0.318,13,17,0.765,100,2015-02-02,NOP,ATL,2015,103.5
1606,1606,6,@,W 115-98 ,240,41,92,0.446,32,65,0.492,9,27,0.333,24,29,0.828,115,33,81,0.407,23,47,0.489,10,34,0.294,22,30,0.733,98,2015-02-09,LAC,DAL,2015,103.0
1607,1607,7,@,L 115-119 ,240,43,84,0.512,33,56,0.589,10,28,0.357,19,23,0.826,115,42,77,0.545,34,58,0.586,8,19,0.421,27,52,0.519,119,2015-02-19,SAS,LAC,2015,123.0
1608,1608,8,@,W 115-110 ,240,39,89,0.438,25,60,0.417,14,29,0.483,23,30,0.767,115,44,97,0.454,35,65,0.538,9,32,0.281,13,16,0.813,110,2015-02-23,BOS,PHO,2015,114.5
1609,1609,9,Home,W 115-94 ,240,42,83,0.506,28,52,0.538,14,31,0.452,17,20,0.85,115,34,82,0.415,32,61,0.525,2,21,0.095,24,31,0.774,94,2015-02-25,BOS,NYK,2015,95.0
1610,1610,10,Home,L 115-121 (2OT),290,39,97,0.402,31,66,0.47,8,31,0.258,29,40,0.725,115,45,109,0.413,39,91,0.429,6,18,0.333,25,26,0.962,121,2015-02-27,DET,NYK,2015,124.0
1611,1611,11,Home,W 115-112 ,240,39,89,0.438,29,63,0.46,10,26,0.385,27,31,0.871,115,45,94,0.479,41,80,0.513,4,14,0.286,18,22,0.818,112,2015-02-27,POR,OKC,2015,114.0
1612,1612,12,Home,W 115-98 ,240,43,82,0.524,36,68,0.529,7,14,0.5,22,30,0.733,115,33,78,0.423,26,47,0.553,7,31,0.226,25,38,0.658,98,2015-03-02,MIA,PHO,2015,101.5
1613,1613,13,@,W 115-91 ,240,42,85,0.494,34,66,0.515,8,19,0.421,23,28,0.821,115,35,88,0.398,32,72,0.444,3,16,0.188,18,24,0.75,91,2015-03-04,CHA,BRK,2015,92.5
1614,1614,14,Home,W 115-102 ,240,42,84,0.5,29,53,0.547,13,31,0.419,18,20,0.9,115,34,81,0.42,25,54,0.463,9,27,0.333,25,27,0.926,102,2015-03-11,DEN,ATL,2015,106.5
1615,1615,15,@,L 115-119 ,240,40,90,0.444,33,64,0.516,7,26,0.269,28,35,0.8,115,42,89,0.472,32,64,0.5,10,25,0.4,25,35,0.714,119,2015-03-16,OKC,DAL,2015,124.0
1616,1616,16,@,L 115-123 ,240,41,82,0.5,28,53,0.528,13,29,0.448,20,25,0.8,115,43,84,0.512,30,54,0.556,13,30,0.433,24,26,0.923,123,2015-03-20,ATL,OKC,2015,129.5
1617,1617,17,Home,W 115-100 ,240,42,80,0.525,30,54,0.556,12,26,0.462,19,22,0.864,115,37,86,0.43,22,56,0.393,15,30,0.5,11,14,0.786,100,2015-03-28,CHA,ATL,2015,107.5
1618,1618,18,Home,W 115-111 ,240,41,89,0.461,23,49,0.469,18,40,0.45,15,25,0.6,115,48,96,0.5,41,82,0.5,7,14,0.5,8,16,0.5,111,2015-04-01,HOU,SAC,2015,114.5
1619,1619,19,@,W 115-112 ,240,38,81,0.469,30,53,0.566,8,28,0.286,31,50,0.62,115,40,92,0.435,26,62,0.419,14,30,0.467,18,26,0.692,112,2015-04-05,HOU,OKC,2015,119.0
1620,1620,20,@,W 115-100 ,240,42,78,0.538,28,50,0.56,14,28,0.5,17,20,0.85,115,39,93,0.419,39,84,0.464,0,9,0.0,22,28,0.786,100,2015-10-28,CHI,BRK,2016,100.0
1621,1621,21,Home,W 115-96 ,240,44,87,0.506,29,57,0.509,15,30,0.5,12,20,0.6,115,37,77,0.481,30,57,0.526,7,20,0.35,15,21,0.714,96,2015-11-05,POR,MEM,2016,99.5
1622,1622,22,Home,L 115-121 ,240,42,84,0.5,32,54,0.593,10,30,0.333,21,24,0.875,115,41,77,0.532,32,56,0.571,9,21,0.429,30,35,0.857,121,2015-11-06,NOP,ATL,2016,125.5
1623,1623,23,Home,W 115-110 ,240,43,80,0.538,32,51,0.627,11,29,0.379,18,27,0.667,115,37,79,0.468,31,61,0.508,6,18,0.333,30,39,0.769,110,2015-11-17,GSW,TOR,2016,113.0
1624,1624,24,@,W 115-98 ,240,45,85,0.529,30,55,0.545,15,30,0.5,10,13,0.769,115,41,83,0.494,34,60,0.567,7,23,0.304,9,11,0.818,98,2015-11-17,DEN,NOP,2016,101.5
1625,1625,25,Home,W 115-86 ,240,37,70,0.529,25,48,0.521,12,22,0.545,29,41,0.707,115,31,72,0.431,21,51,0.412,10,21,0.476,14,24,0.583,86,2015-11-17,WAS,MIL,2016,91.0
1626,1626,26,Home,W 115-100 ,240,40,71,0.563,29,47,0.617,11,24,0.458,24,30,0.8,115,38,73,0.521,35,65,0.538,3,8,0.375,21,26,0.808,100,2015-11-19,CLE,MIL,2016,101.5
1627,1627,27,@,W 115-112 (OT),265,43,94,0.457,34,65,0.523,9,29,0.31,20,24,0.833,115,41,100,0.41,26,60,0.433,15,40,0.375,15,17,0.882,112,2015-12-01,DAL,POR,2016,119.5
1628,1628,28,Home,W 115-96 ,240,43,85,0.506,35,63,0.556,8,22,0.364,21,26,0.808,115,38,92,0.413,27,61,0.443,11,31,0.355,9,13,0.692,96,2015-12-14,CHI,PHI,2016,101.5
1629,1629,29,Home,W 115-107 ,240,43,87,0.494,33,68,0.485,10,19,0.526,19,24,0.792,115,36,72,0.5,26,48,0.542,10,24,0.417,25,40,0.625,107,2015-12-18,SAS,LAC,2016,112.0
1630,1630,30,Home,W 115-89 ,240,41,85,0.482,28,54,0.519,13,31,0.419,20,23,0.87,115,33,95,0.347,26,67,0.388,7,28,0.25,16,24,0.667,89,2015-12-23,NOP,POR,2016,92.5
1631,1631,31,Home,L 115-121 ,240,39,72,0.542,28,52,0.538,11,20,0.55,26,39,0.667,115,43,99,0.434,29,58,0.5,14,41,0.341,21,25,0.84,121,2015-12-29,HOU,ATL,2016,128.0
1632,1632,32,Home,W 115-90 ,240,41,86,0.477,27,51,0.529,14,35,0.4,19,28,0.679,115,35,86,0.407,30,72,0.417,5,14,0.357,15,19,0.789,90,2015-12-31,DET,MIN,2016,92.5
1633,1633,33,@,W 115-113 ,240,42,82,0.512,33,61,0.541,9,21,0.429,22,25,0.88,115,42,92,0.457,29,61,0.475,13,31,0.419,16,19,0.842,113,2016-01-03,CHI,TOR,2016,119.5
1634,1634,34,Home,W 115-89 ,240,43,88,0.489,29,58,0.5,14,30,0.467,15,21,0.714,115,36,81,0.444,30,61,0.492,6,20,0.3,11,11,1.0,89,2016-01-04,DET,ORL,2016,92.0
1635,1635,35,Home,L 115-121 ,240,42,76,0.553,28,52,0.538,14,24,0.583,17,27,0.63,115,48,89,0.539,36,60,0.6,12,29,0.414,13,19,0.684,121,2016-01-06,WAS,CLE,2016,127.0
1636,1636,36,@,L 115-118 ,240,41,76,0.539,33,52,0.635,8,24,0.333,25,29,0.862,115,47,85,0.553,41,64,0.641,6,21,0.286,18,27,0.667,118,2016-01-07,LAL,SAC,2016,121.0
1637,1637,37,Home,W 115-110 ,240,42,100,0.42,23,56,0.411,19,44,0.432,12,14,0.857,115,37,76,0.487,27,55,0.491,10,21,0.476,26,36,0.722,110,2016-01-10,POR,OKC,2016,115.0
1638,1638,38,@,W 115-111 (OT),265,41,88,0.466,34,71,0.479,7,17,0.412,26,31,0.839,115,42,93,0.452,30,66,0.455,12,27,0.444,15,20,0.75,111,2016-01-14,CHI,PHI,2016,117.0
1639,1639,39,Home,W 115-109 ,240,46,83,0.554,35,54,0.648,11,29,0.379,12,17,0.706,115,43,85,0.506,31,59,0.525,12,26,0.462,11,15,0.733,109,2016-01-20,TOR,BOS,2016,115.0
1640,1640,40,Home,W 115-102 ,240,42,83,0.506,29,55,0.527,13,28,0.464,18,24,0.75,115,36,80,0.45,30,55,0.545,6,25,0.24,24,36,0.667,102,2016-01-21,CLE,LAC,2016,105.0
1641,1641,41,Home,W 115-99 ,240,46,86,0.535,41,74,0.554,5,12,0.417,18,18,1.0,115,38,91,0.418,31,61,0.508,7,30,0.233,16,20,0.8,99,2016-01-21,NOP,DET,2016,102.5
1642,1642,42,Home,W 115-104 ,240,43,89,0.483,28,45,0.622,15,44,0.341,14,21,0.667,115,36,79,0.456,21,49,0.429,15,30,0.5,17,22,0.773,104,2016-01-24,HOU,DAL,2016,111.5
1643,1643,43,Home,W 115-93 ,240,45,81,0.556,34,53,0.642,11,28,0.393,14,16,0.875,115,33,70,0.471,25,50,0.5,8,20,0.4,19,25,0.76,93,2016-01-27,CLE,PHO,2016,97.0
1644,1644,44,Home,W 115-102 ,240,44,84,0.524,28,49,0.571,16,35,0.457,11,16,0.688,115,38,85,0.447,32,68,0.471,6,17,0.353,20,27,0.741,102,2016-02-02,HOU,MIA,2016,105.0
1645,1645,45,@,L 115-119 ,240,46,80,0.575,42,63,0.667,4,17,0.235,19,25,0.76,115,40,80,0.5,28,54,0.519,12,26,0.462,27,35,0.771,119,2016-02-02,MIN,LAL,2016,125.0
1646,1646,46,Home,W 115-110 ,240,39,87,0.448,33,69,0.478,6,18,0.333,31,44,0.705,115,43,93,0.462,38,81,0.469,5,12,0.417,19,27,0.704,110,2016-02-05,DEN,CHI,2016,112.5
1647,1647,47,@,W 115-111 ,240,44,88,0.5,36,68,0.529,8,20,0.4,19,28,0.679,115,41,87,0.471,25,51,0.49,16,36,0.444,13,13,1.0,111,2016-02-19,MIA,ATL,2016,119.0
1648,1648,48,@,W 115-112 ,240,42,82,0.512,31,51,0.608,11,31,0.355,20,26,0.769,115,42,94,0.447,29,58,0.5,13,36,0.361,15,18,0.833,112,2016-02-20,GSW,LAC,2016,118.5
1649,1649,49,@,L 115-126 ,240,43,93,0.462,36,72,0.5,7,21,0.333,22,33,0.667,115,44,79,0.557,31,60,0.517,13,19,0.684,25,26,0.962,126,2016-02-21,LAL,CHI,2016,132.5
1650,1650,50,@,W 115-92 ,240,41,80,0.513,31,57,0.544,10,23,0.435,23,27,0.852,115,37,90,0.411,32,69,0.464,5,21,0.238,13,19,0.684,92,2016-02-21,CLE,OKC,2016,94.5
1651,1651,51,Home,W 115-111 ,240,39,90,0.433,27,58,0.466,12,32,0.375,25,38,0.658,115,43,86,0.5,35,70,0.5,8,16,0.5,17,23,0.739,111,2016-02-21,POR,UTA,2016,115.0
1652,1652,52,Home,L 115-124 ,240,43,79,0.544,33,58,0.569,10,21,0.476,19,26,0.731,115,41,85,0.482,34,71,0.479,7,14,0.5,35,41,0.854,124,2016-02-23,PHI,ORL,2016,127.5
1653,1653,53,@,L 115-117 ,240,39,83,0.47,28,56,0.5,11,27,0.407,26,35,0.743,115,34,67,0.507,28,55,0.509,6,12,0.5,43,54,0.796,117,2016-03-04,POR,TOR,2016,120.0
1654,1654,54,Home,W 115-112 ,240,45,94,0.479,38,69,0.551,7,25,0.28,18,26,0.692,115,41,83,0.494,34,58,0.586,7,25,0.28,23,27,0.852,112,2016-03-07,NOP,SAC,2016,115.5
1655,1655,55,Home,W 115-94 ,240,48,84,0.571,35,54,0.648,13,30,0.433,6,10,0.6,115,32,79,0.405,24,59,0.407,8,20,0.4,22,31,0.71,94,2016-03-09,GSW,UTA,2016,98.0
1656,1656,56,Home,W 115-108 ,240,44,92,0.478,32,66,0.485,12,26,0.462,15,18,0.833,115,40,79,0.506,36,64,0.563,4,15,0.267,24,29,0.828,108,2016-03-18,DET,SAC,2016,110.0
1657,1657,57,Home,W 115-103 ,240,46,94,0.489,36,70,0.514,10,24,0.417,13,21,0.619,115,42,80,0.525,37,66,0.561,5,14,0.357,14,21,0.667,103,2016-03-19,DET,BRK,2016,105.5
1658,1658,58,@,W 115-111 ,240,42,80,0.525,32,52,0.615,10,28,0.357,21,26,0.808,115,40,83,0.482,31,61,0.508,9,22,0.409,22,30,0.733,111,2016-03-19,OKC,IND,2016,115.5
1659,1659,59,@,W 115-107 ,240,45,87,0.517,31,62,0.5,14,25,0.56,11,15,0.733,115,38,82,0.463,23,50,0.46,15,32,0.469,16,21,0.762,107,2016-03-23,NYK,CHI,2016,114.5
1660,1660,60,@,W 115-91 ,240,41,74,0.554,25,45,0.556,16,29,0.552,17,21,0.81,115,37,84,0.44,33,69,0.478,4,15,0.267,13,15,0.867,91,2016-03-26,CHA,MIL,2016,93.0
1661,1661,61,@,W 115-91 ,240,39,73,0.534,27,44,0.614,12,29,0.414,25,28,0.893,115,37,85,0.435,33,70,0.471,4,15,0.267,13,20,0.65,91,2016-03-26,TOR,NOP,2016,93.0
1662,1662,62,@,W 115-106 ,240,41,88,0.466,33,67,0.493,8,21,0.381,25,31,0.806,115,40,92,0.435,31,63,0.492,9,29,0.31,17,24,0.708,106,2016-04-02,SAC,DEN,2016,110.5
1663,1663,63,@,W 115-102 ,240,44,84,0.524,36,61,0.59,8,23,0.348,19,23,0.826,115,34,83,0.41,18,46,0.391,16,37,0.432,18,26,0.692,102,2016-04-02,IND,PHI,2016,110.0
1664,1664,64,@,W 115-107 ,240,40,93,0.43,28,62,0.452,12,31,0.387,23,27,0.852,115,41,78,0.526,30,56,0.536,11,22,0.5,14,21,0.667,107,2016-04-05,POR,SAC,2016,112.5
1665,1665,65,@,L 115-120 ,240,43,91,0.473,34,69,0.493,9,22,0.409,20,31,0.645,115,43,84,0.512,28,51,0.549,15,33,0.455,19,24,0.792,120,2016-04-06,OKC,POR,2016,127.5
1666,1666,66,Home,L 115-124 ,240,42,74,0.568,28,41,0.683,14,33,0.424,17,28,0.607,115,44,94,0.468,32,63,0.508,12,31,0.387,24,29,0.828,124,2016-04-07,HOU,PHO,2016,130.0
1667,1667,67,Home,W 115-105 ,240,39,83,0.47,24,59,0.407,15,24,0.625,22,27,0.815,115,37,81,0.457,20,46,0.435,17,35,0.486,14,18,0.778,105,2016-04-13,CHI,PHI,2016,113.5
1668,1668,68,@,W 115-113 (OT),265,45,98,0.459,35,66,0.53,10,32,0.313,15,21,0.714,115,38,100,0.38,32,77,0.416,6,23,0.261,31,39,0.795,113,2016-10-29,POR,DEN,2017,116.0
1669,1669,69,Home,W 115-108 ,240,41,87,0.471,31,59,0.525,10,28,0.357,23,29,0.793,115,40,89,0.449,34,61,0.557,6,28,0.214,22,25,0.88,108,2016-11-01,IND,LAL,2017,111.0
1670,1670,70,@,L 115-118 (OT),265,42,101,0.416,30,68,0.441,12,33,0.364,19,21,0.905,115,44,103,0.427,39,87,0.448,5,16,0.313,25,30,0.833,118,2016-11-02,POR,PHO,2017,120.5
1671,1671,71,Home,W 115-107 ,240,42,83,0.506,33,63,0.524,9,20,0.45,22,27,0.815,115,41,91,0.451,32,64,0.5,9,27,0.333,16,21,0.762,107,2016-11-09,ATL,CHI,2017,111.5
1672,1672,72,@,L 115-122 (OT),265,46,95,0.484,32,59,0.542,14,36,0.389,9,19,0.474,115,49,90,0.544,40,71,0.563,9,19,0.474,15,20,0.75,122,2016-11-09,PHI,IND,2017,126.5
1673,1673,73,Home,W 115-87 ,240,35,90,0.389,24,63,0.381,11,27,0.407,34,43,0.791,115,33,94,0.351,27,71,0.38,6,23,0.261,15,17,0.882,87,2016-11-11,BOS,NYK,2017,90.0
1674,1674,74,Home,W 115-88 ,240,44,91,0.484,27,51,0.529,17,40,0.425,10,17,0.588,115,34,90,0.378,29,68,0.426,5,22,0.227,15,17,0.882,88,2016-11-14,HOU,PHI,2017,90.5
1675,1675,75,@,W 115-108 ,240,43,80,0.538,32,56,0.571,11,24,0.458,18,22,0.818,115,38,89,0.427,23,54,0.426,15,35,0.429,17,21,0.81,108,2016-11-15,CHA,MIN,2017,115.5
1676,1676,76,Home,L 115-121 ,240,38,86,0.442,28,60,0.467,10,26,0.385,29,35,0.829,115,40,76,0.526,27,47,0.574,13,29,0.448,28,34,0.824,121,2016-11-18,SAC,LAC,2017,127.5
1677,1677,77,@,W 115-111 (OT),265,40,89,0.449,29,67,0.433,11,22,0.5,24,31,0.774,115,44,101,0.436,34,65,0.523,10,36,0.278,13,18,0.722,111,2016-11-20,IND,OKC,2017,116.0
1678,1678,78,@,L 115-123 ,240,40,80,0.5,32,61,0.525,8,19,0.421,27,32,0.844,115,39,74,0.527,29,49,0.592,10,25,0.4,35,42,0.833,123,2016-11-21,TOR,LAC,2017,128.0
1679,1679,79,@,W 115-102 ,240,43,88,0.489,31,65,0.477,12,23,0.522,17,21,0.81,115,38,78,0.487,24,36,0.667,14,42,0.333,12,12,1.0,102,2016-11-23,TOR,HOU,2017,109.0
1680,1680,80,Home,W 115-102 ,240,45,81,0.556,34,59,0.576,11,22,0.5,14,17,0.824,115,41,89,0.461,31,54,0.574,10,35,0.286,10,12,0.833,102,2016-11-26,GSW,MIN,2017,107.0
1681,1681,81,@,L 115-126 (OT),265,44,98,0.449,34,70,0.486,10,28,0.357,17,26,0.654,115,46,95,0.484,34,65,0.523,12,30,0.4,22,31,0.71,126,2016-11-30,WAS,OKC,2017,132.0
1682,1682,82,@,W 115-98 ,240,42,89,0.472,35,58,0.603,7,31,0.226,24,29,0.828,115,36,92,0.391,28,66,0.424,8,26,0.308,18,24,0.75,98,2016-12-07,GSW,LAC,2017,102.0
1683,1683,83,Home,W 115-107 ,240,40,77,0.519,30,53,0.566,10,24,0.417,25,37,0.676,115,37,85,0.435,20,45,0.444,17,40,0.425,16,19,0.842,107,2016-12-07,MIL,POR,2017,115.5
1684,1684,84,Home,L 115-119 ,240,40,87,0.46,31,61,0.508,9,26,0.346,26,34,0.765,115,45,95,0.474,32,65,0.492,13,30,0.433,16,21,0.762,119,2016-12-09,LAL,PHO,2017,125.5
1685,1685,85,Home,W 115-108 ,240,42,86,0.488,35,67,0.522,7,19,0.368,24,25,0.96,115,37,82,0.451,28,61,0.459,9,21,0.429,25,35,0.714,108,2016-12-19,MIN,PHO,2017,112.5
1686,1686,86,Home,W 115-107 ,240,45,84,0.536,34,62,0.548,11,22,0.5,14,21,0.667,115,40,90,0.444,26,52,0.5,14,38,0.368,13,15,0.867,107,2016-12-22,MIA,LAL,2017,114.0
1687,1687,87,Home,W 115-109 ,240,41,81,0.506,28,56,0.5,13,25,0.52,20,25,0.8,115,38,89,0.427,18,37,0.486,20,52,0.385,13,15,0.867,109,2016-12-23,MEM,HOU,2017,119.0
1688,1688,88,@,L 115-131 ,240,43,101,0.426,36,71,0.507,7,30,0.233,22,27,0.815,115,46,92,0.5,31,49,0.633,15,43,0.349,24,30,0.8,131,2016-12-26,PHO,HOU,2017,138.5
1689,1689,89,@,W 115-103 ,240,45,91,0.495,30,60,0.5,15,31,0.484,10,14,0.714,115,39,83,0.47,31,62,0.5,8,21,0.381,17,24,0.708,103,2017-01-02,ORL,NYK,2017,107.0
1690,1690,90,Home,W 115-104 ,240,41,74,0.554,24,43,0.558,17,31,0.548,16,17,0.941,115,38,82,0.463,27,56,0.482,11,26,0.423,17,21,0.81,104,2017-01-03,BOS,UTA,2017,109.5
1691,1691,91,Home,W 115-106 ,240,37,73,0.507,28,50,0.56,9,23,0.391,32,45,0.711,115,38,88,0.432,27,60,0.45,11,28,0.393,19,25,0.76,106,2017-01-04,LAC,MEM,2017,111.5
1692,1692,92,Home,W 115-114 ,240,39,97,0.402,29,69,0.42,10,28,0.357,27,32,0.844,115,37,91,0.407,27,65,0.415,10,26,0.385,30,34,0.882,114,2017-01-05,DET,CHO,2017,119.0
1693,1693,93,@,W 115-109 ,240,41,83,0.494,31,65,0.477,10,18,0.556,23,26,0.885,115,39,97,0.402,29,63,0.46,10,34,0.294,21,25,0.84,109,2017-01-13,ORL,POR,2017,114.0
1694,1694,94,Home,L 115-118 (OT),265,45,91,0.495,32,57,0.561,13,34,0.382,12,22,0.545,115,48,96,0.5,38,70,0.543,10,26,0.385,12,14,0.857,118,2017-01-21,CLE,SAS,2017,123.0
1695,1695,95,@,W 115-103 ,240,40,79,0.506,31,57,0.544,9,22,0.409,26,28,0.929,115,33,83,0.398,26,56,0.464,7,27,0.259,30,35,0.857,103,2017-01-22,PHO,TOR,2017,106.5
1696,1696,96,@,W 115-105 ,240,42,84,0.5,28,60,0.467,14,24,0.583,17,22,0.773,115,37,88,0.42,28,59,0.475,9,29,0.31,22,26,0.846,105,2017-01-23,LAC,ATL,2017,109.5
1697,1697,97,Home,W 115-111 (OT),265,38,78,0.487,28,50,0.56,10,28,0.357,29,33,0.879,115,35,71,0.493,22,45,0.489,13,26,0.5,28,36,0.778,111,2017-01-27,IND,SAC,2017,117.5
1698,1698,98,@,W 115-96 ,240,39,80,0.488,23,52,0.442,16,28,0.571,21,24,0.875,115,31,74,0.419,26,55,0.473,5,19,0.263,29,39,0.744,96,2017-01-30,MEM,PHO,2017,98.5
1699,1699,99,Home,W 115-98 ,240,42,93,0.452,31,62,0.5,11,31,0.355,20,23,0.87,115,33,83,0.398,22,52,0.423,11,31,0.355,21,25,0.84,98,2017-01-31,POR,CHO,2017,103.5
1700,1700,0,@,W 115-113 ,240,45,86,0.523,30,58,0.517,15,28,0.536,10,14,0.714,115,43,80,0.538,38,69,0.551,5,11,0.455,22,28,0.786,113,2017-02-06,MIA,MIN,2017,115.5
1701,1701,1,Home,L 115-119 ,240,46,92,0.5,38,65,0.585,8,27,0.296,15,18,0.833,115,45,92,0.489,35,67,0.522,10,25,0.4,19,28,0.679,119,2017-02-08,NYK,LAC,2017,124.0
1702,1702,2,Home,W 115-97 ,240,48,95,0.505,40,76,0.526,8,19,0.421,11,13,0.846,115,37,86,0.43,32,67,0.478,5,19,0.263,18,22,0.818,97,2017-02-10,PHO,CHI,2017,99.5
1703,1703,3,@,W 115-95 ,240,43,84,0.512,33,51,0.647,10,33,0.303,19,25,0.76,115,37,87,0.425,31,63,0.492,6,24,0.25,15,20,0.75,95,2017-03-03,BOS,LAL,2017,98.0
1704,1704,4,Home,W 115-114 ,240,39,81,0.481,25,55,0.455,14,26,0.538,23,25,0.92,115,44,89,0.494,30,54,0.556,14,35,0.4,12,19,0.632,114,2017-03-05,WAS,ORL,2017,121.0
1705,1705,5,@,W 115-108 ,240,41,76,0.539,29,45,0.644,12,31,0.387,21,24,0.875,115,35,79,0.443,27,47,0.574,8,32,0.25,30,40,0.75,108,2017-03-08,UTA,HOU,2017,112.0
1706,1706,6,Home,W 115-98 ,240,44,88,0.5,33,65,0.508,11,23,0.478,16,19,0.842,115,39,89,0.438,32,63,0.508,7,26,0.269,13,22,0.591,98,2017-03-08,IND,DET,2017,101.5
1707,1707,7,@,W 114-101 ,240,39,78,0.5,32,61,0.525,7,17,0.412,29,34,0.853,114,41,80,0.513,34,65,0.523,7,15,0.467,12,20,0.6,101,2011-12-30,CHI,LAC,2012,104.5
1708,1708,8,@,W 114-92 ,240,40,89,0.449,30,61,0.492,10,28,0.357,24,27,0.889,114,30,86,0.349,24,64,0.375,6,22,0.273,26,41,0.634,92,2011-12-31,NYK,SAC,2012,95.0
1709,1709,9,@,W 114-106 ,240,42,87,0.483,37,71,0.521,5,16,0.313,25,26,0.962,114,39,80,0.488,36,69,0.522,3,11,0.273,25,32,0.781,106,2012-01-16,HOU,WAS,2012,107.5
1710,1710,10,@,W 114-75 ,240,46,83,0.554,40,74,0.541,6,9,0.667,16,17,0.941,114,27,89,0.303,20,75,0.267,7,14,0.5,14,19,0.737,75,2012-01-20,CHI,CLE,2012,78.5
1711,1711,11,Home,L 114-119 (2OT),290,44,97,0.454,33,64,0.516,11,33,0.333,15,21,0.714,114,41,98,0.418,35,74,0.473,6,24,0.25,31,43,0.721,119,2012-01-21,NYK,DEN,2012,122.0
1712,1712,12,Home,W 114-106 (OT),265,43,98,0.439,33,76,0.434,10,22,0.455,18,21,0.857,114,39,90,0.433,23,61,0.377,16,29,0.552,12,13,0.923,106,2012-02-04,SAC,GSW,2012,114.0
1713,1713,13,@,W 114-96 ,240,43,83,0.518,36,69,0.522,7,14,0.5,21,25,0.84,114,33,84,0.393,24,61,0.393,9,23,0.391,21,25,0.84,96,2012-02-13,MIA,MIL,2012,100.5
1714,1714,14,Home,W 114-108 ,240,43,93,0.462,37,81,0.457,6,12,0.5,22,25,0.88,114,43,86,0.5,39,75,0.52,4,11,0.364,18,22,0.818,108,2012-02-17,DET,SAC,2012,110.0
1715,1715,15,Home,W 114-100 ,240,47,89,0.528,42,74,0.568,5,15,0.333,15,19,0.789,114,38,84,0.452,36,73,0.493,2,11,0.182,22,26,0.846,100,2012-02-17,UTA,WAS,2012,101.0
1716,1716,16,@,W 114-99 ,240,41,86,0.477,28,59,0.475,13,27,0.481,19,23,0.826,114,37,83,0.446,30,64,0.469,7,19,0.368,18,21,0.857,99,2012-02-23,SAS,DEN,2012,102.5
1717,1717,17,Home,W 114-98 ,240,42,81,0.519,28,54,0.519,14,27,0.519,16,27,0.593,114,37,79,0.468,31,63,0.492,6,16,0.375,18,27,0.667,98,2012-03-03,ORL,MIL,2012,101.0
1718,1718,18,@,L 114-119 ,240,46,83,0.554,39,66,0.591,7,17,0.412,15,21,0.714,114,45,93,0.484,32,67,0.478,13,26,0.5,16,21,0.762,119,2012-03-09,NYK,MIL,2012,125.5
1719,1719,19,@,W 114-110 (OT),265,39,81,0.481,32,66,0.485,7,15,0.467,29,38,0.763,114,37,82,0.451,32,66,0.485,5,16,0.313,31,51,0.608,110,2012-03-16,TOR,MEM,2012,112.5
1720,1720,20,@,W 114-105 ,240,45,87,0.517,36,68,0.529,9,19,0.474,15,25,0.6,114,39,88,0.443,30,63,0.476,9,25,0.36,18,20,0.9,105,2012-03-16,SAS,OKC,2012,109.5
1721,1721,21,Home,W 114-91 ,240,42,78,0.538,33,56,0.589,9,22,0.409,21,22,0.955,114,29,79,0.367,17,53,0.321,12,26,0.462,21,27,0.778,91,2012-03-21,OKC,LAC,2012,97.0
1722,1722,22,Home,W 114-104 ,240,35,69,0.507,29,47,0.617,6,22,0.273,38,43,0.884,114,41,93,0.441,35,77,0.455,6,16,0.375,16,26,0.615,104,2012-04-08,SAS,UTA,2012,107.0
1723,1723,23,@,W 114-90 ,240,47,82,0.573,40,62,0.645,7,20,0.35,13,16,0.813,114,32,83,0.386,26,61,0.426,6,22,0.273,20,23,0.87,90,2012-04-09,PHO,MIN,2012,93.0
1724,1724,24,@,W 114-88 ,240,48,87,0.552,45,78,0.577,3,9,0.333,15,20,0.75,114,39,89,0.438,37,74,0.5,2,15,0.133,8,14,0.571,88,2012-04-22,SAC,CHA,2012,89.0
1725,1725,25,Home,W 114-106 (2OT),290,41,106,0.387,36,90,0.4,5,16,0.313,27,40,0.675,114,37,101,0.366,29,77,0.377,8,24,0.333,24,28,0.857,106,2012-04-22,LAL,OKC,2012,110.0
1726,1726,26,Home,W 114-98 ,240,42,77,0.545,34,57,0.596,8,20,0.4,22,29,0.759,114,37,88,0.42,32,66,0.485,5,22,0.227,19,28,0.679,98,2012-04-22,SAS,CLE,2012,100.5
1727,1727,27,@,W 114-110 ,240,41,84,0.488,37,68,0.544,4,16,0.25,28,39,0.718,114,30,70,0.429,20,49,0.408,10,21,0.476,40,52,0.769,110,2012-11-03,GSW,LAC,2013,115.0
1728,1728,28,Home,W 114-91 ,240,48,78,0.615,38,58,0.655,10,20,0.5,8,13,0.615,114,36,93,0.387,31,71,0.437,5,22,0.227,14,18,0.778,91,2012-11-05,DAL,POR,2013,93.5
1729,1729,29,Home,W 114-101 ,240,42,77,0.545,37,55,0.673,5,22,0.227,25,31,0.806,114,38,87,0.437,35,73,0.479,3,14,0.214,22,26,0.846,101,2012-11-13,BRK,CLE,2013,102.5
1730,1730,30,Home,W 114-102 ,240,42,89,0.472,34,68,0.5,8,21,0.381,22,28,0.786,114,45,92,0.489,40,78,0.513,5,14,0.357,7,15,0.467,102,2012-11-16,LAL,PHO,2013,104.5
1731,1731,31,Home,W 114-111 ,240,42,85,0.494,29,56,0.518,13,29,0.448,17,21,0.81,114,39,77,0.506,24,46,0.522,15,31,0.484,18,22,0.818,111,2012-11-21,DAL,NYK,2013,118.5
1732,1732,32,Home,W 114-87 ,240,46,77,0.597,39,60,0.65,7,17,0.412,15,18,0.833,114,31,77,0.403,26,58,0.448,5,19,0.263,20,26,0.769,87,2012-11-21,PHO,POR,2013,89.5
1733,1733,33,Home,W 114-69 ,240,40,78,0.513,27,51,0.529,13,27,0.481,21,23,0.913,114,23,79,0.291,17,57,0.298,6,22,0.273,17,22,0.773,69,2012-11-26,OKC,CHA,2013,72.0
1734,1734,34,Home,W 114-108 ,240,41,84,0.488,32,67,0.478,9,17,0.529,23,28,0.821,114,36,84,0.429,25,56,0.446,11,28,0.393,25,31,0.806,108,2012-12-07,OKC,LAL,2013,113.5
1735,1735,35,Home,W 114-92 ,240,48,87,0.552,42,67,0.627,6,20,0.3,12,13,0.923,114,37,95,0.389,26,62,0.419,11,33,0.333,7,8,0.875,92,2012-12-07,SAS,HOU,2013,97.5
1736,1736,36,Home,W 114-106 (OT),265,41,94,0.436,35,71,0.493,6,23,0.261,26,32,0.813,114,39,84,0.464,32,70,0.457,7,14,0.5,21,25,0.84,106,2012-12-15,MIN,DAL,2013,109.5
1737,1737,37,@,L 114-126 ,240,41,83,0.494,30,54,0.556,11,29,0.379,21,30,0.7,114,45,94,0.479,33,72,0.458,12,22,0.545,24,32,0.75,126,2012-12-26,LAL,DEN,2013,132.0
1738,1738,38,Home,L 114-116 ,240,34,71,0.479,25,56,0.446,9,15,0.6,37,40,0.925,114,38,77,0.494,31,54,0.574,7,23,0.304,33,41,0.805,116,2012-12-28,UTA,LAC,2013,119.5
1739,1739,39,Home,W 114-96 ,240,44,87,0.506,39,72,0.542,5,15,0.333,21,24,0.875,114,37,78,0.474,29,54,0.537,8,24,0.333,14,17,0.824,96,2012-12-31,OKC,PHO,2013,100.0
1740,1740,40,@,W 114-106 ,240,42,88,0.477,30,55,0.545,12,33,0.364,18,22,0.818,114,41,85,0.482,31,59,0.525,10,26,0.385,14,18,0.778,106,2013-01-05,NYK,ORL,2013,111.0
1741,1741,41,Home,L 114-117 (OT),265,41,91,0.451,34,71,0.479,7,20,0.35,25,30,0.833,114,39,95,0.411,33,75,0.44,6,20,0.3,33,36,0.917,117,2013-01-18,DAL,OKC,2013,120.0
1742,1742,42,Home,W 114-105 ,240,43,89,0.483,31,64,0.484,12,25,0.48,16,21,0.762,114,38,81,0.469,35,66,0.53,3,15,0.2,26,32,0.813,105,2013-01-21,NOP,SAC,2013,106.5
1743,1743,43,Home,W 114-101 ,240,48,83,0.578,40,66,0.606,8,17,0.471,10,17,0.588,114,39,88,0.443,36,74,0.486,3,14,0.214,20,33,0.606,101,2013-01-25,WAS,MIN,2013,102.5
1744,1744,44,Home,W 114-110 (OT),265,44,83,0.53,41,73,0.562,3,10,0.3,23,26,0.885,114,44,82,0.537,37,61,0.607,7,21,0.333,15,18,0.833,110,2013-01-26,UTA,IND,2013,113.5
1745,1745,45,@,W 114-102 ,240,46,86,0.535,40,71,0.563,6,15,0.4,16,20,0.8,114,38,87,0.437,32,68,0.471,6,19,0.316,20,23,0.87,102,2013-01-28,GSW,TOR,2013,105.0
1746,1746,46,Home,W 114-103 ,240,36,75,0.48,25,50,0.5,11,25,0.44,31,40,0.775,114,36,81,0.444,28,60,0.467,8,21,0.381,23,28,0.821,103,2013-02-05,IND,ATL,2013,107.0
1747,1747,47,Home,W 114-108 ,240,40,82,0.488,30,59,0.508,10,23,0.435,24,28,0.857,114,39,80,0.488,30,55,0.545,9,25,0.36,21,25,0.84,108,2013-02-06,MIA,HOU,2013,112.5
1748,1748,48,@,L 114-118 (3OT),315,48,113,0.425,40,87,0.46,8,26,0.308,10,17,0.588,114,43,108,0.398,30,78,0.385,13,30,0.433,19,24,0.792,118,2013-02-10,DEN,BOS,2013,124.5
1749,1749,49,Home,W 114-82 ,240,41,73,0.562,31,59,0.525,10,14,0.714,22,33,0.667,114,29,82,0.354,26,63,0.413,3,19,0.158,21,37,0.568,82,2013-02-22,IND,DET,2013,83.5
1750,1750,50,@,W 114-90 ,240,45,77,0.584,36,56,0.643,9,21,0.429,15,18,0.833,114,35,78,0.449,24,50,0.48,11,28,0.393,9,10,0.9,90,2013-02-23,MIA,PHI,2013,95.5
1751,1751,51,@,W 114-103 ,240,40,79,0.506,26,46,0.565,14,33,0.424,20,24,0.833,114,41,84,0.488,38,70,0.543,3,14,0.214,18,22,0.818,103,2013-02-25,ATL,DET,2013,104.5
1752,1752,52,@,L 114-122 (OT),265,46,100,0.46,38,78,0.487,8,22,0.364,14,18,0.778,114,46,92,0.5,41,78,0.526,5,14,0.357,25,30,0.833,122,2013-03-02,TOR,MIL,2013,124.5
1753,1753,53,Home,W 114-75 ,240,45,89,0.506,36,69,0.522,9,20,0.45,15,20,0.75,114,28,86,0.326,22,67,0.328,6,19,0.316,13,18,0.722,75,2013-03-03,SAS,DET,2013,78.0
1754,1754,54,@,L 114-119 ,240,43,81,0.531,37,66,0.561,6,15,0.4,22,29,0.759,114,42,79,0.532,33,57,0.579,9,22,0.409,26,33,0.788,119,2013-03-18,WAS,CHA,2013,123.5
1755,1755,55,@,W 114-104 ,240,43,96,0.448,39,75,0.52,4,21,0.19,24,29,0.828,114,37,85,0.435,33,60,0.55,4,25,0.16,26,31,0.839,104,2013-03-19,DEN,OKC,2013,106.0
1756,1756,56,Home,W 114-108 ,240,44,85,0.518,38,65,0.585,6,20,0.3,20,28,0.714,114,44,84,0.524,37,65,0.569,7,19,0.368,13,18,0.722,108,2013-03-27,CHA,ORL,2013,111.5
1757,1757,57,@,L 114-132 ,240,39,83,0.47,25,49,0.51,14,34,0.412,22,32,0.688,114,54,99,0.545,43,74,0.581,11,25,0.44,13,21,0.619,132,2013-04-06,HOU,DEN,2013,137.5
1758,1758,58,Home,W 114-90 ,240,40,80,0.5,28,59,0.475,12,21,0.571,22,28,0.786,114,37,84,0.44,30,67,0.448,7,17,0.412,9,13,0.692,90,2013-04-17,TOR,BOS,2013,93.5
1759,1759,59,Home,W 114-110 ,240,43,80,0.538,35,59,0.593,8,21,0.381,20,24,0.833,114,42,85,0.494,26,45,0.578,16,40,0.4,10,13,0.769,110,2013-10-30,PHI,MIA,2014,118.0
1760,1760,60,Home,W 114-103 ,240,40,83,0.482,31,63,0.492,9,20,0.45,25,32,0.781,114,36,80,0.45,28,58,0.483,8,22,0.364,23,28,0.821,103,2013-11-08,PHO,DEN,2014,107.0
1761,1761,61,Home,W 114-99 ,240,47,90,0.522,37,65,0.569,10,25,0.4,10,10,1.0,114,42,87,0.483,34,64,0.531,8,23,0.348,7,17,0.412,99,2013-11-17,LAL,DET,2014,103.0
1762,1762,62,Home,W 114-95 ,240,39,74,0.527,20,42,0.476,19,32,0.594,17,20,0.85,114,37,89,0.416,31,67,0.463,6,22,0.273,15,23,0.652,95,2013-11-29,HOU,BRK,2014,98.0
1763,1763,63,@,W 114-108 ,240,38,87,0.437,29,64,0.453,9,23,0.391,29,34,0.853,114,40,87,0.46,30,59,0.508,10,28,0.357,18,23,0.783,108,2013-12-01,POR,LAL,2014,113.0
1764,1764,64,@,W 114-73 ,240,39,72,0.542,25,47,0.532,14,25,0.56,22,27,0.815,114,25,73,0.342,19,57,0.333,6,16,0.375,17,23,0.739,73,2013-12-08,BOS,NYK,2014,76.0
1765,1765,65,@,W 114-108 ,240,44,85,0.518,37,62,0.597,7,23,0.304,19,21,0.905,114,39,80,0.488,34,61,0.557,5,19,0.263,25,32,0.781,108,2013-12-10,PHO,LAL,2014,110.5
1766,1766,66,Home,W 114-107 ,240,42,76,0.553,34,55,0.618,8,21,0.381,22,30,0.733,114,39,84,0.464,29,55,0.527,10,29,0.345,19,25,0.76,107,2013-12-14,MIA,CLE,2014,112.0
1767,1767,67,Home,W 114-100 ,240,45,92,0.489,34,65,0.523,11,27,0.407,13,15,0.867,114,39,82,0.476,34,61,0.557,5,21,0.238,17,21,0.81,100,2013-12-16,ATL,LAL,2014,102.5
1768,1768,68,Home,W 114-111 (OT),265,39,100,0.39,28,72,0.389,11,28,0.393,25,27,0.926,114,40,100,0.4,30,71,0.423,10,29,0.345,21,25,0.84,111,2013-12-20,CLE,MIL,2014,116.0
1769,1769,69,Home,W 114-81 ,240,43,81,0.531,31,55,0.564,12,26,0.462,16,22,0.727,114,32,84,0.381,28,62,0.452,4,22,0.182,13,24,0.542,81,2013-12-20,IND,HOU,2014,83.0
1770,1770,70,@,W 114-97 ,240,44,79,0.557,35,56,0.625,9,23,0.391,17,23,0.739,114,40,89,0.449,39,77,0.506,1,12,0.083,16,26,0.615,97,2013-12-21,HOU,DET,2014,97.5
1771,1771,71,@,W 114-102 ,240,43,92,0.467,34,69,0.493,9,23,0.391,19,28,0.679,114,36,91,0.396,31,66,0.47,5,25,0.2,25,35,0.714,102,2014-01-01,PHI,DEN,2014,104.5
1772,1772,72,Home,L 114-123 ,240,40,78,0.513,32,60,0.533,8,18,0.444,26,31,0.839,114,46,82,0.561,31,53,0.585,15,29,0.517,16,19,0.842,123,2014-01-02,MIA,GSW,2014,130.5
1773,1773,73,@,W 114-104 ,240,40,94,0.426,29,64,0.453,11,30,0.367,23,33,0.697,114,41,95,0.432,33,71,0.465,8,24,0.333,14,20,0.7,104,2014-01-10,DET,PHI,2014,108.0
1774,1774,74,@,W 114-107 ,240,38,73,0.521,30,55,0.545,8,18,0.444,30,42,0.714,114,40,95,0.421,35,76,0.461,5,19,0.263,22,31,0.71,107,2014-01-11,HOU,WAS,2014,109.5
1775,1775,75,@,L 114-121 ,240,43,91,0.473,37,71,0.521,6,20,0.3,22,24,0.917,114,49,100,0.49,45,81,0.556,4,19,0.211,19,25,0.76,121,2014-01-15,LAL,PHO,2014,123.0
1776,1776,76,Home,W 114-97 ,240,41,75,0.547,31,53,0.585,10,22,0.455,22,26,0.846,114,37,84,0.44,30,59,0.508,7,25,0.28,16,17,0.941,97,2014-01-15,WAS,MIA,2014,100.5
1777,1777,77,Home,W 114-104 ,240,41,85,0.482,34,58,0.586,7,27,0.259,25,37,0.676,114,40,80,0.5,29,57,0.509,11,23,0.478,13,21,0.619,104,2014-01-18,HOU,MIL,2014,109.5
1778,1778,78,@,L 114-121 ,240,38,78,0.487,23,45,0.511,15,33,0.455,23,28,0.821,114,42,81,0.519,30,50,0.6,12,31,0.387,25,27,0.926,121,2014-01-20,MIA,ATL,2014,127.0
1779,1779,79,@,W 114-97 ,240,42,82,0.512,33,61,0.541,9,21,0.429,21,31,0.677,114,33,69,0.478,28,58,0.483,5,11,0.455,26,38,0.684,97,2014-01-21,SAC,NOP,2014,99.5
1780,1780,80,Home,W 114-105 ,240,39,81,0.481,30,64,0.469,9,17,0.529,27,34,0.794,114,41,90,0.456,29,68,0.426,12,22,0.545,11,17,0.647,105,2014-01-24,ORL,LAL,2014,111.0
1781,1781,81,@,W 114-86 ,240,43,79,0.544,29,51,0.569,14,28,0.5,14,19,0.737,114,34,89,0.382,30,67,0.448,4,22,0.182,14,22,0.636,86,2014-01-27,LAC,MIL,2014,88.0
1782,1782,82,Home,W 114-88 ,240,44,82,0.537,34,62,0.548,10,20,0.5,16,23,0.696,114,32,82,0.39,26,60,0.433,6,22,0.273,18,24,0.75,88,2014-01-28,NYK,BOS,2014,91.0
1783,1783,83,@,W 114-108 ,240,41,84,0.488,33,65,0.508,8,19,0.421,24,33,0.727,114,42,94,0.447,35,73,0.479,7,21,0.333,17,20,0.85,108,2014-02-05,BOS,PHI,2014,111.5
1784,1784,84,Home,W 114-89 ,240,45,82,0.549,33,58,0.569,12,24,0.5,12,15,0.8,114,37,82,0.451,32,68,0.471,5,14,0.357,10,12,0.833,89,2014-02-11,CHA,DAL,2014,91.5
1785,1785,85,@,W 114-85 ,240,40,87,0.46,34,69,0.493,6,18,0.333,28,33,0.848,114,31,87,0.356,26,65,0.4,5,22,0.227,18,27,0.667,85,2014-02-18,CLE,PHI,2014,87.5
1786,1786,86,@,W 114-97 ,240,46,89,0.517,33,65,0.508,13,24,0.542,9,11,0.818,114,33,73,0.452,27,57,0.474,6,16,0.375,25,30,0.833,97,2014-02-19,WAS,ATL,2014,100.0
1787,1787,87,@,W 114-104 ,240,40,86,0.465,29,60,0.483,11,26,0.423,23,24,0.958,114,39,80,0.488,26,49,0.531,13,31,0.419,13,17,0.765,104,2014-02-26,CLE,OKC,2014,110.5
1788,1788,88,Home,W 114-88 ,240,42,74,0.568,34,61,0.557,8,13,0.615,22,26,0.846,114,31,79,0.392,25,58,0.431,6,21,0.286,20,26,0.769,88,2014-03-03,MIL,UTA,2014,91.0
1789,1789,89,Home,W 114-101 ,240,41,91,0.451,35,71,0.493,6,20,0.3,26,33,0.788,114,38,94,0.404,34,81,0.42,4,13,0.308,21,30,0.7,101,2014-03-07,MIN,DET,2014,103.0
1790,1790,90,@,W 114-107 ,240,43,80,0.538,28,52,0.538,15,28,0.536,13,23,0.565,114,39,87,0.448,35,71,0.493,4,16,0.25,25,28,0.893,107,2014-03-08,WAS,MIL,2014,109.0
1791,1791,91,Home,W 114-110 ,240,38,81,0.469,25,50,0.5,13,31,0.419,25,30,0.833,114,42,100,0.42,30,65,0.462,12,35,0.343,14,21,0.667,110,2014-03-09,LAL,OKC,2014,116.0
1792,1792,92,Home,W 114-98 ,240,44,78,0.564,35,61,0.574,9,17,0.529,17,24,0.708,114,35,83,0.422,26,56,0.464,9,27,0.333,19,23,0.826,98,2014-03-21,BRK,BOS,2014,102.5
1793,1793,93,@,W 114-94 ,240,46,83,0.554,37,66,0.561,9,17,0.529,13,18,0.722,114,34,83,0.41,27,56,0.482,7,27,0.259,19,28,0.679,94,2014-03-24,DET,UTA,2014,97.5
1794,1794,94,Home,W 114-99 ,240,43,86,0.5,31,53,0.585,12,33,0.364,16,22,0.727,114,39,83,0.47,36,71,0.507,3,12,0.25,18,27,0.667,99,2014-03-30,BRK,MIN,2014,100.5
1795,1795,95,@,W 114-104 ,240,38,82,0.463,26,52,0.5,12,30,0.4,26,32,0.813,114,41,96,0.427,31,70,0.443,10,26,0.385,12,14,0.857,104,2014-03-31,LAC,MIN,2014,109.0
1796,1796,96,@,L 114-125 ,240,44,85,0.518,36,64,0.563,8,21,0.381,18,21,0.857,114,41,82,0.5,29,57,0.509,12,25,0.48,31,37,0.838,125,2014-04-09,PHI,TOR,2014,131.0
1797,1797,97,Home,W 114-93 ,240,46,78,0.59,32,49,0.653,14,29,0.483,8,15,0.533,114,36,80,0.45,29,53,0.547,7,27,0.259,14,16,0.875,93,2014-04-14,WAS,MIA,2014,96.5
1798,1798,98,Home,W 114-85 ,240,46,87,0.529,38,67,0.567,8,20,0.4,14,17,0.824,114,30,79,0.38,22,54,0.407,8,25,0.32,17,23,0.739,85,2014-04-16,CLE,BRK,2014,89.0
1799,1799,99,@,W 114-108 (OT),265,41,104,0.394,38,89,0.427,3,15,0.2,29,33,0.879,114,41,90,0.456,28,59,0.475,13,31,0.419,13,17,0.765,108,2014-10-31,CLE,CHI,2015,114.5
1800,1800,0,@,W 114-96 ,240,41,83,0.494,29,59,0.492,12,24,0.5,20,29,0.69,114,35,67,0.522,28,44,0.636,7,23,0.304,19,26,0.731,96,2014-11-01,MIA,PHI,2015,99.5
1801,1801,1,@,W 114-112 (2OT),290,39,91,0.429,36,75,0.48,3,16,0.188,33,39,0.846,114,42,98,0.429,32,67,0.478,10,31,0.323,18,25,0.72,112,2014-11-07,SAC,PHO,2015,117.0
1802,1802,2,Home,W 114-103 ,240,42,75,0.56,31,47,0.66,11,28,0.393,19,23,0.826,114,35,74,0.473,25,53,0.472,10,21,0.476,23,25,0.92,103,2014-11-14,ATL,MIA,2015,108.0
1803,1803,3,Home,L 114-118 ,240,45,87,0.517,41,77,0.532,4,10,0.4,20,31,0.645,114,48,93,0.516,39,72,0.542,9,21,0.429,13,16,0.813,118,2014-11-17,BOS,PHO,2015,122.5
1804,1804,4,@,W 114-109 ,240,47,87,0.54,41,70,0.586,6,17,0.353,14,22,0.636,114,41,85,0.482,32,58,0.552,9,27,0.333,18,23,0.783,109,2014-11-18,LAL,ATL,2015,113.5
1805,1805,5,@,W 114-90 ,240,45,84,0.536,33,63,0.524,12,21,0.571,12,16,0.75,114,34,86,0.395,26,62,0.419,8,24,0.333,14,18,0.778,90,2014-11-19,LAC,ORL,2015,94.0
1806,1806,6,@,W 114-104 ,240,44,89,0.494,37,62,0.597,7,27,0.259,19,23,0.826,114,42,84,0.5,42,76,0.553,0,8,0.0,20,24,0.833,104,2014-11-24,POR,PHI,2015,104.0
1807,1807,7,Home,W 114-109 ,240,43,85,0.506,35,69,0.507,8,16,0.5,20,27,0.741,114,35,82,0.427,28,61,0.459,7,21,0.333,32,37,0.865,109,2014-11-25,DEN,CHI,2015,112.5
1808,1808,8,@,W 114-97 ,240,43,75,0.573,30,47,0.638,13,28,0.464,15,23,0.652,114,33,85,0.388,23,62,0.371,10,23,0.435,21,27,0.778,97,2014-11-25,GSW,MIA,2015,102.0
1809,1809,9,Home,W 114-86 ,240,42,78,0.538,30,47,0.638,12,31,0.387,18,25,0.72,114,33,79,0.418,26,59,0.441,7,20,0.35,13,25,0.52,86,2014-12-03,LAC,ORL,2015,89.5
1810,1810,10,@,W 114-112 (OT),265,38,78,0.487,26,46,0.565,12,32,0.375,26,31,0.839,114,45,97,0.464,42,87,0.483,3,10,0.3,19,27,0.704,112,2014-12-05,HOU,MIN,2015,113.5
1811,1811,11,Home,W 114-105 ,240,41,85,0.482,34,71,0.479,7,14,0.5,25,29,0.862,114,38,85,0.447,20,45,0.444,18,40,0.45,11,14,0.786,105,2014-12-09,MEM,DAL,2015,114.0
1812,1812,12,Home,W 114-101 ,240,41,82,0.5,37,61,0.607,4,21,0.19,28,34,0.824,114,34,84,0.405,30,63,0.476,4,21,0.19,29,35,0.829,101,2014-12-09,OKC,MIL,2015,103.0
1813,1813,13,@,L 114-119 ,240,44,89,0.494,36,67,0.537,8,22,0.364,18,23,0.783,114,44,79,0.557,32,51,0.627,12,28,0.429,19,25,0.76,119,2014-12-12,CLE,NOP,2015,125.0
1814,1814,14,@,W 114-87 ,240,42,72,0.583,26,49,0.531,16,23,0.696,14,20,0.7,114,31,79,0.392,23,57,0.404,8,22,0.364,17,27,0.63,87,2014-12-13,BRK,CHO,2015,91.0
1815,1815,15,Home,W 114-109 ,240,48,94,0.511,36,63,0.571,12,31,0.387,6,10,0.6,114,41,86,0.477,30,61,0.492,11,25,0.44,16,24,0.667,109,2014-12-18,GSW,OKC,2015,114.5
1816,1816,16,Home,W 114-98 ,240,48,85,0.565,40,62,0.645,8,23,0.348,10,14,0.714,114,42,93,0.452,36,81,0.444,6,12,0.5,8,16,0.5,98,2014-12-19,BOS,MIN,2015,101.0
1817,1817,17,@,W 114-88 ,240,48,90,0.533,39,65,0.6,9,25,0.36,9,15,0.6,114,30,85,0.353,27,70,0.386,3,15,0.2,25,28,0.893,88,2014-12-20,POR,NOP,2015,89.5
1818,1818,18,@,W 114-106 ,240,42,81,0.519,33,66,0.5,9,15,0.6,21,38,0.553,114,42,81,0.519,35,58,0.603,7,23,0.304,15,21,0.714,106,2014-12-25,OKC,SAS,2015,109.5
1819,1819,19,Home,W 114-93 ,240,42,88,0.477,24,45,0.533,18,43,0.419,12,14,0.857,114,36,81,0.444,33,67,0.493,3,14,0.214,18,33,0.545,93,2014-12-26,POR,PHI,2015,94.5
1820,1820,20,Home,W 114-87 ,240,43,82,0.524,35,67,0.522,8,15,0.533,20,29,0.69,114,33,74,0.446,29,62,0.468,4,12,0.333,17,27,0.63,87,2014-12-30,DAL,WAS,2015,89.0
1821,1821,21,Home,W 114-85 ,240,41,79,0.519,34,64,0.531,7,15,0.467,25,31,0.806,114,37,86,0.43,35,72,0.486,2,14,0.143,9,13,0.692,85,2015-01-03,DEN,MEM,2015,86.0
1822,1822,22,Home,W 114-95 ,240,45,91,0.495,33,60,0.55,12,31,0.387,12,16,0.75,114,32,75,0.427,29,60,0.483,3,15,0.2,28,36,0.778,95,2015-01-04,DET,SAC,2015,96.5
1823,1823,23,Home,W 114-105 ,240,41,85,0.482,36,68,0.529,5,17,0.294,27,30,0.9,114,47,102,0.461,39,77,0.506,8,25,0.32,3,5,0.6,105,2015-01-05,CHI,HOU,2015,109.0
1824,1824,24,Home,W 114-89 ,240,40,85,0.471,28,52,0.538,12,33,0.364,22,30,0.733,114,37,85,0.435,32,65,0.492,5,20,0.25,10,17,0.588,89,2015-01-07,LAC,LAL,2015,91.5
1825,1825,25,Home,L 114-121 ,240,41,84,0.488,33,57,0.579,8,27,0.296,24,33,0.727,114,48,81,0.593,41,63,0.651,7,18,0.389,18,29,0.621,121,2015-01-12,CHI,ORL,2015,124.5
1826,1826,26,@,W 114-111 ,240,41,96,0.427,34,75,0.453,7,21,0.333,25,31,0.806,114,47,87,0.54,40,60,0.667,7,27,0.259,10,14,0.714,111,2015-01-12,DET,TOR,2015,114.5
1827,1827,27,Home,W 114-107 ,240,41,82,0.5,37,63,0.587,4,19,0.211,28,35,0.8,114,41,100,0.41,32,63,0.508,9,37,0.243,16,20,0.8,107,2015-01-14,DEN,DAL,2015,111.5
1828,1828,28,Home,W 114-111 ,240,42,89,0.472,34,66,0.515,8,23,0.348,22,25,0.88,114,41,95,0.432,31,67,0.463,10,28,0.357,19,27,0.704,111,2015-01-25,GSW,BOS,2015,116.0
1829,1829,29,Home,W 114-110 ,240,43,81,0.531,38,66,0.576,5,15,0.333,23,29,0.793,114,41,90,0.456,29,56,0.518,12,34,0.353,16,23,0.696,110,2015-01-25,TOR,DET,2015,116.0
1830,1830,30,Home,W 114-101 ,240,41,82,0.5,31,57,0.544,10,25,0.4,22,35,0.629,114,39,87,0.448,28,55,0.509,11,32,0.344,12,19,0.632,101,2015-01-31,DET,HOU,2015,106.5
1831,1831,31,@,L 114-128 ,240,41,98,0.418,31,68,0.456,10,30,0.333,22,28,0.786,114,45,86,0.523,26,48,0.542,19,38,0.5,19,25,0.76,128,2015-02-04,DAL,GSW,2015,137.5
1832,1832,32,Home,W 114-109 ,240,46,77,0.597,34,56,0.607,12,21,0.571,10,18,0.556,114,43,87,0.494,31,63,0.492,12,24,0.5,11,15,0.733,109,2015-02-04,IND,DET,2015,115.0
1833,1833,33,Home,W 114-77 ,240,44,87,0.506,35,67,0.522,9,20,0.45,17,23,0.739,114,26,77,0.338,22,59,0.373,4,18,0.222,21,31,0.677,77,2015-02-07,WAS,BRK,2015,79.0
1834,1834,34,Home,L 114-124 ,240,42,87,0.483,33,59,0.559,9,28,0.321,21,29,0.724,114,43,80,0.538,31,56,0.554,12,24,0.5,26,35,0.743,124,2015-02-09,DEN,OKC,2015,130.0
1835,1835,35,@,W 114-105 ,240,42,89,0.472,32,68,0.471,10,21,0.476,20,24,0.833,114,41,89,0.461,37,66,0.561,4,23,0.174,19,29,0.655,105,2015-02-20,BRK,LAL,2015,107.0
1836,1836,36,@,W 114-107 ,240,45,90,0.5,33,67,0.493,12,23,0.522,12,17,0.706,114,42,79,0.532,37,61,0.607,5,18,0.278,18,21,0.857,107,2015-02-24,GSW,WAS,2015,109.5
1837,1837,37,@,W 114-103 ,240,41,80,0.513,30,53,0.566,11,27,0.407,21,24,0.875,114,41,78,0.526,33,58,0.569,8,20,0.4,13,19,0.684,103,2015-03-02,TOR,PHI,2015,107.0
1838,1838,38,@,L 114-119 ,240,38,85,0.447,28,58,0.483,10,27,0.37,28,38,0.737,114,48,85,0.565,35,61,0.574,13,24,0.542,10,12,0.833,119,2015-03-06,SAC,ORL,2015,125.5
1839,1839,39,@,W 114-100 ,240,40,86,0.465,30,58,0.517,10,28,0.357,24,32,0.75,114,38,92,0.413,29,62,0.468,9,30,0.3,15,19,0.789,100,2015-03-07,HOU,DEN,2015,104.5
1840,1840,40,Home,W 114-109 (OT),265,41,80,0.513,34,56,0.607,7,24,0.292,25,33,0.758,114,40,88,0.455,30,63,0.476,10,25,0.4,19,24,0.792,109,2015-03-07,MIA,SAC,2015,114.0
1841,1841,41,@,W 114-103 ,240,44,75,0.587,35,60,0.583,9,15,0.6,17,21,0.81,114,37,71,0.521,33,56,0.589,4,15,0.267,25,31,0.806,103,2015-03-09,NOP,MIL,2015,105.0
1842,1842,42,Home,W 114-103 ,240,41,82,0.5,33,65,0.508,8,17,0.471,24,37,0.649,114,39,92,0.424,31,73,0.425,8,19,0.421,17,22,0.773,103,2015-03-13,DEN,GSW,2015,107.0
1843,1843,43,Home,W 114-107 ,240,45,95,0.474,36,63,0.571,9,32,0.281,15,23,0.652,114,35,87,0.402,31,73,0.425,4,14,0.286,33,40,0.825,107,2015-03-13,PHI,SAC,2015,109.0
1844,1844,44,Home,W 114-95 ,240,44,84,0.524,30,54,0.556,14,30,0.467,12,20,0.6,114,31,87,0.356,23,65,0.354,8,22,0.364,25,30,0.833,95,2015-03-18,GSW,ATL,2015,99.0
1845,1845,45,@,W 114-103 ,240,38,76,0.5,30,56,0.536,8,20,0.4,30,38,0.789,114,39,80,0.488,32,66,0.485,7,14,0.5,18,24,0.75,103,2015-03-18,SAS,MIL,2015,106.5
1846,1846,46,@,W 114-95 ,240,46,82,0.561,39,65,0.6,7,17,0.412,15,17,0.882,114,38,80,0.475,26,56,0.464,12,24,0.5,7,7,1.0,95,2015-03-22,SAS,ATL,2015,101.0
1847,1847,47,@,L 114-120 ,240,43,92,0.467,34,68,0.5,9,24,0.375,19,22,0.864,114,48,85,0.565,40,67,0.597,8,18,0.444,16,18,0.889,120,2015-03-28,DEN,POR,2015,124.0
1848,1848,48,Home,W 114-88 ,240,40,80,0.5,25,45,0.556,15,35,0.429,19,25,0.76,114,32,75,0.427,25,54,0.463,7,21,0.333,17,21,0.81,88,2015-04-02,CLE,MIA,2015,91.5
1849,1849,49,Home,W 114-109 ,240,46,88,0.523,41,72,0.569,5,16,0.313,17,23,0.739,114,42,82,0.512,34,56,0.607,8,26,0.308,17,23,0.739,109,2015-04-03,BRK,TOR,2015,113.0
1850,1850,50,@,W 114-111 ,240,43,86,0.5,32,58,0.552,11,28,0.393,17,25,0.68,114,41,87,0.471,34,61,0.557,7,26,0.269,22,25,0.88,111,2015-04-08,ATL,BRK,2015,114.5
1851,1851,51,Home,W 114-107 ,240,40,90,0.444,31,64,0.484,9,26,0.346,25,36,0.694,114,37,89,0.416,24,48,0.5,13,41,0.317,20,25,0.8,107,2015-04-11,CHI,PHI,2015,113.5
1852,1852,52,@,L 114-121 ,240,44,91,0.484,33,64,0.516,11,27,0.407,15,22,0.682,114,39,73,0.534,30,49,0.612,9,24,0.375,34,48,0.708,121,2015-04-12,NOP,HOU,2015,125.5
1853,1853,53,Home,W 114-98 ,240,39,86,0.453,30,61,0.492,9,25,0.36,27,34,0.794,114,38,91,0.418,31,66,0.47,7,25,0.28,15,18,0.833,98,2015-04-15,DAL,POR,2015,101.5
1854,1854,54,@,L 114-132 ,240,41,89,0.461,30,55,0.545,11,34,0.324,21,27,0.778,114,52,101,0.515,46,79,0.582,6,22,0.273,22,30,0.733,132,2015-10-30,LAL,SAC,2016,135.0
1855,1855,55,Home,W 114-109 ,240,39,76,0.513,35,59,0.593,4,17,0.235,32,46,0.696,114,43,101,0.426,37,83,0.446,6,18,0.333,17,25,0.68,109,2015-10-31,LAC,SAC,2016,112.0
1856,1856,56,@,L 114-119 (OT),265,46,91,0.505,39,71,0.549,7,20,0.35,15,19,0.789,114,42,88,0.477,31,54,0.574,11,34,0.324,24,34,0.706,119,2015-11-04,ORL,HOU,2016,124.5
1857,1857,57,Home,W 114-99 ,240,43,92,0.467,30,59,0.508,13,33,0.394,15,15,1.0,114,38,78,0.487,30,54,0.556,8,24,0.333,15,17,0.882,99,2015-11-07,ATL,WAS,2016,103.0
1858,1858,58,Home,W 114-94 ,240,45,81,0.556,36,60,0.6,9,21,0.429,15,23,0.652,114,34,73,0.466,28,54,0.519,6,19,0.316,20,31,0.645,94,2015-11-07,SAS,CHO,2016,97.0
1859,1859,59,@,L 114-118 ,240,40,82,0.488,30,60,0.5,10,22,0.455,24,28,0.857,114,37,74,0.5,26,50,0.52,11,24,0.458,33,43,0.767,118,2015-11-10,UTA,CLE,2016,123.5
1860,1860,60,@,W 114-106 ,240,40,71,0.563,31,54,0.574,9,17,0.529,25,27,0.926,114,41,82,0.5,36,66,0.545,5,16,0.313,19,21,0.905,106,2015-11-15,MEM,MIN,2016,108.5
1861,1861,61,@,L 114-122 ,240,41,81,0.506,31,57,0.544,10,24,0.417,22,31,0.71,114,37,84,0.44,25,67,0.373,12,17,0.706,36,39,0.923,122,2015-11-16,OKC,MEM,2016,128.0
1862,1862,62,@,W 114-107 ,240,40,79,0.506,25,52,0.481,15,27,0.556,19,25,0.76,114,41,90,0.456,36,66,0.545,5,24,0.208,20,26,0.769,107,2015-11-20,PHO,DEN,2016,109.5
1863,1863,63,@,L 114-117 ,240,44,83,0.53,34,64,0.531,10,19,0.526,16,28,0.571,114,47,90,0.522,38,68,0.559,9,22,0.409,14,18,0.778,117,2015-11-22,DAL,OKC,2016,121.5
1864,1864,64,Home,L 114-120 ,240,44,96,0.458,34,70,0.486,10,26,0.385,16,20,0.8,114,42,81,0.519,32,59,0.542,10,22,0.455,26,34,0.765,120,2015-11-25,PHO,NOP,2016,125.0
1865,1865,65,@,L 114-116 ,240,40,83,0.482,24,48,0.5,16,35,0.457,18,26,0.692,114,38,73,0.521,27,53,0.509,11,20,0.55,29,37,0.784,116,2015-11-27,PHI,HOU,2016,121.5
1866,1866,66,Home,W 114-90 ,240,43,82,0.524,31,55,0.564,12,27,0.444,16,22,0.727,114,31,74,0.419,23,48,0.479,8,26,0.308,20,22,0.909,90,2015-11-27,ORL,MIL,2016,94.0
1867,1867,67,@,W 114-97 ,240,40,84,0.476,26,51,0.51,14,33,0.424,20,24,0.833,114,29,77,0.377,22,56,0.393,7,21,0.333,32,41,0.78,97,2015-12-03,BOS,SAC,2016,100.5
1868,1868,68,Home,W 114-108 (OT),265,42,85,0.494,33,60,0.55,9,25,0.36,21,31,0.677,114,39,89,0.438,29,56,0.518,10,33,0.303,20,24,0.833,108,2015-12-04,NOP,CLE,2016,113.0
1869,1869,69,@,W 114-98 ,240,44,86,0.512,30,53,0.566,14,33,0.424,12,23,0.522,114,39,89,0.438,34,72,0.472,5,17,0.294,15,23,0.652,98,2015-12-06,GSW,BRK,2016,100.5
1870,1870,70,@,W 114-103 ,240,46,92,0.5,37,74,0.5,9,18,0.5,13,17,0.765,114,41,69,0.594,36,53,0.679,5,16,0.313,16,22,0.727,103,2015-12-07,WAS,MIA,2016,105.5
1871,1871,71,Home,W 114-106 ,240,43,77,0.558,33,49,0.673,10,28,0.357,18,24,0.75,114,38,92,0.413,23,56,0.411,15,36,0.417,15,22,0.682,106,2015-12-08,SAC,UTA,2016,113.5
1872,1872,72,@,W 114-111 ,240,44,85,0.518,30,56,0.536,14,29,0.483,12,15,0.8,114,38,89,0.427,24,56,0.429,14,33,0.424,21,24,0.875,111,2015-12-12,WAS,DAL,2016,118.0
1873,1873,73,Home,W 114-108 ,240,42,82,0.512,34,57,0.596,8,25,0.32,22,25,0.88,114,41,87,0.471,23,47,0.489,18,40,0.45,8,11,0.727,108,2015-12-14,DEN,HOU,2016,117.0
1874,1874,74,Home,W 114-95 ,240,44,83,0.53,36,61,0.59,8,22,0.364,18,23,0.783,114,35,84,0.417,32,69,0.464,3,15,0.2,22,25,0.88,95,2015-12-16,SAS,WAS,2016,96.5
1875,1875,75,Home,W 114-91 ,240,42,82,0.512,28,55,0.509,14,27,0.519,16,20,0.8,114,33,81,0.407,26,62,0.419,7,19,0.368,18,24,0.75,91,2015-12-30,DAL,GSW,2016,94.5
1876,1876,76,@,W 114-110 ,240,43,84,0.512,32,61,0.525,11,23,0.478,17,27,0.63,114,36,78,0.462,24,48,0.5,12,30,0.4,26,29,0.897,110,2015-12-31,GSW,HOU,2016,116.0
1877,1877,77,Home,W 114-111 (OT),265,42,89,0.472,30,53,0.566,12,36,0.333,18,34,0.529,114,40,100,0.4,32,70,0.457,8,30,0.267,23,29,0.793,111,2016-01-10,LAC,NOP,2016,115.0
1878,1878,78,@,W 114-100 ,240,48,99,0.485,39,75,0.52,9,24,0.375,9,10,0.9,114,34,81,0.42,25,59,0.424,9,22,0.409,23,27,0.852,100,2016-01-11,WAS,CHI,2016,104.5
1879,1879,79,@,L 114-120 ,240,42,86,0.488,33,57,0.579,9,29,0.31,21,26,0.808,114,43,81,0.531,36,61,0.59,7,20,0.35,27,30,0.9,120,2016-01-12,BOS,NYK,2016,123.5
1880,1880,80,Home,W 114-86 ,240,44,79,0.557,36,50,0.72,8,29,0.276,18,24,0.75,114,34,78,0.436,28,58,0.483,6,20,0.3,12,19,0.632,86,2016-01-16,ATL,BRK,2016,89.0
1881,1881,81,Home,W 114-89 ,240,42,76,0.553,32,53,0.604,10,23,0.435,20,30,0.667,114,34,87,0.391,29,58,0.5,5,29,0.172,16,24,0.667,89,2016-01-16,PHI,POR,2016,91.5
1882,1882,82,Home,W 114-99 ,240,42,83,0.506,32,60,0.533,10,23,0.435,20,23,0.87,114,36,76,0.474,33,62,0.532,3,14,0.214,24,31,0.774,99,2016-01-19,NOP,MIN,2016,100.5
1883,1883,83,Home,L 114-123 ,240,43,95,0.453,31,71,0.437,12,24,0.5,16,18,0.889,114,38,80,0.475,26,50,0.52,12,30,0.4,35,59,0.593,123,2016-01-20,HOU,DET,2016,129.0
1884,1884,84,Home,W 114-107 ,240,45,89,0.506,34,58,0.586,11,31,0.355,13,20,0.65,114,41,84,0.488,37,68,0.544,4,16,0.25,21,23,0.913,107,2016-01-25,CLE,MIN,2016,109.0
1885,1885,85,@,W 114-91 ,240,47,95,0.495,41,78,0.526,6,17,0.353,14,16,0.875,114,32,85,0.376,23,60,0.383,9,25,0.36,18,23,0.783,91,2016-01-28,CHI,LAL,2016,95.5
1886,1886,86,Home,W 114-105 ,240,43,98,0.439,33,72,0.458,10,26,0.385,18,24,0.75,114,40,89,0.449,30,61,0.492,10,28,0.357,15,20,0.75,105,2016-01-28,NOP,SAC,2016,110.0
1887,1887,87,@,W 114-106 ,240,39,83,0.47,30,60,0.5,9,23,0.391,27,29,0.931,114,40,84,0.476,33,61,0.541,7,23,0.304,19,26,0.731,106,2016-01-29,CLE,DET,2016,109.5
1888,1888,88,@,L 114-119 ,240,39,93,0.419,23,47,0.489,16,46,0.348,20,25,0.8,114,44,82,0.537,34,58,0.586,10,24,0.417,21,35,0.6,119,2016-01-31,BOS,ORL,2016,124.0
1889,1889,89,Home,W 114-98 ,240,43,83,0.518,36,61,0.59,7,22,0.318,21,27,0.778,114,40,86,0.465,33,60,0.55,7,26,0.269,11,15,0.733,98,2016-02-01,OKC,WAS,2016,101.5
1890,1890,90,@,W 114-100 ,240,44,88,0.5,32,64,0.5,12,24,0.5,14,17,0.824,114,36,81,0.444,29,58,0.5,7,23,0.304,21,31,0.677,100,2016-02-03,IND,BRK,2016,103.5
1891,1891,91,@,L 114-117 ,240,47,95,0.495,37,72,0.514,10,23,0.435,10,12,0.833,114,44,93,0.473,35,66,0.53,9,27,0.333,20,25,0.8,117,2016-02-03,ORL,OKC,2016,121.5
1892,1892,92,@,W 114-110 (OT),265,38,88,0.432,23,50,0.46,15,38,0.395,23,33,0.697,114,44,88,0.5,35,65,0.538,9,23,0.391,13,23,0.565,110,2016-02-06,DAL,MEM,2016,114.5
1893,1893,93,@,W 114-110 ,240,44,87,0.506,40,71,0.563,4,16,0.25,22,29,0.759,114,42,91,0.462,27,56,0.482,15,35,0.429,11,17,0.647,110,2016-02-10,SAC,PHI,2016,117.5
1894,1894,94,@,L 114-121 ,240,40,76,0.526,28,49,0.571,12,27,0.444,22,26,0.846,114,41,81,0.506,34,64,0.531,7,17,0.412,32,40,0.8,121,2016-02-19,PHI,NOP,2016,124.5
1895,1895,95,Home,W 114-94 ,240,47,96,0.49,45,83,0.542,2,13,0.154,18,28,0.643,114,40,99,0.404,37,77,0.481,3,22,0.136,11,21,0.524,94,2016-02-20,MIA,WAS,2016,95.5
1896,1896,96,@,W 114-110 ,240,43,83,0.518,36,66,0.545,7,17,0.412,21,28,0.75,114,41,100,0.41,31,73,0.425,10,27,0.37,18,22,0.818,110,2016-02-23,SAC,DEN,2016,115.0
1897,1897,97,@,L 114-117 (OT),265,36,87,0.414,25,53,0.472,11,34,0.324,31,41,0.756,114,38,74,0.514,28,50,0.56,10,24,0.417,31,38,0.816,117,2016-02-23,HOU,UTA,2016,122.0
1898,1898,98,Home,W 114-103 ,240,45,91,0.495,32,59,0.542,13,32,0.406,11,17,0.647,114,37,76,0.487,27,47,0.574,10,29,0.345,19,27,0.704,103,2016-02-24,CLE,CHO,2016,108.0
1899,1899,99,Home,W 114-105 ,240,41,85,0.482,31,59,0.525,10,26,0.385,22,26,0.846,114,37,74,0.5,31,64,0.484,6,10,0.6,25,33,0.758,105,2016-02-24,TOR,MIN,2016,108.0
1900,1900,0,Home,L 114-130 ,240,41,90,0.456,31,64,0.484,10,26,0.385,22,28,0.786,114,53,88,0.602,40,63,0.635,13,25,0.52,11,16,0.688,130,2016-02-25,ORL,GSW,2016,136.5
1901,1901,1,Home,W 114-101 ,240,41,71,0.577,29,48,0.604,12,23,0.522,20,27,0.741,114,39,80,0.488,29,59,0.492,10,21,0.476,13,18,0.722,101,2016-02-28,DET,TOR,2016,106.0
1902,1902,2,@,L 114-116 (OT),265,41,93,0.441,25,52,0.481,16,41,0.39,16,20,0.8,114,44,107,0.411,35,81,0.432,9,26,0.346,19,25,0.76,116,2016-03-06,DAL,DEN,2016,120.5
1903,1903,3,Home,W 114-108 ,240,42,80,0.525,38,72,0.528,4,8,0.5,26,37,0.703,114,42,80,0.525,36,65,0.554,6,15,0.4,18,19,0.947,108,2016-03-09,MIL,MIA,2016,111.0
1904,1904,4,@,L 114-121 (OT),265,42,96,0.438,35,72,0.486,7,24,0.292,23,34,0.676,114,47,96,0.49,41,82,0.5,6,14,0.429,21,32,0.656,121,2016-03-11,NOP,MEM,2016,124.0
1905,1905,5,Home,W 114-93 ,240,38,67,0.567,29,51,0.569,9,16,0.563,29,38,0.763,114,35,80,0.438,28,56,0.5,7,24,0.292,16,22,0.727,93,2016-03-11,UTA,WAS,2016,96.5
1906,1906,6,@,W 114-90 ,240,41,84,0.488,23,47,0.489,18,37,0.486,14,20,0.7,114,32,79,0.405,22,47,0.468,10,32,0.313,16,19,0.842,90,2016-03-13,CLE,LAC,2016,95.0
1907,1907,7,@,L 114-131 ,240,41,88,0.466,30,58,0.517,11,30,0.367,21,26,0.808,114,47,90,0.522,37,66,0.561,10,24,0.417,27,31,0.871,131,2016-03-15,PHI,BRK,2016,136.0
1908,1908,8,Home,L 114-118 ,240,39,84,0.464,31,59,0.525,8,25,0.32,28,39,0.718,114,39,89,0.438,27,55,0.491,12,34,0.353,28,34,0.824,118,2016-03-16,DET,ATL,2016,124.0
1909,1909,9,@,W 114-108 ,240,40,71,0.563,30,50,0.6,10,21,0.476,24,31,0.774,114,44,100,0.44,40,80,0.5,4,20,0.2,16,21,0.762,108,2016-03-16,MIN,MEM,2016,110.0
1910,1910,10,Home,W 114-98 ,240,39,87,0.448,24,53,0.453,15,34,0.441,21,28,0.75,114,36,85,0.424,28,57,0.491,8,28,0.286,18,27,0.667,98,2016-03-23,GSW,LAC,2016,102.0
1911,1911,11,Home,W 114-90 ,240,44,84,0.524,33,59,0.559,11,25,0.44,15,18,0.833,114,31,89,0.348,24,70,0.343,7,19,0.368,21,27,0.778,90,2016-03-28,LAC,BOS,2016,93.5
1912,1912,12,@,W 114-94 ,240,48,90,0.533,43,74,0.581,5,16,0.313,13,18,0.722,114,36,86,0.419,29,67,0.433,7,19,0.368,15,21,0.714,94,2016-03-31,ORL,IND,2016,97.5
1913,1913,13,Home,W 114-109 ,240,43,85,0.506,35,66,0.53,8,19,0.421,20,33,0.606,114,43,94,0.457,32,64,0.5,11,30,0.367,12,21,0.571,109,2016-04-03,LAC,WAS,2016,114.5
1914,1914,14,Home,W 114-112 ,240,45,94,0.479,32,62,0.516,13,32,0.406,11,20,0.55,114,39,81,0.481,26,49,0.531,13,32,0.406,21,28,0.75,112,2016-04-09,SAC,OKC,2016,118.5
1915,1915,15,@,W 114-100 ,240,41,81,0.506,27,49,0.551,14,32,0.438,18,22,0.818,114,34,89,0.382,26,65,0.4,8,24,0.333,24,29,0.828,100,2016-04-11,CHA,BOS,2016,104.0
1916,1916,16,Home,W 114-105 ,240,45,99,0.455,38,73,0.521,7,26,0.269,17,22,0.773,114,43,96,0.448,34,65,0.523,9,31,0.29,10,12,0.833,105,2016-04-13,PHO,LAC,2016,109.5
1917,1917,17,@,L 114-120 ,240,44,86,0.512,37,57,0.649,7,29,0.241,19,27,0.704,114,45,89,0.506,33,54,0.611,12,35,0.343,18,22,0.818,120,2016-10-26,HOU,LAL,2017,126.0
1918,1918,18,Home,W 114-99 ,240,44,88,0.5,32,62,0.516,12,26,0.462,14,18,0.778,114,40,94,0.426,34,74,0.459,6,20,0.3,13,18,0.722,99,2016-10-27,ATL,WAS,2017,102.0
1919,1919,19,@,W 114-106 ,240,37,91,0.407,29,62,0.468,8,29,0.276,32,46,0.696,114,39,85,0.459,35,67,0.522,4,18,0.222,24,32,0.75,106,2016-10-27,LAC,POR,2017,108.0
1920,1920,20,Home,L 114-122 ,240,47,100,0.47,42,78,0.538,5,22,0.227,15,23,0.652,114,44,91,0.484,35,63,0.556,9,28,0.321,25,28,0.893,122,2016-10-28,NOP,GSW,2017,126.5
1921,1921,21,@,W 114-109 ,240,38,75,0.507,30,50,0.6,8,25,0.32,30,35,0.857,114,42,83,0.506,34,63,0.54,8,20,0.4,17,19,0.895,109,2016-11-06,UTA,NYK,2017,113.0
1922,1922,22,Home,W 114-82 ,240,41,76,0.539,28,51,0.549,13,25,0.52,19,22,0.864,114,30,82,0.366,26,70,0.371,4,12,0.333,18,26,0.692,82,2016-11-07,LAC,DET,2017,84.0
1923,1923,23,@,W 114-106 ,240,41,79,0.519,24,42,0.571,17,37,0.459,15,18,0.833,114,39,94,0.415,29,67,0.433,10,27,0.37,18,20,0.9,106,2016-11-07,HOU,WAS,2017,111.0
1924,1924,24,@,W 114-111 ,240,43,85,0.506,30,58,0.517,13,27,0.481,15,26,0.577,114,42,88,0.477,31,61,0.508,11,27,0.407,16,22,0.727,111,2016-11-19,MIA,WAS,2017,116.5
1925,1925,25,Home,L 114-119 ,240,45,89,0.506,34,69,0.493,11,20,0.55,13,18,0.722,114,44,86,0.512,31,55,0.564,13,31,0.419,18,20,0.9,119,2016-11-23,CHA,SAS,2017,125.5
1926,1926,26,Home,L 114-120 ,240,36,89,0.404,25,64,0.391,11,25,0.44,31,36,0.861,114,39,89,0.438,26,60,0.433,13,29,0.448,29,32,0.906,120,2016-11-27,PHO,DEN,2017,126.5
1927,1927,27,Home,L 114-130 ,240,40,83,0.482,28,50,0.56,12,33,0.364,22,29,0.759,114,46,82,0.561,29,46,0.63,17,36,0.472,21,28,0.75,130,2016-11-27,POR,HOU,2017,138.5
1928,1928,28,Home,L 114-121 ,240,40,91,0.44,25,49,0.51,15,42,0.357,19,20,0.95,114,48,87,0.552,39,67,0.582,9,20,0.45,16,21,0.762,121,2016-11-30,BOS,DET,2017,125.5
1929,1929,29,@,W 114-96 ,240,45,88,0.511,35,64,0.547,10,24,0.417,14,16,0.875,114,39,85,0.459,34,65,0.523,5,20,0.25,13,21,0.619,96,2016-12-02,LAC,NOP,2017,98.5
1930,1930,30,@,L 114-118 ,240,41,88,0.466,31,60,0.517,10,28,0.357,22,24,0.917,114,41,86,0.477,29,55,0.527,12,31,0.387,24,30,0.8,118,2016-12-02,MIN,NYK,2017,124.0
1931,1931,31,@,W 114-103 ,240,48,98,0.49,41,73,0.562,7,25,0.28,11,16,0.688,114,38,89,0.427,27,64,0.422,11,25,0.44,16,27,0.593,103,2016-12-06,NYK,MIA,2017,108.5
1932,1932,32,Home,W 114-84 ,240,46,83,0.554,37,59,0.627,9,24,0.375,13,19,0.684,114,31,90,0.344,25,63,0.397,6,27,0.222,16,21,0.762,84,2016-12-09,CLE,MIA,2017,87.0
1933,1933,33,@,W 114-110 ,240,40,84,0.476,28,50,0.56,12,34,0.353,22,29,0.759,114,44,94,0.468,32,66,0.485,12,28,0.429,10,14,0.714,110,2016-12-09,ATL,MIL,2017,116.0
1934,1934,34,Home,W 114-95 ,240,43,80,0.538,35,57,0.614,8,23,0.348,20,27,0.741,114,33,87,0.379,25,60,0.417,8,27,0.296,21,28,0.75,95,2016-12-13,POR,OKC,2017,99.0
1935,1935,35,Home,L 114-123 ,240,43,86,0.5,34,57,0.596,9,29,0.31,19,25,0.76,114,41,87,0.471,31,58,0.534,10,29,0.345,31,36,0.861,123,2016-12-14,PHI,TOR,2017,128.0
1936,1936,36,@,L 114-127 ,240,35,80,0.438,27,57,0.474,8,23,0.348,36,39,0.923,114,50,90,0.556,40,63,0.635,10,27,0.37,17,29,0.586,127,2016-12-17,NYK,DEN,2017,132.0
1937,1937,37,Home,W 114-101 ,240,41,81,0.506,34,65,0.523,7,16,0.438,25,34,0.735,114,39,90,0.433,31,68,0.456,8,22,0.364,15,20,0.75,101,2016-12-17,OKC,PHO,2017,105.0
1938,1938,38,@,W 114-108 (OT),265,37,91,0.407,20,51,0.392,17,40,0.425,23,27,0.852,114,40,87,0.46,33,60,0.55,7,27,0.259,21,29,0.724,108,2016-12-20,CLE,MIL,2017,111.5
1939,1939,39,Home,L 114-119 ,240,41,87,0.471,33,64,0.516,8,23,0.348,24,27,0.889,114,45,93,0.484,31,57,0.544,14,36,0.389,15,20,0.75,119,2016-12-25,NYK,BOS,2017,126.0
1940,1940,40,Home,W 114-80 ,240,43,82,0.524,30,60,0.5,13,22,0.591,15,20,0.75,114,25,74,0.338,21,52,0.404,4,22,0.182,26,38,0.684,80,2016-12-29,MEM,OKC,2017,82.0
1941,1941,41,@,L 114-117 ,240,48,90,0.533,37,62,0.597,11,28,0.393,7,10,0.7,114,38,74,0.514,21,42,0.5,17,32,0.531,24,29,0.828,117,2016-12-30,MIA,BOS,2017,125.5
1942,1942,42,Home,W 114-88 ,240,37,78,0.474,27,49,0.551,10,29,0.345,30,35,0.857,114,31,75,0.413,23,45,0.511,8,30,0.267,18,21,0.857,88,2016-12-31,OKC,LAC,2017,92.0
1943,1943,43,Home,W 114-112 (OT),265,42,92,0.457,28,64,0.438,14,28,0.5,16,27,0.593,114,42,90,0.467,33,63,0.524,9,27,0.333,19,22,0.864,112,2017-01-01,ATL,SAS,2017,116.5
1944,1944,44,Home,L 114-123 ,240,37,92,0.402,22,60,0.367,15,32,0.469,25,31,0.806,114,42,75,0.56,32,58,0.552,10,17,0.588,29,32,0.906,123,2017-01-01,LAL,TOR,2017,128.0
1945,1945,45,@,L 114-115 ,240,37,91,0.407,27,65,0.415,10,26,0.385,30,34,0.882,114,39,97,0.402,29,69,0.42,10,28,0.357,27,32,0.844,115,2017-01-05,CHA,DET,2017,120.0
1946,1946,46,@,L 114-121 ,240,44,92,0.478,25,49,0.51,19,43,0.442,7,9,0.778,114,40,82,0.488,23,43,0.535,17,39,0.436,24,33,0.727,121,2017-01-10,CHA,HOU,2017,129.5
1947,1947,47,Home,W 114-106 ,240,41,87,0.471,31,65,0.477,10,22,0.455,22,27,0.815,114,40,85,0.471,31,58,0.534,9,27,0.333,17,20,0.85,106,2017-01-10,TOR,BOS,2017,110.5
1948,1948,48,Home,W 114-107 ,240,41,83,0.494,34,57,0.596,7,26,0.269,25,36,0.694,114,38,82,0.463,26,48,0.542,12,34,0.353,19,27,0.704,107,2017-01-14,UTA,ORL,2017,113.0
1949,1949,49,@,L 114-122 ,240,36,73,0.493,30,60,0.5,6,13,0.462,36,41,0.878,114,43,84,0.512,35,66,0.53,8,18,0.444,28,35,0.8,122,2017-01-17,MIN,SAS,2017,126.0
1950,1950,50,Home,L 114-143 ,240,43,105,0.41,32,71,0.451,11,34,0.324,17,23,0.739,114,48,83,0.578,33,53,0.623,15,30,0.5,32,35,0.914,143,2017-01-20,NOP,BRK,2017,150.5
1951,1951,51,@,L 114-127 ,240,39,77,0.506,25,42,0.595,14,35,0.4,22,28,0.786,114,47,80,0.588,36,57,0.632,11,23,0.478,22,27,0.815,127,2017-01-23,HOU,MIL,2017,132.5
1952,1952,52,Home,L 114-119 ,240,43,94,0.457,35,67,0.522,8,27,0.296,20,26,0.769,114,43,83,0.518,26,53,0.491,17,30,0.567,16,19,0.842,119,2017-01-25,CHI,ATL,2017,127.5
1953,1953,53,@,W 114-109 ,240,40,75,0.533,28,49,0.571,12,26,0.462,22,25,0.88,114,42,91,0.462,35,63,0.556,7,28,0.25,18,23,0.783,109,2017-01-25,PHI,MIL,2017,112.5
1954,1954,54,@,W 114-105 ,240,42,91,0.462,32,64,0.5,10,27,0.37,20,28,0.714,114,41,96,0.427,30,69,0.435,11,27,0.407,12,19,0.632,105,2017-01-25,OKC,NOP,2017,110.5
1955,1955,55,@,W 114-113 ,240,42,79,0.532,32,56,0.571,10,23,0.435,20,26,0.769,114,36,79,0.456,24,51,0.471,12,28,0.429,29,36,0.806,113,2017-01-29,ORL,TOR,2017,119.0
1956,1956,56,Home,L 114-124 ,240,39,96,0.406,32,76,0.421,7,20,0.35,29,35,0.829,114,44,84,0.524,39,65,0.6,5,19,0.263,31,38,0.816,124,2017-02-01,PHO,LAC,2017,126.5
1957,1957,57,Home,W 114-102 ,240,38,80,0.475,25,54,0.463,13,26,0.5,25,33,0.758,114,40,83,0.482,37,64,0.578,3,19,0.158,19,22,0.864,102,2017-02-03,OKC,MEM,2017,103.5
1958,1958,58,@,W 114-113 ,240,42,86,0.488,31,58,0.534,11,28,0.393,19,24,0.792,114,37,75,0.493,25,47,0.532,12,28,0.429,27,32,0.844,113,2017-02-07,POR,DAL,2017,119.0
1959,1959,59,@,W 114-110 (OT),265,40,97,0.412,31,72,0.431,9,25,0.36,25,33,0.758,114,38,91,0.418,29,58,0.5,9,33,0.273,25,36,0.694,110,2017-02-08,WAS,BRK,2017,114.5
1960,1960,60,Home,L 114-122 ,240,40,76,0.526,32,48,0.667,8,28,0.286,26,31,0.839,114,39,75,0.52,24,45,0.533,15,30,0.5,29,35,0.829,122,2017-02-10,MIL,LAL,2017,129.5
1961,1961,61,Home,L 114-130 ,240,40,83,0.482,34,59,0.576,6,24,0.25,28,36,0.778,114,46,87,0.529,33,56,0.589,13,31,0.419,25,35,0.714,130,2017-02-11,OKC,GSW,2017,136.5
1962,1962,62,Home,W 114-108 (OT),265,44,107,0.411,29,70,0.414,15,37,0.405,11,12,0.917,114,38,92,0.413,31,62,0.5,7,30,0.233,25,26,0.962,108,2017-02-23,DET,CHO,2017,111.5
1963,1963,63,@,W 114-98 ,240,46,95,0.484,40,70,0.571,6,25,0.24,16,20,0.8,114,34,87,0.391,24,53,0.453,10,34,0.294,20,25,0.8,98,2017-02-27,ATL,BOS,2017,103.0
1964,1964,64,Home,W 114-109 ,240,39,79,0.494,29,54,0.537,10,25,0.4,26,35,0.743,114,34,86,0.395,23,57,0.404,11,29,0.379,30,32,0.938,109,2017-03-02,POR,OKC,2017,114.5
1965,1965,65,@,W 114-106 ,240,41,81,0.506,30,56,0.536,11,25,0.44,21,27,0.778,114,34,92,0.37,24,62,0.387,10,30,0.333,28,32,0.875,106,2017-03-03,TOR,WAS,2017,111.0
1966,1966,66,@,L 114-115 ,240,44,89,0.494,30,54,0.556,14,35,0.4,12,19,0.632,114,39,81,0.481,25,55,0.455,14,26,0.538,23,25,0.92,115,2017-03-05,ORL,WAS,2017,122.0
1967,1967,67,Home,W 114-104 ,240,42,84,0.5,28,55,0.509,14,29,0.483,16,21,0.762,114,42,86,0.488,35,67,0.522,7,19,0.368,13,16,0.813,104,2017-03-08,SAS,SAC,2017,107.5
1968,1968,68,@,W 114-98 ,240,40,78,0.513,29,48,0.604,11,30,0.367,23,28,0.821,114,37,83,0.446,30,63,0.476,7,20,0.35,17,22,0.773,98,2017-03-09,LAC,MEM,2017,101.5
1969,1969,69,Home,W 114-108 (OT),265,40,88,0.455,34,67,0.507,6,21,0.286,28,33,0.848,114,41,94,0.436,30,65,0.462,11,29,0.379,15,20,0.75,108,2017-03-09,POR,PHI,2017,113.5
1970,1970,70,Home,W 113-93 ,240,45,80,0.563,45,75,0.6,0,5,0.0,23,33,0.697,113,34,79,0.43,23,50,0.46,11,29,0.379,14,18,0.778,93,2011-12-30,MEM,HOU,2012,98.5
1971,1971,71,Home,W 113-96 ,240,50,91,0.549,48,83,0.578,2,8,0.25,11,16,0.688,113,34,83,0.41,25,59,0.424,9,24,0.375,19,23,0.826,96,2012-01-03,MEM,SAC,2012,100.5
1972,1972,72,Home,W 113-105 ,240,45,76,0.592,42,66,0.636,3,10,0.3,20,29,0.69,113,35,78,0.449,31,58,0.534,4,20,0.2,31,43,0.721,105,2012-01-10,UTA,CLE,2012,107.0
1973,1973,73,Home,W 113-92 ,240,44,81,0.543,37,65,0.569,7,16,0.438,18,21,0.857,113,37,83,0.446,29,68,0.426,8,15,0.533,10,15,0.667,92,2012-01-21,MIA,PHI,2012,96.0
1974,1974,74,Home,W 113-86 ,240,42,70,0.6,33,52,0.635,9,18,0.5,20,25,0.8,113,32,71,0.451,29,62,0.468,3,9,0.333,19,25,0.76,86,2012-01-31,NYK,DET,2012,87.5
1975,1975,75,@,W 113-90 ,240,48,90,0.533,34,60,0.567,14,30,0.467,3,4,0.75,113,37,93,0.398,36,81,0.444,1,12,0.083,15,19,0.789,90,2012-02-04,CHI,MIL,2012,90.5
1976,1976,76,@,W 113-112 (OT),265,40,98,0.408,32,74,0.432,8,24,0.333,25,31,0.806,113,43,88,0.489,35,71,0.493,8,17,0.471,18,32,0.563,112,2012-02-10,MIL,CLE,2012,116.0
1977,1977,77,@,W 113-109 ,240,43,87,0.494,38,70,0.543,5,17,0.294,22,33,0.667,113,42,79,0.532,34,57,0.596,8,22,0.364,17,22,0.773,109,2012-02-11,DEN,IND,2012,113.0
1978,1978,78,@,W 113-106 ,240,41,76,0.539,33,57,0.579,8,19,0.421,23,25,0.92,113,47,86,0.547,44,75,0.587,3,11,0.273,9,14,0.643,106,2012-02-15,SAS,TOR,2012,107.5
1979,1979,79,@,W 113-111 ,240,41,84,0.488,36,67,0.537,5,17,0.294,26,37,0.703,113,42,81,0.519,35,70,0.5,7,11,0.636,20,22,0.909,111,2012-03-23,PHO,IND,2012,114.5
1980,1980,80,Home,W 113-106 (OT),265,43,89,0.483,39,69,0.565,4,20,0.2,23,27,0.852,113,41,96,0.427,36,78,0.462,5,18,0.278,19,26,0.731,106,2012-03-26,HOU,SAC,2012,108.5
1981,1981,81,@,W 113-101 ,240,44,77,0.571,39,63,0.619,5,14,0.357,20,24,0.833,113,39,72,0.542,34,58,0.586,5,14,0.357,18,19,0.947,101,2012-03-30,MIA,TOR,2012,103.5
1982,1982,82,@,W 113-108 ,240,43,83,0.518,37,67,0.552,6,16,0.375,21,30,0.7,113,43,95,0.453,34,70,0.486,9,25,0.36,13,20,0.65,108,2012-04-04,LAL,LAC,2012,112.5
1983,1983,83,@,W 113-85 ,240,40,83,0.482,29,58,0.5,11,25,0.44,22,26,0.846,113,32,82,0.39,29,73,0.397,3,9,0.333,18,22,0.818,85,2012-04-09,WAS,CHA,2012,86.5
1984,1984,84,Home,W 113-107 ,240,41,82,0.5,32,60,0.533,9,22,0.409,22,31,0.71,113,42,84,0.5,34,60,0.567,8,24,0.333,15,18,0.833,107,2012-04-11,DEN,MIN,2012,111.0
1985,1985,85,@,W 113-97 ,240,45,87,0.517,40,72,0.556,5,15,0.333,18,22,0.818,113,37,78,0.474,34,68,0.5,3,10,0.3,20,24,0.833,97,2012-04-13,MIL,DET,2012,98.5
1986,1986,86,Home,W 113-100 ,240,48,90,0.533,37,72,0.514,11,18,0.611,6,6,1.0,113,40,80,0.5,31,62,0.5,9,18,0.5,11,15,0.733,100,2012-04-16,ORL,PHI,2012,104.5
1987,1987,87,@,W 113-112 ,240,43,79,0.544,31,60,0.517,12,19,0.632,15,20,0.75,113,41,76,0.539,26,53,0.491,15,23,0.652,15,23,0.652,112,2012-04-22,NYK,ATL,2012,119.5
1988,1988,88,Home,W 113-96 ,240,47,92,0.511,41,77,0.532,6,15,0.4,13,18,0.722,113,41,91,0.451,34,76,0.447,7,15,0.467,7,9,0.778,96,2012-04-26,SAC,LAL,2012,99.5
1989,1989,89,Home,W 113-94 ,240,38,89,0.427,32,75,0.427,6,14,0.429,31,42,0.738,113,32,85,0.376,21,63,0.333,11,22,0.5,19,26,0.731,94,2012-10-31,UTA,DAL,2013,99.5
1990,1990,90,@,W 113-110 ,240,45,89,0.506,35,68,0.515,10,21,0.476,13,20,0.65,113,36,80,0.45,24,46,0.522,12,34,0.353,26,33,0.788,110,2012-11-12,MIA,HOU,2013,116.0
1991,1991,91,@,L 113-117 ,240,41,77,0.532,31,56,0.554,10,21,0.476,21,22,0.955,113,43,93,0.462,30,68,0.441,13,25,0.52,18,24,0.75,117,2012-11-17,NOP,MIL,2013,123.5
1992,1992,92,Home,W 113-106 (OT),265,41,86,0.477,33,68,0.485,8,18,0.444,23,33,0.697,113,46,109,0.422,41,80,0.513,5,29,0.172,9,12,0.75,106,2012-11-21,MIA,MIL,2013,108.5
1993,1993,93,Home,W 113-97 ,240,44,81,0.543,37,66,0.561,7,15,0.467,18,22,0.818,113,29,65,0.446,17,39,0.436,12,26,0.462,27,39,0.692,97,2012-11-21,SAC,LAL,2013,103.0
1994,1994,94,@,W 113-111 ,240,41,85,0.482,31,62,0.5,10,23,0.435,21,22,0.955,113,38,78,0.487,26,58,0.448,12,20,0.6,23,32,0.719,111,2012-11-30,CLE,ATL,2013,117.0
1995,1995,95,@,W 113-103 ,240,43,86,0.5,35,63,0.556,8,23,0.348,19,20,0.95,113,36,86,0.419,30,69,0.435,6,17,0.353,25,39,0.641,103,2012-12-02,ORL,LAL,2013,106.0
1996,1996,96,Home,W 113-110 ,240,40,85,0.471,34,70,0.486,6,15,0.4,27,43,0.628,113,42,86,0.488,33,58,0.569,9,28,0.321,17,19,0.895,110,2012-12-03,DEN,TOR,2013,114.5
1997,1997,97,Home,W 113-90 ,240,43,75,0.573,29,46,0.63,14,29,0.483,13,23,0.565,113,34,79,0.43,28,58,0.483,6,21,0.286,16,20,0.8,90,2012-12-13,ATL,CHA,2013,93.0
1998,1998,98,@,W 113-102 ,240,47,88,0.534,40,71,0.563,7,17,0.412,12,17,0.706,113,42,78,0.538,31,54,0.574,11,24,0.458,7,10,0.7,102,2012-12-14,MIN,NOH,2013,107.5
1999,1999,99,Home,W 113-103 ,240,41,83,0.494,32,62,0.516,9,21,0.429,22,22,1.0,113,34,75,0.453,27,56,0.482,7,19,0.368,28,31,0.903,103,2012-12-14,OKC,SAC,2013,106.5
2000,2000,0,@,W 113-99 ,240,39,75,0.52,27,51,0.529,12,24,0.5,23,27,0.852,113,36,70,0.514,29,54,0.537,7,16,0.438,20,30,0.667,99,2012-12-18,TOR,CLE,2013,102.5
2001,2001,1,Home,L 113-115 (2OT),290,43,91,0.473,34,73,0.466,9,18,0.5,18,31,0.581,113,41,89,0.461,33,65,0.508,8,24,0.333,25,36,0.694,115,2013-01-04,WAS,BRK,2013,119.0
2002,2002,2,Home,W 113-93 ,240,44,85,0.518,37,61,0.607,7,24,0.292,18,21,0.857,113,36,90,0.4,30,71,0.423,6,19,0.316,15,23,0.652,93,2013-01-05,BRK,SAC,2013,96.0
2003,2003,3,@,W 113-81 ,240,39,80,0.488,28,60,0.467,11,20,0.55,24,27,0.889,113,28,76,0.368,23,55,0.418,5,21,0.238,20,23,0.87,81,2013-01-07,MEM,SAC,2013,83.5
2004,2004,4,Home,W 113-93 ,240,40,69,0.58,27,44,0.614,13,25,0.52,20,27,0.741,113,39,95,0.411,35,74,0.473,4,21,0.19,11,12,0.917,93,2013-01-13,LAL,CLE,2013,95.0
2005,2005,5,Home,W 113-98 ,240,46,77,0.597,40,64,0.625,6,13,0.462,15,16,0.938,113,35,85,0.412,29,65,0.446,6,20,0.3,22,29,0.759,98,2013-01-14,DAL,MIN,2013,101.0
2006,2006,6,Home,W 113-106 ,240,40,81,0.494,32,60,0.533,8,21,0.381,25,28,0.893,113,40,82,0.488,33,69,0.478,7,13,0.538,19,23,0.826,106,2013-01-15,BRK,TOR,2013,109.5
2007,2007,7,Home,W 113-108 ,240,45,86,0.523,39,71,0.549,6,15,0.4,17,22,0.773,113,43,92,0.467,29,64,0.453,14,28,0.5,8,13,0.615,108,2013-01-25,CLE,MIL,2013,115.0
2008,2008,8,@,W 113-107 ,240,43,89,0.483,34,66,0.515,9,23,0.391,18,24,0.75,113,42,91,0.462,36,73,0.493,6,18,0.333,17,18,0.944,107,2013-01-25,SAS,DAL,2013,110.0
2009,2009,9,Home,W 113-97 ,240,47,82,0.573,33,48,0.688,14,34,0.412,5,8,0.625,113,38,77,0.494,31,51,0.608,7,26,0.269,14,16,0.875,97,2013-01-30,NYK,ORL,2013,100.5
2010,2010,10,Home,W 113-98 ,240,44,84,0.524,37,62,0.597,7,22,0.318,18,22,0.818,113,38,72,0.528,34,59,0.576,4,13,0.308,18,21,0.857,98,2013-02-01,DEN,NOH,2013,100.0
2011,2011,11,Home,W 113-93 ,240,45,89,0.506,36,70,0.514,9,19,0.474,14,20,0.7,113,35,86,0.407,30,71,0.423,5,15,0.333,18,24,0.75,93,2013-02-02,GSW,PHO,2013,95.5
2012,2012,12,Home,W 113-111 (OT),265,43,91,0.473,33,72,0.458,10,19,0.526,17,23,0.739,113,46,96,0.479,39,76,0.513,7,20,0.35,12,18,0.667,111,2013-02-19,BRK,MIL,2013,114.5
2013,2013,13,Home,W 113-99 ,240,42,83,0.506,35,61,0.574,7,22,0.318,22,31,0.71,113,39,82,0.476,30,62,0.484,9,20,0.45,12,20,0.6,99,2013-02-20,LAL,BOS,2013,103.5
2014,2014,14,@,W 113-88 ,240,44,79,0.557,34,57,0.596,10,22,0.455,15,23,0.652,113,35,84,0.417,31,65,0.477,4,19,0.211,14,23,0.609,88,2013-02-22,BOS,PHO,2013,90.0
2015,2015,15,@,L 113-119 ,240,39,81,0.481,35,59,0.593,4,22,0.182,31,37,0.838,113,42,88,0.477,31,64,0.484,11,24,0.458,24,33,0.727,119,2013-02-22,DEN,WAS,2013,124.5
2016,2016,16,@,W 113-99 ,240,44,83,0.53,37,64,0.578,7,19,0.368,18,22,0.818,113,37,82,0.451,35,71,0.493,2,11,0.182,23,30,0.767,99,2013-02-23,DEN,CHA,2013,100.0
2017,2017,17,Home,L 113-120 ,240,39,85,0.459,27,54,0.5,12,31,0.387,23,28,0.821,113,46,85,0.541,38,69,0.551,8,16,0.5,20,32,0.625,120,2013-03-05,SAC,DEN,2013,124.0
2018,2018,18,Home,W 113-84 ,240,38,75,0.507,25,43,0.581,13,32,0.406,24,30,0.8,113,30,78,0.385,22,52,0.423,8,26,0.308,16,21,0.762,84,2013-03-09,NYK,UTA,2013,88.0
2019,2019,19,Home,L 113-115 ,240,44,94,0.468,38,72,0.528,6,22,0.273,19,25,0.76,113,40,87,0.46,33,68,0.485,7,19,0.368,28,38,0.737,115,2013-03-10,SAC,MIL,2013,118.5
2020,2020,20,@,W 113-95 ,240,43,83,0.518,35,67,0.522,8,16,0.5,19,22,0.864,113,34,76,0.447,31,62,0.5,3,14,0.214,24,30,0.8,95,2013-03-15,CHI,GSW,2013,96.5
2021,2021,21,@,L 113-119 ,240,43,85,0.506,36,70,0.514,7,15,0.467,20,31,0.645,113,45,78,0.577,39,61,0.639,6,17,0.353,23,29,0.793,119,2013-03-16,CLE,SAS,2013,122.0
2022,2022,22,Home,W 113-102 ,240,41,72,0.569,29,44,0.659,12,28,0.429,19,29,0.655,113,42,96,0.438,32,65,0.492,10,31,0.323,8,8,1.0,102,2013-03-17,LAL,SAC,2013,107.0
2023,2023,23,Home,L 113-127 ,240,42,75,0.56,34,54,0.63,8,21,0.381,21,29,0.724,113,51,89,0.573,38,67,0.567,13,22,0.591,12,14,0.857,127,2013-03-18,ATL,DAL,2013,133.5
2024,2024,24,@,W 113-96 ,240,45,89,0.506,38,68,0.559,7,21,0.333,16,21,0.762,113,40,80,0.5,33,61,0.541,7,19,0.368,9,15,0.6,96,2013-03-20,BRK,DAL,2013,99.5
2025,2025,25,Home,W 113-108 ,240,38,70,0.543,29,52,0.558,9,18,0.5,28,33,0.848,113,42,82,0.512,35,65,0.538,7,17,0.412,17,21,0.81,108,2013-03-24,DAL,UTA,2013,111.5
2026,2026,26,Home,W 113-103 ,240,45,93,0.484,38,74,0.514,7,19,0.368,16,22,0.727,113,34,77,0.442,29,57,0.509,5,20,0.25,30,39,0.769,103,2013-03-28,MIL,LAL,2013,105.5
2027,2027,27,@,W 113-95 ,240,43,76,0.566,33,55,0.6,10,21,0.476,17,22,0.773,113,34,89,0.382,30,75,0.4,4,14,0.286,23,26,0.885,95,2013-04-03,BRK,CLE,2013,97.0
2028,2028,28,@,W 113-96 ,240,41,73,0.562,34,55,0.618,7,18,0.389,24,32,0.75,113,39,84,0.464,33,64,0.516,6,20,0.3,12,18,0.667,96,2013-04-03,DEN,UTA,2013,99.0
2029,2029,29,Home,W 113-103 (OT),265,51,109,0.468,43,94,0.457,8,15,0.533,3,8,0.375,113,39,101,0.386,31,73,0.425,8,28,0.286,17,26,0.654,103,2013-04-10,ORL,MIL,2013,107.0
2030,2030,30,@,W 113-106 ,240,43,73,0.589,37,54,0.685,6,19,0.316,21,24,0.875,113,38,85,0.447,26,59,0.441,12,26,0.462,18,20,0.9,106,2013-04-10,LAL,POR,2013,112.0
2031,2031,31,Home,W 113-93 ,240,43,83,0.518,31,65,0.477,12,18,0.667,15,20,0.75,113,35,78,0.449,26,54,0.481,9,24,0.375,14,17,0.824,93,2013-04-12,DET,CHA,2013,97.5
2032,2032,32,@,W 113-96 ,240,40,78,0.513,30,51,0.588,10,27,0.37,23,27,0.852,113,35,88,0.398,26,60,0.433,9,28,0.321,17,23,0.739,96,2013-04-16,TOR,ATL,2013,100.5
2033,2033,33,Home,W 113-102 ,240,39,78,0.5,30,54,0.556,9,24,0.375,26,33,0.788,113,34,78,0.436,24,53,0.453,10,25,0.4,24,32,0.75,102,2013-10-30,DET,WAS,2014,107.0
2034,2034,34,@,W 113-98 ,240,44,103,0.427,30,81,0.37,14,22,0.636,11,15,0.733,113,36,99,0.364,30,81,0.37,6,18,0.333,20,34,0.588,98,2013-11-01,POR,DEN,2014,101.0
2035,2035,35,Home,W 113-105 ,240,34,73,0.466,23,44,0.523,11,29,0.379,34,51,0.667,113,38,100,0.38,29,73,0.397,9,27,0.333,20,25,0.8,105,2013-11-01,HOU,DAL,2014,109.5
2036,2036,36,@,W 113-90 ,240,44,90,0.489,34,70,0.486,10,20,0.5,15,19,0.789,113,35,92,0.38,25,66,0.379,10,26,0.385,10,18,0.556,90,2013-11-10,MIN,LAL,2014,95.0
2037,2037,37,Home,W 113-95 ,240,42,70,0.6,34,54,0.63,8,16,0.5,21,26,0.808,113,37,87,0.425,34,69,0.493,3,18,0.167,18,27,0.667,95,2013-11-12,GSW,DET,2014,96.5
2038,2038,38,Home,W 113-103 ,240,39,81,0.481,29,58,0.5,10,23,0.435,25,31,0.806,113,40,86,0.465,35,67,0.522,5,19,0.263,18,23,0.783,103,2013-11-15,ATL,PHI,2014,105.5
2039,2039,39,@,L 113-117 ,240,46,94,0.489,40,72,0.556,6,22,0.273,15,19,0.789,113,47,97,0.485,40,77,0.519,7,20,0.35,16,21,0.762,117,2013-11-15,MIN,DEN,2014,120.5
2040,2040,40,@,L 113-115 ,240,40,83,0.482,32,60,0.533,8,23,0.348,25,43,0.581,113,38,93,0.409,25,66,0.379,13,27,0.481,26,32,0.813,115,2013-11-18,DEN,OKC,2014,121.5
2041,2041,41,@,W 113-106 ,240,37,80,0.463,30,63,0.476,7,17,0.412,32,38,0.842,113,38,85,0.447,23,52,0.442,15,33,0.455,15,22,0.682,106,2013-11-20,SAC,PHO,2014,113.5
2042,2042,42,@,W 113-101 ,240,37,86,0.43,27,65,0.415,10,21,0.476,29,35,0.829,113,36,77,0.468,29,60,0.483,7,17,0.412,22,30,0.733,101,2013-11-23,POR,GSW,2014,104.5
2043,2043,43,Home,W 113-94 ,240,43,80,0.538,31,51,0.608,12,29,0.414,15,23,0.652,113,33,73,0.452,27,54,0.5,6,19,0.316,22,26,0.846,94,2013-11-25,DET,MIL,2014,97.0
2044,2044,44,Home,W 113-84 ,240,43,78,0.551,29,51,0.569,14,27,0.519,13,21,0.619,113,32,75,0.427,24,53,0.453,8,22,0.364,12,15,0.8,84,2013-11-27,HOU,ATL,2014,88.0
2045,2045,45,Home,W 113-112 (OT),265,36,92,0.391,30,74,0.405,6,18,0.333,35,42,0.833,113,42,95,0.442,34,69,0.493,8,26,0.308,20,29,0.69,112,2013-11-29,OKC,GSW,2014,116.0
2046,2046,46,Home,W 113-103 ,240,49,87,0.563,40,68,0.588,9,19,0.474,6,9,0.667,113,37,89,0.416,28,60,0.467,9,29,0.31,20,26,0.769,103,2013-12-01,OKC,MIN,2014,107.5
2047,2047,47,Home,L 113-115 ,240,40,76,0.526,31,57,0.544,9,19,0.474,24,28,0.857,113,42,82,0.512,27,57,0.474,15,25,0.6,16,22,0.727,115,2013-12-01,SAC,GSW,2014,122.5
2048,2048,48,@,W 113-83 ,240,44,77,0.571,28,50,0.56,16,27,0.593,9,11,0.818,113,29,73,0.397,25,57,0.439,4,16,0.25,21,31,0.677,83,2013-12-05,NYK,BRK,2014,85.0
2049,2049,49,@,W 113-97 ,240,39,69,0.565,30,48,0.625,9,21,0.429,26,31,0.839,113,40,81,0.494,37,67,0.552,3,14,0.214,14,20,0.7,97,2013-12-14,LAC,WAS,2014,98.5
2050,2050,50,@,W 113-107 ,240,38,88,0.432,26,68,0.382,12,20,0.6,25,30,0.833,113,39,74,0.527,30,53,0.566,9,21,0.429,20,24,0.833,107,2013-12-18,WAS,BRK,2014,111.5
2051,2051,51,@,W 113-100 ,240,43,88,0.489,31,61,0.508,12,27,0.444,15,18,0.833,113,35,82,0.427,26,63,0.413,9,19,0.474,21,26,0.808,100,2013-12-21,OKC,SAS,2014,104.5
2052,2052,52,@,W 113-100 ,240,41,83,0.494,33,66,0.5,8,17,0.471,23,27,0.852,113,31,74,0.419,24,57,0.421,7,17,0.412,31,42,0.738,100,2013-12-23,NOP,SAC,2014,103.5
2053,2053,53,Home,W 113-92 ,240,40,78,0.513,31,58,0.534,9,20,0.45,24,28,0.857,113,37,84,0.44,32,69,0.464,5,15,0.333,13,15,0.867,92,2013-12-31,SAS,BRK,2014,94.5
2054,2054,54,@,W 113-104 ,240,42,90,0.467,37,71,0.521,5,19,0.263,24,31,0.774,113,35,83,0.422,28,60,0.467,7,23,0.304,27,37,0.73,104,2014-01-02,PHI,SAC,2014,107.5
2055,2055,55,@,W 113-103 ,240,45,83,0.542,36,68,0.529,9,15,0.6,14,23,0.609,113,42,92,0.457,36,75,0.48,6,17,0.353,13,19,0.684,103,2014-01-04,CHA,SAC,2014,106.0
2056,2056,56,Home,W 113-99 ,240,39,86,0.453,32,58,0.552,7,28,0.25,28,50,0.56,113,36,88,0.409,29,64,0.453,7,24,0.292,20,25,0.8,99,2014-01-08,HOU,LAL,2014,102.5
2057,2057,57,@,W 113-102 ,240,45,83,0.542,38,69,0.551,7,14,0.5,16,20,0.8,113,39,81,0.481,30,61,0.492,9,20,0.45,15,27,0.556,102,2014-01-10,CLE,UTA,2014,106.5
2058,2058,58,@,L 113-126 ,240,44,97,0.454,36,72,0.5,8,25,0.32,17,22,0.773,113,45,86,0.523,29,53,0.547,16,33,0.485,20,24,0.833,126,2014-01-20,POR,HOU,2014,134.0
2059,2059,59,@,W 113-111 (OT),265,41,89,0.461,26,55,0.473,15,34,0.441,16,23,0.696,113,42,94,0.447,35,72,0.486,7,22,0.318,20,27,0.741,111,2014-01-22,BOS,WAS,2014,114.5
2060,2060,60,Home,W 113-101 ,240,43,74,0.581,35,55,0.636,8,19,0.421,19,20,0.95,113,38,76,0.5,32,54,0.593,6,22,0.273,19,23,0.826,101,2014-01-26,MIA,SAS,2014,104.0
2061,2061,61,Home,L 113-124 ,240,40,87,0.46,32,67,0.478,8,20,0.4,25,26,0.962,113,43,80,0.538,34,60,0.567,9,20,0.45,29,35,0.829,124,2014-01-27,PHI,PHO,2014,128.5
2062,2062,62,Home,W 113-102 ,240,43,83,0.518,36,67,0.537,7,16,0.438,20,25,0.8,113,39,87,0.448,29,66,0.439,10,21,0.476,14,24,0.583,102,2014-01-31,ORL,MIL,2014,107.0
2063,2063,63,@,L 113-120 ,240,37,84,0.44,31,68,0.456,6,16,0.375,33,39,0.846,113,43,92,0.467,34,69,0.493,9,23,0.391,25,30,0.833,120,2014-02-01,MIN,ATL,2014,124.5
2064,2064,64,Home,W 113-96 ,240,41,92,0.446,34,67,0.507,7,25,0.28,24,40,0.6,113,38,89,0.427,33,68,0.485,5,21,0.238,15,23,0.652,96,2014-02-01,DET,PHI,2014,98.5
2065,2065,65,@,L 113-118 (OT),265,45,104,0.433,38,84,0.452,7,20,0.35,16,20,0.8,113,42,92,0.457,37,79,0.468,5,13,0.385,29,35,0.829,118,2014-02-07,POR,IND,2014,120.5
2066,2066,66,Home,L 113-115 ,240,43,85,0.506,32,65,0.492,11,20,0.55,16,23,0.696,113,40,77,0.519,34,62,0.548,6,15,0.4,29,33,0.879,115,2014-02-07,WAS,CLE,2014,118.0
2067,2067,67,Home,W 113-112 ,240,34,64,0.531,24,42,0.571,10,22,0.455,35,47,0.745,113,44,97,0.454,28,65,0.431,16,32,0.5,8,16,0.5,112,2014-02-12,HOU,WAS,2014,120.0
2068,2068,68,@,W 113-103 ,240,44,88,0.5,35,68,0.515,9,20,0.45,16,21,0.762,113,35,81,0.432,29,60,0.483,6,21,0.286,27,38,0.711,103,2014-02-18,SAS,LAC,2014,106.0
2069,2069,69,@,W 113-102 ,240,44,90,0.489,36,67,0.537,8,23,0.348,17,22,0.773,113,40,82,0.488,38,71,0.535,2,11,0.182,20,30,0.667,102,2014-02-22,DAL,DET,2014,103.0
2070,2070,70,Home,W 113-107 ,240,38,77,0.494,28,55,0.509,10,22,0.455,27,32,0.844,113,41,80,0.513,31,64,0.484,10,16,0.625,15,20,0.75,107,2014-02-28,OKC,MEM,2014,112.0
2071,2071,71,Home,W 113-107 ,240,45,85,0.529,35,63,0.556,10,22,0.455,13,21,0.619,113,36,75,0.48,26,54,0.481,10,21,0.476,25,28,0.893,107,2014-03-09,GSW,PHO,2014,112.0
2072,2072,72,@,L 113-118 (OT),265,39,96,0.406,30,71,0.423,9,25,0.36,26,33,0.788,113,38,89,0.427,29,60,0.483,9,29,0.31,33,45,0.733,118,2014-03-09,POR,HOU,2014,122.5
2073,2073,73,Home,W 113-104 ,240,40,78,0.513,31,56,0.554,9,22,0.409,24,29,0.828,113,37,75,0.493,28,52,0.538,9,23,0.391,21,28,0.75,104,2014-03-16,MIA,HOU,2014,108.5
2074,2074,74,@,W 113-112 ,240,42,88,0.477,31,58,0.534,11,30,0.367,18,22,0.818,113,37,88,0.42,25,60,0.417,12,28,0.429,26,30,0.867,112,2014-03-16,GSW,POR,2014,118.0
2075,2075,75,Home,L 113-121 ,240,42,85,0.494,35,62,0.565,7,23,0.304,22,25,0.88,113,38,75,0.507,27,52,0.519,11,23,0.478,34,38,0.895,121,2014-03-16,TOR,PHO,2014,126.5
2076,2076,76,@,L 113-118 (OT),265,40,81,0.494,33,57,0.579,7,24,0.292,26,29,0.897,113,40,94,0.426,29,60,0.483,11,34,0.324,27,31,0.871,118,2014-03-18,TOR,ATL,2014,123.5
2077,2077,77,Home,W 113-91 ,240,44,79,0.557,31,52,0.596,13,27,0.481,12,16,0.75,113,36,88,0.409,25,55,0.455,11,33,0.333,8,18,0.444,91,2014-03-24,SAS,PHI,2014,96.5
2078,2078,78,@,W 113-107 ,240,41,82,0.5,27,53,0.509,14,29,0.483,17,20,0.85,113,39,91,0.429,33,64,0.516,6,27,0.222,23,29,0.793,107,2014-04-03,DAL,LAC,2014,110.0
2079,2079,79,Home,W 113-108 ,240,43,79,0.544,40,67,0.597,3,12,0.25,24,38,0.632,113,40,86,0.465,31,62,0.5,9,24,0.375,19,26,0.731,108,2014-04-14,PHI,BOS,2014,112.5
2080,2080,80,@,W 113-100 ,240,45,91,0.495,34,64,0.531,11,27,0.407,12,17,0.706,113,41,99,0.414,31,69,0.449,10,30,0.333,8,10,0.8,100,2014-04-16,LAL,SAS,2014,105.0
2081,2081,81,@,L 113-118 ,240,45,102,0.441,34,71,0.479,11,31,0.355,12,16,0.75,113,44,82,0.537,30,57,0.526,14,25,0.56,16,20,0.8,118,2014-11-03,BOS,DAL,2015,125.0
2082,2082,82,@,W 113-100 ,240,46,93,0.495,36,68,0.529,10,25,0.4,11,15,0.733,113,38,70,0.543,31,50,0.62,7,20,0.35,17,20,0.85,100,2014-11-11,SAS,GSW,2015,103.5
2083,2083,83,Home,L 113-130 ,240,39,90,0.433,31,67,0.463,8,23,0.348,27,33,0.818,113,45,88,0.511,29,55,0.527,16,33,0.485,24,29,0.828,130,2014-11-12,DEN,POR,2015,138.0
2084,2084,84,@,W 113-101 ,240,43,89,0.483,30,61,0.492,13,28,0.464,14,19,0.737,113,36,81,0.444,30,69,0.435,6,12,0.5,23,30,0.767,101,2014-11-12,HOU,MIN,2015,104.0
2085,2085,85,@,L 113-117 ,240,44,80,0.55,33,55,0.6,11,25,0.44,14,19,0.737,113,43,78,0.551,34,61,0.557,9,17,0.529,22,27,0.815,117,2014-11-18,NYK,MIL,2015,121.5
2086,2086,86,@,W 113-101 ,240,40,81,0.494,32,55,0.582,8,26,0.308,25,30,0.833,113,37,90,0.411,31,73,0.425,6,17,0.353,21,27,0.778,101,2014-11-22,SAC,MIN,2015,104.0
2087,2087,87,@,W 113-92 ,240,45,88,0.511,30,56,0.536,15,32,0.469,8,10,0.8,113,31,75,0.413,29,55,0.527,2,20,0.1,28,35,0.8,92,2014-11-24,LAC,CHO,2015,93.0
2088,2088,88,Home,W 113-87 ,240,38,74,0.514,32,54,0.593,6,20,0.3,31,38,0.816,113,33,71,0.465,28,58,0.483,5,13,0.385,16,22,0.727,87,2014-11-26,CLE,WAS,2015,89.5
2089,2089,89,Home,W 113-96 ,240,46,90,0.511,38,70,0.543,8,20,0.4,13,22,0.591,113,38,92,0.413,32,76,0.421,6,16,0.375,14,19,0.737,96,2014-12-05,BOS,LAL,2015,99.0
2090,2090,90,@,W 113-109 (OT),265,38,95,0.4,23,51,0.451,15,44,0.341,22,31,0.71,113,39,84,0.464,31,66,0.47,8,18,0.444,23,34,0.676,109,2014-12-11,HOU,SAC,2015,113.0
2091,2091,91,Home,W 113-107 (2OT),290,39,85,0.459,33,72,0.458,6,13,0.462,29,38,0.763,113,41,98,0.418,35,81,0.432,6,17,0.353,19,27,0.704,107,2014-12-12,MEM,CHO,2015,110.0
2092,2092,92,Home,W 113-91 ,240,43,80,0.538,31,56,0.554,12,24,0.5,15,20,0.75,113,35,83,0.422,27,56,0.482,8,27,0.296,13,22,0.591,91,2014-12-15,LAC,DET,2015,95.0
2093,2093,93,Home,W 113-93 ,240,42,86,0.488,32,62,0.516,10,24,0.417,19,25,0.76,113,36,92,0.391,31,76,0.408,5,16,0.313,16,21,0.762,93,2014-12-25,CHI,LAL,2015,95.5
2094,2094,94,@,W 113-111 ,240,46,96,0.479,41,70,0.586,5,26,0.192,16,19,0.842,113,44,92,0.478,37,75,0.493,7,17,0.412,16,19,0.842,111,2015-01-07,PHO,MIN,2015,114.5
2095,2095,95,@,W 113-99 ,240,41,86,0.477,25,46,0.543,16,40,0.4,15,20,0.75,113,39,84,0.464,34,63,0.54,5,21,0.238,16,18,0.889,99,2015-01-12,HOU,BRK,2015,101.5
2096,2096,96,@,L 113-120 ,240,42,83,0.506,33,57,0.579,9,26,0.346,20,23,0.87,113,44,90,0.489,35,64,0.547,9,26,0.346,23,26,0.885,120,2015-01-14,HOU,ORL,2015,124.5
2097,2097,97,@,W 113-105 ,240,43,80,0.538,35,61,0.574,8,19,0.421,19,21,0.905,113,38,92,0.413,28,61,0.459,10,31,0.323,19,22,0.864,105,2015-01-17,MIN,DEN,2015,110.0
2098,2098,98,@,L 113-126 ,240,37,87,0.425,24,55,0.436,13,32,0.406,26,31,0.839,113,49,98,0.5,36,69,0.522,13,29,0.448,15,18,0.833,126,2015-01-21,HOU,GSW,2015,132.5
2099,2099,99,@,L 113-118 ,240,39,87,0.448,26,55,0.473,13,32,0.406,22,28,0.786,113,47,92,0.511,38,65,0.585,9,27,0.333,15,24,0.625,118,2015-01-21,POR,PHO,2015,122.5
2100,2100,0,Home,W 113-106 ,240,43,91,0.473,33,66,0.5,10,25,0.4,17,21,0.81,113,44,87,0.506,37,60,0.617,7,27,0.259,11,19,0.579,106,2015-01-23,NYK,ORL,2015,109.5
2101,2101,1,@,W 113-111 ,240,44,84,0.524,34,57,0.596,10,27,0.37,15,20,0.75,113,42,91,0.462,32,61,0.525,10,30,0.333,17,24,0.708,111,2015-01-23,HOU,PHO,2015,116.0
2102,2102,2,@,W 113-111 (OT),265,42,98,0.429,34,69,0.493,8,29,0.276,21,23,0.913,113,48,113,0.425,39,80,0.488,9,33,0.273,6,12,0.5,111,2015-01-27,CHI,GSW,2015,115.5
2103,2103,3,Home,W 113-102 ,240,38,82,0.463,26,49,0.531,12,33,0.364,25,26,0.962,113,39,87,0.448,30,63,0.476,9,24,0.375,15,18,0.833,102,2015-01-28,ATL,BRK,2015,106.5
2104,2104,4,Home,W 113-105 (OT),265,41,82,0.5,30,56,0.536,11,26,0.423,20,22,0.909,113,39,93,0.419,30,65,0.462,9,28,0.321,18,25,0.72,105,2015-02-04,MIL,LAL,2015,109.5
2105,2105,5,Home,L 113-116 ,240,40,89,0.449,32,65,0.492,8,24,0.333,25,28,0.893,113,40,83,0.482,29,63,0.46,11,20,0.55,25,30,0.833,116,2015-02-06,OKC,NOP,2015,121.5
2106,2106,6,Home,W 113-93 ,240,44,78,0.564,34,53,0.642,10,25,0.4,15,19,0.789,113,34,84,0.405,25,60,0.417,9,24,0.375,16,20,0.8,93,2015-02-11,CLE,MIA,2015,97.5
2107,2107,7,Home,W 113-98 ,240,42,92,0.457,33,69,0.478,9,23,0.391,20,26,0.769,113,37,85,0.435,29,54,0.537,8,31,0.258,16,22,0.727,98,2015-02-12,CHI,CLE,2015,102.0
2108,2108,8,Home,W 113-102 ,240,39,94,0.415,27,56,0.482,12,38,0.316,23,34,0.676,113,31,93,0.333,26,75,0.347,5,18,0.278,35,39,0.897,102,2015-02-23,HOU,MIN,2015,104.5
2109,2109,9,@,L 113-117 (OT),265,39,101,0.386,31,77,0.403,8,24,0.333,27,30,0.9,113,48,97,0.495,39,71,0.549,9,26,0.346,12,21,0.571,117,2015-02-26,OKC,PHO,2015,121.5
2110,2110,10,@,W 113-89 ,240,42,87,0.483,29,59,0.492,13,28,0.464,16,19,0.842,113,31,77,0.403,27,55,0.491,4,22,0.182,23,28,0.821,89,2015-02-27,GSW,TOR,2015,91.0
2111,2111,11,@,L 113-121 ,240,43,88,0.489,29,61,0.475,14,27,0.519,13,17,0.765,113,46,85,0.541,42,78,0.538,4,7,0.571,25,31,0.806,121,2015-03-07,POR,MIN,2015,123.0
2112,2112,12,@,W 113-106 ,240,40,85,0.471,32,65,0.492,8,20,0.4,25,30,0.833,113,42,93,0.452,36,75,0.48,6,18,0.333,16,26,0.615,106,2015-03-11,SAC,CHO,2015,109.0
2113,2113,13,Home,W 113-99 ,240,44,101,0.436,33,77,0.429,11,24,0.458,14,14,1.0,113,34,78,0.436,31,66,0.47,3,12,0.25,28,31,0.903,99,2015-03-13,OKC,MIN,2015,100.5
2114,2114,14,Home,W 113-97 ,240,43,81,0.531,30,55,0.545,13,26,0.5,14,17,0.824,113,35,77,0.455,29,58,0.5,6,19,0.316,21,28,0.75,97,2015-03-14,WAS,SAC,2015,100.0
2115,2115,15,@,W 113-97 ,240,45,86,0.523,32,57,0.561,13,29,0.448,10,16,0.625,113,37,78,0.474,32,60,0.533,5,18,0.278,18,23,0.783,97,2015-03-15,POR,TOR,2015,99.5
2116,2116,16,Home,W 113-99 ,240,45,86,0.523,33,63,0.524,12,23,0.522,11,17,0.647,113,37,86,0.43,31,67,0.463,6,19,0.316,19,23,0.826,99,2015-03-20,LAC,WAS,2015,102.0
2117,2117,17,@,W 113-111 (OT),265,40,82,0.488,30,61,0.492,10,21,0.476,23,30,0.767,113,39,96,0.406,29,66,0.439,10,30,0.333,23,38,0.605,111,2015-03-30,LAL,PHI,2015,116.0
2118,2118,18,@,W 113-92 ,240,44,78,0.564,35,62,0.565,9,16,0.563,16,21,0.762,113,37,83,0.446,32,67,0.478,5,16,0.313,13,21,0.619,92,2015-04-01,NOP,LAL,2015,94.5
2119,2119,19,@,W 113-99 ,240,42,76,0.553,29,46,0.63,13,30,0.433,16,23,0.696,113,41,77,0.532,36,63,0.571,5,14,0.357,12,19,0.632,99,2015-04-01,TOR,MIN,2015,101.5
2120,2120,20,@,W 113-88 ,240,47,89,0.528,37,65,0.569,10,24,0.417,9,13,0.692,113,34,84,0.405,29,65,0.446,5,19,0.263,15,28,0.536,88,2015-04-07,SAS,OKC,2015,90.5
2121,2121,21,@,W 113-103 ,240,36,80,0.45,28,52,0.538,8,28,0.286,33,34,0.971,113,45,84,0.536,38,66,0.576,7,18,0.389,6,10,0.6,103,2015-04-08,BOS,DET,2015,106.5
2122,2122,22,@,W 113-86 ,240,44,88,0.5,32,58,0.552,12,30,0.4,13,17,0.765,113,32,87,0.368,29,75,0.387,3,12,0.25,19,22,0.864,86,2015-04-13,CHI,BRK,2015,87.5
2123,2123,23,Home,W 113-108 (OT),265,43,91,0.473,27,61,0.443,16,30,0.533,11,17,0.647,113,42,97,0.433,34,75,0.453,8,22,0.364,16,21,0.762,108,2015-04-15,CLE,WAS,2015,112.0
2124,2124,24,Home,L 113-138 ,240,39,84,0.464,33,65,0.508,6,19,0.316,29,35,0.829,113,52,95,0.547,40,67,0.597,12,28,0.429,22,31,0.71,138,2015-04-15,MIN,OKC,2015,144.0
2125,2125,25,@,W 113-103 ,240,36,82,0.439,25,56,0.446,11,26,0.423,30,35,0.857,113,32,85,0.376,25,59,0.424,7,26,0.269,32,41,0.78,103,2015-10-30,TOR,BOS,2016,106.5
2126,2126,26,Home,L 113-118 ,240,42,82,0.512,35,58,0.603,7,24,0.292,22,28,0.786,113,35,68,0.515,23,47,0.489,12,21,0.571,36,44,0.818,118,2015-10-30,MIL,WAS,2016,124.0
2127,2127,27,@,W 113-101 ,240,46,82,0.561,39,67,0.582,7,15,0.467,14,18,0.778,113,39,88,0.443,30,66,0.455,9,22,0.409,14,23,0.609,101,2015-11-11,SAS,POR,2016,105.5
2128,2128,28,Home,W 113-88 ,240,40,81,0.494,28,56,0.5,12,25,0.48,21,22,0.955,113,32,79,0.405,24,53,0.453,8,26,0.308,16,22,0.727,88,2015-11-20,CHA,PHI,2016,92.0
2129,2129,29,@,W 113-104 ,240,43,90,0.478,41,80,0.513,2,10,0.2,25,26,0.962,113,35,81,0.432,26,54,0.481,9,27,0.333,25,33,0.758,104,2015-12-01,MEM,NOP,2016,108.5
2130,2130,30,@,L 113-120 ,240,46,98,0.469,36,72,0.5,10,26,0.385,11,13,0.846,113,36,78,0.462,20,44,0.455,16,34,0.471,32,43,0.744,120,2015-12-05,SAC,HOU,2016,128.0
2131,2131,31,Home,W 113-95 ,240,41,89,0.461,31,62,0.5,10,27,0.37,21,25,0.84,113,40,85,0.471,36,72,0.5,4,13,0.308,11,20,0.55,95,2015-12-15,LAL,MIL,2016,97.0
2132,2132,32,Home,W 113-98 ,240,43,77,0.558,29,53,0.547,14,24,0.583,13,15,0.867,113,36,79,0.456,22,45,0.489,14,34,0.412,12,15,0.8,98,2015-12-16,ORL,CHO,2016,105.0
2133,2133,33,Home,W 113-99 ,240,46,89,0.517,34,64,0.531,12,25,0.48,9,16,0.563,113,36,79,0.456,34,66,0.515,2,13,0.154,25,32,0.781,99,2015-12-21,BOS,MIN,2016,100.0
2134,2134,34,Home,W 113-99 ,240,42,83,0.506,28,59,0.475,14,24,0.583,15,17,0.882,113,37,91,0.407,30,69,0.435,7,22,0.318,18,22,0.818,99,2015-12-21,WAS,SAC,2016,102.5
2135,2135,35,Home,W 113-100 ,240,51,85,0.6,46,73,0.63,5,12,0.417,6,8,0.75,113,37,81,0.457,30,61,0.492,7,20,0.35,19,29,0.655,100,2015-12-23,MIL,PHI,2016,103.5
2136,2136,36,Home,L 113-115 ,240,42,92,0.457,29,61,0.475,13,31,0.419,16,19,0.842,113,42,82,0.512,33,61,0.541,9,21,0.429,22,25,0.88,115,2016-01-03,TOR,CHI,2016,119.5
2137,2137,37,Home,L 113-117 ,240,40,84,0.476,31,58,0.534,9,26,0.346,24,25,0.96,113,45,89,0.506,40,72,0.556,5,17,0.294,22,26,0.846,117,2016-01-08,LAL,OKC,2016,119.5
2138,2138,38,Home,W 113-93 ,240,47,89,0.528,42,66,0.636,5,23,0.217,14,22,0.636,113,34,85,0.4,29,73,0.397,5,12,0.417,20,23,0.87,93,2016-01-15,OKC,MIN,2016,95.5
2139,2139,39,Home,W 113-95 ,240,47,101,0.465,39,78,0.5,8,23,0.348,11,20,0.55,113,34,94,0.362,24,69,0.348,10,25,0.4,17,23,0.739,95,2016-01-16,DET,GSW,2016,100.0
2140,2140,40,@,L 113-118 (OT),265,40,94,0.426,28,64,0.438,12,30,0.4,21,26,0.808,113,40,93,0.43,24,59,0.407,16,34,0.471,22,24,0.917,118,2016-01-18,BOS,DAL,2016,126.0
2141,2141,41,@,L 113-119 (2OT),290,45,102,0.441,35,74,0.473,10,28,0.357,13,25,0.52,113,43,97,0.443,35,77,0.455,8,20,0.4,25,30,0.833,119,2016-01-18,PHI,NYK,2016,123.0
2142,2142,42,Home,W 113-103 ,240,39,81,0.481,28,53,0.528,11,28,0.393,24,36,0.667,113,39,83,0.47,33,64,0.516,6,19,0.316,19,28,0.679,103,2016-01-26,PHI,PHO,2016,106.0
2143,2143,43,Home,L 113-117 ,240,39,88,0.443,28,60,0.467,11,28,0.393,24,30,0.8,113,41,81,0.506,32,63,0.508,9,18,0.5,26,33,0.788,117,2016-01-28,WAS,DEN,2016,121.5
2144,2144,44,Home,W 113-94 ,240,43,86,0.5,33,62,0.532,10,24,0.417,17,21,0.81,113,32,79,0.405,25,59,0.424,7,20,0.35,23,29,0.793,94,2016-01-29,BOS,ORL,2016,97.5
2145,2145,45,@,W 113-90 ,240,43,90,0.478,30,57,0.526,13,33,0.394,14,15,0.933,113,38,86,0.442,33,72,0.458,5,14,0.357,9,12,0.75,90,2016-02-10,ATL,CHI,2016,92.5
2146,2146,46,Home,L 113-119 ,240,40,81,0.494,30,59,0.508,10,22,0.455,23,26,0.885,113,48,88,0.545,42,76,0.553,6,12,0.5,17,18,0.944,119,2016-02-19,LAL,SAS,2016,122.0
2147,2147,47,Home,W 113-99 ,240,39,79,0.494,28,48,0.583,11,31,0.355,24,34,0.706,113,32,80,0.4,23,51,0.451,9,29,0.31,26,30,0.867,99,2016-02-28,WAS,CLE,2016,103.5
2148,2148,48,@,W 113-107 ,240,38,78,0.487,25,49,0.51,13,29,0.448,24,37,0.649,113,37,77,0.481,25,44,0.568,12,33,0.364,21,27,0.778,107,2016-03-06,HOU,TOR,2016,113.0
2149,2149,49,@,L 113-119 ,240,40,90,0.444,35,69,0.507,5,21,0.238,28,34,0.824,113,42,84,0.5,26,49,0.531,16,35,0.457,19,27,0.704,119,2016-03-07,ORL,GSW,2016,127.0
2150,2150,50,@,L 113-122 ,240,40,85,0.471,30,52,0.577,10,33,0.303,23,28,0.821,113,38,82,0.463,23,47,0.489,15,35,0.429,31,38,0.816,122,2016-03-09,NOP,CHO,2016,129.5
2151,2151,51,Home,W 113-102 ,240,40,82,0.488,36,67,0.537,4,15,0.267,29,36,0.806,113,31,66,0.47,19,36,0.528,12,30,0.4,28,39,0.718,102,2016-03-19,MEM,LAC,2016,108.0
2152,2152,52,@,W 113-99 ,240,44,88,0.5,41,69,0.594,3,19,0.158,22,27,0.815,113,34,87,0.391,27,71,0.38,7,16,0.438,24,30,0.8,99,2016-03-22,MIA,NOP,2016,102.5
2153,2153,53,Home,W 113-104 ,240,40,83,0.482,30,49,0.612,10,34,0.294,23,27,0.852,113,43,80,0.538,36,64,0.563,7,16,0.438,11,15,0.733,104,2016-03-23,CLE,MIL,2016,107.5
2154,2154,54,Home,W 113-104 ,240,45,80,0.563,40,67,0.597,5,13,0.385,18,32,0.563,113,42,91,0.462,34,71,0.479,8,20,0.4,12,23,0.522,104,2016-03-23,MIN,SAC,2016,108.0
2155,2155,55,Home,W 113-91 ,240,45,83,0.542,36,61,0.59,9,22,0.409,14,22,0.636,113,35,73,0.479,30,51,0.588,5,22,0.227,16,23,0.696,91,2016-03-24,OKC,UTA,2016,93.5
2156,2156,56,Home,W 113-110 ,240,47,86,0.547,43,69,0.623,4,17,0.235,15,25,0.6,113,46,86,0.535,38,62,0.613,8,24,0.333,10,12,0.833,110,2016-04-01,MIL,ORL,2016,114.0
2157,2157,57,Home,W 113-99 ,240,41,83,0.494,27,46,0.587,14,37,0.378,17,20,0.85,113,39,92,0.424,29,67,0.433,10,25,0.4,11,20,0.55,99,2016-04-08,CHA,BRK,2016,104.0
2158,2158,58,Home,W 113-98 ,240,42,80,0.525,33,59,0.559,9,21,0.429,20,28,0.714,113,28,81,0.346,16,48,0.333,12,33,0.364,30,35,0.857,98,2016-04-10,WAS,CHO,2016,104.0
2159,2159,59,Home,W 113-104 ,240,39,75,0.52,26,56,0.464,13,19,0.684,22,22,1.0,113,40,82,0.488,32,58,0.552,8,24,0.333,16,16,1.0,104,2016-10-25,POR,UTA,2017,108.0
2160,2160,60,@,W 113-94 ,240,44,86,0.512,38,65,0.585,6,21,0.286,19,26,0.731,113,36,77,0.468,32,61,0.525,4,16,0.25,18,27,0.667,94,2016-10-26,SAC,PHO,2017,96.0
2161,2161,61,Home,W 113-110 (OT),265,40,96,0.417,35,75,0.467,5,21,0.238,28,38,0.737,113,42,94,0.447,37,66,0.561,5,28,0.179,21,32,0.656,110,2016-10-28,OKC,PHO,2017,112.5
2162,2162,62,Home,L 113-115 (OT),265,38,100,0.38,32,77,0.416,6,23,0.261,31,39,0.795,113,45,98,0.459,35,66,0.53,10,32,0.313,15,21,0.714,115,2016-10-29,DEN,POR,2017,120.0
2163,2163,63,Home,W 113-96 ,240,45,95,0.474,36,69,0.522,9,26,0.346,14,17,0.824,113,35,87,0.402,28,55,0.509,7,32,0.219,19,24,0.792,96,2016-10-30,OKC,LAL,2017,99.5
2164,2164,64,Home,L 113-117 ,240,36,82,0.439,27,56,0.482,9,26,0.346,32,41,0.78,113,44,91,0.484,34,59,0.576,10,32,0.313,19,21,0.905,117,2016-11-01,NOP,MIL,2017,122.0
2165,2165,65,@,W 113-103 ,240,43,77,0.558,33,52,0.635,10,25,0.4,17,25,0.68,113,42,72,0.583,39,62,0.629,3,10,0.3,16,24,0.667,103,2016-11-02,TOR,WAS,2017,104.5
2166,2166,66,@,W 113-111 ,240,43,90,0.478,37,68,0.544,6,22,0.273,21,22,0.955,113,38,93,0.409,21,52,0.404,17,41,0.415,18,24,0.75,111,2016-11-11,TOR,CHO,2017,119.5
2167,2167,67,@,W 113-88 ,240,41,98,0.418,34,78,0.436,7,20,0.35,24,28,0.857,113,34,95,0.358,25,61,0.41,9,34,0.265,11,18,0.611,88,2016-11-15,CHI,POR,2017,92.5
2168,2168,68,@,W 113-111 (OT),265,43,94,0.457,35,71,0.493,8,23,0.348,19,31,0.613,113,39,83,0.47,35,58,0.603,4,25,0.16,29,39,0.744,111,2016-11-18,TOR,DEN,2017,113.0
2169,2169,69,Home,W 113-101 ,240,45,82,0.549,36,58,0.621,9,24,0.375,14,20,0.7,113,33,88,0.375,21,54,0.389,12,34,0.353,23,26,0.885,101,2016-11-18,NOP,POR,2017,107.0
2170,2170,70,Home,W 113-111 (OT),265,45,97,0.464,34,69,0.493,11,28,0.393,12,13,0.923,113,43,93,0.462,35,64,0.547,8,29,0.276,17,27,0.63,111,2016-11-25,NYK,CHO,2017,115.0
2171,2171,71,@,W 113-94 ,240,42,89,0.472,29,58,0.5,13,31,0.419,16,24,0.667,113,28,69,0.406,19,45,0.422,9,24,0.375,29,39,0.744,94,2016-12-01,LAC,CLE,2017,98.5
2172,2172,72,Home,W 113-80 ,240,45,83,0.542,33,54,0.611,12,29,0.414,11,13,0.846,113,32,93,0.344,26,67,0.388,6,26,0.231,10,17,0.588,80,2016-12-02,TOR,LAL,2017,83.0
2173,2173,73,Home,L 113-118 ,240,40,81,0.494,29,54,0.537,11,27,0.407,22,30,0.733,113,45,92,0.489,31,58,0.534,14,34,0.412,14,18,0.778,118,2016-12-05,BRK,WAS,2017,125.0
2174,2174,74,Home,L 113-121 ,240,43,88,0.489,32,61,0.525,11,27,0.407,16,24,0.667,113,47,83,0.566,39,64,0.609,8,19,0.421,19,25,0.76,121,2016-12-10,ORL,DEN,2017,125.0
2175,2175,75,@,W 113-109 ,240,42,95,0.442,28,61,0.459,14,34,0.412,15,19,0.789,113,39,82,0.476,25,47,0.532,14,35,0.4,17,21,0.81,109,2016-12-13,GSW,NOP,2017,116.0
2176,2176,76,Home,W 113-111 (OT),265,38,93,0.409,29,63,0.46,9,30,0.3,28,33,0.848,113,38,97,0.392,31,77,0.403,7,20,0.35,28,38,0.737,111,2016-12-13,PHO,NYK,2017,114.5
2177,2177,77,@,W 113-108 ,240,37,74,0.5,24,49,0.49,13,25,0.52,26,37,0.703,113,42,89,0.472,28,56,0.5,14,33,0.424,10,20,0.5,108,2016-12-14,LAC,ORL,2017,115.0
2178,2178,78,Home,W 113-100 ,240,42,86,0.488,31,64,0.484,11,22,0.5,18,22,0.818,113,41,89,0.461,31,63,0.492,10,26,0.385,8,14,0.571,100,2016-12-18,SAS,NOP,2017,105.0
2179,2179,79,Home,W 113-82 ,240,49,82,0.598,41,66,0.621,8,16,0.5,7,7,1.0,113,34,83,0.41,31,60,0.517,3,23,0.13,11,13,0.846,82,2016-12-19,CHI,DET,2017,83.5
2180,2180,80,@,L 113-117 ,240,44,90,0.489,28,57,0.491,16,33,0.485,9,11,0.818,113,43,94,0.457,32,69,0.464,11,25,0.44,20,24,0.833,117,2016-12-20,LAL,CHO,2017,122.5
2181,2181,81,Home,W 113-102 ,240,43,87,0.494,28,60,0.467,15,27,0.556,12,19,0.632,113,36,77,0.468,27,55,0.491,9,22,0.409,21,29,0.724,102,2016-12-21,CLE,MIL,2017,106.5
2182,2182,82,Home,L 113-119 ,240,43,85,0.506,33,56,0.589,10,29,0.345,17,28,0.607,113,43,77,0.558,32,50,0.64,11,27,0.407,22,24,0.917,119,2016-12-23,DET,GSW,2017,124.5
2183,2183,83,Home,W 113-103 ,240,41,85,0.482,29,54,0.537,12,31,0.387,19,21,0.905,113,37,88,0.42,28,58,0.483,9,30,0.3,20,29,0.69,103,2016-12-27,BOS,MEM,2017,107.5
2184,2184,84,Home,W 113-105 ,240,37,78,0.474,20,46,0.435,17,32,0.531,22,24,0.917,113,41,92,0.446,30,62,0.484,11,30,0.367,12,14,0.857,105,2017-01-03,DAL,WAS,2017,110.5
2185,2185,85,Home,L 113-120 ,240,41,82,0.5,23,44,0.523,18,38,0.474,13,13,1.0,113,46,88,0.523,35,59,0.593,11,29,0.379,17,18,0.944,120,2017-01-03,DEN,SAC,2017,125.5
2186,2186,86,@,W 113-108 ,240,43,89,0.483,28,55,0.509,15,34,0.441,12,17,0.706,113,38,78,0.487,28,60,0.467,10,18,0.556,22,27,0.815,108,2017-01-12,DAL,PHO,2017,113.0
2187,2187,87,@,L 113-132 ,240,40,86,0.465,23,50,0.46,17,36,0.472,16,20,0.8,113,52,97,0.536,41,69,0.594,11,28,0.393,17,21,0.81,132,2017-01-13,BRK,TOR,2017,137.5
2188,2188,88,Home,W 113-97 ,240,48,92,0.522,38,64,0.594,10,28,0.357,7,8,0.875,113,36,80,0.45,26,59,0.441,10,21,0.476,15,27,0.556,97,2017-01-14,LAC,LAL,2017,102.0
2189,2189,89,@,W 113-104 ,240,35,78,0.449,21,41,0.512,14,37,0.378,29,36,0.806,113,42,89,0.472,37,75,0.493,5,14,0.357,15,22,0.682,104,2017-01-16,PHI,MIL,2017,106.5
2190,2190,90,@,W 113-110 ,240,44,88,0.5,31,56,0.554,13,32,0.406,12,14,0.857,113,42,90,0.467,35,66,0.53,7,24,0.292,19,22,0.864,110,2017-01-19,WAS,NYK,2017,113.5
2191,2191,91,Home,W 113-78 ,240,40,80,0.5,28,55,0.509,12,25,0.48,21,25,0.84,113,29,86,0.337,22,56,0.393,7,30,0.233,13,14,0.929,78,2017-01-20,CHA,TOR,2017,81.5
2192,2192,92,Home,W 113-112 ,240,43,87,0.494,32,59,0.542,11,28,0.393,16,22,0.727,113,39,91,0.429,31,65,0.477,8,26,0.308,26,33,0.788,112,2017-01-21,DET,WAS,2017,116.0
2193,2193,93,@,W 113-103 ,240,39,82,0.476,28,54,0.519,11,28,0.393,24,27,0.889,113,38,92,0.413,31,69,0.449,7,23,0.304,20,21,0.952,103,2017-01-25,GSW,CHO,2017,106.5
2194,2194,94,@,W 113-111 ,240,36,79,0.456,28,53,0.528,8,26,0.308,33,39,0.846,113,46,93,0.495,36,66,0.545,10,27,0.37,9,12,0.75,111,2017-01-29,GSW,POR,2017,116.0
2195,2195,95,Home,L 113-114 ,240,36,79,0.456,24,51,0.471,12,28,0.429,29,36,0.806,113,42,79,0.532,32,56,0.571,10,23,0.435,20,26,0.769,114,2017-01-29,TOR,ORL,2017,119.0
2196,2196,96,Home,W 113-109 ,240,36,82,0.439,23,50,0.46,13,32,0.406,28,33,0.848,113,43,97,0.443,40,70,0.571,3,27,0.111,20,29,0.69,109,2017-01-30,BOS,DET,2017,110.5
2197,2197,97,Home,W 113-95 ,240,40,86,0.465,30,60,0.5,10,26,0.385,23,28,0.821,113,35,77,0.455,29,55,0.527,6,22,0.273,19,26,0.731,95,2017-02-01,DAL,PHI,2017,98.0
2198,2198,98,@,W 113-108 ,240,44,85,0.518,36,55,0.655,8,30,0.267,17,23,0.739,113,35,93,0.376,22,42,0.524,13,51,0.255,25,33,0.758,108,2017-02-02,ATL,HOU,2017,114.5
2199,2199,99,Home,W 113-107 ,240,39,82,0.476,26,47,0.553,13,35,0.371,22,28,0.786,113,37,94,0.394,23,56,0.411,14,38,0.368,19,26,0.731,107,2017-02-03,BOS,LAL,2017,114.0
2200,2200,0,Home,W 113-86 ,240,41,78,0.526,31,50,0.62,10,28,0.357,21,27,0.778,113,27,78,0.346,20,51,0.392,7,27,0.259,25,28,0.893,86,2017-02-04,ATL,ORL,2017,89.5
2201,2201,1,Home,W 113-96 ,240,46,99,0.465,41,77,0.532,5,22,0.227,16,17,0.941,113,36,85,0.424,31,57,0.544,5,28,0.179,19,28,0.679,96,2017-02-06,DET,PHI,2017,98.5
2202,2202,2,Home,L 113-115 ,240,43,80,0.538,38,69,0.551,5,11,0.455,22,28,0.786,113,45,86,0.523,30,58,0.517,15,28,0.536,10,14,0.714,115,2017-02-06,MIN,MIA,2017,122.5
2203,2203,3,Home,L 113-114 ,240,37,75,0.493,25,47,0.532,12,28,0.429,27,32,0.844,113,42,86,0.488,31,58,0.534,11,28,0.393,19,24,0.792,114,2017-02-07,DAL,POR,2017,119.5
2204,2204,4,Home,W 113-104 ,240,39,82,0.476,21,43,0.488,18,39,0.462,17,19,0.895,113,40,86,0.465,28,62,0.452,12,24,0.5,12,14,0.857,104,2017-02-15,CLE,IND,2017,110.0
2205,2205,5,@,L 113-123 ,240,38,93,0.409,27,65,0.415,11,28,0.393,26,37,0.703,113,43,81,0.531,30,55,0.545,13,26,0.5,24,26,0.923,123,2017-02-23,LAC,GSW,2017,129.5
2206,2206,6,Home,W 113-95 ,240,38,78,0.487,25,47,0.532,13,31,0.419,24,31,0.774,113,34,85,0.4,30,73,0.411,4,12,0.333,23,26,0.885,95,2017-02-25,MIA,IND,2017,97.0
2207,2207,7,@,L 113-120 (OT),265,44,84,0.524,34,59,0.576,10,25,0.4,15,22,0.682,113,45,104,0.433,38,79,0.481,7,25,0.28,23,31,0.742,120,2017-02-28,POR,DET,2017,123.5
2208,2208,8,@,W 113-105 ,240,40,86,0.465,34,72,0.472,6,14,0.429,27,28,0.964,113,40,85,0.471,31,53,0.585,9,32,0.281,16,24,0.667,105,2017-03-06,NYK,ORL,2017,109.5
2209,2209,9,Home,L 113-123 ,240,46,87,0.529,33,59,0.559,13,28,0.464,8,17,0.471,113,50,88,0.568,39,62,0.629,11,26,0.423,12,19,0.632,123,2017-03-08,DEN,WAS,2017,128.5
2210,2210,10,Home,W 112-85 ,240,47,83,0.566,42,70,0.6,5,13,0.385,13,19,0.684,112,34,86,0.395,30,67,0.448,4,19,0.211,13,21,0.619,85,2012-01-10,PHI,SAC,2012,87.0
2211,2211,11,Home,W 112-100 ,240,38,76,0.5,31,63,0.492,7,13,0.538,29,38,0.763,112,35,84,0.417,30,64,0.469,5,20,0.25,25,32,0.781,100,2012-01-14,CHA,GSW,2012,102.5
2212,2212,12,Home,W 112-100 ,240,45,80,0.563,32,55,0.582,13,25,0.52,9,15,0.6,112,38,78,0.487,29,56,0.518,9,22,0.409,15,23,0.652,100,2012-01-30,LAC,OKC,2012,104.5
2213,2213,13,Home,W 112-68 ,240,44,80,0.55,37,66,0.561,7,14,0.5,17,20,0.85,112,26,80,0.325,25,71,0.352,1,9,0.111,15,19,0.789,68,2012-02-01,POR,CHA,2012,68.5
2214,2214,14,@,W 112-91 ,240,39,73,0.534,27,52,0.519,12,21,0.571,22,25,0.88,112,39,85,0.459,31,58,0.534,8,27,0.296,5,12,0.417,91,2012-02-02,DEN,LAC,2012,95.0
2215,2215,15,Home,L 112-113 (OT),265,43,88,0.489,35,71,0.493,8,17,0.471,18,32,0.563,112,40,98,0.408,32,74,0.432,8,24,0.333,25,31,0.806,113,2012-02-10,CLE,MIL,2012,117.0
2216,2216,16,@,W 112-91 ,240,47,89,0.528,37,69,0.536,10,20,0.5,8,12,0.667,112,35,80,0.438,26,58,0.448,9,22,0.409,12,16,0.75,91,2012-03-02,CHI,CLE,2012,95.5
2217,2217,17,@,W 112-106 ,240,46,82,0.561,37,66,0.561,9,16,0.563,11,14,0.786,112,43,81,0.531,34,57,0.596,9,24,0.375,11,14,0.786,106,2012-03-10,HOU,NJN,2012,110.5
2218,2218,18,Home,W 112-97 ,240,47,87,0.54,39,65,0.6,8,22,0.364,10,19,0.526,112,39,87,0.448,31,70,0.443,8,17,0.471,11,14,0.786,97,2012-03-12,SAS,WAS,2012,101.0
2219,2219,19,Home,L 112-124 ,240,45,87,0.517,40,68,0.588,5,19,0.263,17,24,0.708,112,50,86,0.581,42,73,0.575,8,13,0.615,16,20,0.8,124,2012-03-14,SAC,DET,2012,128.0
2220,2220,20,@,W 112-95 ,240,45,84,0.536,35,59,0.593,10,25,0.4,12,15,0.8,112,36,83,0.434,30,62,0.484,6,21,0.286,17,20,0.85,95,2012-03-19,DAL,DEN,2012,98.0
2221,2221,21,@,W 112-92 ,240,48,90,0.533,44,77,0.571,4,13,0.308,12,21,0.571,112,34,84,0.405,33,76,0.434,1,8,0.125,23,26,0.885,92,2012-03-23,MIL,CHA,2012,92.5
2222,2222,22,Home,L 112-117 ,240,47,86,0.547,39,65,0.6,8,21,0.381,10,13,0.769,112,49,91,0.538,39,71,0.549,10,20,0.5,9,12,0.75,117,2012-03-28,SAC,SAS,2012,122.0
2223,2223,23,Home,W 112-103 ,240,38,76,0.5,29,57,0.509,9,19,0.474,27,33,0.818,112,42,79,0.532,37,65,0.569,5,14,0.357,14,18,0.778,103,2012-03-31,SAS,IND,2012,105.5
2224,2224,24,@,L 112-120 ,240,44,90,0.489,33,69,0.478,11,21,0.524,13,15,0.867,112,44,82,0.537,34,63,0.54,10,19,0.526,22,31,0.71,120,2012-04-01,GSW,LAL,2012,125.0
2225,2225,25,@,W 112-98 ,240,43,83,0.518,39,73,0.534,4,10,0.4,22,29,0.759,112,36,81,0.444,29,63,0.46,7,18,0.389,19,20,0.95,98,2012-04-02,MIL,WAS,2012,101.5
2226,2226,26,Home,W 112-104 ,240,41,86,0.477,35,63,0.556,6,23,0.261,24,31,0.774,112,38,83,0.458,28,60,0.467,10,23,0.435,18,25,0.72,104,2012-04-03,IND,NYK,2012,109.0
2227,2227,27,@,W 112-107 ,240,42,88,0.477,32,71,0.451,10,17,0.588,18,22,0.818,112,36,84,0.429,33,73,0.452,3,11,0.273,32,36,0.889,107,2012-04-06,HOU,LAL,2012,108.5
2228,2228,28,Home,W 112-97 ,240,46,88,0.523,38,67,0.567,8,21,0.381,12,16,0.75,112,37,80,0.463,29,55,0.527,8,25,0.32,15,20,0.75,97,2012-04-07,GSW,DEN,2012,101.0
2229,2229,29,@,W 112-103 ,240,44,88,0.5,35,64,0.547,9,24,0.375,15,20,0.75,112,38,81,0.469,31,63,0.492,7,18,0.389,20,23,0.87,103,2012-04-12,DAL,GSW,2012,106.5
2230,2230,30,@,W 112-105 ,240,38,77,0.494,30,59,0.508,8,18,0.444,28,33,0.848,112,36,84,0.429,32,65,0.492,4,19,0.211,29,33,0.879,105,2012-04-13,PHO,HOU,2012,107.0
2231,2231,31,Home,W 112-104 ,240,44,81,0.543,34,59,0.576,10,22,0.455,14,30,0.467,112,37,80,0.463,22,49,0.449,15,31,0.484,15,21,0.714,104,2012-04-14,LAC,GSW,2012,111.5
2232,2232,32,Home,W 112-108 (OT),265,42,93,0.452,35,75,0.467,7,18,0.389,21,27,0.778,112,41,88,0.466,29,67,0.433,12,21,0.571,14,15,0.933,108,2012-04-15,LAL,DAL,2012,114.0
2233,2233,33,@,W 112-91 ,240,50,84,0.595,43,66,0.652,7,18,0.389,5,11,0.455,112,39,80,0.488,37,70,0.529,2,10,0.2,11,11,1.0,91,2012-04-17,SAS,LAL,2012,92.0
2234,2234,34,@,W 112-91 ,240,38,80,0.475,28,63,0.444,10,17,0.588,26,32,0.813,112,31,79,0.392,25,59,0.424,6,20,0.3,23,29,0.793,91,2012-04-18,UTA,POR,2012,94.0
2235,2235,35,@,L 112-121 ,240,42,93,0.452,37,74,0.5,5,19,0.263,23,27,0.852,112,49,88,0.557,42,75,0.56,7,13,0.538,16,25,0.64,121,2012-04-18,MIL,WAS,2012,124.5
2236,2236,36,Home,L 112-113 ,240,41,76,0.539,26,53,0.491,15,23,0.652,15,23,0.652,112,43,79,0.544,31,60,0.517,12,19,0.632,15,20,0.75,113,2012-04-22,ATL,NYK,2012,119.0
2237,2237,37,@,W 112-109 ,240,40,70,0.571,33,52,0.635,7,18,0.389,25,31,0.806,112,42,89,0.472,32,67,0.478,10,22,0.455,15,19,0.789,109,2012-11-10,SAS,POR,2013,114.0
2238,2238,38,@,W 112-106 (OT),265,44,88,0.5,38,76,0.5,6,12,0.5,18,25,0.72,112,42,105,0.4,36,84,0.429,6,21,0.286,16,17,0.941,106,2012-11-14,CHI,PHO,2013,109.0
2239,2239,39,@,W 112-96 ,240,42,76,0.553,34,61,0.557,8,15,0.533,20,27,0.741,112,39,85,0.459,31,65,0.477,8,20,0.4,10,14,0.714,96,2012-11-16,ATL,SAC,2013,100.0
2240,2240,40,@,W 112-100 ,240,45,77,0.584,37,61,0.607,8,16,0.5,14,19,0.737,112,41,77,0.532,38,69,0.551,3,8,0.375,15,17,0.882,100,2012-11-21,SAS,BOS,2013,101.5
2241,2241,41,Home,L 112-118 (OT),265,41,88,0.466,28,61,0.459,13,27,0.481,17,22,0.773,112,43,92,0.467,31,57,0.544,12,35,0.343,20,26,0.769,118,2012-12-03,CHA,POR,2013,124.0
2242,2242,42,Home,W 112-90 ,240,45,90,0.5,39,70,0.557,6,20,0.3,16,21,0.762,112,34,84,0.405,29,65,0.446,5,19,0.263,17,19,0.895,90,2012-12-05,LAC,DAL,2013,92.5
2243,2243,43,@,W 112-92 ,240,41,91,0.451,23,47,0.489,18,44,0.409,12,19,0.632,112,32,76,0.421,26,60,0.433,6,16,0.375,22,28,0.786,92,2012-12-06,NYK,MIA,2013,95.0
2244,2244,44,Home,W 112-106 ,240,37,86,0.43,25,56,0.446,12,30,0.4,26,37,0.703,112,40,72,0.556,35,55,0.636,5,17,0.294,21,29,0.724,106,2012-12-09,NYK,DEN,2013,108.5
2245,2245,45,Home,W 112-106 ,240,38,87,0.437,31,68,0.456,7,19,0.368,29,42,0.69,112,38,95,0.4,24,59,0.407,14,36,0.389,16,18,0.889,106,2012-12-18,DEN,SAS,2013,113.0
2246,2246,46,Home,W 112-100 ,240,45,93,0.484,34,68,0.5,11,25,0.44,11,19,0.579,112,40,80,0.5,37,67,0.552,3,13,0.231,17,24,0.708,100,2012-12-25,LAC,DEN,2013,101.5
2247,2247,47,@,W 112-110 (OT),265,40,85,0.471,34,64,0.531,6,21,0.286,26,35,0.743,112,42,88,0.477,34,65,0.523,8,23,0.348,18,22,0.818,110,2012-12-31,MIA,ORL,2013,114.0
2248,2248,48,@,W 112-104 ,240,37,79,0.468,25,45,0.556,12,34,0.353,26,36,0.722,112,36,91,0.396,29,68,0.426,7,23,0.304,25,28,0.893,104,2013-01-05,HOU,CLE,2013,107.5
2249,2249,49,@,W 112-105 ,240,44,101,0.436,35,77,0.455,9,24,0.375,15,23,0.652,112,38,82,0.463,28,52,0.538,10,30,0.333,19,27,0.704,105,2013-01-06,DEN,LAL,2013,110.0
2250,2250,50,@,L 112-125 ,240,43,91,0.473,29,60,0.483,14,31,0.452,12,13,0.923,112,48,87,0.552,37,62,0.597,11,25,0.44,18,23,0.783,125,2013-01-08,LAL,HOU,2013,130.5
2251,2251,51,@,W 112-102 ,240,44,82,0.537,34,60,0.567,10,22,0.455,14,21,0.667,112,42,88,0.477,38,80,0.475,4,8,0.5,14,22,0.636,102,2013-01-09,UTA,CHA,2013,104.0
2252,2252,52,Home,L 112-117 (OT),265,40,81,0.494,33,54,0.611,7,27,0.259,25,32,0.781,112,41,96,0.427,36,75,0.48,5,21,0.238,30,35,0.857,117,2013-01-10,SAC,DAL,2013,119.5
2253,2253,53,@,W 112-108 ,240,41,80,0.513,30,57,0.526,11,23,0.478,19,28,0.679,112,41,84,0.488,34,68,0.5,7,16,0.438,19,31,0.613,108,2013-01-18,WAS,DEN,2013,111.5
2254,2254,54,Home,L 112-116 ,240,45,79,0.57,36,55,0.655,9,24,0.375,13,23,0.565,112,38,77,0.494,28,55,0.509,10,22,0.455,30,35,0.857,116,2013-01-19,NOP,GSW,2013,121.0
2255,2255,55,Home,W 112-91 ,240,41,87,0.471,31,62,0.5,10,25,0.4,20,27,0.741,112,36,87,0.414,33,71,0.465,3,16,0.188,16,20,0.8,91,2013-02-04,OKC,DAL,2013,92.5
2256,2256,56,Home,W 112-104 ,240,40,91,0.44,35,75,0.467,5,16,0.313,27,37,0.73,112,48,100,0.48,45,84,0.536,3,16,0.188,5,11,0.455,104,2013-02-05,DEN,MIL,2013,105.5
2257,2257,57,Home,W 112-108 ,240,45,83,0.542,34,57,0.596,11,26,0.423,11,14,0.786,112,35,78,0.449,23,46,0.5,12,32,0.375,26,33,0.788,108,2013-03-06,DAL,HOU,2013,114.0
2258,2258,58,@,L 112-121 ,240,43,90,0.478,36,67,0.537,7,23,0.304,19,23,0.826,112,45,82,0.549,32,55,0.582,13,27,0.481,18,21,0.857,121,2013-03-08,PHO,SAC,2013,127.5
2259,2259,59,Home,W 112-88 ,240,39,76,0.513,33,61,0.541,6,15,0.4,28,35,0.8,112,34,79,0.43,31,66,0.47,3,13,0.231,17,19,0.895,88,2013-03-13,BOS,TOR,2013,89.5
2260,2260,60,Home,W 112-101 ,240,41,86,0.477,34,67,0.507,7,19,0.368,23,24,0.958,112,40,76,0.526,35,59,0.593,5,17,0.294,16,24,0.667,101,2013-03-16,POR,DET,2013,103.5
2261,2261,61,@,W 112-104 ,240,37,80,0.463,33,65,0.508,4,15,0.267,34,46,0.739,112,40,82,0.488,34,70,0.486,6,12,0.5,18,19,0.947,104,2013-03-30,IND,PHO,2013,107.0
2262,2262,62,Home,W 112-92 ,240,40,74,0.541,28,53,0.528,12,21,0.571,20,29,0.69,112,38,82,0.463,31,64,0.484,7,18,0.389,9,12,0.75,92,2013-03-31,NOP,CLE,2013,95.5
2263,2263,63,Home,W 112-102 ,240,45,83,0.542,36,61,0.59,9,22,0.409,13,18,0.722,112,39,67,0.582,26,44,0.591,13,23,0.565,11,17,0.647,102,2013-04-01,UTA,POR,2013,108.5
2264,2264,64,@,W 112-102 ,240,42,86,0.488,32,56,0.571,10,30,0.333,18,21,0.857,112,34,87,0.391,28,66,0.424,6,21,0.286,28,34,0.824,102,2013-04-03,HOU,SAC,2013,105.0
2265,2265,65,@,W 112-111 ,240,37,85,0.435,31,71,0.437,6,14,0.429,32,46,0.696,112,42,100,0.42,30,65,0.462,12,35,0.343,15,23,0.652,111,2013-04-15,DEN,MIL,2013,117.0
2266,2266,66,@,L 112-119 ,240,43,92,0.467,32,63,0.508,11,29,0.379,15,23,0.652,112,47,95,0.495,40,72,0.556,7,23,0.304,18,23,0.783,119,2013-04-15,HOU,PHO,2013,122.5
2267,2267,67,@,W 112-108 ,240,44,88,0.5,32,64,0.5,12,24,0.5,12,18,0.667,112,40,89,0.449,31,63,0.492,9,26,0.346,19,25,0.76,108,2013-04-17,LAC,SAC,2013,112.5
2268,2268,68,Home,W 112-108 (OT),265,41,88,0.466,31,64,0.484,10,24,0.417,20,26,0.769,112,41,88,0.466,35,64,0.547,6,24,0.25,20,29,0.69,108,2013-11-08,WAS,BRK,2014,111.0
2269,2269,69,Home,W 112-101 ,240,41,79,0.519,24,48,0.5,17,31,0.548,13,16,0.813,112,40,100,0.4,32,74,0.432,8,26,0.308,13,17,0.765,101,2013-11-23,HOU,MIN,2014,105.0
2270,2270,70,Home,W 112-93 ,240,44,81,0.543,34,56,0.607,10,25,0.4,14,19,0.737,112,37,97,0.381,35,82,0.427,2,15,0.133,17,20,0.85,93,2013-11-25,SAS,NOP,2014,94.0
2271,2271,71,@,L 112-113 (OT),265,42,95,0.442,34,69,0.493,8,26,0.308,20,29,0.69,112,36,92,0.391,30,74,0.405,6,18,0.333,35,42,0.833,113,2013-11-29,GSW,OKC,2014,116.0
2272,2272,72,@,W 112-101 ,240,41,75,0.547,33,50,0.66,8,25,0.32,22,25,0.88,112,40,83,0.482,35,63,0.556,5,20,0.25,16,20,0.8,101,2013-11-29,PHO,UTA,2014,103.5
2273,2273,73,@,W 112-106 ,240,40,79,0.506,29,53,0.547,11,26,0.423,21,30,0.7,112,45,92,0.489,38,68,0.559,7,24,0.292,9,11,0.818,106,2013-11-30,MIN,DAL,2014,109.5
2274,2274,74,@,W 112-104 ,240,39,76,0.513,30,58,0.517,9,18,0.5,25,29,0.862,112,37,78,0.474,25,51,0.49,12,27,0.444,18,25,0.72,104,2013-11-30,UTA,PHO,2014,110.0
2275,2275,75,@,W 112-106 ,240,40,90,0.444,27,60,0.45,13,30,0.433,19,30,0.633,112,44,91,0.484,35,65,0.538,9,26,0.346,9,13,0.692,106,2013-11-30,HOU,SAS,2014,110.5
2276,2276,76,@,W 112-98 ,240,44,87,0.506,34,64,0.531,10,23,0.435,14,19,0.737,112,35,87,0.402,27,65,0.415,8,22,0.364,20,26,0.769,98,2013-12-01,DEN,TOR,2014,102.0
2277,2277,77,Home,W 112-103 ,240,40,79,0.506,28,50,0.56,12,29,0.414,20,25,0.8,112,40,77,0.519,32,57,0.561,8,20,0.4,15,18,0.833,103,2013-12-03,GSW,TOR,2014,107.0
2278,2278,78,@,W 112-102 (OT),265,39,94,0.415,36,79,0.456,3,15,0.2,31,38,0.816,112,36,89,0.404,28,70,0.4,8,19,0.421,22,30,0.733,102,2013-12-07,SAC,UTA,2014,106.0
2279,2279,79,Home,W 112-97 ,240,38,81,0.469,29,56,0.518,9,25,0.36,27,34,0.794,112,37,95,0.389,32,68,0.471,5,27,0.185,18,20,0.9,97,2013-12-09,SAC,DAL,2014,99.5
2280,2280,80,Home,L 112-116 ,240,43,90,0.478,37,68,0.544,6,22,0.273,20,24,0.833,112,39,79,0.494,27,50,0.54,12,29,0.414,26,35,0.743,116,2013-12-13,GSW,HOU,2014,122.0
2281,2281,81,Home,W 112-91 ,240,39,86,0.453,26,53,0.491,13,33,0.394,21,31,0.677,112,31,88,0.352,25,58,0.431,6,30,0.2,23,29,0.793,91,2013-12-21,LAC,DEN,2014,94.0
2282,2282,82,Home,W 112-99 ,240,41,91,0.451,32,68,0.471,9,23,0.391,21,27,0.778,112,37,81,0.457,30,60,0.5,7,21,0.333,18,25,0.72,99,2013-12-23,SAS,TOR,2014,102.5
2283,2283,83,@,L 112-116 (OT),265,49,110,0.445,41,90,0.456,8,20,0.4,6,12,0.5,112,42,96,0.438,29,60,0.483,13,36,0.361,19,22,0.864,116,2013-12-26,LAC,POR,2014,122.5
2284,2284,84,Home,W 112-104 ,240,44,94,0.468,36,70,0.514,8,24,0.333,16,19,0.842,112,41,91,0.451,34,77,0.442,7,14,0.5,15,20,0.75,104,2013-12-29,SAS,SAC,2014,107.5
2285,2285,85,Home,W 112-85 ,240,47,85,0.553,36,51,0.706,11,34,0.324,7,10,0.7,112,29,76,0.382,23,55,0.418,6,21,0.286,21,22,0.955,85,2014-01-01,LAC,CHA,2014,88.0
2286,2286,86,@,L 112-124 ,240,45,87,0.517,39,67,0.582,6,20,0.3,16,22,0.727,112,44,79,0.557,36,57,0.632,8,22,0.364,28,35,0.8,124,2014-01-01,NOP,MIN,2014,128.0
2287,2287,87,Home,L 112-119 ,240,45,88,0.511,33,60,0.55,12,28,0.429,10,14,0.714,112,40,82,0.488,31,59,0.525,9,23,0.391,30,38,0.789,119,2014-01-03,DAL,LAC,2014,123.5
2288,2288,88,@,W 112-84 ,240,43,92,0.467,35,77,0.455,8,15,0.533,18,22,0.818,112,35,86,0.407,31,69,0.449,4,17,0.235,10,20,0.5,84,2014-01-05,MEM,DET,2014,86.0
2289,2289,89,@,W 112-96 ,240,43,85,0.506,34,63,0.54,9,22,0.409,17,20,0.85,112,37,86,0.43,31,66,0.47,6,20,0.3,16,16,1.0,96,2014-01-05,GSW,WAS,2014,99.0
2290,2290,90,Home,W 112-101 ,240,40,68,0.588,32,50,0.64,8,18,0.444,24,31,0.774,112,35,89,0.393,29,55,0.527,6,34,0.176,25,31,0.806,101,2014-01-07,UTA,OKC,2014,104.0
2291,2291,91,Home,W 112-90 ,240,40,76,0.526,31,56,0.554,9,20,0.45,23,26,0.885,112,39,93,0.419,32,74,0.432,7,19,0.368,5,8,0.625,90,2014-01-08,SAS,DAL,2014,93.5
2292,2292,92,Home,W 112-91 ,240,35,86,0.407,24,55,0.436,11,31,0.355,31,34,0.912,112,34,86,0.395,30,70,0.429,4,16,0.25,19,35,0.543,91,2014-01-08,TOR,DET,2014,93.0
2293,2293,93,Home,W 112-104 ,240,40,93,0.43,30,72,0.417,10,21,0.476,22,26,0.846,112,44,95,0.463,40,81,0.494,4,14,0.286,12,17,0.706,104,2014-01-11,POR,BOS,2014,106.0
2294,2294,94,@,W 112-106 ,240,37,80,0.463,25,58,0.431,12,22,0.545,26,28,0.929,112,44,90,0.489,35,60,0.583,9,30,0.3,9,11,0.818,106,2014-01-19,LAL,TOR,2014,110.5
2295,2295,95,@,W 112-103 ,240,40,72,0.556,31,51,0.608,9,21,0.429,23,37,0.622,112,40,79,0.506,38,65,0.585,2,14,0.143,21,29,0.724,103,2014-01-20,LAC,DET,2014,104.0
2296,2296,96,@,W 112-97 ,240,41,90,0.456,33,69,0.478,8,21,0.381,22,24,0.917,112,41,87,0.471,36,70,0.514,5,17,0.294,10,12,0.833,97,2014-01-21,MIN,UTA,2014,99.5
2297,2297,97,@,W 112-109 ,240,41,83,0.494,32,58,0.552,9,25,0.36,21,24,0.875,112,41,83,0.494,35,71,0.493,6,12,0.5,21,24,0.875,109,2014-01-22,ATL,ORL,2014,112.0
2298,2298,98,@,W 112-95 ,240,41,76,0.539,28,55,0.509,13,21,0.619,17,26,0.654,112,40,93,0.43,34,74,0.459,6,19,0.316,9,11,0.818,95,2014-01-24,LAC,CHI,2014,98.0
2299,2299,99,@,W 112-87 ,240,40,76,0.526,27,50,0.54,13,26,0.5,19,25,0.76,112,38,82,0.463,33,61,0.541,5,21,0.238,6,13,0.462,87,2014-01-25,ATL,MIL,2014,89.5
2300,2300,0,@,W 112-95 ,240,41,80,0.513,25,53,0.472,16,27,0.593,14,19,0.737,112,37,72,0.514,34,53,0.642,3,19,0.158,18,22,0.818,95,2014-01-29,OKC,MIA,2014,96.5
2301,2301,1,Home,L 112-116 ,240,37,86,0.43,30,61,0.492,7,25,0.28,31,42,0.738,112,41,78,0.526,28,47,0.596,13,31,0.419,21,26,0.808,116,2014-02-05,LAC,MIA,2014,122.5
2302,2302,2,Home,W 112-98 ,240,44,89,0.494,38,71,0.535,6,18,0.333,18,20,0.9,112,39,85,0.459,33,65,0.508,6,20,0.3,14,23,0.609,98,2014-02-05,ORL,DET,2014,101.0
2303,2303,3,@,W 112-98 ,240,45,89,0.506,37,71,0.521,8,18,0.444,14,20,0.7,112,37,87,0.425,22,55,0.4,15,32,0.469,9,17,0.529,98,2014-02-07,LAL,PHI,2014,105.5
2304,2304,4,Home,W 112-100 ,240,40,73,0.548,28,46,0.609,12,27,0.444,20,27,0.741,112,38,86,0.442,29,62,0.468,9,24,0.375,15,20,0.75,100,2014-02-09,OKC,NYK,2014,104.5
2305,2305,5,@,L 112-113 ,240,44,97,0.454,28,65,0.431,16,32,0.5,8,16,0.5,112,34,64,0.531,24,42,0.571,10,22,0.455,35,47,0.745,113,2014-02-12,WAS,HOU,2014,118.0
2306,2306,6,@,W 112-107 (OT),265,35,93,0.376,24,64,0.375,11,29,0.379,31,39,0.795,112,38,99,0.384,33,71,0.465,5,28,0.179,26,37,0.703,107,2014-02-18,PHO,DEN,2014,109.5
2307,2307,7,Home,L 112-124 ,240,42,94,0.447,37,69,0.536,5,25,0.2,23,32,0.719,112,48,77,0.623,39,54,0.722,9,23,0.391,19,25,0.76,124,2014-02-21,PHI,DAL,2014,128.5
2308,2308,8,Home,L 112-115 ,240,42,86,0.488,31,60,0.517,11,26,0.423,17,24,0.708,112,41,78,0.526,36,62,0.581,5,16,0.313,28,32,0.875,115,2014-02-23,PHO,HOU,2014,117.5
2309,2309,9,@,W 112-89 ,240,39,82,0.476,29,51,0.569,10,31,0.323,24,29,0.828,112,30,81,0.37,24,59,0.407,6,22,0.273,23,33,0.697,89,2014-02-27,BRK,DEN,2014,92.0
2310,2310,10,Home,W 112-98 ,240,43,74,0.581,37,58,0.638,6,16,0.375,20,24,0.833,112,36,83,0.434,32,65,0.492,4,18,0.222,22,29,0.759,98,2014-03-01,MIA,ORL,2014,100.0
2311,2311,11,Home,W 112-106 ,240,39,84,0.464,29,57,0.509,10,27,0.37,24,28,0.857,112,45,97,0.464,38,79,0.481,7,18,0.389,9,14,0.643,106,2014-03-02,SAS,DAL,2014,109.5
2312,2312,12,Home,W 112-86 ,240,40,76,0.526,27,48,0.563,13,28,0.464,19,25,0.76,112,34,74,0.459,27,58,0.466,7,16,0.438,11,15,0.733,86,2014-03-07,HOU,IND,2014,89.5
2313,2313,13,Home,W 112-104 ,240,42,84,0.5,34,64,0.531,8,20,0.4,20,23,0.87,112,40,89,0.449,35,69,0.507,5,20,0.25,19,25,0.76,104,2014-03-07,NOP,MIL,2014,106.5
2314,2314,14,@,L 112-121 ,240,46,96,0.479,39,78,0.5,7,18,0.389,13,17,0.765,112,43,81,0.531,34,61,0.557,9,20,0.45,26,35,0.743,121,2014-03-08,ORL,SAS,2014,125.5
2315,2315,15,Home,W 112-105 ,240,43,78,0.551,39,64,0.609,4,14,0.286,22,31,0.71,112,39,85,0.459,32,65,0.492,7,20,0.35,20,29,0.69,105,2014-03-10,LAC,PHO,2014,108.5
2316,2316,16,@,W 112-110 ,240,38,78,0.487,25,49,0.51,13,29,0.448,23,27,0.852,112,40,82,0.488,30,61,0.492,10,21,0.476,20,24,0.833,110,2014-03-10,ATL,UTA,2014,115.0
2317,2317,17,Home,W 112-101 ,240,41,85,0.482,33,65,0.508,8,20,0.4,22,30,0.733,112,39,74,0.527,34,59,0.576,5,15,0.333,18,29,0.621,101,2014-03-11,MIN,MIL,2014,103.5
2318,2318,18,Home,L 112-120 ,240,45,93,0.484,36,69,0.522,9,24,0.375,13,13,1.0,112,47,92,0.511,37,70,0.529,10,22,0.455,16,24,0.667,120,2014-03-12,ORL,DEN,2014,125.0
2319,2319,19,@,W 112-104 (OT),265,41,104,0.394,34,80,0.425,7,24,0.292,23,25,0.92,112,37,91,0.407,30,68,0.441,7,23,0.304,23,30,0.767,104,2014-03-15,IND,DET,2014,107.5
2320,2320,20,Home,L 112-113 ,240,37,88,0.42,25,60,0.417,12,28,0.429,26,30,0.867,112,42,88,0.477,31,58,0.534,11,30,0.367,18,22,0.818,113,2014-03-16,POR,GSW,2014,118.5
2321,2321,21,Home,W 112-103 ,240,45,83,0.542,34,54,0.63,11,29,0.379,11,17,0.647,112,42,93,0.452,30,64,0.469,12,29,0.414,7,13,0.538,103,2014-03-22,LAC,DET,2014,109.0
2322,2322,22,Home,W 112-88 ,240,40,88,0.455,26,55,0.473,14,33,0.424,18,23,0.783,112,35,87,0.402,27,62,0.435,8,25,0.32,10,16,0.625,88,2014-03-28,PHO,NYK,2014,92.0
2323,2323,23,Home,L 112-124 ,240,41,92,0.446,30,67,0.448,11,25,0.44,19,22,0.864,112,46,99,0.465,33,70,0.471,13,29,0.448,19,21,0.905,124,2014-04-01,LAL,POR,2014,130.5
2324,2324,24,@,W 112-108 ,240,37,79,0.468,26,53,0.491,11,26,0.423,27,30,0.9,112,36,78,0.462,28,50,0.56,8,28,0.286,28,33,0.848,108,2014-04-02,LAC,PHO,2014,112.0
2325,2325,25,Home,W 112-92 ,240,43,77,0.558,34,55,0.618,9,22,0.409,17,18,0.944,112,38,86,0.442,33,72,0.458,5,14,0.357,11,17,0.647,92,2014-04-06,SAS,MEM,2014,94.5
2326,2326,26,@,W 112-95 ,240,45,92,0.489,32,67,0.478,13,25,0.52,9,13,0.692,112,35,89,0.393,26,61,0.426,9,28,0.321,16,20,0.8,95,2014-04-11,GSW,LAL,2014,99.5
2327,2327,27,Home,W 112-110 ,240,41,94,0.436,38,82,0.463,3,12,0.25,27,40,0.675,112,36,83,0.434,25,58,0.431,11,25,0.44,27,36,0.75,110,2014-04-11,MIN,HOU,2014,115.5
2328,2328,28,Home,W 112-104 ,240,43,96,0.448,30,66,0.455,13,30,0.433,13,16,0.813,112,39,82,0.476,30,56,0.536,9,26,0.346,17,19,0.895,104,2014-04-11,SAS,PHO,2014,108.5
2329,2329,29,Home,L 112-116 ,240,37,84,0.44,28,50,0.56,9,34,0.265,29,35,0.829,112,44,90,0.489,36,67,0.537,8,23,0.348,20,35,0.571,116,2014-04-16,DEN,GSW,2014,120.0
2330,2330,30,Home,W 112-111 ,240,38,86,0.442,33,63,0.524,5,23,0.217,31,41,0.756,112,42,83,0.506,34,64,0.531,8,19,0.421,19,31,0.613,111,2014-04-16,OKC,DET,2014,115.0
2331,2331,31,@,W 112-106 ,240,41,91,0.451,35,73,0.479,6,18,0.333,24,31,0.774,112,35,88,0.398,29,72,0.403,6,16,0.375,30,41,0.732,106,2014-11-04,PHO,LAL,2015,109.0
2332,2332,32,Home,W 112-103 (OT),265,46,91,0.505,41,81,0.506,5,10,0.5,15,19,0.789,112,40,93,0.43,36,75,0.48,4,18,0.222,19,25,0.76,103,2014-11-07,ORL,MIN,2015,105.0
2333,2333,33,Home,L 112-114 (2OT),290,42,98,0.429,32,67,0.478,10,31,0.323,18,25,0.72,112,39,91,0.429,36,75,0.48,3,16,0.188,33,39,0.846,114,2014-11-07,PHO,SAC,2015,115.5
2334,2334,34,Home,W 112-104 ,240,39,81,0.481,31,57,0.544,8,24,0.333,26,29,0.897,112,35,74,0.473,26,53,0.491,9,21,0.429,25,32,0.781,104,2014-11-12,PHO,BRK,2015,108.5
2335,2335,35,Home,W 112-87 ,240,45,87,0.517,34,61,0.557,11,26,0.423,11,14,0.786,112,32,84,0.381,25,67,0.373,7,17,0.412,16,28,0.571,87,2014-11-15,GSW,CHO,2015,90.5
2336,2336,36,@,L 112-120 ,240,39,90,0.433,31,65,0.477,8,25,0.32,26,34,0.765,112,45,88,0.511,32,63,0.508,13,25,0.52,17,21,0.81,120,2014-11-26,DEN,PHO,2015,126.5
2337,2337,37,@,W 112-99 ,240,45,84,0.536,39,71,0.549,6,13,0.462,16,26,0.615,112,39,97,0.402,31,69,0.449,8,28,0.286,13,18,0.722,99,2014-11-28,MEM,POR,2015,103.0
2338,2338,38,Home,W 112-104 ,240,42,82,0.512,30,58,0.517,12,24,0.5,16,20,0.8,112,38,75,0.507,32,65,0.492,6,10,0.6,22,26,0.846,104,2014-11-28,SAS,SAC,2015,107.0
2339,2339,39,@,W 112-96 ,240,45,80,0.563,34,52,0.654,11,28,0.393,11,15,0.733,112,34,75,0.453,27,54,0.5,7,21,0.333,21,33,0.636,96,2014-11-29,LAC,UTA,2015,99.5
2340,2340,40,Home,W 112-104 ,240,39,88,0.443,34,71,0.479,5,17,0.294,29,45,0.644,112,37,84,0.44,30,60,0.5,7,24,0.292,23,27,0.852,104,2014-12-02,NOP,OKC,2015,107.5
2341,2341,41,@,W 112-102 ,240,40,74,0.541,28,49,0.571,12,25,0.48,20,23,0.87,112,36,64,0.563,30,48,0.625,6,16,0.375,24,32,0.75,102,2014-12-03,ATL,MIA,2015,105.0
2342,2342,42,Home,W 112-85 ,240,47,100,0.47,37,78,0.474,10,22,0.455,8,17,0.471,112,37,89,0.416,34,74,0.459,3,15,0.2,8,13,0.615,85,2014-12-04,GSW,NOP,2015,86.5
2343,2343,43,Home,L 112-114 (OT),265,45,97,0.464,42,87,0.483,3,10,0.3,19,27,0.704,112,38,78,0.487,26,46,0.565,12,32,0.375,26,31,0.839,114,2014-12-05,MIN,HOU,2015,120.0
2344,2344,44,@,W 112-102 ,240,40,89,0.449,28,59,0.475,12,30,0.4,20,25,0.8,112,36,83,0.434,29,62,0.468,7,21,0.333,23,27,0.852,102,2014-12-06,GSW,CHI,2015,105.5
2345,2345,45,Home,W 112-107 (OT),265,41,81,0.506,32,48,0.667,9,33,0.273,21,29,0.724,112,43,104,0.413,33,74,0.446,10,30,0.333,11,15,0.733,107,2014-12-08,TOR,DEN,2015,112.0
2346,2346,46,Home,W 112-107 ,240,44,83,0.53,35,62,0.565,9,21,0.429,15,17,0.882,112,40,88,0.455,33,70,0.471,7,18,0.389,20,24,0.833,107,2014-12-10,DAL,NOP,2015,110.5
2347,2347,47,@,W 112-110 (OT),265,44,96,0.458,32,72,0.444,12,24,0.5,12,15,0.8,112,42,90,0.467,30,59,0.508,12,31,0.387,14,21,0.667,110,2014-12-12,LAL,SAS,2015,116.0
2348,2348,48,Home,W 112-88 ,240,39,80,0.488,35,62,0.565,4,18,0.222,30,34,0.882,112,34,99,0.343,27,68,0.397,7,31,0.226,13,18,0.722,88,2014-12-14,OKC,PHO,2015,91.5
2349,2349,49,Home,W 112-107 ,240,39,88,0.443,29,57,0.509,10,31,0.323,24,28,0.857,112,45,90,0.5,40,76,0.526,5,14,0.357,12,21,0.571,107,2014-12-28,DAL,OKC,2015,109.5
2350,2350,50,Home,W 112-96 ,240,42,84,0.5,28,52,0.538,14,32,0.438,14,16,0.875,112,37,87,0.425,30,61,0.492,7,26,0.269,15,25,0.6,96,2015-01-02,PHO,PHI,2015,99.5
2351,2351,51,Home,W 112-94 ,240,43,86,0.5,33,56,0.589,10,30,0.333,16,17,0.941,112,35,86,0.407,28,63,0.444,7,23,0.304,17,23,0.739,94,2015-01-09,GSW,CLE,2015,97.5
2352,2352,52,Home,W 112-101 ,240,41,86,0.477,25,50,0.5,16,36,0.444,14,19,0.737,112,35,81,0.432,24,52,0.462,11,29,0.379,20,28,0.714,101,2015-01-15,HOU,OKC,2015,106.5
2353,2353,53,Home,W 112-100 ,240,45,80,0.563,35,52,0.673,10,28,0.357,12,18,0.667,112,37,71,0.521,31,55,0.564,6,16,0.375,20,25,0.8,100,2015-01-25,ATL,MIN,2015,103.0
2354,2354,54,@,W 112-101 ,240,39,76,0.513,34,64,0.531,5,12,0.417,29,34,0.853,112,37,79,0.468,27,48,0.563,10,31,0.323,17,22,0.773,101,2015-02-08,MIN,DET,2015,106.0
2355,2355,55,Home,W 112-107 ,240,43,89,0.483,31,65,0.477,12,24,0.5,14,16,0.875,112,47,88,0.534,37,63,0.587,10,25,0.4,3,8,0.375,107,2015-02-21,CHI,PHO,2015,112.0
2356,2356,56,@,L 112-115 ,240,45,94,0.479,41,80,0.513,4,14,0.286,18,22,0.818,112,39,89,0.438,29,63,0.46,10,26,0.385,27,31,0.871,115,2015-02-27,OKC,POR,2015,120.0
2357,2357,57,Home,W 112-85 ,240,45,85,0.529,35,62,0.565,10,23,0.435,12,16,0.75,112,29,78,0.372,26,69,0.377,3,9,0.333,24,34,0.706,85,2015-03-04,SAS,SAC,2015,86.5
2358,2358,58,Home,L 112-120 ,240,43,79,0.544,33,58,0.569,10,21,0.476,16,17,0.941,112,40,78,0.513,25,42,0.595,15,36,0.417,25,34,0.735,120,2015-03-04,TOR,CLE,2015,127.5
2359,2359,59,@,W 112-101 ,240,41,77,0.532,33,59,0.559,8,18,0.444,22,32,0.688,112,34,76,0.447,26,54,0.481,8,22,0.364,25,36,0.694,101,2015-03-20,MEM,DAL,2015,105.0
2360,2360,60,Home,W 112-96 ,240,44,88,0.5,39,69,0.565,5,19,0.263,19,23,0.826,112,33,77,0.429,22,55,0.4,11,22,0.5,19,22,0.864,96,2015-03-20,GSW,NOP,2015,101.5
2361,2361,61,Home,W 112-89 ,240,37,85,0.435,23,55,0.418,14,30,0.467,24,36,0.667,112,37,82,0.451,35,62,0.565,2,20,0.1,13,19,0.684,89,2015-04-05,IND,MIA,2015,90.0
2362,2362,62,Home,L 112-115 ,240,40,92,0.435,26,62,0.419,14,30,0.467,18,26,0.692,112,38,81,0.469,30,53,0.566,8,28,0.286,31,50,0.62,115,2015-04-05,OKC,HOU,2015,119.0
2363,2363,63,@,W 112-108 ,240,43,77,0.558,30,52,0.577,13,25,0.52,13,19,0.684,112,39,88,0.443,28,56,0.5,11,32,0.344,19,23,0.826,108,2015-04-13,NYK,ATL,2015,113.5
2364,2364,64,@,W 112-101 ,240,42,87,0.483,27,49,0.551,15,38,0.395,13,18,0.722,112,39,80,0.488,28,54,0.519,11,26,0.423,12,20,0.6,101,2015-04-14,LAC,PHO,2015,106.5
2365,2365,65,@,W 112-90 ,240,41,81,0.506,31,55,0.564,10,26,0.385,20,27,0.741,112,33,77,0.429,26,58,0.448,7,19,0.368,17,27,0.63,90,2015-04-15,DET,NYK,2015,93.5
2366,2366,66,Home,W 112-95 ,240,39,85,0.459,31,61,0.508,8,24,0.333,26,27,0.963,112,34,83,0.41,27,61,0.443,7,22,0.318,20,23,0.87,95,2015-10-28,BOS,PHI,2016,98.5
2367,2367,67,@,W 112-111 ,240,38,83,0.458,33,63,0.524,5,20,0.25,31,37,0.838,112,35,90,0.389,26,56,0.464,9,34,0.265,32,35,0.914,111,2015-10-28,MIN,LAL,2016,115.5
2368,2368,68,Home,W 112-106 ,240,42,86,0.488,35,67,0.522,7,19,0.368,21,22,0.955,112,45,93,0.484,40,78,0.513,5,15,0.333,11,13,0.846,106,2015-10-28,OKC,SAS,2016,108.5
2369,2369,69,Home,W 112-94 ,240,44,88,0.5,32,56,0.571,12,32,0.375,12,14,0.857,112,36,91,0.396,25,58,0.431,11,33,0.333,11,18,0.611,94,2015-10-28,POR,NOP,2016,99.5
2370,2370,70,@,W 112-103 ,240,41,82,0.5,34,66,0.515,7,16,0.438,23,29,0.793,112,37,78,0.474,25,48,0.521,12,30,0.4,17,24,0.708,103,2015-10-29,MEM,IND,2016,109.0
2371,2371,71,@,W 112-101 ,240,42,83,0.506,32,59,0.542,10,24,0.417,18,26,0.692,112,38,93,0.409,32,64,0.5,6,29,0.207,19,21,0.905,101,2015-10-29,ATL,NYK,2016,104.0
2372,2372,72,@,W 112-92 ,240,43,93,0.462,34,67,0.507,9,26,0.346,17,25,0.68,112,30,82,0.366,25,59,0.424,5,23,0.217,27,36,0.75,92,2015-10-30,GSW,HOU,2016,94.5
2373,2373,73,Home,W 112-108 ,240,39,85,0.459,29,59,0.492,10,26,0.385,24,31,0.774,112,43,88,0.489,35,66,0.53,8,22,0.364,14,22,0.636,108,2015-11-04,GSW,LAC,2016,112.0
2374,2374,74,@,W 112-85 ,240,42,92,0.457,30,65,0.462,12,27,0.444,16,20,0.8,112,35,76,0.461,30,51,0.588,5,25,0.2,10,16,0.625,85,2015-11-18,IND,PHI,2016,87.5
2375,2375,75,Home,W 112-98 ,240,36,79,0.456,27,48,0.563,9,31,0.29,31,44,0.705,112,36,84,0.429,27,47,0.574,9,37,0.243,17,22,0.773,98,2015-11-30,SAC,DAL,2016,102.5
2376,2376,76,Home,L 112-115 (OT),265,41,100,0.41,26,60,0.433,15,40,0.375,15,17,0.882,112,43,94,0.457,34,65,0.523,9,29,0.31,20,24,0.833,115,2015-12-01,POR,DAL,2016,119.5
2377,2377,77,@,W 112-109 ,240,35,73,0.479,19,43,0.442,16,30,0.533,26,36,0.722,112,40,91,0.44,32,71,0.451,8,20,0.4,21,26,0.808,109,2015-12-05,GSW,TOR,2016,113.0
2378,2378,78,@,W 112-110 ,240,39,75,0.52,30,54,0.556,9,21,0.429,25,28,0.893,112,41,89,0.461,35,68,0.515,6,21,0.286,22,29,0.759,110,2015-12-12,NYK,POR,2016,113.0
2379,2379,79,Home,W 112-95 ,240,44,78,0.564,34,63,0.54,10,15,0.667,14,15,0.933,112,37,86,0.43,28,62,0.452,9,24,0.375,12,20,0.6,95,2015-12-14,MEM,WAS,2016,99.5
2380,2380,80,@,W 112-100 ,240,41,73,0.562,31,55,0.564,10,18,0.556,20,27,0.741,112,36,77,0.468,32,67,0.478,4,10,0.4,24,31,0.774,100,2015-12-15,DEN,MIN,2016,102.0
2381,2381,81,@,L 112-121 ,240,42,91,0.462,38,73,0.521,4,18,0.222,24,28,0.857,112,42,87,0.483,33,61,0.541,9,26,0.346,28,37,0.757,121,2015-12-18,MIL,GSW,2016,125.5
2382,2382,82,Home,W 112-96 ,240,45,80,0.563,39,64,0.609,6,16,0.375,16,22,0.727,112,32,84,0.381,24,55,0.436,8,29,0.276,24,32,0.75,96,2015-12-27,MEM,LAL,2016,100.0
2383,2383,83,@,L 112-122 ,240,46,94,0.489,37,69,0.536,9,25,0.36,11,15,0.733,112,48,83,0.578,40,68,0.588,8,15,0.533,18,21,0.857,122,2015-12-27,DEN,OKC,2016,126.0
2384,2384,84,@,W 112-104 ,240,43,94,0.457,34,75,0.453,9,19,0.474,17,23,0.739,112,38,88,0.432,31,61,0.508,7,27,0.259,21,25,0.84,104,2015-12-30,LAL,BOS,2016,107.5
2385,2385,85,Home,W 112-79 ,240,43,76,0.566,37,62,0.597,6,14,0.429,20,33,0.606,112,32,81,0.395,27,63,0.429,5,18,0.278,10,18,0.556,79,2015-12-30,SAS,PHO,2016,81.5
2386,2386,86,@,W 112-106 ,240,40,78,0.513,30,55,0.545,10,23,0.435,22,32,0.688,112,34,80,0.425,27,58,0.466,7,22,0.318,31,48,0.646,106,2016-01-03,POR,DEN,2016,109.5
2387,2387,87,Home,W 112-94 ,240,38,83,0.458,30,66,0.455,8,17,0.471,28,33,0.848,112,35,90,0.389,28,69,0.406,7,21,0.333,17,24,0.708,94,2016-01-06,OKC,MEM,2016,97.5
2388,2388,88,Home,W 112-110 ,240,37,87,0.425,32,65,0.492,5,22,0.227,33,37,0.892,112,42,88,0.477,32,62,0.516,10,26,0.385,16,20,0.8,110,2016-01-13,DEN,GSW,2016,115.0
2389,2389,89,@,W 112-95 ,240,44,91,0.484,38,70,0.543,6,21,0.286,18,24,0.75,112,37,82,0.451,31,63,0.492,6,19,0.316,15,19,0.789,95,2016-01-17,HOU,LAL,2016,98.0
2390,2390,90,Home,W 112-83 ,240,42,90,0.467,37,70,0.529,5,20,0.25,23,28,0.821,112,29,81,0.358,23,58,0.397,6,23,0.261,19,25,0.76,83,2016-01-17,SAS,DAL,2016,86.0
2391,2391,91,Home,W 112-100 ,240,43,85,0.506,30,61,0.492,13,24,0.542,13,18,0.722,112,39,76,0.513,34,62,0.548,5,14,0.357,17,19,0.895,100,2016-01-18,TOR,BRK,2016,102.5
2392,2392,92,@,W 112-93 ,240,43,89,0.483,37,69,0.536,6,20,0.3,20,28,0.714,112,32,90,0.356,28,65,0.431,4,25,0.16,25,31,0.806,93,2016-01-20,SAC,LAL,2016,95.0
2393,2393,93,@,W 112-92 ,240,43,97,0.443,32,72,0.444,11,25,0.44,15,19,0.789,112,35,89,0.393,27,63,0.429,8,26,0.308,14,20,0.7,92,2016-01-24,BOS,PHI,2016,96.0
2394,2394,94,Home,W 112-94 ,240,41,83,0.494,29,61,0.475,12,22,0.545,18,26,0.692,112,34,76,0.447,26,50,0.52,8,26,0.308,18,30,0.6,94,2016-01-24,TOR,LAC,2016,98.0
2395,2395,95,@,W 112-111 ,240,38,80,0.475,19,40,0.475,19,40,0.475,17,21,0.81,112,42,91,0.462,29,62,0.468,13,29,0.448,14,25,0.56,111,2016-01-25,HOU,NOP,2016,117.5
2396,2396,96,Home,W 112-97 ,240,44,90,0.489,35,60,0.583,9,30,0.3,15,19,0.789,112,36,86,0.419,29,67,0.433,7,19,0.368,18,32,0.563,97,2016-01-26,POR,SAC,2016,100.5
2397,2397,97,Home,W 112-97 ,240,42,80,0.525,28,45,0.622,14,35,0.4,14,19,0.737,112,31,85,0.365,24,59,0.407,7,26,0.269,28,38,0.737,97,2016-02-01,ATL,DAL,2016,100.5
2398,2398,98,Home,W 112-93 ,240,45,83,0.542,35,61,0.574,10,22,0.455,12,15,0.8,112,29,78,0.372,21,53,0.396,8,25,0.32,27,39,0.692,93,2016-02-01,DEN,TOR,2016,97.0
2399,2399,99,Home,W 112-104 ,240,41,76,0.539,35,65,0.538,6,11,0.545,24,29,0.828,112,38,79,0.481,26,46,0.565,12,33,0.364,16,31,0.516,104,2016-02-06,IND,DET,2016,110.0
2400,2400,0,Home,W 112-105 ,240,45,87,0.517,44,75,0.587,1,12,0.083,21,22,0.955,112,40,85,0.471,32,65,0.492,8,20,0.4,17,19,0.895,105,2016-02-06,MIN,CHI,2016,109.0
2401,2401,1,@,W 112-106 (OT),265,44,89,0.494,34,60,0.567,10,29,0.345,14,20,0.7,112,43,86,0.5,36,67,0.537,7,19,0.368,13,19,0.684,106,2016-02-08,POR,MEM,2016,109.5
2402,2402,2,Home,W 112-111 ,240,45,88,0.511,38,69,0.551,7,19,0.368,15,23,0.652,112,39,84,0.464,29,55,0.527,10,29,0.345,23,24,0.958,111,2016-02-09,MIL,BOS,2016,116.0
2403,2403,3,@,L 112-117 ,240,39,86,0.453,29,55,0.527,10,31,0.323,24,32,0.75,112,35,76,0.461,31,62,0.5,4,14,0.286,43,53,0.811,117,2016-02-10,TOR,MIN,2016,119.0
2404,2404,4,@,W 112-104 ,240,37,89,0.416,23,49,0.469,14,40,0.35,24,29,0.828,112,41,93,0.441,35,72,0.486,6,21,0.286,16,22,0.727,104,2016-02-10,GSW,PHO,2016,107.0
2405,2405,5,Home,L 112-115 ,240,42,94,0.447,29,58,0.5,13,36,0.361,15,18,0.833,112,42,82,0.512,31,51,0.608,11,31,0.355,20,26,0.769,115,2016-02-20,LAC,GSW,2016,120.5
2406,2406,6,Home,W 112-104 ,240,40,80,0.5,30,57,0.526,10,23,0.435,22,25,0.88,112,43,90,0.478,40,78,0.513,3,12,0.25,15,19,0.789,104,2016-02-23,POR,BRK,2016,105.5
2407,2407,7,Home,L 112-118 ,240,40,86,0.465,34,72,0.472,6,14,0.429,26,31,0.839,112,42,90,0.467,29,62,0.468,13,28,0.464,21,25,0.84,118,2016-02-24,MIA,GSW,2016,124.5
2408,2408,8,Home,W 112-107 ,240,41,84,0.488,36,61,0.59,5,23,0.217,25,33,0.758,112,42,87,0.483,38,72,0.528,4,15,0.267,19,25,0.76,107,2016-02-25,BOS,MIL,2016,109.0
2409,2409,9,@,W 112-95 ,240,43,85,0.506,30,53,0.566,13,32,0.406,13,15,0.867,112,32,78,0.41,27,55,0.491,5,23,0.217,26,39,0.667,95,2016-02-26,MEM,LAL,2016,97.5
2410,2410,10,@,W 112-110 ,240,42,84,0.5,37,69,0.536,5,15,0.333,23,30,0.767,112,39,84,0.464,29,57,0.509,10,27,0.37,22,26,0.846,110,2016-02-27,MIN,NOP,2016,115.0
2411,2411,11,@,W 112-102 ,240,39,88,0.443,34,72,0.472,5,16,0.313,29,36,0.806,112,36,95,0.379,27,64,0.422,9,31,0.29,21,27,0.778,102,2016-03-04,MIA,PHI,2016,106.5
2412,2412,12,Home,W 112-95 ,240,41,87,0.471,32,62,0.516,9,25,0.36,21,22,0.955,112,37,92,0.402,33,62,0.532,4,30,0.133,17,21,0.81,95,2016-03-06,LAL,GSW,2016,97.0
2413,2413,13,@,L 112-115 ,240,41,83,0.494,34,58,0.586,7,25,0.28,23,27,0.852,112,45,94,0.479,38,69,0.551,7,25,0.28,18,26,0.692,115,2016-03-07,SAC,NOP,2016,118.5
2414,2414,14,@,L 112-128 ,240,37,86,0.43,18,50,0.36,19,36,0.528,19,23,0.826,112,40,89,0.449,22,49,0.449,18,40,0.45,30,39,0.769,128,2016-03-11,POR,GSW,2016,137.0
2415,2415,15,@,W 112-105 ,240,38,81,0.469,29,53,0.547,9,28,0.321,27,29,0.931,112,41,85,0.482,33,63,0.524,8,22,0.364,15,18,0.833,105,2016-03-12,IND,DAL,2016,109.0
2416,2416,16,Home,W 112-104 (OT),265,37,84,0.44,31,66,0.47,6,18,0.333,32,38,0.842,112,37,98,0.378,28,73,0.384,9,25,0.36,21,26,0.808,104,2016-03-12,TOR,MIA,2016,108.5
2417,2417,17,Home,L 112-130 ,240,41,93,0.441,32,64,0.5,9,29,0.31,21,22,0.955,112,48,95,0.505,26,57,0.456,22,38,0.579,12,14,0.857,130,2016-03-18,DAL,GSW,2016,141.0
2418,2418,18,Home,L 112-117 ,240,40,83,0.482,30,62,0.484,10,21,0.476,22,28,0.786,112,36,78,0.462,27,51,0.529,9,27,0.333,36,40,0.9,117,2016-03-18,NOP,POR,2016,121.5
2419,2419,19,Home,W 112-88 ,240,42,81,0.519,34,67,0.507,8,14,0.571,20,24,0.833,112,37,77,0.481,30,63,0.476,7,14,0.5,7,12,0.583,88,2016-03-23,SAS,MIA,2016,91.5
2420,2420,20,Home,W 112-105 ,240,42,91,0.462,34,61,0.557,8,30,0.267,20,26,0.769,112,37,93,0.398,23,63,0.365,14,30,0.467,17,22,0.773,105,2016-03-25,DET,CHO,2016,112.0
2421,2421,21,Home,W 112-109 ,240,42,81,0.519,30,59,0.508,12,22,0.545,16,35,0.457,112,39,94,0.415,26,63,0.413,13,31,0.419,18,26,0.692,109,2016-03-25,HOU,TOR,2016,115.5
2422,2422,22,@,W 112-95 ,240,43,95,0.453,30,61,0.492,13,34,0.382,13,14,0.929,112,34,88,0.386,27,59,0.458,7,29,0.241,20,28,0.714,95,2016-03-26,ATL,DET,2016,98.5
2423,2423,23,@,W 112-106 ,240,42,82,0.512,30,60,0.5,12,22,0.545,16,17,0.941,112,38,87,0.437,31,66,0.47,7,21,0.333,23,29,0.793,106,2016-04-01,MIA,SAC,2016,109.5
2424,2424,24,Home,W 112-103 ,240,45,83,0.542,29,54,0.537,16,29,0.552,6,13,0.462,112,34,76,0.447,25,50,0.5,9,26,0.346,26,27,0.963,103,2016-04-03,CLE,CHO,2016,107.5
2425,2425,25,Home,W 112-101 ,240,45,83,0.542,33,58,0.569,12,25,0.48,10,11,0.909,112,39,80,0.488,32,64,0.5,7,16,0.438,16,23,0.696,101,2016-04-07,GSW,SAS,2016,104.5
2426,2426,26,Home,W 112-99 ,240,36,77,0.468,22,45,0.489,14,32,0.438,26,29,0.897,112,38,86,0.442,32,67,0.478,6,19,0.316,17,23,0.739,99,2016-04-08,DET,WAS,2016,102.0
2427,2427,27,Home,W 112-109 ,240,43,82,0.524,38,71,0.535,5,11,0.455,21,28,0.75,112,45,100,0.45,37,78,0.474,8,22,0.364,11,21,0.524,109,2016-04-08,ORL,MIA,2016,113.0
2428,2428,28,@,L 112-114 ,240,39,81,0.481,26,49,0.531,13,32,0.406,21,28,0.75,112,45,94,0.479,32,62,0.516,13,32,0.406,11,20,0.55,114,2016-04-09,OKC,SAC,2016,120.5
2429,2429,29,Home,W 112-79 ,240,42,96,0.438,30,59,0.508,12,37,0.324,16,27,0.593,112,23,81,0.284,16,50,0.32,7,31,0.226,26,30,0.867,79,2016-04-11,OKC,LAL,2016,82.5
2430,2430,30,@,W 112-110 (OT),265,37,85,0.435,21,52,0.404,16,33,0.485,22,28,0.786,112,46,97,0.474,39,79,0.494,7,18,0.389,11,15,0.733,110,2016-04-13,DET,CLE,2016,113.5
2431,2431,31,Home,W 112-103 (OT),265,39,88,0.443,24,57,0.421,15,31,0.484,19,26,0.731,112,38,86,0.442,33,61,0.541,5,25,0.2,22,25,0.88,103,2016-10-30,MEM,WAS,2017,105.5
2432,2432,32,@,W 112-111 (OT),265,40,93,0.43,32,69,0.464,8,24,0.333,24,28,0.857,112,43,94,0.457,33,64,0.516,10,30,0.333,15,28,0.536,111,2016-11-04,PHO,NOP,2017,116.0
2433,2433,33,Home,W 112-97 ,240,45,85,0.529,37,65,0.569,8,20,0.4,14,24,0.583,112,37,85,0.435,25,49,0.51,12,36,0.333,11,13,0.846,97,2016-11-05,ATL,HOU,2017,103.0
2434,2434,34,Home,W 112-92 ,240,45,86,0.523,38,70,0.543,7,16,0.438,15,24,0.625,112,33,84,0.393,29,65,0.446,4,19,0.211,22,29,0.759,92,2016-11-05,OKC,MIN,2017,94.0
2435,2435,35,Home,W 112-80 ,240,42,89,0.472,39,70,0.557,3,19,0.158,25,31,0.806,112,33,85,0.388,24,55,0.436,9,30,0.3,5,6,0.833,80,2016-11-07,CHI,ORL,2017,84.5
2436,2436,36,@,W 112-102 ,240,43,83,0.518,32,57,0.561,11,26,0.423,15,22,0.682,112,31,74,0.419,19,40,0.475,12,34,0.353,28,31,0.903,102,2016-11-09,TOR,OKC,2017,108.0
2437,2437,37,@,W 112-106 ,240,39,89,0.438,30,64,0.469,9,25,0.36,25,27,0.926,112,40,91,0.44,34,73,0.466,6,18,0.333,20,25,0.8,106,2016-11-10,NOP,MIL,2017,109.0
2438,2438,38,Home,W 112-105 ,240,39,99,0.394,31,70,0.443,8,29,0.276,26,32,0.813,112,36,91,0.396,25,62,0.403,11,29,0.379,22,29,0.759,105,2016-11-13,POR,DEN,2017,110.5
2439,2439,39,@,L 112-119 ,240,41,86,0.477,29,57,0.509,12,29,0.414,18,20,0.9,112,44,81,0.543,29,56,0.518,15,25,0.6,16,18,0.889,119,2016-11-17,NYK,WAS,2017,126.5
2440,2440,40,@,W 112-94 ,240,45,86,0.523,34,61,0.557,11,25,0.44,11,12,0.917,112,39,85,0.459,29,56,0.518,10,29,0.345,6,10,0.6,94,2016-11-22,NOP,ATL,2017,99.0
2441,2441,41,@,W 112-100 ,240,40,75,0.533,31,51,0.608,9,24,0.375,23,29,0.793,112,42,88,0.477,36,66,0.545,6,22,0.273,10,14,0.714,100,2016-11-26,SAS,WAS,2017,103.0
2442,2442,42,@,W 112-108 ,240,38,92,0.413,26,52,0.5,12,40,0.3,24,28,0.857,112,43,92,0.467,28,58,0.483,15,34,0.441,7,10,0.7,108,2016-11-27,CLE,PHI,2017,115.5
2443,2443,43,@,W 112-104 ,240,40,83,0.482,29,56,0.518,11,27,0.407,21,26,0.808,112,38,80,0.475,32,50,0.64,6,30,0.2,22,32,0.688,104,2016-11-28,BOS,MIA,2017,107.0
2444,2444,44,@,W 112-103 ,240,40,79,0.506,36,61,0.59,4,18,0.222,28,34,0.824,112,36,81,0.444,29,62,0.468,7,19,0.368,24,25,0.96,103,2016-11-28,UTA,MIN,2017,106.5
2445,2445,45,@,W 112-103 ,240,46,92,0.5,38,70,0.543,8,22,0.364,12,18,0.667,112,36,91,0.396,30,72,0.417,6,19,0.316,25,28,0.893,103,2016-11-28,OKC,NYK,2017,106.0
2446,2446,46,@,W 112-89 ,240,45,92,0.489,33,64,0.516,12,28,0.429,10,11,0.909,112,31,78,0.397,22,51,0.431,9,27,0.333,18,21,0.857,89,2016-11-29,DET,CHO,2017,93.5
2447,2447,47,Home,W 112-103 ,240,40,85,0.471,34,61,0.557,6,24,0.25,26,36,0.722,112,34,91,0.374,23,50,0.46,11,41,0.268,24,33,0.727,103,2016-12-03,MIL,BRK,2017,108.5
2448,2448,48,@,W 112-110 ,240,45,93,0.484,36,69,0.522,9,24,0.375,13,18,0.722,112,35,83,0.422,28,60,0.467,7,23,0.304,33,38,0.868,110,2016-12-05,POR,CHI,2017,113.5
2449,2449,49,Home,L 112-116 ,240,38,88,0.432,25,56,0.446,13,32,0.406,23,27,0.852,112,40,84,0.476,26,52,0.5,14,32,0.438,22,27,0.815,116,2016-12-05,TOR,CLE,2017,123.0
2450,2450,50,Home,W 112-105 ,240,36,73,0.493,24,46,0.522,12,27,0.444,28,32,0.875,112,39,84,0.464,33,66,0.5,6,18,0.333,21,25,0.84,105,2016-12-06,UTA,PHO,2017,108.0
2451,2451,51,Home,L 112-118 ,240,42,88,0.477,32,60,0.533,10,28,0.357,18,22,0.818,112,41,84,0.488,31,62,0.5,10,22,0.455,26,31,0.839,118,2016-12-11,LAL,NYK,2017,123.0
2452,2452,52,Home,W 112-92 ,240,45,77,0.584,33,51,0.647,12,26,0.462,10,12,0.833,112,35,83,0.422,28,58,0.483,7,25,0.28,15,18,0.833,92,2016-12-12,DAL,DEN,2017,95.5
2453,2453,53,Home,W 112-101 ,240,45,88,0.511,36,62,0.581,9,26,0.346,13,19,0.684,112,39,84,0.464,34,61,0.557,5,23,0.217,18,22,0.818,101,2016-12-12,MIA,WAS,2017,103.5
2454,2454,54,@,W 112-109 (OT),265,33,81,0.407,21,44,0.477,12,37,0.324,34,38,0.895,112,38,94,0.404,26,64,0.406,12,30,0.4,21,26,0.808,109,2016-12-20,BOS,MEM,2017,115.0
2455,2455,55,Home,L 112-117 ,240,41,93,0.441,32,65,0.492,9,28,0.321,21,26,0.808,112,41,80,0.513,30,54,0.556,11,26,0.423,24,36,0.667,117,2016-12-23,BOS,OKC,2017,122.5
2456,2456,56,Home,W 112-100 ,240,42,82,0.512,34,58,0.586,8,24,0.333,20,24,0.833,112,39,83,0.47,35,71,0.493,4,12,0.333,18,23,0.783,100,2016-12-25,OKC,MIN,2017,102.0
2457,2457,57,Home,W 112-102 ,240,44,86,0.512,31,60,0.517,13,26,0.5,11,16,0.688,112,35,76,0.461,25,51,0.49,10,25,0.4,22,28,0.786,102,2016-12-26,ORL,MEM,2017,107.0
2458,2458,58,@,W 112-98 ,240,44,87,0.506,27,52,0.519,17,35,0.486,7,9,0.778,112,31,72,0.431,20,44,0.455,11,28,0.393,25,28,0.893,98,2016-12-31,MEM,SAC,2017,103.5
2459,2459,59,@,L 112-114 (OT),265,42,90,0.467,33,63,0.524,9,27,0.333,19,22,0.864,112,42,92,0.457,28,64,0.438,14,28,0.5,16,27,0.593,114,2017-01-01,SAS,ATL,2017,121.0
2460,2460,60,@,L 112-123 ,240,42,96,0.438,33,66,0.5,9,30,0.3,19,23,0.826,112,37,80,0.463,28,56,0.5,9,24,0.375,40,49,0.816,123,2017-01-04,OKC,CHO,2017,127.5
2461,2461,61,Home,W 112-105 ,240,46,79,0.582,34,57,0.596,12,22,0.545,8,9,0.889,112,42,88,0.477,35,70,0.5,7,18,0.389,14,17,0.824,105,2017-01-06,WAS,MIN,2017,108.5
2462,2462,62,@,L 112-140 ,240,44,94,0.468,32,65,0.492,12,29,0.414,12,13,0.923,112,52,91,0.571,37,59,0.627,15,32,0.469,21,23,0.913,140,2017-01-12,IND,DEN,2017,147.5
2463,2463,63,Home,L 112-137 ,240,41,93,0.441,26,49,0.531,15,44,0.341,15,19,0.789,112,46,92,0.5,25,48,0.521,21,44,0.477,24,32,0.75,137,2017-01-15,BRK,HOU,2017,147.5
2464,2464,64,@,L 112-125 ,240,45,88,0.511,37,63,0.587,8,25,0.32,14,18,0.778,112,52,89,0.584,43,62,0.694,9,27,0.333,12,15,0.8,125,2017-01-16,ORL,DEN,2017,129.5
2465,2465,65,@,W 112-107 (OT),265,38,82,0.463,30,59,0.508,8,23,0.348,28,39,0.718,112,39,87,0.448,31,64,0.484,8,23,0.348,21,28,0.75,107,2017-01-20,UTA,DAL,2017,111.0
2466,2466,66,Home,W 112-96 ,240,40,87,0.46,32,59,0.542,8,28,0.286,24,31,0.774,112,34,84,0.405,24,59,0.407,10,25,0.4,18,26,0.692,96,2017-01-20,ORL,MIL,2017,101.0
2467,2467,67,Home,W 112-105 ,240,39,82,0.476,25,53,0.472,14,29,0.483,20,22,0.909,112,38,89,0.427,21,48,0.438,17,41,0.415,12,15,0.8,105,2017-01-21,CHA,BRK,2017,113.5
2468,2468,68,@,L 112-113 ,240,39,91,0.429,31,65,0.477,8,26,0.308,26,33,0.788,112,43,87,0.494,32,59,0.542,11,28,0.393,16,22,0.727,113,2017-01-21,WAS,DET,2017,118.5
2469,2469,69,@,W 112-86 ,240,45,95,0.474,36,73,0.493,9,22,0.409,13,16,0.813,112,32,81,0.395,27,56,0.482,5,25,0.2,17,18,0.944,86,2017-01-23,SAS,BRK,2017,88.5
2470,2470,70,@,W 112-111 ,240,44,84,0.524,38,67,0.567,6,17,0.353,18,24,0.75,112,38,86,0.442,31,67,0.463,7,19,0.368,28,32,0.875,111,2017-01-24,MIN,PHO,2017,114.5
2471,2471,71,Home,L 112-116 (OT),265,40,82,0.488,25,44,0.568,15,38,0.395,17,34,0.5,112,43,95,0.453,32,64,0.5,11,31,0.355,19,22,0.864,116,2017-01-25,CLE,SAC,2017,121.5
2472,2472,72,@,W 112-86 ,240,43,89,0.483,30,58,0.517,13,31,0.419,13,19,0.684,112,30,83,0.361,21,52,0.404,9,31,0.29,17,25,0.68,86,2017-01-27,WAS,ATL,2017,90.5
2473,2473,73,Home,W 112-109 ,240,38,81,0.469,22,46,0.478,16,35,0.457,20,21,0.952,112,37,77,0.481,28,51,0.549,9,26,0.346,26,33,0.788,109,2017-01-27,POR,MEM,2017,113.5
2474,2474,74,@,W 112-108 (OT),265,37,89,0.416,23,49,0.469,14,40,0.35,24,30,0.8,112,37,87,0.425,28,66,0.424,9,21,0.429,25,32,0.781,108,2017-01-28,BOS,MIL,2017,112.5
2475,2475,75,Home,L 112-123 ,240,41,91,0.451,35,70,0.5,6,21,0.286,24,32,0.75,112,39,80,0.488,31,55,0.564,8,25,0.32,37,42,0.881,123,2017-01-28,PHO,DEN,2017,127.0
2476,2476,76,Home,L 112-137 ,240,38,91,0.418,27,63,0.429,11,28,0.393,25,30,0.833,112,52,82,0.634,45,65,0.692,7,17,0.412,26,35,0.743,137,2017-02-04,PHO,MIL,2017,140.5
2477,2477,77,@,W 112-107 ,240,43,81,0.531,37,62,0.597,6,19,0.316,20,31,0.645,112,41,79,0.519,30,51,0.588,11,28,0.393,14,16,0.875,107,2017-02-06,CHI,SAC,2017,112.5
2478,2478,78,Home,W 112-109 ,240,39,80,0.488,32,61,0.525,7,19,0.368,27,30,0.9,112,42,79,0.532,31,51,0.608,11,28,0.393,14,20,0.7,109,2017-02-08,MIN,TOR,2017,114.5
2479,2479,79,Home,W 112-105 (OT),265,44,87,0.506,39,67,0.582,5,20,0.25,19,25,0.76,112,39,85,0.459,26,56,0.464,13,29,0.448,14,17,0.824,105,2017-02-09,DAL,UTA,2017,111.5
2480,2480,80,@,W 112-111 ,240,40,95,0.421,29,67,0.433,11,28,0.393,21,27,0.778,112,41,84,0.488,31,63,0.492,10,21,0.476,19,24,0.792,111,2017-02-09,PHI,ORL,2017,116.0
2481,2481,81,Home,W 112-107 ,240,41,88,0.466,31,59,0.525,10,29,0.345,20,30,0.667,112,45,92,0.489,41,71,0.577,4,21,0.19,13,15,0.867,107,2017-02-10,WAS,IND,2017,109.0
2482,2482,82,Home,W 112-80 ,240,45,91,0.495,28,56,0.5,17,35,0.486,5,6,0.833,112,32,82,0.39,29,59,0.492,3,23,0.13,13,18,0.722,80,2017-02-11,DAL,ORL,2017,81.5
2483,2483,83,@,W 112-104 ,240,42,71,0.592,29,41,0.707,13,30,0.433,15,23,0.652,112,35,86,0.407,27,55,0.491,8,31,0.258,26,30,0.867,104,2017-02-11,BOS,UTA,2017,108.0
2484,2484,84,@,W 112-103 ,240,39,77,0.506,30,55,0.545,9,22,0.409,25,27,0.926,112,38,82,0.463,26,45,0.578,12,37,0.324,15,18,0.833,103,2017-02-13,MEM,BRK,2017,109.0
2485,2485,85,@,W 112-99 ,240,41,86,0.477,35,68,0.515,6,18,0.333,24,28,0.857,112,38,94,0.404,27,60,0.45,11,34,0.324,12,18,0.667,99,2017-02-15,MIN,DEN,2017,104.5
2486,2486,86,@,W 112-103 ,240,41,81,0.506,32,62,0.516,9,19,0.474,21,27,0.778,112,34,86,0.395,27,64,0.422,7,22,0.318,28,39,0.718,103,2017-02-23,POR,ORL,2017,106.5
2487,2487,87,@,L 112-120 ,240,38,90,0.422,33,66,0.5,5,24,0.208,31,40,0.775,112,43,87,0.494,33,58,0.569,10,29,0.345,24,30,0.8,120,2017-02-24,WAS,PHI,2017,125.0
2488,2488,88,Home,W 112-95 ,240,42,100,0.42,31,69,0.449,11,31,0.355,17,22,0.773,112,38,94,0.404,30,66,0.455,8,28,0.286,11,17,0.647,95,2017-02-25,GSW,BRK,2017,99.0
2489,2489,89,Home,W 112-106 ,240,42,78,0.538,35,58,0.603,7,20,0.35,21,27,0.778,112,35,79,0.443,26,58,0.448,9,21,0.429,27,35,0.771,106,2017-02-26,TOR,POR,2017,110.5
2490,2490,90,@,L 112-130 ,240,43,83,0.518,36,62,0.581,7,21,0.333,19,24,0.792,112,48,86,0.558,36,61,0.59,12,25,0.48,22,29,0.759,130,2017-02-28,PHO,MEM,2017,136.0
2491,2491,91,Home,W 112-108 ,240,41,91,0.451,29,63,0.46,12,28,0.429,18,20,0.9,112,39,84,0.464,31,55,0.564,8,29,0.276,22,27,0.815,108,2017-02-28,WAS,GSW,2017,112.0
2492,2492,92,Home,W 112-101 ,240,44,80,0.55,34,55,0.618,10,25,0.4,14,15,0.933,112,36,64,0.563,28,45,0.622,8,19,0.421,21,36,0.583,101,2017-03-03,MIL,LAC,2017,105.0
2493,2493,93,Home,W 112-97 ,240,38,74,0.514,26,48,0.542,12,26,0.462,24,34,0.706,112,36,89,0.404,29,59,0.492,7,30,0.233,18,24,0.75,97,2017-03-03,UTA,BRK,2017,100.5
2494,2494,94,@,W 112-102 ,240,41,90,0.456,25,63,0.397,16,27,0.593,14,17,0.824,112,36,80,0.45,27,50,0.54,9,30,0.3,21,25,0.84,102,2017-03-04,CHA,DEN,2017,106.5
2495,2495,95,@,W 112-105 ,240,40,88,0.455,27,53,0.509,13,35,0.371,19,23,0.826,112,39,83,0.47,32,61,0.525,7,22,0.318,20,25,0.8,105,2017-03-05,GSW,NYK,2017,108.5
2496,2496,96,@,W 112-98 ,240,41,83,0.494,27,50,0.54,14,33,0.424,16,20,0.8,112,39,89,0.438,31,59,0.525,8,30,0.267,12,19,0.632,98,2017-03-06,MIL,PHI,2017,102.0
2497,2497,97,Home,W 112-110 ,240,40,87,0.46,29,60,0.483,11,27,0.407,21,23,0.913,112,41,88,0.466,27,49,0.551,14,39,0.359,14,17,0.824,110,2017-03-06,SAS,HOU,2017,117.0
2498,2498,98,Home,W 111-102 ,240,41,79,0.519,33,59,0.559,8,20,0.4,21,23,0.913,111,35,87,0.402,31,67,0.463,4,20,0.2,28,33,0.848,102,2011-12-29,POR,DEN,2012,104.0
2499,2499,99,Home,W 111-106 (OT),265,38,95,0.4,29,68,0.426,9,27,0.333,26,30,0.867,111,39,85,0.459,37,74,0.5,2,11,0.182,26,40,0.65,106,2012-01-10,GSW,MIA,2012,107.0
2500,2500,0,@,W 111-100 ,240,43,81,0.531,32,61,0.525,11,20,0.55,14,21,0.667,111,33,78,0.423,25,56,0.446,8,22,0.364,26,32,0.813,100,2012-01-10,CHI,MIN,2012,104.0
2501,2501,1,Home,W 111-81 ,240,42,90,0.467,36,71,0.507,6,19,0.316,21,28,0.75,111,33,78,0.423,32,70,0.457,1,8,0.125,14,16,0.875,81,2012-01-12,ATL,CHA,2012,81.5
2502,2502,2,@,W 111-78 ,240,39,78,0.5,32,59,0.542,7,19,0.368,26,33,0.788,111,27,82,0.329,24,71,0.338,3,11,0.273,21,22,0.955,78,2012-01-24,NYK,CHA,2012,79.5
2503,2503,3,@,W 111-106 (2OT),290,43,96,0.448,33,68,0.485,10,28,0.357,15,19,0.789,111,39,90,0.433,35,72,0.486,4,18,0.222,24,36,0.667,106,2012-01-25,TOR,UTA,2012,108.0
2504,2504,4,@,W 111-107 (OT),265,43,95,0.453,37,73,0.507,6,22,0.273,19,22,0.864,111,41,97,0.423,36,77,0.468,5,20,0.25,20,26,0.769,107,2012-02-06,OKC,POR,2012,109.5
2505,2505,5,Home,W 111-108 (OT),265,39,80,0.488,36,71,0.507,3,9,0.333,30,41,0.732,111,34,85,0.4,21,59,0.356,13,26,0.5,27,34,0.794,108,2012-02-06,WAS,TOR,2012,114.5
2506,2506,6,@,W 111-86 ,240,41,78,0.526,33,58,0.569,8,20,0.4,21,24,0.875,111,26,74,0.351,25,60,0.417,1,14,0.071,33,43,0.767,86,2012-02-11,LAC,CHA,2012,86.5
2507,2507,7,Home,W 111-85 ,240,42,77,0.545,37,63,0.587,5,14,0.357,22,34,0.647,111,32,90,0.356,29,77,0.377,3,13,0.231,18,24,0.75,85,2012-02-14,OKC,UTA,2012,86.5
2508,2508,8,@,W 111-87 ,240,40,79,0.506,26,58,0.448,14,21,0.667,17,20,0.85,111,30,76,0.395,24,60,0.4,6,16,0.375,21,31,0.677,87,2012-02-17,MIA,CLE,2012,90.0
2509,2509,9,@,W 111-98 ,240,43,77,0.558,38,62,0.613,5,15,0.333,20,23,0.87,111,40,85,0.471,30,65,0.462,10,20,0.5,8,10,0.8,98,2012-02-17,MIN,HOU,2012,103.0
2510,2510,10,Home,W 111-99 ,240,44,83,0.53,39,72,0.542,5,11,0.455,18,24,0.75,111,41,90,0.456,33,64,0.516,8,26,0.308,9,13,0.692,99,2012-02-17,LAL,PHO,2012,103.0
2511,2511,11,@,L 111-115 (OT),265,41,94,0.436,33,76,0.434,8,18,0.444,21,26,0.808,111,45,103,0.437,38,85,0.447,7,18,0.389,18,22,0.818,115,2012-03-04,NYK,BOS,2012,118.5
2512,2512,12,Home,W 111-97 ,240,43,77,0.558,36,59,0.61,7,18,0.389,18,24,0.75,111,40,85,0.471,40,82,0.488,0,3,0.0,17,22,0.773,97,2012-03-10,CHI,UTA,2012,97.0
2513,2513,13,Home,W 111-87 ,240,40,74,0.541,30,49,0.612,10,25,0.4,21,25,0.84,111,28,75,0.373,18,52,0.346,10,23,0.435,21,26,0.808,87,2012-03-10,GSW,DAL,2012,92.0
2514,2514,14,Home,L 111-116 (2OT),290,52,116,0.448,50,97,0.515,2,19,0.105,5,5,1.0,111,41,83,0.494,35,63,0.556,6,20,0.3,28,34,0.824,116,2012-03-13,MEM,LAL,2012,119.0
2515,2515,15,Home,W 111-94 ,240,43,76,0.566,36,59,0.61,7,17,0.412,18,22,0.818,111,40,76,0.526,34,63,0.54,6,13,0.462,8,10,0.8,94,2012-03-14,IND,PHI,2012,97.0
2516,2516,16,@,L 111-120 ,240,47,90,0.522,42,77,0.545,5,13,0.385,12,17,0.706,111,44,78,0.564,35,59,0.593,9,19,0.474,23,32,0.719,120,2012-03-14,UTA,PHO,2012,124.5
2517,2517,17,@,L 111-122 ,240,45,86,0.523,34,59,0.576,11,27,0.407,10,16,0.625,111,43,83,0.518,30,57,0.526,13,26,0.5,23,27,0.852,122,2012-03-14,ORL,SAS,2012,128.5
2518,2518,18,Home,W 111-105 (OT),265,43,103,0.417,38,90,0.422,5,13,0.385,20,27,0.741,111,36,83,0.434,27,56,0.482,9,27,0.333,24,33,0.727,105,2012-03-15,UTA,MIN,2012,109.5
2519,2519,19,Home,W 111-95 ,240,41,74,0.554,30,56,0.536,11,18,0.611,18,28,0.643,111,39,84,0.464,31,63,0.492,8,21,0.381,9,14,0.643,95,2012-03-18,OKC,POR,2012,99.0
2520,2520,20,Home,L 111-113 ,240,42,81,0.519,35,70,0.5,7,11,0.636,20,22,0.909,111,41,84,0.488,36,67,0.537,5,17,0.294,26,37,0.703,113,2012-03-23,IND,PHO,2012,115.5
2521,2521,21,Home,W 111-108 ,240,43,88,0.489,36,67,0.537,7,21,0.333,18,21,0.857,111,43,91,0.473,42,76,0.553,1,15,0.067,21,27,0.778,108,2012-03-24,GSW,SAC,2012,108.5
2522,2522,22,@,W 111-99 ,240,43,92,0.467,33,64,0.516,10,28,0.357,15,20,0.75,111,39,90,0.433,36,73,0.493,3,17,0.176,18,23,0.783,99,2012-03-31,BRK,SAC,2012,100.5
2523,2523,23,@,W 111-107 ,240,41,80,0.513,35,64,0.547,6,16,0.375,23,27,0.852,111,42,85,0.494,34,60,0.567,8,25,0.32,15,24,0.625,107,2012-04-11,NYK,MIL,2012,111.0
2524,2524,24,Home,W 111-88 ,240,39,88,0.443,28,64,0.438,11,24,0.458,22,25,0.88,111,32,87,0.368,25,62,0.403,7,25,0.28,17,25,0.68,88,2012-04-16,IND,MIN,2012,91.5
2525,2525,25,@,L 111-114 ,240,39,77,0.506,24,46,0.522,15,31,0.484,18,22,0.818,111,42,85,0.494,29,56,0.518,13,29,0.448,17,21,0.81,114,2012-11-21,NYK,DAL,2013,120.5
2526,2526,26,@,L 111-117 (OT),265,40,93,0.43,33,73,0.452,7,20,0.35,24,33,0.727,111,36,79,0.456,25,56,0.446,11,23,0.478,34,39,0.872,117,2012-11-21,LAC,OKC,2013,122.5
2527,2527,27,Home,W 111-108 (OT),265,44,90,0.489,33,65,0.508,11,25,0.44,12,19,0.632,111,40,78,0.513,27,52,0.519,13,26,0.5,15,18,0.833,108,2012-11-23,PHO,NOH,2013,114.5
2528,2528,28,@,W 111-106 (2OT),290,44,103,0.427,36,76,0.474,8,27,0.296,15,19,0.789,111,40,110,0.364,34,86,0.395,6,24,0.25,20,24,0.833,106,2012-11-25,SAS,TOR,2013,109.0
2529,2529,29,Home,L 111-113 ,240,38,78,0.487,26,58,0.448,12,20,0.6,23,32,0.719,111,41,85,0.482,31,62,0.5,10,23,0.435,21,22,0.955,113,2012-11-30,ATL,CLE,2013,118.0
2530,2530,30,Home,L 111-117 ,240,39,91,0.429,25,57,0.439,14,34,0.412,19,23,0.826,111,40,66,0.606,33,52,0.635,7,14,0.5,30,34,0.882,117,2012-12-04,BRK,OKC,2013,120.5
2531,2531,31,@,W 111-85 ,240,44,82,0.537,39,71,0.549,5,11,0.455,18,24,0.75,111,30,83,0.361,23,62,0.371,7,21,0.333,18,25,0.72,85,2012-12-15,LAC,MIL,2013,88.5
2532,2532,32,@,W 111-98 ,240,39,80,0.488,25,46,0.543,14,34,0.412,19,24,0.792,111,41,83,0.494,31,58,0.534,10,25,0.4,6,11,0.545,98,2012-12-16,LAL,PHI,2013,103.0
2533,2533,33,Home,W 111-105 (OT),265,39,93,0.419,29,68,0.426,10,25,0.4,23,28,0.821,111,40,95,0.421,29,71,0.408,11,24,0.458,14,16,0.875,105,2012-12-27,OKC,DAL,2013,110.5
2534,2534,34,Home,W 111-107 ,240,45,89,0.506,40,71,0.563,5,18,0.278,16,26,0.615,111,45,97,0.464,43,80,0.538,2,17,0.118,15,24,0.625,107,2012-12-29,MIN,PHO,2013,108.0
2535,2535,35,@,W 111-86 ,240,41,81,0.506,33,62,0.532,8,19,0.421,21,24,0.875,111,38,95,0.4,37,79,0.468,1,16,0.063,9,10,0.9,86,2012-12-30,SAS,DAL,2013,86.5
2536,2536,36,@,L 111-115 (OT),265,42,88,0.477,34,61,0.557,8,27,0.296,19,23,0.826,111,47,99,0.475,38,74,0.514,9,25,0.36,12,19,0.632,115,2013-01-15,POR,DEN,2013,119.5
2537,2537,37,@,W 111-99 ,240,44,83,0.53,34,65,0.523,10,18,0.556,13,18,0.722,111,39,82,0.476,28,61,0.459,11,21,0.524,10,13,0.769,99,2013-01-15,NOP,PHI,2013,104.5
2538,2538,38,@,W 111-105 ,240,45,90,0.5,37,75,0.493,8,15,0.533,13,15,0.867,111,40,79,0.506,31,58,0.534,9,21,0.429,16,20,0.8,105,2013-01-20,DAL,ORL,2013,109.5
2539,2539,39,@,L 111-123 (2OT),290,42,93,0.452,35,74,0.473,7,19,0.368,20,20,1.0,111,42,94,0.447,30,58,0.517,12,36,0.333,27,36,0.75,123,2013-01-25,BOS,ATL,2013,129.0
2540,2540,40,Home,W 111-106 ,240,39,79,0.494,27,46,0.587,12,33,0.364,21,33,0.636,111,39,92,0.424,30,73,0.411,9,19,0.474,19,21,0.905,106,2013-01-29,LAL,NOH,2013,110.5
2541,2541,41,@,W 111-100 ,240,39,92,0.424,27,60,0.45,12,32,0.375,21,25,0.84,111,41,89,0.461,31,67,0.463,10,22,0.455,8,18,0.444,100,2013-02-01,LAL,MIN,2013,105.0
2542,2542,42,Home,W 111-101 ,240,39,74,0.527,33,60,0.55,6,14,0.429,27,34,0.794,111,39,88,0.443,35,72,0.486,4,16,0.25,19,22,0.864,101,2013-02-04,IND,CHI,2013,103.0
2543,2543,43,@,W 111-100 ,240,45,86,0.523,36,70,0.514,9,16,0.563,12,18,0.667,111,35,74,0.473,22,50,0.44,13,24,0.542,17,23,0.739,100,2013-02-08,NOP,ATL,2013,106.5
2544,2544,44,Home,W 111-89 ,240,36,68,0.529,21,41,0.512,15,27,0.556,24,32,0.75,111,34,77,0.442,27,61,0.443,7,16,0.438,14,19,0.737,89,2013-02-08,MIA,LAC,2013,92.5
2545,2545,45,@,W 111-103 ,240,40,80,0.5,34,63,0.54,6,17,0.353,25,34,0.735,111,37,84,0.44,28,64,0.438,9,20,0.45,20,26,0.769,103,2013-02-09,DEN,CLE,2013,107.5
2546,2546,46,@,W 111-86 ,240,43,73,0.589,31,54,0.574,12,19,0.632,13,20,0.65,111,34,72,0.472,28,53,0.528,6,19,0.316,12,17,0.706,86,2013-02-10,SAS,BRK,2013,89.0
2547,2547,47,@,L 111-117 ,240,44,89,0.494,34,56,0.607,10,33,0.303,13,17,0.765,111,40,87,0.46,29,67,0.433,11,20,0.55,26,27,0.963,117,2013-02-10,HOU,SAC,2013,122.5
2548,2548,48,@,L 111-113 (OT),265,46,96,0.479,39,76,0.513,7,20,0.35,12,18,0.667,111,43,91,0.473,33,72,0.458,10,19,0.526,17,23,0.739,113,2013-02-19,MIL,BRK,2013,118.0
2549,2549,49,Home,W 111-96 ,240,42,88,0.477,31,59,0.525,11,29,0.379,16,18,0.889,111,39,85,0.459,34,69,0.493,5,16,0.313,13,22,0.591,96,2013-02-20,DAL,ORL,2013,98.5
2550,2550,50,Home,W 111-107 ,240,40,85,0.471,34,67,0.507,6,18,0.333,25,34,0.735,111,46,94,0.489,38,74,0.514,8,20,0.4,7,12,0.583,107,2013-02-22,LAL,POR,2013,111.0
2551,2551,51,@,L 111-127 ,240,41,85,0.482,35,68,0.515,6,17,0.353,23,29,0.793,111,48,83,0.578,39,69,0.565,9,14,0.643,22,22,1.0,127,2013-02-22,MIN,OKC,2013,131.5
2552,2552,52,@,W 111-109 ,240,45,87,0.517,42,73,0.575,3,14,0.214,18,31,0.581,111,38,85,0.447,28,60,0.467,10,25,0.4,23,27,0.852,109,2013-02-27,DEN,POR,2013,114.0
2553,2553,53,Home,W 111-88 ,240,42,78,0.538,33,61,0.541,9,17,0.529,18,22,0.818,111,35,84,0.417,30,66,0.455,5,18,0.278,13,19,0.684,88,2013-03-09,DEN,MIN,2013,90.5
2554,2554,54,Home,W 111-81 ,240,39,76,0.513,29,55,0.527,10,21,0.476,23,30,0.767,111,34,81,0.42,28,60,0.467,6,21,0.286,7,10,0.7,81,2013-03-13,HOU,PHO,2013,84.0
2555,2555,55,@,W 111-90 ,240,39,88,0.443,31,66,0.47,8,22,0.364,25,29,0.862,111,35,92,0.38,29,68,0.426,6,24,0.25,14,21,0.667,90,2013-03-18,IND,CLE,2013,93.0
2556,2556,56,@,W 111-93 ,240,46,95,0.484,41,75,0.547,5,20,0.25,14,25,0.56,111,36,82,0.439,28,64,0.438,8,18,0.444,13,21,0.619,93,2013-03-27,BRK,POR,2013,97.0
2557,2557,57,Home,W 111-102 ,240,38,77,0.494,29,58,0.5,9,19,0.474,26,30,0.867,111,34,73,0.466,24,47,0.511,10,26,0.385,24,31,0.774,102,2013-03-29,NYK,CHA,2013,107.0
2558,2558,58,Home,W 111-103 ,240,44,98,0.449,35,69,0.507,9,29,0.31,14,22,0.636,111,39,93,0.419,33,78,0.423,6,15,0.4,19,21,0.905,103,2013-04-01,HOU,ORL,2013,106.0
2559,2559,59,@,W 111-107 ,240,44,86,0.512,35,70,0.5,9,16,0.563,14,16,0.875,111,44,72,0.611,39,58,0.672,5,14,0.357,14,17,0.824,107,2013-04-05,GSW,PHO,2013,109.5
2560,2560,60,@,W 111-104 ,240,40,80,0.5,36,64,0.563,4,16,0.25,27,42,0.643,111,40,82,0.488,37,67,0.552,3,15,0.2,21,26,0.808,104,2013-04-10,DET,CLE,2013,105.5
2561,2561,61,Home,W 111-95 ,240,44,77,0.571,33,56,0.589,11,21,0.524,12,16,0.75,111,35,90,0.389,29,67,0.433,6,23,0.261,19,22,0.864,95,2013-04-10,LAC,MIN,2013,98.0
2562,2562,62,@,L 111-118 (OT),265,42,104,0.404,32,74,0.432,10,30,0.333,17,22,0.773,111,39,87,0.448,29,60,0.483,10,27,0.37,30,37,0.811,118,2013-04-11,NYK,CHI,2013,123.0
2563,2563,63,Home,L 111-112 ,240,42,100,0.42,30,65,0.462,12,35,0.343,15,23,0.652,111,37,85,0.435,31,71,0.437,6,14,0.429,32,46,0.696,112,2013-04-15,MIL,DEN,2013,115.0
2564,2564,64,Home,W 111-108 (OT),265,40,77,0.519,34,59,0.576,6,18,0.333,25,30,0.833,111,42,89,0.472,35,68,0.515,7,21,0.333,17,24,0.708,108,2013-11-01,MEM,DET,2014,111.5
2565,2565,65,Home,W 111-99 ,240,32,80,0.4,25,61,0.41,7,19,0.368,40,46,0.87,111,37,87,0.425,34,71,0.479,3,16,0.188,22,26,0.846,99,2013-11-02,DAL,MEM,2014,100.5
2566,2566,66,@,W 111-110 ,240,46,89,0.517,36,68,0.529,10,21,0.476,9,12,0.75,111,41,71,0.577,36,61,0.59,5,10,0.5,23,34,0.676,110,2013-11-09,BOS,MIA,2014,112.5
2567,2567,67,Home,W 111-99 ,240,40,100,0.4,34,79,0.43,6,21,0.286,25,37,0.676,111,37,94,0.394,29,73,0.397,8,21,0.381,17,26,0.654,99,2013-11-13,DEN,LAL,2014,103.0
2568,2568,68,Home,W 111-103 ,240,39,86,0.453,33,58,0.569,6,28,0.214,27,34,0.794,111,35,75,0.467,29,59,0.492,6,16,0.375,27,33,0.818,103,2013-11-13,LAC,OKC,2014,106.0
2569,2569,69,Home,W 111-105 ,240,37,72,0.514,28,50,0.56,9,22,0.409,28,39,0.718,111,42,85,0.494,37,73,0.507,5,12,0.417,16,20,0.8,105,2013-11-13,UTA,NOP,2014,107.5
2570,2570,70,@,L 111-122 ,240,45,99,0.455,37,75,0.493,8,24,0.333,13,18,0.722,111,41,81,0.506,32,60,0.533,9,21,0.429,31,44,0.705,122,2013-11-16,DEN,HOU,2014,126.5
2571,2571,71,Home,W 111-81 ,240,40,97,0.412,29,61,0.475,11,36,0.306,20,23,0.87,111,31,78,0.397,26,62,0.419,5,16,0.313,14,20,0.7,81,2013-11-22,MIN,BRK,2014,83.5
2572,2572,72,@,L 111-116 ,240,44,83,0.53,31,55,0.564,13,28,0.464,10,13,0.769,111,46,87,0.529,40,66,0.606,6,21,0.286,18,22,0.818,116,2013-11-26,LAL,WAS,2014,119.0
2573,2573,73,@,W 111-87 ,240,43,85,0.506,36,67,0.537,7,18,0.389,18,28,0.643,111,30,75,0.4,28,59,0.475,2,16,0.125,25,34,0.735,87,2013-12-03,DEN,BRK,2014,88.0
2574,2574,74,Home,W 111-104 ,240,44,98,0.449,36,75,0.48,8,23,0.348,15,17,0.882,111,39,89,0.438,34,78,0.436,5,11,0.455,21,24,0.875,104,2013-12-04,POR,OKC,2014,106.5
2575,2575,75,@,W 111-100 ,240,38,71,0.535,29,52,0.558,9,19,0.474,26,28,0.929,111,41,91,0.451,28,65,0.431,13,26,0.5,5,6,0.833,100,2013-12-07,IND,SAS,2014,106.5
2576,2576,76,@,L 111-115 ,240,41,90,0.456,30,53,0.566,11,37,0.297,18,22,0.818,111,43,94,0.457,37,82,0.451,6,12,0.5,23,29,0.793,115,2013-12-09,GSW,CHA,2014,118.0
2577,2577,77,Home,W 111-106 (OT),265,38,84,0.452,29,61,0.475,9,23,0.391,26,32,0.813,111,42,96,0.438,37,75,0.493,5,21,0.238,17,27,0.63,106,2013-12-11,NOP,DET,2014,108.5
2578,2578,78,Home,W 111-104 ,240,39,89,0.438,31,62,0.5,8,27,0.296,25,30,0.833,111,40,94,0.426,35,74,0.473,5,20,0.25,19,24,0.792,104,2013-12-12,POR,HOU,2014,106.5
2579,2579,79,Home,W 111-106 ,240,44,87,0.506,36,68,0.529,8,19,0.421,15,18,0.833,111,40,66,0.606,25,34,0.735,15,32,0.469,11,11,1.0,106,2013-12-14,NYK,ATL,2014,113.5
2580,2580,80,@,W 111-109 (OT),265,41,99,0.414,34,73,0.466,7,26,0.269,22,26,0.846,111,44,94,0.468,41,79,0.519,3,15,0.2,18,27,0.667,109,2013-12-15,POR,DET,2014,110.5
2581,2581,81,@,L 111-114 (OT),265,40,100,0.4,30,71,0.423,10,29,0.345,21,25,0.84,111,39,100,0.39,28,72,0.389,11,28,0.393,25,27,0.926,114,2013-12-20,MIL,CLE,2014,119.5
2582,2582,82,Home,W 111-110 (OT),265,43,99,0.434,33,82,0.402,10,17,0.588,15,20,0.75,111,42,97,0.433,32,69,0.464,10,28,0.357,16,17,0.941,110,2013-12-23,CHA,MIL,2014,115.0
2583,2583,83,@,W 111-104 ,240,40,79,0.506,29,57,0.509,11,22,0.5,20,23,0.87,111,38,70,0.543,31,51,0.608,7,19,0.368,21,29,0.724,104,2013-12-23,DAL,HOU,2014,107.5
2584,2584,84,@,W 111-98 ,240,45,86,0.523,33,62,0.532,12,24,0.5,9,18,0.5,111,37,91,0.407,32,71,0.451,5,20,0.25,19,23,0.826,98,2013-12-25,HOU,SAS,2014,100.5
2585,2585,85,@,W 111-104 ,240,39,95,0.411,33,71,0.465,6,24,0.25,27,33,0.818,111,31,84,0.369,19,47,0.404,12,37,0.324,30,34,0.882,104,2013-12-29,PHI,LAL,2014,110.0
2586,2586,86,Home,W 111-108 ,240,43,80,0.538,34,58,0.586,9,22,0.409,16,21,0.762,111,37,76,0.487,32,64,0.5,5,12,0.417,29,38,0.763,108,2014-01-03,DEN,MEM,2014,110.5
2587,2587,87,Home,L 111-115 ,240,43,94,0.457,36,74,0.486,7,20,0.35,18,29,0.621,111,40,83,0.482,32,59,0.542,8,24,0.333,27,28,0.964,115,2014-01-04,MIN,OKC,2014,119.0
2588,2588,88,Home,W 111-93 ,240,44,89,0.494,31,61,0.508,13,28,0.464,10,18,0.556,111,34,86,0.395,30,67,0.448,4,19,0.211,21,27,0.778,93,2014-01-07,CLE,PHI,2014,95.0
2589,2589,89,Home,W 111-105 ,240,36,79,0.456,25,49,0.51,11,30,0.367,28,39,0.718,111,39,83,0.47,34,66,0.515,5,17,0.294,22,30,0.733,105,2014-01-08,LAC,BOS,2014,107.5
2590,2590,90,@,W 111-108 ,240,45,82,0.549,40,70,0.571,5,12,0.417,16,19,0.842,111,39,88,0.443,31,68,0.456,8,20,0.4,22,29,0.759,108,2014-01-15,SAC,MIN,2014,112.0
2591,2591,91,@,W 111-101 ,240,39,74,0.527,32,59,0.542,7,15,0.467,26,35,0.743,111,38,82,0.463,28,57,0.491,10,25,0.4,15,21,0.714,101,2014-01-17,CHA,ORL,2014,106.0
2592,2592,92,Home,L 111-127 ,240,42,90,0.467,35,72,0.486,7,18,0.389,20,25,0.8,111,46,90,0.511,37,64,0.578,9,26,0.346,26,28,0.929,127,2014-01-18,DAL,POR,2014,131.5
2593,2593,93,@,W 111-105 ,240,45,83,0.542,35,65,0.538,10,18,0.556,11,16,0.688,111,40,75,0.533,30,53,0.566,10,22,0.455,15,22,0.682,105,2014-01-22,OKC,SAS,2014,110.0
2594,2594,94,Home,L 111-113 (OT),265,42,94,0.447,35,72,0.486,7,22,0.318,20,27,0.741,111,41,89,0.461,26,55,0.473,15,34,0.441,16,23,0.696,113,2014-01-22,WAS,BOS,2014,120.5
2595,2595,95,Home,L 111-116 (OT),265,39,101,0.386,27,69,0.391,12,32,0.375,21,29,0.724,111,41,95,0.432,33,71,0.465,8,24,0.333,26,33,0.788,116,2014-01-24,SAC,IND,2014,120.0
2596,2596,96,Home,W 111-109 ,240,43,82,0.524,30,57,0.526,13,25,0.52,12,18,0.667,111,43,88,0.489,31,63,0.492,12,25,0.48,11,12,0.917,109,2014-01-27,OKC,ATL,2014,115.0
2597,2597,97,Home,W 111-92 ,240,45,91,0.495,39,70,0.557,6,21,0.286,15,20,0.75,111,31,76,0.408,23,52,0.442,8,24,0.333,22,34,0.647,92,2014-01-30,GSW,LAC,2014,96.0
2598,2598,98,Home,W 111-95 ,240,43,84,0.512,34,67,0.507,9,17,0.529,16,24,0.667,111,32,89,0.36,20,58,0.345,12,31,0.387,19,29,0.655,95,2014-02-07,DET,BRK,2014,101.0
2599,2599,99,@,W 111-110 ,240,42,78,0.538,32,56,0.571,10,22,0.455,17,25,0.68,111,40,83,0.482,31,67,0.463,9,16,0.563,21,26,0.808,110,2014-02-12,MIA,GSW,2014,114.5
2600,2600,0,@,W 111-109 ,240,43,88,0.489,34,64,0.531,9,24,0.375,16,21,0.762,111,42,93,0.452,35,71,0.493,7,22,0.318,18,25,0.72,109,2014-02-19,SAS,POR,2014,112.5
2601,2601,1,Home,W 111-87 ,240,40,79,0.506,31,56,0.554,9,23,0.391,22,26,0.846,111,34,79,0.43,30,66,0.455,4,13,0.308,15,18,0.833,87,2014-03-06,SAS,MIA,2014,89.0
2602,2602,2,Home,W 111-97 ,240,43,80,0.538,37,61,0.607,6,19,0.316,19,24,0.792,111,39,86,0.453,31,52,0.596,8,34,0.235,11,13,0.846,97,2014-03-07,GSW,ATL,2014,101.0
2603,2603,3,Home,W 111-89 ,240,44,87,0.506,37,74,0.5,7,13,0.538,16,22,0.727,111,37,93,0.398,32,72,0.444,5,21,0.238,10,14,0.714,89,2014-03-08,MEM,CHA,2014,91.5
2604,2604,4,@,L 111-118 ,240,40,86,0.465,36,71,0.507,4,15,0.267,27,39,0.692,111,47,97,0.485,37,66,0.561,10,31,0.323,14,21,0.667,118,2014-03-09,DET,BOS,2014,123.0
2605,2605,5,@,W 111-104 ,240,37,76,0.487,23,52,0.442,14,24,0.583,23,31,0.742,111,41,95,0.432,34,76,0.447,7,19,0.368,15,20,0.75,104,2014-03-09,TOR,MIN,2014,107.5
2606,2606,6,Home,W 111-107 (OT),265,41,90,0.456,36,76,0.474,5,14,0.357,24,33,0.727,111,40,85,0.471,33,62,0.532,7,23,0.304,20,26,0.769,107,2014-03-09,NOP,DEN,2014,110.5
2607,2607,7,Home,W 111-98 ,240,43,88,0.489,35,70,0.5,8,18,0.444,17,24,0.708,111,36,82,0.439,28,61,0.459,8,21,0.381,18,25,0.72,98,2014-03-12,LAC,GSW,2014,102.0
2608,2608,8,Home,W 111-87 ,240,43,86,0.5,29,62,0.468,14,24,0.583,11,13,0.846,111,28,79,0.354,23,53,0.434,5,26,0.192,26,34,0.765,87,2014-03-13,CHI,HOU,2014,89.5
2609,2609,9,@,W 111-107 ,240,39,82,0.476,31,61,0.508,8,21,0.381,25,29,0.862,111,42,81,0.519,35,57,0.614,7,24,0.292,16,21,0.762,107,2014-03-14,DEN,MIA,2014,110.5
2610,2610,10,@,W 111-103 ,240,38,78,0.487,24,45,0.533,14,33,0.424,21,27,0.778,111,41,86,0.477,38,75,0.507,3,11,0.273,18,21,0.857,103,2014-03-14,POR,NOP,2014,104.5
2611,2611,11,@,L 111-117 (OT),265,40,91,0.44,29,63,0.46,11,28,0.393,20,30,0.667,111,40,87,0.46,34,69,0.493,6,18,0.333,31,40,0.775,117,2014-03-18,WAS,SAC,2014,120.0
2612,2612,12,@,W 111-105 ,240,36,70,0.514,32,57,0.561,4,13,0.308,35,43,0.814,111,38,85,0.447,30,57,0.526,8,28,0.286,21,27,0.778,105,2014-03-21,NOP,ATL,2014,109.0
2613,2613,13,Home,L 111-118 ,240,46,92,0.5,40,75,0.533,6,17,0.353,13,17,0.765,111,38,79,0.481,26,44,0.591,12,35,0.343,30,34,0.882,118,2014-03-22,CLE,HOU,2014,124.0
2614,2614,14,@,L 111-116 (OT),265,40,83,0.482,23,46,0.5,17,37,0.459,14,16,0.875,111,46,92,0.5,38,71,0.535,8,21,0.381,16,23,0.696,116,2014-03-26,BRK,CHA,2014,120.0
2615,2615,15,@,L 111-116 ,240,39,88,0.443,34,71,0.479,5,17,0.294,28,36,0.778,111,46,97,0.474,37,74,0.5,9,23,0.391,15,21,0.714,116,2014-03-31,MIL,DET,2014,120.5
2616,2616,16,Home,W 111-90 ,240,44,83,0.53,40,64,0.625,4,19,0.211,19,22,0.864,111,36,85,0.424,28,64,0.438,8,21,0.381,10,10,1.0,90,2014-04-02,SAS,GSW,2014,94.0
2617,2617,17,@,W 111-102 ,240,39,77,0.506,33,58,0.569,6,19,0.316,27,37,0.73,111,38,87,0.437,29,54,0.537,9,33,0.273,17,21,0.81,102,2014-04-04,PHI,BOS,2014,106.5
2618,2618,18,Home,W 111-107 ,240,33,78,0.423,20,47,0.426,13,31,0.419,32,37,0.865,111,38,85,0.447,25,54,0.463,13,31,0.419,18,20,0.9,107,2014-04-04,HOU,OKC,2014,113.5
2619,2619,19,@,L 111-115 ,240,42,88,0.477,28,57,0.491,14,31,0.452,13,16,0.813,111,38,79,0.481,29,56,0.518,9,23,0.391,30,36,0.833,115,2014-04-05,BOS,DET,2014,119.5
2620,2620,20,@,L 111-115 ,240,38,79,0.481,28,50,0.56,10,29,0.345,25,34,0.735,111,43,77,0.558,32,53,0.604,11,24,0.458,18,30,0.6,115,2014-04-09,BRK,ORL,2014,120.5
2621,2621,21,@,W 111-99 ,240,40,87,0.46,29,65,0.446,11,22,0.5,20,24,0.833,111,40,86,0.465,34,73,0.466,6,13,0.462,13,16,0.813,99,2014-04-11,POR,UTA,2014,102.0
2622,2622,22,Home,W 111-105 ,240,39,72,0.542,32,53,0.604,7,19,0.368,26,41,0.634,111,41,93,0.441,36,68,0.529,5,25,0.2,18,26,0.692,105,2014-04-12,CHA,PHI,2014,107.5
2623,2623,23,@,W 111-99 ,240,42,90,0.467,30,60,0.5,12,30,0.4,15,18,0.833,111,37,90,0.411,32,72,0.444,5,18,0.278,20,30,0.667,99,2014-04-12,BOS,CLE,2014,101.5
2624,2624,24,Home,W 111-104 ,240,35,74,0.473,25,47,0.532,10,27,0.37,31,39,0.795,111,39,88,0.443,30,66,0.455,9,22,0.409,17,21,0.81,104,2014-04-12,HOU,NOP,2014,108.5
2625,2625,25,@,W 111-103 ,240,41,76,0.539,33,52,0.635,8,24,0.333,21,26,0.808,111,40,77,0.519,33,59,0.559,7,18,0.389,16,21,0.762,103,2014-04-16,ATL,MIL,2014,106.5
2626,2626,26,@,L 111-112 ,240,42,83,0.506,34,64,0.531,8,19,0.421,19,31,0.613,111,38,86,0.442,33,63,0.524,5,23,0.217,31,41,0.756,112,2014-04-16,DET,OKC,2014,114.5
2627,2627,27,Home,L 111-118 ,240,42,82,0.512,35,62,0.565,7,20,0.35,20,28,0.714,111,34,71,0.479,22,38,0.579,12,33,0.364,38,44,0.864,118,2014-10-31,LAL,LAC,2015,124.0
2628,2628,28,@,L 111-118 ,240,41,93,0.441,29,66,0.439,12,27,0.444,17,20,0.85,111,40,81,0.494,27,54,0.5,13,27,0.481,25,30,0.833,118,2014-11-10,NOP,CLE,2015,124.5
2629,2629,29,Home,W 111-110 ,240,39,77,0.506,33,68,0.485,6,9,0.667,27,34,0.794,111,37,77,0.481,30,64,0.469,7,13,0.538,29,34,0.853,110,2014-11-13,MEM,SAC,2015,113.5
2630,2630,30,Home,W 111-93 ,240,43,84,0.512,35,63,0.556,8,21,0.381,17,23,0.739,111,33,75,0.44,28,59,0.475,5,16,0.313,22,30,0.733,93,2014-11-15,TOR,UTA,2015,95.5
2631,2631,31,@,W 111-100 ,240,43,93,0.462,35,75,0.467,8,18,0.444,17,22,0.773,111,36,84,0.429,31,69,0.449,5,15,0.333,23,26,0.885,100,2014-11-22,WAS,MIL,2015,102.5
2632,2632,32,@,W 111-100 ,240,37,77,0.481,24,51,0.471,13,26,0.5,24,36,0.667,111,40,80,0.5,32,56,0.571,8,24,0.333,12,21,0.571,100,2014-11-24,IND,DAL,2015,104.0
2633,2633,33,@,W 111-96 ,240,44,85,0.518,32,59,0.542,12,26,0.462,11,19,0.579,111,36,87,0.414,30,67,0.448,6,20,0.3,18,24,0.75,96,2014-11-26,GSW,ORL,2015,99.0
2634,2634,34,@,W 111-89 ,240,41,85,0.482,30,59,0.508,11,26,0.423,18,20,0.9,111,36,87,0.414,30,69,0.435,6,18,0.333,11,15,0.733,89,2014-11-30,SAS,BOS,2015,92.0
2635,2635,35,Home,W 111-108 ,240,39,73,0.534,33,52,0.635,6,21,0.286,27,38,0.711,111,45,92,0.489,38,72,0.528,7,20,0.35,11,13,0.846,108,2014-12-02,CLE,MIL,2015,111.5
2636,2636,36,Home,W 111-95 ,240,45,93,0.484,39,74,0.527,6,19,0.316,15,19,0.789,111,33,85,0.388,21,56,0.375,12,29,0.414,17,21,0.81,95,2014-12-03,WAS,LAL,2015,101.0
2637,2637,37,@,W 111-92 ,240,45,88,0.511,39,64,0.609,6,24,0.25,15,20,0.75,111,36,78,0.462,35,71,0.493,1,7,0.143,19,29,0.655,92,2014-12-12,OKC,MIN,2015,92.5
2638,2638,38,Home,W 111-106 ,240,43,76,0.566,36,65,0.554,7,11,0.636,18,24,0.75,111,39,91,0.429,25,62,0.403,14,29,0.483,14,19,0.737,106,2014-12-13,MIL,LAC,2015,113.0
2639,2639,39,@,L 111-119 ,240,45,90,0.5,40,75,0.533,5,15,0.333,16,19,0.842,111,47,79,0.595,39,63,0.619,8,16,0.5,17,18,0.944,119,2014-12-16,UTA,NOP,2015,123.0
2640,2640,40,@,W 111-106 ,240,43,82,0.524,34,57,0.596,9,25,0.36,16,21,0.762,111,40,86,0.465,30,62,0.484,10,24,0.417,16,22,0.727,106,2014-12-17,PHO,CHO,2015,111.0
2641,2641,41,Home,L 111-115 (OT),265,40,99,0.404,27,69,0.391,13,30,0.433,18,23,0.783,111,35,85,0.412,27,57,0.474,8,28,0.286,37,48,0.771,115,2014-12-17,DEN,HOU,2015,119.0
2642,2642,42,Home,L 111-115 (OT),265,46,101,0.455,40,82,0.488,6,19,0.316,13,15,0.867,111,38,91,0.418,21,60,0.35,17,31,0.548,22,24,0.917,115,2014-12-23,OKC,POR,2015,123.5
2643,2643,43,Home,L 111-117 (OT),265,43,104,0.413,36,80,0.45,7,24,0.292,18,23,0.783,111,41,91,0.451,27,57,0.474,14,34,0.412,21,28,0.75,117,2014-12-26,MEM,HOU,2015,124.0
2644,2644,44,@,W 111-103 ,240,40,76,0.526,26,51,0.51,14,25,0.56,17,26,0.654,111,39,87,0.448,31,61,0.508,8,26,0.308,17,27,0.63,103,2014-12-30,LAL,DEN,2015,107.0
2645,2645,45,Home,W 111-83 ,240,44,83,0.53,37,68,0.544,7,15,0.467,16,20,0.8,111,35,88,0.398,29,59,0.492,6,29,0.207,7,11,0.636,83,2015-01-02,NOP,HOU,2015,86.0
2646,2646,46,Home,L 111-113 ,240,44,92,0.478,37,75,0.493,7,17,0.412,16,19,0.842,111,46,96,0.479,41,70,0.586,5,26,0.192,16,19,0.842,113,2015-01-07,MIN,PHO,2015,115.5
2647,2647,47,Home,L 111-114 ,240,47,87,0.54,40,60,0.667,7,27,0.259,10,14,0.714,111,41,96,0.427,34,75,0.453,7,21,0.333,25,31,0.806,114,2015-01-12,TOR,DET,2015,117.5
2648,2648,48,Home,W 111-76 ,240,45,81,0.556,38,68,0.559,7,13,0.538,14,18,0.778,111,28,85,0.329,22,61,0.361,6,24,0.25,14,23,0.609,76,2015-01-19,WAS,PHI,2015,79.0
2649,2649,49,Home,L 111-113 ,240,42,91,0.462,32,61,0.525,10,30,0.333,17,24,0.708,111,44,84,0.524,34,57,0.596,10,27,0.37,15,20,0.75,113,2015-01-23,PHO,HOU,2015,118.0
2650,2650,50,@,L 111-114 ,240,41,95,0.432,31,67,0.463,10,28,0.357,19,27,0.704,111,42,89,0.472,34,66,0.515,8,23,0.348,22,25,0.88,114,2015-01-25,BOS,GSW,2015,118.0
2651,2651,51,Home,L 111-113 (OT),265,48,113,0.425,39,80,0.488,9,33,0.273,6,12,0.5,111,42,98,0.429,34,69,0.493,8,29,0.276,21,23,0.913,113,2015-01-27,GSW,CHI,2015,117.0
2652,2652,52,@,L 111-117 ,240,48,95,0.505,44,78,0.564,4,17,0.235,11,15,0.733,111,41,81,0.506,26,49,0.531,15,32,0.469,20,29,0.69,117,2015-02-06,MIL,HOU,2015,124.5
2653,2653,53,Home,W 111-101 (OT),265,43,105,0.41,29,69,0.42,14,36,0.389,11,16,0.688,111,37,89,0.416,27,57,0.474,10,32,0.313,17,24,0.708,101,2015-02-07,DAL,POR,2015,106.0
2654,2654,54,Home,W 111-103 ,240,39,80,0.488,32,65,0.492,7,15,0.467,26,32,0.813,111,36,84,0.429,28,62,0.452,8,22,0.364,23,30,0.767,103,2015-02-11,MIL,SAC,2015,107.0
2655,2655,55,Home,W 111-100 ,240,44,93,0.473,35,69,0.507,9,24,0.375,14,18,0.778,111,36,87,0.414,24,50,0.48,12,37,0.324,16,26,0.615,100,2015-02-20,DAL,HOU,2015,106.0
2656,2656,56,Home,W 111-109 ,240,40,86,0.465,36,71,0.507,4,15,0.267,27,38,0.711,111,40,89,0.449,33,72,0.458,7,17,0.412,22,31,0.71,109,2015-02-20,MIN,PHO,2015,112.5
2657,2657,57,@,W 111-87 ,240,38,79,0.481,29,59,0.492,9,20,0.45,26,35,0.743,111,35,82,0.427,29,64,0.453,6,18,0.333,11,16,0.688,87,2015-02-20,MIA,NYK,2015,90.0
2658,2658,58,@,L 111-118 (OT),265,42,98,0.429,34,65,0.523,8,33,0.242,19,27,0.704,111,43,84,0.512,36,66,0.545,7,18,0.389,25,38,0.658,118,2015-02-22,BOS,LAL,2015,121.5
2659,2659,59,Home,W 111-95 ,240,43,85,0.506,30,59,0.508,13,26,0.5,12,15,0.8,111,37,85,0.435,29,64,0.453,8,21,0.381,13,14,0.929,95,2015-02-25,POR,SAS,2015,99.0
2660,2660,60,@,L 111-120 ,240,45,86,0.523,39,69,0.565,6,17,0.353,15,23,0.652,111,43,79,0.544,34,55,0.618,9,24,0.375,25,33,0.758,120,2015-03-06,DEN,SAS,2015,124.5
2661,2661,61,@,W 111-91 ,240,45,87,0.517,33,66,0.5,12,21,0.571,9,11,0.818,111,35,84,0.417,29,68,0.426,6,16,0.375,15,23,0.652,91,2015-03-10,NOP,BRK,2015,94.0
2662,2662,62,Home,L 111-118 (2OT),290,46,99,0.465,40,77,0.519,6,22,0.273,13,21,0.619,111,46,104,0.442,36,73,0.493,10,31,0.323,16,20,0.8,118,2015-03-15,NOP,DEN,2015,123.0
2663,2663,63,Home,W 111-104 ,240,43,94,0.457,38,82,0.463,5,12,0.417,20,24,0.833,111,38,80,0.475,31,56,0.554,7,24,0.292,21,24,0.875,104,2015-03-20,ORL,POR,2015,107.5
2664,2664,64,Home,L 111-123 ,240,45,90,0.5,37,67,0.552,8,23,0.348,13,18,0.722,111,46,75,0.613,40,63,0.635,6,12,0.5,25,31,0.806,123,2015-03-21,IND,BRK,2015,126.0
2665,2665,65,@,W 111-89 ,240,43,84,0.512,29,50,0.58,14,34,0.412,11,13,0.846,111,37,85,0.435,33,68,0.485,4,17,0.235,11,16,0.688,89,2015-03-25,CLE,MEM,2015,91.0
2666,2666,66,@,W 111-80 ,240,44,78,0.564,33,50,0.66,11,28,0.393,12,18,0.667,111,29,82,0.354,24,59,0.407,5,23,0.217,17,19,0.895,80,2015-03-25,LAC,NYK,2015,82.5
2667,2667,67,Home,W 111-107 ,240,39,73,0.534,30,54,0.556,9,19,0.474,24,34,0.706,111,30,71,0.423,16,41,0.39,14,30,0.467,33,43,0.767,107,2015-03-26,MIL,IND,2015,114.0
2668,2668,68,@,W 111-97 ,240,42,90,0.467,35,72,0.486,7,18,0.389,20,27,0.741,111,43,82,0.524,40,67,0.597,3,15,0.2,8,8,1.0,97,2015-03-27,DET,ORL,2015,98.5
2669,2669,69,Home,W 111-80 ,240,43,84,0.512,37,67,0.552,6,17,0.353,19,22,0.864,111,30,79,0.38,26,62,0.419,4,17,0.235,16,19,0.842,80,2015-03-28,CHI,NYK,2015,82.0
2670,2670,70,Home,L 111-113 (OT),265,39,96,0.406,29,66,0.439,10,30,0.333,23,38,0.605,111,40,82,0.488,30,61,0.492,10,21,0.476,23,30,0.767,113,2015-03-30,PHI,LAL,2015,118.0
2671,2671,71,Home,W 111-106 ,240,40,80,0.5,31,62,0.5,9,18,0.5,22,28,0.786,111,37,82,0.451,25,59,0.424,12,23,0.522,20,24,0.833,106,2015-03-31,BRK,IND,2015,112.0
2672,2672,72,@,L 111-115 ,240,48,96,0.5,41,82,0.5,7,14,0.5,8,16,0.5,111,41,89,0.461,23,49,0.469,18,40,0.45,15,25,0.6,115,2015-04-01,SAC,HOU,2015,124.0
2673,2673,73,@,L 111-116 ,240,45,93,0.484,39,74,0.527,6,19,0.316,15,21,0.714,111,42,80,0.525,33,56,0.589,9,24,0.375,23,34,0.676,116,2015-04-07,MIN,SAC,2015,120.5
2674,2674,74,Home,L 111-114 ,240,41,87,0.471,34,61,0.557,7,26,0.269,22,25,0.88,111,43,86,0.5,32,58,0.552,11,28,0.393,17,25,0.68,114,2015-04-08,BRK,ATL,2015,119.5
2675,2675,75,@,W 111-105 ,240,36,79,0.456,30,62,0.484,6,17,0.353,33,42,0.786,111,41,87,0.471,35,57,0.614,6,30,0.2,17,22,0.773,105,2015-04-11,UTA,POR,2015,108.0
2676,2676,76,@,L 111-122 ,240,38,74,0.514,33,56,0.589,5,18,0.278,30,42,0.714,111,45,82,0.549,36,56,0.643,9,26,0.346,23,30,0.767,122,2015-04-12,SAC,DEN,2015,126.5
2677,2677,77,Home,W 111-107 ,240,39,74,0.527,26,50,0.52,13,24,0.542,20,27,0.741,111,41,98,0.418,36,83,0.434,5,15,0.333,20,25,0.8,107,2015-04-13,GSW,MEM,2015,109.5
2678,2678,78,Home,W 111-95 ,240,41,96,0.427,32,66,0.485,9,30,0.3,20,22,0.909,111,35,83,0.422,29,65,0.446,6,18,0.333,19,27,0.704,95,2015-10-27,GSW,NOP,2016,98.0
2679,2679,79,Home,L 111-112 ,240,35,90,0.389,26,56,0.464,9,34,0.265,32,35,0.914,111,38,83,0.458,33,63,0.524,5,20,0.25,31,37,0.838,112,2015-10-28,LAL,MIN,2016,114.5
2680,2680,80,@,W 111-95 ,240,40,85,0.471,30,64,0.469,10,21,0.476,21,31,0.677,111,34,87,0.391,28,63,0.444,6,24,0.25,21,33,0.636,95,2015-10-28,DAL,PHO,2016,98.0
2681,2681,81,@,W 111-104 ,240,42,80,0.525,36,61,0.59,6,19,0.316,21,31,0.677,111,41,94,0.436,30,70,0.429,11,24,0.458,11,18,0.611,104,2015-10-28,LAC,SAC,2016,109.5
2682,2682,82,@,W 111-88 ,240,41,96,0.427,31,71,0.437,10,25,0.4,19,23,0.826,111,35,100,0.35,30,75,0.4,5,25,0.2,13,23,0.565,88,2015-11-09,CHI,PHI,2016,90.5
2683,2683,83,@,W 111-109 ,240,42,95,0.442,31,72,0.431,11,23,0.478,16,18,0.889,111,37,84,0.44,33,67,0.493,4,17,0.235,31,39,0.795,109,2015-11-10,NYK,TOR,2016,111.0
2684,2684,84,Home,W 111-109 ,240,40,94,0.426,29,67,0.433,11,27,0.407,20,26,0.769,111,42,89,0.472,34,68,0.5,8,21,0.381,17,21,0.81,109,2015-11-13,SAC,BRK,2016,113.0
2685,2685,85,@,W 111-95 ,240,44,93,0.473,33,57,0.579,11,36,0.306,12,17,0.706,111,36,85,0.424,25,53,0.472,11,32,0.344,12,23,0.522,95,2015-11-16,BOS,HOU,2016,100.5
2686,2686,86,@,L 111-116 ,240,44,91,0.484,39,76,0.513,5,15,0.333,18,22,0.818,111,39,80,0.488,28,55,0.509,11,25,0.44,27,36,0.75,116,2015-11-18,BRK,CHO,2016,121.5
2687,2687,87,Home,W 111-101 ,240,40,79,0.506,35,64,0.547,5,15,0.333,26,33,0.788,111,35,82,0.427,21,45,0.467,14,37,0.378,17,21,0.81,101,2015-11-22,BRK,BOS,2016,108.0
2688,2688,88,@,W 111-89 ,240,42,77,0.545,31,50,0.62,11,27,0.407,16,18,0.889,111,28,73,0.384,23,54,0.426,5,19,0.263,28,40,0.7,89,2015-11-23,OKC,UTA,2016,91.5
2689,2689,89,@,W 111-94 ,240,37,79,0.468,29,59,0.492,8,20,0.4,29,47,0.617,111,31,78,0.397,23,53,0.434,8,25,0.32,24,29,0.828,94,2015-11-24,LAC,DEN,2016,98.0
2690,2690,90,Home,W 111-77 ,240,45,92,0.489,33,57,0.579,12,35,0.343,9,15,0.6,111,31,83,0.373,28,62,0.452,3,21,0.143,12,16,0.75,77,2015-11-24,GSW,LAL,2016,78.5
2691,2691,91,Home,W 111-78 ,240,42,97,0.433,30,64,0.469,12,33,0.364,15,19,0.789,111,27,84,0.321,22,66,0.333,5,18,0.278,19,22,0.864,78,2015-11-27,BOS,WAS,2016,80.5
2692,2692,92,Home,W 111-90 ,240,40,83,0.482,33,64,0.516,7,19,0.368,24,30,0.8,111,34,94,0.362,29,74,0.392,5,20,0.25,17,23,0.739,90,2015-11-27,LAC,NOP,2016,92.5
2693,2693,93,Home,L 111-116 (OT),265,45,78,0.577,39,60,0.65,6,18,0.333,15,17,0.882,111,43,95,0.453,36,70,0.514,7,25,0.28,23,36,0.639,116,2015-11-29,NYK,HOU,2016,119.5
2694,2694,94,@,L 111-123 ,240,38,88,0.432,25,58,0.431,13,30,0.433,22,24,0.917,111,44,85,0.518,26,49,0.531,18,36,0.5,17,20,0.85,123,2015-12-03,IND,POR,2016,132.0
2695,2695,95,Home,W 111-91 ,240,41,93,0.441,32,69,0.464,9,24,0.375,20,26,0.769,111,32,80,0.4,27,62,0.435,5,18,0.278,22,29,0.759,91,2015-12-06,DET,LAL,2016,93.5
2696,2696,96,@,W 111-93 ,240,40,81,0.494,28,53,0.528,12,28,0.429,19,24,0.792,111,37,90,0.411,33,77,0.429,4,13,0.308,15,18,0.833,93,2015-12-07,BOS,NOP,2016,95.0
2697,2697,97,Home,W 111-108 (OT),265,38,86,0.442,27,58,0.466,11,28,0.393,24,33,0.727,111,38,87,0.437,31,68,0.456,7,19,0.368,25,29,0.862,108,2015-12-11,DEN,MIN,2016,111.5
2698,2698,98,@,W 111-76 ,240,41,72,0.569,30,51,0.588,11,21,0.524,18,27,0.667,111,28,72,0.389,22,50,0.44,6,22,0.273,14,20,0.7,76,2015-12-11,CLE,ORL,2016,79.0
2699,2699,99,Home,L 111-114 ,240,38,89,0.427,24,56,0.429,14,33,0.424,21,24,0.875,111,44,85,0.518,30,56,0.536,14,29,0.483,12,15,0.8,114,2015-12-12,DAL,WAS,2016,121.0
2700,2700,0,@,W 111-107 ,240,40,84,0.476,33,58,0.569,7,26,0.269,24,32,0.75,111,41,90,0.456,32,65,0.492,9,25,0.36,16,19,0.842,107,2015-12-22,LAL,DEN,2016,111.5
2701,2701,1,@,W 111-96 ,240,42,84,0.5,30,57,0.526,12,27,0.444,15,22,0.682,111,43,89,0.483,38,72,0.528,5,17,0.294,5,16,0.313,96,2015-12-26,WAS,BRK,2016,98.5
2702,2702,2,@,L 111-118 ,240,42,78,0.538,34,57,0.596,8,21,0.381,19,26,0.731,111,40,87,0.46,24,54,0.444,16,33,0.485,22,28,0.786,118,2015-12-26,CHI,DAL,2016,126.0
2703,2703,3,@,W 111-90 ,240,42,81,0.519,29,52,0.558,13,29,0.448,14,19,0.737,111,34,81,0.42,28,67,0.418,6,14,0.429,16,18,0.889,90,2015-12-26,TOR,MIL,2016,93.0
2704,2704,4,@,W 111-104 ,240,38,79,0.481,26,52,0.5,12,27,0.444,23,27,0.852,111,34,88,0.386,24,61,0.393,10,27,0.37,26,34,0.765,104,2015-12-26,PHI,PHO,2016,109.0
2705,2705,5,@,W 111-105 ,240,36,82,0.439,24,59,0.407,12,23,0.522,27,36,0.75,111,36,78,0.462,26,54,0.481,10,24,0.417,23,30,0.767,105,2015-12-28,BRK,MIA,2016,110.0
2706,2706,6,Home,W 111-108 (OT),265,43,86,0.5,33,58,0.569,10,28,0.357,15,23,0.652,111,44,105,0.419,39,75,0.52,5,30,0.167,15,23,0.652,108,2016-01-02,GSW,DEN,2016,110.5
2707,2707,7,Home,W 111-97 ,240,44,88,0.5,33,62,0.532,11,26,0.423,12,14,0.857,111,37,84,0.44,29,58,0.5,8,26,0.308,15,20,0.75,97,2016-01-03,NYK,ATL,2016,101.0
2708,2708,8,Home,W 111-101 ,240,45,87,0.517,30,53,0.566,15,34,0.441,6,6,1.0,111,38,86,0.442,31,65,0.477,7,21,0.333,18,19,0.947,101,2016-01-04,GSW,CHO,2016,104.5
2709,2709,9,Home,W 111-102 ,240,41,84,0.488,22,51,0.431,19,33,0.576,10,13,0.769,111,38,87,0.437,27,59,0.458,11,28,0.393,15,22,0.682,102,2016-01-06,PHO,CHO,2016,107.5
2710,2710,10,@,L 111-114 (OT),265,40,100,0.4,32,70,0.457,8,30,0.267,23,29,0.793,111,42,89,0.472,30,53,0.566,12,36,0.333,18,34,0.529,114,2016-01-10,NOP,LAC,2016,120.0
2711,2711,11,Home,W 111-103 ,240,41,86,0.477,34,63,0.54,7,23,0.304,22,30,0.733,111,41,91,0.451,34,72,0.472,7,19,0.368,14,16,0.875,103,2016-01-11,GSW,MIA,2016,106.5
2712,2712,12,Home,L 111-115 (OT),265,42,93,0.452,30,66,0.455,12,27,0.444,15,20,0.75,111,41,88,0.466,34,71,0.479,7,17,0.412,26,31,0.839,115,2016-01-14,PHI,CHI,2016,118.5
2713,2713,13,@,W 111-101 ,240,44,84,0.524,35,63,0.556,9,21,0.429,14,20,0.7,111,42,95,0.442,37,69,0.536,5,26,0.192,12,20,0.6,101,2016-01-18,CHI,DET,2016,103.5
2714,2714,14,@,L 111-118 (OT),265,37,86,0.43,25,59,0.424,12,27,0.444,25,31,0.806,111,47,90,0.522,40,73,0.548,7,17,0.412,17,18,0.944,118,2016-01-20,UTA,NYK,2016,121.5
2715,2715,15,Home,L 111-112 ,240,42,91,0.462,29,62,0.468,13,29,0.448,14,25,0.56,111,38,80,0.475,19,40,0.475,19,40,0.475,17,21,0.81,112,2016-01-25,NOP,HOU,2016,121.5
2716,2716,16,Home,W 111-103 ,240,41,96,0.427,32,68,0.471,9,28,0.321,20,24,0.833,111,36,84,0.429,29,63,0.46,7,21,0.333,24,32,0.75,103,2016-01-27,BOS,DEN,2016,106.5
2717,2717,17,Home,W 111-92 ,240,38,78,0.487,29,63,0.46,9,15,0.6,26,30,0.867,111,33,83,0.398,26,55,0.473,7,28,0.25,19,21,0.905,92,2016-01-28,IND,ATL,2016,95.5
2718,2718,18,Home,W 111-107 ,240,36,78,0.462,32,64,0.5,4,14,0.286,35,47,0.745,111,39,87,0.448,30,58,0.517,9,29,0.31,20,34,0.588,107,2016-01-30,TOR,DET,2016,111.5
2719,2719,19,@,W 111-106 (OT),265,44,88,0.5,37,66,0.561,7,22,0.318,16,23,0.696,111,43,101,0.426,35,74,0.473,8,27,0.296,12,14,0.857,106,2016-02-01,CLE,IND,2016,110.0
2720,2720,20,Home,W 111-104 ,240,39,86,0.453,30,60,0.5,9,26,0.346,24,30,0.8,111,42,84,0.5,34,64,0.531,8,20,0.4,12,17,0.706,104,2016-02-01,SAC,MIL,2016,108.0
2721,2721,21,Home,W 111-105 ,240,40,79,0.506,31,62,0.5,9,17,0.529,22,33,0.667,111,36,84,0.429,30,62,0.484,6,22,0.273,27,34,0.794,105,2016-02-04,DET,NYK,2016,108.0
2722,2722,22,@,W 111-105 ,240,37,86,0.43,22,44,0.5,15,42,0.357,22,32,0.688,111,32,83,0.386,21,54,0.389,11,29,0.379,30,32,0.938,105,2016-02-04,HOU,PHO,2016,110.5
2723,2723,23,@,L 111-112 ,240,39,84,0.464,29,55,0.527,10,29,0.345,23,24,0.958,111,45,88,0.511,38,69,0.551,7,19,0.368,15,23,0.652,112,2016-02-09,BOS,MIL,2016,115.5
2724,2724,24,@,W 111-108 ,240,39,78,0.5,23,52,0.442,16,26,0.615,17,25,0.68,111,44,83,0.53,36,57,0.632,8,26,0.308,12,14,0.857,108,2016-02-09,WAS,NYK,2016,112.0
2725,2725,25,@,L 111-120 ,240,38,86,0.442,25,58,0.431,13,28,0.464,22,27,0.815,111,48,94,0.511,35,63,0.556,13,31,0.419,11,18,0.611,120,2016-02-10,LAL,CLE,2016,126.5
2726,2726,26,Home,L 111-115 ,240,41,87,0.471,25,51,0.49,16,36,0.444,13,13,1.0,111,44,88,0.5,36,68,0.529,8,20,0.4,19,28,0.679,115,2016-02-19,ATL,MIA,2016,119.0
2727,2727,27,Home,W 111-93 ,240,37,68,0.544,27,45,0.6,10,23,0.435,27,44,0.614,111,30,81,0.37,23,56,0.411,7,25,0.28,26,36,0.722,93,2016-02-19,UTA,BOS,2016,96.5
2728,2728,28,@,W 111-106 ,240,41,86,0.477,37,66,0.561,4,20,0.2,25,29,0.862,111,37,89,0.416,25,56,0.446,12,33,0.364,20,32,0.625,106,2016-02-21,NOP,DET,2016,112.0
2729,2729,29,Home,L 111-118 ,240,43,93,0.462,34,69,0.493,9,24,0.375,16,22,0.727,111,43,82,0.524,33,66,0.5,10,16,0.625,22,34,0.647,118,2016-02-21,PHO,SAS,2016,123.0
2730,2730,30,@,L 111-115 ,240,43,86,0.5,35,70,0.5,8,16,0.5,17,23,0.739,111,39,90,0.433,27,58,0.466,12,32,0.375,25,38,0.658,115,2016-02-21,UTA,POR,2016,121.0
2731,2731,31,Home,W 111-91 ,240,39,83,0.47,28,55,0.509,11,28,0.393,22,34,0.647,111,33,83,0.398,26,60,0.433,7,23,0.304,18,26,0.692,91,2016-02-24,DET,PHI,2016,94.5
2732,2732,32,Home,W 111-106 ,240,37,80,0.463,25,48,0.521,12,32,0.375,25,35,0.714,111,32,80,0.4,26,60,0.433,6,20,0.3,36,42,0.857,106,2016-02-27,PHO,MEM,2016,109.0
2733,2733,33,@,W 111-102 ,240,41,81,0.506,27,57,0.474,14,24,0.583,15,21,0.714,111,40,93,0.43,37,79,0.468,3,14,0.214,19,25,0.76,102,2016-02-28,POR,IND,2016,103.5
2734,2734,34,@,L 111-129 ,240,41,90,0.456,30,67,0.448,11,23,0.478,18,26,0.692,111,52,77,0.675,46,65,0.708,6,12,0.5,19,25,0.76,129,2016-03-01,CHI,MIA,2016,132.0
2735,2735,35,Home,L 111-120 ,240,40,84,0.476,32,62,0.516,8,22,0.364,23,32,0.719,111,39,90,0.433,26,46,0.565,13,44,0.295,29,35,0.829,120,2016-03-09,SAC,CLE,2016,126.5
2736,2736,36,Home,L 111-125 ,240,39,84,0.464,29,59,0.492,10,25,0.4,23,27,0.852,111,49,91,0.538,40,73,0.548,9,18,0.5,18,22,0.818,125,2016-03-12,PHI,DET,2016,129.5
2737,2737,37,@,L 111-116 ,240,43,85,0.506,37,69,0.536,6,16,0.375,19,24,0.792,111,48,85,0.565,37,56,0.661,11,29,0.379,9,14,0.643,116,2016-03-18,MIN,HOU,2016,121.5
2738,2738,38,@,W 111-97 ,240,45,89,0.506,38,67,0.567,7,22,0.318,14,18,0.778,111,35,89,0.393,25,60,0.417,10,29,0.345,17,27,0.63,97,2016-03-18,OKC,PHI,2016,102.0
2739,2739,39,Home,L 111-115 ,240,40,83,0.482,31,61,0.508,9,22,0.409,22,30,0.733,111,42,80,0.525,32,52,0.615,10,28,0.357,21,26,0.808,115,2016-03-19,IND,OKC,2016,120.0
2740,2740,40,Home,W 111-107 ,240,41,91,0.451,33,56,0.589,8,35,0.229,21,29,0.724,111,40,92,0.435,27,55,0.491,13,37,0.351,14,17,0.824,107,2016-03-22,OKC,HOU,2016,113.5
2741,2741,41,Home,W 111-92 ,240,44,85,0.518,37,65,0.569,7,20,0.35,16,18,0.889,111,37,86,0.43,33,71,0.465,4,15,0.267,14,17,0.824,92,2016-03-26,OKC,SAS,2016,94.0
2742,2742,42,Home,W 111-89 ,240,48,89,0.539,41,70,0.586,7,19,0.368,8,12,0.667,111,36,88,0.409,30,64,0.469,6,24,0.25,11,17,0.647,89,2016-03-26,ORL,CHI,2016,92.0
2743,2743,43,@,L 111-133 ,240,42,88,0.477,34,64,0.531,8,24,0.333,19,24,0.792,111,51,82,0.622,42,62,0.677,9,20,0.45,22,30,0.733,133,2016-03-27,DAL,SAC,2016,137.5
2744,2744,44,@,L 111-120 ,240,43,89,0.483,34,63,0.54,9,26,0.346,16,20,0.8,111,47,84,0.56,39,66,0.591,8,18,0.444,18,25,0.72,120,2016-03-30,WAS,SAC,2016,124.0
2745,2745,45,@,L 111-136 ,240,38,85,0.447,29,61,0.475,9,24,0.375,26,33,0.788,111,50,88,0.568,32,58,0.552,18,30,0.6,18,22,0.818,136,2016-04-03,POR,GSW,2016,145.0
2746,2746,46,@,W 111-97 ,240,42,90,0.467,30,64,0.469,12,26,0.462,15,17,0.882,111,37,78,0.474,27,52,0.519,10,26,0.385,13,15,0.867,97,2016-04-06,CHA,NYK,2016,102.0
2747,2747,47,Home,W 111-98 ,240,37,68,0.544,27,46,0.587,10,22,0.455,27,38,0.711,111,37,83,0.446,29,56,0.518,8,27,0.296,16,20,0.8,98,2016-04-08,TOR,IND,2016,102.0
2748,2748,48,Home,L 111-120 ,240,44,98,0.449,34,67,0.507,10,31,0.323,13,21,0.619,111,46,89,0.517,37,64,0.578,9,25,0.36,19,24,0.792,120,2016-04-11,BRK,WAS,2016,124.5
2749,2749,49,Home,W 111-104 ,240,40,76,0.526,34,55,0.618,6,21,0.286,25,39,0.641,111,37,86,0.43,28,61,0.459,9,25,0.36,21,26,0.808,104,2016-10-29,NYK,MEM,2017,108.5
2750,2750,50,Home,L 111-112 (OT),265,43,94,0.457,33,64,0.516,10,30,0.333,15,28,0.536,111,40,93,0.43,32,69,0.464,8,24,0.333,24,28,0.857,112,2016-11-04,NOP,PHO,2017,116.0
2751,2751,51,Home,W 111-94 ,240,46,86,0.535,34,60,0.567,12,26,0.462,7,12,0.583,111,34,79,0.43,28,61,0.459,6,18,0.333,20,25,0.8,94,2016-11-05,IND,CHI,2017,97.0
2752,2752,52,Home,W 111-80 ,240,38,87,0.437,27,55,0.491,11,32,0.344,24,33,0.727,111,31,88,0.352,25,58,0.431,6,30,0.2,12,14,0.857,80,2016-11-09,LAC,POR,2017,83.0
2753,2753,53,Home,L 111-113 ,240,38,93,0.409,21,52,0.404,17,41,0.415,18,24,0.75,111,43,90,0.478,37,68,0.544,6,22,0.273,21,22,0.955,113,2016-11-11,CHA,TOR,2017,116.0
2754,2754,54,@,W 111-107 ,240,40,82,0.488,25,56,0.446,15,26,0.577,16,19,0.842,111,37,81,0.457,28,56,0.5,9,25,0.36,24,34,0.706,107,2016-11-16,MEM,LAC,2017,111.5
2755,2755,55,Home,L 111-113 (OT),265,39,83,0.47,35,58,0.603,4,25,0.16,29,39,0.744,111,43,94,0.457,35,71,0.493,8,23,0.348,19,31,0.613,113,2016-11-18,DEN,TOR,2017,117.0
2756,2756,56,Home,W 111-102 ,240,42,94,0.447,30,62,0.484,12,32,0.375,15,20,0.75,111,39,76,0.513,27,49,0.551,12,27,0.444,12,17,0.706,102,2016-11-19,HOU,UTA,2017,108.0
2757,2757,57,Home,L 111-114 ,240,42,88,0.477,31,61,0.508,11,27,0.407,16,22,0.727,111,43,85,0.506,30,58,0.517,13,27,0.481,15,26,0.577,114,2016-11-19,WAS,MIA,2017,120.5
2758,2758,58,Home,L 111-115 (OT),265,44,101,0.436,34,65,0.523,10,36,0.278,13,18,0.722,111,40,89,0.449,29,67,0.433,11,22,0.5,24,31,0.774,115,2016-11-20,OKC,IND,2017,120.5
2759,2759,59,Home,W 111-109 ,240,42,83,0.506,28,56,0.5,14,27,0.519,13,16,0.813,111,45,92,0.489,34,65,0.523,11,27,0.407,8,11,0.727,109,2016-11-22,LAL,OKC,2017,114.5
2760,2760,60,@,W 111-92 ,240,45,98,0.459,30,60,0.5,15,38,0.395,6,8,0.75,111,34,86,0.395,24,55,0.436,10,31,0.323,14,22,0.636,92,2016-11-23,BOS,BRK,2017,97.0
2761,2761,61,@,L 111-113 (OT),265,43,93,0.462,35,64,0.547,8,29,0.276,17,27,0.63,111,45,97,0.464,34,69,0.493,11,28,0.393,12,13,0.923,113,2016-11-25,CHA,NYK,2017,118.5
2762,2762,62,@,W 111-93 ,240,36,80,0.45,21,46,0.457,15,34,0.441,24,29,0.828,111,34,89,0.382,22,49,0.449,12,40,0.3,13,16,0.813,93,2016-12-01,MIL,BRK,2017,99.0
2763,2763,63,@,W 111-110 ,240,44,86,0.512,36,67,0.537,8,19,0.421,15,19,0.789,111,40,73,0.548,23,43,0.535,17,30,0.567,13,17,0.765,110,2016-12-01,MIA,UTA,2017,118.5
2764,2764,64,Home,W 111-105 ,240,47,96,0.49,44,78,0.564,3,18,0.167,14,17,0.824,111,45,83,0.542,35,57,0.614,10,26,0.385,5,10,0.5,105,2016-12-02,CHI,CLE,2017,110.0
2765,2765,65,@,W 111-102 ,240,39,79,0.494,34,65,0.523,5,14,0.357,28,35,0.8,111,36,81,0.444,26,51,0.51,10,30,0.333,20,28,0.714,102,2016-12-04,IND,LAC,2017,107.0
2766,2766,66,@,L 111-116 ,240,42,105,0.4,31,68,0.456,11,37,0.297,16,21,0.762,111,41,85,0.482,32,59,0.542,9,26,0.346,25,31,0.806,116,2016-12-07,DEN,BRK,2017,120.5
2767,2767,67,Home,W 111-103 ,240,39,80,0.488,24,48,0.5,15,32,0.469,18,24,0.75,111,32,69,0.464,18,44,0.409,14,25,0.56,25,26,0.962,103,2016-12-09,DAL,IND,2017,110.0
2768,2768,68,@,L 111-118 ,240,40,82,0.488,24,45,0.533,16,37,0.432,15,16,0.938,111,40,83,0.482,25,54,0.463,15,29,0.517,23,28,0.821,118,2016-12-10,POR,IND,2017,125.5
2769,2769,69,@,L 111-113 (OT),265,38,97,0.392,31,77,0.403,7,20,0.35,28,38,0.737,111,38,93,0.409,29,63,0.46,9,30,0.3,28,33,0.848,113,2016-12-13,NYK,PHO,2017,117.5
2770,2770,70,@,L 111-118 ,240,39,83,0.47,28,56,0.5,11,27,0.407,22,26,0.846,111,39,97,0.402,32,68,0.471,7,29,0.241,33,42,0.786,118,2016-12-16,BRK,ORL,2017,121.5
2771,2771,71,@,W 111-109 (OT),265,39,96,0.406,22,45,0.489,17,51,0.333,16,20,0.8,111,41,92,0.446,34,71,0.479,7,21,0.333,20,27,0.741,109,2016-12-17,HOU,MIN,2017,112.5
2772,2772,72,@,L 111-118 ,240,39,91,0.429,33,68,0.485,6,23,0.261,27,33,0.818,111,44,88,0.5,31,65,0.477,13,23,0.565,17,21,0.81,118,2016-12-20,IND,NYK,2017,124.5
2773,2773,73,Home,L 111-125 ,240,44,93,0.473,35,68,0.515,9,25,0.36,14,20,0.7,111,46,86,0.535,28,48,0.583,18,38,0.474,15,26,0.577,125,2016-12-21,PHO,HOU,2017,134.0
2774,2774,74,Home,W 111-102 ,240,40,84,0.476,32,59,0.542,8,25,0.32,23,30,0.767,111,37,85,0.435,27,56,0.482,10,29,0.345,18,22,0.818,102,2016-12-25,LAL,LAC,2017,107.0
2775,2775,75,Home,W 111-104 ,240,37,70,0.529,25,45,0.556,12,25,0.48,25,30,0.833,111,37,75,0.493,24,43,0.558,13,32,0.406,17,22,0.773,104,2016-12-26,NOP,DAL,2017,110.5
2776,2776,76,@,L 111-121 ,240,40,103,0.388,27,68,0.397,13,35,0.371,18,22,0.818,111,46,81,0.568,32,58,0.552,14,23,0.609,15,18,0.833,121,2016-12-28,TOR,GSW,2017,128.0
2777,2777,77,Home,W 111-105 ,240,38,78,0.487,30,56,0.536,8,22,0.364,27,37,0.73,111,35,79,0.443,24,51,0.471,11,28,0.393,24,29,0.828,105,2016-12-28,WAS,IND,2017,110.5
2778,2778,78,Home,W 111-101 ,240,39,81,0.481,32,62,0.516,7,19,0.368,26,30,0.867,111,35,84,0.417,29,61,0.475,6,23,0.261,25,31,0.806,101,2016-12-30,IND,CHI,2017,104.0
2779,2779,79,@,L 111-118 ,240,41,83,0.494,32,64,0.5,9,19,0.474,20,22,0.909,111,42,90,0.467,35,67,0.522,7,23,0.304,27,29,0.931,118,2017-01-02,CHA,CHI,2017,121.5
2780,2780,80,@,W 111-92 ,240,44,81,0.543,34,62,0.548,10,19,0.526,13,18,0.722,111,37,86,0.43,28,58,0.483,9,28,0.321,9,10,0.9,92,2017-01-04,ATL,ORL,2017,96.5
2781,2781,81,Home,L 111-116 ,240,39,78,0.5,27,56,0.482,12,22,0.545,21,28,0.75,111,41,83,0.494,28,60,0.467,13,23,0.565,21,27,0.778,116,2017-01-06,MIL,NYK,2017,122.5
2782,2782,82,Home,W 111-95 ,240,42,87,0.483,34,55,0.618,8,32,0.25,19,24,0.792,111,34,90,0.378,27,64,0.422,7,26,0.269,20,29,0.69,95,2017-01-08,LAL,ORL,2017,98.5
2783,2783,83,Home,W 111-98 ,240,42,80,0.525,29,54,0.537,13,26,0.5,14,18,0.778,111,39,79,0.494,33,60,0.55,6,19,0.316,14,18,0.778,98,2017-01-15,ATL,MIL,2017,101.0
2784,2784,84,Home,W 111-92 ,240,43,95,0.453,29,51,0.569,14,44,0.318,11,15,0.733,111,37,93,0.398,30,65,0.462,7,28,0.25,11,14,0.786,92,2017-01-18,HOU,MIL,2017,95.5
2785,2785,85,Home,W 111-108 ,240,45,85,0.529,39,70,0.557,6,15,0.4,15,21,0.714,111,42,82,0.512,35,58,0.603,7,24,0.292,17,21,0.81,108,2017-01-22,MIN,DEN,2017,111.5
2786,2786,86,Home,L 111-112 ,240,38,86,0.442,31,67,0.463,7,19,0.368,28,32,0.875,111,44,84,0.524,38,67,0.567,6,17,0.353,18,24,0.75,112,2017-01-24,PHO,MIN,2017,115.0
2787,2787,87,@,L 111-115 (OT),265,35,71,0.493,22,45,0.489,13,26,0.5,28,36,0.778,111,38,78,0.487,28,50,0.56,10,28,0.357,29,33,0.879,115,2017-01-27,SAC,IND,2017,120.0
2788,2788,88,Home,L 111-113 ,240,46,93,0.495,36,66,0.545,10,27,0.37,9,12,0.75,111,36,79,0.456,28,53,0.528,8,26,0.308,33,39,0.846,113,2017-01-29,POR,GSW,2017,117.0
2789,2789,89,Home,W 111-105 (OT),265,40,92,0.435,28,63,0.444,12,29,0.414,19,26,0.731,111,41,96,0.427,31,61,0.508,10,35,0.286,13,19,0.684,105,2017-01-30,MIN,ORL,2017,110.0
2790,2790,90,@,L 111-126 ,240,39,88,0.443,30,57,0.526,9,31,0.29,24,26,0.923,111,47,96,0.49,26,48,0.542,21,48,0.438,11,14,0.786,126,2017-02-01,CHA,GSW,2017,136.5
2791,2791,91,@,W 111-104 ,240,41,84,0.488,25,44,0.568,16,40,0.4,13,18,0.722,111,39,86,0.453,27,55,0.491,12,31,0.387,14,28,0.5,104,2017-02-04,CLE,NYK,2017,110.0
2792,2792,92,Home,W 111-106 ,240,42,92,0.457,33,66,0.5,9,26,0.346,18,22,0.818,111,40,93,0.43,35,66,0.53,5,27,0.185,21,25,0.84,106,2017-02-06,NOP,PHO,2017,108.5
2793,2793,93,Home,W 111-107 ,240,40,102,0.392,33,76,0.434,7,26,0.269,24,29,0.828,111,39,86,0.453,27,50,0.54,12,36,0.333,17,21,0.81,107,2017-02-07,CHA,BRK,2017,113.0
2794,2794,94,@,W 111-103 ,240,39,74,0.527,28,52,0.538,11,22,0.5,22,25,0.88,111,34,84,0.405,21,50,0.42,13,34,0.382,22,29,0.759,103,2017-02-08,SAS,PHI,2017,109.5
2795,2795,95,Home,L 111-112 ,240,41,84,0.488,31,63,0.492,10,21,0.476,19,24,0.792,111,40,95,0.421,29,67,0.433,11,28,0.393,21,27,0.778,112,2017-02-09,ORL,PHI,2017,117.5
2796,2796,96,Home,L 111-120 ,240,39,77,0.506,30,51,0.588,9,26,0.346,24,31,0.774,111,44,91,0.484,34,61,0.557,10,30,0.333,22,27,0.815,120,2017-02-09,POR,BOS,2017,125.0
2797,2797,97,@,W 111-98 ,240,40,81,0.494,24,47,0.511,16,34,0.471,15,18,0.833,111,35,77,0.455,26,50,0.52,9,27,0.333,19,25,0.76,98,2017-02-13,BOS,DAL,2017,102.5
2798,2798,98,Home,W 111-88 ,240,42,81,0.519,31,59,0.525,11,22,0.5,16,23,0.696,111,32,79,0.405,23,57,0.404,9,22,0.409,15,20,0.75,88,2017-02-15,UTA,POR,2017,92.5
2799,2799,99,@,W 111-98 ,240,43,83,0.518,28,54,0.519,15,29,0.517,10,15,0.667,111,40,81,0.494,36,63,0.571,4,18,0.222,14,18,0.778,98,2017-02-16,WAS,IND,2017,100.0
2800,2800,0,@,L 111-118 ,240,37,87,0.425,28,52,0.538,9,35,0.257,28,35,0.8,111,44,89,0.494,39,68,0.574,5,21,0.238,25,31,0.806,118,2017-03-03,OKC,PHO,2017,120.5
2801,2801,1,Home,L 111-119 ,240,38,82,0.463,25,54,0.463,13,28,0.464,22,31,0.71,111,41,87,0.471,21,43,0.488,20,44,0.455,17,22,0.773,119,2017-03-06,ATL,GSW,2017,129.0
2802,2802,2,@,L 111-122 ,240,42,90,0.467,31,60,0.517,11,30,0.367,16,22,0.727,111,45,83,0.542,28,52,0.538,17,31,0.548,15,19,0.789,122,2017-03-07,LAL,DAL,2017,130.5
2803,2803,3,Home,W 110-83 ,240,46,76,0.605,43,67,0.642,3,9,0.333,15,22,0.682,110,30,93,0.323,28,72,0.389,2,21,0.095,21,24,0.875,83,2012-01-04,DEN,SAC,2012,84.0
2804,2804,4,Home,L 110-118 ,240,42,85,0.494,31,56,0.554,11,29,0.379,15,20,0.75,110,47,85,0.553,40,74,0.541,7,11,0.636,17,21,0.81,118,2012-01-04,NYK,CHA,2012,121.5
2805,2805,5,@,W 110-103 ,240,40,80,0.5,25,48,0.521,15,32,0.469,15,19,0.789,110,41,79,0.519,33,57,0.579,8,22,0.364,13,16,0.813,103,2012-01-13,BRK,PHO,2012,107.0
2806,2806,6,Home,W 110-95 ,240,43,75,0.573,36,56,0.643,7,19,0.368,17,23,0.739,110,37,77,0.481,30,58,0.517,7,19,0.368,14,21,0.667,95,2012-01-23,CHI,NJN,2012,98.5
2807,2807,7,Home,W 110-87 ,240,39,74,0.527,29,50,0.58,10,24,0.417,22,27,0.815,110,31,89,0.348,24,66,0.364,7,23,0.304,18,21,0.857,87,2012-02-17,OKC,GSW,2012,90.5
2808,2808,8,Home,W 110-91 ,240,43,79,0.544,37,66,0.561,6,13,0.462,18,24,0.75,110,37,88,0.42,35,75,0.467,2,13,0.154,15,19,0.789,91,2012-02-22,CHI,MIL,2012,92.0
2809,2809,9,Home,L 110-122 ,240,40,83,0.482,30,57,0.526,10,26,0.385,20,28,0.714,110,43,80,0.538,31,57,0.544,12,23,0.522,24,28,0.857,122,2012-03-03,POR,MIN,2012,128.0
2810,2810,10,@,W 110-92 ,240,42,80,0.525,35,61,0.574,7,19,0.368,19,21,0.905,110,35,79,0.443,27,61,0.443,8,18,0.444,14,23,0.609,92,2012-03-07,MEM,GSW,2012,96.0
2811,2811,11,Home,W 110-97 ,240,41,73,0.562,35,50,0.7,6,23,0.261,22,32,0.688,110,33,72,0.458,29,61,0.475,4,11,0.364,27,32,0.844,97,2012-03-09,DEN,NOH,2012,99.0
2812,2812,12,Home,W 110-97 ,240,43,85,0.506,32,58,0.552,11,27,0.407,13,13,1.0,110,39,86,0.453,33,64,0.516,6,22,0.273,13,18,0.722,97,2012-03-09,SAC,DAL,2012,100.0
2813,2813,13,@,W 110-99 ,240,40,78,0.513,36,61,0.59,4,17,0.235,26,27,0.963,110,39,82,0.476,34,66,0.515,5,16,0.313,16,25,0.64,99,2012-03-10,POR,WAS,2012,101.5
2814,2814,14,Home,L 110-114 (OT),265,37,82,0.451,32,66,0.485,5,16,0.313,31,51,0.608,110,39,81,0.481,32,66,0.485,7,15,0.467,29,38,0.763,114,2012-03-16,MEM,TOR,2012,117.5
2815,2815,15,@,L 110-119 ,240,43,90,0.478,39,74,0.527,4,16,0.25,20,25,0.8,110,47,88,0.534,43,71,0.606,4,17,0.235,21,32,0.656,119,2012-03-20,MEM,SAC,2012,121.0
2816,2816,16,Home,W 110-107 (OT),265,45,87,0.517,41,77,0.532,4,10,0.4,16,22,0.727,110,40,86,0.465,32,64,0.5,8,22,0.364,19,22,0.864,107,2012-03-31,DET,CHA,2012,111.0
2817,2817,17,Home,W 110-98 ,240,45,80,0.563,38,62,0.613,7,18,0.389,13,19,0.684,110,38,84,0.452,33,72,0.458,5,12,0.417,17,22,0.773,98,2012-04-06,BRK,WAS,2012,100.5
2818,2818,18,Home,W 110-100 ,240,41,92,0.446,34,78,0.436,7,14,0.5,21,28,0.75,110,41,92,0.446,32,67,0.478,9,25,0.36,9,17,0.529,100,2012-04-10,DAL,SAC,2012,104.5
2819,2819,19,@,L 110-118 ,240,47,90,0.522,39,74,0.527,8,16,0.5,8,11,0.727,110,42,88,0.477,32,65,0.492,10,23,0.435,24,28,0.857,118,2012-04-11,GSW,POR,2012,123.0
2820,2820,20,Home,L 110-115 ,240,42,84,0.5,38,73,0.521,4,11,0.364,22,34,0.647,110,40,91,0.44,33,66,0.5,7,25,0.28,28,32,0.875,115,2012-04-14,MIN,OKC,2012,118.5
2821,2821,21,@,L 110-118 ,240,36,66,0.545,25,45,0.556,11,21,0.524,27,34,0.794,110,42,74,0.568,23,42,0.548,19,32,0.594,15,17,0.882,118,2012-04-17,BOS,NYK,2012,127.5
2822,2822,22,@,L 110-117 ,240,43,86,0.5,31,58,0.534,12,28,0.429,12,15,0.8,110,41,79,0.519,30,53,0.566,11,26,0.423,24,26,0.923,117,2012-04-18,HOU,DAL,2012,122.5
2823,2823,23,@,L 110-118 ,240,43,82,0.524,39,66,0.591,4,16,0.25,20,27,0.741,110,38,81,0.469,29,61,0.475,9,20,0.45,33,36,0.917,118,2012-04-24,SAC,OKC,2012,122.5
2824,2824,24,@,W 110-106 ,240,41,88,0.466,33,66,0.5,8,22,0.364,20,23,0.87,110,45,94,0.479,40,81,0.494,5,13,0.385,11,13,0.846,106,2012-04-25,SAS,PHO,2012,108.5
2825,2825,25,Home,L 110-114 ,240,30,70,0.429,20,49,0.408,10,21,0.476,40,52,0.769,110,41,84,0.488,37,68,0.544,4,16,0.25,28,39,0.718,114,2012-11-03,LAC,GSW,2013,116.0
2826,2826,26,Home,W 110-100 ,240,42,74,0.568,35,61,0.574,7,13,0.538,19,23,0.826,110,38,77,0.494,33,64,0.516,5,13,0.385,19,22,0.864,100,2012-11-03,SAS,UTA,2013,102.5
2827,2827,27,@,W 110-88 ,240,39,84,0.464,26,52,0.5,13,32,0.406,19,19,1.0,110,29,86,0.337,21,64,0.328,8,22,0.364,22,26,0.846,88,2012-11-05,NYK,PHI,2013,92.0
2828,2828,28,Home,L 110-117 ,240,38,87,0.437,28,65,0.431,10,22,0.455,24,27,0.889,110,43,93,0.462,31,66,0.47,12,27,0.444,19,28,0.679,117,2012-11-07,CHA,PHO,2013,123.0
2829,2829,29,Home,L 110-113 ,240,36,80,0.45,24,46,0.522,12,34,0.353,26,33,0.788,110,45,89,0.506,35,68,0.515,10,21,0.476,13,20,0.65,113,2012-11-12,HOU,MIA,2013,118.0
2830,2830,30,Home,W 110-100 ,240,43,94,0.457,36,82,0.439,7,12,0.583,17,21,0.81,110,41,76,0.539,34,60,0.567,7,16,0.438,11,18,0.611,100,2012-11-12,PHO,DEN,2013,103.5
2831,2831,31,@,W 110-106 ,240,44,89,0.494,37,72,0.514,7,17,0.412,15,17,0.882,110,44,82,0.537,42,74,0.568,2,8,0.25,16,20,0.8,106,2012-11-16,ORL,DET,2013,107.0
2832,2832,32,@,W 110-95 ,240,40,74,0.541,26,45,0.578,14,29,0.483,16,20,0.8,110,33,78,0.423,26,66,0.394,7,12,0.583,22,28,0.786,95,2012-11-16,OKC,NOH,2013,98.5
2833,2833,33,Home,W 110-108 ,240,36,69,0.522,27,50,0.54,9,19,0.474,29,37,0.784,110,35,79,0.443,21,48,0.438,14,31,0.452,24,33,0.727,108,2012-11-24,MIA,CLE,2013,115.0
2834,2834,34,Home,L 110-116 (OT),265,41,90,0.456,30,64,0.469,11,26,0.423,17,19,0.895,110,47,105,0.448,40,87,0.46,7,18,0.389,15,19,0.789,116,2012-11-25,ORL,BOS,2013,119.5
2835,2835,35,@,W 110-89 ,240,44,84,0.524,33,59,0.559,11,25,0.44,11,15,0.733,110,41,95,0.432,39,80,0.488,2,15,0.133,5,8,0.625,89,2012-11-28,SAS,ORL,2013,90.0
2836,2836,36,@,L 110-113 ,240,42,86,0.488,33,58,0.569,9,28,0.321,17,19,0.895,110,40,85,0.471,34,70,0.486,6,15,0.4,27,43,0.628,113,2012-12-03,TOR,DEN,2013,116.0
2837,2837,37,Home,W 110-99 ,240,40,85,0.471,34,64,0.531,6,21,0.286,24,28,0.857,110,35,84,0.417,30,72,0.417,5,12,0.417,24,29,0.828,99,2012-12-05,SAS,MIL,2013,101.5
2838,2838,38,Home,L 110-117 ,240,40,85,0.471,25,57,0.439,15,28,0.536,15,18,0.833,110,45,83,0.542,39,65,0.6,6,18,0.333,21,27,0.778,117,2012-12-09,LAL,UTA,2013,120.0
2839,2839,39,@,W 110-95 ,240,42,78,0.538,32,50,0.64,10,28,0.357,16,18,0.889,110,37,96,0.385,34,74,0.459,3,22,0.136,18,21,0.857,95,2012-12-20,MIA,DAL,2013,96.5
2840,2840,40,@,W 110-106 ,240,37,83,0.446,29,65,0.446,8,18,0.444,28,33,0.848,110,38,91,0.418,30,65,0.462,8,26,0.308,22,25,0.88,106,2012-12-21,CHI,NYK,2013,110.0
2841,2841,41,Home,W 110-88 ,240,47,92,0.511,41,72,0.569,6,20,0.3,10,15,0.667,110,33,87,0.379,30,67,0.448,3,20,0.15,19,30,0.633,88,2012-12-22,DEN,CHA,2013,89.5
2842,2842,42,Home,L 110-112 (OT),265,42,88,0.477,34,65,0.523,8,23,0.348,18,22,0.818,110,40,85,0.471,34,64,0.531,6,21,0.286,26,35,0.743,112,2012-12-31,ORL,MIA,2013,115.0
2843,2843,43,Home,L 110-117 ,240,43,88,0.489,38,71,0.535,5,17,0.294,19,24,0.792,110,46,89,0.517,37,72,0.514,9,17,0.529,16,23,0.696,117,2013-01-02,MIL,SAS,2013,121.5
2844,2844,44,@,W 110-93 ,240,38,76,0.5,29,59,0.492,9,17,0.529,25,29,0.862,110,36,73,0.493,28,54,0.519,8,19,0.421,13,17,0.765,93,2013-01-02,BRK,OKC,2013,97.0
2845,2845,45,Home,W 110-91 ,240,39,76,0.513,35,65,0.538,4,11,0.364,28,39,0.718,110,28,78,0.359,19,53,0.358,9,25,0.36,26,35,0.743,91,2013-01-05,DEN,UTA,2013,95.5
2846,2846,46,@,W 110-104 ,240,39,88,0.443,33,70,0.471,6,18,0.333,26,32,0.813,110,34,81,0.42,26,53,0.491,8,28,0.286,28,32,0.875,104,2013-01-19,MIL,POR,2013,108.0
2847,2847,47,Home,W 110-102 ,240,41,79,0.519,34,63,0.54,7,16,0.438,21,33,0.636,110,42,95,0.442,34,79,0.43,8,16,0.5,10,13,0.769,102,2013-01-22,MIL,PHI,2013,106.0
2848,2848,48,Home,W 110-88 ,240,43,77,0.558,38,60,0.633,5,17,0.294,19,23,0.826,110,34,72,0.472,30,60,0.5,4,12,0.333,16,23,0.696,88,2013-01-25,MIA,DET,2013,90.0
2849,2849,49,@,L 110-114 (OT),265,44,82,0.537,37,61,0.607,7,21,0.333,15,18,0.833,110,44,83,0.53,41,73,0.562,3,10,0.3,23,26,0.885,114,2013-01-26,IND,UTA,2013,115.5
2850,2850,50,Home,W 110-95 ,240,45,88,0.511,40,77,0.519,5,11,0.455,15,18,0.833,110,34,77,0.442,30,60,0.5,4,17,0.235,23,28,0.821,95,2013-01-27,DAL,PHO,2013,97.0
2851,2851,51,@,L 110-118 ,240,39,81,0.481,31,54,0.574,8,27,0.296,24,35,0.686,110,42,82,0.512,34,54,0.63,8,28,0.286,26,36,0.722,118,2013-01-30,HOU,DEN,2013,122.0
2852,2852,52,@,L 110-115 ,240,41,83,0.494,34,62,0.548,7,21,0.333,21,26,0.808,110,43,90,0.478,34,72,0.472,9,18,0.5,20,23,0.87,115,2013-02-02,OKC,CLE,2013,119.5
2853,2853,53,Home,W 110-104 ,240,47,93,0.505,42,78,0.538,5,15,0.333,11,18,0.611,110,42,83,0.506,32,56,0.571,10,27,0.37,10,12,0.833,104,2013-02-10,ORL,POR,2013,109.0
2854,2854,54,@,W 110-100 ,240,41,88,0.466,30,59,0.508,11,29,0.379,17,22,0.773,110,32,73,0.438,29,60,0.483,3,13,0.231,33,34,0.971,100,2013-02-14,MIA,OKC,2013,101.5
2855,2855,55,Home,W 110-95 ,240,45,89,0.506,39,73,0.534,6,16,0.375,14,15,0.933,110,35,83,0.422,23,64,0.359,12,19,0.632,13,13,1.0,95,2013-02-24,NOP,SAC,2013,101.0
2856,2856,56,@,W 110-107 (OT),265,41,86,0.477,31,59,0.525,10,27,0.37,18,20,0.9,110,39,88,0.443,31,71,0.437,8,17,0.471,21,24,0.875,107,2013-02-25,BOS,UTA,2013,111.0
2857,2857,57,@,W 110-107 ,240,43,89,0.483,34,65,0.523,9,24,0.375,15,20,0.75,110,42,89,0.472,35,66,0.53,7,23,0.304,16,25,0.64,107,2013-02-27,MIL,HOU,2013,110.5
2858,2858,58,Home,L 110-118 ,240,44,78,0.564,35,56,0.625,9,22,0.409,13,16,0.813,110,42,77,0.545,27,45,0.6,15,32,0.469,19,28,0.679,118,2013-03-01,ORL,HOU,2013,125.5
2859,2859,59,Home,W 110-87 ,240,37,69,0.536,30,53,0.566,7,16,0.438,29,33,0.879,110,28,80,0.35,23,65,0.354,5,15,0.333,26,33,0.788,87,2013-03-13,OKC,UTA,2013,89.5
2860,2860,60,Home,W 110-106 ,240,43,94,0.457,39,83,0.47,4,11,0.364,20,24,0.833,110,38,74,0.514,29,54,0.537,9,20,0.45,21,28,0.75,106,2013-03-23,MEM,BOS,2013,110.5
2861,2861,61,Home,W 110-84 ,240,41,79,0.519,34,60,0.567,7,19,0.368,21,23,0.913,110,34,76,0.447,30,53,0.566,4,23,0.174,12,18,0.667,84,2013-03-23,NYK,TOR,2013,86.0
2862,2862,62,Home,W 110-86 ,240,41,85,0.482,27,60,0.45,14,25,0.56,14,15,0.933,110,25,66,0.379,20,50,0.4,5,16,0.313,31,39,0.795,86,2013-03-25,NOP,DEN,2013,88.5
2863,2863,63,Home,W 110-100 ,240,40,83,0.482,35,65,0.538,5,18,0.278,25,27,0.926,110,42,81,0.519,35,65,0.538,7,16,0.438,9,14,0.643,100,2013-04-01,MIN,BOS,2013,103.5
2864,2864,64,@,L 110-121 ,240,38,78,0.487,32,60,0.533,6,18,0.333,28,35,0.8,110,47,85,0.553,37,65,0.569,10,20,0.5,17,23,0.739,121,2013-04-10,NOP,SAC,2013,126.0
2865,2865,65,@,L 110-114 ,240,42,85,0.494,26,45,0.578,16,40,0.4,10,13,0.769,110,43,80,0.538,35,59,0.593,8,21,0.381,20,24,0.833,114,2013-10-30,MIA,PHI,2014,118.0
2866,2866,66,Home,W 110-90 ,240,39,70,0.557,28,48,0.583,11,22,0.5,21,27,0.778,110,32,92,0.348,26,80,0.325,6,12,0.5,20,26,0.769,90,2013-11-01,ORL,NOP,2014,93.0
2867,2867,67,@,W 110-101 ,240,35,70,0.5,23,46,0.5,12,24,0.5,28,34,0.824,110,36,79,0.456,30,62,0.484,6,17,0.353,23,32,0.719,101,2013-11-01,LAC,SAC,2014,104.0
2868,2868,68,@,W 110-90 ,240,41,92,0.446,26,54,0.481,15,38,0.395,13,20,0.65,110,31,88,0.352,26,63,0.413,5,25,0.2,23,37,0.622,90,2013-11-04,GSW,PHI,2014,92.5
2869,2869,69,Home,L 110-119 ,240,39,91,0.429,28,60,0.467,11,31,0.355,21,27,0.778,110,37,82,0.451,31,65,0.477,6,17,0.353,39,44,0.886,119,2013-11-08,DET,OKC,2014,122.0
2870,2870,70,Home,L 110-111 ,240,41,71,0.577,36,61,0.59,5,10,0.5,23,34,0.676,110,46,89,0.517,36,68,0.529,10,21,0.476,9,12,0.75,111,2013-11-09,MIA,BOS,2014,116.0
2871,2871,71,Home,W 110-104 (2OT),290,37,84,0.44,30,58,0.517,7,26,0.269,29,47,0.617,110,38,114,0.333,30,89,0.337,8,25,0.32,20,27,0.741,104,2013-11-11,HOU,TOR,2014,108.0
2872,2872,72,Home,W 110-104 ,240,40,74,0.541,35,61,0.574,5,13,0.385,25,30,0.833,110,37,74,0.5,25,46,0.543,12,28,0.429,18,21,0.857,104,2013-11-15,MIA,DAL,2014,110.0
2873,2873,73,Home,W 110-94 ,240,40,79,0.506,29,60,0.483,11,19,0.579,19,24,0.792,110,34,85,0.4,30,69,0.435,4,16,0.25,22,28,0.786,94,2013-11-16,CHI,IND,2014,96.0
2874,2874,74,Home,W 110-103 ,240,40,77,0.519,30,54,0.556,10,23,0.435,20,30,0.667,110,36,85,0.424,27,62,0.435,9,23,0.391,22,33,0.667,103,2013-11-16,LAC,BRK,2014,107.5
2875,2875,75,@,W 110-90 ,240,44,78,0.564,35,56,0.625,9,22,0.409,13,17,0.765,110,34,90,0.378,24,60,0.4,10,30,0.333,12,16,0.75,90,2013-11-16,ATL,NYK,2014,95.0
2876,2876,76,Home,L 110-118 (OT),265,42,94,0.447,39,77,0.506,3,17,0.176,23,31,0.742,110,44,99,0.444,29,67,0.433,15,32,0.469,15,20,0.75,118,2013-11-17,TOR,POR,2014,125.5
2877,2877,77,@,W 110-96 ,240,41,75,0.547,33,55,0.6,8,20,0.4,20,28,0.714,110,38,82,0.463,33,63,0.524,5,19,0.263,15,19,0.789,96,2013-11-25,DEN,DAL,2014,98.5
2878,2878,78,Home,L 110-117 ,240,40,88,0.455,35,68,0.515,5,20,0.25,25,28,0.893,110,45,88,0.511,37,72,0.514,8,16,0.5,19,25,0.76,117,2013-11-27,MIN,DEN,2014,121.0
2879,2879,79,Home,W 110-91 ,240,46,84,0.548,41,70,0.586,5,14,0.357,13,21,0.619,110,37,87,0.425,30,58,0.517,7,29,0.241,10,15,0.667,91,2013-12-03,MEM,PHO,2014,94.5
2880,2880,80,@,W 110-95 ,240,40,72,0.556,29,44,0.659,11,28,0.393,19,21,0.905,110,36,85,0.424,29,65,0.446,7,20,0.35,16,22,0.727,95,2013-12-08,MIA,DET,2014,98.5
2881,2881,81,@,L 110-117 ,240,38,88,0.432,27,65,0.415,11,23,0.478,23,26,0.885,110,48,87,0.552,38,65,0.585,10,22,0.455,11,13,0.846,117,2013-12-13,MIN,SAS,2014,122.0
2882,2882,82,Home,W 110-107 ,240,43,98,0.439,35,69,0.507,8,29,0.276,16,18,0.889,110,44,94,0.468,38,77,0.494,6,17,0.353,13,19,0.684,107,2013-12-21,POR,NOP,2014,110.0
2883,2883,83,@,L 110-111 (OT),265,42,97,0.433,32,69,0.464,10,28,0.357,16,17,0.941,110,43,99,0.434,33,82,0.402,10,17,0.588,15,20,0.75,111,2013-12-23,MIL,CHA,2014,116.0
2884,2884,84,Home,W 110-108 ,240,48,89,0.539,46,78,0.59,2,11,0.182,12,15,0.8,110,39,88,0.443,27,56,0.482,12,32,0.375,18,24,0.75,108,2013-12-30,NOP,POR,2014,114.0
2885,2885,85,@,W 110-106 ,240,42,85,0.494,35,63,0.556,7,22,0.318,19,23,0.826,110,39,81,0.481,32,53,0.604,7,28,0.25,21,33,0.636,106,2013-12-31,SAC,HOU,2014,109.5
2886,2886,86,Home,W 110-99 ,240,42,81,0.519,32,57,0.561,10,24,0.417,16,21,0.762,110,38,86,0.442,30,60,0.5,8,26,0.308,15,23,0.652,99,2014-01-03,LAL,UTA,2014,103.0
2887,2887,87,@,W 110-94 ,240,40,74,0.541,34,58,0.586,6,16,0.375,24,31,0.774,110,33,80,0.413,25,54,0.463,8,26,0.308,20,24,0.833,94,2014-01-04,MIA,ORL,2014,98.0
2888,2888,88,Home,W 110-97 ,240,48,90,0.533,43,73,0.589,5,17,0.294,9,15,0.6,110,34,81,0.42,23,50,0.46,11,31,0.355,18,26,0.692,97,2014-01-07,DAL,LAL,2014,102.5
2889,2889,89,@,W 110-108 (OT),265,43,83,0.518,36,59,0.61,7,24,0.292,17,25,0.68,110,46,99,0.465,40,82,0.488,6,17,0.353,10,15,0.667,108,2014-01-07,SAS,MEM,2014,111.0
2890,2890,90,Home,W 110-94 ,240,45,95,0.474,36,65,0.554,9,30,0.3,11,13,0.846,110,33,83,0.398,26,63,0.413,7,20,0.35,21,27,0.778,94,2014-01-08,POR,ORL,2014,97.5
2891,2891,91,Home,W 110-107 ,240,30,67,0.448,19,40,0.475,11,27,0.407,39,45,0.867,110,37,77,0.481,29,58,0.5,8,19,0.421,25,31,0.806,107,2014-01-11,DAL,NOP,2014,111.0
2892,2892,92,Home,W 110-108 ,240,44,94,0.468,41,77,0.532,3,17,0.176,19,27,0.704,110,37,94,0.394,24,59,0.407,13,35,0.371,21,25,0.84,108,2014-01-11,DET,PHO,2014,114.5
2893,2893,93,Home,L 110-127 ,240,40,81,0.494,32,56,0.571,8,25,0.32,22,22,1.0,110,53,91,0.582,37,64,0.578,16,27,0.593,5,7,0.714,127,2014-01-16,ATL,BRK,2014,135.0
2894,2894,94,@,W 110-89 ,240,43,79,0.544,34,57,0.596,9,22,0.409,15,19,0.789,110,32,74,0.432,28,58,0.483,4,16,0.25,21,31,0.677,89,2014-01-17,UTA,DET,2014,91.0
2895,2895,95,@,W 110-107 ,240,44,83,0.53,35,59,0.593,9,24,0.375,13,19,0.684,110,42,93,0.452,35,71,0.493,7,22,0.318,16,21,0.762,107,2014-01-17,DAL,PHO,2014,110.5
2896,2896,96,Home,W 110-82 ,240,43,76,0.566,32,58,0.552,11,18,0.611,13,21,0.619,110,33,88,0.375,27,67,0.403,6,21,0.286,10,17,0.588,82,2014-01-19,SAS,MIL,2014,85.0
2897,2897,97,@,W 110-106 ,240,42,88,0.477,33,74,0.446,9,14,0.643,17,24,0.708,110,37,82,0.451,22,49,0.449,15,33,0.455,17,24,0.708,106,2014-01-22,PHI,NYK,2014,113.5
2898,2898,98,Home,W 110-105 ,240,38,88,0.432,34,70,0.486,4,18,0.222,30,34,0.882,110,39,79,0.494,29,56,0.518,10,23,0.435,17,20,0.85,105,2014-01-23,POR,DEN,2014,110.0
2899,2899,99,Home,W 110-103 ,240,43,90,0.478,32,64,0.5,11,26,0.423,13,18,0.722,110,39,75,0.52,28,52,0.538,11,23,0.478,14,18,0.778,103,2014-01-26,NYK,LAL,2014,108.5
2900,2900,0,Home,W 110-103 ,240,36,73,0.493,30,58,0.517,6,15,0.4,32,42,0.762,110,45,88,0.511,42,66,0.636,3,22,0.136,10,17,0.588,103,2014-01-29,LAC,WAS,2014,104.5
2901,2901,1,@,W 110-100 ,240,46,88,0.523,44,77,0.571,2,11,0.182,16,22,0.727,110,36,93,0.387,30,67,0.448,6,26,0.231,22,27,0.815,100,2014-01-31,CHA,LAL,2014,103.0
2902,2902,2,Home,W 110-100 ,240,39,84,0.464,29,61,0.475,10,23,0.435,22,26,0.846,110,36,95,0.379,29,79,0.367,7,16,0.438,21,31,0.677,100,2014-02-05,DEN,MIL,2014,103.5
2903,2903,3,@,W 110-96 ,240,42,78,0.538,34,60,0.567,8,18,0.444,18,25,0.72,110,37,69,0.536,31,53,0.585,6,16,0.375,16,22,0.727,96,2014-02-05,DAL,MEM,2014,99.0
2904,2904,4,Home,L 110-117 ,240,40,97,0.412,35,80,0.438,5,17,0.294,25,34,0.735,110,40,83,0.482,32,60,0.533,8,23,0.348,29,38,0.763,117,2014-02-08,MIN,POR,2014,121.0
2905,2905,5,Home,L 110-111 ,240,40,83,0.482,31,67,0.463,9,16,0.563,21,26,0.808,110,42,78,0.538,32,56,0.571,10,22,0.455,17,25,0.68,111,2014-02-12,GSW,MIA,2014,116.0
2906,2906,6,@,W 110-100 ,240,36,80,0.45,27,62,0.435,9,18,0.5,29,40,0.725,110,35,83,0.422,26,56,0.464,9,27,0.333,21,32,0.656,100,2014-02-22,IND,MIL,2014,104.5
2907,2907,7,Home,L 110-123 ,240,37,87,0.425,30,69,0.435,7,18,0.389,29,35,0.829,110,43,83,0.518,27,55,0.491,16,28,0.571,21,26,0.808,123,2014-02-24,NOP,LAC,2014,131.0
2908,2908,8,@,W 110-108 ,240,41,86,0.477,26,50,0.52,15,36,0.417,13,16,0.813,110,40,76,0.526,26,43,0.605,14,33,0.424,14,16,0.875,108,2014-02-24,DAL,NYK,2014,115.0
2909,2909,9,Home,L 110-130 ,240,43,88,0.489,35,64,0.547,8,24,0.333,16,23,0.696,110,48,84,0.571,36,64,0.563,12,20,0.6,22,29,0.759,130,2014-02-24,PHI,MIL,2014,136.0
2910,2910,10,Home,W 110-98 ,240,44,80,0.55,38,63,0.603,6,17,0.353,16,21,0.762,110,37,84,0.44,33,69,0.478,4,15,0.267,20,21,0.952,98,2014-02-24,UTA,BOS,2014,100.0
2911,2911,11,@,W 110-101 ,240,42,87,0.483,37,69,0.536,5,18,0.278,21,32,0.656,110,42,95,0.442,39,80,0.488,3,15,0.2,14,18,0.778,101,2014-02-25,MIN,PHO,2014,102.5
2912,2912,12,@,L 110-120 ,240,45,90,0.5,40,80,0.5,5,10,0.5,15,17,0.882,110,44,82,0.537,35,63,0.556,9,19,0.474,23,25,0.92,120,2014-02-26,DET,SAS,2014,124.5
2913,2913,13,@,L 110-118 ,240,45,100,0.45,41,81,0.506,4,19,0.211,16,19,0.842,110,42,84,0.5,31,51,0.608,11,33,0.333,23,33,0.697,118,2014-03-01,DET,HOU,2014,123.5
2914,2914,14,Home,W 110-96 ,240,44,81,0.543,35,62,0.565,9,19,0.474,13,18,0.722,110,39,79,0.494,32,61,0.525,7,18,0.389,11,15,0.733,96,2014-03-01,MEM,CLE,2014,99.5
2915,2915,15,@,W 110-104 ,240,43,79,0.544,37,66,0.561,6,13,0.462,18,21,0.857,110,39,81,0.481,30,62,0.484,9,19,0.474,17,21,0.81,104,2014-03-03,MEM,WAS,2014,108.5
2916,2916,16,@,L 110-115 ,240,46,87,0.529,37,67,0.552,9,20,0.45,9,9,1.0,110,37,79,0.468,26,55,0.473,11,24,0.458,30,36,0.833,115,2014-03-05,DAL,DEN,2014,120.5
2917,2917,17,@,L 110-114 ,240,42,100,0.42,30,65,0.462,12,35,0.343,14,21,0.667,110,38,81,0.469,25,50,0.5,13,31,0.419,25,30,0.833,114,2014-03-09,OKC,LAL,2014,120.5
2918,2918,18,@,L 110-123 ,240,43,84,0.512,37,64,0.578,6,20,0.3,18,25,0.72,110,44,81,0.543,31,49,0.633,13,32,0.406,22,34,0.647,123,2014-03-10,PHI,NYK,2014,129.5
2919,2919,19,Home,L 110-112 ,240,40,82,0.488,30,61,0.492,10,21,0.476,20,24,0.833,110,38,78,0.487,25,49,0.51,13,29,0.448,23,27,0.852,112,2014-03-10,UTA,ATL,2014,118.5
2920,2920,20,@,W 110-101 ,240,38,81,0.469,26,57,0.456,12,24,0.5,22,27,0.815,110,39,90,0.433,29,54,0.537,10,36,0.278,13,22,0.591,101,2014-03-12,CLE,PHO,2014,106.0
2921,2921,21,Home,W 110-100 ,240,38,93,0.409,32,68,0.471,6,25,0.24,28,33,0.848,110,36,92,0.391,31,71,0.437,5,21,0.238,23,25,0.92,100,2014-03-17,DEN,LAC,2014,102.5
2922,2922,22,@,L 110-115 ,240,39,80,0.488,36,68,0.529,3,12,0.25,29,39,0.744,110,43,80,0.538,35,53,0.66,8,27,0.296,21,25,0.84,115,2014-03-20,MIL,GSW,2014,119.0
2923,2923,23,@,W 110-78 ,240,43,79,0.544,35,60,0.583,8,19,0.421,16,22,0.727,110,30,79,0.38,27,55,0.491,3,24,0.125,15,21,0.714,78,2014-03-28,MIA,DET,2014,79.5
2924,2924,24,Home,W 110-105 (OT),265,39,87,0.448,33,69,0.478,6,18,0.333,26,35,0.743,110,43,97,0.443,35,75,0.467,8,22,0.364,11,14,0.786,105,2014-03-28,ORL,CHA,2014,109.0
2925,2925,25,Home,W 110-81 ,240,42,70,0.6,31,45,0.689,11,25,0.44,15,20,0.75,110,26,65,0.4,18,39,0.462,8,26,0.308,21,28,0.75,81,2014-04-02,NYK,BRK,2014,85.0
2926,2926,26,Home,W 110-91 ,240,42,91,0.462,37,76,0.487,5,15,0.333,21,26,0.808,110,36,81,0.444,32,64,0.5,4,17,0.235,15,25,0.6,91,2014-04-08,MIN,SAS,2014,93.0
2927,2927,27,@,L 110-112 ,240,36,83,0.434,25,58,0.431,11,25,0.44,27,36,0.75,110,41,94,0.436,38,82,0.463,3,12,0.25,27,40,0.675,112,2014-04-11,HOU,MIN,2014,113.5
2928,2928,28,Home,W 110-100 ,240,38,81,0.469,24,49,0.49,14,32,0.438,20,26,0.769,110,38,73,0.521,32,63,0.508,6,10,0.6,18,26,0.692,100,2014-04-14,TOR,MIL,2014,103.0
2929,2929,29,Home,W 110-104 ,240,42,101,0.416,32,75,0.427,10,26,0.385,16,22,0.727,110,34,84,0.405,26,50,0.52,8,34,0.235,28,33,0.848,104,2014-04-16,POR,LAC,2014,108.0
2930,2930,30,@,W 110-105 ,240,34,81,0.42,32,72,0.444,2,9,0.222,40,47,0.851,110,36,93,0.387,31,69,0.449,5,24,0.208,28,33,0.848,105,2014-11-03,SAC,DEN,2015,107.5
2931,2931,31,@,W 110-107 ,240,42,87,0.483,35,71,0.493,7,16,0.438,19,23,0.826,110,40,78,0.513,30,52,0.577,10,26,0.385,17,18,0.944,107,2014-11-05,TOR,BOS,2015,112.0
2932,2932,32,Home,W 110-99 ,240,38,74,0.514,24,50,0.48,14,24,0.583,20,26,0.769,110,37,90,0.411,29,71,0.408,8,19,0.421,17,21,0.81,99,2014-11-07,BRK,NYK,2015,103.0
2933,2933,33,@,W 110-101 ,240,40,84,0.476,34,61,0.557,6,23,0.261,24,33,0.727,110,40,85,0.471,29,56,0.518,11,29,0.379,10,15,0.667,101,2014-11-07,CLE,DEN,2015,106.5
2934,2934,34,@,L 110-111 ,240,37,77,0.481,30,64,0.469,7,13,0.538,29,34,0.853,110,39,77,0.506,33,68,0.485,6,9,0.667,27,34,0.794,111,2014-11-13,SAC,MEM,2015,114.0
2935,2935,35,@,W 110-93 ,240,43,77,0.558,30,46,0.652,13,31,0.419,11,17,0.647,110,30,67,0.448,24,41,0.585,6,26,0.231,27,31,0.871,93,2014-11-20,LAC,MIA,2015,96.0
2936,2936,36,@,W 110-93 ,240,32,80,0.4,24,56,0.429,8,24,0.333,38,42,0.905,110,35,81,0.432,32,65,0.492,3,16,0.188,20,29,0.69,93,2014-11-22,TOR,CLE,2015,94.5
2937,2937,37,@,W 110-103 ,240,40,89,0.449,32,59,0.542,8,30,0.267,22,30,0.733,110,36,85,0.424,30,64,0.469,6,21,0.286,25,31,0.806,103,2014-11-29,DAL,PHI,2015,106.0
2938,2938,38,@,W 110-88 ,240,43,90,0.478,34,65,0.523,9,25,0.36,15,22,0.682,110,36,81,0.444,32,62,0.516,4,19,0.211,12,19,0.632,88,2014-12-08,CLE,BRK,2015,90.0
2939,2939,39,Home,L 110-112 (OT),265,42,90,0.467,30,59,0.508,12,31,0.387,14,21,0.667,110,44,96,0.458,32,72,0.444,12,24,0.5,12,15,0.8,112,2014-12-12,SAS,LAL,2015,118.0
2940,2940,40,Home,W 110-91 ,240,40,83,0.482,33,66,0.5,7,17,0.412,23,27,0.852,110,29,88,0.33,19,62,0.306,10,26,0.385,23,29,0.793,91,2014-12-15,IND,LAL,2015,96.0
2941,2941,41,@,W 110-100 ,240,42,88,0.477,34,61,0.557,8,27,0.296,18,24,0.75,110,41,94,0.436,33,69,0.478,8,25,0.32,10,15,0.667,100,2014-12-19,TOR,DET,2015,104.0
2942,2942,42,Home,W 110-105 ,240,40,76,0.526,32,56,0.571,8,20,0.4,22,29,0.759,110,40,91,0.44,31,64,0.484,9,27,0.333,16,26,0.615,105,2014-12-21,BRK,DET,2015,109.5
2943,2943,43,Home,W 110-82 ,240,43,80,0.538,35,61,0.574,8,19,0.421,16,24,0.667,110,31,82,0.378,29,64,0.453,2,18,0.111,18,24,0.75,82,2014-12-22,CHA,DEN,2015,83.0
2944,2944,44,Home,W 110-95 ,240,41,87,0.471,28,51,0.549,13,36,0.361,15,20,0.75,110,34,76,0.447,24,49,0.49,10,27,0.37,17,18,0.944,95,2014-12-22,HOU,POR,2015,100.0
2945,2945,45,@,W 110-85 ,240,44,86,0.512,35,68,0.515,9,18,0.5,13,18,0.722,110,28,77,0.364,21,52,0.404,7,25,0.28,22,27,0.815,85,2014-12-27,IND,BRK,2015,88.5
2946,2946,46,Home,W 110-97 ,240,41,88,0.466,30,60,0.5,11,28,0.393,17,21,0.81,110,34,77,0.442,26,58,0.448,8,19,0.421,21,36,0.583,97,2014-12-27,GSW,MIN,2015,101.0
2947,2947,47,@,W 110-98 ,240,41,86,0.477,28,52,0.538,13,34,0.382,15,19,0.789,110,37,81,0.457,25,56,0.446,12,25,0.48,12,15,0.8,98,2014-12-27,TOR,LAC,2015,104.0
2948,2948,48,Home,W 110-106 ,240,39,83,0.47,28,53,0.528,11,30,0.367,21,24,0.875,110,38,77,0.494,26,44,0.591,12,33,0.364,18,31,0.581,106,2014-12-28,SAS,HOU,2015,112.0
2949,2949,49,Home,W 110-106 ,240,42,81,0.519,34,63,0.54,8,18,0.444,18,29,0.621,110,41,86,0.477,32,65,0.492,9,21,0.429,15,19,0.789,106,2014-12-30,NOP,PHO,2015,110.5
2950,2950,50,@,W 110-107 ,240,40,74,0.541,35,62,0.565,5,12,0.417,25,29,0.862,110,42,91,0.462,35,67,0.522,7,24,0.292,16,22,0.727,107,2015-01-01,SAC,MIN,2015,110.5
2951,2951,51,@,W 110-101 ,240,46,84,0.548,39,65,0.6,7,19,0.368,11,16,0.688,110,38,89,0.427,28,65,0.431,10,24,0.417,15,18,0.833,101,2015-01-05,DEN,MIN,2015,106.0
2952,2952,52,@,W 110-82 ,240,39,78,0.5,32,62,0.516,7,16,0.438,25,33,0.758,110,33,85,0.388,25,56,0.446,8,29,0.276,8,9,0.889,82,2015-01-10,CHA,NYK,2015,86.0
2953,2953,53,@,L 110-122 (2OT),290,42,100,0.42,34,65,0.523,8,35,0.229,18,23,0.783,110,48,100,0.48,39,79,0.494,9,21,0.429,17,24,0.708,122,2015-01-11,PHO,MEM,2015,126.5
2954,2954,54,@,W 110-101 ,240,41,87,0.471,31,67,0.463,10,20,0.5,18,19,0.947,110,39,80,0.488,34,62,0.548,5,18,0.278,18,30,0.6,101,2015-01-13,MIN,IND,2015,103.5
2955,2955,55,Home,W 110-99 ,240,48,87,0.552,43,72,0.597,5,15,0.333,9,11,0.818,110,42,91,0.462,34,69,0.493,8,22,0.364,7,12,0.583,99,2015-01-16,PHO,MIN,2015,103.0
2956,2956,56,Home,W 110-96 ,240,42,94,0.447,31,65,0.477,11,29,0.379,15,17,0.882,110,37,74,0.5,31,55,0.564,6,19,0.316,16,20,0.8,96,2015-01-16,SAS,POR,2015,99.0
2957,2957,57,@,W 110-89 ,240,42,69,0.609,30,46,0.652,12,23,0.522,14,16,0.875,110,35,82,0.427,29,57,0.509,6,25,0.24,13,17,0.765,89,2015-01-16,ATL,TOR,2015,92.0
2958,2958,58,Home,W 110-98 ,240,37,72,0.514,25,41,0.61,12,31,0.387,24,33,0.727,110,39,85,0.459,33,58,0.569,6,27,0.222,14,18,0.778,98,2015-01-19,HOU,IND,2015,101.0
2959,2959,59,Home,W 110-91 ,240,39,78,0.5,26,49,0.531,13,29,0.448,19,26,0.731,110,31,78,0.397,26,53,0.491,5,25,0.2,24,26,0.923,91,2015-01-21,ATL,IND,2015,93.5
2960,2960,60,@,L 110-114 ,240,41,90,0.456,29,56,0.518,12,34,0.353,16,23,0.696,110,43,81,0.531,38,66,0.576,5,15,0.333,23,29,0.793,114,2015-01-25,DET,TOR,2015,116.5
2961,2961,61,Home,W 110-98 ,240,38,77,0.494,32,61,0.525,6,16,0.375,28,32,0.875,110,42,91,0.462,35,68,0.515,7,23,0.304,7,9,0.778,98,2015-01-28,MIN,BOS,2015,101.5
2962,2962,62,Home,W 110-100 ,240,42,94,0.447,33,69,0.478,9,25,0.36,17,28,0.607,110,37,86,0.43,29,59,0.492,8,27,0.296,18,25,0.72,100,2015-01-30,UTA,GSW,2015,104.0
2963,2963,63,Home,W 110-103 ,240,44,84,0.524,30,52,0.577,14,32,0.438,8,14,0.571,110,42,84,0.5,32,63,0.508,10,21,0.476,9,14,0.643,103,2015-02-04,SAS,ORL,2015,108.0
2964,2964,64,Home,W 110-95 ,240,39,81,0.481,35,59,0.593,4,22,0.182,28,45,0.622,110,34,87,0.391,25,42,0.595,9,45,0.2,18,22,0.818,95,2015-02-11,LAC,HOU,2015,99.5
2965,2965,65,Home,W 110-99 ,240,41,84,0.488,24,51,0.471,17,33,0.515,11,18,0.611,110,39,81,0.481,33,62,0.532,6,19,0.316,15,20,0.75,99,2015-02-20,GSW,SAS,2015,102.0
2966,2966,66,@,W 110-103 ,240,42,95,0.442,37,77,0.481,5,18,0.278,21,26,0.808,110,40,93,0.43,33,69,0.478,7,24,0.292,16,20,0.8,103,2015-02-21,OKC,CHO,2015,106.5
2967,2967,67,@,W 110-82 ,240,43,92,0.467,39,71,0.549,4,21,0.19,20,23,0.87,110,31,94,0.33,24,67,0.358,7,27,0.259,13,22,0.591,82,2015-02-23,BRK,DEN,2015,85.5
2968,2968,68,Home,L 110-115 ,240,44,97,0.454,35,65,0.538,9,32,0.281,13,16,0.813,110,39,89,0.438,25,60,0.417,14,29,0.483,23,30,0.767,115,2015-02-23,PHO,BOS,2015,122.0
2969,2969,69,@,W 110-96 ,240,39,91,0.429,31,67,0.463,8,24,0.333,24,32,0.75,110,31,81,0.383,19,47,0.404,12,34,0.353,22,33,0.667,96,2015-02-25,PHO,DEN,2015,102.0
2970,2970,70,Home,W 110-105 ,240,36,88,0.409,19,44,0.432,17,44,0.386,21,30,0.7,110,40,91,0.44,29,59,0.492,11,32,0.344,14,19,0.737,105,2015-02-25,HOU,LAC,2015,110.5
2971,2971,71,Home,W 110-99 ,240,36,77,0.468,27,49,0.551,9,28,0.321,29,35,0.829,110,39,92,0.424,28,63,0.444,11,29,0.379,10,19,0.526,99,2015-02-26,CLE,GSW,2015,104.5
2972,2972,72,@,W 110-99 ,240,41,83,0.494,31,59,0.525,10,24,0.417,18,20,0.9,110,39,86,0.453,36,74,0.486,3,12,0.25,18,23,0.783,99,2015-03-01,POR,SAC,2015,100.5
2973,2973,73,Home,W 110-108 ,240,44,89,0.494,34,68,0.5,10,21,0.476,12,16,0.75,110,42,90,0.467,31,60,0.517,11,30,0.367,13,18,0.722,108,2015-03-02,BRK,GSW,2015,113.5
2974,2974,74,@,W 110-105 ,240,44,92,0.478,32,59,0.542,12,33,0.364,10,19,0.526,110,36,82,0.439,32,67,0.478,4,15,0.267,29,35,0.829,105,2015-03-02,LAC,MIN,2015,107.0
2975,2975,75,Home,W 110-79 ,240,43,89,0.483,33,61,0.541,10,28,0.357,14,14,1.0,110,31,88,0.352,24,60,0.4,7,28,0.25,10,13,0.769,79,2015-03-03,CLE,BOS,2015,82.5
2976,2976,76,@,W 110-103 ,240,38,84,0.452,26,53,0.491,12,31,0.387,22,30,0.733,110,38,81,0.469,31,61,0.508,7,20,0.35,20,25,0.8,103,2015-03-16,ATL,SAC,2015,106.5
2977,2977,77,@,W 110-91 ,240,47,92,0.511,41,70,0.586,6,22,0.273,10,14,0.714,110,32,89,0.36,31,72,0.431,1,17,0.059,26,30,0.867,91,2015-03-23,BOS,BRK,2015,91.5
2978,2978,78,@,W 110-100 ,240,31,65,0.477,18,41,0.439,13,24,0.542,35,37,0.946,110,40,90,0.444,32,66,0.485,8,24,0.333,12,19,0.632,100,2015-03-23,HOU,IND,2015,104.0
2979,2979,79,@,L 110-120 ,240,37,76,0.487,31,62,0.5,6,14,0.429,30,34,0.882,110,44,83,0.53,24,39,0.615,20,44,0.455,12,17,0.706,120,2015-03-27,MIN,HOU,2015,130.0
2980,2980,80,Home,W 110-107 (2OT),290,44,113,0.389,35,88,0.398,9,25,0.36,13,22,0.591,110,36,104,0.346,28,79,0.354,8,25,0.32,27,35,0.771,107,2015-03-27,WAS,CHO,2015,111.0
2981,2981,81,Home,W 110-88 ,240,43,75,0.573,37,62,0.597,6,13,0.462,18,24,0.75,110,32,75,0.427,30,63,0.476,2,12,0.167,22,24,0.917,88,2015-03-29,NOP,MIN,2015,89.0
2982,2982,82,@,W 110-106 ,240,38,85,0.447,30,64,0.469,8,21,0.381,26,34,0.765,110,36,82,0.439,30,60,0.5,6,22,0.273,28,33,0.848,106,2015-03-31,GSW,LAC,2015,109.0
2983,2983,83,@,W 110-101 ,240,45,85,0.529,36,61,0.59,9,24,0.375,11,18,0.611,110,39,88,0.443,31,64,0.484,8,24,0.333,15,16,0.938,101,2015-04-03,MIL,BOS,2015,105.0
2984,2984,84,Home,L 110-123 ,240,34,80,0.425,31,64,0.484,3,16,0.188,39,54,0.722,110,43,95,0.453,29,59,0.492,14,36,0.389,23,32,0.719,123,2015-04-04,DAL,GSW,2015,130.0
2985,2985,85,Home,W 110-74 ,240,45,88,0.511,37,71,0.521,8,17,0.471,12,14,0.857,110,28,80,0.35,22,59,0.373,6,21,0.286,12,18,0.667,74,2015-04-08,MEM,NOP,2015,77.0
2986,2986,86,Home,W 110-98 ,240,48,95,0.505,41,74,0.554,7,21,0.333,7,9,0.778,110,39,84,0.464,29,59,0.492,10,25,0.4,10,16,0.625,98,2015-04-08,SAS,HOU,2015,103.0
2987,2987,87,Home,W 110-101 ,240,42,93,0.452,31,62,0.5,11,31,0.355,15,21,0.714,110,35,79,0.443,24,55,0.436,11,24,0.458,20,26,0.769,101,2015-04-11,GSW,MIN,2015,106.5
2988,2988,88,Home,W 110-103 ,240,37,82,0.451,30,61,0.492,7,21,0.333,29,37,0.784,110,38,101,0.376,26,68,0.382,12,33,0.364,15,22,0.682,103,2015-04-13,LAC,DEN,2015,109.0
2989,2989,89,Home,W 110-92 ,240,37,83,0.446,33,65,0.508,4,18,0.222,32,42,0.762,110,34,86,0.395,25,62,0.403,9,24,0.375,15,19,0.789,92,2015-10-30,PHO,POR,2016,96.5
2990,2990,90,Home,L 110-117 ,240,38,90,0.422,32,68,0.471,6,22,0.273,28,33,0.848,110,41,86,0.477,32,67,0.478,9,19,0.474,26,32,0.813,117,2015-10-31,WAS,NYK,2016,121.5
2991,2991,91,Home,W 110-105 ,240,41,89,0.461,32,60,0.533,9,29,0.31,19,29,0.655,110,40,84,0.476,30,61,0.492,10,23,0.435,15,22,0.682,105,2015-11-02,HOU,OKC,2016,110.0
2992,2992,92,Home,L 110-116 ,240,40,93,0.43,31,65,0.477,9,28,0.321,21,29,0.724,110,40,82,0.488,25,46,0.543,15,36,0.417,21,27,0.778,116,2015-11-06,SAC,HOU,2016,123.5
2993,2993,93,@,W 110-98 ,240,43,89,0.483,35,61,0.574,8,28,0.286,16,21,0.762,110,32,84,0.381,23,50,0.46,9,34,0.265,25,32,0.781,98,2015-11-14,DAL,HOU,2016,102.5
2994,2994,94,@,L 110-115 ,240,37,79,0.468,31,61,0.508,6,18,0.333,30,39,0.769,110,43,80,0.538,32,51,0.627,11,29,0.379,18,27,0.667,115,2015-11-17,TOR,GSW,2016,120.5
2995,2995,95,Home,W 110-103 ,240,38,85,0.447,31,68,0.456,7,17,0.412,27,40,0.675,110,43,95,0.453,35,63,0.556,8,32,0.25,9,9,1.0,103,2015-11-18,OKC,NOP,2016,107.0
2996,2996,96,Home,W 110-96 ,240,37,86,0.43,30,65,0.462,7,21,0.333,29,37,0.784,110,30,77,0.39,19,43,0.442,11,34,0.324,25,28,0.893,96,2015-11-24,MEM,DAL,2016,101.5
2997,2997,97,Home,W 110-99 ,240,41,78,0.526,31,54,0.574,10,24,0.417,18,21,0.857,110,43,94,0.457,40,81,0.494,3,13,0.231,10,12,0.833,99,2015-11-25,OKC,BRK,2016,100.5
2998,2998,98,Home,W 110-91 ,240,45,93,0.484,36,68,0.529,9,25,0.36,11,16,0.688,110,36,88,0.409,31,61,0.508,5,27,0.185,14,20,0.7,91,2015-11-29,ORL,BOS,2016,93.5
2999,2999,99,@,W 110-106 ,240,38,86,0.442,30,61,0.492,8,25,0.32,26,29,0.897,110,36,82,0.439,29,64,0.453,7,18,0.389,27,35,0.771,106,2015-12-07,LAC,MIN,2016,109.5
3000,3000,0,Home,W 110-105 ,240,45,81,0.556,38,63,0.603,7,18,0.389,13,16,0.813,110,39,82,0.476,24,47,0.511,15,35,0.429,12,17,0.706,105,2015-12-08,BRK,HOU,2016,112.5
3001,3001,1,Home,L 110-112 ,240,41,89,0.461,35,68,0.515,6,21,0.286,22,29,0.759,110,39,75,0.52,30,54,0.556,9,21,0.429,25,28,0.893,112,2015-12-12,POR,NYK,2016,116.5
3002,3002,2,Home,W 110-89 ,240,36,79,0.456,27,54,0.5,9,25,0.36,29,37,0.784,110,31,79,0.392,24,55,0.436,7,24,0.292,20,22,0.909,89,2015-12-21,UTA,PHO,2016,92.5
3003,3003,3,Home,W 110-108 ,240,38,75,0.507,25,51,0.49,13,24,0.542,21,26,0.808,110,38,84,0.452,23,51,0.451,15,33,0.455,17,20,0.85,108,2015-12-26,NOP,HOU,2016,115.5
3004,3004,4,Home,W 110-103 ,240,41,87,0.471,29,55,0.527,12,32,0.375,16,20,0.8,110,37,87,0.425,25,60,0.417,12,27,0.444,17,19,0.895,103,2015-12-30,POR,DEN,2016,109.0
3005,3005,5,@,W 110-105 ,240,40,94,0.426,31,63,0.492,9,31,0.29,21,34,0.618,110,36,74,0.486,28,49,0.571,8,25,0.32,25,41,0.61,105,2015-12-30,PHI,SAC,2016,109.0
3006,3006,6,Home,L 110-114 ,240,36,78,0.462,24,48,0.5,12,30,0.4,26,29,0.897,110,43,84,0.512,32,61,0.525,11,23,0.478,17,27,0.63,114,2015-12-31,HOU,GSW,2016,119.5
3007,3007,7,Home,W 110-106 ,240,42,80,0.525,35,59,0.593,7,21,0.333,19,24,0.792,110,43,82,0.524,35,62,0.565,8,20,0.4,12,13,0.923,106,2015-12-31,OKC,PHO,2016,110.0
3008,3008,8,@,L 110-115 ,240,37,76,0.487,27,55,0.491,10,21,0.476,26,36,0.722,110,42,100,0.42,23,56,0.411,19,44,0.432,12,14,0.857,115,2016-01-10,OKC,POR,2016,124.5
3009,3009,9,@,W 110-107 (OT),265,40,97,0.412,23,53,0.434,17,44,0.386,13,16,0.813,110,39,79,0.494,28,51,0.549,11,28,0.393,18,22,0.818,107,2016-01-12,CLE,DAL,2016,112.5
3010,3010,10,Home,W 110-104 ,240,45,86,0.523,36,69,0.522,9,17,0.529,11,14,0.786,110,41,91,0.451,34,69,0.493,7,22,0.318,15,23,0.652,104,2016-01-13,BRK,NYK,2016,107.5
3011,3011,11,@,L 110-112 ,240,42,88,0.477,32,62,0.516,10,26,0.385,16,20,0.8,110,37,87,0.425,32,65,0.492,5,22,0.227,33,37,0.892,112,2016-01-13,GSW,DEN,2016,114.5
3012,3012,12,@,W 110-103 ,240,36,76,0.474,23,51,0.451,13,25,0.52,25,33,0.758,110,38,96,0.396,25,57,0.439,13,39,0.333,14,19,0.737,103,2016-01-16,SAC,LAC,2016,109.5
3013,3013,13,@,W 110-104 ,240,41,97,0.423,35,69,0.507,6,28,0.214,22,30,0.733,110,35,83,0.422,28,63,0.444,7,20,0.35,27,36,0.75,104,2016-01-19,OKC,DEN,2016,107.5
3014,3014,14,Home,W 110-101 ,240,43,96,0.448,35,73,0.479,8,23,0.348,16,21,0.762,110,38,89,0.427,35,76,0.461,3,13,0.231,22,26,0.846,101,2016-01-22,BOS,CHI,2016,102.5
3015,3015,15,@,L 110-122 ,240,44,95,0.463,41,78,0.526,3,17,0.176,19,27,0.704,110,43,90,0.478,29,57,0.509,14,33,0.424,22,25,0.88,122,2016-01-22,IND,GSW,2016,129.0
3016,3016,16,Home,W 110-97 ,240,39,91,0.429,34,70,0.486,5,21,0.238,27,38,0.711,110,39,82,0.476,32,63,0.508,7,19,0.368,12,17,0.706,97,2016-01-27,DET,PHI,2016,100.5
3017,3017,17,@,W 110-95 ,240,43,71,0.606,34,55,0.618,9,16,0.563,15,18,0.833,110,36,88,0.409,26,62,0.419,10,26,0.385,13,21,0.619,95,2016-02-01,MEM,NOP,2016,100.0
3018,3018,18,Home,W 110-97 ,240,42,81,0.519,33,66,0.5,9,15,0.6,17,18,0.944,110,41,90,0.456,38,71,0.535,3,19,0.158,12,14,0.857,97,2016-02-03,SAS,NOP,2016,98.5
3019,3019,19,@,W 110-103 ,240,40,85,0.471,28,66,0.424,12,19,0.632,18,25,0.72,110,38,81,0.469,28,56,0.5,10,25,0.4,17,23,0.739,103,2016-02-04,TOR,POR,2016,108.0
3020,3020,20,@,L 110-115 ,240,43,93,0.462,38,81,0.469,5,12,0.417,19,27,0.704,110,39,87,0.448,33,69,0.478,6,18,0.333,31,44,0.705,115,2016-02-05,CHI,DEN,2016,118.0
3021,3021,21,Home,L 110-114 (OT),265,44,88,0.5,35,65,0.538,9,23,0.391,13,23,0.565,110,38,88,0.432,23,50,0.46,15,38,0.395,23,33,0.697,114,2016-02-06,MEM,DAL,2016,121.5
3022,3022,22,Home,L 110-117 (OT),265,43,92,0.467,31,63,0.492,12,29,0.414,12,20,0.6,110,46,93,0.495,37,64,0.578,9,29,0.31,16,22,0.727,117,2016-02-08,ATL,ORL,2016,121.5
3023,3023,23,@,L 110-123 ,240,37,87,0.425,24,54,0.444,13,33,0.394,23,35,0.657,110,44,94,0.468,32,60,0.533,12,34,0.353,23,26,0.885,123,2016-02-09,HOU,GSW,2016,129.0
3024,3024,24,Home,L 110-114 ,240,42,91,0.462,27,56,0.482,15,35,0.429,11,17,0.647,110,44,87,0.506,40,71,0.563,4,16,0.25,22,29,0.759,114,2016-02-10,PHI,SAC,2016,116.0
3025,3025,25,Home,W 110-104 (OT),265,41,102,0.402,28,67,0.418,13,35,0.371,15,17,0.882,110,37,89,0.416,18,48,0.375,19,41,0.463,11,18,0.611,104,2016-02-19,ORL,DAL,2016,113.5
3026,3026,26,@,L 110-116 ,240,42,90,0.467,34,66,0.515,8,24,0.333,18,26,0.692,110,41,83,0.494,31,62,0.5,10,21,0.476,24,31,0.774,116,2016-02-19,DEN,SAC,2016,121.0
3027,3027,27,Home,L 110-114 ,240,41,100,0.41,31,73,0.425,10,27,0.37,18,22,0.818,110,43,83,0.518,36,66,0.545,7,17,0.412,21,28,0.75,114,2016-02-23,DEN,SAC,2016,117.5
3028,3028,28,Home,L 110-112 ,240,39,84,0.464,29,57,0.509,10,27,0.37,22,26,0.846,110,42,84,0.5,37,69,0.536,5,15,0.333,23,30,0.767,112,2016-02-27,NOP,MIN,2016,114.5
3029,3029,29,Home,W 110-94 ,240,45,99,0.455,39,78,0.5,6,21,0.286,14,19,0.737,110,33,75,0.44,27,57,0.474,6,18,0.333,22,26,0.846,94,2016-03-08,DEN,NYK,2016,97.0
3030,3030,30,@,L 110-116 ,240,40,80,0.5,31,56,0.554,9,24,0.375,21,24,0.875,110,44,81,0.543,36,56,0.643,8,25,0.32,20,25,0.8,116,2016-03-15,DEN,ORL,2016,120.0
3031,3031,31,@,L 110-118 ,240,39,89,0.438,29,67,0.433,10,22,0.455,22,30,0.733,110,45,86,0.523,37,70,0.529,8,16,0.5,20,22,0.909,118,2016-03-17,POR,SAS,2016,122.0
3032,3032,32,Home,W 110-104 ,240,44,77,0.571,37,59,0.627,7,18,0.389,15,18,0.833,110,44,83,0.53,37,65,0.569,7,18,0.389,9,13,0.692,104,2016-03-25,SAS,MEM,2016,107.5
3033,3033,33,@,L 110-120 ,240,37,77,0.481,26,53,0.491,11,24,0.458,25,30,0.833,110,42,77,0.545,37,66,0.561,5,11,0.455,31,36,0.861,120,2016-03-26,IND,BRK,2016,122.5
3034,3034,34,Home,W 110-99 ,240,48,84,0.571,43,68,0.632,5,16,0.313,9,12,0.75,110,41,77,0.532,38,66,0.576,3,11,0.273,14,18,0.778,99,2016-03-28,MIA,BRK,2016,100.5
3035,3035,35,@,W 110-108 (OT),265,39,98,0.398,27,60,0.45,12,38,0.316,20,31,0.645,110,38,95,0.4,29,65,0.446,9,30,0.3,23,26,0.885,108,2016-04-01,CLE,ATL,2016,112.5
3036,3036,36,@,L 110-113 ,240,46,86,0.535,38,62,0.613,8,24,0.333,10,12,0.833,110,47,86,0.547,43,69,0.623,4,17,0.235,15,25,0.6,113,2016-04-01,ORL,MIL,2016,115.0
3037,3037,37,Home,W 110-93 ,240,41,79,0.519,31,64,0.484,10,15,0.667,18,23,0.783,110,34,88,0.386,28,69,0.406,6,19,0.316,19,27,0.704,93,2016-04-02,POR,MIA,2016,96.0
3038,3038,38,@,L 110-118 ,240,38,82,0.463,31,55,0.564,7,27,0.259,27,32,0.844,110,41,102,0.402,28,60,0.467,13,42,0.31,23,26,0.885,118,2016-04-03,OKC,HOU,2016,124.5
3039,3039,39,Home,W 110-102 ,240,42,79,0.532,32,57,0.561,10,22,0.455,16,21,0.762,110,34,81,0.42,23,57,0.404,11,24,0.458,23,27,0.852,102,2016-04-08,NOP,LAL,2016,107.5
3040,3040,40,@,L 110-130 ,240,41,83,0.494,29,55,0.527,12,28,0.429,16,19,0.842,110,50,98,0.51,33,57,0.579,17,41,0.415,13,18,0.722,130,2016-04-10,LAL,HOU,2016,138.5
3041,3041,41,Home,W 110-84 ,240,41,75,0.547,29,50,0.58,12,25,0.48,16,21,0.762,110,35,86,0.407,30,66,0.455,5,20,0.25,9,14,0.643,84,2016-04-12,LAC,MEM,2016,86.5
3042,3042,42,Home,L 110-112 (OT),265,46,97,0.474,39,79,0.494,7,18,0.389,11,15,0.733,110,37,85,0.435,21,52,0.404,16,33,0.485,22,28,0.786,112,2016-04-13,CLE,DET,2016,120.0
3043,3043,43,@,L 110-113 (OT),265,42,94,0.447,37,66,0.561,5,28,0.179,21,32,0.656,110,40,96,0.417,35,75,0.467,5,21,0.238,28,38,0.737,113,2016-10-28,PHO,OKC,2017,115.5
3044,3044,44,Home,W 110-108 ,240,41,88,0.466,33,66,0.5,8,22,0.364,20,24,0.833,110,37,84,0.44,26,50,0.52,11,34,0.324,23,28,0.821,108,2016-10-29,MIL,BRK,2017,113.5
3045,3045,45,@,L 110-119 ,240,39,92,0.424,27,64,0.422,12,28,0.429,20,28,0.714,110,42,76,0.553,30,43,0.698,12,33,0.364,23,26,0.885,119,2016-11-08,MIN,BRK,2017,125.0
3046,3046,46,@,W 110-106 ,240,41,81,0.506,30,52,0.577,11,29,0.379,17,24,0.708,110,37,99,0.374,26,57,0.456,11,42,0.262,21,25,0.84,106,2016-11-08,ATL,CLE,2017,111.5
3047,3047,47,Home,W 110-96 ,240,44,92,0.478,34,62,0.548,10,30,0.333,12,17,0.706,110,33,79,0.418,22,46,0.478,11,33,0.333,19,27,0.704,96,2016-11-09,NYK,BRK,2017,101.5
3048,3048,48,@,W 110-108 ,240,39,86,0.453,28,59,0.475,11,27,0.407,21,35,0.6,110,38,88,0.432,22,60,0.367,16,28,0.571,16,19,0.842,108,2016-11-11,LAC,OKC,2017,116.0
3049,3049,49,@,W 110-105 ,240,43,88,0.489,32,58,0.552,11,30,0.367,13,17,0.765,110,36,76,0.474,27,56,0.482,9,20,0.45,24,31,0.774,105,2016-11-16,SAS,SAC,2017,109.5
3050,3050,50,Home,W 110-86 ,240,43,84,0.512,37,59,0.627,6,25,0.24,18,20,0.9,110,31,83,0.373,22,51,0.431,9,32,0.281,15,19,0.789,86,2016-11-17,MIN,PHI,2017,90.5
3051,3051,51,Home,L 110-118 ,240,41,93,0.441,28,62,0.452,13,31,0.419,15,21,0.714,110,45,87,0.517,37,65,0.569,8,22,0.364,20,28,0.714,118,2016-11-20,LAL,CHI,2017,122.0
3052,3052,52,Home,W 110-107 ,240,43,100,0.43,33,78,0.423,10,22,0.455,14,17,0.824,110,43,95,0.453,37,77,0.481,6,18,0.333,15,18,0.833,107,2016-11-22,DEN,CHI,2017,110.0
3053,3053,53,@,W 110-107 ,240,37,73,0.507,28,48,0.583,9,25,0.36,27,33,0.818,110,40,81,0.494,29,50,0.58,11,31,0.355,16,24,0.667,107,2016-11-26,MEM,MIA,2017,112.5
3054,3054,54,Home,L 110-111 ,240,40,73,0.548,23,43,0.535,17,30,0.567,13,17,0.765,110,44,86,0.512,36,67,0.537,8,19,0.421,15,19,0.789,111,2016-12-01,UTA,MIA,2017,115.0
3055,3055,55,Home,L 110-128 ,240,46,104,0.442,37,73,0.507,9,31,0.29,9,16,0.563,110,45,88,0.511,28,51,0.549,17,37,0.459,21,25,0.84,128,2016-12-02,DEN,HOU,2017,136.5
3056,3056,56,Home,L 110-112 ,240,35,83,0.422,28,60,0.467,7,23,0.304,33,38,0.868,110,45,93,0.484,36,69,0.522,9,24,0.375,13,18,0.722,112,2016-12-05,CHI,POR,2017,116.5
3057,3057,57,@,W 110-108 (2OT),290,42,104,0.404,29,70,0.414,13,34,0.382,13,21,0.619,110,39,99,0.394,29,67,0.433,10,32,0.313,20,21,0.952,108,2016-12-05,MEM,NOP,2017,113.0
3058,3058,58,@,L 110-124 ,240,45,88,0.511,36,60,0.6,9,28,0.321,11,15,0.733,110,43,87,0.494,31,60,0.517,12,27,0.444,26,33,0.788,124,2016-12-08,MIN,TOR,2017,130.0
3059,3059,59,Home,L 110-114 ,240,44,94,0.468,32,66,0.485,12,28,0.429,10,14,0.714,110,40,84,0.476,28,50,0.56,12,34,0.353,22,29,0.759,114,2016-12-09,MIL,ATL,2017,120.0
3060,3060,60,Home,W 110-89 ,240,38,87,0.437,30,61,0.492,8,26,0.308,26,29,0.897,110,34,77,0.442,25,50,0.5,9,27,0.333,12,20,0.6,89,2016-12-10,MEM,GSW,2017,93.5
3061,3061,61,Home,W 110-105 ,240,40,88,0.455,32,67,0.478,8,21,0.381,22,28,0.786,110,40,79,0.506,27,54,0.5,13,25,0.52,12,15,0.8,105,2016-12-10,WAS,MIL,2017,111.5
3062,3062,62,Home,W 110-94 ,240,43,88,0.489,26,52,0.5,17,36,0.472,7,10,0.7,110,28,84,0.333,18,58,0.31,10,26,0.385,28,32,0.875,94,2016-12-12,IND,CHO,2017,99.0
3063,3063,63,@,L 110-117 ,240,43,87,0.494,36,64,0.563,7,23,0.304,17,24,0.708,110,43,81,0.531,33,62,0.532,10,19,0.526,21,30,0.7,117,2016-12-18,LAC,WAS,2017,122.0
3064,3064,64,@,W 110-108 ,240,41,75,0.547,32,52,0.615,9,23,0.391,19,24,0.792,110,39,87,0.448,29,52,0.558,10,35,0.286,20,26,0.769,108,2016-12-19,ATL,OKC,2017,113.0
3065,3065,65,Home,L 110-121 ,240,42,88,0.477,34,68,0.5,8,20,0.4,18,23,0.783,110,45,88,0.511,34,60,0.567,11,28,0.393,20,24,0.833,121,2016-12-21,NOP,OKC,2017,126.5
3066,3066,66,@,W 110-90 ,240,39,78,0.5,27,58,0.466,12,20,0.6,20,21,0.952,110,35,79,0.443,23,49,0.469,12,30,0.4,8,16,0.5,90,2016-12-23,SAS,POR,2017,96.0
3067,3067,67,Home,W 110-94 ,240,39,78,0.5,28,56,0.5,11,22,0.5,21,25,0.84,110,35,77,0.455,29,57,0.509,6,20,0.3,18,21,0.857,94,2016-12-30,SAS,POR,2017,97.0
3068,3068,68,Home,W 110-82 ,240,43,78,0.551,30,54,0.556,13,24,0.542,11,15,0.733,110,31,83,0.373,27,65,0.415,4,18,0.222,16,22,0.727,82,2017-01-03,SAS,TOR,2017,84.0
3069,3069,69,Home,W 110-106 ,240,35,87,0.402,16,47,0.34,19,40,0.475,21,25,0.84,110,37,79,0.468,28,51,0.549,9,28,0.321,23,26,0.885,106,2017-01-06,BOS,PHI,2017,110.5
3070,3070,70,@,W 110-96 ,240,41,84,0.488,29,57,0.509,12,27,0.444,16,19,0.842,110,36,85,0.424,25,56,0.446,11,29,0.379,13,16,0.813,96,2017-01-09,NOP,NYK,2017,101.5
3071,3071,71,@,W 110-105 ,240,41,76,0.539,31,49,0.633,10,27,0.37,18,27,0.667,110,33,82,0.402,23,41,0.561,10,41,0.244,29,36,0.806,105,2017-01-13,MEM,HOU,2017,110.0
3072,3072,72,Home,W 110-77 ,240,43,80,0.538,27,49,0.551,16,31,0.516,8,13,0.615,110,30,76,0.395,24,59,0.407,6,17,0.353,11,16,0.688,77,2017-01-13,UTA,DET,2017,80.0
3073,3073,73,Home,L 110-113 ,240,42,90,0.467,35,66,0.53,7,24,0.292,19,22,0.864,110,44,88,0.5,31,56,0.554,13,32,0.406,12,14,0.857,113,2017-01-19,NYK,WAS,2017,119.5
3074,3074,74,Home,W 110-93 ,240,45,91,0.495,38,71,0.535,7,20,0.35,13,23,0.565,110,33,78,0.423,21,49,0.429,12,29,0.414,15,18,0.833,93,2017-01-21,ATL,PHI,2017,99.0
3075,3075,75,@,L 110-121 ,240,33,71,0.465,15,37,0.405,18,34,0.529,26,41,0.634,110,45,90,0.5,35,61,0.574,10,29,0.345,21,22,0.955,121,2017-01-24,LAC,PHI,2017,126.0
3076,3076,76,Home,W 110-107 ,240,46,96,0.479,37,69,0.536,9,27,0.333,9,13,0.692,110,40,90,0.444,27,53,0.509,13,37,0.351,14,15,0.933,107,2017-01-27,NYK,CHO,2017,113.5
3077,3077,77,Home,W 110-87 ,240,42,84,0.5,31,56,0.554,11,28,0.393,15,16,0.938,110,34,79,0.43,26,53,0.491,8,26,0.308,11,17,0.647,87,2017-02-06,DEN,DAL,2017,91.0
3078,3078,78,Home,L 110-114 (OT),265,38,91,0.418,29,58,0.5,9,33,0.273,25,36,0.694,110,40,97,0.412,31,72,0.431,9,25,0.36,25,33,0.758,114,2017-02-08,BRK,WAS,2017,118.5
3079,3079,79,Home,W 110-91 ,240,35,72,0.486,21,48,0.438,14,24,0.583,26,34,0.765,110,29,87,0.333,24,64,0.375,5,23,0.217,28,34,0.824,91,2017-02-08,MEM,PHO,2017,93.5
3080,3080,80,@,L 110-132 ,240,45,92,0.489,37,60,0.617,8,32,0.25,12,13,0.923,110,48,88,0.545,24,47,0.511,24,41,0.585,12,16,0.75,132,2017-02-13,GSW,DEN,2017,144.0
3081,3081,81,@,W 110-106 ,240,40,87,0.46,33,72,0.458,7,15,0.467,23,27,0.852,110,38,78,0.487,29,58,0.5,9,20,0.45,21,30,0.7,106,2017-02-13,SAS,IND,2017,110.5
3082,3082,82,@,W 110-108 ,240,37,78,0.474,29,50,0.58,8,28,0.286,28,35,0.8,110,40,93,0.43,32,70,0.457,8,23,0.348,20,24,0.833,108,2017-02-13,NOP,PHO,2017,112.0
3083,3083,83,Home,W 110-93 ,240,44,97,0.454,34,73,0.466,10,24,0.417,12,17,0.706,110,40,101,0.396,33,66,0.5,7,35,0.2,6,14,0.429,93,2017-02-24,OKC,LAL,2017,96.5
3084,3084,84,Home,W 110-109 ,240,43,91,0.473,37,70,0.529,6,21,0.286,18,23,0.783,110,40,95,0.421,33,64,0.516,7,31,0.226,22,27,0.815,109,2017-02-25,NYK,PHI,2017,112.5
3085,3085,85,@,L 110-118 ,240,36,80,0.45,28,59,0.475,8,21,0.381,30,37,0.811,110,42,88,0.477,36,67,0.537,6,21,0.286,28,37,0.757,118,2017-02-26,NOP,OKC,2017,121.0
3086,3086,86,@,W 110-98 ,240,41,84,0.488,31,51,0.608,10,33,0.303,18,20,0.9,110,38,83,0.458,29,65,0.446,9,18,0.5,13,15,0.867,98,2017-03-01,DEN,MIL,2017,102.5
3087,3087,87,Home,W 110-99 ,240,45,90,0.5,40,73,0.548,5,17,0.294,15,19,0.789,110,35,91,0.385,27,63,0.429,8,28,0.286,21,25,0.84,99,2017-03-03,ORL,MIA,2017,103.0
3088,3088,88,@,W 110-109 (OT),265,41,90,0.456,31,57,0.544,10,33,0.303,18,27,0.667,110,43,83,0.518,35,66,0.53,8,17,0.471,15,20,0.75,109,2017-03-05,UTA,SAC,2017,113.0
3089,3089,89,@,L 110-112 ,240,41,88,0.466,27,49,0.551,14,39,0.359,14,17,0.824,110,40,87,0.46,29,60,0.483,11,27,0.407,21,23,0.913,112,2017-03-06,HOU,SAS,2017,117.5
3090,3090,90,Home,W 110-105 ,240,41,95,0.432,37,75,0.493,4,20,0.2,24,32,0.75,110,37,80,0.463,26,46,0.565,11,34,0.324,20,25,0.8,105,2017-03-08,ATL,BRK,2017,110.5
3091,3091,91,Home,L 110-122 ,240,42,91,0.462,36,72,0.5,6,19,0.316,20,25,0.8,110,47,98,0.48,35,71,0.493,12,27,0.444,16,24,0.667,122,2017-03-09,PHO,LAL,2017,128.0
3092,3092,92,Home,L 109-116 (3OT),315,36,94,0.383,30,72,0.417,6,22,0.273,31,46,0.674,109,45,102,0.441,37,74,0.5,8,28,0.286,18,23,0.783,116,2012-01-05,ATL,MIA,2012,120.0
3093,3093,93,Home,W 109-94 ,240,42,80,0.525,36,66,0.545,6,14,0.429,19,25,0.76,109,36,78,0.462,33,65,0.508,3,13,0.231,19,27,0.704,94,2012-01-06,OKC,HOU,2012,95.5
3094,3094,94,Home,W 109-94 ,240,47,83,0.566,38,71,0.535,9,12,0.75,6,6,1.0,109,36,82,0.439,30,68,0.441,6,14,0.429,16,20,0.8,94,2012-01-07,ATL,CHI,2012,97.0
3095,3095,95,Home,W 109-93 ,240,43,77,0.558,33,55,0.6,10,22,0.455,13,17,0.765,109,37,86,0.43,34,71,0.479,3,15,0.2,16,24,0.667,93,2012-01-08,PHO,MIL,2012,94.5
3096,3096,96,Home,L 109-117 ,240,43,82,0.524,33,59,0.559,10,23,0.435,13,19,0.684,109,35,68,0.515,24,45,0.533,11,23,0.478,36,55,0.655,117,2012-01-12,GSW,ORL,2012,122.5
3097,3097,97,Home,L 109-120 ,240,41,87,0.471,29,59,0.492,12,28,0.429,15,19,0.789,109,42,88,0.477,38,71,0.535,4,17,0.235,32,37,0.865,120,2012-01-27,GSW,OKC,2012,122.0
3098,3098,98,Home,W 109-71 ,240,43,91,0.473,36,71,0.507,7,20,0.35,16,19,0.842,109,29,78,0.372,25,65,0.385,4,13,0.308,9,18,0.5,71,2012-01-27,POR,PHO,2012,73.0
3099,3099,99,@,W 109-105 ,240,39,86,0.453,25,56,0.446,14,30,0.467,17,26,0.654,109,42,85,0.494,36,67,0.537,6,18,0.333,15,20,0.75,105,2012-01-29,LAC,DEN,2012,108.0
3100,3100,0,Home,W 109-95 ,240,43,78,0.551,37,63,0.587,6,15,0.4,17,21,0.81,109,40,75,0.533,36,62,0.581,4,13,0.308,11,19,0.579,95,2012-01-30,MIA,NOH,2012,97.0
3101,3101,1,@,W 109-99 ,240,38,84,0.452,31,69,0.449,7,15,0.467,26,34,0.765,109,34,91,0.374,31,74,0.419,3,17,0.176,28,37,0.757,99,2012-02-01,IND,MIN,2012,100.5
3102,3102,2,Home,W 109-103 ,240,33,73,0.452,20,43,0.465,13,30,0.433,30,39,0.769,109,42,92,0.457,30,69,0.435,12,23,0.522,7,9,0.778,103,2012-02-01,ORL,WAS,2012,109.0
3103,3103,3,@,W 109-101 ,240,41,79,0.519,28,54,0.519,13,25,0.52,14,22,0.636,109,37,85,0.435,28,61,0.459,9,24,0.375,18,27,0.667,101,2012-02-09,GSW,DEN,2012,105.5
3104,3104,4,Home,W 109-92 ,240,43,79,0.544,39,69,0.565,4,10,0.4,19,25,0.76,109,31,74,0.419,26,55,0.473,5,19,0.263,25,31,0.806,92,2012-02-10,DET,NJN,2012,94.5
3105,3105,5,Home,L 109-113 ,240,42,79,0.532,34,57,0.596,8,22,0.364,17,22,0.773,109,43,87,0.494,38,70,0.543,5,17,0.294,22,33,0.667,113,2012-02-11,IND,DEN,2012,115.5
3106,3106,6,Home,W 109-92 ,240,40,78,0.513,36,64,0.563,4,14,0.286,25,34,0.735,109,33,99,0.333,24,75,0.32,9,24,0.375,17,19,0.895,92,2012-02-14,DEN,PHO,2012,96.5
3107,3107,7,Home,L 109-124 ,240,40,85,0.471,33,62,0.532,7,23,0.304,22,27,0.815,109,48,80,0.6,39,63,0.619,9,17,0.529,19,23,0.826,124,2012-02-14,POR,WAS,2012,128.5
3108,3108,8,@,W 109-97 ,240,40,78,0.513,30,56,0.536,10,22,0.455,19,27,0.704,109,40,85,0.471,38,74,0.514,2,11,0.182,15,22,0.682,97,2012-02-28,MIN,LAC,2012,98.0
3109,3109,9,Home,W 109-94 ,240,42,84,0.5,41,74,0.554,1,10,0.1,24,32,0.75,109,36,82,0.439,33,73,0.452,3,9,0.333,19,29,0.655,94,2012-02-29,DET,CHA,2012,95.5
3110,3110,10,@,W 109-100 ,240,40,80,0.5,35,71,0.493,5,9,0.556,24,29,0.828,109,37,81,0.457,28,58,0.483,9,23,0.391,17,27,0.63,100,2012-03-05,UTA,CLE,2012,104.5
3111,3111,11,Home,W 109-101 ,240,41,83,0.494,31,63,0.492,10,20,0.5,17,22,0.773,109,40,78,0.513,32,63,0.508,8,15,0.533,13,18,0.722,101,2012-03-16,PHO,DET,2012,105.0
3112,3112,12,@,W 109-93 ,240,45,77,0.584,36,59,0.61,9,18,0.5,10,13,0.769,109,35,82,0.427,27,56,0.482,8,26,0.308,15,22,0.682,93,2012-03-21,LAL,DAL,2012,97.0
3113,3113,13,Home,W 109-83 ,240,40,85,0.471,34,68,0.5,6,17,0.353,23,27,0.852,109,34,82,0.415,28,66,0.424,6,16,0.375,9,10,0.9,83,2012-03-22,HOU,GSW,2012,86.0
3114,3114,14,@,W 109-95 ,240,45,79,0.57,39,62,0.629,6,17,0.353,13,16,0.813,109,34,79,0.43,27,63,0.429,7,16,0.438,20,25,0.8,95,2012-03-27,OKC,POR,2012,98.5
3115,3115,15,@,W 109-100 ,240,40,90,0.444,35,68,0.515,5,22,0.227,24,28,0.857,109,39,85,0.459,38,75,0.507,1,10,0.1,21,32,0.656,100,2012-04-03,PHO,SAC,2012,100.5
3116,3116,16,@,W 109-96 ,240,44,76,0.579,40,65,0.615,4,11,0.364,17,19,0.895,109,39,84,0.464,33,66,0.5,6,18,0.333,12,19,0.632,96,2012-04-04,IND,WAS,2012,99.0
3117,3117,17,Home,W 109-94 ,240,44,89,0.494,33,62,0.532,11,27,0.407,10,19,0.526,109,34,82,0.415,27,60,0.45,7,22,0.318,19,28,0.679,94,2012-04-07,LAC,SAC,2012,97.5
3118,3118,18,@,W 109-89 ,240,39,81,0.481,31,61,0.508,8,20,0.4,23,25,0.92,109,37,87,0.425,31,68,0.456,6,19,0.316,9,13,0.692,89,2012-04-09,OKC,MIL,2012,92.0
3119,3119,19,@,W 109-85 ,240,43,82,0.524,38,69,0.551,5,13,0.385,18,21,0.857,109,31,70,0.443,25,59,0.424,6,11,0.545,17,23,0.739,85,2012-04-12,DET,CHA,2012,88.0
3120,3120,20,@,W 109-81 ,240,40,79,0.506,26,44,0.591,14,35,0.4,15,16,0.938,109,33,85,0.388,27,57,0.474,6,28,0.214,9,14,0.643,81,2012-04-13,ATL,ORL,2012,84.0
3121,3121,21,@,W 109-87 ,240,39,80,0.488,33,59,0.559,6,21,0.286,25,36,0.694,109,35,79,0.443,31,70,0.443,4,9,0.444,13,16,0.813,87,2012-04-16,ATL,TOR,2012,89.0
3122,3122,22,@,W 109-97 ,240,36,80,0.45,30,64,0.469,6,16,0.375,31,34,0.912,109,34,83,0.41,28,63,0.444,6,20,0.3,23,32,0.719,97,2012-04-18,OKC,PHO,2012,100.0
3123,3123,23,@,L 109-118 ,240,37,88,0.42,31,68,0.456,6,20,0.3,29,33,0.879,109,43,91,0.473,36,74,0.486,7,17,0.412,25,32,0.781,118,2012-04-19,MIL,IND,2012,121.5
3124,3124,24,@,W 109-106 (OT),265,40,89,0.449,34,71,0.479,6,18,0.333,23,33,0.697,109,42,97,0.433,39,85,0.459,3,12,0.25,19,25,0.76,106,2012-04-21,PHI,IND,2012,107.5
3125,3125,25,Home,W 109-101 ,240,38,81,0.469,33,68,0.485,5,13,0.385,28,36,0.778,109,37,80,0.463,26,56,0.464,11,24,0.458,16,22,0.727,101,2012-04-23,MEM,CLE,2012,106.5
3126,3126,26,Home,W 109-102 ,240,43,86,0.5,32,62,0.516,11,24,0.458,12,14,0.857,109,40,80,0.5,32,61,0.525,8,19,0.421,14,20,0.7,102,2012-04-24,ATL,LAC,2012,106.0
3127,3127,27,@,W 109-102 ,240,38,90,0.422,30,60,0.5,8,30,0.267,25,29,0.862,109,40,85,0.471,33,63,0.524,7,22,0.318,15,17,0.882,102,2012-11-02,HOU,ATL,2013,105.5
3128,3128,28,Home,W 109-97 ,240,41,92,0.446,31,62,0.5,10,30,0.333,17,22,0.773,109,35,78,0.449,29,66,0.439,6,12,0.5,21,25,0.84,97,2012-11-06,DEN,DET,2013,100.0
3129,3129,29,Home,W 109-104 ,240,39,84,0.464,31,63,0.492,8,21,0.381,23,35,0.657,109,36,81,0.444,31,59,0.525,5,22,0.227,27,31,0.871,104,2012-11-07,DAL,TOR,2013,106.5
3130,3130,30,Home,L 109-112 ,240,42,89,0.472,32,67,0.478,10,22,0.455,15,19,0.789,109,40,70,0.571,33,52,0.635,7,18,0.389,25,31,0.806,112,2012-11-10,POR,SAS,2013,115.5
3131,3131,31,@,L 109-119 ,240,43,82,0.524,38,66,0.576,5,16,0.313,18,22,0.818,109,42,83,0.506,29,63,0.46,13,20,0.65,22,26,0.846,119,2012-11-18,GSW,OKC,2013,125.5
3132,3132,32,Home,L 109-116 (OT),265,45,91,0.495,38,71,0.535,7,20,0.35,12,17,0.706,109,39,88,0.443,33,67,0.493,6,21,0.286,32,37,0.865,116,2012-11-24,PHI,OKC,2013,119.0
3133,3133,33,@,W 109-102 ,240,46,90,0.511,37,71,0.521,9,19,0.474,8,10,0.8,109,37,87,0.425,26,54,0.481,11,33,0.333,17,23,0.739,102,2012-12-07,GSW,BRK,2013,107.5
3134,3134,34,Home,L 109-116 ,240,35,72,0.486,23,37,0.622,12,35,0.343,27,38,0.711,109,43,91,0.473,33,67,0.493,10,24,0.417,20,25,0.8,116,2012-12-08,HOU,DAL,2013,121.0
3135,3135,35,@,W 109-96 ,240,40,78,0.513,30,49,0.612,10,29,0.345,19,24,0.792,109,39,90,0.433,30,59,0.508,9,31,0.29,9,16,0.563,96,2012-12-17,HOU,NYK,2013,100.5
3136,3136,36,Home,W 109-91 ,240,44,87,0.506,38,66,0.576,6,21,0.286,15,20,0.75,109,35,86,0.407,26,62,0.419,9,24,0.375,12,16,0.75,91,2012-12-26,POR,SAC,2013,95.5
3137,3137,37,Home,W 109-99 ,240,43,74,0.581,31,55,0.564,12,19,0.632,11,17,0.647,109,39,77,0.506,30,48,0.625,9,29,0.31,12,16,0.75,99,2012-12-28,DET,MIA,2013,103.5
3138,3138,38,Home,W 109-100 ,240,44,80,0.55,34,60,0.567,10,20,0.5,11,14,0.786,109,38,80,0.475,33,65,0.508,5,15,0.333,19,22,0.864,100,2012-12-29,ATL,IND,2013,102.5
3139,3139,39,@,L 109-119 (OT),265,41,94,0.436,31,66,0.47,10,28,0.357,17,20,0.85,109,42,89,0.472,32,63,0.508,10,26,0.385,25,31,0.806,119,2013-01-02,DAL,MIA,2013,124.0
3140,3140,40,Home,W 109-85 ,240,39,75,0.52,29,58,0.5,10,17,0.588,21,27,0.778,109,34,84,0.405,23,60,0.383,11,24,0.458,6,8,0.75,85,2013-01-04,OKC,PHI,2013,90.5
3141,3141,41,Home,W 109-86 ,240,41,85,0.482,33,60,0.55,8,25,0.32,19,23,0.826,109,35,84,0.417,32,67,0.478,3,17,0.176,13,20,0.65,86,2013-01-05,SAS,PHI,2013,87.5
3142,3142,42,@,W 109-89 ,240,40,83,0.482,30,59,0.508,10,24,0.417,19,22,0.864,109,38,79,0.481,31,62,0.5,7,17,0.412,6,10,0.6,89,2013-01-08,BRK,PHI,2013,92.5
3143,3143,43,Home,L 109-117 ,240,41,82,0.5,28,45,0.622,13,37,0.351,14,25,0.56,109,42,78,0.538,31,59,0.525,11,19,0.579,22,26,0.846,117,2013-01-15,HOU,LAC,2013,122.5
3144,3144,44,Home,W 109-95 ,240,45,78,0.577,37,57,0.649,8,21,0.381,11,17,0.647,109,37,87,0.425,33,61,0.541,4,26,0.154,17,17,1.0,95,2013-01-16,ATL,BRK,2013,97.0
3145,3145,45,Home,W 109-98 ,240,45,90,0.5,39,74,0.527,6,16,0.375,13,17,0.765,109,34,83,0.41,28,62,0.452,6,21,0.286,24,30,0.8,98,2013-01-19,UTA,CLE,2013,101.0
3146,3146,46,@,W 109-97 ,240,41,78,0.526,26,51,0.51,15,27,0.556,12,14,0.857,109,39,84,0.464,35,68,0.515,4,16,0.25,15,21,0.714,97,2013-01-22,OKC,LAC,2013,99.0
3147,3147,47,Home,W 109-102 ,240,41,101,0.406,28,71,0.394,13,30,0.433,14,20,0.7,109,39,93,0.419,26,65,0.4,13,28,0.464,11,11,1.0,102,2013-01-26,MIL,GSW,2013,108.5
3148,3148,48,@,W 109-99 ,240,40,88,0.455,32,67,0.478,8,21,0.381,21,25,0.84,109,38,89,0.427,34,74,0.459,4,15,0.267,19,25,0.76,99,2013-02-01,DAL,PHO,2013,101.0
3149,3149,49,Home,W 109-95 ,240,42,82,0.512,35,62,0.565,7,20,0.35,18,23,0.783,109,33,79,0.418,25,60,0.417,8,19,0.421,21,24,0.875,95,2013-02-02,HOU,CHA,2013,99.0
3150,3150,50,@,L 109-140 ,240,41,86,0.477,38,71,0.535,3,15,0.2,24,30,0.8,109,46,91,0.505,23,51,0.451,23,40,0.575,25,35,0.714,140,2013-02-05,GSW,HOU,2013,151.5
3151,3151,51,@,L 109-119 ,240,37,81,0.457,27,57,0.474,10,24,0.417,25,30,0.833,109,46,89,0.517,36,67,0.537,10,22,0.455,17,20,0.85,119,2013-02-08,SAS,DET,2013,124.0
3152,3152,52,@,L 109-120 ,240,40,82,0.488,36,67,0.537,4,15,0.267,25,26,0.962,109,44,85,0.518,36,66,0.545,8,19,0.421,24,35,0.686,120,2013-02-09,UTA,SAC,2013,124.0
3153,3153,53,Home,W 109-108 ,240,39,83,0.47,29,62,0.468,10,21,0.476,21,23,0.913,109,44,85,0.518,38,69,0.551,6,16,0.375,14,20,0.7,108,2013-02-12,TOR,DEN,2013,111.0
3154,3154,54,Home,W 109-94 ,240,42,87,0.483,35,68,0.515,7,19,0.368,18,22,0.818,109,38,68,0.559,33,53,0.623,5,15,0.333,13,23,0.565,94,2013-02-12,UTA,OKC,2013,96.5
3155,3155,55,Home,W 109-105 ,240,39,75,0.52,27,56,0.482,12,19,0.632,19,24,0.792,109,39,78,0.5,31,58,0.534,8,20,0.4,19,24,0.792,105,2013-02-24,MIA,CLE,2013,109.0
3156,3156,56,Home,W 109-105 ,240,36,87,0.414,25,53,0.472,11,34,0.324,26,33,0.788,109,36,72,0.5,21,45,0.467,15,27,0.556,18,21,0.857,105,2013-02-27,NYK,GSW,2013,112.5
3157,3157,57,Home,L 109-111 ,240,38,85,0.447,28,60,0.467,10,25,0.4,23,27,0.852,109,45,87,0.517,42,73,0.575,3,14,0.214,18,31,0.581,111,2013-02-27,POR,DEN,2013,112.5
3158,3158,58,Home,W 109-94 ,240,44,90,0.489,37,70,0.529,7,20,0.35,14,22,0.636,109,34,87,0.391,33,75,0.44,1,12,0.083,25,36,0.694,94,2013-03-02,POR,MIN,2013,94.5
3159,3159,59,Home,W 109-108 (OT),265,45,95,0.474,35,71,0.493,10,24,0.417,9,13,0.692,109,40,99,0.404,36,86,0.419,4,13,0.308,24,31,0.774,108,2013-03-04,MIL,UTA,2013,110.0
3160,3160,60,@,W 109-101 ,240,42,83,0.506,31,64,0.484,11,19,0.579,14,16,0.875,109,41,100,0.41,36,79,0.456,5,21,0.238,14,18,0.778,101,2013-03-05,BOS,PHI,2013,103.5
3161,3161,61,@,L 109-115 ,240,47,93,0.505,42,72,0.583,5,21,0.238,10,15,0.667,109,40,90,0.444,28,63,0.444,12,27,0.444,23,26,0.885,115,2013-03-17,ORL,MIL,2013,121.0
3162,3162,62,Home,W 109-77 ,240,38,76,0.5,25,46,0.543,13,30,0.433,20,23,0.87,109,30,89,0.337,25,64,0.391,5,25,0.2,12,18,0.667,77,2013-03-24,MIA,CHA,2013,79.5
3163,3163,63,Home,W 109-103 ,240,43,90,0.478,33,67,0.493,10,23,0.435,13,19,0.684,109,36,91,0.396,30,65,0.462,6,26,0.231,25,36,0.694,103,2013-03-25,GSW,LAL,2013,106.0
3164,3164,64,Home,W 109-102 (OT),265,40,82,0.488,34,59,0.576,6,23,0.261,23,27,0.852,109,38,85,0.447,28,52,0.538,10,33,0.303,16,25,0.64,102,2013-03-26,DAL,LAC,2013,107.0
3165,3165,65,Home,W 109-87 ,240,42,74,0.568,38,60,0.633,4,14,0.286,21,31,0.677,109,32,79,0.405,27,59,0.458,5,20,0.25,18,36,0.5,87,2013-03-29,DEN,BRK,2013,89.5
3166,3166,66,@,W 109-99 ,240,40,75,0.533,36,59,0.61,4,16,0.25,25,32,0.781,109,37,98,0.378,25,69,0.362,12,29,0.414,13,15,0.867,99,2013-03-30,OKC,MIL,2013,105.0
3167,3167,67,Home,W 109-92 ,240,41,85,0.482,32,68,0.471,9,17,0.529,18,28,0.643,109,32,81,0.395,25,62,0.403,7,19,0.368,21,26,0.808,92,2013-03-31,WAS,TOR,2013,95.5
3168,3168,68,@,W 109-106 ,240,39,71,0.549,29,48,0.604,10,23,0.435,21,28,0.75,109,39,80,0.488,34,64,0.531,5,16,0.313,23,26,0.885,106,2013-04-01,IND,LAC,2013,108.5
3169,3169,69,Home,W 109-95 ,240,42,84,0.5,34,63,0.54,8,21,0.381,17,21,0.81,109,33,76,0.434,26,52,0.5,7,24,0.292,22,30,0.733,95,2013-04-07,LAC,LAL,2013,98.5
3170,3170,70,Home,W 109-104 ,240,43,85,0.506,37,65,0.569,6,20,0.3,17,25,0.68,109,38,92,0.413,21,59,0.356,17,33,0.515,11,16,0.688,104,2013-04-12,ATL,MIL,2013,112.5
3171,3171,71,Home,L 109-117 ,240,40,80,0.5,32,61,0.525,8,19,0.421,21,26,0.808,109,42,82,0.512,30,57,0.526,12,25,0.48,21,26,0.808,117,2013-04-12,IND,BRK,2013,123.0
3172,3172,72,Home,W 109-101 ,240,39,71,0.549,27,48,0.563,12,23,0.522,19,28,0.679,109,41,85,0.482,35,62,0.565,6,23,0.261,13,13,1.0,101,2013-04-12,MIA,BOS,2013,104.0
3173,3173,73,@,L 109-118 ,240,38,82,0.463,26,50,0.52,12,32,0.375,21,26,0.808,109,43,81,0.531,35,59,0.593,8,22,0.364,24,27,0.889,118,2013-04-14,POR,DEN,2013,122.0
3174,3174,74,Home,W 109-101 ,240,41,83,0.494,32,58,0.552,9,25,0.36,18,22,0.818,109,39,87,0.448,33,65,0.508,6,22,0.273,17,21,0.81,101,2013-04-15,DET,PHI,2013,104.0
3175,3175,75,@,L 109-118 ,240,37,76,0.487,29,52,0.558,8,24,0.333,27,35,0.771,109,44,77,0.571,33,53,0.623,11,24,0.458,19,24,0.792,118,2013-10-30,ATL,DAL,2014,123.5
3176,3176,76,@,W 109-102 ,240,48,94,0.511,42,71,0.592,6,23,0.261,7,14,0.5,109,41,94,0.436,32,68,0.471,9,26,0.346,11,17,0.647,102,2013-11-01,PHI,WAS,2014,106.5
3177,3177,77,@,W 109-100 ,240,35,79,0.443,25,52,0.481,10,27,0.37,29,38,0.763,109,40,89,0.449,31,57,0.544,9,32,0.281,11,13,0.846,100,2013-11-03,MIN,NYK,2014,104.5
3178,3178,78,Home,W 109-104 ,240,36,72,0.5,23,49,0.469,13,23,0.565,24,26,0.923,109,38,85,0.447,26,57,0.456,12,28,0.429,16,22,0.727,104,2013-11-06,MIL,CLE,2014,110.0
3179,3179,79,Home,W 109-107 ,240,42,86,0.488,28,61,0.459,14,25,0.56,11,17,0.647,109,43,94,0.457,35,68,0.515,8,26,0.308,13,19,0.684,107,2013-11-07,DEN,ATL,2014,111.0
3180,3180,80,Home,W 109-107 ,240,44,80,0.55,40,64,0.625,4,16,0.25,17,28,0.607,109,40,96,0.417,29,67,0.433,11,29,0.379,16,18,0.889,107,2013-11-11,LAC,MIN,2014,112.5
3181,3181,81,@,W 109-85 ,240,44,89,0.494,31,61,0.508,13,28,0.464,8,11,0.727,109,34,82,0.415,29,63,0.46,5,19,0.263,12,16,0.75,85,2013-11-11,SAS,PHI,2014,87.5
3182,3182,82,Home,W 109-103 ,240,42,82,0.512,31,59,0.525,11,23,0.478,14,15,0.933,109,42,91,0.462,39,77,0.506,3,14,0.214,16,21,0.762,103,2013-11-11,POR,DET,2014,104.5
3183,3183,83,@,W 109-106 ,240,31,68,0.456,22,40,0.55,9,28,0.321,38,44,0.864,109,38,87,0.437,30,67,0.448,8,20,0.4,22,27,0.815,106,2013-11-14,HOU,NYK,2014,110.0
3184,3184,84,@,W 109-96 ,240,40,82,0.488,31,56,0.554,9,26,0.346,20,22,0.909,109,37,81,0.457,30,63,0.476,7,18,0.389,15,19,0.789,96,2013-11-15,POR,BOS,2014,99.5
3185,3185,85,Home,W 109-85 ,240,41,72,0.569,32,51,0.627,9,21,0.429,18,24,0.75,109,32,99,0.323,25,79,0.316,7,20,0.35,14,20,0.7,85,2013-11-19,HOU,BOS,2014,88.5
3186,3186,86,@,W 109-97 ,240,38,80,0.475,33,63,0.524,5,17,0.294,28,40,0.7,109,35,77,0.455,21,51,0.412,14,26,0.538,13,18,0.722,97,2013-11-24,DET,BRK,2014,104.0
3187,3187,87,@,W 109-92 ,240,42,83,0.506,34,61,0.557,8,22,0.364,17,20,0.85,109,30,73,0.411,21,51,0.412,9,22,0.409,23,27,0.852,92,2013-11-26,ORL,ATL,2014,96.5
3188,3188,88,@,W 109-91 ,240,42,76,0.553,34,59,0.576,8,17,0.471,17,17,1.0,109,34,78,0.436,25,59,0.424,9,19,0.474,14,15,0.933,91,2013-11-29,SAS,ORL,2014,95.5
3189,3189,89,Home,W 109-103 ,240,43,79,0.544,33,62,0.532,10,17,0.588,13,16,0.813,109,40,83,0.482,31,55,0.564,9,28,0.321,14,20,0.7,103,2013-12-02,UTA,HOU,2014,107.5
3190,3190,90,@,W 109-95 ,240,39,77,0.506,32,56,0.571,7,21,0.333,24,30,0.8,109,33,88,0.375,30,72,0.417,3,16,0.188,26,34,0.765,95,2013-12-06,OKC,NOP,2014,96.5
3191,3191,91,@,W 109-105 (OT),265,42,92,0.457,36,72,0.5,6,20,0.3,19,26,0.731,109,33,83,0.398,25,56,0.446,8,27,0.296,31,41,0.756,105,2013-12-06,MIL,WAS,2014,109.0
3192,3192,92,Home,W 109-94 ,240,42,74,0.568,33,55,0.6,9,19,0.474,16,22,0.727,109,40,87,0.46,30,56,0.536,10,31,0.323,4,5,0.8,94,2013-12-10,CLE,NYK,2014,99.0
3193,3193,93,@,W 109-77 ,240,46,88,0.523,42,71,0.592,4,17,0.235,13,17,0.765,109,29,84,0.345,27,69,0.391,2,15,0.133,17,23,0.739,77,2013-12-11,SAS,MIL,2014,78.0
3194,3194,94,@,W 109-100 ,240,42,87,0.483,34,66,0.515,8,21,0.381,17,20,0.85,109,37,85,0.435,26,55,0.473,11,30,0.367,15,16,0.938,100,2013-12-13,CLE,ORL,2014,105.5
3195,3195,95,Home,L 109-111 (OT),265,44,94,0.468,41,79,0.519,3,15,0.2,18,27,0.667,109,41,99,0.414,34,73,0.466,7,26,0.269,22,26,0.846,111,2013-12-15,DET,POR,2014,114.5
3196,3196,96,Home,W 109-94 ,240,44,82,0.537,36,60,0.6,8,22,0.364,13,16,0.813,109,38,79,0.481,33,67,0.493,5,12,0.417,13,23,0.565,94,2013-12-18,HOU,CHI,2014,96.5
3197,3197,97,@,L 109-120 ,240,40,94,0.426,26,54,0.481,14,40,0.35,15,19,0.789,109,46,93,0.495,39,74,0.527,7,19,0.368,21,26,0.808,120,2013-12-18,POR,MIN,2014,123.5
3198,3198,98,@,W 109-108 (OT),265,42,91,0.462,31,70,0.443,11,21,0.524,14,18,0.778,109,46,91,0.505,36,70,0.514,10,21,0.476,6,10,0.6,108,2013-12-20,TOR,DAL,2014,113.0
3199,3199,99,Home,W 109-92 ,240,45,85,0.529,41,71,0.577,4,14,0.286,15,23,0.652,109,39,95,0.411,34,77,0.442,5,18,0.278,9,18,0.5,92,2013-12-27,ORL,DET,2014,94.5
3200,3200,0,Home,W 109-102 ,240,41,74,0.554,33,53,0.623,8,21,0.381,19,24,0.792,109,36,81,0.444,21,42,0.5,15,39,0.385,15,21,0.714,102,2013-12-29,ORL,ATL,2014,109.5
3201,3201,1,Home,W 109-105 ,240,43,80,0.538,36,64,0.563,7,16,0.438,16,18,0.889,109,44,89,0.494,40,81,0.494,4,8,0.5,13,19,0.684,105,2014-01-15,SAS,UTA,2014,107.0
3202,3202,2,Home,L 109-117 ,240,40,92,0.435,26,55,0.473,14,37,0.378,15,19,0.789,109,42,88,0.477,37,72,0.514,5,16,0.313,28,35,0.8,117,2014-01-17,DEN,CLE,2014,119.5
3203,3203,3,@,W 109-95 ,240,33,78,0.423,25,48,0.521,8,30,0.267,35,42,0.833,109,29,83,0.349,22,60,0.367,7,23,0.304,30,36,0.833,95,2014-01-17,LAC,NYK,2014,98.5
3204,3204,4,@,W 109-100 ,240,41,86,0.477,33,70,0.471,8,16,0.5,19,20,0.95,109,38,84,0.452,30,64,0.469,8,20,0.4,16,20,0.8,100,2014-01-17,POR,SAS,2014,104.0
3205,3205,5,Home,L 109-112 ,240,41,83,0.494,35,71,0.493,6,12,0.5,21,24,0.875,109,41,83,0.494,32,58,0.552,9,25,0.36,21,24,0.875,112,2014-01-22,ORL,ATL,2014,116.5
3206,3206,6,Home,W 109-102 ,240,45,78,0.577,37,58,0.638,8,20,0.4,11,23,0.478,109,40,88,0.455,31,63,0.492,9,25,0.36,13,21,0.619,102,2014-01-23,MIA,LAL,2014,106.5
3207,3207,7,Home,W 109-96 ,240,40,83,0.482,32,63,0.508,8,20,0.4,21,37,0.568,109,37,88,0.42,32,76,0.421,5,12,0.417,17,27,0.63,96,2014-01-25,DEN,IND,2014,98.5
3208,3208,8,@,L 109-111 ,240,43,88,0.489,31,63,0.492,12,25,0.48,11,12,0.917,109,43,82,0.524,30,57,0.526,13,25,0.52,12,18,0.667,111,2014-01-27,ATL,OKC,2014,117.5
3209,3209,9,Home,W 109-99 ,240,37,83,0.446,29,66,0.439,8,17,0.471,27,38,0.711,109,33,79,0.418,23,58,0.397,10,21,0.476,23,26,0.885,99,2014-02-04,MIN,LAL,2014,104.0
3210,3210,10,Home,W 109-101 ,240,32,81,0.395,28,69,0.406,4,12,0.333,41,51,0.804,109,36,84,0.429,26,59,0.441,10,25,0.4,19,24,0.792,101,2014-02-05,SAC,TOR,2014,106.0
3211,3211,11,@,L 109-126 ,240,41,88,0.466,26,55,0.473,15,33,0.455,12,22,0.545,109,50,98,0.51,42,78,0.538,8,20,0.4,18,23,0.783,126,2014-02-08,DEN,DET,2014,130.0
3212,3212,12,@,L 109-122 ,240,41,84,0.488,33,59,0.559,8,25,0.32,19,26,0.731,109,43,80,0.538,32,59,0.542,11,21,0.524,25,30,0.833,122,2014-02-08,GSW,PHO,2014,127.5
3213,3213,13,Home,W 109-100 ,240,43,90,0.478,38,74,0.514,5,16,0.313,18,26,0.692,109,43,82,0.524,38,65,0.585,5,17,0.294,9,11,0.818,100,2014-02-10,DET,SAS,2014,102.5
3214,3214,14,Home,W 109-99 ,240,41,86,0.477,29,65,0.446,12,21,0.571,15,23,0.652,109,34,74,0.459,26,48,0.542,8,26,0.308,23,33,0.697,99,2014-02-11,CLE,SAC,2014,103.0
3215,3215,15,Home,L 109-111 ,240,42,93,0.452,35,71,0.493,7,22,0.318,18,25,0.72,109,43,88,0.489,34,64,0.531,9,24,0.375,16,21,0.762,111,2014-02-19,POR,SAS,2014,115.5
3216,3216,16,@,W 109-95 ,240,37,78,0.474,32,65,0.492,5,13,0.385,30,36,0.833,109,33,88,0.375,18,56,0.321,15,32,0.469,14,21,0.667,95,2014-02-23,SAC,DEN,2014,102.5
3217,3217,17,Home,W 109-86 ,240,42,74,0.568,33,56,0.589,9,18,0.5,16,24,0.667,109,31,80,0.388,25,61,0.41,6,19,0.316,18,29,0.621,86,2014-02-26,UTA,PHO,2014,89.0
3218,3218,18,Home,W 109-90 ,240,39,84,0.464,31,62,0.5,8,22,0.364,23,33,0.697,109,35,79,0.443,30,61,0.492,5,18,0.278,15,18,0.833,90,2014-03-02,CHI,NYK,2014,92.5
3219,3219,19,Home,W 109-87 ,240,43,84,0.512,34,66,0.515,9,18,0.5,14,20,0.7,109,31,76,0.408,21,53,0.396,10,23,0.435,15,20,0.75,87,2014-03-05,CHA,IND,2014,92.0
3220,3220,20,Home,W 109-108 ,240,42,79,0.532,35,57,0.614,7,22,0.318,18,24,0.75,109,38,76,0.5,26,48,0.542,12,28,0.429,20,26,0.769,108,2014-03-08,LAC,ATL,2014,114.0
3221,3221,21,Home,W 109-99 ,240,47,84,0.56,41,72,0.569,6,12,0.5,9,13,0.692,109,35,86,0.407,28,69,0.406,7,17,0.412,22,29,0.759,99,2014-03-11,MEM,POR,2014,102.5
3222,3222,22,@,W 109-86 ,240,40,75,0.533,27,51,0.529,13,24,0.542,16,20,0.8,109,29,79,0.367,20,50,0.4,9,29,0.31,19,27,0.704,86,2014-03-16,DAL,OKC,2014,90.5
3223,3223,23,@,L 109-118 ,240,43,95,0.453,33,69,0.478,10,26,0.385,13,19,0.684,109,44,86,0.512,33,59,0.559,11,27,0.407,19,27,0.704,118,2014-03-19,DET,DEN,2014,123.5
3224,3224,24,Home,L 109-125 ,240,39,91,0.429,30,65,0.462,9,26,0.346,22,29,0.759,109,50,95,0.526,38,68,0.559,12,27,0.444,13,16,0.813,125,2014-03-19,LAL,SAS,2014,131.0
3225,3225,25,Home,W 109-93 ,240,45,89,0.506,34,64,0.531,11,25,0.44,8,12,0.667,109,32,80,0.4,26,67,0.388,6,13,0.462,23,30,0.767,93,2014-03-19,PHO,ORL,2014,96.0
3226,3226,26,Home,W 109-92 ,240,48,91,0.527,42,79,0.532,6,12,0.5,7,13,0.538,109,34,90,0.378,27,66,0.409,7,24,0.292,17,20,0.85,92,2014-03-24,MEM,MIN,2014,95.5
3227,3227,27,Home,W 109-104 (OT),265,40,85,0.471,31,65,0.477,9,20,0.45,20,27,0.741,109,33,90,0.367,23,50,0.46,10,40,0.25,28,32,0.875,104,2014-03-24,NOP,BRK,2014,109.0
3228,3228,28,@,W 109-103 ,240,38,82,0.463,27,56,0.482,11,26,0.423,22,25,0.88,109,37,79,0.468,27,59,0.458,10,20,0.5,19,27,0.704,103,2014-03-27,LAC,DAL,2014,108.0
3229,3229,29,@,W 109-93 ,240,39,97,0.402,33,76,0.434,6,21,0.286,25,31,0.806,109,35,81,0.432,29,60,0.483,6,21,0.286,17,27,0.63,93,2014-04-04,PHO,POR,2014,96.0
3230,3230,30,@,W 109-100 ,240,38,88,0.432,22,54,0.407,16,34,0.471,17,22,0.773,109,39,83,0.47,34,71,0.479,5,12,0.417,17,21,0.81,100,2014-04-10,SAS,DAL,2014,102.5
3231,3231,31,@,W 109-98 ,240,32,67,0.478,21,46,0.457,11,21,0.524,34,40,0.85,109,33,75,0.44,23,50,0.46,10,25,0.4,22,31,0.71,98,2014-04-15,NYK,BRK,2014,103.0
3232,3232,32,Home,W 109-102 ,240,37,90,0.411,29,64,0.453,8,26,0.308,27,33,0.818,109,40,80,0.5,27,58,0.466,13,22,0.591,9,17,0.529,102,2014-10-29,TOR,ATL,2015,108.5
3233,3233,33,@,W 109-104 ,240,46,89,0.517,40,64,0.625,6,25,0.24,11,19,0.579,109,38,89,0.427,31,70,0.443,7,19,0.368,21,28,0.75,104,2014-11-01,DAL,NOP,2015,107.5
3234,3234,34,@,L 109-131 ,240,37,82,0.451,28,54,0.519,9,28,0.321,26,31,0.839,109,42,76,0.553,34,56,0.607,8,20,0.4,39,50,0.78,131,2014-11-05,DEN,SAC,2015,135.0
3235,3235,35,@,W 109-94 ,240,40,82,0.488,30,58,0.517,10,24,0.417,19,22,0.864,109,37,83,0.446,28,50,0.56,9,33,0.273,11,13,0.846,94,2014-11-12,OKC,BOS,2015,98.5
3236,3236,36,Home,W 109-102 ,240,45,82,0.549,37,63,0.587,8,19,0.421,11,18,0.611,109,35,84,0.417,28,63,0.444,7,21,0.333,25,32,0.781,102,2014-11-12,NOP,LAL,2015,105.5
3237,3237,37,Home,W 109-93 ,240,41,76,0.539,35,62,0.565,6,14,0.429,21,27,0.778,109,32,82,0.39,19,48,0.396,13,34,0.382,16,26,0.615,93,2014-11-16,NYK,DEN,2015,99.5
3238,3238,38,Home,L 109-114 ,240,41,85,0.482,32,58,0.552,9,27,0.333,18,23,0.783,109,47,87,0.54,41,70,0.586,6,17,0.353,14,22,0.636,114,2014-11-18,ATL,LAL,2015,117.0
3239,3239,39,@,L 109-114 ,240,35,82,0.427,28,61,0.459,7,21,0.333,32,37,0.865,109,43,85,0.506,35,69,0.507,8,16,0.5,20,27,0.741,114,2014-11-25,CHI,DEN,2015,118.0
3240,3240,40,Home,W 109-102 (OT),265,38,95,0.4,34,64,0.531,4,31,0.129,29,38,0.763,109,39,92,0.424,25,64,0.391,14,28,0.5,10,16,0.625,102,2014-11-26,DAL,NYK,2015,109.0
3241,3241,41,@,W 109-102 ,240,37,90,0.411,32,73,0.438,5,17,0.294,30,37,0.811,109,37,92,0.402,31,70,0.443,6,22,0.273,22,29,0.759,102,2014-11-28,CHI,BOS,2015,105.0
3242,3242,42,Home,W 109-97 ,240,41,78,0.526,34,62,0.548,7,16,0.438,20,32,0.625,109,35,89,0.393,28,67,0.418,7,22,0.318,20,26,0.769,97,2014-11-29,CLE,IND,2015,100.5
3243,3243,43,@,W 109-103 ,240,36,83,0.434,27,57,0.474,9,26,0.346,28,35,0.8,109,38,89,0.427,26,60,0.433,12,29,0.414,15,25,0.6,103,2014-12-01,SAS,PHI,2015,109.0
3244,3244,44,Home,W 109-105 ,240,43,82,0.524,32,58,0.552,11,24,0.458,12,14,0.857,109,41,84,0.488,29,61,0.475,12,23,0.522,11,13,0.846,105,2014-12-02,ATL,BOS,2015,111.0
3245,3245,45,Home,L 109-117 ,240,39,75,0.52,36,65,0.554,3,10,0.3,28,37,0.757,109,44,88,0.5,34,65,0.523,10,23,0.435,19,21,0.905,117,2014-12-02,SAC,TOR,2015,122.0
3246,3246,46,Home,W 109-102 (OT),265,37,93,0.398,24,63,0.381,13,30,0.433,22,27,0.815,109,37,102,0.363,29,75,0.387,8,27,0.296,20,29,0.69,102,2014-12-03,BOS,DET,2015,106.0
3247,3247,47,Home,W 109-85 ,240,39,69,0.565,30,53,0.566,9,16,0.563,22,26,0.846,109,30,68,0.441,23,50,0.46,7,18,0.389,18,27,0.667,85,2014-12-05,MIL,MIA,2015,88.5
3248,3248,48,Home,W 109-95 ,240,37,73,0.507,27,54,0.5,10,19,0.526,25,30,0.833,109,37,76,0.487,31,61,0.508,6,15,0.4,15,17,0.882,95,2014-12-10,SAS,NYK,2015,98.0
3249,3249,49,Home,L 109-113 (OT),265,39,84,0.464,31,66,0.47,8,18,0.444,23,34,0.676,109,38,95,0.4,23,51,0.451,15,44,0.341,22,31,0.71,113,2014-12-11,SAC,HOU,2015,120.5
3250,3250,50,Home,W 109-95 ,240,43,86,0.5,33,69,0.478,10,17,0.588,13,18,0.722,109,36,81,0.444,33,73,0.452,3,8,0.375,20,35,0.571,95,2014-12-16,WAS,MIN,2015,96.5
3251,3251,51,Home,W 109-92 ,240,44,80,0.55,37,61,0.607,7,19,0.368,14,18,0.778,109,37,85,0.435,32,66,0.485,5,19,0.263,13,15,0.867,92,2014-12-17,BOS,ORL,2015,94.5
3252,3252,52,@,L 109-114 ,240,41,86,0.477,30,61,0.492,11,25,0.44,16,24,0.667,109,48,94,0.511,36,63,0.571,12,31,0.387,6,10,0.6,114,2014-12-18,OKC,GSW,2015,120.0
3253,3253,53,Home,W 109-106 ,240,38,80,0.475,27,51,0.529,11,29,0.379,22,30,0.733,109,39,85,0.459,36,67,0.537,3,18,0.167,25,33,0.758,106,2014-12-19,DEN,LAC,2015,107.5
3254,3254,54,@,W 109-91 ,240,43,98,0.439,33,74,0.446,10,24,0.417,13,17,0.765,109,32,71,0.451,20,45,0.444,12,26,0.462,15,17,0.882,91,2014-12-19,CHA,PHI,2015,97.0
3255,3255,55,@,W 109-107 ,240,41,83,0.494,34,62,0.548,7,21,0.333,20,28,0.714,109,45,87,0.517,36,63,0.571,9,24,0.375,8,11,0.727,107,2014-12-26,BRK,BOS,2015,111.5
3256,3256,56,@,L 109-119 ,240,42,83,0.506,33,63,0.524,9,20,0.45,16,22,0.727,109,47,86,0.547,37,60,0.617,10,26,0.385,15,29,0.517,119,2014-12-26,IND,DET,2015,124.0
3257,3257,57,Home,W 109-101 ,240,40,79,0.506,30,50,0.6,10,29,0.345,19,26,0.731,109,37,84,0.44,24,53,0.453,13,31,0.419,14,21,0.667,101,2014-12-30,ATL,CLE,2015,107.5
3258,3258,58,@,W 109-86 ,240,40,86,0.465,26,53,0.491,14,33,0.424,15,29,0.517,109,38,85,0.447,34,65,0.523,4,20,0.2,6,10,0.6,86,2014-12-30,DET,ORL,2015,88.0
3259,3259,59,@,W 109-106 ,240,41,84,0.488,35,70,0.5,6,14,0.429,21,31,0.677,109,43,81,0.531,37,62,0.597,6,19,0.316,14,19,0.737,106,2015-01-02,MEM,LAL,2015,109.0
3260,3260,60,Home,W 109-102 ,240,44,83,0.53,36,64,0.563,8,19,0.421,13,19,0.684,109,39,84,0.464,28,63,0.444,11,21,0.524,13,15,0.867,102,2015-01-02,OKC,WAS,2015,107.5
3261,3261,61,Home,W 109-104 (OT),265,37,100,0.37,31,72,0.431,6,28,0.214,29,40,0.725,109,45,100,0.45,40,83,0.482,5,17,0.294,9,11,0.818,104,2015-01-03,CHI,BOS,2015,106.5
3262,3262,62,@,W 109-90 ,240,44,78,0.564,32,52,0.615,12,26,0.462,9,11,0.818,109,35,86,0.407,27,61,0.443,8,25,0.32,12,17,0.706,90,2015-01-04,DAL,CLE,2015,94.0
3263,3263,63,@,L 109-125 ,240,38,83,0.458,29,57,0.509,9,26,0.346,24,29,0.828,109,48,89,0.539,40,66,0.606,8,23,0.348,21,28,0.75,125,2015-01-04,TOR,PHO,2015,129.0
3264,3264,64,Home,W 109-96 ,240,41,91,0.451,28,61,0.459,13,30,0.433,14,19,0.737,109,39,83,0.47,33,65,0.508,6,18,0.333,12,20,0.6,96,2015-01-10,TOR,BOS,2015,99.0
3265,3265,65,@,W 109-102 ,240,37,78,0.474,28,48,0.583,9,30,0.3,26,36,0.722,109,39,76,0.513,31,52,0.596,8,24,0.333,16,23,0.696,102,2015-01-15,CLE,LAL,2015,106.0
3266,3266,66,@,W 109-99 ,240,38,84,0.452,27,57,0.474,11,27,0.407,22,27,0.815,109,37,79,0.468,32,65,0.492,5,14,0.357,20,29,0.69,99,2015-01-20,SAS,DEN,2015,101.5
3267,3267,67,Home,W 109-106 ,240,40,79,0.506,32,62,0.516,8,17,0.471,21,25,0.84,109,39,81,0.481,30,57,0.526,9,24,0.375,19,25,0.76,106,2015-01-25,NOP,DAL,2015,110.5
3268,3268,68,@,W 109-90 ,240,42,79,0.532,32,58,0.552,10,21,0.476,15,20,0.75,109,38,78,0.487,31,52,0.596,7,26,0.269,7,10,0.7,90,2015-01-27,MEM,DAL,2015,93.5
3269,3269,69,@,W 109-102 ,240,39,71,0.549,30,55,0.545,9,16,0.563,22,30,0.733,109,38,75,0.507,31,55,0.564,7,20,0.35,19,26,0.731,102,2015-01-27,MIL,MIA,2015,105.5
3270,3270,70,@,L 109-114 ,240,43,87,0.494,31,63,0.492,12,24,0.5,11,15,0.733,109,46,77,0.597,34,56,0.607,12,21,0.571,10,18,0.556,114,2015-02-04,DET,IND,2015,120.0
3271,3271,71,@,W 109-93 ,240,40,81,0.494,31,62,0.5,9,19,0.474,20,23,0.87,109,35,79,0.443,25,46,0.543,10,33,0.303,13,18,0.722,93,2015-02-04,BRK,TOR,2015,98.0
3272,3272,72,@,W 109-98 ,240,40,76,0.526,31,47,0.66,9,29,0.31,20,23,0.87,109,31,82,0.378,18,47,0.383,13,35,0.371,23,34,0.676,98,2015-02-08,POR,HOU,2015,104.5
3273,3273,73,Home,W 109-95 ,240,36,74,0.486,24,52,0.462,12,22,0.545,25,29,0.862,109,36,84,0.429,29,64,0.453,7,20,0.35,16,19,0.842,95,2015-02-09,MIA,NYK,2015,98.5
3274,3274,74,@,L 109-111 ,240,40,89,0.449,33,72,0.458,7,17,0.412,22,31,0.71,109,40,86,0.465,36,71,0.507,4,15,0.267,27,38,0.711,111,2015-02-20,PHO,MIN,2015,113.0
3275,3275,75,Home,W 109-101 ,240,40,83,0.482,32,61,0.525,8,22,0.364,21,26,0.808,109,40,100,0.4,34,78,0.436,6,22,0.273,15,26,0.577,101,2015-02-20,SAC,BOS,2015,104.0
3276,3276,76,@,L 109-114 (OT),265,40,88,0.455,30,63,0.476,10,25,0.4,19,24,0.792,109,41,80,0.513,34,56,0.607,7,24,0.292,25,33,0.758,114,2015-03-07,SAC,MIA,2015,117.5
3277,3277,77,Home,W 109-103 (OT),265,39,79,0.494,30,57,0.526,9,22,0.409,22,28,0.786,109,35,91,0.385,31,77,0.403,4,14,0.286,29,36,0.806,103,2015-03-12,IND,MIL,2015,105.0
3278,3278,78,Home,W 109-91 ,240,44,92,0.478,33,59,0.559,11,33,0.333,10,17,0.588,109,34,79,0.43,27,47,0.574,7,32,0.219,16,24,0.667,91,2015-03-12,UTA,HOU,2015,94.5
3279,3279,79,Home,W 109-100 ,240,40,87,0.46,32,66,0.485,8,21,0.381,21,30,0.7,109,37,83,0.446,28,54,0.519,9,29,0.31,17,24,0.708,100,2015-03-15,OKC,CHI,2015,104.5
3280,3280,80,@,W 109-98 ,240,45,89,0.506,39,71,0.549,6,18,0.333,13,16,0.813,109,41,74,0.554,37,63,0.587,4,11,0.364,12,16,0.75,98,2015-03-22,CHA,MIN,2015,100.0
3281,3281,81,Home,W 109-86 ,240,40,79,0.506,32,62,0.516,8,17,0.471,21,23,0.913,109,35,87,0.402,32,70,0.457,3,17,0.176,13,18,0.722,86,2015-03-22,SAC,WAS,2015,87.5
3282,3282,82,Home,W 109-102 ,240,39,82,0.476,32,64,0.5,7,18,0.389,24,29,0.828,109,40,83,0.482,32,58,0.552,8,25,0.32,14,22,0.636,102,2015-03-29,MIA,DET,2015,106.0
3283,3283,83,@,W 109-97 ,240,40,86,0.465,30,60,0.5,10,26,0.385,19,26,0.731,109,37,82,0.451,32,60,0.533,5,22,0.227,18,24,0.75,97,2015-03-29,OKC,PHO,2015,99.5
3284,3284,84,Home,W 109-86 ,240,44,86,0.512,32,59,0.542,12,27,0.444,9,10,0.9,109,38,87,0.437,35,71,0.493,3,16,0.188,7,10,0.7,86,2015-03-30,POR,PHO,2015,87.5
3285,3285,85,@,L 109-114 ,240,42,82,0.512,34,56,0.607,8,26,0.308,17,23,0.739,109,46,88,0.523,41,72,0.569,5,16,0.313,17,23,0.739,114,2015-04-03,TOR,BRK,2015,116.5
3286,3286,86,Home,W 109-97 ,240,43,85,0.506,26,53,0.491,17,32,0.531,6,12,0.5,109,38,83,0.458,29,58,0.5,9,25,0.36,12,20,0.6,97,2015-04-13,CLE,DET,2015,101.5
3287,3287,87,Home,W 109-92 ,240,41,82,0.5,30,54,0.556,11,28,0.393,16,26,0.615,109,34,82,0.415,25,62,0.403,9,20,0.45,15,23,0.652,92,2015-04-13,UTA,DAL,2015,96.5
3288,3288,88,@,L 109-114 ,240,43,101,0.426,37,83,0.446,6,18,0.333,17,25,0.68,109,39,76,0.513,35,59,0.593,4,17,0.235,32,46,0.696,114,2015-10-31,SAC,LAC,2016,116.0
3289,3289,89,Home,W 109-89 ,240,42,86,0.488,33,64,0.516,9,22,0.409,16,21,0.762,109,32,79,0.405,22,43,0.512,10,36,0.278,15,18,0.833,89,2015-11-01,MIA,HOU,2016,94.0
3290,3290,90,Home,L 109-120 ,240,36,86,0.419,30,60,0.5,6,26,0.231,31,38,0.816,109,43,85,0.506,36,65,0.554,7,20,0.35,27,31,0.871,120,2015-11-03,LAL,DEN,2016,123.5
3291,3291,91,@,W 109-105 ,240,38,86,0.442,31,56,0.554,7,30,0.233,26,29,0.897,109,42,88,0.477,38,66,0.576,4,22,0.182,17,25,0.68,105,2015-11-07,HOU,LAC,2016,107.0
3292,3292,92,Home,W 109-95 ,240,43,91,0.473,31,70,0.443,12,21,0.571,11,13,0.846,109,40,85,0.471,34,66,0.515,6,19,0.316,9,15,0.6,95,2015-11-09,GSW,DET,2016,98.0
3293,3293,93,Home,L 109-111 ,240,37,84,0.44,33,67,0.493,4,17,0.235,31,39,0.795,109,42,95,0.442,31,72,0.431,11,23,0.478,16,18,0.889,111,2015-11-10,TOR,NYK,2016,116.5
3294,3294,94,@,L 109-111 ,240,42,89,0.472,34,68,0.5,8,21,0.381,17,21,0.81,109,40,94,0.426,29,67,0.433,11,27,0.407,20,26,0.769,111,2015-11-13,BRK,SAC,2016,116.5
3295,3295,95,Home,W 109-98 ,240,42,86,0.488,33,68,0.485,9,18,0.5,16,20,0.8,109,38,98,0.388,33,83,0.398,5,15,0.333,17,18,0.944,98,2015-11-18,SAS,DEN,2016,100.5
3296,3296,96,@,L 109-116 ,240,43,84,0.512,31,61,0.508,12,23,0.522,11,20,0.55,109,42,89,0.472,35,65,0.538,7,24,0.292,25,33,0.758,116,2015-11-19,SAC,MIA,2016,119.5
3297,3297,97,Home,W 109-97 ,240,41,85,0.482,30,56,0.536,11,29,0.379,16,19,0.842,109,32,86,0.372,21,58,0.362,11,28,0.393,22,25,0.88,97,2015-11-21,CLE,ATL,2016,102.5
3298,3298,98,Home,W 109-88 ,240,43,83,0.518,34,70,0.486,9,13,0.692,14,17,0.824,109,31,91,0.341,25,63,0.397,6,28,0.214,20,24,0.833,88,2015-11-23,MIL,DET,2016,91.0
3299,3299,99,Home,W 109-106 ,240,40,82,0.488,30,56,0.536,10,26,0.385,19,25,0.76,109,43,84,0.512,33,61,0.541,10,23,0.435,10,16,0.625,106,2015-12-04,WAS,PHO,2016,111.0
3300,3300,0,@,W 109-103 ,240,39,77,0.506,29,57,0.509,10,20,0.5,21,30,0.7,109,38,83,0.458,33,68,0.485,5,15,0.333,22,26,0.846,103,2015-12-05,POR,MIN,2016,105.5
3301,3301,1,Home,L 109-112 ,240,40,91,0.44,32,71,0.451,8,20,0.4,21,26,0.808,109,35,73,0.479,19,43,0.442,16,30,0.533,26,36,0.722,112,2015-12-05,TOR,GSW,2016,120.0
3302,3302,2,@,W 109-95 ,240,38,81,0.469,26,53,0.491,12,28,0.429,21,36,0.583,109,42,90,0.467,40,80,0.5,2,10,0.2,9,12,0.75,95,2015-12-09,LAC,MIL,2016,96.0
3303,3303,3,@,W 109-103 ,240,40,83,0.482,28,50,0.56,12,33,0.364,17,25,0.68,109,39,89,0.438,34,64,0.531,5,25,0.2,20,24,0.833,103,2015-12-09,HOU,WAS,2016,105.5
3304,3304,4,Home,W 109-87 ,240,44,82,0.537,38,68,0.559,6,14,0.429,15,25,0.6,109,36,88,0.409,27,63,0.429,9,25,0.36,6,10,0.6,87,2015-12-11,SAS,LAL,2016,91.5
3305,3305,5,Home,W 109-99 (OT),265,37,85,0.435,27,56,0.482,10,29,0.345,25,31,0.806,109,35,97,0.361,26,58,0.448,9,39,0.231,20,28,0.714,99,2015-12-17,CHA,TOR,2016,103.5
3306,3306,6,@,W 109-101 ,240,41,88,0.466,37,68,0.544,4,20,0.2,23,29,0.793,109,34,77,0.442,24,54,0.444,10,23,0.435,23,31,0.742,101,2015-12-18,ATL,BOS,2016,106.0
3307,3307,7,Home,W 109-101 ,240,40,79,0.506,31,59,0.525,9,20,0.45,20,23,0.87,109,39,93,0.419,29,60,0.483,10,33,0.303,13,16,0.813,101,2015-12-19,WAS,CHO,2016,106.0
3308,3308,8,@,L 109-116 ,240,39,80,0.488,26,46,0.565,13,34,0.382,18,22,0.818,109,43,75,0.573,31,52,0.596,12,23,0.522,18,26,0.692,116,2015-12-20,POR,MIA,2016,122.0
3309,3309,9,@,W 109-104 ,240,38,79,0.481,25,53,0.472,13,26,0.5,20,24,0.833,109,36,74,0.486,26,47,0.553,10,27,0.37,22,27,0.815,104,2015-12-26,LAC,UTA,2016,109.0
3310,3310,10,Home,W 109-96 ,240,43,86,0.5,28,53,0.528,15,33,0.455,8,11,0.727,109,35,78,0.449,19,42,0.452,16,36,0.444,10,14,0.714,96,2015-12-31,UTA,POR,2016,104.0
3311,3311,11,@,W 109-90 ,240,35,79,0.443,26,56,0.464,9,23,0.391,30,37,0.811,109,29,84,0.345,23,62,0.371,6,22,0.273,26,34,0.765,90,2016-01-02,OKC,CHO,2016,93.0
3312,3312,12,Home,W 109-99 ,240,48,87,0.552,44,67,0.657,4,20,0.2,9,14,0.643,109,39,73,0.534,37,68,0.544,2,5,0.4,19,24,0.792,99,2016-01-04,PHI,MIN,2016,100.0
3313,3313,13,@,W 109-88 ,240,40,86,0.465,27,55,0.491,13,31,0.419,16,21,0.762,109,29,91,0.319,24,70,0.343,5,21,0.238,25,30,0.833,88,2016-01-05,GSW,LAL,2016,90.5
3314,3314,14,@,W 109-98 ,240,42,83,0.506,31,60,0.517,11,23,0.478,14,17,0.824,109,38,86,0.442,29,60,0.483,9,26,0.346,13,23,0.565,98,2016-01-06,LAC,POR,2016,102.5
3315,3315,15,@,W 109-99 ,240,41,85,0.482,36,71,0.507,5,14,0.357,22,27,0.815,109,38,91,0.418,32,68,0.471,6,23,0.261,17,26,0.654,99,2016-01-12,SAS,DET,2016,102.0
3316,3316,16,@,W 109-97 ,240,42,100,0.42,26,67,0.388,16,33,0.485,9,11,0.818,109,41,84,0.488,35,61,0.574,6,23,0.261,9,14,0.643,97,2016-01-13,NOP,SAC,2016,100.0
3317,3317,17,Home,W 109-107 ,240,43,87,0.494,31,60,0.517,12,27,0.444,11,13,0.846,109,42,86,0.488,28,51,0.549,14,35,0.4,9,12,0.75,107,2016-01-15,NOP,CHO,2016,114.0
3318,3318,18,Home,W 109-82 ,240,41,83,0.494,29,59,0.492,12,24,0.5,15,18,0.833,109,31,90,0.344,22,67,0.328,9,23,0.391,11,18,0.611,82,2016-01-16,UTA,LAL,2016,86.5
3319,3319,19,Home,W 109-95 ,240,39,83,0.47,30,59,0.508,9,24,0.375,22,30,0.733,109,34,81,0.42,25,54,0.463,9,27,0.333,18,21,0.857,95,2016-01-20,OKC,CHO,2016,99.5
3320,3320,20,@,L 109-115 ,240,43,85,0.506,31,59,0.525,12,26,0.462,11,15,0.733,109,46,83,0.554,35,54,0.648,11,29,0.379,12,17,0.706,115,2016-01-20,BOS,TOR,2016,120.5
3321,3321,21,@,W 109-106 ,240,45,91,0.495,37,61,0.607,8,30,0.267,11,15,0.733,109,40,87,0.46,30,54,0.556,10,33,0.303,16,18,0.889,106,2016-01-22,OKC,DAL,2016,111.0
3322,3322,22,Home,W 109-91 ,240,45,92,0.489,38,72,0.528,7,20,0.35,12,16,0.75,109,31,80,0.388,21,51,0.412,10,29,0.345,19,28,0.679,91,2016-01-29,POR,CHO,2016,96.0
3323,3323,23,Home,W 109-105 (OT),265,44,100,0.44,35,73,0.479,9,27,0.333,12,16,0.75,109,40,87,0.46,36,69,0.522,4,18,0.222,21,25,0.84,105,2016-01-30,IND,DEN,2016,107.0
3324,3324,24,@,W 109-90 ,240,45,86,0.523,36,66,0.545,9,20,0.45,10,12,0.833,109,33,71,0.465,22,49,0.449,11,22,0.5,13,19,0.684,90,2016-02-10,MEM,BRK,2016,95.5
3325,3325,25,Home,W 109-98 ,240,42,86,0.488,34,69,0.493,8,17,0.471,17,20,0.85,109,36,82,0.439,26,56,0.464,10,26,0.385,16,18,0.889,98,2016-02-19,BRK,NYK,2016,103.0
3326,3326,26,Home,W 109-104 ,240,40,82,0.488,33,61,0.541,7,21,0.333,22,28,0.786,109,31,75,0.413,20,49,0.408,11,26,0.423,31,31,1.0,104,2016-02-19,MEM,MIN,2016,109.5
3327,3327,27,Home,L 109-117 (2OT),290,44,106,0.415,35,65,0.538,9,41,0.22,12,18,0.667,109,46,104,0.442,43,87,0.494,3,17,0.176,22,32,0.688,117,2016-02-20,ATL,MIL,2016,118.5
3328,3328,28,Home,W 109-89 ,240,43,94,0.457,31,68,0.456,12,26,0.462,11,17,0.647,109,29,83,0.349,23,60,0.383,6,23,0.261,25,33,0.758,89,2016-02-23,WAS,NOP,2016,92.0
3329,3329,29,Home,W 109-104 ,240,44,88,0.5,36,65,0.554,8,23,0.348,13,16,0.813,109,38,90,0.422,29,62,0.468,9,28,0.321,19,26,0.731,104,2016-02-24,CHI,WAS,2016,108.5
3330,3330,30,Home,W 109-105 (OT),265,41,103,0.398,29,67,0.433,12,36,0.333,15,17,0.882,109,37,80,0.463,25,47,0.532,12,33,0.364,19,24,0.792,105,2016-03-01,GSW,ATL,2016,111.0
3331,3331,31,@,W 109-100 ,240,37,71,0.521,25,43,0.581,12,28,0.429,23,30,0.767,109,32,80,0.4,22,58,0.379,10,22,0.455,26,33,0.788,100,2016-03-06,PHO,MEM,2016,105.0
3332,3332,32,@,W 109-90 ,240,39,83,0.47,27,51,0.529,12,32,0.375,19,29,0.655,109,30,81,0.37,26,56,0.464,4,25,0.16,26,32,0.813,90,2016-03-07,LAC,DAL,2016,92.0
3333,3333,33,@,L 109-116 (OT),265,45,99,0.455,37,79,0.468,8,20,0.4,11,23,0.478,109,41,89,0.461,31,65,0.477,10,24,0.417,24,31,0.774,116,2016-03-08,WAS,POR,2016,121.0
3334,3334,34,Home,W 109-101 ,240,44,93,0.473,38,76,0.5,6,17,0.353,15,19,0.789,109,39,86,0.453,28,64,0.438,11,22,0.5,12,13,0.923,101,2016-03-10,SAS,CHI,2016,106.5
3335,3335,35,@,L 109-125 ,240,43,93,0.462,38,67,0.567,5,26,0.192,18,28,0.643,109,48,88,0.545,33,57,0.579,15,31,0.484,14,16,0.875,125,2016-03-12,HOU,CHO,2016,132.5
3336,3336,36,@,W 109-100 ,240,45,89,0.506,39,75,0.52,6,14,0.429,13,21,0.619,109,39,70,0.557,27,43,0.628,12,27,0.444,10,13,0.769,100,2016-03-13,MIL,BRK,2016,106.0
3337,3337,37,@,W 109-107 ,240,41,83,0.494,32,58,0.552,9,25,0.36,18,20,0.9,109,37,83,0.446,31,63,0.492,6,20,0.3,27,31,0.871,107,2016-03-14,CHI,TOR,2016,110.0
3338,3338,38,Home,L 109-130 ,240,40,93,0.43,35,74,0.473,5,19,0.263,24,27,0.889,109,47,96,0.49,35,67,0.522,12,29,0.414,24,30,0.8,130,2016-03-16,BOS,OKC,2016,136.0
3339,3339,39,@,W 109-106 ,240,40,86,0.465,27,60,0.45,13,26,0.5,16,21,0.762,109,40,75,0.533,33,58,0.569,7,17,0.412,19,24,0.792,106,2016-03-17,CHA,MIA,2016,109.5
3340,3340,40,@,W 109-103 ,240,38,76,0.5,25,48,0.521,13,28,0.464,20,27,0.741,109,37,82,0.451,26,60,0.433,11,22,0.5,18,22,0.818,103,2016-03-18,CLE,ORL,2016,108.5
3341,3341,41,Home,W 109-97 ,240,44,88,0.5,30,50,0.6,14,38,0.368,7,12,0.583,109,33,84,0.393,28,61,0.459,5,23,0.217,26,31,0.839,97,2016-03-19,ATL,HOU,2016,99.5
3342,3342,42,Home,W 109-105 ,240,35,71,0.493,28,50,0.56,7,21,0.333,32,40,0.8,109,33,82,0.402,23,43,0.535,10,39,0.256,29,42,0.69,105,2016-03-20,NOP,LAC,2016,110.0
3343,3343,43,Home,W 109-102 ,240,41,91,0.451,29,67,0.433,12,24,0.5,15,23,0.652,109,40,88,0.455,31,59,0.525,9,29,0.31,13,16,0.813,102,2016-03-21,CHI,SAC,2016,106.5
3344,3344,44,@,W 109-104 ,240,43,87,0.494,35,63,0.556,8,24,0.333,15,24,0.625,109,36,82,0.439,29,63,0.46,7,19,0.368,25,30,0.833,104,2016-03-21,GSW,MIN,2016,107.5
3345,3345,45,Home,W 109-103 ,240,40,89,0.449,33,62,0.532,7,27,0.259,22,25,0.88,109,42,96,0.438,33,66,0.5,9,30,0.3,10,11,0.909,103,2016-03-23,POR,DAL,2016,107.5
3346,3346,46,@,L 109-112 ,240,39,94,0.415,26,63,0.413,13,31,0.419,18,26,0.692,109,42,81,0.519,30,59,0.508,12,22,0.545,16,35,0.457,112,2016-03-25,TOR,HOU,2016,118.0
3347,3347,47,@,W 109-105 ,240,38,78,0.487,25,49,0.51,13,29,0.448,20,24,0.833,109,41,95,0.432,35,76,0.461,6,19,0.316,17,27,0.63,105,2016-03-30,DEN,MEM,2016,108.0
3348,3348,48,@,L 109-116 ,240,37,88,0.42,28,64,0.438,9,24,0.375,26,34,0.765,109,41,90,0.456,27,56,0.482,14,34,0.412,20,27,0.741,116,2016-03-31,BOS,POR,2016,123.0
3349,3349,49,@,W 109-106 ,240,41,87,0.471,33,64,0.516,8,23,0.348,19,30,0.633,109,38,83,0.458,18,40,0.45,20,43,0.465,10,13,0.769,106,2016-04-01,BOS,GSW,2016,116.0
3350,3350,50,@,L 109-114 ,240,43,94,0.457,32,64,0.5,11,30,0.367,12,21,0.571,109,43,85,0.506,35,66,0.53,8,19,0.421,20,33,0.606,114,2016-04-03,WAS,LAC,2016,118.0
3351,3351,51,@,W 109-80 ,240,41,75,0.547,23,39,0.59,18,36,0.5,9,10,0.9,109,35,88,0.398,31,72,0.431,4,16,0.25,6,12,0.5,80,2016-04-05,CLE,MIL,2016,82.0
3352,3352,52,@,L 109-123 ,240,35,74,0.473,27,45,0.6,8,29,0.276,31,34,0.912,109,45,80,0.563,29,49,0.592,16,31,0.516,17,22,0.773,123,2016-04-06,CLE,IND,2016,131.0
3353,3353,53,@,L 109-124 ,240,41,84,0.488,34,67,0.507,7,17,0.412,20,29,0.69,109,44,78,0.564,38,64,0.594,6,14,0.429,30,38,0.789,124,2016-04-08,MIL,BOS,2016,127.0
3354,3354,54,@,L 109-112 ,240,45,100,0.45,37,78,0.474,8,22,0.364,11,21,0.524,109,43,82,0.524,38,71,0.535,5,11,0.455,21,28,0.75,112,2016-04-08,MIA,ORL,2016,114.5
3355,3355,55,@,W 109-102 ,240,43,91,0.473,39,75,0.52,4,16,0.25,19,30,0.633,109,32,91,0.352,18,54,0.333,14,37,0.378,24,36,0.667,102,2016-04-08,NYK,PHI,2016,109.0
3356,3356,56,@,W 109-108 (OT),265,40,87,0.46,33,64,0.516,7,23,0.304,22,24,0.917,109,39,96,0.406,26,50,0.52,13,46,0.283,17,25,0.68,108,2016-04-10,MIL,PHI,2016,114.5
3357,3357,57,Home,W 109-94 ,240,40,83,0.482,29,54,0.537,11,29,0.379,18,20,0.9,109,39,87,0.448,31,57,0.544,8,30,0.267,8,15,0.533,94,2016-04-11,CLE,ATL,2016,98.0
3358,3358,58,@,L 109-144 ,240,40,92,0.435,29,62,0.468,11,30,0.367,18,22,0.818,109,56,86,0.651,43,58,0.741,13,28,0.464,19,23,0.826,144,2016-04-13,NOP,MIN,2016,150.5
3359,3359,59,Home,W 109-98 ,240,42,88,0.477,33,60,0.55,9,28,0.321,16,30,0.533,109,32,81,0.395,21,52,0.404,11,29,0.379,23,31,0.742,98,2016-04-13,WAS,ATL,2016,103.5
3360,3360,60,Home,W 109-91 ,240,41,86,0.477,38,68,0.559,3,18,0.167,24,29,0.828,109,35,84,0.417,31,62,0.5,4,22,0.182,17,22,0.773,91,2016-10-26,TOR,DET,2017,93.0
3361,3361,61,Home,W 109-101 ,240,41,76,0.539,28,49,0.571,13,27,0.481,14,17,0.824,109,37,88,0.42,28,63,0.444,9,25,0.36,18,21,0.857,101,2016-11-02,BRK,DET,2017,105.5
3362,3362,62,Home,W 109-93 ,240,39,79,0.494,26,45,0.578,13,34,0.382,18,26,0.692,109,34,86,0.395,22,48,0.458,12,38,0.316,13,15,0.867,93,2016-11-02,CHA,PHI,2017,99.0
3363,3363,63,Home,L 109-114 ,240,42,83,0.506,34,63,0.54,8,20,0.4,17,19,0.895,109,38,75,0.507,30,50,0.6,8,25,0.32,30,35,0.857,114,2016-11-06,NYK,UTA,2017,118.0
3364,3364,64,@,W 109-84 ,240,43,85,0.506,32,66,0.485,11,19,0.579,12,20,0.6,109,31,77,0.403,24,56,0.429,7,21,0.333,15,22,0.682,84,2016-11-07,UTA,PHI,2017,87.5
3365,3365,65,@,W 109-97 ,240,43,82,0.524,33,59,0.559,10,23,0.435,13,15,0.867,109,38,78,0.487,28,52,0.538,10,26,0.385,11,14,0.786,97,2016-11-08,DAL,LAL,2017,102.0
3366,3366,66,Home,W 109-105 (OT),265,36,86,0.419,25,54,0.463,11,32,0.344,26,31,0.839,109,39,88,0.443,34,69,0.493,5,19,0.263,22,23,0.957,105,2016-11-11,PHI,IND,2017,107.5
3367,3367,67,Home,W 109-102 ,240,42,77,0.545,32,49,0.653,10,28,0.357,15,22,0.682,109,38,91,0.418,30,68,0.441,8,23,0.348,18,25,0.72,102,2016-11-16,PHI,WAS,2017,106.0
3368,3368,68,@,L 109-126 ,240,41,90,0.456,31,62,0.5,10,28,0.357,17,21,0.81,109,46,95,0.484,32,63,0.508,14,32,0.438,20,25,0.8,126,2016-11-17,POR,HOU,2017,133.0
3369,3369,69,Home,L 109-129 ,240,37,93,0.398,27,58,0.466,10,35,0.286,25,31,0.806,109,49,85,0.576,34,49,0.694,15,36,0.417,16,21,0.762,129,2016-11-20,BRK,POR,2017,136.5
3370,3370,70,@,L 109-111 ,240,45,92,0.489,34,65,0.523,11,27,0.407,8,11,0.727,109,42,83,0.506,28,56,0.5,14,27,0.519,13,16,0.813,111,2016-11-22,OKC,LAL,2017,118.0
3371,3371,71,@,W 109-103 ,240,38,81,0.469,27,57,0.474,11,24,0.458,22,25,0.88,109,42,91,0.462,30,57,0.526,12,34,0.353,7,9,0.778,103,2016-11-25,SAS,BOS,2017,109.0
3372,3372,72,@,W 109-85 ,240,43,83,0.518,32,55,0.582,11,28,0.393,12,17,0.706,109,32,90,0.356,27,68,0.397,5,22,0.227,16,23,0.696,85,2016-11-25,GSW,LAL,2017,87.5
3373,3373,73,Home,W 109-94 ,240,42,95,0.442,34,75,0.453,8,20,0.4,17,20,0.85,109,39,88,0.443,27,53,0.509,12,35,0.343,4,10,0.4,94,2016-11-27,LAL,ATL,2017,100.0
3374,3374,74,Home,W 109-107 ,240,40,89,0.449,30,68,0.441,10,21,0.476,19,25,0.76,109,45,89,0.506,36,64,0.563,9,25,0.36,8,10,0.8,107,2016-11-30,PHO,ATL,2017,111.5
3375,3375,75,@,L 109-131 ,240,36,72,0.5,30,58,0.517,6,14,0.429,31,35,0.886,109,51,94,0.543,39,62,0.629,12,32,0.375,17,19,0.895,131,2016-11-30,IND,POR,2017,137.0
3376,3376,76,@,L 109-138 ,240,41,91,0.451,30,59,0.508,11,32,0.344,16,21,0.762,109,49,78,0.628,35,57,0.614,14,21,0.667,26,34,0.765,138,2016-12-03,PHO,GSW,2017,145.0
3377,3377,77,@,W 109-101 ,240,40,79,0.506,37,61,0.607,3,18,0.167,26,28,0.929,109,37,89,0.416,24,53,0.453,13,36,0.361,14,18,0.778,101,2016-12-05,CHA,DAL,2017,107.5
3378,3378,78,@,W 109-94 ,240,35,78,0.449,28,55,0.509,7,23,0.304,32,41,0.78,109,34,85,0.4,25,52,0.481,9,33,0.273,17,18,0.944,94,2016-12-07,IND,PHO,2017,98.5
3379,3379,79,Home,W 109-88 ,240,41,85,0.482,32,63,0.508,9,22,0.409,18,23,0.783,109,34,91,0.374,25,57,0.439,9,34,0.265,11,14,0.786,88,2016-12-09,CHA,ORL,2017,92.5
3380,3380,80,Home,W 109-87 ,240,37,74,0.5,18,37,0.486,19,37,0.514,16,22,0.727,109,32,79,0.405,21,45,0.467,11,34,0.324,12,14,0.857,87,2016-12-10,HOU,DAL,2017,92.5
3381,3381,81,Home,L 109-113 ,240,39,82,0.476,25,47,0.532,14,35,0.4,17,21,0.81,109,42,95,0.442,28,61,0.459,14,34,0.412,15,19,0.789,113,2016-12-13,NOP,GSW,2017,120.0
3382,3382,82,Home,W 109-89 ,240,42,72,0.583,29,49,0.592,13,23,0.565,12,15,0.8,109,30,82,0.366,24,63,0.381,6,19,0.316,23,27,0.852,89,2016-12-14,UTA,OKC,2017,92.0
3383,3383,83,Home,W 109-106 ,240,45,87,0.517,40,69,0.58,5,18,0.278,14,17,0.824,109,38,74,0.514,24,41,0.585,14,33,0.424,16,21,0.762,106,2016-12-14,WAS,CHO,2017,113.0
3384,3384,84,Home,L 109-111 (OT),265,41,92,0.446,34,71,0.479,7,21,0.333,20,27,0.741,109,39,96,0.406,22,45,0.489,17,51,0.333,16,20,0.8,111,2016-12-17,MIN,HOU,2017,119.5
3385,3385,85,@,W 109-79 ,240,43,87,0.494,36,60,0.6,7,27,0.259,16,21,0.762,109,34,83,0.41,31,62,0.5,3,21,0.143,8,9,0.889,79,2016-12-18,TOR,ORL,2017,80.5
3386,3386,86,Home,L 109-112 (OT),265,38,94,0.404,26,64,0.406,12,30,0.4,21,26,0.808,109,33,81,0.407,21,44,0.477,12,37,0.324,34,38,0.895,112,2016-12-20,MEM,BOS,2017,118.0
3387,3387,87,@,W 109-102 ,240,38,92,0.413,28,53,0.528,10,39,0.256,23,27,0.852,109,35,82,0.427,28,59,0.475,7,23,0.304,25,29,0.862,102,2016-12-22,BOS,IND,2017,105.5
3388,3388,88,@,W 109-108 ,240,37,86,0.43,29,61,0.475,8,25,0.32,27,33,0.818,109,37,78,0.474,29,53,0.547,8,25,0.32,26,35,0.743,108,2016-12-23,ATL,DEN,2017,112.0
3389,3389,89,@,L 109-115 ,240,38,89,0.427,18,37,0.486,20,52,0.385,13,15,0.867,109,41,81,0.506,28,56,0.5,13,25,0.52,20,25,0.8,115,2016-12-23,HOU,MEM,2017,121.5
3390,3390,90,@,W 109-105 ,240,42,80,0.525,27,51,0.529,15,29,0.517,10,14,0.714,109,36,79,0.456,24,47,0.511,12,32,0.375,21,26,0.808,105,2016-12-23,SAC,MIN,2017,111.0
3391,3391,91,Home,W 109-90 ,240,45,89,0.506,34,62,0.548,11,27,0.407,8,14,0.571,109,31,87,0.356,23,64,0.359,8,23,0.348,20,24,0.833,90,2016-12-23,ORL,LAL,2017,94.0
3392,3392,92,Home,W 109-108 ,240,37,95,0.389,25,60,0.417,12,35,0.343,23,32,0.719,109,37,77,0.481,28,47,0.596,9,30,0.3,25,29,0.862,108,2016-12-25,CLE,GSW,2017,112.5
3393,3393,93,Home,L 109-121 ,240,40,78,0.513,31,54,0.574,9,24,0.375,20,23,0.87,109,43,85,0.506,29,54,0.537,14,31,0.452,21,25,0.84,121,2016-12-31,CHA,CLE,2017,128.0
3394,3394,94,Home,W 109-98 ,240,37,80,0.463,30,64,0.469,7,16,0.438,28,38,0.737,109,39,102,0.382,37,87,0.425,2,15,0.133,18,22,0.818,98,2017-01-02,LAC,PHO,2017,99.0
3395,3395,95,@,L 109-121 ,240,41,90,0.456,24,52,0.462,17,38,0.447,10,13,0.769,109,48,93,0.516,38,71,0.535,10,22,0.455,15,19,0.789,121,2017-01-05,BRK,IND,2017,126.0
3396,3396,96,@,L 109-118 ,240,36,86,0.419,26,55,0.473,10,31,0.323,27,33,0.818,109,43,81,0.531,31,48,0.646,12,33,0.364,20,30,0.667,118,2017-01-05,LAL,POR,2017,124.0
3397,3397,97,@,L 109-123 ,240,40,87,0.46,28,56,0.5,12,31,0.387,17,24,0.708,109,43,86,0.5,32,62,0.516,11,24,0.458,26,28,0.929,123,2017-01-07,NYK,IND,2017,128.5
3398,3398,98,@,W 109-94 ,240,47,83,0.566,40,59,0.678,7,24,0.292,8,11,0.727,109,34,83,0.41,27,64,0.422,7,19,0.368,19,22,0.864,94,2017-01-09,OKC,CHI,2017,97.5
3399,3399,99,@,W 109-107 ,240,44,84,0.524,34,65,0.523,10,19,0.526,11,13,0.846,109,42,88,0.477,30,58,0.517,12,30,0.4,11,14,0.786,107,2017-01-10,MIL,SAS,2017,113.0
3400,3400,0,Home,L 109-115 ,240,39,97,0.402,29,63,0.46,10,34,0.294,21,25,0.84,109,41,83,0.494,31,65,0.477,10,18,0.556,23,26,0.885,115,2017-01-13,POR,ORL,2017,120.0
3401,3401,1,Home,W 109-93 ,240,44,91,0.484,36,74,0.486,8,17,0.471,13,18,0.722,109,36,87,0.414,26,56,0.464,10,31,0.323,11,21,0.524,93,2017-01-14,WAS,PHI,2017,98.0
3402,3402,2,Home,L 109-119 ,240,40,89,0.449,33,63,0.524,7,26,0.269,22,24,0.917,109,48,92,0.522,38,73,0.521,10,19,0.526,13,16,0.813,119,2017-01-17,BRK,TOR,2017,124.0
3403,3403,3,Home,W 109-103 ,240,42,90,0.467,33,61,0.541,9,29,0.31,16,24,0.667,109,36,90,0.4,27,51,0.529,9,39,0.231,22,28,0.786,103,2017-01-17,MIA,HOU,2017,107.5
3404,3404,4,Home,W 109-97 ,240,41,77,0.532,28,47,0.596,13,30,0.433,14,22,0.636,109,33,79,0.418,27,61,0.443,6,18,0.333,25,32,0.781,97,2017-01-21,MIA,MIL,2017,100.0
3405,3405,5,Home,W 109-100 ,240,39,84,0.464,33,60,0.55,6,24,0.25,25,32,0.781,109,39,77,0.506,29,57,0.509,10,20,0.5,12,17,0.706,100,2017-01-21,UTA,IND,2017,105.0
3406,3406,6,@,W 109-99 ,240,43,80,0.538,33,55,0.6,10,25,0.4,13,17,0.765,109,35,90,0.389,27,58,0.466,8,32,0.25,21,25,0.84,99,2017-01-23,WAS,CHO,2017,103.0
3407,3407,7,@,W 109-104 ,240,40,82,0.488,31,61,0.508,9,21,0.429,20,26,0.769,109,41,82,0.5,31,54,0.574,10,28,0.357,12,17,0.706,104,2017-01-23,SAC,DET,2017,109.0
3408,3408,8,@,W 109-103 ,240,35,76,0.461,27,54,0.5,8,22,0.364,31,35,0.886,109,38,86,0.442,31,60,0.517,7,26,0.269,20,25,0.8,103,2017-01-23,NYK,IND,2017,106.5
3409,3409,9,@,L 109-120 ,240,36,77,0.468,26,46,0.565,10,31,0.323,27,38,0.711,109,47,91,0.516,36,59,0.61,11,32,0.344,15,16,0.938,120,2017-01-25,HOU,BOS,2017,125.5
3410,3410,10,@,W 109-106 ,240,40,83,0.482,29,60,0.483,11,23,0.478,18,25,0.72,109,35,80,0.438,22,45,0.489,13,35,0.371,23,26,0.885,106,2017-01-25,MIA,BRK,2017,112.5
3411,3411,11,Home,L 109-114 ,240,42,91,0.462,35,63,0.556,7,28,0.25,18,23,0.783,109,40,75,0.533,28,49,0.571,12,26,0.462,22,25,0.88,114,2017-01-25,MIL,PHI,2017,120.0
3412,3412,12,@,W 109-103 ,240,42,81,0.519,32,63,0.508,10,18,0.556,15,17,0.882,109,36,81,0.444,26,54,0.481,10,27,0.37,21,27,0.778,103,2017-01-26,IND,MIN,2017,108.0
3413,3413,13,Home,W 109-98 ,240,37,72,0.514,28,50,0.56,9,22,0.409,26,36,0.722,109,38,84,0.452,27,58,0.466,11,26,0.423,11,13,0.846,98,2017-01-26,OKC,DAL,2017,103.5
3414,3414,14,@,L 109-112 ,240,37,77,0.481,28,51,0.549,9,26,0.346,26,33,0.788,109,38,81,0.469,22,46,0.478,16,35,0.457,20,21,0.952,112,2017-01-27,MEM,POR,2017,120.0
3415,3415,15,@,W 109-106 ,240,41,79,0.519,30,52,0.577,11,27,0.407,16,26,0.615,109,36,75,0.48,24,38,0.632,12,37,0.324,22,24,0.917,106,2017-01-28,SAC,CHO,2017,112.0
3416,3416,16,@,L 109-129 ,240,41,85,0.482,34,64,0.531,7,21,0.333,20,25,0.8,109,47,92,0.511,38,72,0.528,9,20,0.45,26,32,0.813,129,2017-01-28,BRK,MIN,2017,133.5
3417,3417,17,@,L 109-113 ,240,43,97,0.443,40,70,0.571,3,27,0.111,20,29,0.69,109,36,82,0.439,23,50,0.46,13,32,0.406,28,33,0.848,113,2017-01-30,DET,BOS,2017,119.5
3418,3418,18,Home,W 109-104 ,240,36,87,0.414,24,51,0.471,12,36,0.333,25,30,0.833,109,41,78,0.526,33,47,0.702,8,31,0.258,14,25,0.56,104,2017-02-01,BOS,TOR,2017,108.0
3419,3419,19,Home,W 109-106 (OT),265,43,88,0.489,36,65,0.554,7,23,0.304,16,19,0.842,109,36,87,0.414,21,43,0.488,15,44,0.341,19,24,0.792,106,2017-02-04,SAC,GSW,2017,113.5
3420,3420,20,@,L 109-118 ,240,42,90,0.467,29,55,0.527,13,35,0.371,12,18,0.667,109,41,84,0.488,31,60,0.517,10,24,0.417,26,29,0.897,118,2017-02-06,LAC,TOR,2017,123.0
3421,3421,21,@,L 109-112 ,240,42,79,0.532,31,51,0.608,11,28,0.393,14,20,0.7,109,39,80,0.488,32,61,0.525,7,19,0.368,27,30,0.9,112,2017-02-08,TOR,MIN,2017,115.5
3422,3422,22,@,L 109-118 ,240,38,79,0.481,28,58,0.483,10,21,0.476,23,30,0.767,109,50,106,0.472,42,79,0.532,8,27,0.296,10,13,0.769,118,2017-02-09,CLE,OKC,2017,122.0
3423,3423,23,@,L 109-125 ,240,39,97,0.402,27,60,0.45,12,37,0.324,19,22,0.864,109,46,84,0.548,31,54,0.574,15,30,0.5,18,22,0.818,125,2017-02-11,DEN,CLE,2017,132.5
3424,3424,24,@,L 109-117 ,240,39,85,0.459,32,62,0.516,7,23,0.304,24,28,0.857,109,39,86,0.453,30,61,0.492,9,25,0.36,30,38,0.789,117,2017-02-11,MIA,PHI,2017,121.5
3425,3425,25,@,W 109-104 (OT),265,32,83,0.386,24,55,0.436,8,28,0.286,37,48,0.771,109,37,103,0.359,21,61,0.344,16,42,0.381,14,25,0.56,104,2017-02-13,ATL,POR,2017,112.0
3426,3426,26,Home,W 109-86 ,240,41,84,0.488,28,48,0.583,13,36,0.361,14,21,0.667,109,33,89,0.371,26,65,0.4,7,24,0.292,13,17,0.765,86,2017-02-15,GSW,SAC,2017,89.5
3427,3427,27,Home,L 109-117 ,240,36,87,0.414,23,47,0.489,13,40,0.325,24,31,0.774,109,44,84,0.524,31,49,0.633,13,35,0.371,16,24,0.667,117,2017-02-15,HOU,MIA,2017,123.5
3428,3428,28,@,L 109-129 ,240,41,83,0.494,31,53,0.585,10,30,0.333,17,31,0.548,109,49,97,0.505,35,66,0.53,14,31,0.452,17,24,0.708,129,2017-02-24,BRK,DEN,2017,136.0
3429,3429,29,@,W 109-95 ,240,37,74,0.5,29,51,0.569,8,23,0.348,27,30,0.9,109,32,74,0.432,25,56,0.446,7,18,0.389,24,29,0.828,95,2017-02-24,UTA,MIL,2017,98.5
3430,3430,30,@,L 109-110 ,240,40,95,0.421,33,64,0.516,7,31,0.226,22,27,0.815,109,43,91,0.473,37,70,0.529,6,21,0.286,18,23,0.783,110,2017-02-25,PHI,NYK,2017,113.0
3431,3431,31,@,W 109-104 ,240,38,85,0.447,22,46,0.478,16,39,0.41,17,24,0.708,109,41,84,0.488,29,52,0.558,12,32,0.375,10,13,0.769,104,2017-02-28,CHA,LAL,2017,110.0
3432,3432,32,Home,W 109-106 ,240,39,76,0.513,24,54,0.444,15,22,0.682,16,23,0.696,109,43,93,0.462,34,71,0.479,9,22,0.409,11,13,0.846,106,2017-02-28,OKC,UTA,2017,110.5
3433,3433,33,Home,W 109-86 ,240,39,78,0.5,30,53,0.566,9,25,0.36,22,23,0.957,109,40,103,0.388,37,80,0.463,3,23,0.13,3,17,0.176,86,2017-03-01,NOP,DET,2017,87.5
3434,3434,34,@,W 109-100 ,240,34,74,0.459,23,46,0.5,11,28,0.393,30,36,0.833,109,35,81,0.432,24,59,0.407,11,22,0.5,19,22,0.864,100,2017-03-01,BRK,SAC,2017,105.5
3435,3435,35,@,L 109-114 ,240,34,86,0.395,23,57,0.404,11,29,0.379,30,32,0.938,109,39,79,0.494,29,54,0.537,10,25,0.4,26,35,0.743,114,2017-03-02,OKC,POR,2017,119.0
3436,3436,36,Home,W 109-106 ,240,42,94,0.447,38,74,0.514,4,20,0.2,21,26,0.808,109,32,85,0.376,19,48,0.396,13,37,0.351,29,40,0.725,106,2017-03-05,PHO,BOS,2017,112.5
3437,3437,37,Home,L 109-110 (OT),265,43,83,0.518,35,66,0.53,8,17,0.471,15,20,0.75,109,41,90,0.456,31,57,0.544,10,33,0.303,18,27,0.667,110,2017-03-05,SAC,UTA,2017,115.0
3438,3438,38,Home,W 109-95 ,240,45,92,0.489,39,71,0.549,6,21,0.286,13,20,0.65,109,34,83,0.41,26,55,0.473,8,28,0.286,19,21,0.905,95,2017-03-06,DET,CHI,2017,99.0
3439,3439,39,Home,L 109-122 ,240,34,77,0.442,24,52,0.462,10,25,0.4,31,39,0.795,109,39,73,0.534,25,43,0.581,14,30,0.467,30,38,0.789,122,2017-03-06,MEM,BRK,2017,129.0
3440,3440,40,@,W 108-98 ,240,43,80,0.538,37,68,0.544,6,12,0.5,16,21,0.762,108,35,83,0.422,27,66,0.409,8,17,0.471,20,34,0.588,98,2011-12-29,CHI,SAC,2012,102.0
3441,3441,41,@,W 108-94 ,240,41,78,0.526,28,57,0.491,13,21,0.619,13,18,0.722,108,33,89,0.371,26,61,0.426,7,28,0.25,21,26,0.808,94,2012-01-02,IND,NJN,2012,97.5
3442,3442,42,Home,W 108-99 ,240,41,78,0.526,36,64,0.563,5,14,0.357,21,27,0.778,108,41,96,0.427,30,65,0.462,11,31,0.355,6,7,0.857,99,2012-01-03,LAL,HOU,2012,104.5
3443,3443,43,Home,W 108-96 ,240,38,75,0.507,31,56,0.554,7,19,0.368,25,29,0.862,108,35,84,0.417,28,72,0.389,7,12,0.583,19,25,0.76,96,2012-01-08,OKC,SAS,2012,99.5
3444,3444,44,Home,W 108-99 ,240,35,78,0.449,30,68,0.441,5,10,0.5,33,41,0.805,108,35,75,0.467,31,65,0.477,4,10,0.4,25,31,0.806,99,2012-01-14,MEM,NOH,2012,101.0
3445,3445,45,Home,W 108-79 ,240,39,82,0.476,36,74,0.486,3,8,0.375,27,31,0.871,108,31,85,0.365,27,65,0.415,4,20,0.2,13,21,0.619,79,2012-01-17,UTA,LAC,2012,81.0
3446,3446,46,@,W 108-104 (OT),265,43,89,0.483,36,71,0.507,7,18,0.389,15,22,0.682,108,43,98,0.439,39,84,0.464,4,14,0.286,14,19,0.737,104,2012-01-18,DEN,PHI,2012,106.0
3447,3447,47,@,W 108-104 ,240,39,79,0.494,29,58,0.5,10,21,0.476,20,30,0.667,108,40,95,0.421,29,69,0.42,11,26,0.423,13,17,0.765,104,2012-01-20,DEN,WAS,2012,109.5
3448,3448,48,Home,W 108-98 ,240,41,79,0.519,36,64,0.563,5,15,0.333,21,29,0.724,108,37,83,0.446,29,62,0.468,8,21,0.381,16,21,0.762,98,2012-01-21,UTA,MIN,2012,102.0
3449,3449,49,Home,L 108-120 ,240,40,85,0.471,33,66,0.5,7,19,0.368,21,30,0.7,108,43,74,0.581,37,57,0.649,6,17,0.353,28,31,0.903,120,2012-01-30,HOU,MIN,2012,123.0
3450,3450,50,@,W 108-105 ,240,36,82,0.439,29,66,0.439,7,16,0.438,29,32,0.906,108,38,86,0.442,28,65,0.431,10,21,0.476,19,24,0.792,105,2012-02-03,MIN,NJN,2012,110.0
3451,3451,51,@,W 108-87 ,240,40,72,0.556,31,57,0.544,9,15,0.6,19,23,0.826,108,32,79,0.405,29,62,0.468,3,17,0.176,20,26,0.769,87,2012-02-06,CHI,NJN,2012,88.5
3452,3452,52,@,L 108-111 (OT),265,34,85,0.4,21,59,0.356,13,26,0.5,27,34,0.794,108,39,80,0.488,36,71,0.507,3,9,0.333,30,41,0.732,111,2012-02-06,TOR,WAS,2012,112.5
3453,3453,53,@,L 108-114 ,240,43,86,0.5,39,75,0.52,4,11,0.364,18,22,0.818,108,43,93,0.462,37,81,0.457,6,12,0.5,22,25,0.88,114,2012-02-17,SAC,DET,2012,117.0
3454,3454,54,Home,W 108-73 ,240,39,78,0.5,33,62,0.532,6,16,0.375,24,32,0.75,108,28,75,0.373,24,58,0.414,4,17,0.235,13,22,0.591,73,2012-02-19,IND,CHA,2012,75.0
3455,3455,55,@,L 108-117 (OT),265,42,79,0.532,33,58,0.569,9,21,0.429,15,23,0.652,108,44,88,0.5,37,69,0.536,7,19,0.368,22,31,0.71,117,2012-02-21,NOP,IND,2012,120.5
3456,3456,56,@,L 108-120 ,240,40,89,0.449,27,62,0.435,13,27,0.481,15,19,0.789,108,45,81,0.556,35,58,0.603,10,23,0.435,20,23,0.87,120,2012-02-21,SAC,MIA,2012,125.0
3457,3457,57,@,W 108-91 ,240,45,84,0.536,32,55,0.582,13,29,0.448,5,15,0.333,108,38,81,0.469,29,57,0.509,9,24,0.375,6,9,0.667,91,2012-02-22,ORL,NJN,2012,95.5
3458,3458,58,@,W 108-100 ,240,44,92,0.478,32,69,0.464,12,23,0.522,8,8,1.0,108,37,79,0.468,28,59,0.475,9,20,0.45,17,23,0.739,100,2012-03-01,LAC,SAC,2012,104.5
3459,3459,59,Home,W 108-78 ,240,45,77,0.584,35,60,0.583,10,17,0.588,8,9,0.889,108,31,83,0.373,23,61,0.377,8,22,0.364,8,12,0.667,78,2012-03-06,MIA,NJN,2012,82.0
3460,3460,60,Home,L 108-120 ,240,38,78,0.487,26,48,0.542,12,30,0.4,20,32,0.625,108,43,84,0.512,29,57,0.509,14,27,0.519,20,24,0.833,120,2012-03-09,SAS,LAC,2012,127.0
3461,3461,61,@,W 108-89 ,240,40,83,0.482,34,66,0.515,6,17,0.353,22,29,0.759,108,31,84,0.369,25,64,0.391,6,20,0.3,21,27,0.778,89,2012-03-21,WAS,NJN,2012,92.0
3462,3462,62,@,L 108-111 ,240,43,91,0.473,42,76,0.553,1,15,0.067,21,27,0.778,108,43,88,0.489,36,67,0.537,7,21,0.333,18,21,0.857,111,2012-03-24,SAC,GSW,2012,114.5
3463,3463,63,@,W 108-83 ,240,42,82,0.512,36,65,0.554,6,17,0.353,18,26,0.692,108,27,70,0.386,23,54,0.426,4,16,0.25,25,30,0.833,83,2012-03-25,PHO,CLE,2012,85.0
3464,3464,64,@,W 108-91 ,240,44,88,0.5,36,72,0.5,8,16,0.5,12,16,0.75,108,35,74,0.473,22,54,0.407,13,20,0.65,8,11,0.727,91,2012-03-26,DEN,CHI,2012,97.5
3465,3465,65,Home,W 108-101 ,240,44,88,0.5,39,77,0.506,5,11,0.455,15,16,0.938,108,42,84,0.5,35,61,0.574,7,23,0.304,10,17,0.588,101,2012-03-27,MIL,ATL,2012,104.5
3466,3466,66,Home,W 108-86 ,240,43,85,0.506,31,51,0.608,12,34,0.353,10,12,0.833,108,31,69,0.449,22,43,0.512,9,26,0.346,15,26,0.577,86,2012-03-28,NYK,ORL,2012,90.5
3467,3467,67,@,L 108-116 ,240,39,81,0.481,28,60,0.467,11,21,0.524,19,26,0.731,108,43,85,0.506,36,62,0.581,7,23,0.304,23,28,0.821,116,2012-04-02,MIN,SAC,2012,119.5
3468,3468,68,Home,L 108-113 ,240,43,95,0.453,34,70,0.486,9,25,0.36,13,20,0.65,108,43,83,0.518,37,67,0.552,6,16,0.375,21,30,0.7,113,2012-04-04,LAC,LAL,2012,116.0
3469,3469,69,@,L 108-112 (OT),265,41,88,0.466,29,67,0.433,12,21,0.571,14,15,0.933,108,42,93,0.452,35,75,0.467,7,18,0.389,21,27,0.778,112,2012-04-15,DAL,LAL,2012,115.5
3470,3470,70,Home,W 108-86 ,240,41,81,0.506,27,49,0.551,14,32,0.438,12,16,0.75,108,34,87,0.391,29,72,0.403,5,15,0.333,13,16,0.813,86,2012-04-26,DET,PHI,2012,88.5
3471,3471,71,Home,W 108-79 ,240,40,77,0.519,30,55,0.545,10,22,0.455,18,26,0.692,108,28,79,0.354,24,66,0.364,4,13,0.308,19,23,0.826,79,2012-11-04,LAL,DET,2013,81.0
3472,3472,72,@,W 108-101 ,240,40,92,0.435,26,63,0.413,14,29,0.483,14,22,0.636,108,39,74,0.527,30,49,0.612,9,25,0.36,14,16,0.875,101,2012-11-05,CLE,LAC,2013,105.5
3473,3473,73,Home,W 108-88 ,240,35,74,0.473,26,49,0.531,9,25,0.36,29,34,0.853,108,30,84,0.357,23,54,0.426,7,30,0.233,21,25,0.84,88,2012-11-06,OKC,TOR,2013,91.5
3474,3474,74,@,W 108-90 ,240,44,83,0.53,38,67,0.567,6,16,0.375,14,19,0.737,108,35,91,0.385,29,76,0.382,6,15,0.4,14,21,0.667,90,2012-11-07,MEM,MIL,2013,93.0
3475,3475,75,@,L 108-119 ,240,44,90,0.489,35,67,0.522,9,23,0.391,11,18,0.611,108,46,85,0.541,37,65,0.569,9,20,0.45,18,28,0.643,119,2012-11-18,HOU,LAL,2013,123.5
3476,3476,76,Home,W 108-100 ,240,39,80,0.488,30,63,0.476,9,17,0.529,21,24,0.875,108,37,79,0.468,31,55,0.564,6,24,0.25,20,24,0.833,100,2012-11-23,BOS,OKC,2013,103.0
3477,3477,77,Home,W 108-104 ,240,40,80,0.5,29,59,0.492,11,21,0.524,17,20,0.85,108,37,87,0.425,29,61,0.475,8,26,0.308,22,30,0.733,104,2012-11-23,ORL,CLE,2013,108.0
3478,3478,78,@,L 108-111 (OT),265,40,78,0.513,27,52,0.519,13,26,0.5,15,18,0.833,108,44,90,0.489,33,65,0.508,11,25,0.44,12,19,0.632,111,2012-11-23,NOP,PHO,2013,116.5
3479,3479,79,@,L 108-110 ,240,35,79,0.443,21,48,0.438,14,31,0.452,24,33,0.727,108,36,69,0.522,27,50,0.54,9,19,0.474,29,37,0.784,110,2012-11-24,CLE,MIA,2013,114.5
3480,3480,80,Home,W 108-97 ,240,40,74,0.541,34,58,0.586,6,16,0.375,22,32,0.688,108,32,79,0.405,21,54,0.389,11,25,0.44,22,30,0.733,97,2012-11-24,SAC,UTA,2013,102.5
3481,3481,81,@,W 108-106 (2OT),290,34,83,0.41,22,55,0.4,12,28,0.429,28,36,0.778,108,34,93,0.366,28,66,0.424,6,27,0.222,32,39,0.821,106,2012-11-24,CHA,WAS,2013,109.0
3482,3482,82,Home,W 108-101 ,240,42,80,0.525,33,65,0.508,9,15,0.6,15,22,0.682,108,36,85,0.424,30,66,0.455,6,19,0.316,23,31,0.742,101,2012-11-26,DET,POR,2013,104.0
3483,3483,83,Home,W 108-87 ,240,43,81,0.531,31,52,0.596,12,29,0.414,10,15,0.667,108,35,78,0.449,30,60,0.5,5,18,0.278,12,21,0.571,87,2012-11-30,NYK,WAS,2013,89.5
3484,3484,84,Home,W 108-98 (OT),265,40,85,0.471,36,66,0.545,4,19,0.211,24,31,0.774,108,38,82,0.463,32,68,0.471,6,14,0.429,16,22,0.727,98,2012-12-04,MEM,PHO,2013,101.0
3485,3485,85,Home,W 108-104 ,240,42,95,0.442,34,73,0.466,8,22,0.364,16,19,0.842,108,38,79,0.481,31,62,0.5,7,17,0.412,21,25,0.84,104,2012-12-05,ATL,DEN,2013,107.5
3486,3486,86,@,W 108-104 ,240,43,82,0.524,38,68,0.559,5,14,0.357,17,21,0.81,108,36,70,0.514,28,56,0.5,8,14,0.571,24,31,0.774,104,2012-12-07,CHI,DET,2013,108.0
3487,3487,87,Home,W 108-93 ,240,38,94,0.404,32,80,0.4,6,14,0.429,26,32,0.813,108,36,81,0.444,33,68,0.485,3,13,0.231,18,32,0.563,93,2012-12-07,MIL,CHA,2013,94.5
3488,3488,88,@,L 108-114 ,240,36,84,0.429,25,56,0.446,11,28,0.393,25,31,0.806,108,41,84,0.488,32,67,0.478,9,17,0.529,23,28,0.821,114,2012-12-07,LAL,OKC,2013,118.5
3489,3489,89,Home,W 108-105 ,240,38,87,0.437,36,73,0.493,2,14,0.143,30,37,0.811,108,42,83,0.506,35,67,0.522,7,16,0.438,14,24,0.583,105,2012-12-12,MIN,DEN,2013,108.5
3490,3490,90,Home,W 108-96 ,240,45,81,0.556,36,62,0.581,9,19,0.474,9,11,0.818,108,37,85,0.435,30,61,0.492,7,24,0.292,15,17,0.882,96,2012-12-23,SAC,POR,2013,99.5
3491,3491,91,Home,W 108-93 ,240,40,84,0.476,30,67,0.448,10,17,0.588,18,19,0.947,108,34,88,0.386,30,67,0.448,4,21,0.19,21,24,0.875,93,2012-12-26,MIL,BRK,2013,95.0
3492,3492,92,@,W 108-101 (OT),265,40,92,0.435,37,79,0.468,3,13,0.231,25,29,0.862,108,40,80,0.5,32,54,0.593,8,26,0.308,13,19,0.684,101,2013-01-06,CHA,DET,2013,105.0
3493,3493,93,Home,W 108-99 ,240,42,91,0.462,33,74,0.446,9,17,0.529,15,19,0.789,108,37,90,0.411,33,70,0.471,4,20,0.2,21,26,0.808,99,2013-01-08,MIL,PHO,2013,101.0
3494,3494,94,Home,W 108-103 ,240,40,87,0.46,32,72,0.444,8,15,0.533,20,26,0.769,108,38,77,0.494,28,55,0.509,10,22,0.455,17,21,0.81,103,2013-01-08,MIN,ATL,2013,108.0
3495,3495,95,Home,W 108-105 ,240,41,94,0.436,37,82,0.451,4,12,0.333,22,36,0.611,108,44,93,0.473,36,69,0.522,8,24,0.333,9,10,0.9,105,2013-01-09,DEN,ORL,2013,109.0
3496,3496,96,Home,W 108-105 ,240,41,84,0.488,29,59,0.492,12,25,0.48,14,16,0.875,108,44,95,0.463,36,68,0.529,8,27,0.296,9,15,0.6,105,2013-01-09,SAS,LAL,2013,109.0
3497,3497,97,@,W 108-101 ,240,39,68,0.574,34,57,0.596,5,11,0.455,25,34,0.735,108,37,90,0.411,26,68,0.382,11,22,0.5,16,23,0.696,101,2013-01-11,CHI,NYK,2013,106.5
3498,3498,98,Home,L 108-112 ,240,41,84,0.488,34,68,0.5,7,16,0.438,19,31,0.613,108,41,80,0.513,30,57,0.526,11,23,0.478,19,28,0.679,112,2013-01-18,DEN,WAS,2013,117.5
3499,3499,99,Home,W 108-101 (OT),265,47,91,0.516,43,72,0.597,4,19,0.211,10,14,0.714,108,40,88,0.455,29,63,0.46,11,25,0.44,10,13,0.769,101,2013-01-18,PHI,TOR,2013,106.5
3500,3500,0,Home,W 108-103 ,240,46,84,0.548,40,64,0.625,6,20,0.3,10,17,0.588,108,38,88,0.432,29,61,0.475,9,27,0.333,18,21,0.857,103,2013-01-20,TOR,LAL,2013,107.5
3501,3501,1,@,L 108-113 ,240,43,92,0.467,29,64,0.453,14,28,0.5,8,13,0.615,108,45,86,0.523,39,71,0.549,6,15,0.4,17,22,0.773,113,2013-01-25,MIL,CLE,2013,116.0
3502,3502,2,Home,W 108-99 ,240,41,83,0.494,34,59,0.576,7,24,0.292,19,23,0.826,108,41,81,0.506,35,69,0.507,6,12,0.5,11,14,0.786,99,2013-01-26,SAS,PHO,2013,102.0
3503,3503,3,@,W 108-95 ,240,45,84,0.536,34,68,0.5,11,16,0.688,7,10,0.7,108,36,84,0.429,32,66,0.485,4,18,0.222,19,25,0.76,95,2013-01-29,GSW,CLE,2013,97.0
3504,3504,4,@,L 108-114 ,240,39,80,0.488,30,55,0.545,9,25,0.36,21,25,0.84,108,40,82,0.488,30,59,0.508,10,23,0.435,24,28,0.857,114,2013-02-06,HOU,MIA,2013,119.0
3505,3505,5,@,L 108-119 ,240,45,86,0.523,37,65,0.569,8,21,0.381,10,13,0.769,108,39,80,0.488,32,66,0.485,7,14,0.5,34,41,0.829,119,2013-02-08,ORL,CLE,2013,122.5
3506,3506,6,Home,W 108-101 ,240,41,75,0.547,35,62,0.565,6,13,0.462,20,24,0.833,108,40,86,0.465,36,70,0.514,4,16,0.25,17,24,0.708,101,2013-02-12,MEM,SAC,2013,103.0
3507,3507,7,@,L 108-109 ,240,44,85,0.518,38,69,0.551,6,16,0.375,14,20,0.7,108,39,83,0.47,29,62,0.468,10,21,0.476,21,23,0.913,109,2013-02-12,DEN,TOR,2013,114.0
3508,3508,8,@,L 108-119 ,240,42,79,0.532,30,62,0.484,12,17,0.706,12,22,0.545,108,41,75,0.547,25,48,0.521,16,27,0.593,21,30,0.7,119,2013-02-13,DEN,BRK,2013,127.0
3509,3509,9,@,W 108-76 ,240,41,92,0.446,31,58,0.534,10,34,0.294,16,23,0.696,108,34,82,0.415,31,68,0.456,3,14,0.214,5,9,0.556,76,2013-02-13,ATL,ORL,2013,77.5
3510,3510,10,@,W 108-102 ,240,35,75,0.467,25,45,0.556,10,30,0.333,28,35,0.8,108,34,90,0.378,25,65,0.385,9,25,0.36,25,29,0.862,102,2013-02-19,SAS,SAC,2013,106.5
3511,3511,11,Home,W 108-98 ,240,42,87,0.483,32,67,0.478,10,20,0.5,14,17,0.824,108,40,84,0.476,31,67,0.463,9,17,0.529,9,14,0.643,98,2013-02-20,GSW,PHO,2013,102.5
3512,3512,12,@,L 108-122 ,240,38,88,0.432,26,66,0.394,12,22,0.545,20,25,0.8,108,49,92,0.533,37,65,0.569,12,27,0.444,12,19,0.632,122,2013-02-22,SAC,ATL,2013,128.0
3513,3513,13,@,L 108-119 ,240,43,78,0.551,35,59,0.593,8,19,0.421,14,31,0.452,108,49,88,0.557,44,70,0.629,5,18,0.278,16,27,0.593,119,2013-02-25,LAL,DEN,2013,121.5
3514,3514,14,Home,W 108-97 ,240,41,84,0.488,35,63,0.556,6,21,0.286,20,27,0.741,108,33,76,0.434,21,55,0.382,12,21,0.571,19,24,0.792,97,2013-02-26,IND,GSW,2013,103.0
3515,3515,15,@,W 108-104 ,240,38,80,0.475,31,59,0.525,7,21,0.333,25,34,0.735,108,38,82,0.463,29,58,0.5,9,24,0.375,19,22,0.864,104,2013-03-03,OKC,LAC,2013,108.5
3516,3516,16,@,W 108-82 ,240,44,83,0.53,33,59,0.559,11,24,0.458,9,15,0.6,108,29,73,0.397,27,58,0.466,2,15,0.133,22,26,0.846,82,2013-03-03,MEM,ORL,2013,83.0
3517,3517,17,@,L 108-109 (OT),265,40,99,0.404,36,86,0.419,4,13,0.308,24,31,0.774,108,45,95,0.474,35,71,0.493,10,24,0.417,9,13,0.692,109,2013-03-04,UTA,MIL,2013,114.0
3518,3518,18,@,L 108-112 ,240,35,78,0.449,23,46,0.5,12,32,0.375,26,33,0.788,108,45,83,0.542,34,57,0.596,11,26,0.423,11,14,0.786,112,2013-03-06,HOU,DAL,2013,117.5
3519,3519,19,@,W 108-102 ,240,38,78,0.487,27,50,0.54,11,28,0.393,21,29,0.724,108,38,88,0.432,29,64,0.453,9,24,0.375,17,20,0.85,102,2013-03-06,LAL,NOH,2013,106.5
3520,3520,20,@,W 108-93 ,240,44,86,0.512,41,74,0.554,3,12,0.25,17,25,0.68,108,35,84,0.417,29,64,0.453,6,20,0.3,17,22,0.773,93,2013-03-11,DEN,PHO,2013,96.0
3521,3521,21,Home,W 108-98 ,240,40,80,0.5,35,64,0.547,5,16,0.313,23,31,0.742,108,40,78,0.513,35,62,0.565,5,16,0.313,13,15,0.867,98,2013-03-12,BRK,NOH,2013,100.5
3522,3522,22,Home,L 108-115 ,240,43,89,0.483,35,68,0.515,8,21,0.381,14,17,0.824,108,41,82,0.5,30,53,0.566,11,29,0.379,22,27,0.815,115,2013-03-12,MIL,DAL,2013,120.5
3523,3523,23,Home,W 108-100 ,240,36,74,0.486,25,43,0.581,11,31,0.355,25,31,0.806,108,39,81,0.481,33,57,0.579,6,24,0.25,16,20,0.8,100,2013-03-15,HOU,MIN,2013,103.0
3524,3524,24,@,W 108-78 ,240,44,96,0.458,31,70,0.443,13,26,0.5,7,9,0.778,108,28,86,0.326,19,51,0.373,9,35,0.257,13,16,0.813,78,2013-03-17,GSW,HOU,2013,82.5
3525,3525,25,@,W 108-91 ,240,39,67,0.582,29,45,0.644,10,22,0.455,20,29,0.69,108,39,94,0.415,37,74,0.5,2,20,0.1,11,12,0.917,91,2013-03-17,MIA,TOR,2013,92.0
3526,3526,26,@,L 108-113 ,240,42,82,0.512,35,65,0.538,7,17,0.412,17,21,0.81,108,38,70,0.543,29,52,0.558,9,18,0.5,28,33,0.848,113,2013-03-24,UTA,DAL,2013,117.5
3527,3527,27,@,W 108-94 ,240,37,78,0.474,22,50,0.44,15,28,0.536,19,29,0.655,108,37,86,0.43,28,62,0.452,9,24,0.375,11,18,0.611,94,2013-03-25,MIA,ORL,2013,98.5
3528,3528,28,@,L 108-114 ,240,44,84,0.524,37,65,0.569,7,19,0.368,13,18,0.722,108,44,85,0.518,38,65,0.585,6,20,0.3,20,28,0.714,114,2013-03-27,ORL,CHA,2013,117.0
3529,3529,29,Home,W 108-101 ,240,38,74,0.514,25,43,0.581,13,31,0.419,19,22,0.864,108,33,70,0.471,27,49,0.551,6,21,0.286,29,35,0.829,101,2013-03-27,NYK,MEM,2013,104.0
3530,3530,30,@,W 108-89 ,240,42,69,0.609,28,42,0.667,14,27,0.519,10,16,0.625,108,34,74,0.459,29,56,0.518,5,18,0.278,16,18,0.889,89,2013-03-29,MIA,NOH,2013,91.5
3531,3531,31,Home,W 108-89 ,240,35,72,0.486,21,45,0.467,14,27,0.519,24,31,0.774,108,32,74,0.432,25,49,0.51,7,25,0.28,18,23,0.783,89,2013-03-31,NYK,BOS,2013,92.5
3532,3532,32,@,W 108-98 ,240,43,77,0.558,36,62,0.581,7,15,0.467,15,21,0.714,108,41,81,0.506,33,60,0.55,8,21,0.381,8,10,0.8,98,2013-04-01,DET,TOR,2013,102.0
3533,3533,33,Home,L 108-117 ,240,39,87,0.448,33,61,0.541,6,26,0.231,24,31,0.774,108,46,90,0.511,40,70,0.571,6,20,0.3,19,19,1.0,117,2013-04-05,SAC,DAL,2013,120.0
3534,3534,34,Home,W 108-105 (OT),265,43,95,0.453,32,72,0.444,11,23,0.478,11,19,0.579,108,41,93,0.441,33,69,0.478,8,24,0.333,15,21,0.714,105,2013-04-12,DAL,DEN,2013,109.0
3535,3535,35,Home,W 108-101 ,240,42,77,0.545,36,60,0.6,6,17,0.353,18,21,0.857,108,39,89,0.438,28,69,0.406,11,20,0.55,12,15,0.8,101,2013-04-12,SAS,SAC,2013,106.5
3536,3536,36,Home,L 108-112 ,240,40,89,0.449,31,63,0.492,9,26,0.346,19,25,0.76,108,44,88,0.5,32,64,0.5,12,24,0.5,12,18,0.667,112,2013-04-17,SAC,LAC,2013,118.0
3537,3537,37,@,W 108-95 ,240,42,91,0.462,30,62,0.484,12,29,0.414,12,16,0.75,108,33,79,0.418,26,61,0.426,7,18,0.389,22,22,1.0,95,2013-04-17,MIN,SAS,2013,98.5
3538,3538,38,@,L 108-111 (OT),265,42,89,0.472,35,68,0.515,7,21,0.333,17,24,0.708,108,40,77,0.519,34,59,0.576,6,18,0.333,25,30,0.833,111,2013-11-01,DET,MEM,2014,114.0
3539,3539,39,@,L 108-116 ,240,44,90,0.489,34,68,0.5,10,22,0.455,10,15,0.667,108,41,89,0.461,33,69,0.478,8,20,0.4,26,30,0.867,116,2013-11-08,DAL,MIN,2014,120.0
3540,3540,40,@,L 108-112 (OT),265,41,88,0.466,35,64,0.547,6,24,0.25,20,29,0.69,108,41,88,0.466,31,64,0.484,10,24,0.417,20,26,0.769,112,2013-11-08,BRK,WAS,2014,117.0
3541,3541,41,Home,W 108-90 ,240,42,79,0.532,37,66,0.561,5,13,0.385,19,25,0.76,108,33,78,0.423,23,48,0.479,10,30,0.333,14,26,0.538,90,2013-11-09,MEM,GSW,2014,95.0
3542,3542,42,@,W 108-100 ,240,43,84,0.512,33,57,0.579,10,27,0.37,12,18,0.667,108,37,70,0.529,33,55,0.6,4,15,0.267,22,28,0.786,100,2013-11-16,DAL,ORL,2014,102.0
3543,3543,43,@,W 108-98 ,240,41,76,0.539,33,58,0.569,8,18,0.444,18,21,0.857,108,31,85,0.365,28,72,0.389,3,13,0.231,33,35,0.943,98,2013-11-18,POR,BRK,2014,99.5
3544,3544,44,@,W 108-98 ,240,36,86,0.419,22,57,0.386,14,29,0.483,22,28,0.786,108,34,76,0.447,27,56,0.482,7,20,0.35,23,31,0.742,98,2013-11-20,TOR,PHI,2014,101.5
3545,3545,45,Home,W 108-101 ,240,38,78,0.487,26,54,0.481,12,24,0.5,20,30,0.667,108,36,81,0.444,29,64,0.453,7,17,0.412,22,26,0.846,101,2013-11-30,WAS,ATL,2014,104.5
3546,3546,46,Home,L 108-114 ,240,40,87,0.46,30,59,0.508,10,28,0.357,18,23,0.783,108,38,87,0.437,29,64,0.453,9,23,0.391,29,34,0.853,114,2013-12-01,LAL,POR,2014,118.5
3547,3547,47,Home,W 108-100 ,240,38,77,0.494,27,53,0.509,11,24,0.458,21,27,0.778,108,37,78,0.474,29,60,0.483,8,18,0.444,18,21,0.857,100,2013-12-03,BOS,MIL,2014,104.0
3548,3548,48,Home,W 108-89 ,240,47,91,0.516,39,68,0.574,8,23,0.348,6,11,0.545,108,38,94,0.404,33,74,0.446,5,20,0.25,8,17,0.471,89,2013-12-06,ATL,CLE,2014,91.5
3549,3549,49,@,W 108-82 ,240,44,88,0.5,36,70,0.514,8,18,0.444,12,14,0.857,108,31,85,0.365,29,75,0.387,2,10,0.2,18,22,0.818,82,2013-12-07,GSW,MEM,2014,83.0
3550,3550,50,@,W 108-106 ,240,46,87,0.529,38,71,0.535,8,16,0.5,8,11,0.727,108,39,87,0.448,30,57,0.526,9,30,0.3,19,24,0.792,106,2013-12-07,DAL,POR,2014,110.5
3551,3551,51,Home,L 108-114 ,240,39,80,0.488,34,61,0.557,5,19,0.263,25,32,0.781,108,44,85,0.518,37,62,0.597,7,23,0.304,19,21,0.905,114,2013-12-10,LAL,PHO,2014,117.5
3552,3552,52,Home,W 108-100 ,240,39,82,0.476,29,57,0.509,10,25,0.4,20,24,0.833,108,37,84,0.44,28,61,0.459,9,23,0.391,17,21,0.81,100,2013-12-13,TOR,PHI,2014,104.5
3553,3553,53,Home,W 108-95 ,240,33,78,0.423,22,49,0.449,11,29,0.379,31,36,0.861,108,37,93,0.398,30,73,0.411,7,20,0.35,14,20,0.7,95,2013-12-18,LAC,NOP,2014,98.5
3554,3554,54,@,W 108-101 ,240,41,87,0.471,34,69,0.493,7,18,0.389,19,24,0.792,108,38,82,0.463,31,67,0.463,7,15,0.467,18,24,0.75,101,2013-12-18,SAS,PHO,2014,104.5
3555,3555,55,Home,L 108-109 (OT),265,46,91,0.505,36,70,0.514,10,21,0.476,6,10,0.6,108,42,91,0.462,31,70,0.443,11,21,0.524,14,18,0.778,109,2013-12-20,DAL,TOR,2014,114.5
3556,3556,56,@,L 108-123 ,240,44,91,0.484,41,74,0.554,3,17,0.176,17,23,0.739,108,44,86,0.512,29,56,0.518,15,30,0.5,20,22,0.909,123,2013-12-21,DAL,PHO,2014,130.5
3557,3557,57,Home,W 108-103 (OT),265,41,83,0.494,36,63,0.571,5,20,0.25,21,25,0.84,108,38,86,0.442,27,54,0.5,11,32,0.344,16,21,0.762,103,2013-12-27,SAC,MIA,2014,108.5
3558,3558,58,@,W 108-107 ,240,45,88,0.511,37,74,0.5,8,14,0.571,10,11,0.909,108,39,77,0.506,28,51,0.549,11,26,0.423,18,21,0.857,107,2013-12-28,MIA,POR,2014,112.5
3559,3559,59,@,W 108-104 (OT),265,42,95,0.442,32,62,0.516,10,33,0.303,14,19,0.737,108,38,92,0.413,28,76,0.368,10,16,0.625,18,21,0.857,104,2013-12-29,GSW,CLE,2014,109.0
3560,3560,60,@,L 108-110 ,240,39,88,0.443,27,56,0.482,12,32,0.375,18,24,0.75,108,48,89,0.539,46,78,0.59,2,11,0.182,12,15,0.8,110,2013-12-30,POR,NOP,2014,111.0
3561,3561,61,@,L 108-111 ,240,37,76,0.487,32,64,0.5,5,12,0.417,29,38,0.763,108,43,80,0.538,34,58,0.586,9,22,0.409,16,21,0.762,111,2014-01-03,MEM,DEN,2014,115.5
3562,3562,62,Home,L 108-110 (OT),265,46,99,0.465,40,82,0.488,6,17,0.353,10,15,0.667,108,43,83,0.518,36,59,0.61,7,24,0.292,17,25,0.68,110,2014-01-07,MEM,SAS,2014,113.5
3563,3563,63,@,L 108-110 ,240,37,94,0.394,24,59,0.407,13,35,0.371,21,25,0.84,108,44,94,0.468,41,77,0.532,3,17,0.176,19,27,0.704,110,2014-01-11,PHO,DET,2014,111.5
3564,3564,64,Home,W 108-101 ,240,43,83,0.518,37,68,0.544,6,15,0.4,16,20,0.8,108,38,80,0.475,29,53,0.547,9,27,0.333,16,24,0.667,101,2014-01-12,MEM,ATL,2014,105.5
3565,3565,65,Home,W 108-98 ,240,38,75,0.507,32,61,0.525,6,14,0.429,26,33,0.788,108,39,81,0.481,33,64,0.516,6,17,0.353,14,18,0.778,98,2014-01-14,CHA,NYK,2014,101.0
3566,3566,66,Home,L 108-111 ,240,39,88,0.443,31,68,0.456,8,20,0.4,22,29,0.759,108,45,82,0.549,40,70,0.571,5,12,0.417,16,19,0.842,111,2014-01-15,MIN,SAC,2014,113.5
3567,3567,67,Home,W 108-96 ,240,42,88,0.477,31,61,0.508,11,27,0.407,13,17,0.765,108,39,89,0.438,33,66,0.5,6,23,0.261,12,18,0.667,96,2014-01-15,POR,CLE,2014,99.0
3568,3568,68,Home,W 108-93 ,240,39,86,0.453,30,65,0.462,9,21,0.429,21,30,0.7,108,33,77,0.429,28,60,0.467,5,17,0.294,22,28,0.786,93,2014-01-19,OKC,SAC,2014,95.5
3569,3569,69,Home,W 108-102 ,240,32,72,0.444,22,47,0.468,10,25,0.4,34,39,0.872,108,37,71,0.521,29,51,0.569,8,20,0.4,20,28,0.714,102,2014-02-03,BRK,PHI,2014,106.0
3570,3570,70,Home,L 108-119 ,240,38,101,0.376,33,68,0.485,5,33,0.152,27,37,0.73,108,42,79,0.532,24,42,0.571,18,37,0.486,17,22,0.773,119,2014-02-05,CLE,LAL,2014,128.0
3571,3571,71,@,L 108-122 ,240,42,90,0.467,34,60,0.567,8,30,0.267,16,21,0.762,108,39,71,0.549,28,55,0.509,11,16,0.688,33,42,0.786,122,2014-02-05,PHO,HOU,2014,127.5
3572,3572,72,Home,L 108-114 ,240,42,94,0.447,35,73,0.479,7,21,0.333,17,20,0.85,108,41,84,0.488,33,65,0.508,8,19,0.421,24,33,0.727,114,2014-02-05,PHI,BOS,2014,118.0
3573,3573,73,Home,W 108-101 ,240,36,76,0.474,26,52,0.5,10,24,0.417,26,33,0.788,108,39,77,0.506,33,65,0.508,6,12,0.5,17,26,0.654,101,2014-02-10,TOR,NOP,2014,104.0
3574,3574,74,@,W 108-96 ,240,39,75,0.52,32,58,0.552,7,17,0.412,23,37,0.622,108,39,98,0.398,34,82,0.415,5,16,0.313,13,23,0.565,96,2014-02-18,CHA,DET,2014,98.5
3575,3575,75,Home,W 108-98 ,240,39,79,0.494,30,56,0.536,9,23,0.391,21,26,0.808,108,37,77,0.481,25,51,0.49,12,26,0.462,12,19,0.632,98,2014-02-18,IND,ATL,2014,104.0
3576,3576,76,Home,L 108-134 ,240,41,84,0.488,27,57,0.474,14,27,0.519,12,15,0.8,108,52,104,0.5,34,69,0.493,18,35,0.514,12,25,0.48,134,2014-02-19,LAL,HOU,2014,143.0
3577,3577,77,@,W 108-102 ,240,36,76,0.474,24,51,0.471,12,25,0.48,24,32,0.75,108,39,76,0.513,32,59,0.542,7,17,0.412,17,26,0.654,102,2014-02-23,BRK,LAL,2014,105.5
3578,3578,78,Home,W 108-97 ,240,40,83,0.482,27,55,0.491,13,28,0.464,15,16,0.938,108,37,94,0.394,28,66,0.424,9,28,0.321,14,20,0.7,97,2014-02-23,POR,MIN,2014,101.5
3579,3579,79,Home,L 108-110 ,240,40,76,0.526,26,43,0.605,14,33,0.424,14,16,0.875,108,41,86,0.477,26,50,0.52,15,36,0.417,13,16,0.813,110,2014-02-24,NYK,DAL,2014,117.5
3580,3580,80,Home,W 108-89 ,240,41,79,0.519,31,57,0.544,10,22,0.455,16,17,0.941,108,36,71,0.507,27,51,0.529,9,20,0.45,8,19,0.421,89,2014-02-26,DAL,NOP,2014,93.5
3581,3581,81,Home,W 108-103 ,240,45,92,0.489,41,79,0.519,4,13,0.308,14,21,0.667,108,38,77,0.494,23,49,0.469,15,28,0.536,12,18,0.667,103,2014-02-26,MEM,LAL,2014,110.5
3582,3582,82,Home,W 108-82 ,240,45,74,0.608,39,59,0.661,6,15,0.4,12,18,0.667,108,31,83,0.373,27,60,0.45,4,23,0.174,16,22,0.727,82,2014-02-27,MIA,NYK,2014,84.0
3583,3583,83,Home,W 108-76 ,240,38,81,0.469,29,56,0.518,9,25,0.36,23,32,0.719,108,28,85,0.329,25,63,0.397,3,22,0.136,17,19,0.895,76,2014-03-01,LAC,NOP,2014,77.5
3584,3584,84,@,W 108-97 ,240,37,81,0.457,32,60,0.533,5,21,0.238,29,38,0.763,108,37,82,0.451,30,60,0.5,7,22,0.318,16,21,0.762,97,2014-03-01,MIN,SAC,2014,100.5
3585,3585,85,@,W 108-88 ,240,46,98,0.469,41,70,0.586,5,28,0.179,11,12,0.917,108,30,76,0.395,23,50,0.46,7,26,0.269,21,26,0.808,88,2014-03-05,GSW,BOS,2014,91.5
3586,3586,86,Home,W 108-81 ,240,42,85,0.494,30,54,0.556,12,31,0.387,12,18,0.667,108,30,73,0.411,24,46,0.522,6,27,0.222,15,20,0.75,81,2014-03-07,NYK,UTA,2014,84.0
3587,3587,87,@,L 108-109 ,240,38,76,0.5,26,48,0.542,12,28,0.429,20,26,0.769,108,42,79,0.532,35,57,0.614,7,22,0.318,18,24,0.75,109,2014-03-08,ATL,LAC,2014,112.5
3588,3588,88,Home,W 108-85 ,240,41,80,0.513,29,55,0.527,12,25,0.48,14,17,0.824,108,30,82,0.366,25,64,0.391,5,18,0.278,20,31,0.645,85,2014-03-11,GSW,DAL,2014,87.5
3589,3589,89,@,W 108-101 ,240,42,79,0.532,29,58,0.5,13,21,0.619,11,12,0.917,108,40,85,0.471,35,59,0.593,5,26,0.192,16,21,0.762,101,2014-03-12,DAL,UTA,2014,103.5
3590,3590,90,Home,W 108-95 ,240,41,70,0.586,32,49,0.653,9,21,0.429,17,27,0.63,108,37,80,0.463,31,58,0.534,6,22,0.273,15,28,0.536,95,2014-03-17,BRK,PHO,2014,98.0
3591,3591,91,Home,W 108-103 ,240,43,88,0.489,35,68,0.515,8,20,0.4,14,20,0.7,108,38,83,0.458,31,64,0.484,7,19,0.368,20,25,0.8,103,2014-03-26,SAS,DEN,2014,106.5
3592,3592,92,Home,W 108-105 ,240,39,70,0.557,33,60,0.55,6,10,0.6,24,34,0.706,108,42,85,0.494,35,64,0.547,7,21,0.333,14,18,0.778,105,2014-03-27,MIL,LAL,2014,108.5
3593,3593,93,Home,W 108-97 ,240,39,71,0.549,25,42,0.595,14,29,0.483,16,21,0.762,108,37,87,0.425,27,63,0.429,10,24,0.417,13,16,0.813,97,2014-03-28,BRK,CLE,2014,102.0
3594,3594,94,Home,L 108-112 ,240,36,78,0.462,28,50,0.56,8,28,0.286,28,33,0.848,108,37,79,0.468,26,53,0.491,11,26,0.423,27,30,0.9,112,2014-04-02,PHO,LAC,2014,117.5
3595,3595,95,@,W 108-100 ,240,35,73,0.479,29,49,0.592,6,24,0.25,32,36,0.889,108,30,76,0.395,15,43,0.349,15,33,0.455,25,31,0.806,100,2014-04-11,NYK,TOR,2014,107.5
3596,3596,96,Home,W 108-95 ,240,39,77,0.506,34,64,0.531,5,13,0.385,25,32,0.781,108,36,72,0.5,29,57,0.509,7,15,0.467,16,19,0.842,95,2014-04-14,CHI,ORL,2014,98.5
3597,3597,97,@,L 108-113 ,240,40,86,0.465,31,62,0.5,9,24,0.375,19,26,0.731,108,43,79,0.544,40,67,0.597,3,12,0.25,24,38,0.632,113,2014-04-14,BOS,PHI,2014,114.5
3598,3598,98,@,W 108-90 ,240,31,73,0.425,19,44,0.432,12,29,0.414,34,50,0.68,108,28,79,0.354,25,69,0.362,3,10,0.3,31,39,0.795,90,2014-10-28,HOU,LAL,2015,91.5
3599,3599,99,Home,W 108-106 (OT),265,41,101,0.406,35,80,0.438,6,21,0.286,20,29,0.69,108,39,80,0.488,32,66,0.485,7,14,0.5,21,24,0.875,106,2014-10-29,CHA,MIL,2015,109.5
3600,3600,0,Home,L 108-114 (OT),265,41,90,0.456,28,59,0.475,13,31,0.419,13,17,0.765,108,41,104,0.394,38,89,0.427,3,15,0.2,29,33,0.879,114,2014-10-31,CHI,CLE,2015,115.5
3601,3601,1,@,W 108-95 ,240,33,83,0.398,29,62,0.468,4,21,0.19,38,48,0.792,108,38,81,0.469,31,61,0.508,7,20,0.35,12,24,0.5,95,2014-11-01,TOR,ORL,2015,98.5
3602,3602,2,Home,W 108-97 ,240,40,73,0.548,36,60,0.6,4,13,0.308,24,33,0.727,108,34,80,0.425,25,58,0.431,9,22,0.409,20,24,0.833,97,2014-11-01,WAS,MIL,2015,101.5
3603,3603,3,@,W 108-91 ,240,35,68,0.515,18,31,0.581,17,37,0.459,21,27,0.778,108,31,74,0.419,19,46,0.413,12,28,0.429,17,27,0.63,91,2014-11-04,HOU,MIA,2015,97.0
3604,3604,4,Home,W 108-87 ,240,40,77,0.519,28,47,0.596,12,30,0.4,16,19,0.842,108,33,90,0.367,28,67,0.418,5,23,0.217,16,16,1.0,87,2014-11-06,POR,DAL,2015,89.5
3605,3605,5,@,W 108-87 ,240,43,87,0.494,35,64,0.547,8,23,0.348,14,25,0.56,108,34,84,0.405,26,62,0.419,8,22,0.364,11,22,0.5,87,2014-11-14,DEN,IND,2015,91.0
3606,3606,6,@,L 108-111 ,240,45,92,0.489,38,72,0.528,7,20,0.35,11,13,0.846,108,39,73,0.534,33,52,0.635,6,21,0.286,27,38,0.711,111,2014-12-02,MIL,CLE,2015,114.0
3607,3607,7,@,W 108-101 (OT),265,40,87,0.46,33,64,0.516,7,23,0.304,21,30,0.7,108,34,87,0.391,28,64,0.438,6,23,0.261,27,35,0.771,101,2014-12-06,PHI,DET,2015,104.0
3608,3608,8,@,W 108-92 ,240,40,77,0.519,31,56,0.554,9,21,0.429,19,27,0.704,108,37,84,0.44,28,57,0.491,9,27,0.333,9,17,0.529,92,2014-12-08,ATL,IND,2015,96.5
3609,3609,9,Home,W 108-96 ,240,39,88,0.443,29,54,0.537,10,34,0.294,20,34,0.588,108,36,96,0.375,29,68,0.426,7,28,0.25,17,26,0.654,96,2014-12-13,HOU,DEN,2015,99.5
3610,3610,10,Home,W 108-95 ,240,41,89,0.461,34,71,0.479,7,18,0.389,19,22,0.864,108,38,78,0.487,34,67,0.507,4,11,0.364,15,22,0.682,95,2014-12-15,POR,SAS,2015,97.0
3611,3611,11,@,W 108-107 ,240,37,75,0.493,24,52,0.462,13,23,0.565,21,27,0.778,108,38,67,0.567,32,53,0.604,6,14,0.429,25,33,0.758,107,2014-12-18,MIL,SAC,2015,110.0
3612,3612,12,Home,W 108-101 ,240,38,79,0.481,31,56,0.554,7,23,0.304,25,36,0.694,108,33,87,0.379,23,61,0.377,10,26,0.385,25,30,0.833,101,2014-12-21,SAC,LAL,2015,106.0
3613,3613,13,@,L 108-118 ,240,40,82,0.488,35,68,0.515,5,14,0.357,23,26,0.885,108,42,86,0.488,28,53,0.528,14,33,0.424,20,27,0.741,118,2014-12-21,NYK,TOR,2015,125.0
3614,3614,14,@,L 108-128 ,240,43,90,0.478,35,73,0.479,8,17,0.471,14,21,0.667,108,49,91,0.538,40,66,0.606,9,25,0.36,21,24,0.875,128,2014-12-22,SAC,GSW,2015,132.5
3615,3615,15,@,W 108-101 ,240,36,82,0.439,28,61,0.459,8,21,0.381,28,36,0.778,108,39,82,0.476,31,61,0.508,8,21,0.381,15,20,0.75,101,2014-12-23,CHA,MIL,2015,105.0
3616,3616,16,@,W 108-95 ,240,43,97,0.443,33,76,0.434,10,21,0.476,12,14,0.857,108,38,87,0.437,32,65,0.492,6,22,0.273,13,18,0.722,95,2015-01-07,DET,DAL,2015,98.0
3617,3617,17,Home,L 108-118 ,240,42,86,0.488,36,67,0.537,6,19,0.316,18,24,0.75,108,47,85,0.553,42,68,0.618,5,17,0.294,19,28,0.679,118,2015-01-09,SAC,DEN,2015,120.5
3618,3618,18,@,W 108-93 ,240,41,84,0.488,32,60,0.533,9,24,0.375,17,20,0.85,108,32,81,0.395,29,66,0.439,3,15,0.2,26,26,1.0,93,2015-01-10,SAS,MIN,2015,94.5
3619,3619,19,Home,W 108-100 ,240,37,88,0.42,29,64,0.453,8,24,0.333,26,31,0.839,108,31,75,0.413,25,60,0.417,6,15,0.4,32,37,0.865,100,2015-01-12,BOS,NOP,2015,103.0
3620,3620,20,@,W 108-104 (OT),265,43,100,0.43,37,76,0.487,6,24,0.25,16,23,0.696,108,38,86,0.442,37,68,0.544,1,18,0.056,27,34,0.794,104,2015-01-13,DAL,SAC,2015,104.5
3621,3621,21,Home,L 108-117 ,240,41,89,0.461,36,71,0.507,5,18,0.278,21,26,0.808,108,44,92,0.478,35,64,0.547,9,28,0.321,20,31,0.645,117,2015-01-17,SAC,LAC,2015,121.5
3622,3622,22,Home,W 108-94 ,240,41,90,0.456,33,72,0.458,8,18,0.444,18,25,0.72,108,30,80,0.375,22,64,0.344,8,16,0.5,26,32,0.813,94,2015-01-19,CLE,CHI,2015,98.0
3623,3623,23,Home,W 108-73 ,240,42,79,0.532,29,50,0.58,13,29,0.448,11,14,0.786,108,29,75,0.387,24,60,0.4,5,15,0.333,10,16,0.625,73,2015-01-24,UTA,BRK,2015,75.5
3624,3624,24,Home,W 108-98 ,240,36,82,0.439,20,46,0.435,16,36,0.444,20,29,0.69,108,37,94,0.394,27,64,0.422,10,30,0.333,14,18,0.778,98,2015-01-25,CLE,OKC,2015,103.0
3625,3625,25,Home,W 108-103 ,240,36,86,0.419,23,61,0.377,13,25,0.52,23,26,0.885,108,42,92,0.457,35,64,0.547,7,28,0.25,12,17,0.706,103,2015-01-30,NOP,LAC,2015,106.5
3626,3626,26,@,W 108-93 ,240,42,74,0.568,31,53,0.585,11,21,0.524,13,22,0.591,108,33,78,0.423,25,54,0.463,8,24,0.333,19,24,0.792,93,2015-01-31,DAL,ORL,2015,97.0
3627,3627,27,Home,W 108-91 ,240,42,88,0.477,33,68,0.485,9,20,0.45,15,18,0.833,108,35,74,0.473,29,60,0.483,6,14,0.429,15,23,0.652,91,2015-02-03,DET,MIA,2015,94.0
3628,3628,28,@,W 108-97 ,240,42,77,0.545,36,53,0.679,6,24,0.25,18,23,0.783,108,41,83,0.494,34,63,0.54,7,20,0.35,8,11,0.727,97,2015-02-03,BOS,NYK,2015,100.5
3629,3629,29,Home,W 108-87 ,240,40,90,0.444,32,59,0.542,8,31,0.258,20,23,0.87,108,34,88,0.386,28,65,0.431,6,23,0.261,13,17,0.765,87,2015-02-05,POR,PHO,2015,90.0
3630,3630,30,@,L 108-131 ,240,42,90,0.467,30,58,0.517,12,32,0.375,12,17,0.706,108,46,88,0.523,38,68,0.559,8,20,0.4,31,38,0.816,131,2015-02-08,LAC,OKC,2015,135.0
3631,3631,31,@,L 108-119 ,240,40,84,0.476,27,53,0.509,13,31,0.419,15,28,0.536,108,46,83,0.554,35,62,0.565,11,21,0.524,16,22,0.727,119,2015-02-23,PHI,MIA,2015,124.5
3632,3632,32,@,W 108-101 ,240,40,97,0.412,29,65,0.446,11,32,0.344,17,23,0.739,108,40,90,0.444,31,65,0.477,9,25,0.36,12,18,0.667,101,2015-03-01,OKC,LAL,2015,105.5
3633,3633,33,@,L 108-110 ,240,42,90,0.467,31,60,0.517,11,30,0.367,13,18,0.722,108,44,89,0.494,34,68,0.5,10,21,0.476,12,16,0.75,110,2015-03-02,GSW,BRK,2015,115.0
3634,3634,34,Home,W 108-105 ,240,40,87,0.46,33,62,0.532,7,25,0.28,21,26,0.808,108,41,88,0.466,33,68,0.485,8,20,0.4,15,19,0.789,105,2015-03-05,CHI,OKC,2015,109.0
3635,3635,35,@,W 108-100 (OT),265,39,91,0.429,36,65,0.554,3,26,0.115,27,35,0.771,108,34,97,0.351,26,75,0.347,8,22,0.364,24,29,0.828,100,2015-03-06,PHO,BRK,2015,104.0
3636,3636,36,@,W 108-101 ,240,41,79,0.519,35,62,0.565,6,17,0.353,20,23,0.87,108,39,89,0.438,36,75,0.48,3,14,0.214,20,25,0.8,101,2015-03-08,CHA,DET,2015,102.5
3637,3637,37,Home,W 108-104 ,240,42,82,0.512,36,61,0.59,6,21,0.286,18,25,0.72,108,42,98,0.429,31,71,0.437,11,27,0.407,9,9,1.0,104,2015-03-08,OKC,TOR,2015,109.5
3638,3638,38,Home,L 108-120 ,240,33,76,0.434,21,51,0.412,12,25,0.48,30,36,0.833,108,35,76,0.461,20,46,0.435,15,30,0.5,35,47,0.745,120,2015-03-11,OKC,LAC,2015,127.5
3639,3639,39,Home,L 108-123 ,240,42,88,0.477,33,69,0.478,9,19,0.474,15,27,0.556,108,45,76,0.592,27,41,0.659,18,35,0.514,15,19,0.789,123,2015-03-15,ORL,CLE,2015,132.0
3640,3640,40,Home,W 108-89 ,240,44,88,0.5,36,68,0.529,8,20,0.4,12,15,0.8,108,34,84,0.405,26,60,0.433,8,24,0.333,13,24,0.542,89,2015-03-16,BOS,PHI,2015,93.0
3641,3641,41,Home,W 108-105 ,240,40,84,0.476,33,57,0.579,7,27,0.259,21,23,0.913,108,39,85,0.459,31,70,0.443,8,15,0.533,19,21,0.905,105,2015-03-16,GSW,LAL,2015,109.0
3642,3642,42,Home,W 108-104 ,240,46,87,0.529,39,77,0.506,7,10,0.7,9,14,0.643,108,41,81,0.506,31,55,0.564,10,26,0.385,12,21,0.571,104,2015-03-18,MIA,POR,2015,109.0
3643,3643,43,@,L 108-118 ,240,42,93,0.452,29,57,0.509,13,36,0.361,11,19,0.579,108,37,83,0.446,25,53,0.472,12,30,0.4,32,40,0.8,118,2015-03-19,DEN,HOU,2015,124.0
3644,3644,44,Home,W 108-92 ,240,42,79,0.532,33,51,0.647,9,28,0.321,15,17,0.882,108,30,79,0.38,20,54,0.37,10,25,0.4,22,26,0.846,92,2015-03-20,CHI,TOR,2015,97.0
3645,3645,45,Home,W 108-91 ,240,43,81,0.531,36,65,0.554,7,16,0.438,15,19,0.789,108,37,79,0.468,30,52,0.577,7,27,0.259,10,19,0.526,91,2015-03-20,MIA,DEN,2015,94.5
3646,3646,46,@,W 108-90 ,240,42,84,0.5,29,53,0.547,13,31,0.419,11,16,0.688,108,38,70,0.543,35,58,0.603,3,12,0.25,11,14,0.786,90,2015-03-22,CLE,MIL,2015,91.5
3647,3647,47,Home,W 108-104 ,240,40,93,0.43,28,64,0.438,12,29,0.414,16,24,0.667,108,35,75,0.467,28,52,0.538,7,23,0.304,27,29,0.931,104,2015-03-24,DET,TOR,2015,107.5
3648,3648,48,Home,L 108-122 ,240,39,92,0.424,24,58,0.414,15,34,0.441,15,19,0.789,108,50,83,0.602,38,57,0.667,12,26,0.462,10,11,0.909,122,2015-03-24,POR,GSW,2015,128.0
3649,3649,49,@,W 108-99 ,240,40,81,0.494,32,60,0.533,8,21,0.381,20,23,0.87,108,38,87,0.437,32,62,0.516,6,25,0.24,17,26,0.654,99,2015-03-25,SAC,PHO,2015,102.0
3650,3650,50,@,W 108-95 ,240,42,82,0.512,30,57,0.526,12,25,0.48,12,14,0.857,108,33,87,0.379,31,72,0.431,2,15,0.133,27,32,0.844,95,2015-03-28,GSW,MIL,2015,96.0
3651,3651,51,@,W 108-101 ,240,34,77,0.442,23,46,0.5,11,31,0.355,29,40,0.725,108,37,84,0.44,29,58,0.5,8,26,0.308,19,27,0.704,101,2015-04-02,HOU,DAL,2015,105.0
3652,3652,52,Home,W 108-99 ,240,39,85,0.459,30,64,0.469,9,21,0.429,21,27,0.778,108,36,87,0.414,27,58,0.466,9,29,0.31,18,24,0.75,99,2015-04-12,WAS,ATL,2015,103.5
3653,3653,53,Home,L 108-112 ,240,39,88,0.443,28,56,0.5,11,32,0.344,19,23,0.826,108,43,77,0.558,30,52,0.577,13,25,0.52,13,19,0.684,112,2015-04-13,ATL,NYK,2015,118.5
3654,3654,54,@,L 108-113 (OT),265,42,97,0.433,34,75,0.453,8,22,0.364,16,21,0.762,108,43,91,0.473,27,61,0.443,16,30,0.533,11,17,0.647,113,2015-04-15,WAS,CLE,2015,121.0
3655,3655,55,Home,W 108-103 ,240,43,83,0.518,38,73,0.521,5,10,0.5,17,25,0.68,108,45,79,0.57,42,69,0.609,3,10,0.3,10,13,0.769,103,2015-04-15,NOP,SAS,2015,104.5
3656,3656,56,@,L 108-112 ,240,43,88,0.489,35,66,0.53,8,22,0.364,14,22,0.636,108,39,85,0.459,29,59,0.492,10,26,0.385,24,31,0.774,112,2015-11-04,LAC,GSW,2016,117.0
3657,3657,57,@,W 108-92 ,240,41,77,0.532,30,52,0.577,11,25,0.44,15,32,0.469,108,33,88,0.375,28,64,0.438,5,24,0.208,21,33,0.636,92,2015-11-04,POR,UTA,2016,94.5
3658,3658,58,@,W 108-94 ,240,44,89,0.494,38,62,0.613,6,27,0.222,14,17,0.824,108,32,82,0.39,26,53,0.491,6,29,0.207,24,27,0.889,94,2015-11-05,CHA,DAL,2016,97.0
3659,3659,59,Home,W 108-102 ,240,45,88,0.511,35,62,0.565,10,26,0.385,8,12,0.667,108,41,79,0.519,31,56,0.554,10,23,0.435,10,15,0.667,102,2015-11-06,CLE,PHI,2016,107.0
3660,3660,60,Home,W 108-104 ,240,40,77,0.519,33,58,0.569,7,19,0.368,21,32,0.656,108,36,91,0.396,26,62,0.419,10,29,0.345,22,27,0.815,104,2015-11-09,DEN,POR,2016,109.0
3661,3661,61,@,L 108-118 ,240,37,86,0.43,25,59,0.424,12,27,0.444,22,33,0.667,108,42,76,0.553,31,52,0.596,11,24,0.458,23,30,0.767,118,2015-11-11,LAC,DAL,2016,123.5
3662,3662,62,Home,W 108-105 (2OT),290,43,102,0.422,37,86,0.43,6,16,0.375,16,22,0.727,108,37,91,0.407,23,53,0.434,14,38,0.368,17,27,0.63,105,2015-11-14,MIL,CLE,2016,112.0
3663,3663,63,Home,W 108-99 ,240,39,83,0.47,27,54,0.5,12,29,0.414,18,26,0.692,108,38,87,0.437,34,69,0.493,4,18,0.222,19,24,0.792,99,2015-11-14,WAS,ORL,2016,101.0
3664,3664,64,Home,W 108-103 (OT),265,32,92,0.348,18,48,0.375,14,44,0.318,30,35,0.857,108,35,88,0.398,26,58,0.448,9,30,0.3,24,29,0.828,103,2015-11-18,HOU,POR,2016,107.5
3665,3665,65,Home,W 108-96 ,240,38,78,0.487,26,48,0.542,12,30,0.4,20,26,0.769,108,36,82,0.439,29,59,0.492,7,23,0.304,17,23,0.739,96,2015-11-28,POR,LAL,2016,99.5
3666,3666,66,Home,W 108-88 ,240,40,85,0.471,31,68,0.456,9,17,0.529,19,20,0.95,108,37,87,0.425,31,61,0.508,6,26,0.231,8,13,0.615,88,2015-11-28,SAS,ATL,2016,91.0
3667,3667,67,Home,W 108-101 ,240,36,87,0.414,28,60,0.467,8,27,0.296,28,39,0.718,108,36,88,0.409,29,63,0.46,7,25,0.28,22,25,0.88,101,2015-12-02,HOU,NOP,2016,104.5
3668,3668,68,@,W 108-104 ,240,41,96,0.427,33,71,0.465,8,25,0.32,18,20,0.9,108,37,79,0.468,30,58,0.517,7,21,0.333,23,31,0.742,104,2015-12-02,LAL,WAS,2016,107.5
3669,3669,69,@,L 108-114 (OT),265,39,89,0.438,29,56,0.518,10,33,0.303,20,24,0.833,108,42,85,0.494,33,60,0.55,9,25,0.36,21,31,0.677,114,2015-12-04,CLE,NOP,2016,118.5
3670,3670,70,Home,W 108-91 ,240,39,87,0.448,27,60,0.45,12,27,0.444,18,21,0.857,108,39,91,0.429,36,80,0.45,3,11,0.273,10,15,0.667,91,2015-12-04,NYK,BRK,2016,92.5
3671,3671,71,@,W 108-105 ,240,37,81,0.457,26,50,0.52,11,31,0.355,23,38,0.605,108,37,74,0.5,22,43,0.512,15,31,0.484,16,26,0.615,105,2015-12-05,DEN,PHI,2016,112.5
3672,3672,72,Home,W 108-105 ,240,44,83,0.53,39,66,0.591,5,17,0.294,15,22,0.682,108,39,86,0.453,27,57,0.474,12,29,0.414,15,22,0.682,105,2015-12-05,SAS,BOS,2016,111.0
3673,3673,73,@,L 108-111 (OT),265,38,87,0.437,31,68,0.456,7,19,0.368,25,29,0.862,108,38,86,0.442,27,58,0.466,11,28,0.393,24,33,0.727,111,2015-12-11,MIN,DEN,2016,116.5
3674,3674,74,Home,W 108-95 ,240,44,90,0.489,38,76,0.5,6,14,0.429,14,18,0.778,108,36,89,0.404,30,62,0.484,6,27,0.222,17,25,0.68,95,2015-12-12,MIL,GSW,2016,98.0
3675,3675,75,Home,W 108-101 ,240,39,87,0.448,29,57,0.509,10,30,0.333,20,24,0.833,108,33,73,0.452,25,54,0.463,8,19,0.421,27,34,0.794,101,2015-12-13,PHO,MIN,2016,105.0
3676,3676,76,@,L 108-114 ,240,41,87,0.471,23,47,0.489,18,40,0.45,8,11,0.727,108,42,82,0.512,34,57,0.596,8,25,0.32,22,25,0.88,114,2015-12-14,HOU,DEN,2016,118.0
3677,3677,77,@,W 108-94 ,240,41,80,0.513,33,59,0.559,8,21,0.381,18,22,0.818,108,35,74,0.473,26,49,0.531,9,25,0.36,15,17,0.882,94,2015-12-18,TOR,MIA,2016,98.5
3678,3678,78,Home,W 108-86 ,240,40,85,0.471,29,60,0.483,11,25,0.44,17,21,0.81,108,30,86,0.349,25,62,0.403,5,24,0.208,21,30,0.7,86,2015-12-20,CLE,PHI,2016,88.5
3679,3679,79,@,W 108-106 ,240,46,89,0.517,42,66,0.636,4,23,0.174,12,16,0.75,108,41,89,0.461,29,57,0.509,12,32,0.375,12,20,0.6,106,2015-12-23,SAC,IND,2016,112.0
3680,3680,80,@,W 108-83 ,240,44,82,0.537,34,58,0.586,10,24,0.417,10,14,0.714,108,30,72,0.417,27,62,0.435,3,10,0.3,20,25,0.8,83,2015-12-23,SAS,MIN,2016,84.5
3681,3681,81,@,L 108-110 ,240,38,84,0.452,23,51,0.451,15,33,0.455,17,20,0.85,108,38,75,0.507,25,51,0.49,13,24,0.542,21,26,0.808,110,2015-12-26,HOU,NOP,2016,116.5
3682,3682,82,@,W 108-101 ,240,38,77,0.494,28,57,0.491,10,20,0.5,22,23,0.957,108,43,79,0.544,34,60,0.567,9,19,0.474,6,13,0.462,101,2015-12-26,MIA,ORL,2016,105.5
3683,3683,83,Home,W 108-98 ,240,43,89,0.483,37,64,0.578,6,25,0.24,16,22,0.727,108,35,85,0.412,26,56,0.464,9,29,0.31,19,23,0.826,98,2015-12-28,CHA,LAL,2016,102.5
3684,3684,84,@,W 108-91 ,240,41,78,0.526,34,55,0.618,7,23,0.304,19,25,0.76,108,34,87,0.391,27,63,0.429,7,24,0.292,16,24,0.667,91,2015-12-28,LAC,WAS,2016,94.5
3685,3685,85,Home,W 108-96 ,240,43,79,0.544,35,63,0.556,8,16,0.5,14,17,0.824,108,37,89,0.416,27,62,0.435,10,27,0.37,12,17,0.706,96,2015-12-29,NYK,DET,2016,101.0
3686,3686,86,Home,W 108-81 ,240,39,85,0.459,29,69,0.42,10,16,0.625,20,25,0.8,108,31,84,0.369,25,65,0.385,6,19,0.316,13,17,0.765,81,2016-01-01,CHI,NYK,2016,84.0
3687,3687,87,@,L 108-111 (OT),265,44,105,0.419,39,75,0.52,5,30,0.167,15,23,0.652,108,43,86,0.5,33,58,0.569,10,28,0.357,15,23,0.652,111,2016-01-02,DEN,GSW,2016,116.0
3688,3688,88,Home,L 108-128 ,240,38,96,0.396,26,63,0.413,12,33,0.364,20,28,0.714,108,46,87,0.529,28,55,0.509,18,32,0.563,18,21,0.857,128,2016-01-08,POR,GSW,2016,137.0
3689,3689,89,@,W 108-95 ,240,41,75,0.547,36,58,0.621,5,17,0.294,21,27,0.778,108,39,80,0.488,28,63,0.444,11,17,0.647,6,14,0.429,95,2016-01-09,TOR,PHI,2016,100.5
3690,3690,90,Home,W 108-89 ,240,38,82,0.463,23,49,0.469,15,33,0.455,17,29,0.586,108,32,82,0.39,26,51,0.51,6,31,0.194,19,25,0.76,89,2016-01-13,OKC,DAL,2016,92.0
3691,3691,91,Home,W 108-101 (OT),265,40,96,0.417,37,86,0.43,3,10,0.3,25,37,0.676,108,43,100,0.43,34,70,0.486,9,30,0.3,6,6,1.0,101,2016-01-15,MIL,ATL,2016,105.5
3692,3692,92,@,W 108-98 ,240,43,84,0.512,26,53,0.491,17,31,0.548,5,11,0.455,108,37,77,0.481,28,56,0.5,9,21,0.429,15,20,0.75,98,2016-01-18,POR,WAS,2016,102.5
3693,3693,93,@,W 108-86 ,240,43,75,0.573,34,59,0.576,9,16,0.563,13,15,0.867,108,33,75,0.44,27,59,0.458,6,16,0.375,14,18,0.778,86,2016-01-22,UTA,BRK,2016,89.0
3694,3694,94,@,W 108-95 ,240,43,85,0.506,32,64,0.5,11,21,0.524,11,13,0.846,108,38,84,0.452,32,68,0.471,6,16,0.375,13,18,0.722,95,2016-01-22,SAS,LAL,2016,98.0
3695,3695,95,Home,W 108-97 ,240,38,85,0.447,33,69,0.478,5,16,0.313,27,36,0.75,108,36,86,0.419,29,67,0.433,7,19,0.368,18,25,0.72,97,2016-01-23,SAC,IND,2016,100.5
3696,3696,96,Home,W 108-102 (OT),265,43,100,0.43,37,82,0.451,6,18,0.333,16,25,0.64,108,40,86,0.465,30,58,0.517,10,28,0.357,12,14,0.857,102,2016-01-25,MEM,ORL,2016,107.0
3697,3697,97,@,L 108-116 ,240,36,95,0.379,27,56,0.482,9,39,0.231,27,43,0.628,108,41,86,0.477,33,67,0.493,8,19,0.421,26,30,0.867,116,2016-01-29,HOU,OKC,2016,120.0
3698,3698,98,@,W 108-105 ,240,47,95,0.495,34,65,0.523,13,30,0.433,1,2,0.5,108,42,92,0.457,32,63,0.508,10,29,0.345,11,21,0.524,105,2016-01-30,GSW,PHI,2016,110.0
3699,3699,99,@,W 108-102 ,240,39,77,0.506,31,60,0.517,8,17,0.471,22,26,0.846,108,33,75,0.44,22,43,0.512,11,32,0.344,25,34,0.735,102,2016-02-03,MIN,LAC,2016,107.5
3700,3700,0,Home,W 108-104 ,240,38,81,0.469,26,54,0.481,12,27,0.444,20,25,0.8,108,38,86,0.442,29,61,0.475,9,25,0.36,19,24,0.792,104,2016-02-06,CHA,WAS,2016,108.5
3701,3701,1,@,L 108-116 ,240,36,85,0.424,29,63,0.46,7,22,0.318,29,37,0.784,108,48,97,0.495,41,71,0.577,7,26,0.269,13,20,0.65,116,2016-02-06,OKC,GSW,2016,119.5
3702,3702,2,Home,W 108-91 ,240,35,80,0.438,21,44,0.477,14,36,0.389,24,31,0.774,108,35,90,0.389,25,65,0.385,10,25,0.4,11,14,0.786,91,2016-02-08,CHA,CHI,2016,96.0
3703,3703,3,Home,L 108-111 ,240,44,83,0.53,36,57,0.632,8,26,0.308,12,14,0.857,108,39,78,0.5,23,52,0.442,16,26,0.615,17,25,0.68,111,2016-02-09,NYK,WAS,2016,119.0
3704,3704,4,Home,W 108-101 ,240,44,86,0.512,39,70,0.557,5,16,0.313,15,25,0.6,108,28,76,0.368,16,47,0.34,12,29,0.414,33,43,0.767,101,2016-02-22,MIL,LAL,2016,107.0
3705,3705,5,Home,W 108-105 ,240,46,91,0.505,43,76,0.566,3,15,0.2,13,16,0.813,108,35,77,0.455,22,51,0.431,13,26,0.5,22,25,0.88,105,2016-02-24,IND,NYK,2016,111.5
3706,3706,6,@,W 108-92 ,240,44,85,0.518,36,66,0.545,8,19,0.421,12,15,0.8,108,39,96,0.406,33,78,0.423,6,18,0.333,8,15,0.533,92,2016-02-24,SAS,SAC,2016,95.0
3707,3707,7,Home,W 108-95 ,240,37,80,0.463,33,64,0.516,4,16,0.25,30,36,0.833,108,39,93,0.419,33,66,0.5,6,27,0.222,11,16,0.688,95,2016-02-26,NYK,ORL,2016,98.0
3708,3708,8,@,L 108-116 ,240,43,89,0.483,33,57,0.579,10,32,0.313,12,21,0.571,108,43,89,0.483,37,69,0.536,6,20,0.3,24,31,0.774,116,2016-02-29,PHI,WAS,2016,119.0
3709,3709,9,@,L 108-121 ,240,41,91,0.451,32,61,0.525,9,30,0.3,17,20,0.85,108,43,77,0.558,34,58,0.586,9,19,0.474,26,31,0.839,121,2016-03-01,ORL,DAL,2016,125.5
3710,3710,10,Home,W 108-92 ,240,40,83,0.482,31,66,0.47,9,17,0.529,19,25,0.76,108,33,82,0.402,28,60,0.467,5,22,0.227,21,27,0.778,92,2016-03-03,MIA,PHO,2016,94.5
3711,3711,11,Home,W 108-101 ,240,38,79,0.481,25,48,0.521,13,31,0.419,19,23,0.826,108,37,90,0.411,28,62,0.452,9,28,0.321,18,21,0.857,101,2016-03-04,CHA,IND,2016,105.5
3712,3712,12,Home,W 108-83 ,240,42,90,0.467,30,63,0.476,12,27,0.444,12,16,0.75,108,32,81,0.395,29,61,0.475,3,20,0.15,16,24,0.667,83,2016-03-04,CLE,WAS,2016,84.5
3713,3713,13,Home,W 108-100 ,240,36,79,0.456,27,58,0.466,9,21,0.429,27,34,0.794,108,35,87,0.402,26,52,0.5,9,35,0.257,21,30,0.7,100,2016-03-05,CHI,HOU,2016,104.5
3714,3714,14,Home,W 108-103 ,240,41,90,0.456,29,60,0.483,12,30,0.4,14,17,0.824,108,39,80,0.488,35,65,0.538,4,15,0.267,21,24,0.875,103,2016-03-07,CHA,MIN,2016,105.0
3715,3715,15,@,L 108-114 ,240,42,80,0.525,36,65,0.554,6,15,0.4,18,19,0.947,108,42,80,0.525,38,72,0.528,4,8,0.5,26,37,0.703,114,2016-03-09,MIA,MIL,2016,116.0
3716,3716,16,@,L 108-120 ,240,41,81,0.506,29,47,0.617,12,34,0.353,14,23,0.609,108,48,91,0.527,39,67,0.582,9,24,0.375,15,18,0.833,120,2016-03-09,LAC,OKC,2016,124.5
3717,3717,17,Home,L 108-120 ,240,42,80,0.525,35,58,0.603,7,22,0.318,17,21,0.81,108,45,85,0.529,29,50,0.58,16,35,0.457,14,20,0.7,120,2016-03-10,LAL,CLE,2016,128.0
3718,3718,18,@,W 108-99 ,240,39,82,0.476,27,54,0.5,12,28,0.429,18,22,0.818,108,38,81,0.469,29,60,0.483,9,21,0.429,14,21,0.667,99,2016-03-13,UTA,SAC,2016,103.5
3719,3719,19,Home,W 108-87 ,240,44,82,0.537,36,62,0.581,8,20,0.4,12,16,0.75,108,32,69,0.464,24,50,0.48,8,19,0.421,15,22,0.682,87,2016-03-15,SAS,LAC,2016,91.0
3720,3720,20,Home,L 108-114 ,240,44,100,0.44,40,80,0.5,4,20,0.2,16,21,0.762,108,40,71,0.563,30,50,0.6,10,21,0.476,24,31,0.774,114,2016-03-16,MEM,MIN,2016,119.0
3721,3721,21,Home,L 108-123 ,240,42,90,0.467,33,72,0.458,9,18,0.5,15,17,0.882,108,49,90,0.544,37,69,0.536,12,21,0.571,13,16,0.813,123,2016-03-16,SAC,NOP,2016,129.0
3722,3722,22,@,L 108-115 ,240,40,79,0.506,36,64,0.563,4,15,0.267,24,29,0.828,108,44,92,0.478,32,66,0.485,12,26,0.462,15,18,0.833,115,2016-03-18,SAC,DET,2016,121.0
3723,3723,23,Home,W 108-97 ,240,40,80,0.5,35,65,0.538,5,15,0.333,23,33,0.697,108,36,84,0.429,30,66,0.455,6,18,0.333,19,28,0.679,97,2016-03-25,MIA,ORL,2016,100.0
3724,3724,24,Home,W 108-105 ,240,38,91,0.418,30,66,0.455,8,25,0.32,24,30,0.8,108,39,93,0.419,29,55,0.527,10,38,0.263,17,24,0.708,105,2016-03-26,POR,PHI,2016,110.0
3725,3725,25,Home,L 108-110 (OT),265,38,95,0.4,29,65,0.446,9,30,0.3,23,26,0.885,108,39,98,0.398,27,60,0.45,12,38,0.316,20,31,0.645,110,2016-04-01,ATL,CLE,2016,116.0
3726,3726,26,Home,W 108-92 ,240,39,87,0.448,32,68,0.471,7,19,0.368,23,26,0.885,108,34,77,0.442,23,48,0.479,11,29,0.379,13,19,0.684,92,2016-04-05,MEM,CHI,2016,97.5
3727,3727,27,@,W 108-104 ,240,39,86,0.453,28,59,0.475,11,27,0.407,19,31,0.613,108,43,90,0.478,39,75,0.52,4,15,0.267,14,19,0.737,104,2016-04-06,DET,ORL,2016,106.0
3728,3728,28,Home,L 108-109 (OT),265,39,96,0.406,26,50,0.52,13,46,0.283,17,25,0.68,108,40,87,0.46,33,64,0.516,7,23,0.304,22,24,0.917,109,2016-04-10,PHI,MIL,2016,112.5
3729,3729,29,@,W 108-96 ,240,47,97,0.485,43,81,0.531,4,16,0.25,10,16,0.625,108,34,89,0.382,28,71,0.394,6,18,0.333,22,28,0.786,96,2016-10-26,MIA,ORL,2017,99.0
3730,3730,30,Home,W 108-82 ,240,48,95,0.505,41,76,0.539,7,19,0.368,5,6,0.833,108,33,95,0.347,25,69,0.362,8,26,0.308,8,12,0.667,82,2016-10-28,DET,ORL,2017,86.0
3731,3731,31,@,L 108-110 ,240,37,84,0.44,26,50,0.52,11,34,0.324,23,28,0.821,108,41,88,0.466,33,66,0.5,8,22,0.364,20,24,0.833,110,2016-10-29,BRK,MIL,2017,114.0
3732,3732,32,@,L 108-115 ,240,40,89,0.449,34,61,0.557,6,28,0.214,22,25,0.88,108,41,87,0.471,31,59,0.525,10,28,0.357,23,29,0.793,115,2016-11-01,LAL,IND,2017,120.0
3733,3733,33,Home,W 108-96 (OT),265,37,86,0.43,24,57,0.421,13,29,0.448,21,29,0.724,108,34,89,0.382,29,66,0.439,5,23,0.217,23,27,0.852,96,2016-11-01,MIA,SAC,2017,98.5
3734,3734,34,@,L 108-119 ,240,40,91,0.44,34,71,0.479,6,20,0.3,22,28,0.786,108,41,90,0.456,31,67,0.463,10,23,0.435,27,35,0.771,119,2016-11-06,PHO,LAL,2017,124.0
3735,3735,35,Home,W 108-107 ,240,44,86,0.512,37,62,0.597,7,24,0.292,13,19,0.684,108,35,70,0.5,25,46,0.543,10,24,0.417,27,34,0.794,107,2016-11-08,MEM,DEN,2017,112.0
3736,3736,36,Home,L 108-110 ,240,38,88,0.432,22,60,0.367,16,28,0.571,16,19,0.842,108,39,86,0.453,28,59,0.475,11,27,0.407,21,35,0.6,110,2016-11-11,OKC,LAC,2017,115.5
3737,3737,37,Home,L 108-115 ,240,38,89,0.427,23,54,0.426,15,35,0.429,17,21,0.81,108,43,80,0.538,32,56,0.571,11,24,0.458,18,22,0.818,115,2016-11-15,MIN,CHO,2017,120.5
3738,3738,38,Home,W 108-83 ,240,39,79,0.494,31,53,0.585,8,26,0.308,22,31,0.71,108,28,88,0.318,19,61,0.311,9,27,0.333,18,31,0.581,83,2016-11-23,UTA,DEN,2017,87.5
3739,3739,39,Home,W 108-97 ,240,47,90,0.522,38,71,0.535,9,19,0.474,5,7,0.714,108,35,73,0.479,28,52,0.538,7,21,0.333,20,26,0.769,97,2016-11-25,DET,LAC,2017,100.5
3740,3740,40,Home,L 108-112 ,240,43,92,0.467,28,58,0.483,15,34,0.441,7,10,0.7,108,38,92,0.413,26,52,0.5,12,40,0.3,24,28,0.857,112,2016-11-27,PHI,CLE,2017,118.0
3741,3741,41,Home,L 108-110 (2OT),290,39,99,0.394,29,67,0.433,10,32,0.313,20,21,0.952,108,42,104,0.404,29,70,0.414,13,34,0.382,13,21,0.619,110,2016-12-05,NOP,MEM,2017,116.5
3742,3742,42,Home,L 108-116 ,240,36,81,0.444,27,57,0.474,9,24,0.375,27,36,0.75,108,38,83,0.458,25,51,0.49,13,32,0.406,27,30,0.9,116,2016-12-11,MIN,GSW,2017,122.5
3743,3743,43,Home,L 108-113 ,240,42,89,0.472,28,56,0.5,14,33,0.424,10,20,0.5,108,37,74,0.5,24,49,0.49,13,25,0.52,26,37,0.703,113,2016-12-14,ORL,LAC,2017,119.5
3744,3744,44,Home,W 108-101 ,240,44,80,0.55,36,58,0.621,8,22,0.364,12,14,0.857,108,37,84,0.44,27,53,0.509,10,31,0.323,17,20,0.85,101,2016-12-14,SAS,BOS,2017,106.0
3745,3745,45,Home,W 108-97 ,240,45,95,0.474,34,75,0.453,11,20,0.55,7,13,0.538,108,35,74,0.473,30,55,0.545,5,19,0.263,22,29,0.759,97,2016-12-15,MIL,CHI,2017,99.5
3746,3746,46,@,L 108-122 ,240,42,86,0.488,32,58,0.552,10,28,0.357,14,21,0.667,108,44,77,0.571,32,52,0.615,12,25,0.48,22,27,0.815,122,2016-12-16,DET,WAS,2017,128.0
3747,3747,47,@,L 108-119 ,240,41,86,0.477,25,49,0.51,16,37,0.432,10,13,0.769,108,46,89,0.517,31,56,0.554,15,33,0.455,12,18,0.667,119,2016-12-17,LAL,CLE,2017,126.5
3748,3748,48,Home,W 108-107 ,240,38,88,0.432,26,60,0.433,12,28,0.429,20,23,0.87,108,36,81,0.444,24,47,0.511,12,34,0.353,23,31,0.742,107,2016-12-18,PHI,BRK,2017,113.0
3749,3749,49,@,L 108-115 ,240,37,82,0.451,28,61,0.459,9,21,0.429,25,35,0.714,108,42,86,0.488,35,67,0.522,7,19,0.368,24,25,0.96,115,2016-12-19,PHO,MIN,2017,118.5
3750,3750,50,Home,L 108-110 ,240,39,87,0.448,29,52,0.558,10,35,0.286,20,26,0.769,108,41,75,0.547,32,52,0.615,9,23,0.391,19,24,0.792,110,2016-12-19,OKC,ATL,2017,114.5
3751,3751,51,Home,L 108-114 (OT),265,40,87,0.46,33,60,0.55,7,27,0.259,21,29,0.724,108,37,91,0.407,20,51,0.392,17,40,0.425,23,27,0.852,114,2016-12-20,MIL,CLE,2017,122.5
3752,3752,52,@,W 108-93 ,240,40,93,0.43,30,76,0.395,10,17,0.588,18,26,0.692,108,33,82,0.402,22,49,0.449,11,33,0.333,16,21,0.762,93,2016-12-20,NOP,PHI,2017,98.5
3753,3753,53,Home,L 108-109 ,240,37,78,0.474,29,53,0.547,8,25,0.32,26,35,0.743,108,37,86,0.43,29,61,0.475,8,25,0.32,27,33,0.818,109,2016-12-23,DEN,ATL,2017,113.0
3754,3754,54,@,L 108-109 ,240,37,77,0.481,28,47,0.596,9,30,0.3,25,29,0.862,108,37,95,0.389,25,60,0.417,12,35,0.343,23,32,0.719,109,2016-12-25,GSW,CLE,2017,115.0
3755,3755,55,Home,W 108-99 ,240,42,84,0.5,31,51,0.608,11,33,0.333,13,15,0.867,108,39,93,0.419,31,61,0.508,8,32,0.25,13,15,0.867,99,2016-12-30,GSW,DAL,2017,103.0
3756,3756,56,Home,L 108-116 ,240,41,91,0.451,32,61,0.525,9,30,0.3,17,19,0.895,108,38,88,0.432,29,55,0.527,9,33,0.273,31,43,0.721,116,2017-01-06,BRK,CLE,2017,120.5
3757,3757,57,@,L 108-117 ,240,40,85,0.471,30,54,0.556,10,31,0.323,18,23,0.783,108,40,93,0.43,22,57,0.386,18,36,0.5,19,21,0.905,117,2017-01-07,NOP,BOS,2017,126.0
3758,3758,58,@,W 108-87 ,240,43,85,0.506,36,64,0.563,7,21,0.333,15,20,0.75,108,32,83,0.386,23,59,0.39,9,24,0.375,14,26,0.538,87,2017-01-10,POR,LAL,2017,91.5
3759,3759,59,@,L 108-117 ,240,45,105,0.429,35,79,0.443,10,26,0.385,8,12,0.667,108,43,85,0.506,26,44,0.591,17,41,0.415,14,18,0.778,117,2017-01-11,WAS,BOS,2017,125.5
3760,3760,60,Home,L 108-113 ,240,38,78,0.487,28,60,0.467,10,18,0.556,22,27,0.815,108,43,89,0.483,28,55,0.509,15,34,0.441,12,17,0.706,113,2017-01-12,PHO,DAL,2017,120.5
3761,3761,61,@,L 108-116 ,240,41,83,0.494,29,51,0.569,12,32,0.375,14,18,0.778,108,40,80,0.5,31,65,0.477,9,15,0.6,27,31,0.871,116,2017-01-13,MIA,MIL,2017,120.5
3762,3762,62,Home,L 108-120 ,240,42,80,0.525,33,55,0.6,9,25,0.36,15,19,0.789,108,44,87,0.506,29,50,0.58,15,37,0.405,17,22,0.773,120,2017-01-13,SAC,CLE,2017,127.5
3763,3763,63,Home,W 108-105 ,240,39,85,0.459,31,64,0.484,8,21,0.381,22,24,0.917,108,36,71,0.507,27,51,0.529,9,20,0.45,24,34,0.706,105,2017-01-14,PHO,SAS,2017,109.5
3764,3764,64,@,W 108-104 ,240,40,78,0.513,36,61,0.59,4,17,0.235,24,35,0.686,108,40,95,0.421,29,63,0.46,11,32,0.344,13,13,1.0,104,2017-01-15,CHI,MEM,2017,109.5
3765,3765,65,Home,W 108-98 ,240,42,84,0.5,27,45,0.6,15,39,0.385,9,10,0.9,108,38,86,0.442,30,61,0.492,8,25,0.32,14,17,0.824,98,2017-01-16,BOS,CHO,2017,102.0
3766,3766,66,@,W 108-107 ,240,40,87,0.46,28,55,0.509,12,32,0.375,16,23,0.696,108,42,85,0.494,34,59,0.576,8,26,0.308,15,23,0.652,107,2017-01-16,ATL,NYK,2017,111.0
3767,3767,67,Home,L 108-125 ,240,43,96,0.448,36,61,0.59,7,35,0.2,15,18,0.833,108,47,89,0.528,32,51,0.627,15,38,0.395,16,21,0.762,125,2017-01-20,HOU,GSW,2017,132.5
3768,3768,68,Home,W 108-95 ,240,41,87,0.471,27,54,0.5,14,33,0.424,12,15,0.8,108,34,80,0.425,25,57,0.439,9,23,0.391,18,25,0.72,95,2017-01-20,LAL,IND,2017,99.5
3769,3769,69,@,L 108-111 ,240,42,82,0.512,35,58,0.603,7,24,0.292,17,21,0.81,108,45,85,0.529,39,70,0.557,6,15,0.4,15,21,0.714,111,2017-01-22,DEN,MIN,2017,114.0
3770,3770,70,@,W 108-106 ,240,38,85,0.447,31,61,0.508,7,24,0.292,25,33,0.758,108,38,84,0.452,32,59,0.542,6,25,0.24,24,28,0.857,106,2017-01-24,SAS,TOR,2017,109.0
3771,3771,71,@,L 108-123 ,240,38,84,0.452,28,51,0.549,10,33,0.303,22,24,0.917,108,48,83,0.578,39,63,0.619,9,20,0.45,18,21,0.857,123,2017-01-24,BOS,WAS,2017,127.5
3772,3772,72,Home,L 108-112 (OT),265,37,87,0.425,28,66,0.424,9,21,0.429,25,32,0.781,108,37,89,0.416,23,49,0.469,14,40,0.35,24,30,0.8,112,2017-01-28,MIL,BOS,2017,119.0
3773,3773,73,@,L 108-121 ,240,44,99,0.444,34,71,0.479,10,28,0.357,10,14,0.714,108,45,89,0.506,37,75,0.493,8,14,0.571,23,28,0.821,121,2017-01-29,PHI,CHI,2017,125.0
3774,3774,74,Home,W 108-94 ,240,37,86,0.43,30,65,0.462,7,21,0.333,27,38,0.711,108,30,85,0.353,23,57,0.404,7,28,0.25,27,32,0.844,94,2017-01-31,SAS,OKC,2017,97.5
3775,3775,75,Home,W 108-106 (OT),265,43,94,0.457,33,63,0.524,10,31,0.323,12,15,0.8,108,40,94,0.426,28,64,0.438,12,30,0.4,14,19,0.737,106,2017-01-31,TOR,NOP,2017,112.0
3776,3776,76,Home,L 108-113 ,240,35,93,0.376,22,42,0.524,13,51,0.255,25,33,0.758,108,44,85,0.518,36,55,0.655,8,30,0.267,17,23,0.739,113,2017-02-02,HOU,ATL,2017,117.0
3777,3777,77,@,L 108-116 ,240,40,87,0.46,28,48,0.583,12,39,0.308,16,22,0.727,108,44,96,0.458,32,63,0.508,12,33,0.364,16,21,0.762,116,2017-02-02,LAL,WAS,2017,122.0
3778,3778,78,@,L 108-116 ,240,44,89,0.494,39,72,0.542,5,17,0.294,15,19,0.789,108,44,98,0.449,33,72,0.458,11,26,0.423,17,22,0.773,116,2017-02-03,MIN,DET,2017,121.5
3779,3779,79,@,W 108-104 ,240,36,76,0.474,19,45,0.422,17,31,0.548,19,23,0.826,108,40,88,0.455,31,58,0.534,9,30,0.3,15,20,0.75,104,2017-02-03,DAL,POR,2017,108.5
3780,3780,80,Home,W 108-92 ,240,42,84,0.5,32,59,0.542,10,25,0.4,14,15,0.933,108,29,73,0.397,19,41,0.463,10,32,0.313,24,27,0.889,92,2017-02-08,SAC,BOS,2017,97.0
3781,3781,81,@,W 108-99 ,240,41,92,0.446,34,69,0.493,7,23,0.304,19,21,0.905,108,35,81,0.432,27,61,0.443,8,20,0.4,21,28,0.75,99,2017-02-10,MIA,BRK,2017,103.0
3782,3782,82,Home,W 108-107 ,240,38,80,0.475,20,44,0.455,18,36,0.5,14,21,0.667,108,36,71,0.507,25,41,0.61,11,30,0.367,24,31,0.774,107,2017-02-10,SAC,ATL,2017,112.5
3783,3783,83,Home,L 108-110 ,240,40,93,0.43,32,70,0.457,8,23,0.348,20,24,0.833,108,37,78,0.474,29,50,0.58,8,28,0.286,28,35,0.8,110,2017-02-13,PHO,NOP,2017,114.0
3784,3784,84,Home,L 108-116 ,240,42,86,0.488,33,63,0.524,9,23,0.391,15,19,0.789,108,44,86,0.512,31,47,0.66,13,39,0.333,15,22,0.682,116,2017-02-14,MIN,CLE,2017,122.5
3785,3785,85,@,L 108-116 ,240,44,93,0.473,36,62,0.581,8,31,0.258,12,18,0.667,108,38,80,0.475,25,52,0.481,13,28,0.464,27,36,0.75,116,2017-02-15,PHI,BOS,2017,122.5
3786,3786,86,@,L 108-114 (OT),265,38,92,0.413,31,62,0.5,7,30,0.233,25,26,0.962,108,44,107,0.411,29,70,0.414,15,37,0.405,11,12,0.917,114,2017-02-23,CHA,DET,2017,121.5
3787,3787,87,@,W 108-90 ,240,40,99,0.404,23,62,0.371,17,37,0.459,11,13,0.846,108,30,79,0.38,24,59,0.407,6,20,0.3,24,36,0.667,90,2017-02-24,MIA,ATL,2017,93.0
3788,3788,88,Home,L 108-117 ,240,32,88,0.364,22,43,0.512,10,45,0.222,34,42,0.81,108,41,91,0.451,28,61,0.459,13,30,0.433,22,25,0.88,117,2017-02-27,HOU,IND,2017,123.5
3789,3789,89,Home,L 108-119 ,240,37,82,0.451,27,48,0.563,10,34,0.294,24,27,0.889,108,40,89,0.449,34,60,0.567,6,29,0.207,33,39,0.846,119,2017-02-27,PHI,GSW,2017,122.0
3790,3790,90,@,L 108-112 ,240,39,84,0.464,31,55,0.564,8,29,0.276,22,27,0.815,108,41,91,0.451,29,63,0.46,12,28,0.429,18,20,0.9,112,2017-02-28,GSW,WAS,2017,118.0
3791,3791,91,@,L 108-123 ,240,43,97,0.443,35,69,0.507,8,28,0.286,14,21,0.667,108,39,78,0.5,21,36,0.583,18,42,0.429,27,36,0.75,123,2017-03-04,MEM,HOU,2017,132.0
3792,3792,92,Home,W 108-96 ,240,37,75,0.493,24,45,0.533,13,30,0.433,21,28,0.75,108,36,83,0.434,30,67,0.448,6,16,0.375,18,21,0.857,96,2017-03-06,DEN,SAC,2017,99.0
3793,3793,93,Home,L 108-115 ,240,35,79,0.443,27,47,0.574,8,32,0.25,30,40,0.75,108,41,76,0.539,29,45,0.644,12,31,0.387,21,24,0.875,115,2017-03-08,HOU,UTA,2017,121.0
3794,3794,94,Home,W 108-101 ,240,37,85,0.435,20,44,0.455,17,41,0.415,17,24,0.708,108,37,80,0.463,30,59,0.508,7,21,0.333,20,21,0.952,101,2017-03-08,MIA,CHO,2017,104.5
3795,3795,95,@,L 108-114 (OT),265,41,94,0.436,30,65,0.462,11,29,0.379,15,20,0.75,108,40,88,0.455,34,67,0.507,6,21,0.286,28,33,0.848,114,2017-03-09,PHI,POR,2017,117.0
3796,3796,96,Home,W 107-103 ,240,40,97,0.412,31,78,0.397,9,19,0.474,18,23,0.783,107,40,83,0.482,32,64,0.5,8,19,0.421,15,19,0.789,103,2011-12-26,POR,PHI,2012,107.0
3797,3797,97,@,L 107-115 ,240,37,72,0.514,25,53,0.472,12,19,0.632,21,27,0.778,107,42,75,0.56,36,65,0.554,6,10,0.6,25,35,0.714,115,2011-12-27,BOS,MIA,2012,118.0
3798,3798,98,@,W 107-79 ,240,39,79,0.494,28,59,0.475,11,20,0.55,18,31,0.581,107,34,89,0.382,30,72,0.417,4,17,0.235,7,12,0.583,79,2011-12-31,PHI,GSW,2012,81.0
3799,3799,99,Home,W 107-97 ,240,41,77,0.532,32,55,0.582,9,22,0.409,16,18,0.889,107,35,88,0.398,27,62,0.435,8,26,0.308,19,23,0.826,97,2011-12-31,OKC,PHO,2012,101.0
3800,3800,0,Home,W 107-96 ,240,41,89,0.461,36,77,0.468,5,12,0.417,20,26,0.769,107,37,79,0.468,37,68,0.544,0,11,0.0,22,27,0.815,96,2012-01-05,POR,LAL,2012,96.0
3801,3801,1,@,W 107-104 ,240,41,70,0.586,25,43,0.581,16,27,0.593,9,19,0.474,107,41,86,0.477,31,61,0.508,10,25,0.4,12,13,0.923,104,2012-01-11,ORL,POR,2012,109.0
3802,3802,2,Home,W 107-105 (OT),265,39,93,0.419,34,75,0.453,5,18,0.278,24,28,0.857,107,37,90,0.411,28,64,0.438,9,26,0.346,22,31,0.71,105,2012-01-14,HOU,POR,2012,109.5
3803,3803,3,Home,W 107-94 ,240,42,81,0.519,39,73,0.534,3,8,0.375,20,26,0.769,107,32,74,0.432,23,47,0.489,9,27,0.333,21,27,0.778,94,2012-01-14,UTA,NJN,2012,98.5
3804,3804,4,Home,W 107-100 ,240,37,75,0.493,26,46,0.565,11,29,0.379,22,25,0.88,107,37,72,0.514,29,56,0.518,8,16,0.5,18,27,0.667,100,2012-01-18,BRK,GSW,2012,104.0
3805,3805,5,@,W 107-92 ,240,39,86,0.453,32,65,0.492,7,21,0.333,22,28,0.786,107,33,80,0.413,28,68,0.412,5,12,0.417,21,27,0.778,92,2012-01-23,HOU,MIN,2012,94.5
3806,3806,6,Home,W 107-100 ,240,41,90,0.456,36,73,0.493,5,17,0.294,20,33,0.606,107,39,92,0.424,32,68,0.471,7,24,0.292,15,16,0.938,100,2012-01-27,CHI,MIL,2012,103.5
3807,3807,7,@,W 107-101 (OT),265,40,82,0.488,30,66,0.455,10,16,0.625,17,25,0.68,107,38,93,0.409,31,77,0.403,7,16,0.438,18,22,0.818,101,2012-01-27,ATL,DET,2012,104.5
3808,3808,8,@,W 107-105 ,240,42,87,0.483,37,65,0.569,5,22,0.227,18,23,0.783,107,38,81,0.469,35,70,0.5,3,11,0.273,26,36,0.722,105,2012-02-01,LAC,UTA,2012,106.5
3809,3809,9,Home,W 107-96 ,240,37,88,0.42,25,65,0.385,12,23,0.522,21,25,0.84,107,36,77,0.468,29,56,0.518,7,21,0.333,17,28,0.607,96,2012-02-04,SAS,OKC,2012,99.5
3810,3810,10,@,W 107-81 ,240,45,83,0.542,34,60,0.567,11,23,0.478,6,17,0.353,107,30,80,0.375,23,62,0.371,7,18,0.389,14,23,0.609,81,2012-02-04,LAC,WAS,2012,84.5
3811,3811,11,@,W 107-102 (OT),265,36,82,0.439,23,51,0.451,13,31,0.419,22,25,0.88,107,40,86,0.465,29,56,0.518,11,30,0.367,11,16,0.688,102,2012-02-06,LAC,ORL,2012,107.5
3812,3812,12,Home,L 107-111 (OT),265,41,97,0.423,36,77,0.468,5,20,0.25,20,26,0.769,107,43,95,0.453,37,73,0.507,6,22,0.273,19,22,0.864,111,2012-02-06,POR,OKC,2012,114.0
3813,3813,13,Home,W 107-91 ,240,39,84,0.464,33,67,0.493,6,17,0.353,23,26,0.885,107,32,82,0.39,25,63,0.397,7,19,0.368,20,30,0.667,91,2012-02-07,MIA,CLE,2012,94.5
3814,3814,14,@,W 107-105 ,240,45,94,0.479,36,69,0.522,9,25,0.36,8,8,1.0,107,39,81,0.481,30,61,0.492,9,20,0.45,18,20,0.9,105,2012-02-07,PHO,MIL,2012,109.5
3815,3815,15,@,W 107-93 ,240,37,81,0.457,30,53,0.566,7,28,0.25,26,33,0.788,107,38,83,0.458,36,66,0.545,2,17,0.118,15,19,0.789,93,2012-02-08,NYK,WAS,2012,94.0
3816,3816,16,@,W 107-87 ,240,38,83,0.458,33,71,0.465,5,12,0.417,26,31,0.839,107,35,90,0.389,24,63,0.381,11,27,0.407,6,7,0.857,87,2012-02-12,MIA,ATL,2012,92.5
3817,3817,17,Home,L 107-115 ,240,41,84,0.488,32,61,0.525,9,23,0.391,16,27,0.593,107,43,96,0.448,39,79,0.494,4,17,0.235,25,27,0.926,115,2012-02-22,WAS,SAC,2012,117.0
3818,3818,18,@,W 107-93 ,240,39,82,0.476,33,71,0.465,6,11,0.545,23,29,0.793,107,36,76,0.474,31,60,0.517,5,16,0.313,16,19,0.842,93,2012-03-01,MIA,POR,2012,95.5
3819,3819,19,Home,W 107-94 ,240,45,87,0.517,41,71,0.577,4,16,0.25,13,17,0.765,107,34,76,0.447,29,57,0.509,5,19,0.263,21,28,0.75,94,2012-03-02,BOS,NJN,2012,96.5
3820,3820,20,@,L 107-115 ,240,45,103,0.437,36,78,0.462,9,25,0.36,8,9,0.889,107,44,82,0.537,38,65,0.585,6,17,0.353,21,26,0.808,115,2012-03-02,SAC,LAL,2012,118.0
3821,3821,21,@,L 107-118 ,240,44,86,0.512,36,69,0.522,8,17,0.471,11,17,0.647,107,39,82,0.476,28,62,0.452,11,20,0.55,29,36,0.806,118,2012-03-11,HOU,CLE,2012,123.5
3822,3822,22,Home,W 107-94 ,240,37,79,0.468,27,52,0.519,10,27,0.37,23,30,0.767,107,39,82,0.476,38,70,0.543,1,12,0.083,15,18,0.833,94,2012-03-11,ORL,IND,2012,94.5
3823,3823,23,Home,W 107-98 ,240,44,87,0.506,38,65,0.585,6,22,0.273,13,15,0.867,107,35,80,0.438,33,68,0.485,2,12,0.167,26,38,0.684,98,2012-03-13,DAL,WAS,2012,99.0
3824,3824,24,Home,W 107-87 ,240,45,84,0.536,39,75,0.52,6,9,0.667,11,17,0.647,107,33,81,0.407,29,69,0.42,4,12,0.333,17,19,0.895,87,2012-03-14,HOU,CHA,2012,89.0
3825,3825,25,@,W 107-101 (OT),265,37,82,0.451,32,63,0.508,5,19,0.263,28,35,0.8,107,44,85,0.518,41,75,0.547,3,10,0.3,10,13,0.769,101,2012-03-14,LAL,NOH,2012,102.5
3826,3826,26,Home,W 107-103 ,240,36,71,0.507,32,62,0.516,4,9,0.444,31,34,0.912,107,38,73,0.521,30,55,0.545,8,18,0.444,19,24,0.792,103,2012-03-17,CHA,TOR,2012,107.0
3827,3827,27,Home,W 107-104 ,240,39,80,0.488,30,60,0.5,9,20,0.45,20,27,0.741,107,42,83,0.506,36,67,0.537,6,16,0.375,14,16,0.875,104,2012-03-20,HOU,LAL,2012,107.0
3828,3828,28,@,W 107-100 ,240,45,92,0.489,39,65,0.6,6,27,0.222,11,13,0.846,107,41,87,0.471,34,68,0.5,7,19,0.368,11,12,0.917,100,2012-03-27,SAS,PHO,2012,103.5
3829,3829,29,@,L 107-110 (OT),265,40,86,0.465,32,64,0.5,8,22,0.364,19,22,0.864,107,45,87,0.517,41,77,0.532,4,10,0.4,16,22,0.727,110,2012-03-31,CHA,DET,2012,112.0
3830,3830,30,Home,W 107-98 ,240,48,84,0.571,46,73,0.63,2,11,0.182,9,17,0.529,107,39,95,0.411,31,69,0.449,8,26,0.308,12,13,0.923,98,2012-04-04,MIL,CLE,2012,102.0
3831,3831,31,@,W 107-105 ,240,41,91,0.451,28,60,0.467,13,31,0.419,12,22,0.545,107,40,79,0.506,37,70,0.529,3,9,0.333,22,28,0.786,105,2012-04-04,PHO,UTA,2012,106.5
3832,3832,32,Home,L 107-112 ,240,36,84,0.429,33,73,0.452,3,11,0.273,32,36,0.889,107,42,88,0.477,32,71,0.451,10,17,0.588,18,22,0.818,112,2012-04-06,LAL,HOU,2012,117.0
3833,3833,33,Home,L 107-115 ,240,39,87,0.448,31,69,0.449,8,18,0.444,21,27,0.778,107,43,71,0.606,34,57,0.596,9,14,0.643,20,25,0.8,115,2012-04-10,MIA,BOS,2012,119.5
3834,3834,34,@,W 107-88 ,240,39,85,0.459,33,68,0.485,6,17,0.353,23,26,0.885,107,34,88,0.386,32,77,0.416,2,11,0.182,18,21,0.857,88,2012-04-10,PHI,NJN,2012,89.0
3835,3835,35,@,L 107-113 ,240,42,84,0.5,34,60,0.567,8,24,0.333,15,18,0.833,107,41,82,0.5,32,60,0.533,9,22,0.409,22,31,0.71,113,2012-04-11,MIN,DEN,2012,117.5
3836,3836,36,Home,L 107-111 ,240,42,85,0.494,34,60,0.567,8,25,0.32,15,24,0.625,107,41,80,0.513,35,64,0.547,6,16,0.375,23,27,0.852,111,2012-04-11,MIL,NYK,2012,114.0
3837,3837,37,Home,W 107-97 ,240,37,76,0.487,30,56,0.536,7,20,0.35,26,31,0.839,107,36,85,0.424,32,66,0.485,4,19,0.211,21,27,0.778,97,2012-04-12,SAS,MEM,2012,99.0
3838,3838,38,@,L 107-125 ,240,41,89,0.461,33,68,0.485,8,21,0.381,17,23,0.739,107,51,85,0.6,44,70,0.629,7,15,0.467,16,19,0.842,125,2012-04-16,POR,PHO,2012,128.5
3839,3839,39,Home,L 107-118 ,240,44,95,0.463,33,69,0.478,11,26,0.423,8,11,0.727,107,48,87,0.552,42,74,0.568,6,13,0.462,16,17,0.941,118,2012-04-21,PHO,DEN,2012,121.0
3840,3840,40,@,L 107-117 (OT),265,42,96,0.438,27,58,0.466,15,38,0.395,8,13,0.615,107,47,88,0.534,43,80,0.538,4,8,0.5,19,23,0.826,117,2012-04-21,ORL,UTA,2012,119.0
3841,3841,41,Home,W 107-98 ,240,33,77,0.429,26,49,0.531,7,28,0.25,34,43,0.791,107,35,71,0.493,32,59,0.542,3,12,0.25,25,34,0.735,98,2012-04-22,LAC,NOH,2012,99.5
3842,3842,42,Home,W 107-75 ,240,45,85,0.529,40,69,0.58,5,16,0.313,12,17,0.706,107,28,87,0.322,26,74,0.351,2,13,0.154,17,26,0.654,75,2012-04-26,CHI,CLE,2012,76.0
3843,3843,43,@,W 107-101 ,240,42,96,0.438,33,65,0.508,9,31,0.29,14,17,0.824,107,45,87,0.517,43,79,0.544,2,8,0.25,9,12,0.75,101,2012-04-26,SAS,GSW,2012,102.0
3844,3844,44,@,L 107-120 ,240,39,75,0.52,33,62,0.532,6,13,0.462,23,28,0.821,107,43,79,0.544,35,63,0.556,8,16,0.5,26,32,0.813,120,2012-10-30,BOS,MIA,2013,124.0
3845,3845,45,Home,W 107-100 ,240,37,81,0.457,31,66,0.47,6,15,0.4,27,37,0.73,107,37,82,0.451,30,64,0.469,7,18,0.389,19,25,0.76,100,2012-11-03,BRK,TOR,2013,103.5
3846,3846,46,@,W 107-96 ,240,44,88,0.5,37,68,0.544,7,20,0.35,12,15,0.8,107,35,73,0.479,22,50,0.44,13,23,0.565,13,18,0.722,96,2012-11-05,MIN,BRK,2013,102.5
3847,3847,47,Home,W 107-99 ,240,43,83,0.518,35,61,0.574,8,22,0.364,13,21,0.619,107,40,83,0.482,33,62,0.532,7,21,0.333,12,18,0.667,99,2012-11-09,NOP,CHA,2013,102.5
3848,3848,48,@,W 107-68 ,240,41,82,0.5,32,59,0.542,9,23,0.391,16,25,0.64,107,30,70,0.429,26,59,0.441,4,11,0.364,4,8,0.5,68,2012-11-09,BRK,ORL,2013,70.0
3849,3849,49,Home,W 107-105 ,240,38,81,0.469,32,64,0.5,6,17,0.353,25,33,0.758,107,37,77,0.481,28,56,0.5,9,21,0.429,22,27,0.815,105,2012-11-09,PHO,CLE,2013,109.5
3850,3850,50,@,W 107-101 (2OT),290,43,113,0.381,38,89,0.427,5,24,0.208,16,27,0.593,107,39,102,0.382,30,77,0.39,9,25,0.36,14,23,0.609,101,2012-11-10,DEN,GSW,2013,105.5
3851,3851,51,Home,W 107-101 ,240,39,78,0.5,36,67,0.537,3,11,0.273,26,33,0.788,107,39,81,0.481,26,54,0.481,13,27,0.481,10,11,0.909,101,2012-11-14,DAL,WAS,2013,107.5
3852,3852,52,Home,W 107-100 ,240,35,72,0.486,25,51,0.49,10,21,0.476,27,32,0.844,107,35,77,0.455,26,56,0.464,9,21,0.429,21,29,0.724,100,2012-11-14,LAC,MIA,2013,104.5
3853,3853,53,@,W 107-97 ,240,44,93,0.473,37,76,0.487,7,17,0.412,12,14,0.857,107,35,72,0.486,29,59,0.492,6,13,0.462,21,26,0.808,97,2012-11-14,MEM,OKC,2013,100.0
3854,3854,54,Home,W 107-89 ,240,43,76,0.566,37,61,0.607,6,15,0.4,15,19,0.789,107,30,70,0.429,22,48,0.458,8,22,0.364,21,31,0.677,89,2012-11-17,BOS,TOR,2013,93.0
3855,3855,55,@,L 107-115 (OT),265,39,92,0.424,33,82,0.402,6,10,0.6,23,27,0.852,107,40,92,0.435,25,65,0.385,15,27,0.556,20,28,0.714,115,2012-11-21,NOP,IND,2013,122.5
3856,3856,56,Home,W 107-105 ,240,38,101,0.376,31,67,0.463,7,34,0.206,24,31,0.774,107,38,83,0.458,31,62,0.5,7,21,0.333,22,34,0.647,105,2012-12-04,HOU,LAL,2013,108.5
3857,3857,57,Home,W 107-100 ,240,38,82,0.463,32,67,0.478,6,15,0.4,25,34,0.735,107,35,86,0.407,29,63,0.46,6,23,0.261,24,28,0.857,100,2012-12-05,SAC,TOR,2013,103.0
3858,3858,58,@,L 107-116 ,240,35,84,0.417,23,47,0.489,12,37,0.324,25,29,0.862,107,42,79,0.532,30,54,0.556,12,25,0.48,20,30,0.667,116,2012-12-13,LAL,NYK,2013,122.0
3859,3859,59,Home,W 107-105 (2OT),290,42,93,0.452,32,67,0.478,10,26,0.385,13,16,0.813,107,40,99,0.404,35,83,0.422,5,16,0.313,20,26,0.769,105,2012-12-14,BRK,DET,2013,107.5
3860,3860,60,@,W 107-98 ,240,43,79,0.544,38,62,0.613,5,17,0.294,16,19,0.842,107,36,78,0.462,32,66,0.485,4,12,0.333,22,29,0.759,98,2012-12-15,ORL,CHA,2013,100.0
3861,3861,61,Home,W 107-93 ,240,38,85,0.447,34,71,0.479,4,14,0.286,27,30,0.9,107,36,79,0.456,30,59,0.508,6,20,0.3,15,21,0.714,93,2012-12-17,OKC,SAS,2013,96.0
3862,3862,62,Home,W 107-100 ,240,39,72,0.542,35,61,0.574,4,11,0.364,25,29,0.862,107,37,86,0.43,24,51,0.471,13,35,0.371,13,15,0.867,100,2012-12-18,DAL,PHI,2013,106.5
3863,3863,63,@,L 107-111 ,240,45,97,0.464,43,80,0.538,2,17,0.118,15,24,0.625,107,45,89,0.506,40,71,0.563,5,18,0.278,16,26,0.615,111,2012-12-29,PHO,MIN,2013,113.5
3864,3864,64,Home,W 107-96 ,240,39,78,0.5,31,60,0.517,8,18,0.444,21,29,0.724,107,33,80,0.413,28,67,0.418,5,13,0.385,25,34,0.735,96,2012-12-30,LAC,UTA,2013,98.5
3865,3865,65,Home,W 107-102 ,240,41,82,0.5,35,68,0.515,6,14,0.429,19,25,0.76,107,35,76,0.461,29,51,0.569,6,25,0.24,26,36,0.722,102,2013-01-04,LAC,LAL,2013,105.0
3866,3866,66,Home,W 107-100 ,240,43,87,0.494,37,69,0.536,6,18,0.333,15,19,0.789,107,37,84,0.44,29,52,0.558,8,32,0.25,18,22,0.818,100,2013-01-12,PHI,HOU,2013,104.0
3867,3867,67,@,W 107-96 ,240,40,77,0.519,32,58,0.552,8,19,0.421,19,23,0.826,107,36,85,0.424,33,72,0.458,3,13,0.231,21,27,0.778,96,2013-01-13,MIL,TOR,2013,97.5
3868,3868,68,@,W 107-105 (OT),265,39,86,0.453,36,75,0.48,3,11,0.273,26,36,0.722,107,38,85,0.447,32,69,0.464,6,16,0.375,23,32,0.719,105,2013-01-16,CHI,TOR,2013,108.0
3869,3869,69,Home,L 107-113 ,240,42,91,0.462,36,73,0.493,6,18,0.333,17,18,0.944,107,43,89,0.483,34,66,0.515,9,23,0.391,18,24,0.75,113,2013-01-25,DAL,SAS,2013,117.5
3870,3870,70,Home,W 107-98 ,240,42,90,0.467,33,66,0.5,9,24,0.375,14,20,0.7,107,41,94,0.436,36,75,0.48,5,19,0.263,11,22,0.5,98,2013-02-02,MIL,ORL,2013,100.5
3871,3871,71,Home,W 107-97 ,240,44,80,0.55,38,64,0.594,6,16,0.375,13,14,0.929,107,35,70,0.5,28,58,0.483,7,12,0.583,20,26,0.769,97,2013-02-10,MIA,LAL,2013,100.5
3872,3872,72,@,W 107-90 ,240,44,75,0.587,36,56,0.643,8,19,0.421,11,22,0.5,107,35,84,0.417,26,66,0.394,9,18,0.5,11,16,0.688,90,2013-02-11,LAC,PHI,2013,94.5
3873,3873,73,Home,L 107-116 ,240,38,84,0.452,30,64,0.469,8,20,0.4,23,31,0.742,107,43,91,0.473,33,57,0.579,10,34,0.294,20,25,0.8,116,2013-02-12,GSW,HOU,2013,121.0
3874,3874,74,Home,W 107-101 (OT),265,39,94,0.415,34,73,0.466,5,21,0.238,24,30,0.8,107,37,95,0.389,33,73,0.452,4,22,0.182,23,32,0.719,101,2013-02-22,GSW,SAS,2013,103.0
3875,3875,75,@,L 107-111 ,240,46,94,0.489,38,74,0.514,8,20,0.4,7,12,0.583,107,40,85,0.471,34,67,0.507,6,18,0.333,25,34,0.735,111,2013-02-22,POR,LAL,2013,114.0
3876,3876,76,Home,W 107-94 ,240,40,78,0.513,32,58,0.552,8,20,0.4,19,24,0.792,107,35,84,0.417,34,69,0.493,1,15,0.067,23,28,0.821,94,2013-02-23,LAC,UTA,2013,94.5
3877,3877,77,Home,L 107-110 (OT),265,39,88,0.443,31,71,0.437,8,17,0.471,21,24,0.875,107,41,86,0.477,31,59,0.525,10,27,0.37,18,20,0.9,110,2013-02-25,UTA,BOS,2013,115.0
3878,3878,78,Home,L 107-110 ,240,42,89,0.472,35,66,0.53,7,23,0.304,16,25,0.64,107,43,89,0.483,34,65,0.523,9,24,0.375,15,20,0.75,110,2013-02-27,HOU,MIL,2013,114.5
3879,3879,79,Home,W 107-96 ,240,43,80,0.538,32,56,0.571,11,24,0.458,10,17,0.588,107,37,86,0.43,31,69,0.449,6,17,0.353,16,21,0.762,96,2013-03-06,ATL,PHI,2013,99.0
3880,3880,80,Home,W 107-92 ,240,43,77,0.558,32,54,0.593,11,23,0.478,10,12,0.833,107,36,85,0.424,29,63,0.46,7,22,0.318,13,16,0.813,92,2013-03-07,DEN,LAC,2013,95.5
3881,3881,81,Home,W 107-102 (OT),265,40,78,0.513,30,58,0.517,10,20,0.5,17,20,0.85,107,40,88,0.455,31,61,0.508,9,27,0.333,13,17,0.765,102,2013-03-08,BOS,ATL,2013,106.5
3882,3882,82,Home,W 107-105 ,240,37,82,0.451,29,64,0.453,8,18,0.444,25,39,0.641,107,37,86,0.43,18,45,0.4,19,41,0.463,12,18,0.667,105,2013-03-09,PHO,HOU,2013,114.5
3883,3883,83,Home,W 107-83 ,240,44,82,0.537,32,62,0.516,12,20,0.6,7,18,0.389,107,29,82,0.354,20,53,0.377,9,29,0.31,16,18,0.889,83,2013-03-12,MIN,SAS,2013,87.5
3884,3884,84,Home,W 107-91 ,240,41,82,0.5,32,57,0.561,9,25,0.36,16,26,0.615,107,35,80,0.438,29,61,0.475,6,19,0.316,15,18,0.833,91,2013-03-13,IND,MIN,2013,94.0
3885,3885,85,Home,W 107-94 ,240,41,84,0.488,29,61,0.475,12,23,0.522,13,16,0.813,107,35,79,0.443,32,60,0.533,3,19,0.158,21,31,0.677,94,2013-03-15,ATL,PHO,2013,95.5
3886,3886,86,@,W 107-94 ,240,41,79,0.519,34,64,0.531,7,15,0.467,18,22,0.818,107,33,89,0.371,24,64,0.375,9,25,0.36,19,21,0.905,94,2013-03-15,MIA,MIL,2013,98.5
3887,3887,87,@,W 107-101 ,240,39,80,0.488,34,59,0.576,5,21,0.238,24,30,0.8,107,38,83,0.458,29,62,0.468,9,21,0.429,16,16,1.0,101,2013-03-17,OKC,DAL,2013,105.5
3888,3888,88,Home,W 107-101 ,240,35,75,0.467,27,59,0.458,8,16,0.5,29,40,0.725,107,35,83,0.422,30,61,0.492,5,22,0.227,26,26,1.0,101,2013-03-20,CHA,TOR,2013,103.5
3889,3889,89,Home,W 107-91 ,240,41,84,0.488,34,70,0.486,7,14,0.5,18,21,0.857,107,32,83,0.386,28,69,0.406,4,14,0.286,23,28,0.821,91,2013-03-25,UTA,PHI,2013,93.0
3890,3890,90,Home,W 107-94 ,240,36,72,0.5,31,59,0.525,5,13,0.385,30,44,0.682,107,34,77,0.442,28,61,0.459,6,16,0.375,20,22,0.909,94,2013-03-25,WAS,MEM,2013,97.0
3891,3891,91,@,W 107-88 ,240,40,81,0.494,30,60,0.5,10,21,0.476,17,20,0.85,107,35,78,0.449,31,61,0.508,4,17,0.235,14,20,0.7,88,2013-03-27,ATL,TOR,2013,90.0
3892,3892,92,@,L 107-118 ,240,40,88,0.455,32,68,0.471,8,20,0.4,19,24,0.792,107,45,83,0.542,34,60,0.567,11,23,0.478,17,21,0.81,118,2013-03-29,ATL,BOS,2013,123.5
3893,3893,93,@,L 107-116 ,240,42,81,0.519,34,58,0.586,8,23,0.348,15,19,0.789,107,45,81,0.556,35,64,0.547,10,17,0.588,16,24,0.667,116,2013-03-30,BRK,UTA,2013,121.0
3894,3894,94,@,W 107-98 ,240,44,84,0.524,36,71,0.507,8,13,0.615,11,16,0.688,107,42,96,0.438,34,73,0.466,8,23,0.348,6,9,0.667,98,2013-04-03,MIN,MIL,2013,102.0
3895,3895,95,Home,L 107-111 ,240,44,72,0.611,39,58,0.672,5,14,0.357,14,17,0.824,107,44,86,0.512,35,70,0.5,9,16,0.563,14,16,0.875,111,2013-04-05,PHO,GSW,2013,115.5
3896,3896,96,Home,W 107-101 ,240,36,83,0.434,30,69,0.435,6,14,0.429,29,38,0.763,107,40,75,0.533,34,60,0.567,6,15,0.4,15,21,0.714,101,2013-04-06,MIN,DET,2013,104.0
3897,3897,97,Home,W 107-96 ,240,43,77,0.558,39,66,0.591,4,11,0.364,17,21,0.81,107,39,88,0.443,29,62,0.468,10,26,0.385,8,12,0.667,96,2013-04-07,BOS,WAS,2013,101.0
3898,3898,98,Home,W 107-100 ,240,42,72,0.583,34,59,0.576,8,13,0.615,15,17,0.882,107,36,78,0.462,28,56,0.5,8,22,0.364,20,21,0.952,100,2013-04-12,UTA,MIN,2013,104.0
3899,3899,99,@,W 107-89 ,240,45,86,0.523,36,65,0.554,9,21,0.429,8,8,1.0,107,33,87,0.379,24,65,0.369,9,22,0.409,14,18,0.778,89,2013-04-14,DAL,NOH,2013,93.5
3900,3900,0,Home,W 107-95 ,240,37,72,0.514,26,52,0.5,11,20,0.55,22,29,0.759,107,35,83,0.422,28,57,0.491,7,26,0.269,18,23,0.783,95,2013-10-29,MIA,CHI,2014,98.5
3901,3901,1,Home,W 107-104 ,240,42,86,0.488,31,64,0.484,11,22,0.5,12,18,0.667,107,42,93,0.452,39,79,0.494,3,14,0.214,17,19,0.895,104,2013-11-02,PHI,CHI,2014,105.5
3902,3902,2,Home,W 107-86 ,240,42,89,0.472,35,72,0.486,7,17,0.412,16,22,0.727,107,34,89,0.382,30,72,0.417,4,17,0.235,14,15,0.933,86,2013-11-03,ORL,BRK,2014,88.0
3903,3903,3,Home,W 107-93 ,240,43,79,0.544,38,66,0.576,5,13,0.385,16,23,0.696,107,36,85,0.424,27,62,0.435,9,23,0.391,12,14,0.857,93,2013-11-06,OKC,DAL,2014,97.5
3904,3904,4,@,L 107-109 ,240,43,94,0.457,35,68,0.515,8,26,0.308,13,19,0.684,107,42,86,0.488,28,61,0.459,14,25,0.56,11,17,0.647,109,2013-11-07,ATL,DEN,2014,116.0
3905,3905,5,@,W 107-94 ,240,42,88,0.477,33,64,0.516,9,24,0.375,14,23,0.609,107,35,78,0.449,28,52,0.538,7,26,0.269,17,27,0.63,94,2013-11-09,LAC,HOU,2014,97.5
3906,3906,6,@,L 107-109 ,240,40,96,0.417,29,67,0.433,11,29,0.379,16,18,0.889,107,44,80,0.55,40,64,0.625,4,16,0.25,17,28,0.607,109,2013-11-11,MIN,LAC,2014,111.0
3907,3907,7,Home,W 107-86 ,240,41,94,0.436,33,70,0.471,8,24,0.333,17,23,0.739,107,31,82,0.378,28,69,0.406,3,13,0.231,21,27,0.778,86,2013-11-13,SAC,BRK,2014,87.5
3908,3908,8,Home,W 107-104 ,240,39,83,0.47,31,61,0.508,8,22,0.364,21,28,0.75,107,37,79,0.468,27,50,0.54,10,29,0.345,20,28,0.714,104,2013-11-19,SAC,PHO,2014,109.0
3909,3909,9,@,L 107-115 (OT),265,41,93,0.441,33,64,0.516,8,29,0.276,17,24,0.708,107,45,79,0.57,38,59,0.644,7,20,0.35,18,29,0.621,115,2013-11-22,MIL,PHI,2014,118.5
3910,3910,10,Home,W 107-92 ,240,39,79,0.494,32,57,0.561,7,22,0.318,22,24,0.917,107,33,83,0.398,25,51,0.49,8,32,0.25,18,24,0.75,92,2013-11-25,MIA,PHO,2014,96.0
3911,3911,11,@,W 107-97 ,240,41,80,0.513,34,64,0.531,7,16,0.438,18,26,0.692,107,36,82,0.439,27,54,0.5,9,28,0.321,16,23,0.696,97,2013-12-03,DET,MIA,2014,101.5
3912,3912,12,Home,W 107-97 ,240,42,82,0.512,30,59,0.508,12,23,0.522,11,16,0.688,107,39,83,0.47,35,64,0.547,4,19,0.211,15,20,0.75,97,2013-12-04,ATL,LAC,2014,99.0
3913,3913,13,Home,W 107-87 ,240,37,74,0.5,27,55,0.491,10,19,0.526,23,32,0.719,107,32,77,0.416,26,55,0.473,6,22,0.273,17,24,0.708,87,2013-12-05,CHI,MIA,2014,90.0
3914,3914,14,@,L 107-116 ,240,38,87,0.437,32,68,0.471,6,19,0.316,25,29,0.862,107,41,83,0.494,29,59,0.492,12,24,0.5,22,29,0.759,116,2013-12-13,SAC,PHO,2014,122.0
3915,3915,15,@,L 107-114 ,240,39,84,0.464,29,55,0.527,10,29,0.345,19,25,0.76,107,42,76,0.553,34,55,0.618,8,21,0.381,22,30,0.733,114,2013-12-14,CLE,MIA,2014,118.0
3916,3916,16,@,L 107-124 ,240,40,84,0.476,34,69,0.493,6,15,0.4,21,25,0.84,107,47,81,0.58,32,56,0.571,15,25,0.6,15,18,0.833,124,2013-12-18,SAC,ATL,2014,131.5
3917,3917,17,@,W 107-106 ,240,41,88,0.466,31,61,0.508,10,27,0.37,15,20,0.75,107,40,81,0.494,34,63,0.54,6,18,0.333,20,22,0.909,106,2013-12-18,DET,BOS,2014,109.0
3918,3918,18,Home,L 107-113 ,240,39,74,0.527,30,53,0.566,9,21,0.429,20,24,0.833,107,38,88,0.432,26,68,0.382,12,20,0.6,25,30,0.833,113,2013-12-18,BRK,WAS,2014,119.0
3919,3919,19,@,W 107-101 (2OT),290,38,101,0.376,21,60,0.35,17,41,0.415,14,19,0.737,107,34,82,0.415,26,60,0.433,8,22,0.364,25,35,0.714,101,2013-12-18,NYK,MIL,2014,105.0
3920,3920,20,Home,W 107-95 ,240,43,84,0.512,34,69,0.493,9,15,0.6,12,14,0.857,107,29,77,0.377,21,48,0.438,8,29,0.276,29,39,0.744,95,2013-12-19,OKC,CHI,2014,99.0
3921,3921,21,@,L 107-110 ,240,44,94,0.468,38,77,0.494,6,17,0.353,13,19,0.684,107,43,98,0.439,35,69,0.507,8,29,0.276,16,18,0.889,110,2013-12-21,NOP,POR,2014,114.0
3922,3922,22,Home,L 107-116 ,240,39,85,0.459,34,68,0.5,5,17,0.294,24,31,0.774,107,37,75,0.493,30,59,0.508,7,16,0.438,35,42,0.833,116,2013-12-26,DAL,SAS,2014,119.5
3923,3923,23,Home,W 107-98 ,240,38,77,0.494,32,51,0.627,6,26,0.231,25,32,0.781,107,41,93,0.441,31,71,0.437,10,22,0.455,6,8,0.75,98,2013-12-28,HOU,NOP,2014,103.0
3924,3924,24,Home,L 107-108 ,240,39,77,0.506,28,51,0.549,11,26,0.423,18,21,0.857,107,45,88,0.511,37,74,0.5,8,14,0.571,10,11,0.909,108,2013-12-28,POR,MIA,2014,112.0
3925,3925,25,@,W 107-88 ,240,41,85,0.482,29,54,0.537,12,31,0.387,13,22,0.591,107,31,85,0.365,24,65,0.369,7,20,0.35,19,26,0.731,88,2013-12-30,PHO,LAC,2014,91.5
3926,3926,26,Home,W 107-88 ,240,40,78,0.513,31,51,0.608,9,27,0.333,18,23,0.783,107,36,77,0.468,33,68,0.485,3,9,0.333,13,17,0.765,88,2014-01-07,MIA,NOP,2014,89.5
3927,3927,27,@,W 107-90 ,240,41,78,0.526,27,50,0.54,14,28,0.5,11,16,0.688,107,36,80,0.45,33,73,0.452,3,7,0.429,15,19,0.789,90,2014-01-10,DAL,NOP,2014,91.5
3928,3928,28,@,L 107-110 ,240,37,77,0.481,29,58,0.5,8,19,0.421,25,31,0.806,107,30,67,0.448,19,40,0.475,11,27,0.407,39,45,0.867,110,2014-01-11,NOP,DAL,2014,115.5
3929,3929,29,Home,L 107-114 ,240,40,95,0.421,35,76,0.461,5,19,0.263,22,31,0.71,107,38,73,0.521,30,55,0.545,8,18,0.444,30,42,0.714,114,2014-01-11,WAS,HOU,2014,118.0
3930,3930,30,Home,W 107-88 ,240,40,79,0.506,27,52,0.519,13,27,0.481,14,15,0.933,107,34,76,0.447,27,52,0.519,7,24,0.292,13,16,0.813,88,2014-01-13,DAL,ORL,2014,91.5
3931,3931,31,@,W 107-104 ,240,37,74,0.5,25,54,0.463,12,20,0.6,21,28,0.75,107,44,99,0.444,37,76,0.487,7,23,0.304,9,11,0.818,104,2014-01-17,LAL,BOS,2014,107.5
3932,3932,32,Home,L 107-110 ,240,42,93,0.452,35,71,0.493,7,22,0.318,16,21,0.762,107,44,83,0.53,35,59,0.593,9,24,0.375,13,19,0.684,110,2014-01-17,PHO,DAL,2014,114.5
3933,3933,33,Home,W 107-99 ,240,37,84,0.44,32,66,0.485,5,18,0.278,28,35,0.8,107,37,88,0.42,33,70,0.471,4,18,0.222,21,31,0.677,99,2014-01-20,WAS,PHI,2014,101.0
3934,3934,34,Home,W 107-106 ,240,37,73,0.507,27,46,0.587,10,27,0.37,23,28,0.821,107,34,78,0.436,24,58,0.414,10,20,0.5,28,33,0.848,106,2014-01-24,BRK,DAL,2014,111.0
3935,3935,35,Home,W 107-103 ,240,38,80,0.475,36,61,0.59,2,19,0.105,29,36,0.806,107,38,75,0.507,31,54,0.574,7,21,0.333,20,23,0.87,103,2014-01-31,DAL,SAC,2014,106.5
3936,3936,36,@,L 107-124 ,240,37,80,0.463,29,56,0.518,8,24,0.333,25,33,0.758,107,44,80,0.55,32,54,0.593,12,26,0.462,24,26,0.923,124,2014-02-03,CLE,DAL,2014,130.0
3937,3937,37,@,W 107-89 ,240,39,82,0.476,28,55,0.509,11,27,0.407,18,20,0.9,107,31,87,0.356,25,62,0.403,6,25,0.24,21,21,1.0,89,2014-02-10,HOU,MIN,2014,92.0
3938,3938,38,@,W 107-103 ,240,39,88,0.443,31,60,0.517,8,28,0.286,21,24,0.875,107,40,83,0.482,30,55,0.545,10,28,0.357,13,22,0.591,103,2014-02-13,OKC,LAL,2014,108.0
3939,3939,39,Home,L 107-112 (OT),265,38,99,0.384,33,71,0.465,5,28,0.179,26,37,0.703,107,35,93,0.376,24,64,0.375,11,29,0.379,31,39,0.795,112,2014-02-18,DEN,PHO,2014,117.5
3940,3940,40,@,L 107-115 ,240,40,88,0.455,27,57,0.474,13,31,0.419,14,20,0.7,107,47,87,0.54,39,67,0.582,8,20,0.4,13,29,0.448,115,2014-02-21,ATL,DET,2014,119.0
3941,3941,41,Home,W 107-98 ,240,32,74,0.432,16,43,0.372,16,31,0.516,27,33,0.818,107,39,89,0.438,29,61,0.475,10,28,0.357,10,16,0.625,98,2014-02-22,ATL,NYK,2014,103.0
3942,3942,42,@,W 107-103 ,240,37,88,0.42,29,64,0.453,8,24,0.333,25,29,0.862,107,38,84,0.452,24,51,0.471,14,33,0.424,13,16,0.813,103,2014-02-25,CHI,ATL,2014,110.0
3943,3943,43,@,L 107-113 ,240,41,80,0.513,31,64,0.484,10,16,0.625,15,20,0.75,107,38,77,0.494,28,55,0.509,10,22,0.455,27,32,0.844,113,2014-02-28,MEM,OKC,2014,118.0
3944,3944,44,@,W 107-98 ,240,37,83,0.446,27,58,0.466,10,25,0.4,23,31,0.742,107,34,74,0.459,29,62,0.468,5,12,0.417,25,31,0.806,98,2014-03-01,BRK,MIL,2014,100.5
3945,3945,45,@,L 107-124 ,240,42,82,0.512,33,59,0.559,9,23,0.391,14,21,0.667,107,46,83,0.554,30,55,0.545,16,28,0.571,16,20,0.8,124,2014-03-03,CHA,MIA,2014,132.0
3946,3946,46,@,W 107-106 ,240,43,94,0.457,35,76,0.461,8,18,0.444,13,15,0.867,107,43,96,0.448,34,67,0.507,9,29,0.31,11,19,0.579,106,2014-03-03,LAL,POR,2014,110.5
3947,3947,47,@,W 107-97 ,240,38,88,0.432,24,57,0.421,14,31,0.452,17,23,0.739,107,36,87,0.414,27,64,0.422,9,23,0.391,16,18,0.889,97,2014-03-08,NYK,CLE,2014,101.5
3948,3948,48,Home,L 107-114 ,240,39,87,0.448,35,71,0.493,4,16,0.25,25,28,0.893,107,43,80,0.538,28,52,0.538,15,28,0.536,13,23,0.565,114,2014-03-08,MIL,WAS,2014,121.5
3949,3949,49,@,L 107-113 ,240,36,75,0.48,26,54,0.481,10,21,0.476,25,28,0.893,107,45,85,0.529,35,63,0.556,10,22,0.455,13,21,0.619,113,2014-03-09,PHO,GSW,2014,118.0
3950,3950,50,@,L 107-111 (OT),265,40,85,0.471,33,62,0.532,7,23,0.304,20,26,0.769,107,41,90,0.456,36,76,0.474,5,14,0.357,24,33,0.727,111,2014-03-09,DEN,NOP,2014,113.5
3951,3951,51,Home,L 107-111 ,240,42,81,0.519,35,57,0.614,7,24,0.292,16,21,0.762,107,39,82,0.476,31,61,0.508,8,21,0.381,25,29,0.862,111,2014-03-14,MIA,DEN,2014,115.0
3952,3952,52,@,W 107-100 ,240,36,86,0.419,27,64,0.422,9,22,0.409,26,32,0.813,107,36,67,0.537,32,54,0.593,4,13,0.308,24,32,0.75,100,2014-03-19,TOR,NOP,2014,102.0
3953,3953,53,Home,L 107-117 ,240,43,91,0.473,36,72,0.5,7,19,0.368,14,23,0.609,107,42,87,0.483,32,62,0.516,10,25,0.4,23,29,0.793,117,2014-03-21,LAL,WAS,2014,122.0
3954,3954,54,@,W 107-104 (OT),265,34,84,0.405,23,54,0.426,11,30,0.367,28,33,0.848,107,35,91,0.385,25,60,0.417,10,31,0.323,24,31,0.774,104,2014-03-23,BRK,DAL,2014,109.0
3955,3955,55,@,L 107-124 ,240,42,85,0.494,38,67,0.567,4,18,0.222,19,30,0.633,107,44,86,0.512,37,66,0.561,7,20,0.35,29,36,0.806,124,2014-03-23,MIL,SAC,2014,127.5
3956,3956,56,Home,W 107-83 ,240,43,86,0.5,34,64,0.531,9,22,0.409,12,16,0.75,107,31,82,0.378,24,54,0.444,7,28,0.25,14,16,0.875,83,2014-03-26,MIN,ATL,2014,86.5
3957,3957,57,@,W 107-99 ,240,40,73,0.548,25,47,0.532,15,26,0.577,12,13,0.923,107,33,69,0.478,27,52,0.519,6,17,0.353,27,35,0.771,99,2014-03-26,NYK,SAC,2014,102.0
3958,3958,58,@,L 107-143 ,240,44,102,0.431,37,77,0.481,7,25,0.28,12,15,0.8,107,51,76,0.671,43,58,0.741,8,18,0.444,33,40,0.825,143,2014-03-28,LAL,MIN,2014,147.0
3959,3959,59,Home,L 107-118 ,240,32,79,0.405,25,54,0.463,7,25,0.28,36,45,0.8,107,42,89,0.472,30,48,0.625,12,41,0.293,22,36,0.611,118,2014-03-29,HOU,LAC,2014,124.0
3960,3960,60,@,W 107-102 ,240,37,70,0.529,29,54,0.537,8,16,0.5,25,31,0.806,107,40,87,0.46,30,58,0.517,10,29,0.345,12,16,0.75,102,2014-03-30,CHI,BOS,2014,107.0
3961,3961,61,@,L 107-137 ,240,35,74,0.473,33,65,0.508,2,9,0.222,35,45,0.778,107,52,92,0.565,37,65,0.569,15,27,0.556,18,25,0.72,137,2014-04-02,NOP,DEN,2014,144.5
3962,3962,62,Home,W 107-102 ,240,42,86,0.488,37,71,0.521,5,15,0.333,18,27,0.667,107,37,96,0.385,25,68,0.368,12,28,0.429,16,20,0.8,102,2014-04-02,SAC,LAL,2014,108.0
3963,3963,63,Home,W 107-103 ,240,34,75,0.453,24,50,0.48,10,25,0.4,29,39,0.744,107,36,87,0.414,27,61,0.443,9,26,0.346,22,30,0.733,103,2014-04-02,TOR,HOU,2014,107.5
3964,3964,64,Home,L 107-113 ,240,39,91,0.429,33,64,0.516,6,27,0.222,23,29,0.793,107,41,82,0.5,27,53,0.509,14,29,0.483,17,20,0.85,113,2014-04-03,LAC,DAL,2014,120.0
3965,3965,65,@,L 107-111 ,240,38,85,0.447,25,54,0.463,13,31,0.419,18,20,0.9,107,33,78,0.423,20,47,0.426,13,31,0.419,32,37,0.865,111,2014-04-04,OKC,HOU,2014,117.5
3966,3966,66,@,W 107-95 ,240,44,92,0.478,39,71,0.549,5,21,0.238,14,15,0.933,107,35,83,0.422,28,55,0.509,7,28,0.25,18,24,0.75,95,2014-04-04,DAL,LAL,2014,98.5
3967,3967,67,@,W 107-88 ,240,41,73,0.562,29,46,0.63,12,27,0.444,13,17,0.765,107,32,78,0.41,27,58,0.466,5,20,0.25,19,30,0.633,88,2014-04-06,ATL,IND,2014,90.5
3968,3968,68,@,W 107-92 ,240,38,80,0.475,26,58,0.448,12,22,0.545,19,27,0.704,107,34,82,0.415,31,68,0.456,3,14,0.214,21,28,0.75,92,2014-04-08,OKC,SAC,2014,93.5
3969,3969,69,@,W 107-101 ,240,38,90,0.422,33,69,0.478,5,21,0.238,26,32,0.813,107,36,86,0.419,28,59,0.475,8,27,0.296,21,34,0.618,101,2014-04-09,OKC,LAC,2014,105.0
3970,3970,70,Home,W 107-102 ,240,43,78,0.551,36,58,0.621,7,20,0.35,14,21,0.667,107,38,73,0.521,23,48,0.479,15,25,0.6,11,12,0.917,102,2014-04-09,MEM,MIA,2014,109.5
3971,3971,71,Home,L 107-116 ,240,35,84,0.417,30,64,0.469,5,20,0.25,32,48,0.667,107,39,81,0.481,30,58,0.517,9,23,0.391,29,35,0.829,116,2014-04-13,DET,TOR,2014,120.5
3972,3972,72,Home,W 107-95 ,240,39,81,0.481,30,53,0.566,9,28,0.321,20,23,0.87,107,36,75,0.48,30,56,0.536,6,19,0.316,17,24,0.708,95,2014-10-29,MIA,WAS,2015,98.0
3973,3973,73,Home,W 107-102 ,240,35,70,0.5,26,46,0.565,9,24,0.375,28,38,0.737,107,37,79,0.468,33,63,0.524,4,16,0.25,24,39,0.615,102,2014-11-02,MIA,TOR,2015,104.0
3974,3974,74,Home,W 107-101 ,240,41,81,0.506,31,58,0.534,10,23,0.435,15,17,0.882,107,36,77,0.468,26,50,0.52,10,27,0.37,19,24,0.792,101,2014-11-03,LAC,UTA,2015,106.0
3975,3975,75,Home,L 107-110 ,240,40,78,0.513,30,52,0.577,10,26,0.385,17,18,0.944,107,42,87,0.483,35,71,0.493,7,16,0.438,19,23,0.826,110,2014-11-05,BOS,TOR,2015,113.5
3976,3976,76,Home,W 107-92 ,240,42,82,0.512,36,65,0.554,6,17,0.353,17,22,0.773,107,35,79,0.443,32,65,0.492,3,14,0.214,19,27,0.704,92,2014-11-09,LAL,CHO,2015,93.5
3977,3977,77,Home,W 107-95 ,240,34,79,0.43,22,49,0.449,12,30,0.4,27,33,0.818,107,33,69,0.478,22,45,0.489,11,24,0.458,18,21,0.857,95,2014-11-09,PHO,GSW,2015,100.5
3978,3978,78,Home,W 107-102 ,240,41,78,0.526,37,67,0.552,4,11,0.364,21,26,0.808,107,41,87,0.471,34,65,0.523,7,22,0.318,13,17,0.765,102,2014-11-11,MEM,LAL,2015,105.5
3979,3979,79,Home,W 107-103 ,240,40,83,0.482,37,72,0.514,3,11,0.273,24,33,0.727,107,38,81,0.469,29,59,0.492,9,22,0.409,18,22,0.818,103,2014-11-12,WAS,DET,2015,107.5
3980,3980,80,Home,W 107-99 ,240,41,90,0.456,30,56,0.536,11,34,0.324,14,21,0.667,107,39,89,0.438,36,73,0.493,3,16,0.188,18,20,0.9,99,2014-11-13,GSW,BRK,2015,100.5
3981,3981,81,@,L 107-120 ,240,38,99,0.384,27,69,0.391,11,30,0.367,20,23,0.87,107,36,68,0.529,22,39,0.564,14,29,0.483,34,43,0.791,120,2014-11-15,PHO,LAC,2015,127.0
3982,3982,82,@,W 107-80 ,240,43,84,0.512,33,56,0.589,10,28,0.357,11,16,0.688,107,32,80,0.4,22,58,0.379,10,22,0.455,6,13,0.462,80,2014-11-17,DAL,CHO,2015,85.0
3983,3983,83,@,W 107-93 ,240,41,79,0.519,28,53,0.528,13,26,0.5,12,15,0.8,107,32,80,0.4,21,56,0.375,11,24,0.458,18,24,0.75,93,2014-11-17,ORL,DET,2015,98.5
3984,3984,84,Home,W 107-100 ,240,40,82,0.488,30,53,0.566,10,29,0.345,17,22,0.773,107,36,79,0.456,26,56,0.464,10,23,0.435,18,25,0.72,100,2014-11-19,DEN,OKC,2015,105.0
3985,3985,85,Home,W 107-91 ,240,42,85,0.494,35,64,0.547,7,21,0.333,16,23,0.696,107,32,77,0.416,25,52,0.481,7,25,0.28,20,28,0.714,91,2014-11-23,MEM,LAC,2015,94.5
3986,3986,86,Home,W 107-93 ,240,39,86,0.453,27,53,0.509,12,33,0.364,17,25,0.68,107,39,90,0.433,37,81,0.457,2,9,0.222,13,20,0.65,93,2014-11-30,POR,MIN,2015,94.0
3987,3987,87,Home,W 107-86 ,240,39,72,0.542,29,53,0.547,10,19,0.526,19,24,0.792,107,33,72,0.458,31,50,0.62,2,22,0.091,18,30,0.6,86,2014-12-01,WAS,MIA,2015,87.0
3988,3988,88,@,W 107-105 ,240,42,92,0.457,34,65,0.523,8,27,0.296,15,22,0.682,107,38,73,0.521,31,62,0.5,7,11,0.636,22,32,0.688,105,2014-12-03,DAL,MIL,2015,108.5
3989,3989,89,@,W 107-101 ,240,40,84,0.476,26,59,0.441,14,25,0.56,13,16,0.813,107,37,80,0.463,32,68,0.471,5,12,0.417,22,26,0.846,101,2014-12-05,SAS,MEM,2015,103.5
3990,3990,90,@,L 107-112 (OT),265,43,104,0.413,33,74,0.446,10,30,0.333,11,15,0.733,107,41,81,0.506,32,48,0.667,9,33,0.273,21,29,0.724,112,2014-12-08,DEN,TOR,2015,116.5
3991,3991,91,@,L 107-112 ,240,40,88,0.455,33,70,0.471,7,18,0.389,20,24,0.833,107,44,83,0.53,35,62,0.565,9,21,0.429,15,17,0.882,112,2014-12-10,NOP,DAL,2015,116.5
3992,3992,92,@,L 107-113 (2OT),290,41,98,0.418,35,81,0.432,6,17,0.353,19,27,0.704,107,39,85,0.459,33,72,0.458,6,13,0.462,29,38,0.763,113,2014-12-12,CHA,MEM,2015,116.0
3993,3993,93,@,W 107-87 ,240,42,83,0.506,27,50,0.54,15,33,0.455,8,8,1.0,107,37,84,0.44,32,63,0.508,5,21,0.238,8,10,0.8,87,2014-12-16,DAL,NYK,2015,89.5
3994,3994,94,Home,L 107-108 ,240,38,67,0.567,32,53,0.604,6,14,0.429,25,33,0.758,107,37,75,0.493,24,52,0.462,13,23,0.565,21,27,0.778,108,2014-12-18,SAC,MIL,2015,114.5
3995,3995,95,Home,W 107-104 ,240,34,76,0.447,22,53,0.415,12,23,0.522,27,35,0.771,107,37,92,0.402,26,63,0.413,11,29,0.379,19,28,0.679,104,2014-12-23,ATL,LAC,2015,109.5
3996,3996,96,@,W 107-77 ,240,40,79,0.506,32,60,0.533,8,19,0.421,19,23,0.826,107,31,76,0.408,27,53,0.509,4,23,0.174,11,14,0.786,77,2014-12-26,MIL,ATL,2015,79.0
3997,3997,97,Home,L 107-109 ,240,45,87,0.517,36,63,0.571,9,24,0.375,8,11,0.727,107,41,83,0.494,34,62,0.548,7,21,0.333,20,28,0.714,109,2014-12-26,BOS,BRK,2015,112.5
3998,3998,98,Home,W 107-100 ,240,41,89,0.461,35,69,0.507,6,20,0.3,19,22,0.864,107,41,88,0.466,37,74,0.5,4,14,0.286,14,16,0.875,100,2014-12-27,CHI,NOP,2015,102.0
3999,3999,99,@,L 107-112 ,240,45,90,0.5,40,76,0.526,5,14,0.357,12,21,0.571,107,39,88,0.443,29,57,0.509,10,31,0.323,24,28,0.857,112,2014-12-28,OKC,DAL,2015,117.0
4000,4000,0,Home,L 107-116 ,240,42,81,0.519,30,61,0.492,12,20,0.6,11,20,0.55,107,44,87,0.506,35,65,0.538,9,22,0.409,19,24,0.792,116,2014-12-28,LAL,PHO,2015,120.5
4001,4001,1,Home,W 107-99 ,240,36,80,0.45,28,59,0.475,8,21,0.381,27,39,0.692,107,37,76,0.487,28,56,0.5,9,20,0.45,16,20,0.8,99,2014-12-29,BRK,SAC,2015,103.5
4002,4002,2,Home,L 107-110 ,240,42,91,0.462,35,67,0.522,7,24,0.292,16,22,0.727,107,40,74,0.541,35,62,0.565,5,12,0.417,25,29,0.862,110,2015-01-01,MIN,SAC,2015,112.5
4003,4003,3,Home,L 107-115 ,240,42,93,0.452,29,60,0.483,13,33,0.394,10,12,0.833,107,43,84,0.512,37,67,0.552,6,17,0.353,23,31,0.742,115,2015-01-03,POR,ATL,2015,118.0
4004,4004,4,@,W 107-98 ,240,36,81,0.444,23,54,0.426,13,27,0.481,22,33,0.667,107,33,74,0.446,26,49,0.531,7,25,0.28,25,33,0.758,98,2015-01-05,ATL,LAC,2015,101.5
4005,4005,5,Home,W 107-103 (OT),265,34,92,0.37,25,69,0.362,9,23,0.391,30,34,0.882,107,41,103,0.398,31,69,0.449,10,34,0.294,11,16,0.688,103,2015-01-09,IND,BOS,2015,108.0
4006,4006,6,Home,W 107-100 ,240,40,76,0.526,33,56,0.589,7,20,0.35,20,27,0.741,107,36,82,0.439,23,47,0.489,13,35,0.371,15,20,0.75,100,2015-01-13,PHO,CLE,2015,106.5
4007,4007,7,@,L 107-114 ,240,41,100,0.41,32,63,0.508,9,37,0.243,16,20,0.8,107,41,82,0.5,37,63,0.587,4,19,0.211,28,35,0.8,114,2015-01-14,DAL,DEN,2015,116.0
4008,4008,8,@,W 107-99 ,240,40,84,0.476,29,58,0.5,11,26,0.423,16,21,0.762,107,37,80,0.463,28,54,0.519,9,26,0.346,16,20,0.8,99,2015-01-17,ATL,CHI,2015,103.5
4009,4009,9,Home,W 107-89 ,240,38,88,0.432,23,53,0.434,15,35,0.429,16,19,0.842,107,38,82,0.463,31,54,0.574,7,28,0.25,6,7,0.857,89,2015-01-17,DET,PHI,2015,92.5
4010,4010,10,Home,W 107-96 ,240,39,86,0.453,29,59,0.492,10,27,0.37,19,25,0.76,107,35,79,0.443,24,54,0.444,11,25,0.44,15,31,0.484,96,2015-02-06,BOS,PHI,2015,101.5
4011,4011,11,@,L 107-123 ,240,38,78,0.487,32,55,0.582,6,23,0.261,25,31,0.806,107,40,75,0.533,27,45,0.6,13,30,0.433,30,37,0.811,123,2015-02-06,LAC,TOR,2015,129.5
4012,4012,12,@,W 107-72 ,240,43,84,0.512,33,62,0.532,10,22,0.455,11,13,0.846,107,32,86,0.372,28,69,0.406,4,17,0.235,4,7,0.571,72,2015-02-07,CHI,NOP,2015,74.0
4013,4013,13,@,L 107-112 ,240,47,88,0.534,37,63,0.587,10,25,0.4,3,8,0.375,107,43,89,0.483,31,65,0.477,12,24,0.5,14,16,0.875,112,2015-02-21,PHO,CHI,2015,118.0
4014,4014,14,Home,L 107-114 ,240,42,79,0.532,37,61,0.607,5,18,0.278,18,21,0.857,107,45,90,0.5,33,67,0.493,12,23,0.522,12,17,0.706,114,2015-02-24,WAS,GSW,2015,120.0
4015,4015,15,@,W 107-96 ,240,35,88,0.398,27,65,0.415,8,23,0.348,29,32,0.906,107,38,79,0.481,37,75,0.493,1,4,0.25,19,23,0.826,96,2015-02-27,SAS,SAC,2015,96.5
4016,4016,16,@,L 107-117 ,240,43,97,0.443,35,71,0.493,8,26,0.308,13,18,0.722,107,41,85,0.482,30,67,0.448,11,18,0.611,24,30,0.8,117,2015-03-10,TOR,SAS,2015,122.5
4017,4017,17,Home,W 107-87 ,240,40,80,0.5,35,63,0.556,5,17,0.294,22,31,0.71,107,31,80,0.388,28,61,0.459,3,19,0.158,22,30,0.733,87,2015-03-12,WAS,MEM,2015,88.5
4018,4018,18,@,L 107-114 ,240,35,87,0.402,31,73,0.425,4,14,0.286,33,40,0.825,107,45,95,0.474,36,63,0.571,9,32,0.281,15,23,0.652,114,2015-03-13,SAC,PHI,2015,118.5
4019,4019,19,Home,W 107-94 ,240,39,78,0.5,28,51,0.549,11,27,0.407,18,27,0.667,107,38,89,0.427,32,67,0.478,6,22,0.273,12,17,0.706,94,2015-03-17,HOU,ORL,2015,97.0
4020,4020,20,Home,W 107-102 ,240,39,80,0.488,26,49,0.531,13,31,0.419,16,24,0.667,107,40,87,0.46,31,59,0.525,9,28,0.321,13,14,0.929,102,2015-03-18,DAL,ORL,2015,106.5
4021,4021,21,Home,W 107-91 ,240,44,90,0.489,33,64,0.516,11,26,0.423,8,10,0.8,107,33,77,0.429,27,56,0.482,6,21,0.286,19,24,0.792,91,2015-03-21,DET,CHI,2015,94.0
4022,4022,22,Home,W 107-100 ,240,42,91,0.462,35,68,0.515,7,23,0.304,16,23,0.696,107,38,75,0.507,26,53,0.491,12,22,0.545,12,16,0.75,100,2015-03-22,LAC,NOP,2015,106.0
4023,4023,23,Home,W 107-76 ,240,39,95,0.411,26,62,0.419,13,33,0.394,16,21,0.762,107,27,81,0.333,24,70,0.343,3,11,0.273,19,26,0.731,76,2015-03-23,GSW,WAS,2015,77.5
4024,4024,24,Home,W 107-106 ,240,35,97,0.361,28,77,0.364,7,20,0.35,30,38,0.789,107,40,81,0.494,27,53,0.509,13,28,0.464,13,21,0.619,106,2015-03-24,SAC,PHI,2015,112.5
4025,4025,25,@,L 107-111 ,240,30,71,0.423,16,41,0.39,14,30,0.467,33,43,0.767,107,39,73,0.534,30,54,0.556,9,19,0.474,24,34,0.706,111,2015-03-26,IND,MIL,2015,115.5
4026,4026,26,Home,W 107-91 ,240,39,76,0.513,26,52,0.5,13,24,0.542,16,23,0.696,107,32,81,0.395,27,54,0.5,5,27,0.185,22,31,0.71,91,2015-03-27,DEN,UTA,2015,93.5
4027,4027,27,@,W 107-84 ,240,39,90,0.433,23,59,0.39,16,31,0.516,13,17,0.765,107,34,76,0.447,29,63,0.46,5,13,0.385,11,15,0.733,84,2015-03-27,GSW,MEM,2015,86.5
4028,4028,28,@,L 107-110 (2OT),290,36,104,0.346,28,79,0.354,8,25,0.32,27,35,0.771,107,44,113,0.389,35,88,0.398,9,25,0.36,13,22,0.591,110,2015-03-27,CHA,WAS,2015,114.5
4029,4029,29,Home,W 107-99 ,240,42,87,0.483,34,59,0.576,8,28,0.286,15,21,0.714,107,42,91,0.462,36,73,0.493,6,18,0.333,9,11,0.818,99,2015-03-29,BRK,LAL,2015,102.0
4030,4030,30,Home,W 107-106 ,240,43,93,0.462,33,67,0.493,10,26,0.385,11,17,0.647,107,42,90,0.467,37,71,0.521,5,19,0.263,17,26,0.654,106,2015-04-02,GSW,PHO,2015,108.5
4031,4031,31,@,W 107-77 ,240,43,88,0.489,33,62,0.532,10,26,0.385,11,11,1.0,107,31,82,0.378,26,68,0.382,5,14,0.357,10,17,0.588,77,2015-04-03,POR,LAL,2015,79.5
4032,4032,32,@,W 107-92 ,240,34,79,0.43,21,45,0.467,13,34,0.382,26,42,0.619,107,32,85,0.376,26,63,0.413,6,22,0.273,22,31,0.71,92,2015-04-04,LAC,DEN,2015,95.0
4033,4033,33,Home,W 107-92 ,240,44,83,0.53,37,62,0.597,7,21,0.333,12,15,0.8,107,39,91,0.429,30,63,0.476,9,28,0.321,5,10,0.5,92,2015-04-05,SAS,GSW,2015,96.5
4034,4034,34,Home,W 107-104 ,240,45,94,0.479,41,76,0.539,4,18,0.222,13,16,0.813,107,40,82,0.488,32,57,0.561,8,25,0.32,16,19,0.842,104,2015-04-08,DAL,PHO,2015,108.0
4035,4035,35,@,W 107-103 ,240,38,79,0.481,27,60,0.45,11,19,0.579,20,22,0.909,107,40,89,0.449,29,66,0.439,11,23,0.478,12,23,0.522,103,2015-04-10,IND,DET,2015,108.5
4036,4036,36,@,L 107-114 ,240,37,89,0.416,24,48,0.5,13,41,0.317,20,25,0.8,107,40,90,0.444,31,64,0.484,9,26,0.346,25,36,0.694,114,2015-04-11,PHI,CHI,2015,118.5
4037,4037,37,@,W 107-104 ,240,35,83,0.422,26,57,0.456,9,26,0.346,28,37,0.757,107,37,81,0.457,31,61,0.508,6,20,0.3,24,44,0.545,104,2015-04-11,TOR,MIA,2015,107.0
4038,4038,38,Home,W 107-91 ,240,35,69,0.507,27,50,0.54,8,19,0.421,29,34,0.853,107,35,85,0.412,31,69,0.449,4,16,0.25,17,23,0.739,91,2015-04-12,SAS,PHO,2015,93.0
4039,4039,39,@,L 107-111 ,240,41,98,0.418,36,83,0.434,5,15,0.333,20,25,0.8,107,39,74,0.527,26,50,0.52,13,24,0.542,20,27,0.741,111,2015-04-13,MEM,GSW,2015,117.5
4040,4040,40,@,W 107-97 ,240,40,81,0.494,36,72,0.5,4,9,0.444,23,36,0.639,107,32,81,0.395,26,53,0.491,6,28,0.214,27,34,0.794,97,2015-04-13,MIL,PHI,2015,100.0
4041,4041,41,@,W 107-100 ,240,42,81,0.519,34,59,0.576,8,22,0.364,15,20,0.75,107,38,85,0.447,31,61,0.508,7,24,0.292,17,23,0.739,100,2015-11-02,CLE,PHI,2016,103.5
4042,4042,42,Home,W 107-98 ,240,40,84,0.476,31,60,0.517,9,24,0.375,18,22,0.818,107,39,86,0.453,30,58,0.517,9,28,0.321,11,13,0.846,98,2015-11-07,DAL,NOP,2016,102.5
4043,4043,43,Home,L 107-117 ,240,44,86,0.512,31,55,0.564,13,31,0.419,6,7,0.857,107,46,80,0.575,39,65,0.6,7,15,0.467,18,22,0.818,117,2015-11-09,ATL,MIN,2016,120.5
4044,4044,44,Home,W 107-98 ,240,37,81,0.457,28,61,0.459,9,20,0.45,24,32,0.75,107,33,77,0.429,24,48,0.5,9,29,0.31,23,31,0.742,98,2015-11-13,DEN,HOU,2016,102.5
4045,4045,45,Home,W 107-103 ,240,41,86,0.477,31,61,0.508,10,25,0.4,15,23,0.652,107,42,83,0.506,35,63,0.556,7,20,0.35,12,13,0.923,103,2015-11-13,IND,MIN,2016,106.5
4046,4046,46,Home,W 107-99 (OT),265,43,97,0.443,31,63,0.492,12,34,0.353,9,10,0.9,107,41,98,0.418,39,80,0.488,2,18,0.111,15,16,0.938,99,2015-11-14,GSW,BRK,2016,100.0
4047,4047,47,Home,W 107-101 ,240,39,76,0.513,29,51,0.569,10,25,0.4,19,24,0.792,107,38,87,0.437,23,56,0.411,15,31,0.484,10,14,0.714,101,2015-11-15,SAC,TOR,2016,108.5
4048,4048,48,Home,L 107-114 ,240,41,90,0.456,36,66,0.545,5,24,0.208,20,26,0.769,107,40,79,0.506,25,52,0.481,15,27,0.556,19,25,0.76,114,2015-11-20,DEN,PHO,2016,121.5
4049,4049,49,@,W 107-102 ,240,34,80,0.425,22,55,0.4,12,25,0.48,27,34,0.794,107,35,81,0.432,23,53,0.434,12,28,0.429,20,28,0.714,102,2015-11-21,NYK,HOU,2016,108.0
4050,4050,50,@,W 107-93 ,240,43,87,0.494,35,62,0.565,8,25,0.32,13,17,0.765,107,32,88,0.364,26,70,0.371,6,18,0.333,23,27,0.852,93,2015-11-22,POR,LAL,2016,96.0
4051,4051,51,Home,W 107-99 ,240,39,75,0.52,31,53,0.585,8,22,0.364,21,33,0.636,107,37,82,0.451,29,66,0.439,8,16,0.5,17,21,0.81,99,2015-11-29,LAC,MIN,2016,103.0
4052,4052,52,@,W 107-103 ,240,34,83,0.41,25,56,0.446,9,27,0.333,30,37,0.811,107,38,99,0.384,27,66,0.409,11,33,0.333,16,22,0.727,103,2015-11-29,IND,LAL,2016,108.5
4053,4053,53,@,W 107-102 ,240,40,94,0.426,29,67,0.433,11,27,0.407,16,20,0.8,107,38,86,0.442,26,57,0.456,12,29,0.414,14,17,0.824,102,2015-11-29,PHO,TOR,2016,108.0
4054,4054,54,Home,W 107-104 ,240,41,80,0.513,35,56,0.625,6,24,0.25,19,27,0.704,107,40,85,0.471,28,60,0.467,12,25,0.48,12,16,0.75,104,2015-12-09,PHO,ORL,2016,110.0
4055,4055,55,Home,W 107-94 ,240,39,80,0.488,30,63,0.476,9,17,0.529,20,26,0.769,107,35,78,0.449,25,50,0.5,10,28,0.357,14,23,0.609,94,2015-12-10,OKC,ATL,2016,99.0
4056,4056,56,Home,W 107-105 ,240,39,79,0.494,23,52,0.442,16,27,0.593,13,18,0.722,107,40,80,0.5,28,53,0.528,12,27,0.444,13,21,0.619,105,2015-12-11,NOP,WAS,2016,111.0
4057,4057,57,@,W 107-95 ,240,43,93,0.462,33,66,0.5,10,27,0.37,11,16,0.688,107,36,80,0.45,30,62,0.484,6,18,0.333,17,24,0.708,95,2015-12-11,DET,PHI,2016,98.0
4058,4058,58,Home,W 107-97 ,240,38,75,0.507,27,51,0.529,11,24,0.458,20,29,0.69,107,34,82,0.415,22,43,0.512,12,39,0.308,17,23,0.739,97,2015-12-15,SAC,HOU,2016,103.0
4059,4059,59,Home,W 107-81 ,240,43,89,0.483,32,60,0.533,11,29,0.379,10,17,0.588,107,33,90,0.367,25,57,0.439,8,33,0.242,7,10,0.7,81,2015-12-16,IND,DAL,2016,85.0
4060,4060,60,Home,W 107-102 ,240,37,85,0.435,29,64,0.453,8,21,0.381,25,30,0.833,107,42,101,0.416,38,80,0.475,4,21,0.19,14,14,1.0,102,2015-12-16,NYK,MIN,2016,104.0
4061,4061,61,@,W 107-87 ,240,34,88,0.386,22,57,0.386,12,31,0.387,27,42,0.643,107,36,84,0.429,31,60,0.517,5,24,0.208,10,18,0.556,87,2015-12-17,HOU,LAL,2016,89.5
4062,4062,62,@,W 107-97 ,240,40,85,0.471,34,66,0.515,6,19,0.316,21,28,0.75,107,37,77,0.481,31,53,0.585,6,24,0.25,17,30,0.567,97,2015-12-18,NYK,PHI,2016,100.0
4063,4063,63,@,L 107-115 ,240,36,72,0.5,26,48,0.542,10,24,0.417,25,40,0.625,107,43,87,0.494,33,68,0.485,10,19,0.526,19,24,0.792,115,2015-12-18,LAC,SAS,2016,120.0
4064,4064,64,Home,W 107-97 ,240,34,76,0.447,26,51,0.51,8,25,0.32,31,49,0.633,107,34,86,0.395,23,48,0.479,11,38,0.289,18,29,0.621,97,2015-12-19,HOU,LAC,2016,102.5
4065,4065,65,Home,W 107-91 ,240,41,82,0.5,36,62,0.581,5,20,0.25,20,24,0.833,107,37,94,0.394,32,73,0.438,5,21,0.238,12,17,0.706,91,2015-12-19,NYK,CHI,2016,93.5
4066,4066,66,@,W 107-99 ,240,44,86,0.512,34,64,0.531,10,22,0.455,9,11,0.818,107,39,76,0.513,32,52,0.615,7,24,0.292,14,16,0.875,99,2015-12-21,ORL,NYK,2016,102.5
4067,4067,67,Home,L 107-111 ,240,41,90,0.456,32,65,0.492,9,25,0.36,16,19,0.842,107,40,84,0.476,33,58,0.569,7,26,0.269,24,32,0.75,111,2015-12-22,DEN,LAL,2016,114.5
4068,4068,68,Home,W 107-100 ,240,43,89,0.483,37,69,0.536,6,20,0.3,15,20,0.75,107,38,89,0.427,31,68,0.456,7,21,0.333,17,33,0.515,100,2015-12-23,ATL,DET,2016,103.5
4069,4069,69,@,W 107-101 ,240,40,84,0.476,35,66,0.53,5,18,0.278,22,24,0.917,107,37,87,0.425,22,48,0.458,15,39,0.385,12,19,0.632,101,2016-01-05,NYK,ATL,2016,108.5
4070,4070,70,Home,W 107-103 (OT),265,39,89,0.438,25,51,0.49,14,38,0.368,15,23,0.652,107,43,90,0.478,34,59,0.576,9,31,0.29,8,10,0.8,103,2016-01-10,HOU,IND,2016,107.5
4071,4071,71,Home,L 107-110 (OT),265,39,79,0.494,28,51,0.549,11,28,0.393,18,22,0.818,107,40,97,0.412,23,53,0.434,17,44,0.386,13,16,0.813,110,2016-01-12,DAL,CLE,2016,118.5
4072,4072,72,@,W 107-91 ,240,33,77,0.429,15,42,0.357,18,35,0.514,23,27,0.852,107,33,72,0.458,26,54,0.481,7,18,0.389,18,24,0.75,91,2016-01-12,HOU,MEM,2016,94.5
4073,4073,73,Home,W 107-84 ,240,36,82,0.439,23,43,0.535,13,39,0.333,22,26,0.846,107,30,81,0.37,23,56,0.411,7,25,0.28,17,21,0.81,84,2016-01-13,CHA,ATL,2016,87.5
4074,4074,74,Home,W 107-104 ,240,37,75,0.493,30,45,0.667,7,30,0.233,26,38,0.684,107,36,78,0.462,28,61,0.459,8,17,0.471,24,30,0.8,104,2016-01-13,HOU,MIN,2016,108.0
4075,4075,75,@,L 107-109 ,240,42,86,0.488,28,51,0.549,14,35,0.4,9,12,0.75,107,43,87,0.494,31,60,0.517,12,27,0.444,11,13,0.846,109,2016-01-15,CHA,NOP,2016,115.0
4076,4076,76,@,L 107-114 ,240,41,84,0.488,37,68,0.544,4,16,0.25,21,23,0.913,107,45,89,0.506,34,58,0.586,11,31,0.355,13,20,0.65,114,2016-01-25,MIN,CLE,2016,119.5
4077,4077,77,Home,W 107-100 ,240,38,77,0.494,33,64,0.516,5,13,0.385,26,31,0.839,107,33,80,0.413,20,56,0.357,13,24,0.542,21,29,0.724,100,2016-01-26,MIL,ORL,2016,106.5
4078,4078,78,@,L 107-127 ,240,44,87,0.506,33,56,0.589,11,31,0.355,8,12,0.667,107,47,81,0.58,33,52,0.635,14,29,0.483,19,21,0.905,127,2016-01-27,DAL,GSW,2016,134.0
4079,4079,79,@,W 107-103 ,240,37,74,0.5,30,56,0.536,7,18,0.389,26,32,0.813,107,38,80,0.475,36,68,0.529,2,12,0.167,25,28,0.893,103,2016-01-29,MIA,MIL,2016,104.0
4080,4080,80,@,L 107-111 ,240,39,87,0.448,30,58,0.517,9,29,0.31,20,34,0.588,107,36,78,0.462,32,64,0.5,4,14,0.286,35,47,0.745,111,2016-01-30,DET,TOR,2016,113.0
4081,4081,81,Home,W 107-92 ,240,40,78,0.513,31,54,0.574,9,24,0.375,18,21,0.857,107,39,96,0.406,34,79,0.43,5,17,0.294,9,11,0.818,92,2016-02-01,SAS,ORL,2016,94.5
4082,4082,82,Home,W 107-95 ,240,39,85,0.459,28,54,0.519,11,31,0.355,18,25,0.72,107,38,86,0.442,33,72,0.458,5,14,0.357,14,24,0.583,95,2016-02-02,POR,MIL,2016,97.5
4083,4083,83,@,W 107-102 ,240,40,88,0.455,29,67,0.433,11,21,0.524,16,21,0.762,107,42,88,0.477,36,68,0.529,6,20,0.3,12,19,0.632,102,2016-02-03,CHI,SAC,2016,105.0
4084,4084,84,@,W 107-93 ,240,40,74,0.541,32,47,0.681,8,27,0.296,19,23,0.826,107,34,81,0.42,30,61,0.492,4,20,0.2,21,28,0.75,93,2016-02-05,LAC,ORL,2016,95.0
4085,4085,85,@,L 107-112 ,240,42,87,0.483,38,72,0.528,4,15,0.267,19,25,0.76,107,41,84,0.488,36,61,0.59,5,23,0.217,25,33,0.758,112,2016-02-25,MIL,BOS,2016,114.5
4086,4086,86,Home,L 107-117 ,240,34,78,0.436,22,54,0.407,12,24,0.5,27,37,0.73,107,43,89,0.483,34,60,0.567,9,29,0.31,22,26,0.846,117,2016-02-26,SAC,LAC,2016,121.5
4087,4087,87,Home,W 107-101 ,240,41,83,0.494,30,57,0.526,11,26,0.423,14,21,0.667,107,39,89,0.438,34,71,0.479,5,18,0.278,18,27,0.667,101,2016-03-01,LAL,BRK,2016,103.5
4088,4088,88,@,L 107-117 ,240,35,79,0.443,24,48,0.5,11,31,0.355,26,32,0.813,107,38,78,0.487,26,55,0.473,12,23,0.522,29,38,0.763,117,2016-03-02,LAL,DEN,2016,123.0
4089,4089,89,@,W 107-97 ,240,40,89,0.449,30,62,0.484,10,27,0.37,17,20,0.85,107,34,79,0.43,22,47,0.468,12,32,0.375,17,28,0.607,97,2016-03-05,ATL,LAC,2016,103.0
4090,4090,90,Home,L 107-113 ,240,37,77,0.481,25,44,0.568,12,33,0.364,21,27,0.778,107,38,78,0.487,25,49,0.51,13,29,0.448,24,37,0.649,113,2016-03-06,TOR,HOU,2016,119.5
4091,4091,91,Home,W 107-98 ,240,40,81,0.494,31,54,0.574,9,27,0.333,18,23,0.783,107,37,76,0.487,32,57,0.561,5,19,0.263,19,27,0.704,98,2016-03-08,LAL,ORL,2016,100.5
4092,4092,92,@,W 107-100 ,240,41,79,0.519,37,64,0.578,4,15,0.267,21,34,0.618,107,35,88,0.398,27,63,0.429,8,25,0.32,22,25,0.88,100,2016-03-11,ORL,SAC,2016,104.0
4093,4093,93,@,W 107-96 ,240,42,87,0.483,33,57,0.579,9,30,0.3,14,18,0.778,107,32,76,0.421,22,46,0.478,10,30,0.333,22,34,0.647,96,2016-03-14,DAL,CHO,2016,101.0
4094,4094,94,@,L 107-125 ,240,35,93,0.376,28,68,0.412,7,25,0.28,30,34,0.882,107,47,81,0.58,35,56,0.625,12,25,0.48,19,23,0.826,125,2016-03-14,NOP,GSW,2016,131.0
4095,4095,95,Home,W 107-104 ,240,40,95,0.421,29,60,0.483,11,35,0.314,16,20,0.8,107,37,84,0.44,33,68,0.485,4,16,0.25,26,30,0.867,104,2016-03-14,PHO,MIN,2016,106.0
4096,4096,96,Home,L 107-109 ,240,37,83,0.446,31,63,0.492,6,20,0.3,27,31,0.871,107,41,83,0.494,32,58,0.552,9,25,0.36,18,20,0.9,109,2016-03-14,TOR,CHI,2016,113.5
4097,4097,97,@,W 107-89 ,240,39,83,0.47,25,53,0.472,14,30,0.467,15,17,0.882,107,34,77,0.442,32,64,0.5,2,13,0.154,19,26,0.731,89,2016-03-15,TOR,MIL,2016,90.0
4098,4098,98,Home,W 107-99 ,240,40,100,0.4,29,63,0.46,11,37,0.297,16,21,0.762,107,35,83,0.422,24,58,0.414,11,25,0.44,18,21,0.857,99,2016-03-16,CHA,ORL,2016,104.5
4099,4099,99,Home,W 107-96 ,240,40,85,0.471,33,63,0.524,7,22,0.318,20,24,0.833,107,39,93,0.419,34,74,0.459,5,19,0.263,13,19,0.684,96,2016-03-21,BOS,ORL,2016,98.5
4100,4100,0,Home,W 107-100 ,240,39,77,0.506,33,58,0.569,6,19,0.316,23,24,0.958,107,40,80,0.5,36,65,0.554,4,15,0.267,16,23,0.696,100,2016-03-22,LAL,MEM,2016,102.0
4101,4101,1,@,L 107-111 ,240,40,92,0.435,27,55,0.491,13,37,0.351,14,17,0.824,107,41,91,0.451,33,56,0.589,8,35,0.229,21,29,0.724,111,2016-03-22,HOU,OKC,2016,115.0
4102,4102,2,Home,L 107-115 ,240,38,82,0.463,23,50,0.46,15,32,0.469,16,21,0.762,107,45,87,0.517,31,62,0.5,14,25,0.56,11,15,0.733,115,2016-03-23,CHI,NYK,2016,122.0
4103,4103,3,@,L 107-119 ,240,39,93,0.419,32,66,0.485,7,27,0.259,22,26,0.846,107,47,93,0.505,34,65,0.523,13,28,0.464,12,20,0.6,119,2016-03-23,LAL,PHO,2016,125.5
4104,4104,4,@,W 107-93 ,240,37,83,0.446,23,49,0.469,14,34,0.412,19,25,0.76,107,33,79,0.418,25,56,0.446,8,23,0.348,19,28,0.679,93,2016-03-26,CLE,NYK,2016,97.0
4105,4105,5,Home,W 107-87 ,240,38,87,0.437,26,49,0.531,12,38,0.316,19,24,0.792,107,35,94,0.372,31,73,0.425,4,21,0.19,13,21,0.619,87,2016-03-31,CLE,BRK,2016,89.0
4106,4106,6,@,W 107-100 ,240,41,91,0.451,33,61,0.541,8,30,0.267,17,22,0.773,107,37,90,0.411,31,69,0.449,6,21,0.286,20,29,0.69,100,2016-04-03,BOS,LAL,2016,103.0
4107,4107,7,@,L 107-119 ,240,41,89,0.461,33,68,0.485,8,21,0.381,17,26,0.654,107,43,90,0.478,33,64,0.516,10,26,0.385,23,29,0.793,119,2016-04-03,MEM,ORL,2016,124.0
4108,4108,8,Home,W 107-89 ,240,44,84,0.524,35,70,0.5,9,14,0.643,10,14,0.714,107,32,80,0.4,27,58,0.466,5,22,0.227,20,25,0.8,89,2016-04-05,MIA,DET,2016,91.5
4109,4109,9,Home,W 107-93 ,240,40,88,0.455,27,54,0.5,13,34,0.382,14,17,0.824,107,37,82,0.451,30,64,0.469,7,18,0.389,12,16,0.75,93,2016-04-05,PHI,NOP,2016,96.5
4110,4110,10,Home,L 107-115 ,240,41,78,0.526,30,56,0.536,11,22,0.5,14,21,0.667,107,40,93,0.43,28,62,0.452,12,31,0.387,23,27,0.852,115,2016-04-05,SAC,POR,2016,121.0
4111,4111,11,@,L 107-118 ,240,40,90,0.444,29,62,0.468,11,28,0.393,16,24,0.667,107,46,88,0.523,29,55,0.527,17,33,0.515,9,11,0.818,118,2016-04-09,BOS,ATL,2016,126.5
4112,4112,12,Home,W 107-98 ,240,41,84,0.488,34,61,0.557,7,23,0.304,18,28,0.643,107,41,78,0.526,38,63,0.603,3,15,0.2,13,19,0.684,98,2016-04-11,ORL,MIL,2016,99.5
4113,4113,13,Home,W 107-99 ,240,39,89,0.438,28,53,0.528,11,36,0.306,18,22,0.818,107,40,94,0.426,33,69,0.478,7,25,0.28,12,18,0.667,99,2016-04-13,POR,DEN,2016,102.5
4114,4114,14,@,W 107-96 ,240,40,89,0.449,33,66,0.5,7,23,0.304,20,24,0.833,107,39,92,0.424,36,76,0.474,3,16,0.188,15,20,0.75,96,2016-10-26,CHA,MIL,2017,97.5
4115,4115,15,@,W 107-102 ,240,37,83,0.446,29,59,0.492,8,24,0.333,25,33,0.758,107,38,92,0.413,35,73,0.479,3,19,0.158,23,26,0.885,102,2016-10-26,DEN,NOP,2017,103.5
4116,4116,16,Home,W 107-100 ,240,41,87,0.471,27,55,0.491,14,32,0.438,11,17,0.647,107,35,81,0.432,28,61,0.459,7,20,0.35,23,31,0.742,100,2016-11-02,BOS,CHI,2017,103.5
4117,4117,17,@,L 107-125 ,240,38,81,0.469,28,58,0.483,10,23,0.435,21,27,0.778,107,47,82,0.573,35,55,0.636,12,27,0.444,19,24,0.792,125,2016-11-03,IND,MIL,2017,131.0
4118,4118,18,Home,L 107-123 ,240,41,90,0.456,33,65,0.508,8,25,0.32,17,21,0.81,107,44,84,0.524,33,61,0.541,11,23,0.478,24,31,0.774,123,2016-11-06,BOS,DEN,2017,128.5
4119,4119,19,@,L 107-108 ,240,35,70,0.5,25,46,0.543,10,24,0.417,27,34,0.794,107,44,86,0.512,37,62,0.597,7,24,0.292,13,19,0.684,108,2016-11-08,DEN,MEM,2017,111.5
4120,4120,20,@,L 107-115 ,240,41,91,0.451,32,64,0.5,9,27,0.333,16,21,0.762,107,42,83,0.506,33,63,0.524,9,20,0.45,22,27,0.815,115,2016-11-09,CHI,ATL,2017,119.5
4121,4121,21,Home,L 107-123 ,240,38,85,0.447,30,61,0.492,8,24,0.333,23,30,0.767,107,45,87,0.517,32,64,0.5,13,23,0.565,20,26,0.769,123,2016-11-09,ORL,MIN,2017,129.5
4122,4122,22,Home,W 107-100 ,240,38,84,0.452,30,62,0.484,8,22,0.364,23,30,0.767,107,32,89,0.36,23,67,0.343,9,22,0.409,27,32,0.844,100,2016-11-09,PHO,DET,2017,104.5
4123,4123,23,@,L 107-118 ,240,44,97,0.454,37,74,0.5,7,23,0.304,12,16,0.75,107,39,83,0.47,32,61,0.525,7,22,0.318,33,38,0.868,118,2016-11-12,NYK,TOR,2017,121.5
4124,4124,24,Home,W 107-100 ,240,35,72,0.486,25,40,0.625,10,32,0.313,27,31,0.871,107,39,98,0.398,31,66,0.47,8,32,0.25,14,18,0.778,100,2016-11-16,ATL,MIL,2017,104.0
4125,4125,25,Home,L 107-111 ,240,37,81,0.457,28,56,0.5,9,25,0.36,24,34,0.706,107,40,82,0.488,25,56,0.446,15,26,0.577,16,19,0.842,111,2016-11-16,LAC,MEM,2017,118.5
4126,4126,26,Home,L 107-116 ,240,39,87,0.448,27,62,0.435,12,25,0.48,17,21,0.81,107,44,78,0.564,34,54,0.63,10,24,0.417,18,19,0.947,116,2016-11-18,LAL,SAS,2017,121.0
4127,4127,27,@,L 107-110 ,240,43,95,0.453,37,77,0.481,6,18,0.333,15,18,0.833,107,43,100,0.43,33,78,0.423,10,22,0.455,14,17,0.824,110,2016-11-22,CHI,DEN,2017,115.0
4128,4128,28,Home,W 107-103 ,240,45,96,0.469,36,67,0.537,9,29,0.31,8,8,1.0,107,38,86,0.442,32,64,0.5,6,22,0.273,21,26,0.808,103,2016-11-22,NYK,POR,2017,106.0
4129,4129,29,Home,W 107-84 ,240,40,81,0.494,34,62,0.548,6,19,0.316,21,25,0.84,107,27,75,0.36,20,49,0.408,7,26,0.269,23,30,0.767,84,2016-11-23,DET,MIA,2017,87.5
4130,4130,30,Home,W 107-102 ,240,35,80,0.438,27,58,0.466,8,22,0.364,29,42,0.69,107,37,98,0.378,25,66,0.379,12,32,0.375,16,20,0.8,102,2016-11-26,CHA,NYK,2017,108.0
4131,4131,31,Home,L 107-110 ,240,40,81,0.494,29,50,0.58,11,31,0.355,16,24,0.667,107,37,73,0.507,28,48,0.583,9,25,0.36,27,33,0.818,110,2016-11-26,MIA,MEM,2017,114.5
4132,4132,32,@,L 107-109 ,240,45,89,0.506,36,64,0.563,9,25,0.36,8,10,0.8,107,40,89,0.449,30,68,0.441,10,21,0.476,19,25,0.76,109,2016-11-30,ATL,PHO,2017,114.0
4133,4133,33,Home,W 107-105 ,240,39,80,0.488,31,60,0.517,8,20,0.4,21,33,0.636,107,41,81,0.506,34,70,0.486,7,11,0.636,16,18,0.889,105,2016-12-02,SAS,WAS,2017,108.5
4134,4134,34,Home,W 107-82 ,240,40,87,0.46,27,56,0.482,13,31,0.419,14,18,0.778,107,32,71,0.451,29,58,0.5,3,13,0.231,15,21,0.714,82,2016-12-03,DAL,CHI,2017,83.5
4135,4135,35,@,W 107-106 ,240,38,76,0.5,30,50,0.6,8,26,0.308,23,29,0.793,107,35,76,0.461,20,43,0.465,15,33,0.455,21,26,0.808,106,2016-12-03,BOS,PHI,2017,113.5
4136,4136,36,Home,W 107-106 ,240,34,76,0.447,22,38,0.579,12,38,0.316,27,31,0.871,107,42,99,0.424,31,67,0.463,11,32,0.344,11,12,0.917,106,2016-12-05,HOU,BOS,2017,111.5
4137,4137,37,@,W 107-101 ,240,38,80,0.475,25,48,0.521,13,32,0.406,18,29,0.621,107,39,87,0.448,34,73,0.466,5,14,0.357,18,23,0.783,101,2016-12-05,UTA,LAL,2017,103.5
4138,4138,38,@,L 107-115 ,240,37,85,0.435,20,45,0.444,17,40,0.425,16,19,0.842,107,40,77,0.519,30,53,0.566,10,24,0.417,25,37,0.676,115,2016-12-07,POR,MIL,2017,120.0
4139,4139,39,Home,W 107-97 ,240,33,86,0.384,22,51,0.431,11,35,0.314,30,40,0.75,107,35,91,0.385,29,64,0.453,6,27,0.222,21,34,0.618,97,2016-12-14,BRK,LAL,2017,100.0
4140,4140,40,@,W 107-92 ,240,39,74,0.527,34,58,0.586,5,16,0.313,24,26,0.923,107,34,85,0.4,24,58,0.414,10,27,0.37,14,18,0.778,92,2016-12-15,SAS,PHO,2017,97.0
4141,4141,41,@,W 107-99 ,240,43,88,0.489,31,61,0.508,12,27,0.444,9,13,0.692,107,40,86,0.465,30,60,0.5,10,26,0.385,9,16,0.563,99,2016-12-17,CHA,ATL,2017,104.0
4142,4142,42,@,L 107-108 ,240,36,81,0.444,24,47,0.511,12,34,0.353,23,31,0.742,107,38,88,0.432,26,60,0.433,12,28,0.429,20,23,0.87,108,2016-12-18,BRK,PHI,2017,114.0
4143,4143,43,@,L 107-117 ,240,43,81,0.531,29,56,0.518,14,25,0.56,7,9,0.778,107,45,79,0.57,32,55,0.582,13,24,0.542,14,18,0.778,117,2016-12-19,DAL,DEN,2017,123.5
4144,4144,44,Home,W 107-105 ,240,41,87,0.471,34,66,0.515,7,21,0.333,18,21,0.857,107,38,88,0.432,30,55,0.545,8,33,0.242,21,26,0.808,105,2016-12-19,IND,WAS,2017,109.0
4145,4145,45,@,W 107-97 ,240,43,82,0.524,40,64,0.625,3,18,0.167,18,25,0.72,107,38,95,0.4,32,74,0.432,6,21,0.286,15,19,0.789,97,2016-12-21,WAS,CHI,2017,100.0
4146,4146,46,@,L 107-115 ,240,40,90,0.444,26,52,0.5,14,38,0.368,13,15,0.867,107,45,84,0.536,34,62,0.548,11,22,0.5,14,21,0.667,115,2016-12-22,LAL,MIA,2017,120.5
4147,4147,47,Home,W 107-102 ,240,40,79,0.506,28,50,0.56,12,29,0.414,15,20,0.75,107,40,85,0.471,34,64,0.531,6,21,0.286,16,23,0.696,102,2016-12-26,WAS,MIL,2017,105.0
4148,4148,48,Home,L 107-123 ,240,36,87,0.414,21,49,0.429,15,38,0.395,20,25,0.8,107,41,78,0.526,24,46,0.522,17,32,0.531,24,28,0.857,123,2016-12-27,DAL,HOU,2017,131.5
4149,4149,49,@,W 107-98 ,240,42,86,0.488,33,64,0.516,9,22,0.409,14,22,0.636,107,35,77,0.455,21,51,0.412,14,26,0.538,14,18,0.778,98,2017-01-01,DET,MIA,2017,105.0
4150,4150,50,@,W 107-102 ,240,35,72,0.486,23,44,0.523,12,28,0.429,25,29,0.862,107,40,78,0.513,32,58,0.552,8,20,0.4,14,17,0.824,102,2017-01-04,MIA,SAC,2017,106.0
4151,4151,51,@,W 107-101 ,240,41,84,0.488,31,52,0.596,10,32,0.313,15,18,0.833,107,37,80,0.463,28,57,0.491,9,23,0.391,18,20,0.9,101,2017-01-08,WAS,MIL,2017,105.5
4152,4152,52,Home,W 107-95 ,240,39,86,0.453,28,59,0.475,11,27,0.407,18,22,0.818,107,38,90,0.422,32,60,0.533,6,30,0.2,13,17,0.765,95,2017-01-10,GSW,MIA,2017,98.0
4153,4153,53,Home,L 107-109 ,240,42,88,0.477,30,58,0.517,12,30,0.4,11,14,0.786,107,44,84,0.524,34,65,0.523,10,19,0.526,11,13,0.846,109,2017-01-10,SAS,MIL,2017,114.0
4154,4154,54,@,L 107-127 ,240,43,88,0.489,37,60,0.617,6,28,0.214,15,20,0.75,107,50,89,0.562,35,60,0.583,15,29,0.517,12,18,0.667,127,2017-01-12,DET,GSW,2017,134.5
4155,4155,55,Home,W 107-99 ,240,43,101,0.426,35,81,0.432,8,20,0.4,13,23,0.565,107,39,84,0.464,32,61,0.525,7,23,0.304,14,21,0.667,99,2017-01-14,CHI,NOP,2017,102.5
4156,4156,56,@,L 107-114 ,240,38,82,0.463,26,48,0.542,12,34,0.353,19,27,0.704,107,41,83,0.494,34,57,0.596,7,26,0.269,25,36,0.694,114,2017-01-14,ORL,UTA,2017,117.5
4157,4157,57,Home,L 107-108 ,240,42,85,0.494,34,59,0.576,8,26,0.308,15,23,0.652,107,40,87,0.46,28,55,0.509,12,32,0.375,16,23,0.696,108,2017-01-16,NYK,ATL,2017,114.0
4158,4158,58,Home,W 107-85 ,240,41,87,0.471,30,61,0.492,11,26,0.423,14,17,0.824,107,33,94,0.351,25,63,0.397,8,31,0.258,11,11,1.0,85,2017-01-18,CHA,POR,2017,89.0
4159,4159,59,Home,L 107-112 (OT),265,39,87,0.448,31,64,0.484,8,23,0.348,21,28,0.75,107,38,82,0.463,30,59,0.508,8,23,0.348,28,39,0.718,112,2017-01-20,DAL,UTA,2017,116.0
4160,4160,60,Home,W 107-91 ,240,38,83,0.458,27,55,0.491,11,28,0.393,20,25,0.8,107,31,76,0.408,25,47,0.532,6,29,0.207,23,32,0.719,91,2017-01-20,MEM,SAC,2017,94.0
4161,4161,61,@,W 107-105 ,240,37,85,0.435,28,61,0.459,9,24,0.375,24,27,0.889,107,40,89,0.449,29,68,0.426,11,21,0.524,14,16,0.875,105,2017-01-21,PHO,NYK,2017,110.5
4162,4162,62,@,L 107-110 ,240,40,90,0.444,27,53,0.509,13,37,0.351,14,15,0.933,107,46,96,0.479,37,69,0.536,9,27,0.333,9,13,0.692,110,2017-01-27,CHA,NYK,2017,114.5
4163,4163,63,Home,W 107-91 ,240,41,92,0.446,33,63,0.524,8,29,0.276,17,22,0.773,107,37,100,0.37,31,74,0.419,6,26,0.231,11,16,0.688,91,2017-01-29,CLE,OKC,2017,94.0
4164,4164,64,@,W 107-94 ,240,45,89,0.506,35,68,0.515,10,21,0.476,7,10,0.7,107,38,84,0.452,28,52,0.538,10,32,0.313,8,15,0.533,94,2017-01-29,WAS,NOP,2017,99.0
4165,4165,65,@,L 107-113 ,240,37,94,0.394,23,56,0.411,14,38,0.368,19,26,0.731,107,39,82,0.476,26,47,0.553,13,35,0.371,22,28,0.786,113,2017-02-03,LAL,BOS,2017,119.5
4166,4166,66,@,W 107-99 ,240,32,77,0.416,22,49,0.449,10,28,0.357,33,39,0.846,107,35,84,0.417,25,58,0.431,10,26,0.385,19,24,0.792,99,2017-02-04,MEM,MIN,2017,104.0
4167,4167,67,Home,W 107-102 ,240,37,88,0.42,21,36,0.583,16,52,0.308,17,20,0.85,107,35,84,0.417,25,55,0.455,10,29,0.345,22,28,0.786,102,2017-02-05,BOS,LAC,2017,107.0
4168,4168,68,Home,L 107-121 ,240,37,82,0.451,30,61,0.492,7,21,0.333,26,33,0.788,107,44,102,0.431,36,74,0.486,8,28,0.286,25,31,0.806,121,2017-02-06,NYK,LAL,2017,125.0
4169,4169,69,Home,L 107-112 ,240,41,79,0.519,30,51,0.588,11,28,0.393,14,16,0.875,107,43,81,0.531,37,62,0.597,6,19,0.316,20,31,0.645,112,2017-02-06,SAC,CHI,2017,115.0
4170,4170,70,@,L 107-111 ,240,39,86,0.453,27,50,0.54,12,36,0.333,17,21,0.81,107,40,102,0.392,33,76,0.434,7,26,0.269,24,29,0.828,111,2017-02-07,BRK,CHO,2017,114.5
4171,4171,71,@,W 107-95 ,240,39,87,0.448,26,47,0.553,13,40,0.325,16,20,0.8,107,37,85,0.435,29,59,0.492,8,26,0.308,13,14,0.929,95,2017-02-09,HOU,CHO,2017,99.0
4172,4172,72,Home,L 107-122 ,240,34,87,0.391,25,61,0.41,9,26,0.346,30,37,0.811,107,39,77,0.506,24,44,0.545,15,33,0.455,29,38,0.763,122,2017-02-10,MEM,GSW,2017,129.5
4173,4173,73,@,L 107-108 ,240,36,71,0.507,25,41,0.61,11,30,0.367,24,31,0.774,107,38,80,0.475,20,44,0.455,18,36,0.5,14,21,0.667,108,2017-02-10,ATL,SAC,2017,117.0
4174,4174,74,@,L 107-112 ,240,45,92,0.489,41,71,0.577,4,21,0.19,13,15,0.867,107,41,88,0.466,31,59,0.525,10,29,0.345,20,30,0.667,112,2017-02-10,IND,WAS,2017,117.0
4175,4175,75,@,W 107-102 ,240,40,85,0.471,26,51,0.51,14,34,0.412,13,20,0.65,107,37,85,0.435,24,48,0.5,13,37,0.351,15,20,0.75,102,2017-02-11,LAC,CHO,2017,108.5
4176,4176,76,Home,L 107-116 ,240,39,83,0.47,33,61,0.541,6,22,0.273,23,27,0.852,107,44,90,0.489,36,76,0.474,8,14,0.571,20,29,0.69,116,2017-02-13,MIA,ORL,2017,120.0
4177,4177,77,@,W 107-79 ,240,42,89,0.472,34,58,0.586,8,31,0.258,15,19,0.789,107,30,76,0.395,26,58,0.448,4,18,0.222,15,19,0.789,79,2017-02-15,SAS,ORL,2017,81.0
4178,4178,78,Home,W 107-97 ,240,40,81,0.494,35,66,0.53,5,15,0.333,22,29,0.759,107,33,78,0.423,21,40,0.525,12,38,0.316,19,22,0.864,97,2017-02-24,TOR,BOS,2017,103.0
4179,4179,79,Home,L 107-125 ,240,44,96,0.458,34,70,0.486,10,26,0.385,9,10,0.9,107,45,80,0.563,32,50,0.64,13,30,0.433,22,24,0.917,125,2017-02-28,CHI,DEN,2017,131.5
4180,4180,80,@,W 107-80 ,240,39,78,0.5,31,62,0.5,8,16,0.5,21,26,0.808,107,35,90,0.389,31,71,0.437,4,19,0.211,6,11,0.545,80,2017-03-01,MIN,UTA,2017,82.0
4181,4181,81,Home,W 107-91 ,240,42,86,0.488,37,66,0.561,5,20,0.25,18,20,0.9,107,35,83,0.422,26,59,0.441,9,24,0.375,12,18,0.667,91,2017-03-08,MIN,LAC,2017,95.5
4182,4182,82,Home,W 106-104 ,240,35,74,0.473,26,54,0.481,9,20,0.45,27,34,0.794,106,39,76,0.513,37,71,0.521,2,5,0.4,24,31,0.774,104,2011-12-25,NYK,BOS,2012,105.0
4183,4183,83,@,W 106-70 ,240,38,86,0.442,26,63,0.413,12,23,0.522,18,21,0.857,106,22,71,0.31,17,47,0.362,5,24,0.208,21,26,0.808,70,2011-12-27,ATL,NJN,2012,72.5
4184,4184,84,Home,W 106-96 ,240,41,71,0.577,29,50,0.58,12,21,0.571,12,15,0.8,106,36,82,0.439,29,62,0.468,7,20,0.35,17,21,0.81,96,2012-01-02,MIN,SAS,2012,99.5
4185,4185,85,@,W 106-101 ,240,42,78,0.538,33,57,0.579,9,21,0.429,13,19,0.684,106,36,77,0.468,25,55,0.455,11,22,0.5,18,21,0.857,101,2012-01-09,ATL,NJN,2012,106.5
4186,4186,86,@,L 106-111 (OT),265,39,85,0.459,37,74,0.5,2,11,0.182,26,40,0.65,106,38,95,0.4,29,68,0.426,9,27,0.333,26,30,0.867,111,2012-01-10,MIA,GSW,2012,115.5
4187,4187,87,Home,W 106-103 ,240,44,85,0.518,35,71,0.493,9,14,0.643,9,10,0.9,106,45,75,0.6,41,61,0.672,4,14,0.286,9,16,0.563,103,2012-01-10,MIL,SAS,2012,105.0
4188,4188,88,@,W 106-96 ,240,44,85,0.518,40,73,0.548,4,12,0.333,14,20,0.7,106,32,75,0.427,26,59,0.441,6,16,0.375,26,39,0.667,96,2012-01-15,UTA,DEN,2012,99.0
4189,4189,89,Home,L 106-114 ,240,39,80,0.488,36,69,0.522,3,11,0.273,25,32,0.781,106,42,87,0.483,37,71,0.521,5,16,0.313,25,26,0.962,114,2012-01-16,WAS,HOU,2012,116.5
4190,4190,90,Home,L 106-111 (2OT),290,39,90,0.433,35,72,0.486,4,18,0.222,24,36,0.667,106,43,96,0.448,33,68,0.485,10,28,0.357,15,19,0.789,111,2012-01-25,UTA,TOR,2012,116.0
4191,4191,91,@,W 106-101 ,240,40,79,0.506,32,60,0.533,8,19,0.421,18,23,0.783,106,40,104,0.385,35,83,0.422,5,21,0.238,16,23,0.696,101,2012-01-29,LAL,MIN,2012,103.5
4192,4192,92,@,W 106-85 ,240,45,88,0.511,37,71,0.521,8,17,0.471,8,11,0.727,106,31,64,0.484,21,41,0.512,10,23,0.435,13,29,0.448,85,2012-01-29,IND,ORL,2012,90.0
4193,4193,93,Home,W 106-99 ,240,38,73,0.521,34,62,0.548,4,11,0.364,26,36,0.722,106,35,74,0.473,23,45,0.511,12,29,0.414,17,23,0.739,99,2012-01-31,IND,NJN,2012,105.0
4194,4194,94,Home,W 106-73 ,240,42,76,0.553,30,50,0.6,12,26,0.462,10,11,0.909,106,31,89,0.348,29,80,0.363,2,9,0.222,9,13,0.692,73,2012-01-31,LAL,CHA,2012,74.0
4195,4195,95,Home,W 106-89 ,240,42,93,0.452,39,80,0.488,3,13,0.231,19,28,0.679,106,33,87,0.379,28,68,0.412,5,19,0.263,18,25,0.72,89,2012-02-03,TOR,WAS,2012,91.5
4196,4196,96,@,L 106-114 (OT),265,39,90,0.433,23,61,0.377,16,29,0.552,12,13,0.923,106,43,98,0.439,33,76,0.434,10,22,0.455,18,21,0.857,114,2012-02-04,GSW,SAC,2012,119.0
4197,4197,97,Home,W 106-101 ,240,40,99,0.404,33,79,0.418,7,20,0.35,19,26,0.731,106,37,77,0.481,30,59,0.508,7,18,0.389,20,26,0.769,101,2012-02-09,SAC,OKC,2012,104.5
4198,4198,98,@,W 106-89 ,240,40,81,0.494,35,66,0.53,5,15,0.333,21,23,0.913,106,34,89,0.382,30,68,0.441,4,21,0.19,17,28,0.607,89,2012-02-10,MIA,WAS,2012,91.0
4199,4199,99,Home,W 106-97 ,240,40,79,0.506,27,55,0.491,13,24,0.542,13,18,0.722,106,31,75,0.413,20,46,0.435,11,29,0.379,24,33,0.727,97,2012-02-12,GSW,HOU,2012,102.5
4200,4200,0,Home,L 106-113 ,240,47,86,0.547,44,75,0.587,3,11,0.273,9,14,0.643,106,41,76,0.539,33,57,0.579,8,19,0.421,23,25,0.92,113,2012-02-15,TOR,SAS,2012,117.0
4201,4201,1,@,W 106-102 ,240,36,78,0.462,26,57,0.456,10,21,0.476,24,30,0.8,106,40,84,0.476,37,76,0.487,3,8,0.375,19,23,0.826,102,2012-02-20,SAS,UTA,2012,103.5
4202,4202,2,@,W 106-104 ,240,39,84,0.464,30,64,0.469,9,20,0.45,19,22,0.864,106,43,90,0.478,39,71,0.549,4,19,0.211,14,20,0.7,104,2012-02-22,GSW,PHO,2012,106.0
4203,4203,3,@,W 106-104 ,240,43,83,0.518,38,67,0.567,5,16,0.313,15,17,0.882,106,42,88,0.477,37,73,0.507,5,15,0.333,15,19,0.789,104,2012-03-07,CHI,MIL,2012,106.5
4204,4204,4,Home,W 106-94 ,240,37,78,0.474,24,55,0.436,13,23,0.565,19,26,0.731,106,44,93,0.473,41,70,0.586,3,23,0.13,3,4,0.75,94,2012-03-07,MIN,POR,2012,95.5
4205,4205,5,Home,W 106-101 ,240,43,92,0.467,36,66,0.545,7,26,0.269,13,19,0.684,106,32,81,0.395,24,60,0.4,8,21,0.381,29,37,0.784,101,2012-03-07,WAS,LAL,2012,105.0
4206,4206,6,Home,L 106-112 ,240,43,81,0.531,34,57,0.596,9,24,0.375,11,14,0.786,106,46,82,0.561,37,66,0.561,9,16,0.563,11,14,0.786,112,2012-03-10,BRK,HOU,2012,116.5
4207,4207,7,@,W 106-94 ,240,40,79,0.506,35,70,0.5,5,9,0.556,21,26,0.808,106,33,80,0.413,26,63,0.413,7,17,0.412,21,26,0.808,94,2012-03-11,PHI,NYK,2012,97.5
4208,4208,8,@,W 106-99 ,240,42,82,0.512,35,61,0.574,7,21,0.333,15,23,0.652,106,38,82,0.463,28,53,0.528,10,29,0.345,13,17,0.765,99,2012-03-11,ATL,SAC,2012,104.0
4209,4209,9,Home,W 106-102 ,240,36,77,0.468,26,58,0.448,10,19,0.526,24,26,0.923,106,38,85,0.447,32,73,0.438,6,12,0.5,20,23,0.87,102,2012-03-14,CHI,MIA,2012,105.0
4210,4210,10,Home,W 106-99 ,240,37,79,0.468,26,55,0.473,11,24,0.458,21,25,0.84,106,39,79,0.494,28,55,0.509,11,24,0.458,10,18,0.556,99,2012-03-17,DAL,SAS,2012,104.5
4211,4211,11,Home,W 106-87 ,240,39,81,0.481,34,65,0.523,5,16,0.313,23,33,0.697,106,33,69,0.478,31,56,0.554,2,13,0.154,19,22,0.864,87,2012-03-20,NYK,TOR,2012,88.0
4212,4212,12,@,L 106-113 (OT),265,41,96,0.427,36,78,0.462,5,18,0.278,19,26,0.731,106,43,89,0.483,39,69,0.565,4,20,0.2,23,27,0.852,113,2012-03-26,SAC,HOU,2012,115.0
4213,4213,13,Home,W 106-85 ,240,39,80,0.488,34,63,0.54,5,17,0.294,23,27,0.852,106,33,78,0.423,24,54,0.444,9,24,0.375,10,13,0.769,85,2012-03-29,MIA,DAL,2012,89.5
4214,4214,14,@,L 106-119 ,240,36,78,0.462,31,57,0.544,5,21,0.238,29,35,0.829,106,46,88,0.523,37,60,0.617,9,28,0.321,18,20,0.9,119,2012-04-01,MIN,POR,2012,123.5
4215,4215,15,Home,L 106-109 (OT),265,42,97,0.433,39,85,0.459,3,12,0.25,19,25,0.76,106,40,89,0.449,34,71,0.479,6,18,0.333,23,33,0.697,109,2012-04-21,IND,PHI,2012,112.0
4216,4216,16,Home,W 106-95 ,240,38,84,0.452,34,71,0.479,4,13,0.308,26,37,0.703,106,40,86,0.465,36,74,0.486,4,12,0.333,11,15,0.733,95,2012-04-21,MIL,NJN,2012,97.0
4217,4217,17,@,L 106-114 (2OT),290,37,101,0.366,29,77,0.377,8,24,0.333,24,28,0.857,106,41,106,0.387,36,90,0.4,5,16,0.313,27,40,0.675,114,2012-04-22,OKC,LAL,2012,116.5
4218,4218,18,@,W 106-101 ,240,40,90,0.444,32,67,0.478,8,23,0.348,18,30,0.6,106,39,79,0.494,29,55,0.527,10,24,0.417,13,15,0.867,101,2012-04-25,DEN,OKC,2012,106.0
4219,4219,19,Home,L 106-110 ,240,45,94,0.479,40,81,0.494,5,13,0.385,11,13,0.846,106,41,88,0.466,33,66,0.5,8,22,0.364,20,23,0.87,110,2012-04-25,PHO,SAS,2012,114.0
4220,4220,20,Home,W 106-89 ,240,45,85,0.529,36,58,0.621,9,27,0.333,7,9,0.778,106,33,78,0.423,28,63,0.444,5,15,0.333,18,23,0.783,89,2012-04-26,ATL,DAL,2012,91.5
4221,4221,21,@,L 106-116 ,240,36,72,0.5,28,54,0.519,8,18,0.444,26,32,0.813,106,42,83,0.506,33,63,0.524,9,20,0.45,23,28,0.821,116,2012-10-31,LAL,POR,2013,120.5
4222,4222,22,Home,W 106-92 ,240,39,76,0.513,34,67,0.507,5,9,0.556,23,32,0.719,106,32,89,0.36,23,63,0.365,9,26,0.346,19,24,0.792,92,2012-11-02,OKC,POR,2013,96.5
4223,4223,23,Home,W 106-98 (2OT),290,39,99,0.394,35,77,0.455,4,22,0.182,24,27,0.889,106,37,102,0.363,29,80,0.363,8,22,0.364,16,20,0.8,98,2012-11-03,IND,SAC,2013,102.0
4224,4224,24,Home,W 106-96 ,240,42,78,0.538,37,60,0.617,5,18,0.278,17,23,0.739,106,36,86,0.419,25,54,0.463,11,32,0.344,13,21,0.619,96,2012-11-07,GSW,CLE,2013,101.5
4225,4225,25,Home,W 106-84 ,240,46,83,0.554,40,66,0.606,6,17,0.353,8,9,0.889,106,30,73,0.411,22,50,0.44,8,23,0.348,16,24,0.667,84,2012-11-07,LAC,SAS,2013,88.0
4226,4226,26,@,W 106-100 ,240,40,82,0.488,33,69,0.478,7,13,0.538,19,23,0.826,106,37,76,0.487,33,66,0.5,4,10,0.4,22,31,0.71,100,2012-11-09,PHI,BOS,2013,102.0
4227,4227,27,Home,W 106-91 ,240,40,73,0.548,33,58,0.569,7,15,0.467,19,22,0.864,106,34,83,0.41,27,60,0.45,7,23,0.304,16,23,0.696,91,2012-11-11,OKC,CLE,2013,94.5
4228,4228,28,Home,L 106-112 (OT),265,42,105,0.4,36,84,0.429,6,21,0.286,16,17,0.941,106,44,88,0.5,38,76,0.5,6,12,0.5,18,25,0.72,112,2012-11-14,PHO,CHI,2013,115.0
4229,4229,29,Home,L 106-110 ,240,44,82,0.537,42,74,0.568,2,8,0.25,16,20,0.8,106,44,89,0.494,37,72,0.514,7,17,0.412,15,17,0.882,110,2012-11-16,DET,ORL,2013,113.5
4230,4230,30,@,W 106-98 ,240,43,85,0.506,41,70,0.586,2,15,0.133,18,26,0.692,106,34,79,0.43,27,61,0.443,7,18,0.389,23,29,0.793,98,2012-11-16,GSW,MIN,2013,101.5
4231,4231,31,Home,W 106-98 ,240,40,85,0.471,31,61,0.508,9,24,0.375,17,19,0.895,106,37,82,0.451,33,66,0.5,4,16,0.25,20,29,0.69,98,2012-11-20,PHI,TOR,2013,100.0
4232,4232,32,@,L 106-113 (OT),265,46,109,0.422,41,80,0.513,5,29,0.172,9,12,0.75,106,41,86,0.477,33,68,0.485,8,18,0.444,23,33,0.697,113,2012-11-21,MIL,MIA,2013,117.0
4233,4233,33,Home,W 106-98 ,240,38,75,0.507,32,64,0.5,6,11,0.545,24,30,0.8,106,33,74,0.446,21,47,0.447,12,27,0.444,20,24,0.833,98,2012-11-23,MEM,LAL,2013,104.0
4234,4234,34,Home,L 106-108 (2OT),290,34,93,0.366,28,66,0.424,6,27,0.222,32,39,0.821,106,34,83,0.41,22,55,0.4,12,28,0.429,28,36,0.778,108,2012-11-24,WAS,CHA,2013,114.0
4235,4235,35,Home,L 106-111 (2OT),290,40,110,0.364,34,86,0.395,6,24,0.25,20,24,0.833,106,44,103,0.427,36,76,0.474,8,27,0.296,15,19,0.789,111,2012-11-25,TOR,SAS,2013,115.0
4236,4236,36,Home,W 106-105 ,240,44,86,0.512,36,68,0.529,8,18,0.444,10,13,0.769,106,38,84,0.452,28,63,0.444,10,21,0.476,19,24,0.792,105,2012-11-29,GSW,DEN,2013,110.0
4237,4237,37,Home,W 106-94 ,240,39,75,0.52,35,66,0.53,4,9,0.444,24,33,0.727,106,38,92,0.413,31,69,0.449,7,23,0.304,11,12,0.917,94,2012-11-30,OKC,UTA,2013,97.5
4238,4238,38,Home,W 106-99 ,240,40,90,0.444,28,61,0.459,12,29,0.414,14,17,0.824,106,39,80,0.488,31,57,0.544,8,23,0.348,13,19,0.684,99,2012-12-02,NYK,PHO,2013,103.0
4239,4239,39,Home,W 106-90 ,240,40,69,0.58,33,58,0.569,7,11,0.636,19,24,0.792,106,35,78,0.449,27,60,0.45,8,18,0.444,12,13,0.923,90,2012-12-08,MIA,NOH,2013,94.0
4240,4240,40,@,L 106-112 ,240,40,72,0.556,35,55,0.636,5,17,0.294,21,29,0.724,106,37,86,0.43,25,56,0.446,12,30,0.4,26,37,0.703,112,2012-12-09,DEN,NYK,2013,118.0
4241,4241,41,@,L 106-114 (OT),265,39,84,0.464,32,70,0.457,7,14,0.5,21,25,0.84,106,41,94,0.436,35,71,0.493,6,23,0.261,26,32,0.813,114,2012-12-15,DAL,MIN,2013,117.0
4242,4242,42,@,L 106-112 ,240,38,95,0.4,24,59,0.407,14,36,0.389,16,18,0.889,106,38,87,0.437,31,68,0.456,7,19,0.368,29,42,0.69,112,2012-12-18,SAS,DEN,2013,115.5
4243,4243,43,Home,L 106-110 ,240,38,91,0.418,30,65,0.462,8,26,0.308,22,25,0.88,106,37,83,0.446,29,65,0.446,8,18,0.444,28,33,0.848,110,2012-12-21,NYK,CHI,2013,114.0
4244,4244,44,Home,W 106-77 ,240,41,85,0.482,29,55,0.527,12,30,0.4,12,24,0.5,106,29,72,0.403,23,56,0.411,6,16,0.375,13,15,0.867,77,2012-12-27,LAC,BOS,2013,80.0
4245,4245,45,@,W 106-85 ,240,43,94,0.457,31,66,0.47,12,28,0.429,8,14,0.571,106,33,88,0.375,28,63,0.444,5,25,0.2,14,21,0.667,85,2012-12-28,DEN,DAL,2013,87.5
4246,4246,46,Home,W 106-105 ,240,39,86,0.453,24,56,0.429,15,30,0.5,13,17,0.765,106,41,83,0.494,30,53,0.566,11,30,0.367,12,20,0.6,105,2012-12-28,SAC,NYK,2013,110.5
4247,4247,47,Home,W 106-84 ,240,43,87,0.494,39,75,0.52,4,12,0.333,16,19,0.842,106,29,84,0.345,27,67,0.403,2,17,0.118,24,30,0.8,84,2013-01-02,UTA,MIN,2013,85.0
4248,4248,48,@,W 106-104 ,240,39,78,0.5,32,62,0.516,7,16,0.438,21,29,0.724,106,37,82,0.451,29,65,0.446,8,17,0.471,22,28,0.786,104,2013-01-04,CLE,CHA,2013,108.0
4249,4249,49,Home,L 106-114 ,240,41,85,0.482,31,59,0.525,10,26,0.385,14,18,0.778,106,42,88,0.477,30,55,0.545,12,33,0.364,18,22,0.818,114,2013-01-05,ORL,NYK,2013,120.0
4250,4250,50,Home,W 106-84 ,240,36,76,0.474,25,56,0.446,11,20,0.55,23,27,0.852,106,31,72,0.431,28,60,0.467,3,12,0.25,19,24,0.792,84,2013-01-09,OKC,MIN,2013,85.5
4251,4251,51,Home,W 106-88 ,240,45,80,0.563,37,59,0.627,8,21,0.381,8,11,0.727,106,33,89,0.371,29,73,0.397,4,16,0.25,18,23,0.783,88,2013-01-13,SAS,MIN,2013,90.0
4252,4252,52,@,L 106-113 ,240,40,82,0.488,33,69,0.478,7,13,0.538,19,23,0.826,106,40,81,0.494,32,60,0.533,8,21,0.381,25,28,0.893,113,2013-01-15,TOR,BRK,2013,117.0
4253,4253,53,@,W 106-100 ,240,37,79,0.468,33,67,0.493,4,12,0.333,28,38,0.737,106,37,79,0.468,26,48,0.542,11,31,0.355,15,21,0.714,100,2013-01-18,CHA,ORL,2013,105.5
4254,4254,54,Home,W 106-99 ,240,39,75,0.52,27,53,0.509,12,22,0.545,16,18,0.889,106,38,83,0.458,27,53,0.509,11,30,0.367,12,22,0.545,99,2013-01-21,GSW,LAC,2013,104.5
4255,4255,55,Home,W 106-93 ,240,47,96,0.49,43,83,0.518,4,13,0.308,8,10,0.8,106,31,73,0.425,24,56,0.429,7,17,0.412,24,32,0.75,93,2013-01-23,MEM,LAL,2013,96.5
4256,4256,56,@,W 106-96 ,240,43,90,0.478,37,71,0.521,6,19,0.316,14,16,0.875,106,38,79,0.481,33,68,0.485,5,11,0.455,15,24,0.625,96,2013-01-23,PHO,SAC,2013,98.5
4257,4257,57,Home,W 106-102 ,240,43,80,0.538,35,55,0.636,8,25,0.32,12,23,0.522,106,38,81,0.469,28,64,0.438,10,17,0.588,16,23,0.696,102,2013-01-23,SAS,NOH,2013,107.0
4258,4258,58,@,L 106-119 ,240,36,80,0.45,20,44,0.455,16,36,0.444,18,21,0.857,106,43,87,0.494,31,59,0.525,12,28,0.429,21,27,0.778,119,2013-01-26,BRK,HOU,2013,125.0
4259,4259,59,Home,W 106-104 ,240,39,72,0.542,23,45,0.511,16,27,0.593,12,17,0.706,106,39,65,0.6,29,42,0.69,10,23,0.435,16,20,0.8,104,2013-01-27,NYK,ATL,2013,109.0
4260,4260,60,@,L 106-111 ,240,39,92,0.424,30,73,0.411,9,19,0.474,19,21,0.905,106,39,79,0.494,27,46,0.587,12,33,0.364,21,33,0.636,111,2013-01-29,NOP,LAL,2013,117.0
4261,4261,61,Home,W 106-104 ,240,39,86,0.453,29,58,0.5,10,28,0.357,18,23,0.783,106,42,84,0.5,34,69,0.493,8,15,0.533,12,15,0.8,104,2013-01-29,POR,DAL,2013,108.0
4262,4262,62,Home,W 106-89 ,240,40,72,0.556,35,58,0.603,5,14,0.357,21,25,0.84,106,34,98,0.347,28,73,0.384,6,25,0.24,15,19,0.789,89,2013-01-31,OKC,MEM,2013,92.0
4263,4263,63,Home,W 106-104 ,240,36,72,0.5,25,54,0.463,11,18,0.611,23,27,0.852,106,40,79,0.506,31,58,0.534,9,21,0.429,15,21,0.714,104,2013-02-03,BOS,LAC,2013,108.5
4264,4264,64,Home,W 106-96 ,240,42,79,0.532,31,59,0.525,11,20,0.55,11,14,0.786,106,34,84,0.405,25,56,0.446,9,28,0.321,19,23,0.826,96,2013-02-06,WAS,NYK,2013,100.5
4265,4265,65,Home,W 106-96 ,240,37,75,0.493,24,43,0.558,13,32,0.406,19,26,0.731,106,36,82,0.439,31,58,0.534,5,24,0.208,19,22,0.864,96,2013-02-13,LAC,HOU,2013,98.5
4266,4266,66,@,W 106-96 ,240,41,77,0.532,25,47,0.532,16,30,0.533,8,12,0.667,106,40,91,0.44,30,61,0.492,10,30,0.333,6,11,0.545,96,2013-02-22,HOU,BRK,2013,101.0
4267,4267,67,Home,W 106-84 ,240,41,76,0.539,29,54,0.537,12,22,0.545,12,26,0.462,106,33,81,0.407,27,65,0.415,6,16,0.375,12,14,0.857,84,2013-02-26,LAC,CHA,2013,87.0
4268,4268,68,Home,L 106-136 ,240,44,84,0.524,38,65,0.585,6,19,0.316,12,15,0.8,106,53,86,0.616,40,65,0.615,13,21,0.619,17,21,0.81,136,2013-03-08,SAS,POR,2013,142.5
4269,4269,69,Home,W 106-97 ,240,40,76,0.526,32,61,0.525,8,15,0.533,18,27,0.667,106,40,81,0.494,34,62,0.548,6,19,0.316,11,16,0.688,97,2013-03-11,PHI,BRK,2013,100.0
4270,4270,70,@,W 106-97 ,240,34,73,0.466,25,48,0.521,9,25,0.36,29,47,0.617,106,37,93,0.398,27,61,0.443,10,32,0.313,13,17,0.765,97,2013-03-12,LAL,ORL,2013,102.0
4271,4271,71,Home,W 106-93 ,240,43,86,0.5,35,70,0.5,8,16,0.5,12,24,0.5,106,39,85,0.459,33,67,0.493,6,18,0.333,9,12,0.75,93,2013-03-13,WAS,MIL,2013,96.0
4272,4272,72,Home,W 106-94 ,240,40,76,0.526,25,42,0.595,15,34,0.441,11,16,0.688,106,38,79,0.481,33,62,0.532,5,17,0.294,13,18,0.722,94,2013-03-20,NYK,ORL,2013,96.5
4273,4273,73,@,L 106-110 ,240,38,74,0.514,29,54,0.537,9,20,0.45,21,28,0.75,106,43,94,0.457,39,83,0.47,4,11,0.364,20,24,0.833,110,2013-03-23,BOS,MEM,2013,112.0
4274,4274,74,Home,L 106-109 ,240,39,80,0.488,34,64,0.531,5,16,0.313,23,26,0.885,106,39,71,0.549,29,48,0.604,10,23,0.435,21,28,0.75,109,2013-04-01,LAC,IND,2013,114.0
4275,4275,75,Home,W 106-87 ,240,40,83,0.482,26,58,0.448,14,25,0.56,12,14,0.857,106,33,82,0.402,27,62,0.435,6,20,0.3,15,20,0.75,87,2013-04-06,MIA,PHI,2013,90.0
4276,4276,76,Home,L 106-113 ,240,38,85,0.447,26,59,0.441,12,26,0.462,18,20,0.9,106,43,73,0.589,37,54,0.685,6,19,0.316,21,24,0.875,113,2013-04-10,POR,LAL,2013,116.0
4277,4277,77,@,W 106-90 ,240,40,77,0.519,31,55,0.564,9,22,0.409,17,21,0.81,106,36,88,0.409,30,68,0.441,6,20,0.3,12,18,0.667,90,2013-04-12,OKC,POR,2013,93.0
4278,4278,78,Home,W 106-101 ,240,43,92,0.467,36,77,0.468,7,15,0.467,13,27,0.481,106,41,77,0.532,37,66,0.561,4,11,0.364,15,20,0.75,101,2013-04-15,BRK,WAS,2013,103.0
4279,4279,79,Home,W 106-95 ,240,43,74,0.581,36,56,0.643,7,18,0.389,13,14,0.929,106,34,79,0.43,20,42,0.476,14,37,0.378,13,13,1.0,95,2013-04-15,CHA,NYK,2013,102.0
4280,4280,80,@,L 106-116 ,240,45,98,0.459,37,74,0.5,8,24,0.333,8,13,0.615,106,46,85,0.541,37,65,0.569,9,20,0.45,15,18,0.833,116,2013-04-15,SAS,GSW,2013,120.5
4281,4281,81,@,W 106-93 ,240,42,84,0.5,34,64,0.531,8,20,0.4,14,20,0.7,106,34,90,0.378,30,74,0.405,4,16,0.25,21,27,0.778,93,2013-11-06,GSW,MIN,2014,95.0
4282,4282,82,Home,W 106-105 (OT),265,41,92,0.446,35,72,0.486,6,20,0.3,18,22,0.818,106,40,88,0.455,28,59,0.475,12,29,0.414,13,26,0.5,105,2013-11-10,OKC,WAS,2014,111.0
4283,4283,83,Home,L 106-109 ,240,38,87,0.437,30,67,0.448,8,20,0.4,22,27,0.815,106,31,68,0.456,22,40,0.55,9,28,0.321,38,44,0.864,109,2013-11-14,NYK,HOU,2014,113.5
4284,4284,84,Home,W 106-88 ,240,40,94,0.426,33,71,0.465,7,23,0.304,19,22,0.864,106,34,86,0.395,29,68,0.426,5,18,0.278,15,18,0.833,88,2013-11-16,MIN,BOS,2014,90.5
4285,4285,85,@,W 106-102 ,240,39,81,0.481,34,69,0.493,5,12,0.417,23,30,0.767,106,34,86,0.395,27,63,0.429,7,23,0.304,27,32,0.844,102,2013-11-18,MEM,LAC,2014,105.5
4286,4286,86,Home,L 106-113 ,240,38,85,0.447,23,52,0.442,15,33,0.455,15,22,0.682,106,37,80,0.463,30,63,0.476,7,17,0.412,32,38,0.842,113,2013-11-20,PHO,SAC,2014,116.5
4287,4287,87,Home,W 106-98 ,240,35,76,0.461,30,58,0.517,5,18,0.278,31,38,0.816,106,35,102,0.343,31,77,0.403,4,25,0.16,24,32,0.75,98,2013-11-23,IND,PHI,2014,100.0
4288,4288,88,@,L 106-120 ,240,39,86,0.453,32,67,0.478,7,19,0.368,21,24,0.875,106,42,81,0.519,32,57,0.561,10,24,0.417,26,31,0.839,120,2013-11-27,POR,PHO,2014,125.0
4289,4289,89,@,W 106-102 ,240,36,80,0.45,22,49,0.449,14,31,0.452,20,30,0.667,106,44,100,0.44,43,92,0.467,1,8,0.125,13,25,0.52,102,2013-11-29,LAL,DET,2014,102.5
4290,4290,90,Home,L 106-112 ,240,45,92,0.489,38,68,0.559,7,24,0.292,9,11,0.818,106,40,79,0.506,29,53,0.547,11,26,0.423,21,30,0.7,112,2013-11-30,DAL,MIN,2014,117.5
4291,4291,91,Home,L 106-112 ,240,44,91,0.484,35,65,0.538,9,26,0.346,9,13,0.692,106,40,90,0.444,27,60,0.45,13,30,0.433,19,30,0.633,112,2013-11-30,SAS,HOU,2014,118.5
4292,4292,92,Home,W 106-102 ,240,36,76,0.474,31,63,0.492,5,13,0.385,29,33,0.879,106,39,88,0.443,30,66,0.455,9,22,0.409,15,17,0.882,102,2013-12-02,POR,IND,2014,106.5
4293,4293,93,Home,W 106-98 ,240,43,83,0.518,37,63,0.587,6,20,0.3,14,18,0.778,106,34,77,0.442,28,60,0.467,6,17,0.353,24,29,0.828,98,2013-12-06,BOS,DEN,2014,101.0
4294,4294,94,Home,W 106-97 ,240,37,82,0.451,28,59,0.475,9,23,0.391,23,32,0.719,106,35,87,0.402,30,68,0.441,5,19,0.263,22,25,0.88,97,2013-12-06,PHO,TOR,2014,99.5
4295,4295,95,@,W 106-100 ,240,41,86,0.477,29,54,0.537,12,32,0.375,12,18,0.667,106,37,86,0.43,27,64,0.422,10,22,0.455,16,22,0.727,100,2013-12-06,LAL,SAC,2014,105.0
4296,4296,96,Home,L 106-108 ,240,39,87,0.448,30,57,0.526,9,30,0.3,19,24,0.792,106,46,87,0.529,38,71,0.535,8,16,0.5,8,11,0.727,108,2013-12-07,POR,DAL,2014,112.0
4297,4297,97,@,W 106-94 ,240,40,82,0.488,36,56,0.643,4,26,0.154,22,25,0.88,106,34,79,0.43,25,51,0.49,9,28,0.321,17,20,0.85,94,2013-12-08,TOR,LAL,2014,98.5
4298,4298,98,Home,W 106-99 ,240,37,96,0.385,30,76,0.395,7,20,0.35,25,29,0.862,106,39,74,0.527,30,54,0.556,9,20,0.45,12,14,0.857,99,2013-12-11,MIN,PHI,2014,103.5
4299,4299,99,@,L 106-111 (OT),265,42,96,0.438,37,75,0.493,5,21,0.238,17,27,0.63,106,38,84,0.452,29,61,0.475,9,23,0.391,26,32,0.813,111,2013-12-11,DET,NOP,2014,115.5
4300,4300,0,Home,W 106-93 ,240,42,88,0.477,32,64,0.5,10,24,0.417,12,18,0.667,106,36,81,0.444,31,64,0.484,5,17,0.294,16,19,0.842,93,2013-12-14,DAL,MIL,2014,95.5
4301,4301,1,@,L 106-111 ,240,40,66,0.606,25,34,0.735,15,32,0.469,11,11,1.0,106,44,87,0.506,36,68,0.529,8,19,0.421,15,18,0.833,111,2013-12-14,ATL,NYK,2014,115.0
4302,4302,2,Home,W 106-102 ,240,35,79,0.443,22,52,0.423,13,27,0.481,23,34,0.676,106,34,80,0.425,23,58,0.397,11,22,0.5,23,33,0.697,102,2013-12-15,PHO,GSW,2014,107.5
4303,4303,3,Home,W 106-91 ,240,39,81,0.481,36,68,0.529,3,13,0.231,25,30,0.833,106,31,75,0.413,24,48,0.5,7,27,0.259,22,38,0.579,91,2013-12-15,SAC,HOU,2014,94.5
4304,4304,4,Home,L 106-107 ,240,40,81,0.494,34,63,0.54,6,18,0.333,20,22,0.909,106,41,88,0.466,31,61,0.508,10,27,0.37,15,20,0.75,107,2013-12-18,BOS,DET,2014,112.0
4305,4305,5,Home,L 106-116 ,240,42,90,0.467,30,67,0.448,12,23,0.522,10,17,0.588,106,44,84,0.524,41,74,0.554,3,10,0.3,25,28,0.893,116,2013-12-20,DET,CHA,2014,117.5
4306,4306,6,@,W 106-99 ,240,41,87,0.471,33,66,0.5,8,21,0.381,16,22,0.727,106,42,87,0.483,38,67,0.567,4,20,0.2,11,18,0.611,99,2013-12-21,WAS,BOS,2014,101.0
4307,4307,7,@,L 106-116 ,240,38,93,0.409,28,70,0.4,10,23,0.435,20,22,0.909,106,43,82,0.524,36,57,0.632,7,25,0.28,23,25,0.92,116,2013-12-21,PHI,MIL,2014,119.5
4308,4308,8,Home,W 106-79 ,240,41,83,0.494,32,64,0.5,9,19,0.474,15,22,0.682,106,32,84,0.381,26,70,0.371,6,14,0.429,9,13,0.692,79,2013-12-22,IND,BOS,2014,82.0
4309,4309,9,Home,W 106-82 ,240,43,86,0.5,34,67,0.507,9,19,0.474,11,17,0.647,106,31,77,0.403,24,56,0.429,7,21,0.333,13,17,0.765,82,2013-12-28,WAS,DET,2014,85.5
4310,4310,10,@,W 106-99 ,240,39,78,0.5,32,59,0.542,7,19,0.368,21,27,0.778,106,36,82,0.439,30,62,0.484,6,20,0.3,21,35,0.6,99,2013-12-30,WAS,DET,2014,102.0
4311,4311,11,Home,L 106-110 ,240,39,81,0.481,32,53,0.604,7,28,0.25,21,33,0.636,106,42,85,0.494,35,63,0.556,7,22,0.318,19,23,0.826,110,2013-12-31,HOU,SAC,2014,113.5
4312,4312,12,Home,W 106-92 ,240,38,83,0.458,29,64,0.453,9,19,0.474,21,22,0.955,106,33,83,0.398,28,63,0.444,5,20,0.25,21,24,0.875,92,2014-01-18,IND,LAC,2014,94.5
4313,4313,13,Home,L 106-112 ,240,44,90,0.489,35,60,0.583,9,30,0.3,9,11,0.818,106,37,80,0.463,25,58,0.431,12,22,0.545,26,28,0.929,112,2014-01-19,TOR,LAL,2014,118.0
4314,4314,14,Home,L 106-110 ,240,37,82,0.451,22,49,0.449,15,33,0.455,17,24,0.708,106,42,88,0.477,33,74,0.446,9,14,0.643,17,24,0.708,110,2014-01-22,NYK,PHI,2014,114.5
4315,4315,15,@,L 106-107 ,240,34,78,0.436,24,58,0.414,10,20,0.5,28,33,0.848,106,37,73,0.507,27,46,0.587,10,27,0.37,23,28,0.821,107,2014-01-24,DAL,BRK,2014,112.0
4316,4316,16,@,L 106-116 ,240,43,91,0.473,39,78,0.5,4,13,0.308,16,28,0.571,106,43,74,0.581,36,53,0.679,7,21,0.333,23,28,0.821,116,2014-01-26,DET,DAL,2014,119.5
4317,4317,17,Home,W 106-99 ,240,32,80,0.4,25,60,0.417,7,20,0.35,35,53,0.66,106,37,90,0.411,32,68,0.471,5,22,0.227,20,26,0.769,99,2014-01-27,UTA,SAC,2014,101.5
4318,4318,18,Home,W 106-92 ,240,41,80,0.513,34,54,0.63,7,26,0.269,17,24,0.708,106,38,87,0.437,30,57,0.526,8,30,0.267,8,10,0.8,92,2014-02-01,HOU,CLE,2014,96.0
4319,4319,19,@,W 106-91 ,240,41,76,0.539,33,53,0.623,8,23,0.348,16,24,0.667,106,33,67,0.493,22,41,0.537,11,26,0.423,14,23,0.609,91,2014-02-01,MIA,NYK,2014,96.5
4320,4320,20,Home,W 106-103 ,240,35,76,0.461,27,58,0.466,8,18,0.444,28,35,0.8,106,40,87,0.46,34,67,0.507,6,20,0.3,17,25,0.68,103,2014-02-01,POR,TOR,2014,106.0
4321,4321,21,Home,W 106-97 ,240,44,91,0.484,34,64,0.531,10,27,0.37,8,11,0.727,106,37,78,0.474,31,58,0.534,6,20,0.3,17,23,0.739,97,2014-02-05,OKC,MIN,2014,100.0
4322,4322,22,@,W 106-101 (OT),265,40,85,0.471,30,62,0.484,10,23,0.435,16,19,0.842,106,41,90,0.456,32,66,0.485,9,24,0.375,10,14,0.714,101,2014-02-12,SAC,NYK,2014,105.5
4323,4323,23,Home,L 106-117 ,240,34,85,0.4,25,58,0.431,9,27,0.333,29,32,0.906,106,44,77,0.571,34,51,0.667,10,26,0.385,19,24,0.792,117,2014-02-18,DAL,MIA,2014,122.0
4324,4324,24,Home,W 106-85 ,240,42,82,0.512,37,57,0.649,5,25,0.2,17,25,0.68,106,29,83,0.349,27,62,0.435,2,21,0.095,25,27,0.926,85,2014-02-21,PHO,SAS,2014,86.0
4325,4325,25,@,L 106-115 ,240,43,86,0.5,35,61,0.574,8,25,0.32,12,14,0.857,106,42,80,0.525,32,64,0.5,10,16,0.625,21,28,0.75,115,2014-02-25,ORL,WAS,2014,120.0
4326,4326,26,@,L 106-112 ,240,45,97,0.464,38,79,0.481,7,18,0.389,9,14,0.643,106,39,84,0.464,29,57,0.509,10,27,0.37,24,28,0.857,112,2014-03-02,DAL,SAS,2014,117.0
4327,4327,27,Home,L 106-107 ,240,43,96,0.448,34,67,0.507,9,29,0.31,11,19,0.579,106,43,94,0.457,35,76,0.461,8,18,0.444,13,15,0.867,107,2014-03-03,POR,LAL,2014,111.0
4328,4328,28,Home,W 106-103 ,240,40,78,0.513,32,55,0.582,8,23,0.348,18,27,0.667,106,38,80,0.475,31,53,0.585,7,27,0.259,20,29,0.69,103,2014-03-04,HOU,MIA,2014,106.5
4329,4329,29,Home,L 106-118 ,240,39,90,0.433,32,64,0.5,7,26,0.269,21,24,0.875,106,47,90,0.522,36,63,0.571,11,27,0.407,13,19,0.684,118,2014-03-05,MIN,NYK,2014,123.5
4330,4330,30,Home,W 106-98 ,240,34,80,0.425,23,51,0.451,11,29,0.379,27,34,0.794,106,33,79,0.418,24,54,0.444,9,25,0.36,23,34,0.676,98,2014-03-11,OKC,HOU,2014,102.5
4331,4331,31,@,L 106-129 ,240,38,87,0.437,26,59,0.441,12,28,0.429,18,23,0.783,106,49,85,0.576,33,47,0.702,16,38,0.421,15,19,0.789,129,2014-03-20,MIN,HOU,2014,137.0
4332,4332,32,@,L 106-122 ,240,40,81,0.494,27,51,0.529,13,30,0.433,13,21,0.619,106,48,89,0.539,36,67,0.537,12,22,0.545,14,17,0.824,122,2014-03-21,DEN,DAL,2014,128.0
4333,4333,33,@,W 106-100 ,240,42,69,0.609,33,51,0.647,9,18,0.5,13,17,0.765,106,35,77,0.455,23,50,0.46,12,27,0.444,18,19,0.947,100,2014-03-23,CLE,NYK,2014,106.0
4334,4334,34,Home,W 106-98 ,240,38,78,0.487,30,60,0.5,8,18,0.444,22,27,0.815,106,41,85,0.482,36,72,0.5,5,13,0.385,11,16,0.688,98,2014-03-24,LAC,MIL,2014,100.5
4335,4335,35,Home,W 106-94 ,240,40,81,0.494,34,63,0.54,6,18,0.333,20,23,0.87,106,38,88,0.432,29,66,0.439,9,22,0.409,9,12,0.75,94,2014-04-03,OKC,SAS,2014,98.5
4336,4336,36,Home,W 106-103 ,240,41,79,0.519,30,56,0.536,11,23,0.478,13,13,1.0,106,44,87,0.506,37,69,0.536,7,18,0.389,8,12,0.667,103,2014-04-11,BOS,CHA,2014,106.5
4337,4337,37,Home,W 106-98 ,240,40,81,0.494,35,62,0.565,5,19,0.263,21,23,0.913,106,40,86,0.465,35,69,0.507,5,17,0.294,13,23,0.565,98,2014-04-11,CHI,DET,2014,100.5
4338,4338,38,Home,W 106-103 ,240,41,82,0.5,35,65,0.538,6,17,0.353,18,27,0.667,106,35,88,0.398,28,66,0.424,7,22,0.318,26,30,0.867,103,2014-04-13,SAC,MIN,2014,106.5
4339,4339,39,Home,W 106-105 (OT),265,43,88,0.489,38,68,0.559,5,20,0.25,15,25,0.6,106,44,92,0.478,36,62,0.581,8,30,0.267,9,11,0.818,105,2014-04-16,MEM,DAL,2014,109.0
4340,4340,40,@,L 106-108 (OT),265,39,80,0.488,32,66,0.485,7,14,0.5,21,24,0.875,106,41,101,0.406,35,80,0.438,6,21,0.286,20,29,0.69,108,2014-10-29,MIL,CHO,2015,111.0
4341,4341,41,Home,W 106-89 ,240,39,87,0.448,28,58,0.483,11,29,0.379,17,22,0.773,106,33,81,0.407,31,65,0.477,2,16,0.125,21,26,0.808,89,2014-10-29,POR,OKC,2015,90.0
4342,4342,42,@,W 106-105 ,240,33,69,0.478,24,46,0.522,9,23,0.391,31,40,0.775,106,38,85,0.447,34,73,0.466,4,12,0.333,25,31,0.806,105,2014-11-01,CHI,MIN,2015,107.0
4343,4343,43,Home,L 106-112 ,240,35,88,0.398,29,72,0.403,6,16,0.375,30,41,0.732,106,41,91,0.451,35,73,0.479,6,18,0.333,24,31,0.774,112,2014-11-04,LAL,PHO,2015,115.0
4344,4344,44,@,W 106-101 ,240,42,81,0.519,35,62,0.565,7,19,0.368,15,20,0.75,106,42,92,0.457,34,74,0.459,8,18,0.444,9,15,0.6,101,2014-11-08,BOS,CHI,2015,105.0
4345,4345,45,Home,W 106-102 ,240,40,81,0.494,35,69,0.507,5,12,0.417,21,30,0.7,106,36,80,0.45,26,55,0.473,10,25,0.4,20,25,0.8,102,2014-11-08,LAC,POR,2015,107.0
4346,4346,46,Home,W 106-98 ,240,38,80,0.475,28,53,0.528,10,27,0.37,20,24,0.833,106,32,72,0.444,23,53,0.434,9,19,0.474,25,32,0.781,98,2014-11-11,DAL,SAC,2015,102.5
4347,4347,47,@,W 106-97 ,240,41,85,0.482,29,54,0.537,12,31,0.387,12,15,0.8,106,34,79,0.43,24,50,0.48,10,29,0.345,19,23,0.826,97,2014-11-17,DEN,CLE,2015,102.0
4348,4348,48,@,W 106-100 ,240,39,79,0.494,30,55,0.545,9,24,0.375,19,24,0.792,106,38,86,0.442,34,75,0.453,4,11,0.364,20,29,0.69,100,2014-11-18,NOP,SAC,2015,102.0
4349,4349,49,@,L 106-140 ,240,44,85,0.518,39,72,0.542,5,13,0.385,13,21,0.619,106,51,82,0.622,33,47,0.702,18,35,0.514,20,28,0.714,140,2014-11-21,LAL,DAL,2015,149.0
4350,4350,50,@,W 106-83 ,240,38,85,0.447,26,54,0.481,12,31,0.387,18,20,0.9,106,31,84,0.369,24,61,0.393,7,23,0.304,14,20,0.7,83,2014-11-22,PHO,IND,2015,86.5
4351,4351,51,@,W 106-94 ,240,42,93,0.452,38,76,0.5,4,17,0.235,18,22,0.818,106,33,71,0.465,28,57,0.491,5,14,0.357,23,29,0.793,94,2014-11-22,NOP,UTA,2015,96.5
4352,4352,52,Home,W 106-74 ,240,42,81,0.519,36,65,0.554,6,16,0.375,16,22,0.727,106,29,80,0.363,24,63,0.381,5,17,0.294,11,15,0.733,74,2014-11-24,CLE,ORL,2015,76.5
4353,4353,53,@,W 106-102 ,240,36,85,0.424,29,60,0.483,7,25,0.28,27,34,0.794,106,36,84,0.429,27,64,0.422,9,20,0.45,21,29,0.724,102,2014-11-25,ATL,WAS,2015,106.5
4354,4354,54,Home,W 106-100 ,240,41,74,0.554,36,59,0.61,5,15,0.333,19,29,0.655,106,40,87,0.46,30,66,0.455,10,21,0.476,10,18,0.556,100,2014-11-26,SAS,IND,2015,105.0
4355,4355,55,@,W 106-101 ,240,42,99,0.424,35,73,0.479,7,26,0.269,15,16,0.938,106,38,87,0.437,32,68,0.471,6,19,0.316,19,23,0.826,101,2014-11-28,GSW,CHO,2015,104.0
4356,4356,56,@,W 106-102 ,240,40,86,0.465,29,60,0.483,11,26,0.423,15,22,0.682,106,38,91,0.418,24,58,0.414,14,33,0.424,12,16,0.75,102,2014-11-28,DAL,TOR,2015,109.0
4357,4357,57,@,W 106-96 ,240,39,81,0.481,29,64,0.453,10,17,0.588,18,24,0.75,106,33,90,0.367,27,69,0.391,6,21,0.286,24,31,0.774,96,2014-12-02,LAL,DET,2015,99.0
4358,4358,58,Home,L 106-118 ,240,40,88,0.455,36,69,0.522,4,19,0.211,22,30,0.733,106,45,80,0.563,32,54,0.593,13,26,0.5,15,17,0.882,118,2014-12-05,DAL,PHO,2015,124.5
4359,4359,59,@,L 106-115 ,240,43,88,0.489,31,64,0.484,12,24,0.5,8,11,0.727,106,44,88,0.5,39,73,0.534,5,15,0.333,22,28,0.786,115,2014-12-12,POR,CHI,2015,117.5
4360,4360,60,Home,W 106-94 ,240,38,91,0.418,28,65,0.431,10,26,0.385,20,22,0.909,106,33,80,0.413,25,58,0.431,8,22,0.364,20,23,0.87,94,2014-12-12,TOR,IND,2015,98.0
4361,4361,61,@,L 106-111 ,240,39,91,0.429,25,62,0.403,14,29,0.483,14,19,0.737,106,43,76,0.566,36,65,0.554,7,11,0.636,18,24,0.75,111,2014-12-13,LAC,MIL,2015,114.5
4362,4362,62,Home,L 106-111 ,240,40,86,0.465,30,62,0.484,10,24,0.417,16,22,0.727,106,43,82,0.524,34,57,0.596,9,25,0.36,16,21,0.762,111,2014-12-17,CHA,PHO,2015,115.5
4363,4363,63,Home,L 106-117 ,240,40,89,0.449,27,56,0.482,13,33,0.394,13,19,0.684,106,40,79,0.506,30,57,0.526,10,22,0.455,27,35,0.771,117,2014-12-17,DET,DAL,2015,122.0
4364,4364,64,@,L 106-109 ,240,39,85,0.459,36,67,0.537,3,18,0.167,25,33,0.758,106,38,80,0.475,27,51,0.529,11,29,0.379,22,30,0.733,109,2014-12-19,LAC,DEN,2015,114.5
4365,4365,65,Home,W 106-102 ,240,37,81,0.457,25,55,0.455,12,26,0.462,20,27,0.741,106,43,81,0.531,35,57,0.614,8,24,0.333,8,15,0.533,102,2014-12-20,LAC,MIL,2015,106.0
4366,4366,66,Home,L 106-114 ,240,42,81,0.519,35,58,0.603,7,23,0.304,15,21,0.714,106,42,81,0.519,33,66,0.5,9,15,0.6,21,38,0.553,114,2014-12-25,SAS,OKC,2015,118.5
4367,4367,67,Home,W 106-102 ,240,39,95,0.411,36,76,0.474,3,19,0.158,25,32,0.781,106,41,103,0.398,38,88,0.432,3,15,0.2,17,24,0.708,102,2014-12-26,DEN,MIN,2015,103.5
4368,4368,68,Home,L 106-115 ,240,41,93,0.441,34,73,0.466,7,20,0.35,17,24,0.708,106,46,94,0.489,32,61,0.525,14,33,0.424,9,12,0.75,115,2014-12-26,SAC,PHO,2015,122.0
4369,4369,69,@,L 106-110 ,240,38,77,0.494,26,44,0.591,12,33,0.364,18,31,0.581,106,39,83,0.47,28,53,0.528,11,30,0.367,21,24,0.875,110,2014-12-28,HOU,SAS,2015,115.5
4370,4370,70,@,L 106-110 ,240,41,86,0.477,32,65,0.492,9,21,0.429,15,19,0.789,106,42,81,0.519,34,63,0.54,8,18,0.444,18,29,0.621,110,2014-12-30,PHO,NOP,2015,114.0
4371,4371,71,Home,W 106-84 ,240,44,94,0.468,39,73,0.534,5,21,0.238,13,15,0.867,106,32,87,0.368,30,72,0.417,2,15,0.133,18,28,0.643,84,2014-12-31,BOS,SAC,2015,85.0
4372,4372,72,Home,W 106-95 ,240,35,79,0.443,25,61,0.41,10,18,0.556,26,30,0.867,106,38,77,0.494,33,61,0.541,5,16,0.313,14,18,0.778,95,2014-12-31,IND,MIA,2015,97.5
4373,4373,73,Home,W 106-101 ,240,38,91,0.418,30,76,0.395,8,15,0.533,22,25,0.88,106,37,92,0.402,32,78,0.41,5,14,0.357,22,27,0.815,101,2015-01-01,CHI,DEN,2015,103.5
4374,4374,74,Home,L 106-109 ,240,43,81,0.531,37,62,0.597,6,19,0.316,14,19,0.737,106,41,84,0.488,35,70,0.5,6,14,0.429,21,31,0.677,109,2015-01-02,LAL,MEM,2015,112.0
4375,4375,75,@,W 106-103 ,240,40,82,0.488,30,59,0.508,10,23,0.435,16,24,0.667,106,38,96,0.396,25,53,0.472,13,43,0.302,14,18,0.778,103,2015-01-09,ATL,DET,2015,109.5
4376,4376,76,Home,W 106-95 ,240,37,81,0.457,27,61,0.443,10,20,0.5,22,26,0.846,106,36,82,0.439,30,65,0.462,6,17,0.353,17,22,0.773,95,2015-01-09,NOP,MEM,2015,98.0
4377,4377,77,@,W 106-94 ,240,41,86,0.477,28,55,0.509,13,31,0.419,11,17,0.647,106,36,81,0.444,29,59,0.492,7,22,0.318,15,19,0.789,94,2015-01-11,POR,LAL,2015,97.5
4378,4378,78,@,W 106-96 ,240,40,87,0.46,37,73,0.507,3,14,0.214,23,29,0.793,106,36,79,0.456,27,55,0.491,9,24,0.375,15,20,0.75,96,2015-01-16,MEM,ORL,2015,100.5
4379,4379,79,Home,L 106-131 ,240,37,88,0.42,30,65,0.462,7,23,0.304,25,34,0.735,106,50,91,0.549,41,69,0.594,9,22,0.409,22,33,0.667,131,2015-01-17,HOU,GSW,2015,135.5
4380,4380,80,Home,W 106-92 ,240,42,81,0.519,37,57,0.649,5,24,0.208,17,25,0.68,106,35,84,0.417,27,62,0.435,8,22,0.364,14,18,0.778,92,2015-01-21,CLE,UTA,2015,96.0
4381,4381,81,@,L 106-113 ,240,44,87,0.506,37,60,0.617,7,27,0.259,11,19,0.579,106,43,91,0.473,33,66,0.5,10,25,0.4,17,21,0.81,113,2015-01-23,ORL,NYK,2015,118.0
4382,4382,82,@,L 106-109 ,240,39,81,0.481,30,57,0.526,9,24,0.375,19,25,0.76,106,40,79,0.506,32,62,0.516,8,17,0.471,21,25,0.84,109,2015-01-25,DAL,NOP,2015,113.0
4383,4383,83,@,W 106-99 ,240,43,83,0.518,35,63,0.556,8,20,0.4,12,18,0.667,106,38,78,0.487,32,61,0.525,6,17,0.353,17,23,0.739,99,2015-01-25,IND,ORL,2015,102.0
4384,4384,84,Home,W 106-98 ,240,40,88,0.455,29,59,0.492,11,29,0.379,15,18,0.833,106,37,88,0.42,29,70,0.414,8,18,0.444,16,23,0.696,98,2015-01-28,PHO,WAS,2015,102.0
4385,4385,85,Home,W 106-87 ,240,40,87,0.46,28,55,0.509,12,32,0.375,14,18,0.778,106,33,91,0.363,24,65,0.369,9,26,0.346,12,17,0.706,87,2015-01-31,GSW,PHO,2015,91.5
4386,4386,86,@,W 106-90 ,240,42,87,0.483,32,55,0.582,10,32,0.313,12,19,0.632,106,34,82,0.415,28,69,0.406,6,13,0.462,16,21,0.762,90,2015-01-31,CLE,MIN,2015,93.0
4387,4387,87,@,W 106-92 ,240,37,81,0.457,25,56,0.446,12,25,0.48,20,24,0.833,106,35,87,0.402,27,69,0.391,8,18,0.444,14,17,0.824,92,2015-02-07,GSW,NYK,2015,96.0
4388,4388,88,@,W 106-78 ,240,37,83,0.446,32,64,0.5,5,19,0.263,27,30,0.9,106,29,81,0.358,20,57,0.351,9,24,0.375,11,14,0.786,78,2015-02-10,DET,CHO,2015,82.5
4389,4389,89,@,W 106-96 ,240,43,79,0.544,39,63,0.619,4,16,0.25,16,23,0.696,106,37,85,0.435,31,67,0.463,6,18,0.333,16,27,0.593,96,2015-02-10,DEN,LAL,2015,99.0
4390,4390,90,@,W 106-93 ,240,40,75,0.533,31,55,0.564,9,20,0.45,17,18,0.944,106,34,74,0.459,27,59,0.458,7,15,0.467,18,25,0.72,93,2015-02-11,IND,NOP,2015,96.5
4391,4391,91,@,W 106-95 ,240,40,83,0.482,32,61,0.525,8,22,0.364,18,22,0.818,106,34,84,0.405,26,59,0.441,8,25,0.32,19,29,0.655,95,2015-02-20,IND,PHI,2015,99.0
4392,4392,92,Home,W 106-89 ,240,37,89,0.416,24,57,0.421,13,32,0.406,19,25,0.76,106,37,85,0.435,31,68,0.456,6,17,0.353,9,14,0.643,89,2015-02-22,DET,WAS,2015,92.0
4393,4393,93,Home,W 106-98 ,240,40,96,0.417,26,61,0.426,14,35,0.4,12,15,0.8,106,37,82,0.451,27,61,0.443,10,21,0.476,14,17,0.824,98,2015-02-27,BOS,CHO,2015,103.0
4394,4394,94,@,W 106-101 ,240,40,95,0.421,28,61,0.459,12,34,0.353,14,17,0.824,106,40,109,0.367,32,78,0.41,8,31,0.258,13,17,0.765,101,2015-03-01,GSW,BOS,2015,105.0
4395,4395,95,Home,W 106-95 ,240,39,86,0.453,27,52,0.519,12,34,0.353,16,20,0.8,106,35,86,0.407,25,62,0.403,10,24,0.417,15,22,0.682,95,2015-03-03,DEN,MIL,2015,100.0
4396,4396,96,Home,W 106-97 ,240,43,84,0.512,37,63,0.587,6,21,0.286,14,17,0.824,106,29,69,0.42,16,31,0.516,13,38,0.342,26,33,0.788,97,2015-03-06,ATL,CLE,2015,103.5
4397,4397,97,Home,W 106-98 ,240,40,80,0.5,30,58,0.517,10,22,0.455,16,23,0.696,106,40,83,0.482,32,58,0.552,8,25,0.32,10,14,0.714,98,2015-03-08,GSW,LAC,2015,102.0
4398,4398,98,Home,W 106-78 ,240,38,87,0.437,30,63,0.476,8,24,0.333,22,29,0.759,106,29,75,0.387,24,62,0.387,5,13,0.385,15,25,0.6,78,2015-03-09,DEN,NYK,2015,80.5
4399,4399,99,Home,L 106-113 ,240,42,93,0.452,36,75,0.48,6,18,0.333,16,26,0.615,106,40,85,0.471,32,65,0.492,8,20,0.4,25,30,0.833,113,2015-03-11,CHA,SAC,2015,117.0
4400,4400,0,Home,W 106-97 ,240,45,90,0.5,39,66,0.591,6,24,0.25,10,13,0.769,106,36,81,0.444,35,68,0.515,1,13,0.077,24,26,0.923,97,2015-03-11,PHO,MIN,2015,97.5
4401,4401,1,Home,W 106-92 ,240,42,76,0.553,38,61,0.623,4,15,0.267,18,22,0.818,106,30,79,0.38,19,46,0.413,11,33,0.333,21,27,0.778,92,2015-03-16,MIA,CLE,2015,97.5
4402,4402,2,Home,L 106-122 ,240,41,88,0.466,32,73,0.438,9,15,0.6,15,17,0.882,106,52,90,0.578,47,77,0.61,5,13,0.385,13,17,0.765,122,2015-03-16,MIN,BRK,2015,124.5
4403,4403,3,Home,W 106-91 ,240,38,78,0.487,30,60,0.5,8,18,0.444,22,26,0.846,106,32,73,0.438,22,51,0.431,10,22,0.455,17,21,0.81,91,2015-03-21,GSW,UTA,2015,96.0
4404,4404,4,Home,W 106-89 ,240,39,75,0.52,35,64,0.547,4,11,0.364,24,29,0.828,106,35,84,0.417,27,65,0.415,8,19,0.421,11,16,0.688,89,2015-03-22,TOR,NYK,2015,93.0
4405,4405,5,@,W 106-104 (OT),265,37,78,0.474,25,59,0.424,12,19,0.632,20,25,0.8,106,38,87,0.437,29,59,0.492,9,28,0.321,19,31,0.613,104,2015-03-23,MIN,UTA,2015,108.5
4406,4406,6,@,L 106-107 ,240,40,81,0.494,27,53,0.509,13,28,0.464,13,21,0.619,106,35,97,0.361,28,77,0.364,7,20,0.35,30,38,0.789,107,2015-03-24,PHI,SAC,2015,110.5
4407,4407,7,Home,W 106-98 ,240,40,86,0.465,31,63,0.492,9,23,0.391,17,19,0.895,106,37,81,0.457,29,51,0.569,8,30,0.267,16,20,0.8,98,2015-03-27,BRK,CLE,2015,102.0
4408,4408,8,Home,L 106-119 ,240,39,93,0.419,31,62,0.5,8,31,0.258,20,23,0.87,106,41,84,0.488,28,52,0.538,13,32,0.406,24,40,0.6,119,2015-03-29,BOS,LAC,2015,125.5
4409,4409,9,@,L 106-111 ,240,37,82,0.451,25,59,0.424,12,23,0.522,20,24,0.833,106,40,80,0.5,31,62,0.5,9,18,0.5,22,28,0.786,111,2015-03-31,IND,BRK,2015,115.5
4410,4410,10,Home,L 106-110 ,240,36,82,0.439,30,60,0.5,6,22,0.273,28,33,0.848,106,38,85,0.447,30,64,0.469,8,21,0.381,26,34,0.765,110,2015-03-31,LAC,GSW,2015,114.0
4411,4411,11,Home,W 106-93 ,240,44,76,0.579,40,64,0.625,4,12,0.333,14,22,0.636,106,36,91,0.396,26,57,0.456,10,34,0.294,11,17,0.647,93,2015-04-01,WAS,PHI,2015,98.0
4412,4412,12,@,L 106-107 ,240,42,90,0.467,37,71,0.521,5,19,0.263,17,26,0.654,106,43,93,0.462,33,67,0.493,10,26,0.385,11,17,0.647,107,2015-04-02,PHO,GSW,2015,112.0
4413,4413,13,@,W 106-78 ,240,40,75,0.533,25,48,0.521,15,27,0.556,11,18,0.611,106,29,75,0.387,22,58,0.379,7,17,0.412,13,22,0.591,78,2015-04-05,LAC,LAL,2015,81.5
4414,4414,14,Home,W 106-96 ,240,41,91,0.451,35,77,0.455,6,14,0.429,18,23,0.783,106,39,87,0.448,28,61,0.459,11,26,0.423,7,9,0.778,96,2015-04-06,BRK,POR,2015,101.5
4415,4415,15,Home,W 106-98 ,240,41,83,0.494,32,60,0.533,9,23,0.391,15,24,0.625,106,32,74,0.432,29,59,0.492,3,15,0.2,31,34,0.912,98,2015-04-10,LAL,MIN,2015,99.5
4416,4416,16,Home,L 106-120 ,240,34,78,0.436,25,54,0.463,9,24,0.375,29,36,0.806,106,45,83,0.542,35,62,0.565,10,21,0.476,20,26,0.769,120,2015-04-12,LAL,DAL,2015,125.0
4417,4417,17,@,W 106-94 ,240,37,96,0.385,25,67,0.373,12,29,0.414,20,26,0.769,106,37,82,0.451,29,55,0.527,8,27,0.296,12,15,0.8,94,2015-10-27,DET,ATL,2016,98.0
4418,4418,18,@,W 106-76 ,240,41,84,0.488,28,55,0.509,13,29,0.448,11,17,0.647,106,29,82,0.354,27,66,0.409,2,16,0.125,16,22,0.727,76,2015-10-28,CLE,MEM,2016,77.0
4419,4419,19,@,L 106-112 ,240,45,93,0.484,40,78,0.513,5,15,0.333,11,13,0.846,106,42,86,0.488,35,67,0.522,7,19,0.368,21,22,0.955,112,2015-10-28,SAS,OKC,2016,115.5
4420,4420,20,Home,W 106-99 ,240,36,80,0.45,29,62,0.468,7,18,0.389,27,39,0.692,106,32,86,0.372,23,63,0.365,9,23,0.391,26,31,0.839,99,2015-10-28,TOR,IND,2016,103.5
4421,4421,21,Home,W 106-87 ,240,41,90,0.456,30,65,0.462,11,25,0.44,13,20,0.65,106,29,69,0.42,24,50,0.48,5,19,0.263,24,24,1.0,87,2015-11-01,TOR,MIL,2016,89.5
4422,4422,22,@,W 106-101 ,240,41,89,0.461,32,59,0.542,9,30,0.3,15,20,0.75,106,34,79,0.43,31,66,0.47,3,13,0.231,30,39,0.769,101,2015-11-02,POR,MIN,2016,102.5
4423,4423,23,@,W 106-88 ,240,46,87,0.529,40,64,0.625,6,23,0.261,8,11,0.727,106,34,84,0.405,27,65,0.415,7,19,0.368,13,19,0.684,88,2015-11-09,SAS,SAC,2016,91.5
4424,4424,24,Home,W 106-98 ,240,42,86,0.488,32,60,0.533,10,26,0.385,12,16,0.75,106,37,83,0.446,23,54,0.426,14,29,0.483,10,15,0.667,98,2015-11-11,ATL,NOP,2016,105.0
4425,4425,25,@,W 106-98 ,240,42,98,0.429,34,81,0.42,8,17,0.471,14,17,0.824,106,42,98,0.429,34,64,0.531,8,34,0.235,6,12,0.5,98,2015-11-11,BRK,HOU,2016,102.0
4426,4426,26,Home,W 106-93 ,240,42,103,0.408,31,70,0.443,11,33,0.333,11,12,0.917,106,36,76,0.474,30,56,0.536,6,20,0.3,15,20,0.75,93,2015-11-13,BOS,ATL,2016,96.0
4427,4427,27,Home,W 106-94 ,240,41,83,0.494,32,52,0.615,9,31,0.29,15,19,0.789,106,35,89,0.393,30,68,0.441,5,21,0.238,19,21,0.905,94,2015-11-15,CHA,POR,2016,96.5
4428,4428,28,Home,L 106-114 ,240,41,82,0.5,36,66,0.545,5,16,0.313,19,21,0.905,106,40,71,0.563,31,54,0.574,9,17,0.529,25,27,0.926,114,2015-11-15,MIN,MEM,2016,118.5
4429,4429,29,@,W 106-102 ,240,37,72,0.514,30,52,0.577,7,20,0.35,25,35,0.714,106,38,92,0.413,30,66,0.455,8,26,0.308,18,24,0.75,102,2015-11-18,DAL,BOS,2016,106.0
4430,4430,30,Home,W 106-94 ,240,39,79,0.494,29,50,0.58,10,29,0.345,18,24,0.75,106,35,88,0.398,28,66,0.424,7,22,0.318,17,23,0.739,94,2015-11-20,GSW,CHI,2016,97.5
4431,4431,31,Home,L 106-123 ,240,38,83,0.458,25,50,0.5,13,33,0.394,17,24,0.708,106,44,80,0.55,25,54,0.463,19,26,0.731,16,23,0.696,123,2015-11-24,WAS,IND,2016,132.5
4432,4432,32,Home,W 106-100 ,240,39,90,0.433,29,62,0.468,10,28,0.357,18,20,0.9,106,37,93,0.398,30,74,0.405,7,19,0.368,19,22,0.864,100,2015-11-30,ATL,OKC,2016,103.5
4433,4433,33,@,W 106-103 ,240,40,82,0.488,26,53,0.491,14,29,0.483,12,15,0.8,106,40,89,0.449,34,70,0.486,6,19,0.316,17,22,0.773,103,2015-11-30,GSW,UTA,2016,106.0
4434,4434,34,@,W 106-105 ,240,38,81,0.469,26,54,0.481,12,27,0.444,18,18,1.0,106,39,92,0.424,31,65,0.477,8,27,0.296,19,22,0.864,105,2015-12-03,DEN,TOR,2016,109.0
4435,4435,35,@,L 106-109 ,240,43,84,0.512,33,61,0.541,10,23,0.435,10,16,0.625,106,40,82,0.488,30,56,0.536,10,26,0.385,19,25,0.76,109,2015-12-04,PHO,WAS,2016,114.0
4436,4436,36,Home,W 106-91 ,240,44,89,0.494,42,85,0.494,2,4,0.5,16,24,0.667,106,32,76,0.421,26,51,0.51,6,25,0.24,21,28,0.75,91,2015-12-05,MIL,NYK,2016,94.0
4437,4437,37,Home,L 106-110 ,240,36,82,0.439,29,64,0.453,7,18,0.389,27,35,0.771,106,38,86,0.442,30,61,0.492,8,25,0.32,26,29,0.897,110,2015-12-07,MIN,LAC,2016,114.0
4438,4438,38,@,L 106-114 ,240,38,92,0.413,23,56,0.411,15,36,0.417,15,22,0.682,106,43,77,0.558,33,49,0.673,10,28,0.357,18,24,0.75,114,2015-12-08,UTA,SAC,2016,119.0
4439,4439,39,Home,W 106-85 ,240,39,80,0.488,30,59,0.508,9,21,0.429,19,23,0.826,106,31,78,0.397,23,57,0.404,8,21,0.381,15,27,0.556,85,2015-12-09,UTA,NYK,2016,89.0
4440,4440,40,@,W 106-96 ,240,45,96,0.469,33,62,0.532,12,34,0.353,4,7,0.571,106,36,83,0.434,23,48,0.479,13,35,0.371,11,18,0.611,96,2015-12-11,POR,PHO,2016,102.5
4441,4441,41,Home,W 106-90 ,240,41,86,0.477,31,64,0.484,10,22,0.455,14,16,0.875,106,29,79,0.367,19,51,0.373,10,28,0.357,22,26,0.846,90,2015-12-14,IND,TOR,2016,95.0
4442,4442,42,@,L 106-127 ,240,39,75,0.52,27,49,0.551,12,26,0.462,16,24,0.667,106,48,78,0.615,38,57,0.667,10,21,0.476,21,24,0.875,127,2015-12-16,PHI,ATL,2016,132.0
4443,4443,43,Home,W 106-90 ,240,38,79,0.481,36,65,0.554,2,14,0.143,28,37,0.757,106,32,92,0.348,21,66,0.318,11,26,0.423,15,18,0.833,90,2015-12-16,OKC,POR,2016,95.5
4444,4444,44,Home,W 106-97 ,240,37,77,0.481,28,48,0.583,9,29,0.31,23,28,0.821,106,38,81,0.469,33,57,0.579,5,24,0.208,16,22,0.727,97,2015-12-21,ATL,POR,2016,99.5
4445,4445,45,Home,W 106-92 ,240,46,89,0.517,40,69,0.58,6,20,0.3,8,9,0.889,106,38,90,0.422,31,71,0.437,7,19,0.368,9,15,0.6,92,2015-12-21,SAS,IND,2016,95.5
4446,4446,46,Home,L 106-108 ,240,41,89,0.461,29,57,0.509,12,32,0.375,12,20,0.6,106,46,89,0.517,42,66,0.636,4,23,0.174,12,16,0.75,108,2015-12-23,IND,SAC,2016,110.0
4447,4447,47,@,L 106-110 ,240,43,82,0.524,35,62,0.565,8,20,0.4,12,13,0.923,106,42,80,0.525,35,59,0.593,7,21,0.333,19,24,0.792,110,2015-12-31,PHO,OKC,2016,113.5
4448,4448,48,Home,W 106-82 ,240,46,82,0.561,38,64,0.594,8,18,0.444,6,9,0.667,106,32,88,0.364,25,57,0.439,7,31,0.226,11,14,0.786,82,2016-01-01,MIA,DAL,2016,85.5
4449,4449,49,Home,L 106-112 ,240,34,80,0.425,27,58,0.466,7,22,0.318,31,48,0.646,106,40,78,0.513,30,55,0.545,10,23,0.435,22,32,0.688,112,2016-01-03,DEN,POR,2016,117.0
4450,4450,50,@,L 106-117 ,240,46,102,0.451,40,86,0.465,6,16,0.375,8,14,0.571,106,46,83,0.554,41,64,0.641,5,19,0.263,20,20,1.0,117,2016-01-05,MIL,CHI,2016,119.5
4451,4451,51,@,W 106-79 ,240,44,82,0.537,40,69,0.58,4,13,0.308,14,19,0.737,106,33,73,0.452,31,61,0.508,2,12,0.167,11,13,0.846,79,2016-01-11,SAS,BRK,2016,80.0
4452,4452,52,Home,W 106-101 ,240,43,93,0.462,40,80,0.5,3,13,0.231,17,28,0.607,106,35,85,0.412,23,56,0.411,12,29,0.414,19,24,0.792,101,2016-01-12,MIL,CHI,2016,107.0
4453,4453,53,Home,W 106-101 ,240,38,84,0.452,26,57,0.456,12,27,0.444,18,24,0.75,106,38,72,0.528,37,64,0.578,1,8,0.125,24,34,0.706,101,2016-01-13,WAS,MIL,2016,101.5
4454,4454,54,@,W 106-103 (OT),265,37,90,0.411,29,66,0.439,8,24,0.333,24,31,0.774,106,44,97,0.454,35,74,0.473,9,23,0.391,6,8,0.75,103,2016-01-14,TOR,ORL,2016,107.5
4455,4455,55,Home,W 106-94 (OT),265,42,97,0.433,37,72,0.514,5,25,0.2,17,22,0.773,106,40,91,0.44,35,68,0.515,5,23,0.217,9,11,0.818,94,2016-01-20,DAL,MIN,2016,96.5
4456,4456,56,Home,W 106-87 ,240,45,86,0.523,40,70,0.571,5,16,0.313,11,13,0.846,106,33,68,0.485,26,53,0.491,7,15,0.467,14,18,0.778,87,2016-01-20,WAS,MIA,2016,90.5
4457,4457,57,Home,L 106-109 ,240,40,87,0.46,30,54,0.556,10,33,0.303,16,18,0.889,106,45,91,0.495,37,61,0.607,8,30,0.267,11,15,0.733,109,2016-01-22,DAL,OKC,2016,113.0
4458,4458,58,Home,W 106-101 ,240,34,68,0.5,29,51,0.569,5,17,0.294,33,36,0.917,106,37,79,0.468,28,60,0.467,9,19,0.474,18,22,0.818,101,2016-01-23,MIN,MEM,2016,105.5
4459,4459,59,@,L 106-116 ,240,43,93,0.462,35,67,0.522,8,26,0.308,12,19,0.632,106,45,94,0.479,37,77,0.481,8,17,0.471,18,25,0.72,116,2016-01-24,OKC,BRK,2016,120.0
4460,4460,60,Home,W 106-89 ,240,35,79,0.443,24,50,0.48,11,29,0.379,25,32,0.781,106,32,78,0.41,28,63,0.444,4,15,0.267,21,28,0.75,89,2016-01-26,TOR,WAS,2016,91.0
4461,4461,61,Home,L 106-114 ,240,40,84,0.476,33,61,0.541,7,23,0.304,19,26,0.731,106,39,83,0.47,30,60,0.5,9,23,0.391,27,29,0.931,114,2016-01-29,DET,CLE,2016,118.5
4462,4462,62,Home,L 106-111 (OT),265,43,101,0.426,35,74,0.473,8,27,0.296,12,14,0.857,106,44,88,0.5,37,66,0.561,7,22,0.318,16,23,0.696,111,2016-02-01,IND,CLE,2016,114.5
4463,4463,63,Home,W 106-97 ,240,39,79,0.494,30,52,0.577,9,27,0.333,19,23,0.826,106,38,83,0.458,28,55,0.509,10,28,0.357,11,14,0.786,97,2016-02-03,CHA,CLE,2016,102.0
4464,4464,64,Home,W 106-94 ,240,44,84,0.524,38,62,0.613,6,22,0.273,12,20,0.6,106,37,87,0.425,28,61,0.459,9,26,0.346,11,14,0.786,94,2016-02-05,WAS,PHI,2016,98.5
4465,4465,65,Home,W 106-102 ,240,39,88,0.443,31,64,0.484,8,24,0.333,20,25,0.8,106,34,86,0.395,24,56,0.429,10,30,0.333,24,27,0.889,102,2016-02-06,SAS,LAL,2016,107.0
4466,4466,66,Home,L 106-112 (OT),265,43,86,0.5,36,67,0.537,7,19,0.368,13,19,0.684,106,44,89,0.494,34,60,0.567,10,29,0.345,14,20,0.7,112,2016-02-08,MEM,POR,2016,117.0
4467,4467,67,Home,L 106-122 ,240,37,73,0.507,36,62,0.581,1,11,0.091,31,39,0.795,106,42,85,0.494,27,52,0.519,15,33,0.455,23,30,0.767,122,2016-02-08,PHO,OKC,2016,129.5
4468,4468,68,Home,W 106-95 ,240,42,91,0.462,35,67,0.522,7,24,0.292,15,17,0.882,106,37,93,0.398,29,72,0.403,8,21,0.381,13,22,0.591,95,2016-02-18,CLE,CHI,2016,99.0
4469,4469,69,@,L 106-116 ,240,38,88,0.432,33,70,0.471,5,18,0.278,25,34,0.735,106,48,93,0.516,41,77,0.532,7,16,0.438,13,20,0.65,116,2016-02-19,TOR,CHI,2016,119.5
4470,4470,70,Home,L 106-111 ,240,37,89,0.416,25,56,0.446,12,33,0.364,20,32,0.625,106,41,86,0.477,37,66,0.561,4,20,0.2,25,29,0.862,111,2016-02-21,DET,NOP,2016,113.0
4471,4471,71,Home,L 106-116 ,240,42,98,0.429,33,71,0.465,9,27,0.333,13,23,0.565,106,37,75,0.493,29,57,0.509,8,18,0.444,34,42,0.81,116,2016-02-25,PHO,BRK,2016,120.0
4472,4472,72,@,L 106-111 ,240,32,80,0.4,26,60,0.433,6,20,0.3,36,42,0.857,106,37,80,0.463,25,48,0.521,12,32,0.375,25,35,0.714,111,2016-02-27,MEM,PHO,2016,117.0
4473,4473,73,@,L 106-121 ,240,40,86,0.465,36,66,0.545,4,20,0.2,22,27,0.815,106,47,87,0.54,36,53,0.679,11,34,0.324,16,21,0.762,121,2016-03-03,OKC,GSW,2016,126.5
4474,4474,74,@,W 106-77 ,240,37,68,0.544,24,40,0.6,13,28,0.464,19,26,0.731,106,29,85,0.341,24,58,0.414,5,27,0.185,14,20,0.7,77,2016-03-04,ATL,LAL,2016,79.5
4475,4475,75,@,W 106-94 ,240,37,78,0.474,31,58,0.534,6,20,0.3,26,27,0.963,106,38,92,0.413,29,73,0.397,9,19,0.474,9,11,0.818,94,2016-03-05,UTA,NOP,2016,98.5
4476,4476,76,@,W 106-103 ,240,41,86,0.477,35,66,0.53,6,20,0.3,18,22,0.818,106,36,80,0.45,29,51,0.569,7,29,0.241,24,29,0.828,103,2016-03-07,MEM,CLE,2016,106.5
4477,4477,77,@,W 106-98 ,240,38,79,0.481,34,61,0.557,4,18,0.222,26,33,0.788,106,37,84,0.44,32,58,0.552,5,26,0.192,19,26,0.731,98,2016-03-15,SAC,LAL,2016,100.5
4478,4478,78,Home,L 106-122 ,240,40,82,0.488,31,57,0.544,9,25,0.36,17,24,0.708,106,43,76,0.566,31,46,0.674,12,30,0.4,24,32,0.75,122,2016-03-16,HOU,LAC,2016,128.0
4479,4479,79,Home,L 106-109 ,240,40,75,0.533,33,58,0.569,7,17,0.412,19,24,0.792,106,40,86,0.465,27,60,0.45,13,26,0.5,16,21,0.762,109,2016-03-17,MIA,CHO,2016,115.5
4480,4480,80,Home,W 106-94 ,240,39,76,0.513,26,46,0.565,13,30,0.433,15,16,0.938,106,37,89,0.416,31,64,0.484,6,25,0.24,14,18,0.778,94,2016-03-24,NYK,CHI,2016,97.0
4481,4481,81,@,W 106-100 ,240,38,79,0.481,29,54,0.537,9,25,0.36,21,42,0.5,106,31,86,0.36,17,46,0.37,14,40,0.35,24,28,0.857,100,2016-03-29,HOU,CLE,2016,107.0
4482,4482,82,Home,L 106-109 ,240,38,83,0.458,18,40,0.45,20,43,0.465,10,13,0.769,106,41,87,0.471,33,64,0.516,8,23,0.348,19,30,0.633,109,2016-04-01,GSW,BOS,2016,113.0
4483,4483,83,@,W 106-99 ,240,38,86,0.442,28,60,0.467,10,26,0.385,20,25,0.8,106,36,93,0.387,29,70,0.414,7,23,0.304,20,26,0.769,99,2016-04-01,WAS,PHO,2016,102.5
4484,4484,84,Home,L 106-112 ,240,38,87,0.437,31,66,0.47,7,21,0.333,23,29,0.793,106,42,82,0.512,30,60,0.5,12,22,0.545,16,17,0.941,112,2016-04-01,SAC,MIA,2016,118.0
4485,4485,85,Home,L 106-115 ,240,40,92,0.435,31,63,0.492,9,29,0.31,17,24,0.708,106,41,88,0.466,33,67,0.493,8,21,0.381,25,31,0.806,115,2016-04-02,DEN,SAC,2016,119.0
4486,4486,86,@,W 106-87 ,240,42,76,0.553,34,54,0.63,8,22,0.364,14,23,0.609,106,33,85,0.388,25,62,0.403,8,23,0.348,13,21,0.619,87,2016-04-03,NOP,BRK,2016,91.0
4487,4487,87,Home,W 106-98 ,240,44,92,0.478,40,78,0.513,4,14,0.286,14,17,0.824,106,35,78,0.449,32,64,0.5,3,14,0.214,25,28,0.893,98,2016-04-07,MIA,CHI,2016,99.5
4488,4488,88,@,W 106-105 ,240,41,84,0.488,36,71,0.507,5,13,0.385,19,25,0.76,106,40,80,0.5,31,56,0.554,9,24,0.375,16,18,0.889,105,2016-04-09,MIN,POR,2016,109.5
4489,4489,89,Home,L 106-114 ,240,39,85,0.459,35,67,0.522,4,18,0.222,24,32,0.75,106,37,91,0.407,29,62,0.468,8,29,0.276,32,46,0.696,114,2016-10-27,POR,LAC,2017,118.0
4490,4490,90,@,W 106-98 ,240,33,70,0.471,18,38,0.474,15,32,0.469,25,31,0.806,106,35,80,0.438,27,51,0.529,8,29,0.276,20,24,0.833,98,2016-10-28,HOU,DAL,2017,102.0
4491,4491,91,Home,W 106-103 ,240,39,85,0.459,30,59,0.508,9,26,0.346,19,25,0.76,106,37,70,0.529,30,48,0.625,7,22,0.318,22,31,0.71,103,2016-10-29,SAC,MIN,2017,106.5
4492,4492,92,@,W 106-99 ,240,37,82,0.451,27,64,0.422,10,18,0.556,22,26,0.846,106,37,80,0.463,30,60,0.5,7,20,0.35,18,26,0.692,99,2016-10-30,SAS,MIA,2017,102.5
4493,4493,93,@,W 106-100 ,240,35,83,0.422,27,54,0.5,8,29,0.276,28,33,0.848,106,37,90,0.411,29,67,0.433,8,23,0.348,18,25,0.72,100,2016-10-30,GSW,PHO,2017,104.0
4494,4494,94,Home,W 106-95 ,240,33,79,0.418,22,49,0.449,11,30,0.367,29,47,0.617,106,36,75,0.48,26,52,0.5,10,23,0.435,13,19,0.684,95,2016-10-31,ATL,SAC,2017,100.0
4495,4495,95,@,W 106-91 ,240,38,76,0.5,23,45,0.511,15,31,0.484,15,18,0.833,106,33,76,0.434,27,56,0.482,6,20,0.3,19,21,0.905,91,2016-11-01,UTA,SAS,2017,94.0
4496,4496,96,@,L 106-116 ,240,39,80,0.488,32,59,0.542,7,21,0.333,21,27,0.778,106,45,90,0.5,29,55,0.527,16,35,0.457,10,12,0.833,116,2016-11-07,NOP,GSW,2017,124.0
4497,4497,97,Home,L 106-114 ,240,39,94,0.415,29,67,0.433,10,27,0.37,18,20,0.9,106,41,79,0.519,24,42,0.571,17,37,0.459,15,18,0.833,114,2016-11-07,WAS,HOU,2017,122.5
4498,4498,98,Home,L 106-110 ,240,37,99,0.374,26,57,0.456,11,42,0.262,21,25,0.84,106,41,81,0.506,30,52,0.577,11,29,0.379,17,24,0.708,110,2016-11-08,CLE,ATL,2017,115.5
4499,4499,99,Home,L 106-112 ,240,40,91,0.44,34,73,0.466,6,18,0.333,20,25,0.8,106,39,89,0.438,30,64,0.469,9,25,0.36,25,27,0.926,112,2016-11-10,MIL,NOP,2017,116.5
4500,4500,0,Home,W 106-95 ,240,39,97,0.402,34,82,0.415,5,15,0.333,23,25,0.92,106,38,91,0.418,34,78,0.436,4,13,0.308,15,18,0.833,95,2016-11-12,CHI,WAS,2017,97.0
4501,4501,1,@,W 106-95 ,240,46,90,0.511,42,72,0.583,4,18,0.222,10,14,0.714,106,36,84,0.429,27,59,0.458,9,25,0.36,14,19,0.737,95,2016-11-12,DET,DEN,2017,99.5
4502,4502,2,@,W 106-100 ,240,41,76,0.539,36,58,0.621,5,18,0.278,19,24,0.792,106,34,89,0.382,19,42,0.452,15,47,0.319,17,21,0.81,100,2016-11-12,SAS,HOU,2017,107.5
4503,4503,3,Home,W 106-96 ,240,36,68,0.529,29,50,0.58,7,18,0.389,27,36,0.75,106,35,78,0.449,29,48,0.604,6,30,0.2,20,21,0.952,96,2016-11-12,MIL,MEM,2017,99.0
4504,4504,4,Home,W 106-105 ,240,35,79,0.443,29,58,0.5,6,21,0.286,30,36,0.833,106,38,95,0.4,26,54,0.481,12,41,0.293,17,20,0.85,105,2016-11-14,NOP,BOS,2017,111.0
4505,4505,5,Home,W 106-101 ,240,37,91,0.407,27,63,0.429,10,28,0.357,22,34,0.647,106,39,91,0.429,28,64,0.438,11,27,0.407,12,15,0.8,101,2016-11-21,WAS,PHO,2017,106.5
4506,4506,6,@,L 106-149 ,240,40,93,0.43,32,73,0.438,8,20,0.4,18,22,0.818,106,53,86,0.616,34,50,0.68,19,36,0.528,24,35,0.686,149,2016-11-23,LAL,GSW,2017,158.5
4507,4507,7,Home,W 106-88 ,240,42,83,0.506,34,60,0.567,8,23,0.348,14,26,0.538,106,37,82,0.451,36,63,0.571,1,19,0.053,13,17,0.765,88,2016-11-26,OKC,DET,2017,88.5
4508,4508,8,@,W 106-98 ,240,41,93,0.441,32,69,0.464,9,24,0.375,15,26,0.577,106,38,91,0.418,31,69,0.449,7,22,0.318,15,24,0.625,98,2016-11-30,MIA,DEN,2017,101.5
4509,4509,9,@,W 106-104 ,240,41,91,0.451,28,59,0.475,13,32,0.406,11,15,0.733,106,34,77,0.442,30,58,0.517,4,19,0.211,32,39,0.821,104,2016-11-30,NYK,MIN,2017,106.0
4510,4510,10,Home,L 106-107 ,240,35,76,0.461,20,43,0.465,15,33,0.455,21,26,0.808,106,38,76,0.5,30,50,0.6,8,26,0.308,23,29,0.793,107,2016-12-03,PHI,BOS,2017,111.0
4511,4511,11,Home,W 106-98 ,240,39,88,0.443,28,59,0.475,11,29,0.379,17,24,0.708,106,31,97,0.32,22,69,0.319,9,28,0.321,27,31,0.871,98,2016-12-04,NYK,SAC,2017,102.5
4512,4512,12,@,L 106-142 ,240,35,85,0.412,32,70,0.457,3,15,0.2,33,35,0.943,106,54,104,0.519,40,67,0.597,14,37,0.378,20,26,0.769,142,2016-12-05,IND,GSW,2017,149.0
4513,4513,13,@,L 106-107 ,240,42,99,0.424,31,67,0.463,11,32,0.344,11,12,0.917,106,34,76,0.447,22,38,0.579,12,38,0.316,27,31,0.871,107,2016-12-05,BOS,HOU,2017,113.0
4514,4514,14,@,W 106-98 ,240,35,76,0.461,25,49,0.51,10,27,0.37,26,34,0.765,106,35,86,0.407,24,55,0.436,11,31,0.355,17,23,0.739,98,2016-12-05,DEN,PHI,2017,103.5
4515,4515,15,@,W 106-99 ,240,39,80,0.488,27,51,0.529,12,29,0.414,16,23,0.696,106,37,89,0.416,27,51,0.529,10,38,0.263,15,21,0.714,99,2016-12-08,GSW,UTA,2017,104.0
4516,4516,16,@,L 106-109 ,240,38,74,0.514,24,41,0.585,14,33,0.424,16,21,0.762,106,45,87,0.517,40,69,0.58,5,18,0.278,14,17,0.824,109,2016-12-14,CHA,WAS,2017,111.5
4517,4517,17,Home,W 106-101 ,240,39,83,0.47,28,55,0.509,11,28,0.393,17,22,0.773,106,37,92,0.402,31,73,0.425,6,19,0.316,21,25,0.84,101,2016-12-22,LAC,SAS,2017,104.0
4518,4518,18,Home,W 106-95 ,240,41,96,0.427,32,76,0.421,9,20,0.45,15,17,0.882,106,39,90,0.433,34,63,0.54,5,27,0.185,12,16,0.75,95,2016-12-22,NYK,ORL,2017,97.5
4519,4519,19,Home,W 106-90 ,240,41,92,0.446,25,64,0.391,16,28,0.571,8,15,0.533,106,30,79,0.38,19,51,0.373,11,28,0.393,19,23,0.826,90,2016-12-26,DET,CLE,2017,95.5
4520,4520,20,@,W 106-102 ,240,36,82,0.439,25,51,0.49,11,31,0.355,23,28,0.821,106,39,84,0.464,30,59,0.508,9,25,0.36,15,20,0.75,102,2016-12-26,DEN,LAC,2017,106.5
4521,4521,21,@,W 106-94 ,240,42,82,0.512,37,63,0.587,5,19,0.263,17,25,0.68,106,36,82,0.439,29,59,0.492,7,23,0.304,15,21,0.714,94,2016-12-27,OKC,MIA,2017,97.5
4522,4522,22,@,W 106-94 ,240,41,85,0.482,28,55,0.509,13,30,0.433,11,15,0.733,106,34,83,0.41,26,58,0.448,8,25,0.32,18,24,0.75,94,2017-01-04,CHI,CLE,2017,98.0
4523,4523,23,@,L 106-115 ,240,38,88,0.432,27,60,0.45,11,28,0.393,19,25,0.76,106,37,73,0.507,28,50,0.56,9,23,0.391,32,45,0.711,115,2017-01-04,MEM,LAC,2017,119.5
4524,4524,24,@,L 106-110 ,240,37,79,0.468,28,51,0.549,9,28,0.321,23,26,0.885,106,35,87,0.402,16,47,0.34,19,40,0.475,21,25,0.84,110,2017-01-06,PHI,BOS,2017,119.5
4525,4525,25,@,W 106-98 ,240,39,84,0.464,26,53,0.491,13,31,0.419,15,21,0.714,106,36,87,0.414,27,57,0.474,9,30,0.3,17,22,0.773,98,2017-01-06,LAC,SAC,2017,102.5
4526,4526,26,@,L 106-121 ,240,40,99,0.404,31,75,0.413,9,24,0.375,17,24,0.708,106,43,89,0.483,31,53,0.585,12,36,0.333,23,29,0.793,121,2017-01-07,DEN,OKC,2017,127.0
4527,4527,27,Home,L 106-117 ,240,36,74,0.486,25,46,0.543,11,28,0.393,23,29,0.793,106,45,89,0.506,35,60,0.583,10,29,0.345,17,20,0.85,117,2017-01-08,SAC,GSW,2017,122.0
4528,4528,28,@,L 106-114 ,240,40,85,0.471,31,58,0.534,9,27,0.333,17,20,0.85,106,41,87,0.471,31,65,0.477,10,22,0.455,22,27,0.815,114,2017-01-10,BOS,TOR,2017,119.0
4529,4529,29,@,W 106-101 ,240,41,89,0.461,33,66,0.5,8,23,0.348,16,24,0.667,106,40,81,0.494,35,59,0.593,5,22,0.227,16,17,0.941,101,2017-01-16,UTA,PHO,2017,103.5
4530,4530,30,Home,L 106-117 ,240,35,91,0.385,26,58,0.448,9,33,0.273,27,29,0.931,106,46,91,0.505,36,66,0.545,10,25,0.4,15,18,0.833,117,2017-01-18,BOS,NYK,2017,122.0
4531,4531,31,@,W 106-100 ,240,39,75,0.52,32,54,0.593,7,21,0.333,21,25,0.84,106,35,72,0.486,26,51,0.51,9,21,0.429,21,27,0.778,100,2017-01-18,IND,SAC,2017,104.5
4532,4532,32,Home,L 106-108 ,240,38,84,0.452,32,59,0.542,6,25,0.24,24,28,0.857,106,38,85,0.447,31,61,0.508,7,24,0.292,25,33,0.758,108,2017-01-24,TOR,SAS,2017,111.5
4533,4533,33,Home,L 106-109 ,240,35,80,0.438,22,45,0.489,13,35,0.371,23,26,0.885,106,40,83,0.482,29,60,0.483,11,23,0.478,18,25,0.72,109,2017-01-25,BRK,MIA,2017,114.5
4534,4534,34,Home,L 106-109 ,240,36,75,0.48,24,38,0.632,12,37,0.324,22,24,0.917,106,41,79,0.519,30,52,0.577,11,27,0.407,16,26,0.615,109,2017-01-28,CHA,SAC,2017,114.5
4535,4535,35,@,L 106-108 (OT),265,40,94,0.426,28,64,0.438,12,30,0.4,14,19,0.737,106,43,94,0.457,33,63,0.524,10,31,0.323,12,15,0.8,108,2017-01-31,NOP,TOR,2017,113.0
4536,4536,36,@,W 106-97 ,240,37,86,0.43,29,66,0.439,8,20,0.4,24,31,0.774,106,32,86,0.372,21,58,0.362,11,28,0.393,22,23,0.957,97,2017-02-03,IND,BRK,2017,102.5
4537,4537,37,@,L 106-109 (OT),265,36,87,0.414,21,43,0.488,15,44,0.341,19,24,0.792,106,43,88,0.489,36,65,0.554,7,23,0.304,16,19,0.842,109,2017-02-04,GSW,SAC,2017,112.5
4538,4538,38,@,L 106-111 ,240,40,93,0.43,35,66,0.53,5,27,0.185,21,25,0.84,106,42,92,0.457,33,66,0.5,9,26,0.346,18,22,0.818,111,2017-02-06,PHO,NOP,2017,115.5
4539,4539,39,@,L 106-117 ,240,40,100,0.4,27,56,0.482,13,44,0.295,13,21,0.619,106,47,93,0.505,39,66,0.591,8,27,0.296,15,18,0.833,117,2017-02-08,DEN,ATL,2017,121.0
4540,4540,40,@,W 106-88 ,240,41,86,0.477,30,53,0.566,11,33,0.333,13,18,0.722,106,33,71,0.465,27,56,0.482,6,15,0.4,16,28,0.571,88,2017-02-08,MIA,MIL,2017,91.0
4541,4541,41,Home,L 106-122 ,240,38,82,0.463,32,55,0.582,6,27,0.222,24,32,0.75,106,45,75,0.6,33,50,0.66,12,25,0.48,20,27,0.741,122,2017-02-10,MIN,NOP,2017,128.0
4542,4542,42,Home,L 106-110 ,240,38,78,0.487,29,58,0.5,9,20,0.45,21,30,0.7,106,40,87,0.46,33,72,0.458,7,15,0.467,23,27,0.852,110,2017-02-13,IND,SAS,2017,113.5
4543,4543,43,@,L 106-112 ,240,35,79,0.443,26,58,0.448,9,21,0.429,27,35,0.771,106,42,78,0.538,35,58,0.603,7,20,0.35,21,27,0.778,112,2017-02-26,POR,TOR,2017,115.5
4544,4544,44,@,L 106-109 ,240,43,93,0.462,34,71,0.479,9,22,0.409,11,13,0.846,106,39,76,0.513,24,54,0.444,15,22,0.682,16,23,0.696,109,2017-02-28,UTA,OKC,2017,116.5
4545,4545,45,Home,L 106-114 ,240,34,92,0.37,24,62,0.387,10,30,0.333,28,32,0.875,106,41,81,0.506,30,56,0.536,11,25,0.44,21,27,0.778,114,2017-03-03,WAS,TOR,2017,119.5
4546,4546,46,Home,L 106-136 ,240,43,88,0.489,29,54,0.537,14,34,0.412,6,7,0.857,106,54,95,0.568,44,72,0.611,10,23,0.435,18,21,0.857,136,2017-03-04,PHI,DET,2017,141.0
4547,4547,47,@,L 106-109 ,240,32,85,0.376,19,48,0.396,13,37,0.351,29,40,0.725,106,42,94,0.447,38,74,0.514,4,20,0.2,21,26,0.808,109,2017-03-05,BOS,PHO,2017,111.0
4548,4548,48,@,W 106-98 ,240,39,91,0.429,23,56,0.411,16,35,0.457,12,14,0.857,106,35,78,0.449,26,51,0.51,9,27,0.333,19,29,0.655,98,2017-03-06,MIA,CLE,2017,102.5
4549,4549,49,Home,W 106-101 ,240,41,87,0.471,32,61,0.525,9,26,0.346,15,19,0.789,106,39,84,0.464,28,45,0.622,11,39,0.282,12,19,0.632,101,2017-03-09,DET,CLE,2017,106.5
4550,4550,50,@,W 105-94 ,240,38,78,0.487,34,71,0.479,4,7,0.571,25,36,0.694,105,31,82,0.378,22,54,0.407,9,28,0.321,23,30,0.767,94,2011-12-25,MIA,DAL,2012,98.5
4551,4551,51,@,W 105-86 ,240,37,81,0.457,29,58,0.5,8,23,0.348,23,38,0.605,105,32,82,0.39,27,61,0.443,5,21,0.238,17,24,0.708,86,2011-12-25,LAC,GSW,2012,88.5
4552,4552,52,@,W 105-89 ,240,40,70,0.571,33,58,0.569,7,12,0.583,18,22,0.818,105,36,81,0.444,27,60,0.45,9,21,0.429,8,11,0.727,89,2011-12-28,CLE,DET,2012,93.5
4553,4553,53,Home,W 105-85 ,240,43,85,0.506,34,59,0.576,9,26,0.346,10,13,0.769,105,35,93,0.376,33,76,0.434,2,17,0.118,13,20,0.65,85,2011-12-29,HOU,SAS,2012,86.0
4554,4554,54,Home,W 105-98 ,240,37,77,0.481,33,62,0.532,4,15,0.267,27,38,0.711,105,38,82,0.463,29,62,0.468,9,20,0.45,13,14,0.929,98,2011-12-30,ATL,NJN,2012,102.5
4555,4555,55,Home,W 105-97 ,240,37,72,0.514,32,58,0.552,5,14,0.357,26,32,0.813,105,37,83,0.446,31,60,0.517,6,23,0.261,17,24,0.708,97,2012-01-10,POR,LAC,2012,100.0
4556,4556,56,@,L 105-113 ,240,35,78,0.449,31,58,0.534,4,20,0.2,31,43,0.721,105,45,76,0.592,42,66,0.636,3,10,0.3,20,29,0.69,113,2012-01-10,CLE,UTA,2012,114.5
4557,4557,57,@,L 105-107 (OT),265,37,90,0.411,28,64,0.438,9,26,0.346,22,31,0.71,105,39,93,0.419,34,75,0.453,5,18,0.278,24,28,0.857,107,2012-01-14,POR,HOU,2012,109.5
4558,4558,58,@,W 105-95 ,240,41,94,0.436,32,75,0.427,9,19,0.474,14,19,0.737,105,35,82,0.427,30,67,0.448,5,15,0.333,20,28,0.714,95,2012-01-17,GSW,CLE,2012,97.5
4559,4559,59,@,W 105-95 ,240,32,75,0.427,20,50,0.4,12,25,0.48,29,37,0.784,105,38,91,0.418,31,68,0.456,7,23,0.304,12,14,0.857,95,2012-01-17,DEN,MIL,2012,98.5
4560,4560,60,Home,W 105-102 ,240,33,86,0.384,25,65,0.385,8,21,0.381,31,43,0.721,105,37,77,0.481,33,58,0.569,4,19,0.211,24,30,0.8,102,2012-01-18,WAS,OKC,2012,104.0
4561,4561,61,Home,W 105-102 ,240,44,79,0.557,38,57,0.667,6,22,0.273,11,12,0.917,105,42,94,0.447,35,72,0.486,7,22,0.318,11,15,0.733,102,2012-01-21,HOU,SAS,2012,105.5
4562,4562,62,@,W 105-90 ,240,34,77,0.442,25,56,0.446,9,21,0.429,28,33,0.848,105,39,95,0.411,33,73,0.452,6,22,0.273,6,10,0.6,90,2012-01-25,MIN,DAL,2012,93.0
4563,4563,63,@,W 105-99 ,240,39,91,0.429,25,62,0.403,14,29,0.483,13,17,0.765,105,38,93,0.409,30,62,0.484,8,31,0.258,15,20,0.75,99,2012-01-25,MIL,HOU,2012,103.0
4564,4564,64,Home,W 105-83 ,240,42,82,0.512,31,59,0.525,11,23,0.478,10,15,0.667,105,35,80,0.438,29,63,0.46,6,17,0.353,7,10,0.7,83,2012-01-25,SAS,ATL,2012,86.0
4565,4565,65,Home,L 105-109 ,240,42,85,0.494,36,67,0.537,6,18,0.333,15,20,0.75,105,39,86,0.453,25,56,0.446,14,30,0.467,17,26,0.654,109,2012-01-29,DEN,LAC,2012,116.0
4566,4566,66,Home,W 105-97 ,240,39,88,0.443,29,65,0.446,10,23,0.435,17,25,0.68,105,34,73,0.466,25,53,0.472,9,20,0.45,20,24,0.833,97,2012-02-01,MIL,MIA,2012,101.5
4567,4567,67,Home,L 105-107 ,240,38,81,0.469,35,70,0.5,3,11,0.273,26,36,0.722,105,42,87,0.483,37,65,0.569,5,22,0.227,18,23,0.783,107,2012-02-01,UTA,LAC,2012,109.5
4568,4568,68,@,W 105-102 ,240,39,74,0.527,33,62,0.532,6,12,0.5,21,29,0.724,105,44,90,0.489,40,74,0.541,4,16,0.25,10,14,0.714,102,2012-02-02,CHI,NYK,2012,104.0
4569,4569,69,Home,L 105-108 ,240,38,86,0.442,28,65,0.431,10,21,0.476,19,24,0.792,105,36,82,0.439,29,66,0.439,7,16,0.438,29,32,0.906,108,2012-02-03,BRK,MIN,2012,111.5
4570,4570,70,Home,L 105-107 ,240,39,81,0.481,30,61,0.492,9,20,0.45,18,20,0.9,105,45,94,0.479,36,69,0.522,9,25,0.36,8,8,1.0,107,2012-02-07,MIL,PHO,2012,111.5
4571,4571,71,@,W 105-95 ,240,44,90,0.489,35,62,0.565,9,28,0.321,8,9,0.889,105,33,72,0.458,24,46,0.522,9,26,0.346,20,27,0.741,95,2012-02-08,DAL,DEN,2012,99.5
4572,4572,72,@,W 105-99 ,240,33,72,0.458,21,47,0.447,12,25,0.48,27,37,0.73,105,37,90,0.411,28,66,0.424,9,24,0.375,16,17,0.941,99,2012-02-08,MIL,TOR,2012,103.5
4573,4573,73,@,W 105-90 ,240,35,70,0.5,30,57,0.526,5,13,0.385,30,35,0.857,105,33,76,0.434,31,61,0.508,2,15,0.133,22,29,0.759,90,2012-02-14,MIA,IND,2012,91.0
4574,4574,74,@,W 105-100 ,240,41,88,0.466,35,73,0.479,6,15,0.4,17,20,0.85,105,37,72,0.514,26,45,0.578,11,27,0.407,15,15,1.0,100,2012-02-15,MEM,NJN,2012,105.5
4575,4575,75,@,W 105-102 ,240,38,74,0.514,30,56,0.536,8,18,0.444,21,27,0.778,105,40,84,0.476,31,59,0.525,9,25,0.36,13,19,0.684,102,2012-03-01,OKC,ORL,2012,106.5
4576,4576,76,Home,L 105-117 ,240,36,76,0.474,26,47,0.553,10,29,0.345,23,29,0.793,105,43,97,0.443,35,75,0.467,8,22,0.364,23,35,0.657,117,2012-03-02,HOU,DEN,2012,121.0
4577,4577,77,Home,W 105-83 ,240,42,89,0.472,34,72,0.472,8,17,0.471,13,16,0.813,105,33,82,0.402,28,64,0.438,5,18,0.278,12,14,0.857,83,2012-03-02,PHI,GSW,2012,85.5
4578,4578,78,@,W 105-103 (OT),265,40,86,0.465,34,72,0.472,6,14,0.429,19,25,0.76,105,37,86,0.43,27,66,0.409,10,20,0.5,19,24,0.792,103,2012-03-04,LAC,HOU,2012,108.0
4579,4579,79,@,L 105-118 ,240,41,96,0.427,31,68,0.456,10,28,0.357,13,17,0.765,105,46,85,0.541,39,66,0.591,7,19,0.368,19,25,0.76,118,2012-03-07,NYK,SAS,2012,121.5
4580,4580,80,@,W 105-102 ,240,39,82,0.476,33,64,0.516,6,18,0.333,21,27,0.778,105,37,81,0.457,29,61,0.475,8,20,0.4,20,26,0.769,102,2012-03-09,LAL,MIN,2012,106.0
4581,4581,81,Home,W 105-86 ,240,39,74,0.527,32,53,0.604,7,21,0.333,20,25,0.8,105,29,73,0.397,24,52,0.462,5,21,0.238,23,25,0.92,86,2012-03-10,DET,TOR,2012,88.5
4582,4582,82,@,W 105-99 ,240,35,73,0.479,29,55,0.527,6,18,0.333,29,35,0.829,105,40,86,0.465,36,73,0.493,4,13,0.308,15,19,0.789,99,2012-03-11,MIL,TOR,2012,101.0
4583,4583,83,@,W 105-99 ,240,43,92,0.467,33,67,0.493,10,25,0.4,9,11,0.818,105,37,76,0.487,33,59,0.559,4,17,0.235,21,29,0.724,99,2012-03-12,MIL,NJN,2012,101.0
4584,4584,84,Home,W 105-90 ,240,39,72,0.542,32,61,0.525,7,11,0.636,20,26,0.769,105,34,71,0.479,31,59,0.525,3,12,0.25,19,28,0.679,90,2012-03-12,UTA,DET,2012,91.5
4585,4585,85,@,W 105-103 ,240,40,78,0.513,34,65,0.523,6,13,0.462,19,21,0.905,105,41,78,0.526,36,57,0.632,5,21,0.238,16,19,0.842,103,2012-03-14,BOS,GSW,2012,105.5
4586,4586,86,@,L 105-115 ,240,38,85,0.447,27,61,0.443,11,24,0.458,18,25,0.72,105,46,86,0.535,39,63,0.619,7,23,0.304,16,21,0.762,115,2012-03-14,CLE,MIL,2012,118.5
4587,4587,87,@,L 105-111 (OT),265,36,83,0.434,27,56,0.482,9,27,0.333,24,33,0.727,105,43,103,0.417,38,90,0.422,5,13,0.385,20,27,0.741,111,2012-03-15,MIN,UTA,2012,113.5
4588,4588,88,Home,L 105-114 ,240,39,88,0.443,30,63,0.476,9,25,0.36,18,20,0.9,105,45,87,0.517,36,68,0.529,9,19,0.474,15,25,0.6,114,2012-03-16,OKC,SAS,2012,118.5
4589,4589,89,@,W 105-80 ,240,46,86,0.535,41,75,0.547,5,11,0.455,8,9,0.889,105,29,75,0.387,27,67,0.403,2,8,0.25,20,28,0.714,80,2012-03-19,PHI,CHA,2012,81.0
4590,4590,90,@,W 105-100 ,240,41,89,0.461,36,74,0.486,5,15,0.333,18,27,0.667,105,34,81,0.42,28,58,0.483,6,23,0.261,26,31,0.839,100,2012-03-19,CLE,NJN,2012,103.0
4591,4591,91,Home,W 105-90 ,240,37,81,0.457,27,63,0.429,10,18,0.556,21,28,0.75,105,29,69,0.42,21,49,0.429,8,20,0.4,24,37,0.649,90,2012-03-26,IND,MIA,2012,94.0
4592,4592,92,@,W 105-84 ,240,42,81,0.519,37,67,0.552,5,14,0.357,16,18,0.889,105,29,81,0.358,24,60,0.4,5,21,0.238,21,35,0.6,84,2012-03-26,UTA,NJN,2012,86.5
4593,4593,93,Home,W 105-96 ,240,35,86,0.407,23,64,0.359,12,22,0.545,23,33,0.697,105,33,80,0.413,28,60,0.467,5,20,0.25,25,30,0.833,96,2012-03-28,TOR,DEN,2012,98.5
4594,4594,94,Home,W 105-96 ,240,39,72,0.542,29,51,0.569,10,21,0.476,17,24,0.708,105,35,77,0.455,31,65,0.477,4,12,0.333,22,31,0.71,96,2012-03-31,LAC,UTA,2012,98.0
4595,4595,95,Home,L 105-107 ,240,40,79,0.506,37,70,0.529,3,9,0.333,22,28,0.786,105,41,91,0.451,28,60,0.467,13,31,0.419,12,22,0.545,107,2012-04-04,UTA,PHO,2012,113.5
4596,4596,96,Home,W 105-99 ,240,37,92,0.402,26,65,0.4,11,27,0.407,20,31,0.645,105,34,82,0.415,26,60,0.433,8,22,0.364,23,29,0.793,99,2012-04-06,DEN,PHO,2012,103.0
4597,4597,97,@,L 105-125 ,240,47,97,0.485,46,88,0.523,1,9,0.111,10,18,0.556,105,47,94,0.5,33,65,0.508,14,29,0.483,17,21,0.81,125,2012-04-07,LAL,PHO,2012,132.0
4598,4598,98,Home,W 105-96 ,240,38,68,0.559,34,59,0.576,4,9,0.444,25,36,0.694,105,36,83,0.434,29,61,0.475,7,22,0.318,17,23,0.739,96,2012-04-11,NOP,SAC,2012,99.5
4599,4599,99,Home,L 105-112 ,240,36,84,0.429,32,65,0.492,4,19,0.211,29,33,0.879,105,38,77,0.494,30,59,0.508,8,18,0.444,28,33,0.848,112,2012-04-13,HOU,PHO,2012,116.0
4600,4600,0,Home,W 105-82 ,240,44,85,0.518,42,71,0.592,2,14,0.143,15,17,0.882,105,33,74,0.446,28,57,0.491,5,17,0.294,11,19,0.579,82,2012-04-13,MIA,CHA,2012,84.5
4601,4601,1,@,W 105-99 ,240,37,92,0.402,30,73,0.411,7,19,0.368,24,26,0.923,105,37,84,0.44,28,61,0.459,9,23,0.391,16,26,0.615,99,2012-04-14,IND,MIL,2012,103.5
4602,4602,2,Home,W 105-91 ,240,40,76,0.526,31,58,0.534,9,18,0.5,16,19,0.842,105,38,96,0.396,36,80,0.45,2,16,0.125,13,18,0.722,91,2012-04-14,SAS,PHO,2012,92.0
4603,4603,3,@,W 105-102 ,240,38,80,0.475,29,62,0.468,9,18,0.5,20,29,0.69,105,40,94,0.426,32,65,0.492,8,29,0.276,14,17,0.824,102,2012-04-16,DEN,HOU,2012,106.0
4604,4604,4,Home,W 105-99 (OT),265,41,87,0.471,37,67,0.552,4,20,0.2,19,24,0.792,105,37,89,0.416,26,58,0.448,11,31,0.355,14,25,0.56,99,2012-04-19,NOP,HOU,2012,104.5
4605,4605,5,@,W 105-87 ,240,43,80,0.538,38,66,0.576,5,14,0.357,14,17,0.824,105,31,72,0.431,27,58,0.466,4,14,0.286,21,23,0.913,87,2012-04-23,PHI,NJN,2012,89.0
4606,4606,6,@,W 105-96 ,240,39,79,0.494,29,52,0.558,10,27,0.37,17,23,0.739,105,35,79,0.443,29,63,0.46,6,16,0.375,20,26,0.769,96,2012-10-31,HOU,DET,2013,99.0
4607,4607,7,@,W 105-95 ,240,38,84,0.452,30,62,0.484,8,22,0.364,21,27,0.778,105,34,68,0.5,27,52,0.519,7,16,0.438,20,28,0.714,95,2012-11-02,LAC,LAL,2013,98.5
4608,4608,8,Home,W 105-102 ,240,41,79,0.519,32,55,0.582,9,24,0.375,14,21,0.667,105,39,83,0.47,33,67,0.493,6,16,0.375,18,29,0.621,102,2012-11-03,MIL,CLE,2013,105.0
4609,4609,9,Home,W 105-86 ,240,40,90,0.444,30,69,0.435,10,21,0.476,15,17,0.882,105,29,64,0.453,23,48,0.479,6,16,0.375,22,31,0.71,86,2012-11-04,TOR,MIN,2013,89.0
4610,4610,10,Home,W 105-103 ,240,40,82,0.488,33,66,0.5,7,16,0.438,18,24,0.75,105,36,73,0.493,28,51,0.549,8,22,0.364,23,31,0.742,103,2012-11-07,SAC,DET,2013,107.0
4611,4611,11,Home,W 105-94 ,240,38,71,0.535,30,51,0.588,8,20,0.4,21,26,0.808,105,36,87,0.414,30,68,0.441,6,19,0.316,16,22,0.727,94,2012-11-09,OKC,DET,2013,97.0
4612,4612,12,@,L 105-107 ,240,37,77,0.481,28,56,0.5,9,21,0.429,22,27,0.815,105,38,81,0.469,32,64,0.5,6,17,0.353,25,33,0.758,107,2012-11-09,CLE,PHO,2013,110.0
4613,4613,13,@,W 105-96 ,240,41,80,0.513,34,60,0.567,7,20,0.35,16,18,0.889,105,37,85,0.435,27,61,0.443,10,24,0.417,12,16,0.75,96,2012-11-12,MIL,PHI,2013,101.0
4614,4614,14,Home,W 105-95 ,240,37,76,0.487,32,61,0.525,5,15,0.333,26,32,0.813,105,37,72,0.514,32,53,0.604,5,19,0.263,16,21,0.762,95,2012-11-16,MEM,NYK,2013,97.5
4615,4615,15,@,W 105-101 (OT),265,37,91,0.407,28,67,0.418,9,24,0.375,22,30,0.733,105,37,86,0.43,27,65,0.415,10,21,0.476,17,24,0.708,101,2012-11-19,GSW,DAL,2013,106.0
4616,4616,16,@,W 105-98 ,240,36,71,0.507,21,46,0.457,15,25,0.6,18,23,0.783,105,37,79,0.468,19,42,0.452,18,37,0.486,6,11,0.545,98,2012-11-26,NOP,LAC,2013,107.0
4617,4617,17,Home,W 105-103 ,240,36,78,0.462,28,56,0.5,8,22,0.364,25,34,0.735,105,40,73,0.548,35,59,0.593,5,14,0.357,18,32,0.563,103,2012-11-26,UTA,DEN,2013,105.5
4618,4618,18,@,L 105-106 ,240,38,84,0.452,28,63,0.444,10,21,0.476,19,24,0.792,105,44,86,0.512,36,68,0.529,8,18,0.444,10,13,0.769,106,2012-11-29,DEN,GSW,2013,110.0
4619,4619,19,Home,W 105-100 ,240,42,86,0.488,37,73,0.507,5,13,0.385,16,19,0.842,105,36,80,0.45,26,50,0.52,10,30,0.333,18,24,0.75,100,2012-11-29,MIA,SAS,2013,105.0
4620,4620,20,@,W 105-104 ,240,42,89,0.472,38,68,0.559,4,21,0.19,17,24,0.708,105,42,74,0.568,33,54,0.611,9,20,0.45,11,15,0.733,104,2012-12-03,LAC,UTA,2013,108.5
4621,4621,21,@,L 105-107 ,240,38,83,0.458,31,62,0.5,7,21,0.333,22,34,0.647,105,38,101,0.376,31,67,0.463,7,34,0.206,24,31,0.774,107,2012-12-04,LAL,HOU,2013,110.5
4622,4622,22,@,W 105-88 ,240,41,77,0.532,28,52,0.538,13,25,0.52,10,17,0.588,105,35,83,0.422,30,63,0.476,5,20,0.25,13,23,0.565,88,2012-12-04,MIN,PHI,2013,90.5
4623,4623,23,Home,W 105-101 ,240,38,79,0.481,31,60,0.517,7,19,0.368,22,29,0.759,105,41,89,0.461,33,61,0.541,8,28,0.286,11,16,0.688,101,2012-12-04,WAS,MIA,2013,105.0
4624,4624,24,@,L 105-108 ,240,42,83,0.506,35,67,0.522,7,16,0.438,14,24,0.583,105,38,87,0.437,36,73,0.493,2,14,0.143,30,37,0.811,108,2012-12-12,DEN,MIN,2013,109.0
4625,4625,25,@,L 105-107 (2OT),290,40,99,0.404,35,83,0.422,5,16,0.313,20,26,0.769,105,42,93,0.452,32,67,0.478,10,26,0.385,13,16,0.813,107,2012-12-14,DET,BRK,2013,112.0
4626,4626,26,Home,W 105-89 ,240,38,73,0.521,27,49,0.551,11,24,0.458,18,22,0.818,105,30,73,0.411,23,57,0.404,7,16,0.438,22,26,0.846,89,2012-12-22,MIA,UTA,2013,92.5
4627,4627,27,@,W 105-92 ,240,37,81,0.457,25,58,0.431,12,23,0.522,19,25,0.76,105,34,78,0.436,29,64,0.453,5,14,0.357,19,28,0.679,92,2012-12-26,MIA,CHA,2013,94.5
4628,4628,28,@,L 105-111 (OT),265,40,95,0.421,29,71,0.408,11,24,0.458,14,16,0.875,105,39,93,0.419,29,68,0.426,10,25,0.4,23,28,0.821,111,2012-12-27,DAL,OKC,2013,116.0
4629,4629,29,@,L 105-106 ,240,41,83,0.494,30,53,0.566,11,30,0.367,12,20,0.6,105,39,86,0.453,24,56,0.429,15,30,0.5,13,17,0.765,106,2012-12-28,NYK,SAC,2013,113.5
4630,4630,30,Home,W 105-97 ,240,42,88,0.477,36,68,0.529,6,20,0.3,15,17,0.882,105,39,86,0.453,29,58,0.5,10,28,0.357,9,11,0.818,97,2012-12-28,WAS,ORL,2013,102.0
4631,4631,31,@,W 105-100 ,240,41,81,0.506,30,48,0.625,11,33,0.333,12,18,0.667,105,36,84,0.429,26,47,0.553,10,37,0.27,18,24,0.75,100,2013-01-01,POR,NYK,2013,105.0
4632,4632,32,@,W 105-96 ,240,40,76,0.526,36,64,0.563,4,12,0.333,21,30,0.7,105,30,79,0.38,19,46,0.413,11,33,0.333,25,37,0.676,96,2013-01-04,SAC,TOR,2013,101.5
4633,4633,33,Home,L 105-112 ,240,38,82,0.463,28,52,0.538,10,30,0.333,19,27,0.704,105,44,101,0.436,35,77,0.455,9,24,0.375,15,23,0.652,112,2013-01-06,LAL,DEN,2013,116.5
4634,4634,34,@,L 105-108 ,240,44,93,0.473,36,69,0.522,8,24,0.333,9,10,0.9,105,41,94,0.436,37,82,0.451,4,12,0.333,22,36,0.611,108,2013-01-09,ORL,DEN,2013,110.0
4635,4635,35,@,L 105-108 ,240,44,95,0.463,36,68,0.529,8,27,0.296,9,15,0.6,105,41,84,0.488,29,59,0.492,12,25,0.48,14,16,0.875,108,2013-01-09,LAL,SAS,2013,114.0
4636,4636,36,@,L 105-116 ,240,43,83,0.518,30,59,0.508,13,24,0.542,6,8,0.75,105,43,90,0.478,34,63,0.54,9,27,0.333,21,27,0.778,116,2013-01-13,GSW,DEN,2013,120.5
4637,4637,37,Home,W 105-100 ,240,33,86,0.384,28,64,0.438,5,22,0.227,34,43,0.791,105,33,84,0.393,22,57,0.386,11,27,0.407,23,30,0.767,100,2013-01-16,DAL,HOU,2013,105.5
4638,4638,38,Home,L 105-107 (OT),265,38,85,0.447,32,69,0.464,6,16,0.375,23,32,0.719,105,39,86,0.453,36,75,0.48,3,11,0.273,26,36,0.722,107,2013-01-16,TOR,CHI,2013,108.5
4639,4639,39,Home,W 105-95 ,240,40,87,0.46,29,68,0.426,11,19,0.579,14,17,0.824,105,34,83,0.41,21,53,0.396,13,30,0.433,14,16,0.875,95,2013-01-18,IND,HOU,2013,101.5
4640,4640,40,Home,L 105-111 ,240,40,79,0.506,31,58,0.534,9,21,0.429,16,20,0.8,105,45,90,0.5,37,75,0.493,8,15,0.533,13,15,0.867,111,2013-01-20,ORL,DAL,2013,115.0
4641,4641,41,@,L 105-114 ,240,38,81,0.469,35,66,0.53,3,15,0.2,26,32,0.813,105,43,89,0.483,31,64,0.484,12,25,0.48,16,21,0.762,114,2013-01-21,SAC,NOH,2013,120.0
4642,4642,42,Home,W 105-90 ,240,42,91,0.462,35,68,0.515,7,23,0.304,14,21,0.667,105,38,84,0.452,30,64,0.469,8,20,0.4,6,8,0.75,90,2013-01-22,DET,ORL,2013,94.0
4643,4643,43,@,W 105-95 ,240,40,86,0.465,32,65,0.492,8,21,0.381,17,25,0.68,105,37,83,0.446,26,49,0.531,11,34,0.324,10,13,0.769,95,2013-01-23,DEN,HOU,2013,100.5
4644,4644,44,@,W 105-95 ,240,37,76,0.487,31,53,0.585,6,23,0.261,25,30,0.833,105,36,86,0.419,28,71,0.394,8,15,0.533,15,21,0.714,95,2013-01-25,OKC,SAC,2013,99.0
4645,4645,45,Home,W 105-96 ,240,41,74,0.554,34,57,0.596,7,17,0.412,16,29,0.552,105,36,81,0.444,32,65,0.492,4,16,0.25,20,26,0.769,96,2013-01-27,LAL,OKC,2013,98.0
4646,4646,46,@,W 105-85 ,240,43,83,0.518,32,64,0.5,11,19,0.579,8,14,0.571,105,31,69,0.449,26,52,0.5,5,17,0.294,18,24,0.75,85,2013-01-30,MIA,BRK,2013,87.5
4647,4647,47,Home,W 105-99 ,240,38,75,0.507,28,57,0.491,10,18,0.556,19,28,0.679,105,39,90,0.433,31,71,0.437,8,19,0.421,13,16,0.813,99,2013-02-02,POR,UTA,2013,103.0
4648,4648,48,Home,W 105-99 ,240,41,86,0.477,31,66,0.47,10,20,0.5,13,19,0.684,105,36,84,0.429,26,54,0.481,10,30,0.333,17,19,0.895,99,2013-02-06,DAL,POR,2013,104.0
4649,4649,49,@,W 105-100 ,240,41,83,0.494,33,66,0.5,8,17,0.471,15,19,0.789,105,34,86,0.395,27,69,0.391,7,17,0.412,25,28,0.893,100,2013-02-09,DET,MIL,2013,103.5
4650,4650,50,Home,W 105-88 ,240,41,79,0.519,35,66,0.53,6,13,0.462,17,22,0.773,105,34,69,0.493,30,53,0.566,4,16,0.25,16,25,0.64,88,2013-02-10,MEM,MIN,2013,90.0
4651,4651,51,@,W 105-101 ,240,40,77,0.519,31,51,0.608,9,26,0.346,16,23,0.696,105,38,89,0.427,29,68,0.426,9,21,0.429,16,20,0.8,101,2013-02-11,ATL,DAL,2013,105.5
4652,4652,52,@,W 105-86 ,240,41,83,0.494,31,62,0.5,10,21,0.476,13,14,0.929,105,29,81,0.358,24,62,0.387,5,19,0.263,23,33,0.697,86,2013-02-11,NOP,DET,2013,88.5
4653,4653,53,@,W 105-91 ,240,45,80,0.563,42,71,0.592,3,9,0.333,12,20,0.6,105,38,82,0.463,29,62,0.468,9,20,0.45,6,10,0.6,91,2013-02-19,MEM,DET,2013,95.5
4654,4654,54,@,W 105-92 ,240,38,81,0.469,29,57,0.509,9,24,0.375,20,27,0.741,105,37,89,0.416,33,64,0.516,4,25,0.16,14,17,0.824,92,2013-02-19,CHA,ORL,2013,94.0
4655,4655,55,@,W 105-99 ,240,40,81,0.494,32,64,0.5,8,17,0.471,17,23,0.739,105,36,89,0.404,25,64,0.391,11,25,0.44,16,21,0.762,99,2013-02-20,DET,CHA,2013,104.5
4656,4656,56,Home,W 105-100 ,240,38,77,0.494,33,63,0.524,5,14,0.357,24,34,0.706,105,37,76,0.487,30,61,0.492,7,15,0.467,19,22,0.864,100,2013-02-20,CLE,NOH,2013,103.5
4657,4657,57,@,W 105-75 ,240,42,83,0.506,37,69,0.536,5,14,0.357,16,20,0.8,105,25,75,0.333,21,59,0.356,4,16,0.25,21,35,0.6,75,2013-02-22,CHI,CHA,2013,77.0
4658,4658,58,Home,W 105-103 ,240,41,80,0.513,34,64,0.531,7,16,0.438,16,19,0.842,105,38,84,0.452,19,38,0.5,19,46,0.413,8,14,0.571,103,2013-02-23,WAS,HOU,2013,112.5
4659,4659,59,@,L 105-109 ,240,39,78,0.5,31,58,0.534,8,20,0.4,19,24,0.792,105,39,75,0.52,27,56,0.482,12,19,0.632,19,24,0.792,109,2013-02-24,CLE,MIA,2013,115.0
4660,4660,60,@,L 105-109 ,240,36,72,0.5,21,45,0.467,15,27,0.556,18,21,0.857,105,36,87,0.414,25,53,0.472,11,34,0.324,26,33,0.788,109,2013-02-27,GSW,NYK,2013,114.5
4661,4661,61,@,W 105-101 (OT),265,44,95,0.463,41,83,0.494,3,12,0.25,14,21,0.667,105,35,81,0.432,29,64,0.453,6,17,0.353,25,35,0.714,101,2013-02-27,PHO,SAS,2013,104.0
4662,4662,62,@,W 105-89 ,240,43,83,0.518,36,58,0.621,7,25,0.28,12,20,0.6,105,33,74,0.446,28,58,0.483,5,16,0.313,18,28,0.643,89,2013-03-01,LAC,CLE,2013,91.5
4663,4663,63,Home,W 105-103 ,240,43,95,0.453,36,74,0.486,7,21,0.333,12,17,0.706,105,36,83,0.434,29,63,0.46,7,20,0.35,24,34,0.706,103,2013-03-01,DEN,OKC,2013,106.5
4664,4664,64,@,W 105-102 ,240,43,87,0.494,36,66,0.545,7,21,0.333,12,16,0.75,105,37,80,0.463,29,59,0.492,8,21,0.381,20,26,0.769,102,2013-03-04,ORL,NOH,2013,106.0
4665,4665,65,@,L 105-122 ,240,45,97,0.464,44,87,0.506,1,10,0.1,14,18,0.778,105,49,82,0.598,37,58,0.638,12,24,0.5,12,17,0.706,122,2013-03-04,CHA,POR,2013,128.0
4666,4666,66,@,L 105-122 ,240,31,77,0.403,19,48,0.396,12,29,0.414,31,40,0.775,105,46,96,0.479,38,73,0.521,8,23,0.348,22,24,0.917,122,2013-03-05,LAL,OKC,2013,126.0
4667,4667,67,@,L 105-107 ,240,37,86,0.43,18,45,0.4,19,41,0.463,12,18,0.667,105,37,82,0.451,29,64,0.453,8,18,0.444,25,39,0.641,107,2013-03-09,HOU,PHO,2013,111.0
4668,4668,68,Home,W 105-91 ,240,38,68,0.559,31,54,0.574,7,14,0.5,22,31,0.71,105,26,63,0.413,16,36,0.444,10,27,0.37,29,34,0.853,91,2013-03-10,MIA,IND,2013,96.0
4669,4669,69,Home,W 105-93 ,240,43,82,0.524,35,61,0.574,8,21,0.381,11,14,0.786,105,33,77,0.429,27,60,0.45,6,17,0.353,21,24,0.875,93,2013-03-11,SAS,OKC,2013,96.0
4670,4670,70,Home,W 105-97 ,240,41,72,0.569,33,54,0.611,8,18,0.444,15,25,0.6,105,40,89,0.449,35,72,0.486,5,17,0.294,12,14,0.857,97,2013-03-13,GSW,DET,2013,99.5
4671,4671,71,Home,W 105-90 ,240,40,78,0.513,30,50,0.6,10,28,0.357,15,21,0.714,105,36,82,0.439,29,57,0.509,7,25,0.28,11,17,0.647,90,2013-03-14,POR,NYK,2013,93.5
4672,4672,72,Home,W 105-88 ,240,41,79,0.519,31,64,0.484,10,15,0.667,13,20,0.65,105,34,76,0.447,27,56,0.482,7,20,0.35,13,21,0.619,88,2013-03-16,BOS,CHA,2013,91.5
4673,4673,73,@,L 105-127 ,240,42,88,0.477,36,67,0.537,6,21,0.286,15,20,0.75,105,48,93,0.516,34,72,0.472,14,21,0.667,17,20,0.85,127,2013-03-16,PHO,WAS,2013,134.0
4674,4674,74,@,W 105-93 ,240,44,84,0.524,36,63,0.571,8,21,0.381,9,13,0.692,105,36,86,0.419,28,63,0.444,8,23,0.348,13,16,0.813,93,2013-03-17,ATL,BRK,2013,97.0
4675,4675,75,@,W 105-103 ,240,42,85,0.494,35,65,0.538,7,20,0.35,14,21,0.667,105,39,72,0.542,29,51,0.569,10,21,0.476,15,24,0.625,103,2013-03-18,MIA,BOS,2013,108.0
4676,4676,76,@,W 105-82 ,240,42,79,0.532,28,53,0.528,14,26,0.538,7,8,0.875,105,32,79,0.405,25,59,0.424,7,20,0.35,11,13,0.846,82,2013-03-26,MIN,DET,2013,85.5
4677,4677,77,@,W 105-98 ,240,41,90,0.456,30,62,0.484,11,28,0.393,12,21,0.571,105,41,90,0.456,36,66,0.545,5,24,0.208,11,13,0.846,98,2013-03-27,SAC,GSW,2013,100.5
4678,4678,78,@,W 105-91 ,240,34,73,0.466,21,44,0.477,13,29,0.448,24,28,0.857,105,35,71,0.493,31,57,0.544,4,14,0.286,17,24,0.708,91,2013-03-27,LAC,NOH,2013,93.0
4679,4679,79,@,W 105-95 ,240,43,86,0.5,39,67,0.582,4,19,0.211,15,18,0.833,105,33,67,0.493,27,54,0.5,6,13,0.462,23,32,0.719,95,2013-03-29,UTA,POR,2013,98.0
4680,4680,80,Home,W 105-96 ,240,39,80,0.488,34,59,0.576,5,21,0.238,22,30,0.733,105,36,80,0.45,29,59,0.492,7,21,0.333,17,23,0.739,96,2013-04-06,BRK,CHA,2013,99.5
4681,4681,81,Home,W 105-89 ,240,39,91,0.429,29,67,0.433,10,24,0.417,17,22,0.773,105,33,90,0.367,26,71,0.366,7,19,0.368,16,20,0.8,89,2013-04-09,GSW,MIN,2013,92.5
4682,4682,82,@,L 105-108 (OT),265,41,93,0.441,33,69,0.478,8,24,0.333,15,21,0.714,105,43,95,0.453,32,72,0.444,11,23,0.478,11,19,0.579,108,2013-04-12,DEN,DAL,2013,113.5
4683,4683,83,Home,W 105-93 ,240,41,83,0.494,35,68,0.515,6,15,0.4,17,19,0.895,105,37,73,0.507,28,53,0.528,9,20,0.45,10,14,0.714,93,2013-04-13,MIN,PHO,2013,97.5
4684,4684,84,Home,W 105-93 ,240,36,70,0.514,30,53,0.566,6,17,0.353,27,41,0.659,105,29,82,0.354,18,56,0.321,11,26,0.423,24,31,0.774,93,2013-04-14,MIA,CHI,2013,98.5
4685,4685,85,Home,W 105-98 ,240,37,73,0.507,29,53,0.547,8,20,0.4,23,30,0.767,105,39,80,0.488,31,57,0.544,8,23,0.348,12,18,0.667,98,2013-04-17,CHA,CLE,2013,102.0
4686,4686,86,@,W 105-95 ,240,43,85,0.506,35,66,0.53,8,19,0.421,11,14,0.786,105,36,80,0.45,30,54,0.556,6,26,0.231,17,27,0.63,95,2013-04-17,PHI,IND,2013,98.0
4687,4687,87,Home,W 105-93 ,240,42,78,0.538,30,49,0.612,12,29,0.414,9,19,0.474,105,40,77,0.519,38,63,0.603,2,14,0.143,11,25,0.44,93,2013-04-17,MIA,ORL,2013,94.0
4688,4688,88,@,W 105-98 ,240,35,84,0.417,29,69,0.42,6,15,0.4,29,34,0.853,105,34,76,0.447,30,60,0.5,4,16,0.25,26,38,0.684,98,2013-11-01,MIL,BOS,2014,100.0
4689,4689,89,@,L 105-113 ,240,38,100,0.38,29,73,0.397,9,27,0.333,20,25,0.8,105,34,73,0.466,23,44,0.523,11,29,0.379,34,51,0.667,113,2013-11-01,DAL,HOU,2014,118.5
4690,4690,90,Home,W 105-84 ,240,37,75,0.493,30,62,0.484,7,13,0.538,24,28,0.857,105,30,80,0.375,27,59,0.458,3,21,0.143,21,36,0.583,84,2013-11-02,NOP,CHA,2014,85.5
4691,4691,91,@,L 105-115 ,240,47,94,0.5,41,82,0.5,6,12,0.5,5,8,0.625,105,45,81,0.556,37,61,0.607,8,20,0.4,17,19,0.895,115,2013-11-02,SAS,POR,2014,119.0
4692,4692,92,Home,W 105-103 ,240,38,89,0.427,29,64,0.453,9,25,0.36,20,24,0.833,105,40,90,0.444,31,68,0.456,9,22,0.409,14,26,0.538,103,2013-11-03,LAL,ATL,2014,107.5
4693,4693,93,@,W 105-100 ,240,39,81,0.481,31,59,0.525,8,22,0.364,19,26,0.731,105,35,80,0.438,25,49,0.51,10,31,0.323,20,21,0.952,100,2013-11-05,ATL,SAC,2014,105.0
4694,4694,94,@,L 105-106 (OT),265,40,88,0.455,28,59,0.475,12,29,0.414,13,26,0.5,105,41,92,0.446,35,72,0.486,6,20,0.3,18,22,0.818,106,2013-11-10,WAS,OKC,2014,109.0
4695,4695,95,@,L 105-120 ,240,39,85,0.459,32,67,0.478,7,18,0.389,20,23,0.87,105,51,85,0.6,46,73,0.63,5,12,0.417,13,15,0.867,120,2013-11-11,ORL,BOS,2014,122.5
4696,4696,96,Home,W 105-95 ,240,41,84,0.488,31,58,0.534,10,26,0.385,13,19,0.684,105,33,75,0.44,24,49,0.49,9,26,0.346,20,29,0.69,95,2013-11-12,DAL,WAS,2014,99.5
4697,4697,97,@,L 105-111 ,240,42,85,0.494,37,73,0.507,5,12,0.417,16,20,0.8,105,37,72,0.514,28,50,0.56,9,22,0.409,28,39,0.718,111,2013-11-13,NOP,UTA,2014,115.5
4698,4698,98,Home,W 105-98 ,240,40,79,0.506,35,64,0.547,5,15,0.333,20,33,0.606,105,37,83,0.446,29,59,0.492,8,24,0.333,16,20,0.8,98,2013-11-20,NOP,UTA,2014,102.0
4699,4699,99,Home,W 105-91 ,240,41,79,0.519,37,60,0.617,4,19,0.211,19,29,0.655,105,38,92,0.413,30,64,0.469,8,28,0.286,7,15,0.467,91,2013-11-21,OKC,LAC,2014,95.0
4700,4700,0,Home,W 105-94 ,240,43,82,0.524,39,63,0.619,4,19,0.211,15,21,0.714,105,38,85,0.447,31,63,0.492,7,22,0.318,11,17,0.647,94,2013-11-27,ORL,PHI,2014,97.5
4701,4701,1,Home,L 105-121 ,240,42,92,0.457,30,61,0.492,12,31,0.387,9,21,0.429,105,51,93,0.548,43,73,0.589,8,20,0.4,11,14,0.786,121,2013-11-29,PHI,NOP,2014,125.0
4702,4702,2,@,W 105-100 ,240,39,89,0.438,31,63,0.492,8,26,0.308,19,26,0.731,105,36,82,0.439,32,67,0.478,4,15,0.267,24,31,0.774,100,2013-12-01,IND,LAC,2014,102.0
4703,4703,3,@,W 105-98 ,240,33,86,0.384,26,65,0.4,7,21,0.333,32,42,0.762,105,36,91,0.396,27,64,0.422,9,27,0.333,17,22,0.773,98,2013-12-04,DET,MIL,2014,102.5
4704,4704,4,Home,W 105-88 ,240,42,91,0.462,38,70,0.543,4,21,0.19,17,25,0.68,105,37,92,0.402,31,65,0.477,6,27,0.222,8,13,0.615,88,2013-12-06,CHA,PHI,2014,91.0
4705,4705,5,Home,W 105-83 ,240,37,83,0.446,31,55,0.564,6,28,0.214,25,39,0.641,105,27,76,0.355,25,60,0.417,2,16,0.125,27,34,0.794,83,2013-12-06,HOU,GSW,2014,84.0
4706,4706,6,Home,L 105-109 (OT),265,33,83,0.398,25,56,0.446,8,27,0.296,31,41,0.756,105,42,92,0.457,36,72,0.5,6,20,0.3,19,26,0.731,109,2013-12-06,WAS,MIL,2014,112.0
4707,4707,7,@,W 105-94 ,240,40,85,0.471,34,66,0.515,6,19,0.316,19,20,0.95,105,36,82,0.439,35,75,0.467,1,7,0.143,21,23,0.913,94,2013-12-09,POR,UTA,2014,94.5
4708,4708,8,Home,L 105-139 ,240,39,87,0.448,30,72,0.417,9,15,0.6,18,26,0.692,105,52,93,0.559,31,56,0.554,21,37,0.568,14,20,0.7,139,2013-12-14,PHI,POR,2014,149.5
4709,4709,9,@,W 105-93 ,240,43,88,0.489,38,66,0.576,5,22,0.227,14,20,0.7,105,36,87,0.414,31,68,0.456,5,19,0.263,16,22,0.727,93,2013-12-17,OKC,DEN,2014,95.5
4710,4710,10,Home,W 105-91 ,240,40,73,0.548,35,58,0.603,5,15,0.333,20,23,0.87,105,37,93,0.398,29,75,0.387,8,18,0.444,9,14,0.643,91,2013-12-18,DAL,MEM,2014,95.0
4711,4711,11,@,W 105-100 ,240,39,79,0.494,27,56,0.482,12,23,0.522,15,23,0.652,105,39,82,0.476,31,62,0.5,8,20,0.4,14,23,0.609,100,2013-12-21,SAC,ORL,2014,104.0
4712,4712,12,Home,W 105-103 ,240,40,95,0.421,30,71,0.423,10,24,0.417,15,22,0.682,105,40,81,0.494,36,63,0.571,4,18,0.222,19,23,0.826,103,2013-12-25,GSW,LAC,2014,105.0
4713,4713,13,Home,W 105-89 ,240,42,89,0.472,31,65,0.477,11,24,0.458,10,15,0.667,105,33,82,0.402,27,59,0.458,6,23,0.261,17,24,0.708,89,2013-12-27,NOP,DEN,2014,92.0
4714,4714,14,Home,W 105-103 ,240,40,88,0.455,31,65,0.477,9,23,0.391,16,20,0.8,105,40,80,0.5,33,57,0.579,7,23,0.304,16,23,0.696,103,2013-12-27,UTA,LAL,2014,106.5
4715,4715,15,@,W 105-83 ,240,41,78,0.526,28,52,0.538,13,26,0.5,10,11,0.909,105,32,74,0.432,29,57,0.509,3,17,0.176,16,19,0.842,83,2013-12-28,DAL,CHI,2014,84.5
4716,4716,16,Home,W 105-91 ,240,38,71,0.535,30,52,0.577,8,19,0.421,21,25,0.84,105,36,77,0.468,28,56,0.5,8,21,0.381,11,16,0.688,91,2013-12-28,IND,BRK,2014,95.0
4717,4717,17,@,W 105-101 ,240,39,76,0.513,30,59,0.508,9,17,0.529,18,20,0.9,105,37,77,0.481,23,45,0.511,14,32,0.438,13,19,0.684,101,2014-01-02,NYK,SAS,2014,108.0
4718,4718,18,@,L 105-111 ,240,39,83,0.47,34,66,0.515,5,17,0.294,22,30,0.733,105,36,79,0.456,25,49,0.51,11,30,0.367,28,39,0.718,111,2014-01-08,BOS,LAC,2014,116.5
4719,4719,19,@,L 105-109 ,240,44,89,0.494,40,81,0.494,4,8,0.5,13,19,0.684,105,43,80,0.538,36,64,0.563,7,16,0.438,16,18,0.889,109,2014-01-15,UTA,SAS,2014,112.5
4720,4720,20,Home,W 105-97 ,240,42,87,0.483,32,72,0.444,10,15,0.667,11,17,0.647,105,40,86,0.465,33,67,0.493,7,19,0.368,10,16,0.625,97,2014-01-21,OKC,POR,2014,100.5
4721,4721,21,Home,L 105-111 ,240,40,75,0.533,30,53,0.566,10,22,0.455,15,22,0.682,105,45,83,0.542,35,65,0.538,10,18,0.556,11,16,0.688,111,2014-01-22,SAS,OKC,2014,116.0
4722,4722,22,@,L 105-110 ,240,39,79,0.494,29,56,0.518,10,23,0.435,17,20,0.85,105,38,88,0.432,34,70,0.486,4,18,0.222,30,34,0.882,110,2014-01-23,DEN,POR,2014,112.0
4723,4723,23,@,W 105-79 ,240,41,84,0.488,30,66,0.455,11,18,0.611,12,17,0.706,105,29,76,0.382,27,63,0.429,2,13,0.154,19,27,0.704,79,2014-01-24,SAS,ATL,2014,80.0
4724,4724,24,@,L 105-114 ,240,41,90,0.456,29,68,0.426,12,22,0.545,11,17,0.647,105,39,81,0.481,30,64,0.469,9,17,0.529,27,34,0.794,114,2014-01-24,LAL,ORL,2014,118.5
4725,4725,25,Home,W 105-95 ,240,39,80,0.488,32,59,0.542,7,21,0.333,20,23,0.87,105,33,79,0.418,25,56,0.446,8,23,0.348,21,29,0.724,95,2014-02-01,PHO,CHA,2014,99.0
4726,4726,26,Home,W 105-100 ,240,40,86,0.465,35,72,0.486,5,14,0.357,20,22,0.909,105,38,84,0.452,24,54,0.444,14,30,0.467,10,14,0.714,100,2014-02-05,NOP,ATL,2014,107.0
4727,4727,27,@,L 105-118 ,240,34,85,0.4,27,59,0.458,7,26,0.269,30,40,0.75,105,36,71,0.507,27,47,0.574,9,24,0.375,37,54,0.685,118,2014-02-07,TOR,LAC,2014,122.5
4728,4728,28,Home,W 105-89 ,240,40,80,0.5,27,49,0.551,13,31,0.419,12,15,0.8,105,36,87,0.414,26,60,0.433,10,27,0.37,7,15,0.467,89,2014-02-12,BRK,CHA,2014,94.0
4729,4729,29,Home,W 105-100 ,240,37,87,0.425,34,71,0.479,3,16,0.188,28,32,0.875,105,37,80,0.463,29,61,0.475,8,19,0.421,18,23,0.783,100,2014-02-12,UTA,PHI,2014,104.0
4730,4730,30,@,W 105-99 ,240,41,82,0.5,32,59,0.542,9,23,0.391,14,20,0.7,105,37,82,0.451,28,58,0.483,9,24,0.375,16,17,0.941,99,2014-02-19,BRK,UTA,2014,103.5
4731,4731,31,Home,W 105-98 ,240,38,73,0.521,33,64,0.516,5,9,0.556,24,28,0.857,105,34,87,0.391,28,66,0.424,6,21,0.286,24,36,0.667,98,2014-02-22,SAC,BOS,2014,101.0
4732,4732,32,Home,W 105-90 ,240,34,65,0.523,25,48,0.521,9,17,0.529,28,36,0.778,105,36,87,0.414,31,73,0.425,5,14,0.357,13,17,0.765,90,2014-02-23,TOR,ORL,2014,92.5
4733,4733,33,@,W 105-94 ,240,43,80,0.538,38,61,0.623,5,19,0.263,14,17,0.824,105,39,87,0.448,37,76,0.487,2,11,0.182,14,17,0.824,94,2014-03-05,CHI,DET,2014,95.0
4734,4734,34,Home,W 105-94 ,240,36,81,0.444,28,61,0.459,8,20,0.4,25,31,0.806,105,32,67,0.478,25,51,0.49,7,16,0.438,23,29,0.793,94,2014-03-09,DAL,IND,2014,97.5
4735,4735,35,Home,W 105-98 ,240,37,81,0.457,29,61,0.475,8,20,0.4,23,28,0.821,105,36,83,0.434,31,59,0.525,5,24,0.208,21,31,0.677,98,2014-03-10,CHA,DEN,2014,100.5
4736,4736,36,@,L 105-112 ,240,39,85,0.459,32,65,0.492,7,20,0.35,20,29,0.69,105,43,78,0.551,39,64,0.609,4,14,0.286,22,31,0.71,112,2014-03-10,PHO,LAC,2014,114.0
4737,4737,37,Home,W 105-98 ,240,38,84,0.452,30,57,0.526,8,27,0.296,21,25,0.84,105,42,88,0.477,33,65,0.508,9,23,0.391,5,8,0.625,98,2014-03-10,MIL,ORL,2014,102.5
4738,4738,38,Home,W 105-93 ,240,44,91,0.484,36,72,0.5,8,19,0.421,9,14,0.643,105,35,82,0.427,29,67,0.433,6,15,0.4,17,21,0.81,93,2014-03-14,CHA,MIN,2014,96.0
4739,4739,39,@,W 105-101 (OT),265,36,90,0.4,26,67,0.388,10,23,0.435,23,29,0.793,105,43,97,0.443,36,72,0.5,7,25,0.28,8,10,0.8,101,2014-03-14,WAS,ORL,2014,104.5
4740,4740,40,Home,L 105-111 ,240,38,85,0.447,30,57,0.526,8,28,0.286,21,27,0.778,105,36,70,0.514,32,57,0.561,4,13,0.308,35,43,0.814,111,2014-03-21,ATL,NOP,2014,113.0
4741,4741,41,Home,W 105-95 ,240,43,84,0.512,36,67,0.537,7,17,0.412,12,17,0.706,105,37,73,0.507,29,47,0.617,8,26,0.308,13,17,0.765,95,2014-03-22,NOP,MIA,2014,99.0
4742,4742,42,Home,W 105-102 ,240,40,91,0.44,29,64,0.453,11,27,0.407,14,18,0.778,105,41,85,0.482,36,70,0.514,5,15,0.333,15,18,0.833,102,2014-03-23,DEN,WAS,2014,104.5
4743,4743,43,@,L 105-108 ,240,42,85,0.494,35,64,0.547,7,21,0.333,14,18,0.778,105,39,70,0.557,33,60,0.55,6,10,0.6,24,34,0.706,108,2014-03-27,LAL,MIL,2014,111.0
4744,4744,44,@,L 105-110 (OT),265,43,97,0.443,35,75,0.467,8,22,0.364,11,14,0.786,105,39,87,0.448,33,69,0.478,6,18,0.333,26,35,0.743,110,2014-03-28,CHA,ORL,2014,113.0
4745,4745,45,Home,W 105-103 ,240,40,86,0.465,35,66,0.53,5,20,0.25,20,22,0.909,105,40,76,0.526,34,58,0.586,6,18,0.333,17,20,0.85,103,2014-03-28,TOR,BOS,2014,106.0
4746,4746,46,Home,W 105-98 ,240,39,75,0.52,34,60,0.567,5,15,0.333,22,25,0.88,105,41,89,0.461,36,72,0.5,5,17,0.294,11,18,0.611,98,2014-03-30,POR,MEM,2014,100.5
4747,4747,47,Home,W 105-96 ,240,44,83,0.53,38,58,0.655,6,25,0.24,11,17,0.647,105,32,84,0.381,22,49,0.449,10,35,0.286,22,28,0.786,96,2014-04-01,BRK,HOU,2014,101.0
4748,4748,48,@,W 105-92 ,240,40,78,0.513,28,53,0.528,12,25,0.48,13,15,0.867,105,32,72,0.444,24,48,0.5,8,24,0.333,20,26,0.769,92,2014-04-02,CHI,ATL,2014,96.0
4749,4749,49,@,W 105-101 ,240,41,80,0.513,35,59,0.593,6,21,0.286,17,23,0.739,105,36,79,0.456,26,56,0.464,10,23,0.435,19,27,0.704,101,2014-04-05,BRK,PHI,2014,106.0
4750,4750,50,Home,W 105-97 ,240,40,76,0.526,31,53,0.585,9,23,0.391,16,22,0.727,105,37,84,0.44,25,58,0.431,12,26,0.462,11,14,0.786,97,2014-04-09,ATL,BOS,2014,103.0
4751,4751,51,@,L 105-111 ,240,41,93,0.441,36,68,0.529,5,25,0.2,18,26,0.692,105,39,72,0.542,32,53,0.604,7,19,0.368,26,41,0.634,111,2014-04-12,PHI,CHA,2014,114.5
4752,4752,52,@,L 105-117 ,240,35,82,0.427,27,53,0.509,8,29,0.276,27,30,0.9,105,44,83,0.53,35,59,0.593,9,24,0.375,20,30,0.667,117,2014-04-15,DEN,LAC,2014,121.5
4753,4753,53,@,L 105-106 (OT),265,44,92,0.478,36,62,0.581,8,30,0.267,9,11,0.818,105,43,88,0.489,38,68,0.559,5,20,0.25,15,25,0.6,106,2014-04-16,DAL,MEM,2014,108.5
4754,4754,54,Home,W 105-100 ,240,43,82,0.524,37,70,0.529,6,12,0.5,13,20,0.65,105,35,81,0.432,21,51,0.412,14,30,0.467,16,24,0.667,100,2014-04-16,NOP,HOU,2014,107.0
4755,4755,55,@,L 105-121 ,240,39,80,0.488,32,61,0.525,7,19,0.368,20,26,0.769,105,49,88,0.557,41,66,0.621,8,22,0.364,15,23,0.652,121,2014-10-29,BRK,BOS,2015,125.0
4756,4756,56,Home,W 105-101 ,240,43,82,0.524,39,67,0.582,4,15,0.267,15,20,0.75,105,39,86,0.453,33,74,0.446,6,12,0.5,17,23,0.739,101,2014-10-29,MEM,MIN,2015,104.0
4757,4757,57,@,W 105-98 ,240,39,80,0.488,32,67,0.478,7,13,0.538,20,26,0.769,105,37,72,0.514,31,57,0.544,6,15,0.4,18,24,0.75,98,2014-10-30,WAS,ORL,2015,101.0
4758,4758,58,Home,L 105-106 ,240,38,85,0.447,34,73,0.466,4,12,0.333,25,31,0.806,105,33,69,0.478,24,46,0.522,9,23,0.391,31,40,0.775,106,2014-11-01,MIN,CHI,2015,110.5
4759,4759,59,Home,L 105-110 ,240,36,93,0.387,31,69,0.449,5,24,0.208,28,33,0.848,105,34,81,0.42,32,72,0.444,2,9,0.222,40,47,0.851,110,2014-11-03,DEN,SAC,2015,111.0
4760,4760,60,@,W 105-82 ,240,42,88,0.477,33,64,0.516,9,24,0.375,12,14,0.857,105,29,68,0.426,20,40,0.5,9,28,0.321,15,19,0.789,82,2014-11-07,DAL,UTA,2015,86.5
4761,4761,61,@,W 105-96 ,240,42,76,0.553,33,53,0.623,9,23,0.391,12,20,0.6,105,35,83,0.422,26,54,0.481,9,29,0.31,17,24,0.708,96,2014-11-09,MIA,DAL,2015,100.5
4762,4762,62,@,W 105-89 ,240,39,80,0.488,29,54,0.537,10,26,0.385,17,25,0.68,105,36,81,0.444,29,58,0.5,7,23,0.304,10,22,0.455,89,2014-11-17,CHI,LAC,2015,92.5
4763,4763,63,@,W 105-102 ,240,34,82,0.415,22,54,0.407,12,28,0.429,25,29,0.862,105,37,84,0.44,27,62,0.435,10,22,0.455,18,21,0.857,102,2014-11-19,DAL,WAS,2015,107.0
4764,4764,64,@,W 105-100 ,240,39,82,0.476,35,66,0.53,4,16,0.25,23,32,0.719,105,42,91,0.462,35,71,0.493,7,20,0.35,9,15,0.6,100,2014-11-21,ORL,CHO,2015,103.5
4765,4765,65,Home,W 105-87 ,240,39,79,0.494,30,63,0.476,9,16,0.563,18,22,0.818,105,30,83,0.361,22,61,0.361,8,22,0.364,19,28,0.679,87,2014-11-21,POR,CHI,2015,91.0
4766,4766,66,@,W 105-97 ,240,39,92,0.424,27,65,0.415,12,27,0.444,15,20,0.75,105,41,94,0.436,36,79,0.456,5,15,0.333,10,15,0.667,97,2014-11-26,POR,CHO,2015,99.5
4767,4767,67,Home,W 105-78 ,240,38,86,0.442,28,62,0.452,10,24,0.417,19,23,0.826,105,29,75,0.387,27,56,0.482,2,19,0.105,18,24,0.75,78,2014-11-28,OKC,NYK,2015,79.0
4768,4768,68,Home,W 105-75 ,240,40,75,0.533,28,52,0.538,12,23,0.522,13,16,0.813,105,29,88,0.33,24,65,0.369,5,23,0.217,12,16,0.75,75,2014-11-29,ATL,CHO,2015,77.5
4769,4769,69,@,L 105-109 ,240,41,84,0.488,29,61,0.475,12,23,0.522,11,13,0.846,105,43,82,0.524,32,58,0.552,11,24,0.458,12,14,0.857,109,2014-12-02,BOS,ATL,2015,114.5
4770,4770,70,@,W 105-103 ,240,43,86,0.5,38,64,0.594,5,22,0.227,14,17,0.824,105,41,81,0.506,34,61,0.557,7,20,0.35,14,19,0.737,103,2014-12-02,POR,DEN,2015,106.5
4771,4771,71,Home,W 105-96 ,240,41,93,0.441,31,65,0.477,10,28,0.357,13,20,0.65,105,39,76,0.513,37,63,0.587,2,13,0.154,16,27,0.593,96,2014-12-03,HOU,MEM,2015,97.0
4772,4772,72,Home,L 105-107 ,240,38,73,0.521,31,62,0.5,7,11,0.636,22,32,0.688,105,42,92,0.457,34,65,0.523,8,27,0.296,15,22,0.682,107,2014-12-03,MIL,DAL,2015,111.0
4773,4773,73,@,W 105-91 ,240,41,84,0.488,32,64,0.5,9,20,0.45,14,21,0.667,105,35,86,0.407,27,62,0.435,8,24,0.333,13,20,0.65,91,2014-12-05,CLE,TOR,2015,95.0
4774,4774,74,@,W 105-96 ,240,42,83,0.506,33,57,0.579,9,26,0.346,12,14,0.857,105,35,79,0.443,31,64,0.484,4,15,0.267,22,28,0.786,96,2014-12-06,ORL,SAC,2015,98.0
4775,4775,75,Home,W 105-101 ,240,39,79,0.494,30,53,0.566,9,26,0.346,18,21,0.857,105,42,82,0.512,35,59,0.593,7,23,0.304,10,10,1.0,101,2014-12-09,CLE,TOR,2015,104.5
4776,4776,76,@,L 105-114 ,240,38,85,0.447,20,45,0.444,18,40,0.45,11,14,0.786,105,41,85,0.482,34,71,0.479,7,14,0.5,25,29,0.862,114,2014-12-09,DAL,MEM,2015,117.5
4777,4777,77,Home,W 105-80 ,240,37,79,0.468,29,57,0.509,8,22,0.364,23,32,0.719,105,29,88,0.33,26,74,0.351,3,14,0.214,19,24,0.792,80,2014-12-10,CHI,BRK,2015,81.5
4778,4778,78,Home,W 105-93 ,240,40,81,0.494,32,58,0.552,8,23,0.348,17,20,0.85,105,37,90,0.411,28,55,0.509,9,35,0.257,10,15,0.667,93,2014-12-10,GSW,HOU,2015,97.5
4779,4779,79,@,W 105-103 ,240,40,84,0.476,36,69,0.522,4,15,0.267,21,27,0.778,105,39,83,0.47,29,52,0.558,10,31,0.323,15,19,0.789,103,2014-12-12,DET,PHO,2015,108.0
4780,4780,80,@,W 105-98 ,240,37,83,0.446,27,51,0.529,10,32,0.313,21,27,0.778,105,36,89,0.404,31,64,0.484,5,25,0.2,21,30,0.7,98,2014-12-13,GSW,DAL,2015,100.5
4781,4781,81,@,W 105-87 ,240,38,86,0.442,32,61,0.525,6,25,0.24,23,35,0.657,105,33,93,0.355,29,65,0.446,4,28,0.143,17,21,0.81,87,2014-12-15,BOS,PHI,2015,89.0
4782,4782,82,Home,W 105-98 ,240,42,92,0.457,37,78,0.474,5,14,0.357,16,19,0.842,105,39,95,0.411,30,64,0.469,9,31,0.29,11,12,0.917,98,2014-12-16,MEM,GSW,2015,102.5
4783,4783,83,@,W 105-87 ,240,35,66,0.53,21,41,0.512,14,25,0.56,21,24,0.875,105,27,70,0.386,23,53,0.434,4,17,0.235,29,40,0.725,87,2014-12-17,UTA,MIA,2015,89.0
4784,4784,84,Home,W 105-89 ,240,41,80,0.513,31,60,0.517,10,20,0.5,13,19,0.684,105,35,81,0.432,26,54,0.481,9,27,0.333,10,22,0.455,89,2014-12-17,TOR,BRK,2015,93.5
4785,4785,85,@,W 105-103 ,240,39,79,0.494,36,65,0.554,3,14,0.214,24,33,0.727,105,40,75,0.533,31,56,0.554,9,19,0.474,14,19,0.737,103,2014-12-19,WAS,MIA,2015,107.5
4786,4786,86,@,L 105-110 ,240,40,91,0.44,31,64,0.484,9,27,0.333,16,26,0.615,105,40,76,0.526,32,56,0.571,8,20,0.4,22,29,0.759,110,2014-12-21,DET,BRK,2015,114.0
4787,4787,87,Home,W 105-91 ,240,46,76,0.605,39,62,0.629,7,14,0.5,6,10,0.6,105,39,86,0.453,38,70,0.543,1,16,0.063,12,15,0.8,91,2014-12-21,CLE,MEM,2015,91.5
4788,4788,88,@,W 105-102 ,240,40,81,0.494,33,62,0.532,7,19,0.368,18,27,0.667,105,39,90,0.433,28,62,0.452,11,28,0.393,13,20,0.65,102,2014-12-22,ATL,DAL,2015,107.5
4789,4789,89,@,L 105-115 ,240,39,84,0.464,27,58,0.466,12,26,0.462,15,17,0.882,105,46,89,0.517,34,63,0.54,12,26,0.462,11,17,0.647,115,2014-12-23,GSW,LAL,2015,121.0
4790,4790,90,@,L 105-126 ,240,40,86,0.465,30,61,0.492,10,25,0.4,15,20,0.75,105,49,92,0.533,37,64,0.578,12,28,0.429,16,20,0.8,126,2015-01-02,TOR,GSW,2015,132.0
4791,4791,91,@,L 105-114 ,240,47,102,0.461,39,77,0.506,8,25,0.32,3,5,0.6,105,41,85,0.482,36,68,0.529,5,17,0.294,27,30,0.9,114,2015-01-05,HOU,CHI,2015,116.5
4792,4792,92,Home,W 105-83 ,240,43,82,0.524,36,67,0.537,7,15,0.467,12,19,0.632,105,33,76,0.434,25,50,0.5,8,26,0.308,9,13,0.692,83,2015-01-05,MEM,NYK,2015,87.0
4793,4793,93,@,W 105-101 ,240,35,74,0.473,28,61,0.459,7,13,0.538,28,30,0.933,105,35,81,0.432,31,58,0.534,4,23,0.174,27,34,0.794,101,2015-01-05,IND,UTA,2015,103.0
4794,4794,94,@,W 105-104 ,240,41,87,0.471,38,68,0.559,3,19,0.158,20,28,0.714,105,36,79,0.456,27,58,0.466,9,21,0.429,23,34,0.676,104,2015-01-06,DET,SAS,2015,108.5
4795,4795,95,@,W 105-93 ,240,39,86,0.453,27,52,0.519,12,34,0.353,15,24,0.625,105,34,82,0.415,24,53,0.453,10,29,0.345,15,19,0.789,93,2015-01-07,HOU,CLE,2015,98.0
4796,4796,96,@,W 105-87 ,240,42,87,0.483,30,64,0.469,12,23,0.522,9,16,0.563,105,31,76,0.408,22,51,0.431,9,25,0.36,16,25,0.64,87,2015-01-13,ATL,PHI,2015,91.5
4797,4797,97,Home,L 105-116 ,240,39,81,0.481,32,60,0.533,7,21,0.333,20,24,0.833,105,46,91,0.505,33,66,0.5,13,25,0.52,11,13,0.846,116,2015-01-13,UTA,GSW,2015,122.5
4798,4798,98,@,W 105-91 ,240,36,73,0.493,26,44,0.591,10,29,0.345,23,27,0.852,105,34,83,0.41,23,50,0.46,11,33,0.333,12,14,0.857,91,2015-01-14,ATL,BOS,2015,96.5
4799,4799,99,@,W 105-99 ,240,40,78,0.513,35,63,0.556,5,15,0.333,20,25,0.8,105,34,79,0.43,21,52,0.404,13,27,0.481,18,24,0.75,99,2015-01-14,WAS,CHI,2015,105.5
4800,4800,0,@,W 105-94 ,240,39,80,0.488,31,59,0.525,8,21,0.381,19,23,0.826,105,34,73,0.466,26,51,0.51,8,22,0.364,18,23,0.783,94,2015-01-14,NOP,DET,2015,98.0
4801,4801,1,Home,L 105-113 ,240,38,92,0.413,28,61,0.459,10,31,0.323,19,22,0.864,105,43,80,0.538,35,61,0.574,8,19,0.421,19,21,0.905,113,2015-01-17,DEN,MIN,2015,117.0
4802,4802,2,Home,W 105-80 ,240,40,89,0.449,28,67,0.418,12,22,0.545,13,19,0.684,105,29,80,0.363,23,61,0.377,6,19,0.316,16,20,0.8,80,2015-01-19,CHA,MIN,2015,83.0
4803,4803,3,@,W 105-103 (OT),265,40,102,0.392,34,73,0.466,6,29,0.207,19,23,0.826,105,38,100,0.38,31,70,0.443,7,30,0.233,20,26,0.769,103,2015-01-21,OKC,WAS,2015,106.5
4804,4804,4,Home,W 105-99 ,240,40,84,0.476,29,61,0.475,11,23,0.478,14,22,0.636,105,39,87,0.448,28,57,0.491,11,30,0.367,10,11,0.909,99,2015-01-30,ATL,POR,2015,104.5
4805,4805,5,@,W 105-85 ,240,40,91,0.44,32,69,0.464,8,22,0.364,17,18,0.944,105,28,75,0.373,18,45,0.4,10,30,0.333,19,28,0.679,85,2015-01-31,LAC,SAS,2015,90.0
4806,4806,6,Home,W 105-98 ,240,31,70,0.443,20,43,0.465,11,27,0.407,32,42,0.762,105,33,85,0.388,21,54,0.389,12,31,0.387,20,28,0.714,98,2015-02-03,PHI,DEN,2015,104.0
4807,4807,7,Home,W 105-96 ,240,38,80,0.475,27,55,0.491,11,25,0.44,18,27,0.667,105,34,77,0.442,30,61,0.492,4,16,0.25,24,30,0.8,96,2015-02-04,ATL,WAS,2015,98.0
4808,4808,8,@,L 105-113 (OT),265,39,93,0.419,30,65,0.462,9,28,0.321,18,25,0.72,105,41,82,0.5,30,56,0.536,11,26,0.423,20,22,0.909,113,2015-02-04,LAL,MIL,2015,118.5
4809,4809,9,Home,W 105-94 ,240,31,72,0.431,23,42,0.548,8,30,0.267,35,44,0.795,105,38,91,0.418,33,69,0.478,5,22,0.227,13,20,0.65,94,2015-02-05,CLE,LAC,2015,96.5
4810,4810,10,@,L 105-120 ,240,41,100,0.41,34,77,0.442,7,23,0.304,16,19,0.842,105,45,82,0.549,27,49,0.551,18,33,0.545,12,20,0.6,120,2015-02-08,LAL,CLE,2015,129.0
4811,4811,11,Home,L 105-117 ,240,42,93,0.452,37,77,0.481,5,16,0.313,16,22,0.727,105,44,86,0.512,34,65,0.523,10,21,0.476,19,20,0.95,117,2015-02-09,MIN,ATL,2015,122.0
4812,4812,12,Home,W 105-89 ,240,37,83,0.446,30,63,0.476,7,20,0.35,24,25,0.96,105,32,86,0.372,30,74,0.405,2,12,0.167,23,30,0.767,89,2015-02-11,OKC,MEM,2015,90.0
4813,4813,13,@,W 105-80 ,240,43,96,0.448,30,66,0.455,13,30,0.433,6,8,0.75,105,29,88,0.33,21,50,0.42,8,38,0.211,14,21,0.667,80,2015-02-20,TOR,ATL,2015,84.0
4814,4814,14,Home,L 105-114 ,240,41,89,0.461,37,66,0.561,4,23,0.174,19,29,0.655,105,42,89,0.472,32,68,0.471,10,21,0.476,20,24,0.833,114,2015-02-20,LAL,BRK,2015,119.0
4815,4815,15,@,W 105-91 ,240,35,83,0.422,27,62,0.435,8,21,0.381,27,31,0.871,105,33,79,0.418,28,62,0.452,5,17,0.294,20,27,0.741,91,2015-02-21,NOP,MIA,2015,93.5
4816,4816,16,Home,W 105-92 ,240,40,96,0.417,31,72,0.431,9,24,0.375,16,18,0.889,105,38,88,0.432,29,62,0.468,9,26,0.346,7,11,0.636,92,2015-02-24,OKC,IND,2015,96.5
4817,4817,17,@,L 105-110 ,240,40,91,0.44,29,59,0.492,11,32,0.344,14,19,0.737,105,36,88,0.409,19,44,0.432,17,44,0.386,21,30,0.7,110,2015-02-25,LAC,HOU,2015,118.5
4818,4818,18,Home,W 105-103 (OT),265,34,74,0.459,23,44,0.523,11,30,0.367,26,33,0.788,105,40,98,0.408,28,58,0.483,12,40,0.3,11,21,0.524,103,2015-03-01,HOU,CLE,2015,109.0
4819,4819,19,Home,L 105-110 ,240,36,82,0.439,32,67,0.478,4,15,0.267,29,35,0.829,105,44,92,0.478,32,59,0.542,12,33,0.364,10,19,0.526,110,2015-03-02,MIN,LAC,2015,116.0
4820,4820,20,Home,W 105-82 ,240,38,80,0.475,28,58,0.483,10,22,0.455,19,24,0.792,105,30,76,0.395,24,60,0.4,6,16,0.375,16,23,0.696,82,2015-03-04,IND,NYK,2015,85.0
4821,4821,21,@,W 105-100 ,240,37,79,0.468,29,58,0.5,8,21,0.381,23,27,0.852,105,41,87,0.471,36,67,0.537,5,20,0.25,13,15,0.867,100,2015-03-04,PHO,ORL,2015,102.5
4822,4822,22,@,L 105-108 ,240,41,88,0.466,33,68,0.485,8,20,0.4,15,19,0.789,105,40,87,0.46,33,62,0.532,7,25,0.28,21,26,0.808,108,2015-03-05,OKC,CHI,2015,111.5
4823,4823,23,@,L 105-116 ,240,37,73,0.507,32,58,0.552,5,15,0.333,26,29,0.897,105,44,90,0.489,35,68,0.515,9,22,0.409,19,24,0.792,116,2015-03-08,CHI,SAS,2015,120.5
4824,4824,24,@,L 105-130 ,240,39,81,0.481,31,61,0.508,8,20,0.4,19,20,0.95,105,53,88,0.602,33,52,0.635,20,36,0.556,4,7,0.571,130,2015-03-09,SAC,ATL,2015,140.0
4825,4825,25,Home,W 105-98 ,240,44,84,0.524,37,64,0.578,7,20,0.35,10,13,0.769,105,42,98,0.429,38,86,0.442,4,12,0.333,10,12,0.833,98,2015-03-11,GSW,DET,2015,100.0
4826,4826,26,Home,W 105-100 ,240,42,92,0.457,32,59,0.542,10,33,0.303,11,14,0.786,105,38,91,0.418,27,60,0.45,11,31,0.355,13,23,0.565,100,2015-03-11,POR,HOU,2015,105.5
4827,4827,27,@,L 105-108 ,240,39,85,0.459,31,70,0.443,8,15,0.533,19,21,0.905,105,40,84,0.476,33,57,0.579,7,27,0.259,21,23,0.913,108,2015-03-16,LAL,GSW,2015,111.5
4828,4828,28,Home,W 105-97 ,240,41,82,0.5,34,70,0.486,7,12,0.583,16,26,0.615,105,36,89,0.404,28,61,0.459,8,28,0.286,17,20,0.85,97,2015-03-16,WAS,POR,2015,101.0
4829,4829,29,Home,W 105-95 ,240,39,83,0.47,27,50,0.54,12,33,0.364,15,22,0.682,105,35,80,0.438,25,62,0.403,10,18,0.556,15,17,0.882,95,2015-03-17,DET,MEM,2015,100.0
4830,4830,30,Home,L 105-116 ,240,38,79,0.481,35,62,0.565,3,17,0.176,26,32,0.813,105,45,88,0.511,28,51,0.549,17,37,0.459,9,13,0.692,116,2015-03-18,SAC,LAC,2015,124.5
4831,4831,31,Home,W 105-100 ,240,35,79,0.443,23,50,0.46,12,29,0.414,23,27,0.852,105,42,87,0.483,36,70,0.514,6,17,0.353,10,15,0.667,100,2015-03-18,TOR,MIN,2015,103.0
4832,4832,32,@,W 105-97 (OT),265,39,89,0.438,30,63,0.476,9,26,0.346,18,30,0.6,105,38,105,0.362,30,78,0.385,8,27,0.296,13,17,0.765,97,2015-03-22,DET,BOS,2015,101.0
4833,4833,33,Home,W 105-95 ,240,41,83,0.494,30,54,0.556,11,29,0.379,12,17,0.706,105,40,84,0.476,32,59,0.542,8,25,0.32,7,10,0.7,95,2015-03-31,DET,ATL,2015,99.0
4834,4834,34,Home,W 105-100 ,240,39,81,0.481,32,57,0.561,7,24,0.292,20,30,0.667,105,35,84,0.417,26,59,0.441,9,25,0.36,21,27,0.778,100,2015-04-07,LAC,LAL,2015,104.5
4835,4835,35,Home,W 105-100 ,240,40,81,0.494,37,66,0.561,3,15,0.2,22,28,0.786,105,39,91,0.429,34,73,0.466,5,18,0.278,17,21,0.81,100,2015-04-07,MIA,CHO,2015,102.5
4836,4836,36,Home,W 105-103 ,240,38,82,0.463,30,59,0.508,8,23,0.348,21,24,0.875,105,34,79,0.43,22,53,0.415,12,26,0.462,23,31,0.742,103,2015-04-08,ORL,CHI,2015,109.0
4837,4837,37,@,L 105-116 ,240,46,98,0.469,39,74,0.527,7,24,0.292,6,8,0.75,105,48,90,0.533,36,64,0.563,12,26,0.462,8,9,0.889,116,2015-04-09,POR,GSW,2015,122.0
4838,4838,38,Home,L 105-111 ,240,41,87,0.471,35,57,0.614,6,30,0.2,17,22,0.773,105,36,79,0.456,30,62,0.484,6,17,0.353,33,42,0.786,111,2015-04-11,POR,UTA,2015,114.0
4839,4839,39,@,W 105-100 ,240,42,85,0.494,29,55,0.527,13,30,0.433,8,14,0.571,105,41,89,0.461,34,68,0.5,7,21,0.333,11,16,0.688,100,2015-04-15,BOS,MIL,2015,103.5
4840,4840,40,@,W 105-101 ,240,39,89,0.438,27,58,0.466,12,31,0.387,15,20,0.75,105,38,83,0.458,33,54,0.611,5,29,0.172,20,25,0.8,101,2015-04-15,MIA,PHI,2015,103.5
4841,4841,41,@,W 105-85 ,240,40,79,0.506,27,52,0.519,13,27,0.481,12,18,0.667,105,30,87,0.345,22,52,0.423,8,35,0.229,17,26,0.654,85,2015-10-28,DEN,HOU,2016,89.0
4842,4842,42,@,L 105-110 ,240,40,84,0.476,30,61,0.492,10,23,0.435,15,22,0.682,105,41,89,0.461,32,60,0.533,9,29,0.31,19,29,0.655,110,2015-11-02,OKC,HOU,2016,114.5
4843,4843,43,@,L 105-130 ,240,44,90,0.489,30,60,0.5,14,30,0.467,3,8,0.375,105,47,91,0.516,33,68,0.485,14,23,0.609,22,23,0.957,130,2015-11-03,CHI,CHO,2016,137.0
4844,4844,44,Home,L 105-109 ,240,42,88,0.477,38,66,0.576,4,22,0.182,17,25,0.68,105,38,86,0.442,31,56,0.554,7,30,0.233,26,29,0.897,109,2015-11-07,LAC,HOU,2016,112.5
4845,4845,45,@,W 105-97 ,240,39,83,0.47,33,70,0.471,6,13,0.462,21,24,0.875,105,36,80,0.45,25,47,0.532,11,33,0.333,14,26,0.538,97,2015-11-07,ORL,PHI,2016,102.5
4846,4846,46,@,L 105-120 ,240,39,88,0.443,34,68,0.5,5,20,0.25,22,26,0.846,105,46,92,0.5,32,59,0.542,14,33,0.424,14,18,0.778,120,2015-11-10,DAL,NOP,2016,127.0
4847,4847,47,@,L 105-108 (2OT),290,37,91,0.407,23,53,0.434,14,38,0.368,17,27,0.63,105,43,102,0.422,37,86,0.43,6,16,0.375,16,22,0.727,108,2015-11-14,CLE,MIL,2016,111.0
4848,4848,48,Home,W 105-81 ,240,37,84,0.44,26,60,0.433,11,24,0.458,20,26,0.769,105,34,98,0.347,28,63,0.444,6,35,0.171,7,8,0.875,81,2015-11-14,PHO,DEN,2016,84.0
4849,4849,49,Home,L 105-118 ,240,37,86,0.43,33,71,0.465,4,15,0.267,27,35,0.771,105,47,89,0.528,32,60,0.533,15,29,0.517,9,13,0.692,118,2015-11-22,DEN,GSW,2016,125.5
4850,4850,50,@,L 105-116 ,240,35,88,0.398,24,61,0.393,11,27,0.407,24,28,0.857,105,45,85,0.529,37,62,0.597,8,23,0.348,18,37,0.486,116,2015-11-30,HOU,DET,2016,120.0
4851,4851,51,@,W 105-95 ,240,38,80,0.475,30,60,0.5,8,20,0.4,21,25,0.84,105,36,75,0.48,31,58,0.534,5,17,0.294,18,24,0.75,95,2015-11-30,BOS,MIA,2016,97.5
4852,4852,52,Home,L 105-106 ,240,39,92,0.424,31,65,0.477,8,27,0.296,19,22,0.864,105,38,81,0.469,26,54,0.481,12,27,0.444,18,18,1.0,106,2015-12-03,TOR,DEN,2016,112.0
4853,4853,53,Home,L 105-108 ,240,37,74,0.5,22,43,0.512,15,31,0.484,16,26,0.615,105,37,81,0.457,26,50,0.52,11,31,0.355,23,38,0.605,108,2015-12-05,PHI,DEN,2016,113.5
4854,4854,54,@,L 105-108 ,240,39,86,0.453,27,57,0.474,12,29,0.414,15,22,0.682,105,44,83,0.53,39,66,0.591,5,17,0.294,15,22,0.682,108,2015-12-05,BOS,SAS,2016,110.5
4855,4855,55,@,L 105-110 ,240,39,82,0.476,24,47,0.511,15,35,0.429,12,17,0.706,105,45,81,0.556,38,63,0.603,7,18,0.389,13,16,0.813,110,2015-12-08,HOU,BRK,2016,113.5
4856,4856,56,Home,W 105-100 ,240,40,79,0.506,31,58,0.534,9,21,0.429,16,20,0.8,105,40,79,0.506,29,53,0.547,11,26,0.423,9,16,0.563,100,2015-12-08,CLE,POR,2016,105.5
4857,4857,57,Home,W 105-100 ,240,38,92,0.413,33,69,0.478,5,23,0.217,24,28,0.857,105,39,91,0.429,33,70,0.471,6,21,0.286,16,23,0.696,100,2015-12-09,BOS,CHI,2016,103.0
4858,4858,58,@,L 105-107 ,240,40,80,0.5,28,53,0.528,12,27,0.444,13,21,0.619,105,39,79,0.494,23,52,0.442,16,27,0.593,13,18,0.722,107,2015-12-11,WAS,NOP,2016,115.0
4859,4859,59,@,W 105-100 ,240,43,86,0.5,35,62,0.565,8,24,0.333,11,18,0.611,105,35,79,0.443,30,60,0.5,5,19,0.263,25,30,0.833,100,2015-12-12,LAC,BRK,2016,102.5
4860,4860,60,@,W 105-82 ,240,41,76,0.539,32,55,0.582,9,21,0.429,14,20,0.7,105,31,80,0.388,24,61,0.393,7,19,0.368,13,16,0.813,82,2015-12-14,ORL,BRK,2016,85.5
4861,4861,61,@,W 105-103 (OT),265,44,97,0.454,38,78,0.487,6,19,0.316,11,15,0.733,105,37,89,0.416,31,70,0.443,6,19,0.316,23,31,0.742,103,2015-12-14,LAC,DET,2016,106.0
4862,4862,62,Home,W 105-101 ,240,35,81,0.432,22,49,0.449,13,32,0.406,22,29,0.759,105,36,82,0.439,28,57,0.491,8,25,0.32,21,27,0.778,101,2015-12-14,POR,NOP,2016,105.0
4863,4863,63,@,W 105-102 ,240,43,94,0.457,36,74,0.486,7,20,0.35,12,14,0.857,105,43,95,0.453,34,69,0.493,9,26,0.346,7,13,0.538,102,2015-12-21,BRK,CHI,2016,106.5
4864,4864,64,@,W 105-96 ,240,40,92,0.435,33,74,0.446,7,18,0.389,18,20,0.9,105,37,96,0.385,31,72,0.431,6,24,0.25,16,23,0.696,96,2015-12-25,CHI,OKC,2016,99.0
4865,4865,65,Home,W 105-76 ,240,41,89,0.461,32,67,0.478,9,22,0.409,14,19,0.737,105,28,77,0.364,17,46,0.37,11,31,0.355,9,15,0.6,76,2015-12-26,POR,CLE,2016,81.5
4866,4866,66,Home,L 105-111 ,240,36,78,0.462,26,54,0.481,10,24,0.417,23,30,0.767,105,36,82,0.439,24,59,0.407,12,23,0.522,27,36,0.75,111,2015-12-28,MIA,BRK,2016,117.0
4867,4867,67,Home,L 105-110 ,240,36,74,0.486,28,49,0.571,8,25,0.32,25,41,0.61,105,40,94,0.426,31,63,0.492,9,31,0.29,21,34,0.618,110,2015-12-30,SAC,PHI,2016,114.5
4868,4868,68,@,W 105-98 ,240,40,83,0.482,34,63,0.54,6,20,0.3,19,24,0.792,105,36,83,0.434,26,57,0.456,10,26,0.385,16,19,0.842,98,2016-01-02,NOP,DAL,2016,103.0
4869,4869,69,@,L 105-120 ,240,36,83,0.434,29,65,0.446,7,18,0.389,26,31,0.839,105,49,94,0.521,39,70,0.557,10,24,0.417,12,15,0.8,120,2016-01-09,CHI,ATL,2016,125.0
4870,4870,70,@,W 105-99 ,240,42,76,0.553,29,53,0.547,13,23,0.565,8,10,0.8,105,38,74,0.514,33,60,0.55,5,14,0.357,18,24,0.75,99,2016-01-09,WAS,ORL,2016,101.5
4871,4871,71,@,W 105-92 ,240,39,72,0.542,34,60,0.567,5,12,0.417,22,26,0.846,105,33,87,0.379,24,51,0.471,9,36,0.25,17,22,0.773,92,2016-01-16,MIL,CHO,2016,96.5
4872,4872,72,Home,L 105-119 ,240,33,84,0.393,27,64,0.422,6,20,0.3,33,37,0.892,105,43,86,0.5,34,59,0.576,9,27,0.333,24,26,0.923,119,2016-01-25,DEN,ATL,2016,123.5
4873,4873,73,@,L 105-114 ,240,40,89,0.449,30,61,0.492,10,28,0.357,15,20,0.75,105,43,98,0.439,33,72,0.458,10,26,0.385,18,24,0.75,114,2016-01-28,SAC,NOP,2016,119.0
4874,4874,74,Home,W 105-93 ,240,40,81,0.494,32,55,0.582,8,26,0.308,17,24,0.708,105,34,78,0.436,29,65,0.446,5,13,0.385,20,25,0.8,93,2016-01-29,LAC,LAL,2016,95.5
4875,4875,75,@,L 105-109 (OT),265,40,87,0.46,36,69,0.522,4,18,0.222,21,25,0.84,105,44,100,0.44,35,73,0.479,9,27,0.333,12,16,0.75,109,2016-01-30,DEN,IND,2016,113.5
4876,4876,76,Home,W 105-103 ,240,43,93,0.462,32,66,0.485,11,27,0.407,8,10,0.8,105,40,84,0.476,31,64,0.484,9,20,0.45,14,23,0.609,103,2016-01-30,NOP,BRK,2016,107.5
4877,4877,77,Home,L 105-108 ,240,42,92,0.457,32,63,0.508,10,29,0.345,11,21,0.524,105,47,95,0.495,34,65,0.523,13,30,0.433,1,2,0.5,108,2016-01-30,PHI,GSW,2016,114.5
4878,4878,78,Home,W 105-87 ,240,39,81,0.481,34,61,0.557,5,20,0.25,22,26,0.846,105,27,70,0.386,22,48,0.458,5,22,0.227,28,32,0.875,87,2016-01-31,MIA,ATL,2016,89.5
4879,4879,79,@,W 105-100 ,240,42,98,0.429,32,68,0.471,10,30,0.333,11,16,0.688,105,40,82,0.488,33,66,0.5,7,16,0.438,13,15,0.867,100,2016-02-01,DET,BRK,2016,103.5
4880,4880,80,Home,W 105-96 (OT),265,38,85,0.447,31,67,0.463,7,18,0.389,22,33,0.667,105,39,90,0.433,34,69,0.493,5,21,0.238,13,20,0.65,96,2016-02-01,UTA,CHI,2016,98.5
4881,4881,81,@,L 105-111 ,240,36,84,0.429,30,62,0.484,6,22,0.273,27,34,0.794,105,40,79,0.506,31,62,0.5,9,17,0.529,22,33,0.667,111,2016-02-04,NYK,DET,2016,115.5
4882,4882,82,Home,L 105-111 ,240,32,83,0.386,21,54,0.389,11,29,0.379,30,32,0.938,105,37,86,0.43,22,44,0.5,15,42,0.357,22,32,0.688,111,2016-02-04,PHO,HOU,2016,118.5
4883,4883,83,@,L 105-112 ,240,40,85,0.471,32,65,0.492,8,20,0.4,17,19,0.895,105,45,87,0.517,44,75,0.587,1,12,0.083,21,22,0.955,112,2016-02-06,CHI,MIN,2016,112.5
4884,4884,84,Home,W 105-104 ,240,42,81,0.519,33,62,0.532,9,19,0.474,12,15,0.8,105,42,90,0.467,33,65,0.508,9,25,0.36,11,13,0.846,104,2016-02-08,BRK,DEN,2016,108.5
4885,4885,85,Home,W 105-86 ,240,39,78,0.5,27,53,0.509,12,25,0.48,15,20,0.75,105,35,83,0.422,31,66,0.47,4,17,0.235,12,15,0.8,86,2016-02-18,LAC,SAS,2016,88.0
4886,4886,86,@,L 105-137 ,240,36,92,0.391,24,58,0.414,12,34,0.353,21,28,0.75,105,52,97,0.536,35,67,0.522,17,30,0.567,16,23,0.696,137,2016-02-19,GSW,POR,2016,145.5
4887,4887,87,@,W 105-102 ,240,41,82,0.5,32,58,0.552,9,24,0.375,14,21,0.667,105,38,91,0.418,31,66,0.47,7,25,0.28,19,29,0.655,102,2016-02-21,IND,ORL,2016,105.5
4888,4888,88,@,L 105-108 ,240,35,77,0.455,22,51,0.431,13,26,0.5,22,25,0.88,105,46,91,0.505,43,76,0.566,3,15,0.2,13,16,0.813,108,2016-02-24,NYK,IND,2016,109.5
4889,4889,89,@,L 105-114 ,240,37,74,0.5,31,64,0.484,6,10,0.6,25,33,0.758,105,41,85,0.482,31,59,0.525,10,26,0.385,22,26,0.846,114,2016-02-24,MIN,TOR,2016,119.0
4890,4890,90,Home,L 105-119 ,240,37,80,0.463,24,45,0.533,13,35,0.371,18,22,0.818,105,44,82,0.537,34,53,0.642,10,29,0.345,21,35,0.6,119,2016-02-25,POR,HOU,2016,124.0
4891,4891,91,Home,W 105-95 ,240,41,83,0.494,32,60,0.533,9,23,0.391,14,16,0.875,105,32,77,0.416,24,58,0.414,8,19,0.421,23,33,0.697,95,2016-02-29,LAC,BRK,2016,99.0
4892,4892,92,@,L 105-109 (OT),265,37,80,0.463,25,47,0.532,12,33,0.364,19,24,0.792,105,41,103,0.398,29,67,0.433,12,36,0.333,15,17,0.882,109,2016-03-01,ATL,GSW,2016,115.0
4893,4893,93,Home,W 105-104 ,240,41,90,0.456,37,70,0.529,4,20,0.2,19,25,0.76,105,42,92,0.457,33,69,0.478,9,23,0.391,11,14,0.786,104,2016-03-04,BOS,NYK,2016,108.5
4894,4894,94,Home,L 105-112 ,240,41,85,0.482,33,63,0.524,8,22,0.364,15,18,0.833,105,38,81,0.469,29,53,0.547,9,28,0.321,27,29,0.931,112,2016-03-12,DAL,IND,2016,116.5
4895,4895,95,Home,W 105-91 ,240,37,77,0.481,24,49,0.49,13,28,0.464,18,25,0.72,105,36,82,0.439,27,61,0.443,9,21,0.429,10,12,0.833,91,2016-03-18,TOR,BOS,2016,95.5
4896,4896,96,@,L 105-109 ,240,33,82,0.402,23,43,0.535,10,39,0.256,29,42,0.69,105,35,71,0.493,28,50,0.56,7,21,0.333,32,40,0.8,109,2016-03-20,LAC,NOP,2016,112.5
4897,4897,97,Home,L 105-120 ,240,39,92,0.424,31,71,0.437,8,21,0.381,19,27,0.704,105,46,94,0.489,36,69,0.522,10,25,0.4,18,21,0.857,120,2016-03-20,PHI,BOS,2016,125.0
4898,4898,98,Home,W 105-100 ,240,35,81,0.432,29,61,0.475,6,20,0.3,29,45,0.644,105,40,83,0.482,32,61,0.525,8,22,0.364,12,18,0.667,100,2016-03-20,TOR,ORL,2016,104.0
4899,4899,99,@,W 105-100 ,240,39,82,0.476,29,54,0.537,10,28,0.357,17,21,0.81,105,34,74,0.459,26,56,0.464,8,18,0.444,24,27,0.889,100,2016-03-22,CHA,BRK,2016,104.0
4900,4900,0,@,L 105-112 ,240,37,93,0.398,23,63,0.365,14,30,0.467,17,22,0.773,105,42,91,0.462,34,61,0.557,8,30,0.267,20,26,0.769,112,2016-03-25,CHA,DET,2016,116.0
4901,4901,1,Home,L 105-116 ,240,37,85,0.435,27,62,0.435,10,23,0.435,21,26,0.808,105,45,94,0.479,35,68,0.515,10,26,0.385,16,24,0.667,116,2016-03-25,LAL,DEN,2016,121.0
4902,4902,2,@,L 105-108 ,240,39,93,0.419,29,55,0.527,10,38,0.263,17,24,0.708,105,38,91,0.418,30,66,0.455,8,25,0.32,24,30,0.8,108,2016-03-26,PHI,POR,2016,112.0
4903,4903,3,@,L 105-117 ,240,42,90,0.467,32,60,0.533,10,30,0.333,11,12,0.917,105,44,83,0.53,30,50,0.6,14,33,0.424,15,20,0.75,117,2016-03-27,PHI,GSW,2016,124.0
4904,4904,4,Home,W 105-90 ,240,38,80,0.475,28,52,0.538,10,28,0.357,19,26,0.731,105,37,94,0.394,30,65,0.462,7,29,0.241,9,13,0.692,90,2016-03-27,LAC,DEN,2016,93.5
4905,4905,5,Home,W 105-93 ,240,38,80,0.475,24,51,0.471,14,29,0.483,15,18,0.833,105,37,89,0.416,30,74,0.405,7,15,0.467,12,19,0.632,93,2016-03-28,POR,SAC,2016,96.5
4906,4906,6,@,L 105-139 ,240,37,79,0.468,32,65,0.492,5,14,0.357,26,39,0.667,105,56,91,0.615,42,64,0.656,14,27,0.519,13,19,0.684,139,2016-03-29,BRK,ORL,2016,146.0
4907,4907,7,Home,L 105-109 ,240,41,95,0.432,35,76,0.461,6,19,0.316,17,27,0.63,105,38,78,0.487,25,49,0.51,13,29,0.448,20,24,0.833,109,2016-03-30,MEM,DEN,2016,115.5
4908,4908,8,Home,W 105-94 ,240,37,77,0.481,31,62,0.5,6,15,0.4,25,34,0.735,105,38,84,0.452,33,60,0.55,5,24,0.208,13,17,0.765,94,2016-03-30,MIL,PHO,2016,96.5
4909,4909,9,Home,W 105-97 ,240,36,80,0.45,25,57,0.439,11,23,0.478,22,28,0.786,105,37,83,0.446,23,50,0.46,14,33,0.424,9,13,0.692,97,2016-03-30,TOR,ATL,2016,104.0
4910,4910,10,Home,W 105-91 ,240,42,84,0.5,28,61,0.459,14,23,0.609,7,7,1.0,105,36,101,0.356,32,77,0.416,4,24,0.167,15,20,0.75,91,2016-04-01,NYK,BRK,2016,93.0
4911,4911,11,@,W 105-97 ,240,36,80,0.45,25,59,0.424,11,21,0.524,22,31,0.71,105,36,85,0.424,30,68,0.441,6,17,0.353,19,21,0.905,97,2016-04-07,MIN,SAC,2016,100.0
4912,4912,12,Home,W 105-102 ,240,40,89,0.449,32,65,0.492,8,24,0.333,17,21,0.81,105,36,83,0.434,17,43,0.395,19,40,0.475,11,18,0.611,102,2016-04-09,CHI,CLE,2016,111.5
4913,4913,13,Home,L 105-106 ,240,40,80,0.5,31,56,0.554,9,24,0.375,16,18,0.889,105,41,84,0.488,36,71,0.507,5,13,0.385,19,25,0.76,106,2016-04-09,POR,MIN,2016,108.5
4914,4914,14,@,L 105-129 ,240,35,91,0.385,21,54,0.389,14,37,0.378,21,26,0.808,105,48,86,0.558,37,59,0.627,11,27,0.407,22,27,0.815,129,2016-04-10,BRK,IND,2016,134.5
4915,4915,15,Home,L 105-129 ,240,38,83,0.458,33,62,0.532,5,21,0.238,24,33,0.727,105,48,86,0.558,33,56,0.589,15,30,0.5,18,26,0.692,129,2016-04-11,MIN,HOU,2016,136.5
4916,4916,16,@,W 105-101 ,240,41,83,0.494,35,66,0.53,6,17,0.353,17,28,0.607,105,41,100,0.41,36,78,0.462,5,22,0.227,14,17,0.824,101,2016-04-11,SAC,PHO,2016,103.5
4917,4917,17,@,L 105-115 ,240,37,81,0.457,20,46,0.435,17,35,0.486,14,18,0.778,105,39,83,0.47,24,59,0.407,15,24,0.625,22,27,0.815,115,2016-04-13,PHI,CHI,2016,122.5
4918,4918,18,@,L 105-114 ,240,43,96,0.448,34,65,0.523,9,31,0.29,10,12,0.833,105,45,99,0.455,38,73,0.521,7,26,0.269,17,22,0.773,114,2016-04-13,LAC,PHO,2016,117.5
4919,4919,19,Home,W 105-99 ,240,36,92,0.391,25,67,0.373,11,25,0.44,22,30,0.733,105,38,76,0.5,30,53,0.566,8,23,0.348,15,24,0.625,99,2016-10-27,CHI,BOS,2017,103.0
4920,4920,20,Home,W 105-99 ,240,36,88,0.409,25,51,0.49,11,37,0.297,22,30,0.733,105,38,84,0.452,30,56,0.536,8,28,0.286,15,26,0.577,99,2016-10-29,CLE,ORL,2017,103.0
4921,4921,21,Home,W 105-102 ,240,41,88,0.466,37,72,0.514,4,16,0.25,19,25,0.76,105,33,81,0.407,24,59,0.407,9,22,0.409,27,35,0.771,102,2016-10-31,TOR,DEN,2017,106.5
4922,4922,22,@,W 105-95 ,240,36,80,0.45,24,49,0.49,12,31,0.387,21,26,0.808,105,34,83,0.41,24,55,0.436,10,28,0.357,17,20,0.85,95,2016-11-04,POR,DAL,2017,100.0
4923,4923,23,@,L 105-109 (OT),265,39,88,0.443,34,69,0.493,5,19,0.263,22,23,0.957,105,36,86,0.419,25,54,0.463,11,32,0.344,26,31,0.839,109,2016-11-11,IND,PHI,2017,114.5
4924,4924,24,@,W 105-94 ,240,36,86,0.419,22,53,0.415,14,33,0.424,19,26,0.731,105,38,87,0.437,35,72,0.486,3,15,0.2,15,19,0.789,94,2016-11-11,CLE,WAS,2017,95.5
4925,4925,25,@,W 105-99 ,240,35,80,0.438,27,55,0.491,8,25,0.32,27,33,0.818,105,36,86,0.419,30,59,0.508,6,27,0.222,21,28,0.75,99,2016-11-12,BOS,IND,2017,102.0
4926,4926,26,Home,L 105-119 ,240,40,89,0.449,32,67,0.478,8,22,0.364,17,21,0.81,105,40,76,0.526,29,52,0.558,11,24,0.458,28,37,0.757,119,2016-11-12,MIN,LAC,2017,124.5
4927,4927,27,@,L 105-112 ,240,36,91,0.396,25,62,0.403,11,29,0.379,22,29,0.759,105,39,99,0.394,31,70,0.443,8,29,0.276,26,32,0.813,112,2016-11-13,DEN,POR,2017,116.0
4928,4928,28,@,L 105-106 ,240,38,95,0.4,26,54,0.481,12,41,0.293,17,20,0.85,105,35,79,0.443,29,58,0.5,6,21,0.286,30,36,0.833,106,2016-11-14,BOS,NOP,2017,109.0
4929,4929,29,Home,W 105-102 ,240,42,93,0.452,33,68,0.485,9,25,0.36,12,19,0.632,105,42,85,0.494,34,62,0.548,8,23,0.348,10,12,0.833,102,2016-11-16,NYK,DET,2017,106.0
4930,4930,30,Home,W 105-103 ,240,40,84,0.476,28,59,0.475,12,25,0.48,13,14,0.929,105,40,92,0.435,26,52,0.5,14,40,0.35,9,14,0.643,103,2016-11-16,OKC,HOU,2017,110.0
4931,4931,31,Home,L 105-110 ,240,36,76,0.474,27,56,0.482,9,20,0.45,24,31,0.774,105,43,88,0.489,32,58,0.552,11,30,0.367,13,17,0.765,110,2016-11-16,SAC,SAS,2017,115.5
4932,4932,32,@,L 105-124 ,240,35,83,0.422,24,54,0.444,11,29,0.379,24,30,0.8,105,49,89,0.551,42,63,0.667,7,26,0.269,19,24,0.792,124,2016-11-18,BRK,OKC,2017,127.5
4933,4933,33,@,L 105-120 ,240,39,92,0.424,33,71,0.465,6,21,0.286,21,34,0.618,105,45,86,0.523,28,51,0.549,17,35,0.486,13,20,0.65,120,2016-11-19,PHO,PHI,2017,128.5
4934,4934,34,Home,W 105-91 ,240,42,86,0.488,34,64,0.531,8,22,0.364,13,30,0.433,105,33,85,0.388,26,59,0.441,7,26,0.269,18,23,0.783,91,2016-11-20,DEN,UTA,2017,94.5
4935,4935,35,@,W 105-90 ,240,40,84,0.476,28,58,0.483,12,26,0.462,13,17,0.765,105,30,73,0.411,21,42,0.5,9,31,0.29,21,33,0.636,90,2016-11-21,MEM,CHO,2017,94.5
4936,4936,36,@,W 105-99 ,240,38,82,0.463,24,50,0.48,14,32,0.438,15,19,0.789,105,40,79,0.506,28,50,0.56,12,29,0.414,7,12,0.583,99,2016-11-25,TOR,MIL,2017,105.0
4937,4937,37,@,W 105-89 ,240,40,90,0.444,34,69,0.493,6,21,0.286,19,26,0.731,105,31,78,0.397,22,56,0.393,9,22,0.409,18,22,0.818,89,2016-11-25,CHI,PHI,2017,93.5
4938,4938,38,Home,L 105-122 ,240,38,87,0.437,22,48,0.458,16,39,0.41,13,14,0.929,105,46,86,0.535,33,63,0.524,13,23,0.565,17,22,0.773,122,2016-11-27,BRK,SAC,2017,128.5
4939,4939,39,Home,W 105-100 ,240,37,85,0.435,25,50,0.5,12,35,0.343,19,24,0.792,105,36,86,0.419,29,57,0.509,7,29,0.241,21,30,0.7,100,2016-11-28,GSW,ATL,2017,103.5
4940,4940,40,Home,W 105-88 ,240,38,88,0.432,30,57,0.526,8,31,0.258,21,25,0.84,105,37,87,0.425,32,57,0.561,5,30,0.167,9,18,0.5,88,2016-11-29,NOP,LAL,2017,90.5
4941,4941,41,@,L 105-120 ,240,36,81,0.444,25,54,0.463,11,27,0.407,22,26,0.846,105,38,69,0.551,22,37,0.595,16,32,0.5,28,33,0.848,120,2016-11-30,MEM,TOR,2017,128.0
4942,4942,42,@,L 105-111 ,240,45,83,0.542,35,57,0.614,10,26,0.385,5,10,0.5,105,47,96,0.49,44,78,0.564,3,18,0.167,14,17,0.824,111,2016-12-02,CLE,CHI,2017,112.5
4943,4943,43,@,W 105-88 ,240,37,78,0.474,24,52,0.462,13,26,0.5,18,26,0.692,105,36,95,0.379,27,63,0.429,9,32,0.281,7,10,0.7,88,2016-12-02,ORL,PHI,2017,92.5
4944,4944,44,@,L 105-107 ,240,41,81,0.506,34,70,0.486,7,11,0.636,16,18,0.889,105,39,80,0.488,31,60,0.517,8,20,0.4,21,33,0.636,107,2016-12-02,WAS,SAS,2017,111.0
4945,4945,45,Home,W 105-98 ,240,35,78,0.449,26,53,0.491,9,25,0.36,26,28,0.929,105,37,83,0.446,24,59,0.407,13,24,0.542,11,14,0.786,98,2016-12-03,UTA,DEN,2017,104.5
4946,4946,46,@,W 105-91 ,240,39,74,0.527,28,50,0.56,11,24,0.458,16,19,0.842,105,36,82,0.439,29,62,0.468,7,20,0.35,12,18,0.667,91,2016-12-06,SAS,MIN,2017,94.5
4947,4947,47,@,L 105-112 ,240,39,84,0.464,33,66,0.5,6,18,0.333,21,25,0.84,105,36,73,0.493,24,46,0.522,12,27,0.444,28,32,0.875,112,2016-12-06,PHO,UTA,2017,118.0
4948,4948,48,Home,W 105-100 ,240,38,84,0.452,37,76,0.487,1,8,0.125,28,31,0.903,105,42,91,0.462,37,71,0.521,5,20,0.25,11,18,0.611,100,2016-12-10,CHI,MIA,2017,102.5
4949,4949,49,@,L 105-116 ,240,39,86,0.453,29,59,0.492,10,27,0.37,17,24,0.708,105,42,73,0.575,29,42,0.69,13,31,0.419,19,28,0.679,116,2016-12-10,CHA,CLE,2017,122.5
4950,4950,50,@,L 105-133 ,240,40,83,0.482,32,64,0.5,8,19,0.421,17,26,0.654,105,54,94,0.574,37,58,0.638,17,36,0.472,8,9,0.889,133,2016-12-10,NOP,LAC,2017,141.5
4951,4951,51,@,L 105-110 ,240,40,79,0.506,27,54,0.5,13,25,0.52,12,15,0.8,105,40,88,0.455,32,67,0.478,8,21,0.381,22,28,0.786,110,2016-12-10,MIL,WAS,2017,114.0
4952,4952,52,@,W 105-90 ,240,40,83,0.482,34,64,0.531,6,19,0.316,19,25,0.76,105,32,84,0.381,22,54,0.407,10,30,0.333,16,22,0.727,90,2016-12-17,IND,DET,2017,95.0
4953,4953,53,@,W 105-95 ,240,41,90,0.456,32,62,0.516,9,28,0.321,14,19,0.737,105,36,69,0.522,27,45,0.6,9,24,0.375,14,25,0.56,95,2016-12-18,BOS,MIA,2017,99.5
4954,4954,54,@,L 105-107 ,240,38,88,0.432,30,55,0.545,8,33,0.242,21,26,0.808,105,41,87,0.471,34,66,0.515,7,21,0.333,18,21,0.857,107,2016-12-19,WAS,IND,2017,110.5
4955,4955,55,Home,L 105-109 ,240,36,79,0.456,24,47,0.511,12,32,0.375,21,26,0.808,105,42,80,0.525,27,51,0.529,15,29,0.517,10,14,0.714,109,2016-12-23,MIN,SAC,2017,116.5
4956,4956,56,Home,W 105-103 ,240,42,81,0.519,32,53,0.604,10,28,0.357,11,14,0.786,105,42,94,0.447,35,69,0.507,7,25,0.28,12,17,0.706,103,2016-12-28,DEN,MIN,2017,106.5
4957,4957,57,@,L 105-111 ,240,35,79,0.443,24,51,0.471,11,28,0.393,24,29,0.828,105,38,78,0.487,30,56,0.536,8,22,0.364,27,37,0.73,111,2016-12-28,IND,WAS,2017,115.0
4958,4958,58,Home,W 105-98 ,240,39,88,0.443,31,62,0.5,8,26,0.308,19,25,0.76,105,35,84,0.417,26,53,0.491,9,31,0.29,19,21,0.905,98,2016-12-30,ATL,DET,2017,102.5
4959,4959,59,@,L 105-113 ,240,41,92,0.446,30,62,0.484,11,30,0.367,12,14,0.857,105,37,78,0.474,20,46,0.435,17,32,0.531,22,24,0.917,113,2017-01-03,WAS,DAL,2017,121.5
4960,4960,60,@,W 105-104 ,240,37,78,0.474,28,50,0.56,9,28,0.321,22,31,0.71,105,42,94,0.447,29,66,0.439,13,28,0.464,7,12,0.583,104,2017-01-04,MIL,NYK,2017,110.5
4961,4961,61,@,L 105-112 ,240,42,88,0.477,35,70,0.5,7,18,0.389,14,17,0.824,105,46,79,0.582,34,57,0.596,12,22,0.545,8,9,0.889,112,2017-01-06,MIN,WAS,2017,118.0
4962,4962,62,@,W 105-95 ,240,37,94,0.394,29,67,0.433,8,27,0.296,23,27,0.852,105,36,78,0.462,26,51,0.51,10,27,0.37,13,17,0.765,95,2017-01-08,PHI,BRK,2017,100.0
4963,4963,63,Home,W 105-96 ,240,39,76,0.513,30,50,0.6,9,26,0.346,18,26,0.692,105,39,92,0.424,33,65,0.508,6,27,0.222,12,18,0.667,96,2017-01-11,LAC,ORL,2017,99.0
4964,4964,64,@,L 105-119 ,240,36,87,0.414,21,45,0.467,15,42,0.357,18,22,0.818,105,44,81,0.543,36,58,0.621,8,23,0.348,23,25,0.92,119,2017-01-11,HOU,MIN,2017,123.0
4965,4965,65,Home,L 105-110 ,240,33,82,0.402,23,41,0.561,10,41,0.244,29,36,0.806,105,41,76,0.539,31,49,0.633,10,27,0.37,18,27,0.667,110,2017-01-13,HOU,MEM,2017,115.0
4966,4966,66,@,L 105-108 ,240,36,71,0.507,27,51,0.529,9,20,0.45,24,34,0.706,105,39,85,0.459,31,64,0.484,8,21,0.381,22,24,0.917,108,2017-01-14,SAS,PHO,2017,112.0
4967,4967,67,@,L 105-112 ,240,38,89,0.427,21,48,0.438,17,41,0.415,12,15,0.8,105,39,82,0.476,25,53,0.472,14,29,0.483,20,22,0.909,112,2017-01-21,BRK,CHO,2017,119.0
4968,4968,68,Home,L 105-107 ,240,40,89,0.449,29,68,0.426,11,21,0.524,14,16,0.875,105,37,85,0.435,28,61,0.459,9,24,0.375,24,27,0.889,107,2017-01-21,NYK,PHO,2017,111.5
4969,4969,69,Home,L 105-115 ,240,37,88,0.42,28,59,0.475,9,29,0.31,22,26,0.846,105,42,84,0.5,28,60,0.467,14,24,0.583,17,22,0.773,115,2017-01-23,ATL,LAC,2017,122.0
4970,4970,70,Home,W 105-102 ,240,38,86,0.442,25,56,0.446,13,30,0.433,16,27,0.593,105,41,88,0.466,33,58,0.569,8,30,0.267,12,20,0.6,102,2017-01-23,MIA,GSW,2017,106.0
4971,4971,71,Home,L 105-114 ,240,41,96,0.427,30,69,0.435,11,27,0.407,12,19,0.632,105,42,91,0.462,32,64,0.5,10,27,0.37,20,28,0.714,114,2017-01-25,NOP,OKC,2017,119.0
4972,4972,72,Home,W 105-98 ,240,43,90,0.478,39,75,0.52,4,15,0.267,15,20,0.75,105,37,94,0.394,26,65,0.4,11,29,0.379,13,14,0.929,98,2017-01-25,POR,LAL,2017,103.5
4973,4973,73,@,W 105-101 ,240,39,87,0.448,27,53,0.509,12,34,0.353,15,16,0.938,105,39,83,0.47,31,61,0.508,8,22,0.364,15,23,0.652,101,2017-01-29,DAL,SAS,2017,105.0
4974,4974,74,@,L 105-111 (OT),265,41,96,0.427,31,61,0.508,10,35,0.286,13,19,0.684,105,40,92,0.435,28,63,0.444,12,29,0.414,19,26,0.731,111,2017-01-30,ORL,MIN,2017,117.0
4975,4975,75,Home,W 105-83 ,240,38,85,0.447,24,40,0.6,14,45,0.311,15,22,0.682,105,30,86,0.349,22,57,0.386,8,29,0.276,15,26,0.577,83,2017-01-31,HOU,SAC,2017,87.0
4976,4976,76,@,W 105-103 ,240,32,77,0.416,20,48,0.417,12,29,0.414,29,35,0.829,105,38,85,0.447,28,58,0.483,10,27,0.37,17,22,0.773,103,2017-02-03,PHO,SAC,2017,108.0
4977,4977,77,Home,W 105-84 ,240,44,91,0.484,37,67,0.552,7,24,0.292,10,15,0.667,105,31,75,0.413,25,58,0.431,6,17,0.353,16,20,0.8,84,2017-02-04,IND,DET,2017,87.0
4978,4978,78,Home,W 105-98 ,240,38,81,0.469,25,48,0.521,13,33,0.394,16,24,0.667,105,35,82,0.427,22,49,0.449,13,33,0.394,15,18,0.833,98,2017-02-04,UTA,CHO,2017,104.5
4979,4979,79,Home,W 105-91 ,240,38,83,0.458,28,52,0.538,10,31,0.323,19,22,0.864,105,37,84,0.44,32,67,0.478,5,17,0.294,12,22,0.545,91,2017-02-04,WAS,NOP,2017,93.5
4980,4980,80,Home,W 105-99 ,240,40,98,0.408,36,80,0.45,4,18,0.222,21,28,0.75,105,35,87,0.402,25,59,0.424,10,28,0.357,19,21,0.905,99,2017-02-05,OKC,POR,2017,104.0
4981,4981,81,@,L 105-112 (OT),265,39,85,0.459,26,56,0.464,13,29,0.448,14,17,0.824,105,44,87,0.506,39,67,0.582,5,20,0.25,19,25,0.76,112,2017-02-09,UTA,DAL,2017,114.5
4982,4982,82,Home,W 105-99 ,240,35,78,0.449,24,47,0.511,11,31,0.355,24,27,0.889,105,34,82,0.415,21,51,0.412,13,31,0.419,18,21,0.857,99,2017-02-12,SAC,NOP,2017,105.5
4983,4983,83,@,W 105-99 ,240,41,86,0.477,29,53,0.547,12,33,0.364,11,17,0.647,105,34,78,0.436,23,47,0.489,11,31,0.355,20,26,0.769,99,2017-02-13,PHI,CHO,2017,104.5
4984,4984,84,Home,W 105-94 ,240,35,73,0.479,28,56,0.5,7,17,0.412,28,35,0.8,105,35,77,0.455,30,57,0.526,5,20,0.25,19,24,0.792,94,2017-02-14,CHI,TOR,2017,96.5
4985,4985,85,@,L 105-116 ,240,41,86,0.477,30,65,0.462,11,21,0.524,12,14,0.857,105,41,88,0.466,29,65,0.446,12,23,0.522,22,31,0.71,116,2017-02-15,NYK,OKC,2017,122.0
4986,4986,86,@,W 105-97 ,240,35,82,0.427,26,56,0.464,9,26,0.346,26,30,0.867,105,35,79,0.443,28,56,0.5,7,23,0.304,20,24,0.833,97,2017-02-24,SAS,LAC,2017,100.5
4987,4987,87,Home,W 105-86 ,240,37,81,0.457,29,54,0.537,8,27,0.296,23,24,0.958,105,32,85,0.376,24,60,0.4,8,25,0.32,14,26,0.538,86,2017-02-25,ORL,ATL,2017,90.0
4988,4988,88,@,W 105-98 ,240,36,80,0.45,25,47,0.532,11,33,0.333,22,25,0.88,105,37,84,0.44,26,50,0.52,11,34,0.324,13,17,0.765,98,2017-02-26,MEM,DEN,2017,103.5
4989,4989,89,@,W 105-96 ,240,40,84,0.476,31,59,0.525,9,25,0.36,16,19,0.842,105,33,90,0.367,26,70,0.371,7,20,0.35,23,26,0.885,96,2017-03-01,WAS,TOR,2017,99.5
4990,4990,90,Home,W 105-102 ,240,36,83,0.434,27,55,0.491,9,28,0.321,24,31,0.774,105,33,84,0.393,26,63,0.413,7,21,0.333,29,33,0.879,102,2017-03-03,PHI,NYK,2017,105.5
4991,4991,91,@,W 105-97 ,240,36,89,0.404,27,65,0.415,9,24,0.375,24,35,0.686,105,38,83,0.458,28,55,0.509,10,28,0.357,11,15,0.733,97,2017-03-05,NOP,LAL,2017,102.0
4992,4992,92,Home,L 105-112 ,240,39,83,0.47,32,61,0.525,7,22,0.318,20,25,0.8,105,40,88,0.455,27,53,0.509,13,35,0.371,19,23,0.826,112,2017-03-05,NYK,GSW,2017,118.5
4993,4993,93,Home,L 105-113 ,240,40,85,0.471,31,53,0.585,9,32,0.281,16,24,0.667,105,40,86,0.465,34,72,0.472,6,14,0.429,27,28,0.964,113,2017-03-06,ORL,NYK,2017,116.0
4994,4994,94,@,L 105-110 ,240,37,80,0.463,26,46,0.565,11,34,0.324,20,25,0.8,105,41,95,0.432,37,75,0.493,4,20,0.2,24,32,0.75,110,2017-03-08,BRK,ATL,2017,112.0
4995,4995,95,@,L 104-106 ,240,39,76,0.513,37,71,0.521,2,5,0.4,24,31,0.774,104,35,74,0.473,26,54,0.481,9,20,0.45,27,34,0.794,106,2011-12-25,BOS,NYK,2012,110.5
4996,4996,96,@,W 104-96 ,240,42,79,0.532,33,58,0.569,9,21,0.429,11,13,0.846,104,35,85,0.412,29,65,0.446,6,20,0.3,20,28,0.714,96,2011-12-26,TOR,CLE,2012,99.0
4997,4997,97,@,W 104-100 ,240,35,78,0.449,30,62,0.484,5,16,0.313,29,31,0.935,104,39,87,0.448,36,65,0.554,3,22,0.136,19,26,0.731,100,2011-12-26,OKC,MIN,2012,101.5
4998,4998,98,Home,W 104-95 ,240,44,83,0.53,35,61,0.574,9,22,0.409,7,10,0.7,104,36,82,0.439,30,55,0.545,6,27,0.222,17,20,0.85,95,2011-12-26,ORL,HOU,2012,98.0
4999,4999,99,Home,W 104-102 ,240,37,63,0.587,31,49,0.633,6,14,0.429,24,32,0.75,104,38,90,0.422,29,64,0.453,9,26,0.346,17,21,0.81,102,2011-12-29,OKC,DAL,2012,106.5
5000,5000,0,Home,W 104-89 ,240,36,74,0.486,26,58,0.448,10,16,0.625,22,31,0.71,104,33,89,0.371,31,73,0.425,2,16,0.125,21,25,0.84,89,2011-12-31,SAS,UTA,2012,90.0
5001,5001,1,Home,W 104-64 ,240,39,84,0.464,34,71,0.479,5,13,0.385,21,29,0.724,104,26,84,0.31,25,75,0.333,1,9,0.111,11,14,0.786,64,2012-01-01,CHI,MEM,2012,64.5
5002,5002,2,@,W 104-97 ,240,37,87,0.425,27,55,0.491,10,32,0.313,20,31,0.645,104,38,73,0.521,35,53,0.66,3,20,0.15,18,24,0.75,97,2012-01-08,ORL,SAC,2012,98.5
5003,5003,3,Home,L 104-107 ,240,41,86,0.477,31,61,0.508,10,25,0.4,12,13,0.923,104,41,70,0.586,25,43,0.581,16,27,0.593,9,19,0.474,107,2012-01-11,POR,ORL,2012,115.0
5004,5004,4,@,L 104-117 ,240,38,81,0.469,31,65,0.477,7,16,0.438,21,29,0.724,104,43,78,0.551,31,53,0.585,12,25,0.48,19,26,0.731,117,2012-01-13,MIA,DEN,2012,123.0
5005,5005,5,Home,W 104-92 ,240,34,71,0.479,27,53,0.509,7,18,0.389,29,34,0.853,104,34,83,0.41,29,64,0.453,5,19,0.263,19,23,0.826,92,2012-01-14,OKC,NYK,2012,94.5
5006,5006,6,Home,L 104-108 (OT),265,43,98,0.439,39,84,0.464,4,14,0.286,14,19,0.737,104,43,89,0.483,36,71,0.507,7,18,0.389,15,22,0.682,108,2012-01-18,PHI,DEN,2012,111.5
5007,5007,7,Home,L 104-108 ,240,40,95,0.421,29,69,0.42,11,26,0.423,13,17,0.765,104,39,79,0.494,29,58,0.5,10,21,0.476,20,30,0.667,108,2012-01-20,WAS,DEN,2012,113.0
5008,5008,8,@,W 104-102 ,240,41,75,0.547,34,59,0.576,7,16,0.438,15,20,0.75,104,42,83,0.506,36,71,0.507,6,12,0.5,12,13,0.923,102,2012-01-23,SAS,NOH,2012,105.0
5009,5009,9,Home,W 104-99 ,240,41,87,0.471,37,73,0.507,4,14,0.286,18,22,0.818,104,37,78,0.474,33,68,0.485,4,10,0.4,21,23,0.913,99,2012-02-07,IND,UTA,2012,101.0
5010,5010,10,@,W 104-97 ,240,39,90,0.433,30,69,0.435,9,21,0.429,17,23,0.739,104,32,79,0.405,26,56,0.464,6,23,0.261,27,31,0.871,97,2012-02-10,DAL,MIN,2012,100.0
5011,5011,11,Home,W 104-103 ,240,37,73,0.507,33,63,0.524,4,10,0.4,26,38,0.684,104,35,82,0.427,23,56,0.411,12,26,0.462,21,27,0.778,103,2012-02-18,MEM,GSW,2012,109.0
5012,5012,12,Home,W 104-97 ,240,40,86,0.465,28,57,0.491,12,29,0.414,12,18,0.667,104,36,81,0.444,24,48,0.5,12,33,0.364,13,17,0.765,97,2012-02-19,NYK,DAL,2012,103.0
5013,5013,13,Home,W 104-97 ,240,38,83,0.458,29,60,0.483,9,23,0.391,19,24,0.792,104,33,77,0.429,22,51,0.431,11,26,0.423,20,27,0.741,97,2012-02-20,GSW,LAC,2012,102.5
5014,5014,14,Home,W 104-88 ,240,37,79,0.468,30,58,0.517,7,21,0.333,23,29,0.793,104,36,84,0.429,31,64,0.484,5,20,0.25,11,19,0.579,88,2012-02-20,PHO,WAS,2012,90.5
5015,5015,15,@,L 104-119 ,240,34,70,0.486,27,52,0.519,7,18,0.389,29,34,0.853,104,42,84,0.5,33,65,0.508,9,19,0.474,26,35,0.743,119,2012-02-22,BOS,OKC,2012,123.5
5016,5016,16,Home,L 104-106 ,240,43,90,0.478,39,71,0.549,4,19,0.211,14,20,0.7,104,39,84,0.464,30,64,0.469,9,20,0.45,19,22,0.864,106,2012-02-22,PHO,GSW,2012,110.5
5017,5017,17,Home,W 104-95 ,240,44,91,0.484,38,70,0.543,6,21,0.286,10,16,0.625,104,38,87,0.437,29,63,0.46,9,24,0.375,10,11,0.909,95,2012-02-29,DEN,POR,2012,99.5
5018,5018,18,Home,W 104-85 ,240,41,84,0.488,36,63,0.571,5,21,0.238,17,22,0.773,104,35,89,0.393,30,70,0.429,5,19,0.263,10,18,0.556,85,2012-02-29,LAL,MIN,2012,87.5
5019,5019,19,Home,W 104-83 ,240,42,87,0.483,38,75,0.507,4,12,0.333,16,16,1.0,104,32,82,0.39,26,59,0.441,6,23,0.261,13,16,0.813,83,2012-02-29,UTA,HOU,2012,86.0
5020,5020,20,Home,W 104-95 ,240,42,79,0.532,39,71,0.549,3,8,0.375,17,21,0.81,104,34,86,0.395,33,73,0.452,1,13,0.077,26,32,0.813,95,2012-03-01,PHO,MIN,2012,95.5
5021,5021,21,@,W 104-101 ,240,33,68,0.485,28,51,0.549,5,17,0.294,33,44,0.75,104,31,80,0.388,29,66,0.439,2,14,0.143,37,39,0.949,101,2012-03-04,BRK,CHA,2012,102.0
5022,5022,22,Home,L 104-106 ,240,42,88,0.477,37,73,0.507,5,15,0.333,15,19,0.789,104,43,83,0.518,38,67,0.567,5,16,0.313,15,17,0.882,106,2012-03-07,MIL,CHI,2012,108.5
5023,5023,23,@,L 104-115 ,240,38,84,0.452,35,65,0.538,3,19,0.158,25,34,0.735,104,40,91,0.44,32,65,0.492,8,26,0.308,27,32,0.844,115,2012-03-07,PHO,OKC,2012,119.0
5024,5024,24,Home,W 104-86 ,240,42,88,0.477,34,70,0.486,8,18,0.444,12,17,0.706,104,31,72,0.431,25,57,0.439,6,15,0.4,18,23,0.783,86,2012-03-09,BOS,POR,2012,89.0
5025,5025,25,Home,W 104-91 ,240,41,78,0.526,38,71,0.535,3,7,0.429,19,27,0.704,104,34,84,0.405,31,73,0.425,3,11,0.273,20,24,0.833,91,2012-03-09,PHI,UTA,2012,92.5
5026,5026,26,Home,W 104-99 ,240,40,93,0.43,35,79,0.443,5,14,0.357,19,28,0.679,104,37,80,0.463,34,69,0.493,3,11,0.273,22,31,0.71,99,2012-03-12,CHI,NYK,2012,100.5
5027,5027,27,@,W 104-103 ,240,41,89,0.461,31,65,0.477,10,24,0.417,12,14,0.857,104,39,84,0.464,31,61,0.508,8,23,0.348,17,22,0.773,103,2012-03-13,HOU,OKC,2012,107.0
5028,5028,28,Home,W 104-98 (OT),265,36,73,0.493,25,45,0.556,11,28,0.393,21,37,0.568,104,40,91,0.44,32,68,0.471,8,23,0.348,10,11,0.909,98,2012-03-13,ORL,MIA,2012,102.0
5029,5029,29,@,L 104-107 ,240,42,83,0.506,36,67,0.537,6,16,0.375,14,16,0.875,104,39,80,0.488,30,60,0.5,9,20,0.45,20,27,0.741,107,2012-03-20,LAL,HOU,2012,111.5
5030,5030,30,Home,W 104-87 ,240,43,88,0.489,34,63,0.54,9,25,0.36,9,11,0.818,104,31,81,0.383,20,55,0.364,11,26,0.423,14,17,0.824,87,2012-03-23,SAS,DAL,2012,92.5
5031,5031,31,Home,L 104-125 ,240,40,91,0.44,30,70,0.429,10,21,0.476,14,18,0.778,104,43,84,0.512,36,72,0.5,7,12,0.583,32,39,0.821,125,2012-03-24,MIL,IND,2012,128.5
5032,5032,32,@,W 104-101 ,240,36,86,0.419,31,66,0.47,5,20,0.25,27,34,0.794,104,39,91,0.429,33,72,0.458,6,19,0.316,17,18,0.944,101,2012-03-27,LAL,GSW,2012,104.0
5033,5033,33,@,W 104-103 ,240,39,90,0.433,35,74,0.473,4,16,0.25,22,32,0.688,104,31,88,0.352,28,75,0.373,3,13,0.231,38,52,0.731,103,2012-03-30,SAC,UTA,2012,104.5
5034,5034,34,@,W 104-102 (OT),265,37,83,0.446,31,68,0.456,6,15,0.4,24,28,0.857,104,44,101,0.436,35,80,0.438,9,21,0.429,5,10,0.5,102,2012-04-01,IND,HOU,2012,106.5
5035,5035,35,@,W 104-101 ,240,40,72,0.556,32,53,0.604,8,19,0.421,16,21,0.762,104,37,88,0.42,29,56,0.518,8,32,0.25,19,25,0.76,101,2012-04-01,DEN,ORL,2012,105.0
5036,5036,36,@,L 104-112 ,240,38,83,0.458,28,60,0.467,10,23,0.435,18,25,0.72,104,41,86,0.477,35,63,0.556,6,23,0.261,24,31,0.774,112,2012-04-03,NYK,IND,2012,115.0
5037,5037,37,Home,W 104-98 ,240,38,79,0.481,32,63,0.508,6,16,0.375,22,25,0.88,104,39,86,0.453,30,64,0.469,9,22,0.409,11,12,0.917,98,2012-04-06,UTA,GSW,2012,102.5
5038,5038,38,@,W 104-87 ,240,42,93,0.452,33,71,0.465,9,22,0.409,11,13,0.846,104,30,70,0.429,23,56,0.411,7,14,0.5,20,37,0.541,87,2012-04-08,HOU,SAC,2012,90.5
5039,5039,39,@,L 104-114 ,240,41,93,0.441,35,77,0.455,6,16,0.375,16,26,0.615,104,35,69,0.507,29,47,0.617,6,22,0.273,38,43,0.884,114,2012-04-08,UTA,SAS,2012,117.0
5040,5040,40,@,W 104-98 (OT),265,36,77,0.468,28,57,0.491,8,20,0.4,24,32,0.75,104,40,88,0.455,37,67,0.552,3,21,0.143,15,19,0.789,98,2012-04-11,IND,CLE,2012,99.5
5041,5041,41,Home,W 104-93 ,240,42,84,0.5,38,70,0.543,4,14,0.286,16,19,0.842,104,38,79,0.481,31,55,0.564,7,24,0.292,10,14,0.714,93,2012-04-11,MEM,PHO,2012,96.5
5042,5042,42,@,L 104-112 ,240,37,80,0.463,22,49,0.449,15,31,0.484,15,21,0.714,104,44,81,0.543,34,59,0.576,10,22,0.455,14,30,0.467,112,2012-04-14,GSW,LAC,2012,117.0
5043,5043,43,Home,W 104-103 ,240,45,95,0.474,37,76,0.487,8,19,0.421,6,9,0.667,104,40,76,0.526,24,44,0.545,16,32,0.5,7,10,0.7,103,2012-04-15,SAC,POR,2012,111.0
5044,5044,44,@,W 104-98 ,240,38,78,0.487,24,54,0.444,14,24,0.583,14,20,0.7,104,36,73,0.493,31,55,0.564,5,18,0.278,21,26,0.808,98,2012-04-18,LAC,DEN,2012,100.5
5045,5045,45,@,W 104-95 ,240,36,83,0.434,23,48,0.479,13,35,0.371,19,24,0.792,104,35,78,0.449,25,53,0.472,10,25,0.4,15,17,0.882,95,2012-04-18,NYK,NJN,2012,100.0
5046,5046,46,Home,W 104-94 ,240,38,81,0.469,35,62,0.565,3,19,0.158,25,26,0.962,104,37,83,0.446,28,64,0.438,9,19,0.474,11,21,0.524,94,2012-04-20,DAL,GSW,2012,98.5
5047,5047,47,@,W 104-84 ,240,44,85,0.518,36,65,0.554,8,20,0.4,8,15,0.533,104,32,74,0.432,26,58,0.448,6,16,0.375,14,26,0.538,84,2012-04-26,NYK,CHA,2012,87.0
5048,5048,48,Home,W 104-70 ,240,42,76,0.553,37,66,0.561,5,10,0.5,15,24,0.625,104,24,67,0.358,20,49,0.408,4,18,0.222,18,24,0.75,70,2012-04-26,WAS,MIA,2012,72.0
5049,5049,49,@,W 104-94 ,240,35,77,0.455,29,64,0.453,6,13,0.462,28,34,0.824,104,36,80,0.45,26,60,0.433,10,20,0.5,12,17,0.706,94,2012-11-02,MEM,GSW,2013,99.0
5050,5050,50,Home,W 104-84 ,240,36,84,0.429,17,48,0.354,19,36,0.528,13,15,0.867,104,33,71,0.465,26,51,0.51,7,20,0.35,11,13,0.846,84,2012-11-02,NYK,MIA,2013,87.5
5051,5051,51,@,W 104-95 ,240,41,83,0.494,33,58,0.569,8,25,0.32,14,20,0.7,104,33,71,0.465,24,49,0.49,9,22,0.409,20,22,0.909,95,2012-11-04,ATL,OKC,2013,99.5
5052,5052,52,@,L 104-109 ,240,36,81,0.444,31,59,0.525,5,22,0.227,27,31,0.871,104,39,84,0.464,31,63,0.492,8,21,0.381,23,35,0.657,109,2012-11-07,TOR,DAL,2013,113.0
5053,5053,53,Home,W 104-84 ,240,40,92,0.435,34,75,0.453,6,17,0.353,18,25,0.72,104,32,87,0.368,28,64,0.438,4,23,0.174,16,22,0.727,84,2012-11-09,DEN,UTA,2013,86.0
5054,5054,54,Home,W 104-94 ,240,35,84,0.417,27,62,0.435,8,22,0.364,26,38,0.684,104,33,81,0.407,25,53,0.472,8,28,0.286,20,23,0.87,94,2012-11-09,NYK,DAL,2013,98.0
5055,5055,55,Home,W 104-86 ,240,38,86,0.442,24,62,0.387,14,24,0.583,14,16,0.875,104,30,79,0.38,26,64,0.406,4,15,0.267,22,36,0.611,86,2012-11-11,MEM,MIA,2013,88.0
5056,5056,56,@,W 104-100 ,240,39,86,0.453,28,60,0.467,11,26,0.423,15,23,0.652,104,38,87,0.437,30,58,0.517,8,29,0.276,16,21,0.762,100,2012-11-15,NYK,SAS,2013,104.0
5057,5057,57,@,W 104-97 ,240,41,83,0.494,39,66,0.591,2,17,0.118,20,22,0.909,104,38,92,0.413,31,76,0.408,7,16,0.438,14,21,0.667,97,2012-11-23,SAS,IND,2013,100.5
5058,5058,58,@,L 104-108 ,240,37,87,0.425,29,61,0.475,8,26,0.308,22,30,0.733,104,40,80,0.5,29,59,0.492,11,21,0.524,17,20,0.85,108,2012-11-23,CLE,ORL,2013,113.5
5059,5059,59,Home,W 104-102 ,240,36,83,0.434,33,68,0.485,3,15,0.2,29,33,0.879,104,40,80,0.5,30,63,0.476,10,17,0.588,12,16,0.75,102,2012-11-23,UTA,SAC,2013,107.0
5060,5060,60,Home,W 104-93 ,240,38,75,0.507,31,58,0.534,7,17,0.412,21,26,0.808,104,32,75,0.427,24,56,0.429,8,19,0.421,21,25,0.84,93,2012-11-24,ATL,LAC,2013,97.0
5061,5061,61,Home,W 104-101 ,240,39,81,0.481,30,62,0.484,9,19,0.474,17,23,0.739,104,39,83,0.47,35,72,0.486,4,11,0.364,19,20,0.95,101,2012-11-25,PHI,PHO,2013,103.0
5062,5062,62,@,W 104-98 ,240,44,86,0.512,36,69,0.522,8,17,0.471,8,10,0.8,104,39,83,0.47,31,66,0.47,8,17,0.471,12,18,0.667,98,2012-11-30,PHI,CHA,2013,102.0
5063,5063,63,Home,L 104-105 ,240,42,74,0.568,33,54,0.611,9,20,0.45,11,15,0.733,104,42,89,0.472,38,68,0.559,4,21,0.19,17,24,0.708,105,2012-12-03,UTA,LAC,2013,107.0
5064,5064,64,@,L 104-108 ,240,38,79,0.481,31,62,0.5,7,17,0.412,21,25,0.84,104,42,95,0.442,34,73,0.466,8,22,0.364,16,19,0.842,108,2012-12-05,DEN,ATL,2013,112.0
5065,5065,65,Home,W 104-94 ,240,41,78,0.526,37,61,0.607,4,17,0.235,18,26,0.692,104,37,84,0.44,31,65,0.477,6,19,0.316,14,30,0.467,94,2012-12-05,BOS,MIN,2013,97.0
5066,5066,66,@,W 104-97 ,240,34,75,0.453,25,51,0.49,9,24,0.375,27,34,0.794,104,35,79,0.443,29,58,0.5,6,21,0.286,21,31,0.677,97,2012-12-05,GSW,DET,2013,100.0
5067,5067,67,Home,W 104-95 ,240,41,85,0.482,31,59,0.525,10,26,0.385,12,19,0.632,104,36,79,0.456,29,63,0.46,7,16,0.438,16,20,0.8,95,2012-12-07,ATL,WAS,2013,98.5
5068,5068,68,Home,L 104-108 ,240,36,70,0.514,28,56,0.5,8,14,0.571,24,31,0.774,104,43,82,0.524,38,68,0.559,5,14,0.357,17,21,0.81,108,2012-12-07,DET,CHI,2013,110.5
5069,5069,69,@,W 104-97 ,240,35,75,0.467,26,60,0.433,9,15,0.6,25,33,0.758,104,39,91,0.429,33,64,0.516,6,27,0.222,13,17,0.765,97,2012-12-08,DET,CLE,2013,100.0
5070,5070,70,Home,W 104-93 ,240,37,76,0.487,32,57,0.561,5,19,0.263,25,30,0.833,104,38,82,0.463,32,65,0.492,6,17,0.353,11,13,0.846,93,2012-12-09,OKC,IND,2013,96.0
5071,5071,71,@,W 104-96 ,240,38,84,0.452,30,64,0.469,8,20,0.4,20,23,0.87,104,31,83,0.373,22,57,0.386,9,26,0.346,25,32,0.781,96,2012-12-10,GSW,CHA,2013,100.5
5072,5072,72,Home,W 104-97 ,240,44,82,0.537,40,71,0.563,4,11,0.364,12,23,0.522,104,32,81,0.395,27,63,0.429,5,18,0.278,28,33,0.848,97,2012-12-10,PHI,DET,2013,99.5
5073,5073,73,Home,W 104-84 ,240,41,80,0.513,32,64,0.5,9,16,0.563,13,18,0.722,104,32,86,0.372,30,71,0.423,2,15,0.133,18,25,0.72,84,2012-12-19,IND,UTA,2013,85.0
5074,5074,74,@,L 104-121 ,240,40,86,0.465,34,76,0.447,6,10,0.6,18,22,0.818,104,47,85,0.553,30,57,0.526,17,28,0.607,10,11,0.909,121,2012-12-19,CHA,PHO,2013,129.5
5075,5075,75,Home,W 104-87 ,240,40,86,0.465,33,62,0.532,7,24,0.292,17,28,0.607,104,36,87,0.414,33,68,0.485,3,19,0.158,12,16,0.75,87,2012-12-28,LAL,POR,2013,88.5
5076,5076,76,@,W 104-97 (OT),265,37,85,0.435,32,61,0.525,5,24,0.208,25,32,0.781,104,37,82,0.451,32,69,0.464,5,13,0.385,18,24,0.75,97,2012-12-28,TOR,NOH,2013,99.5
5077,5077,77,Home,W 104-85 ,240,40,98,0.408,32,77,0.416,8,21,0.381,16,17,0.941,104,33,76,0.434,29,63,0.46,4,13,0.308,15,24,0.625,85,2012-12-29,MIL,MIA,2013,87.0
5078,5078,78,@,L 104-123 ,240,43,90,0.478,31,67,0.463,12,23,0.522,6,7,0.857,104,45,84,0.536,29,55,0.527,16,29,0.552,17,22,0.773,123,2012-12-31,ATL,HOU,2013,131.0
5079,5079,79,Home,W 104-73 ,240,43,73,0.589,37,59,0.627,6,14,0.429,12,16,0.75,104,28,74,0.378,24,57,0.421,4,17,0.235,13,17,0.765,73,2012-12-31,SAS,BRK,2013,75.0
5080,5080,80,Home,W 104-92 ,240,41,83,0.494,36,59,0.61,5,24,0.208,17,23,0.739,104,38,90,0.422,33,74,0.446,5,16,0.313,11,20,0.55,92,2013-01-02,HOU,NOH,2013,94.5
5081,5081,81,Home,L 104-106 ,240,37,82,0.451,29,65,0.446,8,17,0.471,22,28,0.786,104,39,78,0.5,32,62,0.516,7,16,0.438,21,29,0.724,106,2013-01-04,CHA,CLE,2013,109.5
5082,5082,82,Home,L 104-112 ,240,36,91,0.396,29,68,0.426,7,23,0.304,25,28,0.893,104,37,79,0.468,25,45,0.556,12,34,0.353,26,36,0.722,112,2013-01-05,CLE,HOU,2013,118.0
5083,5083,83,@,W 104-92 ,240,38,77,0.494,32,55,0.582,6,22,0.273,22,24,0.917,104,34,76,0.447,26,53,0.491,8,23,0.348,16,21,0.762,92,2013-01-06,OKC,TOR,2013,96.0
5084,5084,84,@,W 104-96 ,240,39,84,0.464,29,62,0.468,10,22,0.455,16,21,0.762,104,39,95,0.411,35,85,0.412,4,10,0.4,14,20,0.7,96,2013-01-09,MIL,CHI,2013,98.0
5085,5085,85,Home,W 104-92 ,240,44,84,0.524,36,62,0.581,8,22,0.364,8,9,0.889,104,31,69,0.449,27,51,0.529,4,18,0.222,26,33,0.788,92,2013-01-11,NOP,MIN,2013,94.0
5086,5086,86,Home,W 104-83 ,240,39,80,0.488,28,63,0.444,11,17,0.647,15,21,0.714,104,32,84,0.381,29,76,0.382,3,8,0.375,16,26,0.615,83,2013-01-12,DAL,MEM,2013,84.5
5087,5087,87,@,W 104-101 ,240,39,81,0.481,28,56,0.5,11,25,0.44,15,19,0.789,104,43,88,0.489,34,66,0.515,9,22,0.409,6,6,1.0,101,2013-01-12,ORL,LAC,2013,105.5
5088,5088,88,Home,W 104-97 ,240,36,76,0.474,28,58,0.483,8,18,0.444,24,28,0.857,104,39,72,0.542,30,49,0.612,9,23,0.391,10,16,0.625,97,2013-01-14,UTA,MIA,2013,101.5
5089,5089,89,Home,W 104-88 ,240,42,84,0.5,32,55,0.582,10,29,0.345,10,18,0.556,104,34,95,0.358,27,67,0.403,7,28,0.25,13,22,0.591,88,2013-01-15,LAL,MIL,2013,91.5
5090,5090,90,Home,L 104-110 ,240,34,81,0.42,26,53,0.491,8,28,0.286,28,32,0.875,104,39,88,0.443,33,70,0.471,6,18,0.333,26,32,0.813,110,2013-01-19,POR,MIL,2013,113.0
5091,5091,91,Home,W 104-96 ,240,41,71,0.577,31,55,0.564,10,16,0.625,12,21,0.571,104,36,74,0.486,31,60,0.517,5,14,0.357,19,26,0.731,96,2013-01-21,ATL,MIN,2013,98.5
5092,5092,92,@,W 104-92 ,240,43,87,0.494,31,62,0.5,12,25,0.48,6,12,0.5,104,31,76,0.408,25,61,0.41,6,15,0.4,24,29,0.828,92,2013-01-23,ATL,CHA,2013,95.0
5093,5093,93,Home,W 104-99 ,240,37,84,0.44,31,61,0.508,6,23,0.261,24,27,0.889,104,36,78,0.462,31,62,0.5,5,16,0.313,22,27,0.815,99,2013-01-23,GSW,OKC,2013,101.5
5094,5094,94,@,L 104-106 ,240,39,65,0.6,29,42,0.69,10,23,0.435,16,20,0.8,104,39,72,0.542,23,45,0.511,16,27,0.593,12,17,0.706,106,2013-01-27,ATL,NYK,2013,114.0
5095,5095,95,@,W 104-102 ,240,40,79,0.506,29,56,0.518,11,23,0.478,13,18,0.722,104,40,90,0.444,30,67,0.448,10,23,0.435,12,16,0.75,102,2013-01-27,DET,ORL,2013,107.0
5096,5096,96,@,L 104-106 ,240,42,84,0.5,34,69,0.493,8,15,0.533,12,15,0.8,104,39,86,0.453,29,58,0.5,10,28,0.357,18,23,0.783,106,2013-01-29,DAL,POR,2013,111.0
5097,5097,97,@,W 104-88 ,240,45,91,0.495,41,78,0.526,4,13,0.308,10,13,0.769,104,34,82,0.415,28,68,0.412,6,14,0.429,14,19,0.737,88,2013-01-30,CHI,MIL,2013,91.0
5098,5098,98,Home,W 104-99 ,240,34,68,0.5,30,56,0.536,4,12,0.333,32,46,0.696,104,37,78,0.474,29,56,0.518,8,22,0.364,17,28,0.607,99,2013-01-30,UTA,NOH,2013,103.0
5099,5099,99,@,L 104-106 ,240,40,79,0.506,31,58,0.534,9,21,0.429,15,21,0.714,104,36,72,0.5,25,54,0.463,11,18,0.611,23,27,0.852,106,2013-02-03,LAC,BOS,2013,111.5
5100,5100,0,@,L 104-112 ,240,48,100,0.48,45,84,0.536,3,16,0.188,5,11,0.455,104,40,91,0.44,35,75,0.467,5,16,0.313,27,37,0.73,112,2013-02-05,MIL,DEN,2013,114.5
5101,5101,1,@,W 104-94 ,240,37,81,0.457,27,56,0.482,10,25,0.4,20,21,0.952,104,33,81,0.407,25,63,0.397,8,18,0.444,20,23,0.87,94,2013-02-06,SAS,MIN,2013,98.0
5102,5102,2,@,L 104-110 ,240,42,83,0.506,32,56,0.571,10,27,0.37,10,12,0.833,104,47,93,0.505,42,78,0.538,5,15,0.333,11,18,0.611,110,2013-02-10,POR,ORL,2013,112.5
5103,5103,3,@,L 104-117 ,240,39,73,0.534,31,49,0.633,8,24,0.333,18,20,0.9,104,43,74,0.581,35,55,0.636,8,19,0.421,23,27,0.852,117,2013-02-12,POR,MIA,2013,121.0
5104,5104,4,@,W 104-100 ,240,40,84,0.476,32,64,0.5,8,20,0.4,16,19,0.842,104,37,91,0.407,32,74,0.432,5,17,0.294,21,24,0.875,100,2013-02-22,DAL,NOH,2013,102.5
5105,5105,5,Home,W 104-97 ,240,44,85,0.518,32,67,0.478,12,18,0.667,4,9,0.444,104,36,86,0.419,26,60,0.433,10,26,0.385,15,19,0.789,97,2013-03-02,PHI,GSW,2013,102.0
5106,5106,6,Home,L 104-108 ,240,38,82,0.463,29,58,0.5,9,24,0.375,19,22,0.864,104,38,80,0.475,31,59,0.525,7,21,0.333,25,34,0.735,108,2013-03-03,LAC,OKC,2013,111.5
5107,5107,7,Home,W 104-88 ,240,46,86,0.535,41,71,0.577,5,15,0.333,7,9,0.778,104,36,89,0.404,29,65,0.446,7,24,0.292,9,11,0.818,88,2013-03-04,DEN,ATL,2013,91.5
5108,5108,8,Home,W 104-101 ,240,37,90,0.411,30,74,0.405,7,16,0.438,23,29,0.793,104,38,87,0.437,29,68,0.426,9,19,0.474,16,19,0.842,101,2013-03-06,CLE,UTA,2013,105.5
5109,5109,9,Home,W 104-87 ,240,35,70,0.5,25,52,0.481,10,18,0.556,24,32,0.75,104,32,79,0.405,27,64,0.422,5,15,0.333,18,23,0.783,87,2013-03-09,WAS,CHA,2013,89.5
5110,5110,10,@,L 104-117 ,240,40,92,0.435,33,65,0.508,7,27,0.259,17,21,0.81,104,42,76,0.553,38,63,0.603,4,13,0.308,29,43,0.674,117,2013-03-15,ORL,OKC,2013,119.0
5111,5111,11,Home,L 104-114 ,240,37,85,0.435,33,60,0.55,4,25,0.16,26,31,0.839,104,43,96,0.448,39,75,0.52,4,21,0.19,24,29,0.828,114,2013-03-19,OKC,DEN,2013,116.0
5112,5112,12,Home,W 104-93 ,240,41,85,0.482,33,59,0.559,8,26,0.308,14,15,0.933,104,37,84,0.44,31,72,0.431,6,12,0.5,13,15,0.867,93,2013-03-20,SAS,GSW,2013,96.0
5113,5113,13,@,W 104-93 ,240,41,87,0.471,31,69,0.449,10,18,0.556,12,16,0.75,104,37,83,0.446,30,59,0.508,7,24,0.292,12,16,0.75,93,2013-03-22,POR,ATL,2013,96.5
5114,5114,14,Home,W 104-94 ,240,38,82,0.463,32,63,0.508,6,19,0.316,22,28,0.786,104,32,77,0.416,27,60,0.45,5,17,0.294,25,27,0.926,94,2013-03-22,DAL,BOS,2013,96.5
5115,5115,15,Home,W 104-97 (OT),265,39,84,0.464,31,64,0.484,8,20,0.4,18,24,0.75,104,41,96,0.427,33,79,0.418,8,17,0.471,7,12,0.583,97,2013-03-22,SAS,UTA,2013,101.0
5116,5116,16,@,W 104-99 ,240,39,78,0.5,29,52,0.558,10,26,0.385,16,21,0.762,104,42,92,0.457,37,71,0.521,5,21,0.238,10,18,0.556,99,2013-03-24,ATL,MIL,2013,101.5
5117,5117,17,@,W 104-97 ,240,41,89,0.461,31,63,0.492,10,26,0.385,12,17,0.706,104,39,78,0.5,33,66,0.5,6,12,0.5,13,19,0.684,97,2013-03-24,CHI,MIN,2013,100.0
5118,5118,18,Home,W 104-102 ,240,39,74,0.527,33,59,0.559,6,15,0.4,20,21,0.952,104,41,81,0.506,33,62,0.532,8,19,0.421,12,21,0.571,102,2013-03-29,SAS,LAC,2013,106.0
5119,5119,19,Home,L 104-112 ,240,40,82,0.488,34,70,0.486,6,12,0.5,18,19,0.947,104,37,80,0.463,33,65,0.508,4,15,0.267,34,46,0.739,112,2013-03-30,PHO,IND,2013,114.0
5120,5120,20,Home,W 104-85 ,240,39,79,0.494,35,67,0.522,4,12,0.333,22,31,0.71,104,35,86,0.407,32,66,0.485,3,20,0.15,12,15,0.8,85,2013-04-06,WAS,IND,2013,86.5
5121,5121,21,Home,W 104-83 ,240,42,93,0.452,37,73,0.507,5,20,0.25,15,23,0.652,104,30,80,0.375,23,66,0.348,7,14,0.5,16,20,0.8,83,2013-04-09,BRK,PHI,2013,86.5
5122,5122,22,Home,W 104-96 ,240,40,79,0.506,33,54,0.611,7,25,0.28,17,22,0.773,104,37,84,0.44,32,64,0.5,5,20,0.25,17,18,0.944,96,2013-04-09,LAL,NOH,2013,98.5
5123,5123,23,Home,L 104-111 ,240,40,82,0.488,37,67,0.552,3,15,0.2,21,26,0.808,104,40,80,0.5,36,64,0.563,4,16,0.25,27,42,0.643,111,2013-04-10,CLE,DET,2013,113.0
5124,5124,24,@,L 104-109 ,240,38,92,0.413,21,59,0.356,17,33,0.515,11,16,0.688,104,43,85,0.506,37,65,0.569,6,20,0.3,17,25,0.68,109,2013-04-12,MIL,ATL,2013,112.0
5125,5125,25,Home,W 104-95 ,240,42,92,0.457,37,69,0.536,5,23,0.217,15,20,0.75,104,38,87,0.437,31,60,0.517,7,27,0.259,12,21,0.571,95,2013-04-15,OKC,SAC,2013,98.5
5126,5126,26,Home,W 104-91 ,240,43,83,0.518,39,64,0.609,4,19,0.211,14,18,0.778,104,33,81,0.407,25,55,0.455,8,26,0.308,17,24,0.708,91,2013-10-30,PHO,POR,2014,95.0
5127,5127,27,@,L 104-107 ,240,42,93,0.452,39,79,0.494,3,14,0.214,17,19,0.895,104,42,86,0.488,31,64,0.484,11,22,0.5,12,18,0.667,107,2013-11-02,CHI,PHI,2014,112.5
5128,5128,28,@,W 104-93 ,240,34,67,0.507,25,45,0.556,9,22,0.409,27,35,0.771,104,34,81,0.42,30,59,0.508,4,22,0.182,21,27,0.778,93,2013-11-02,HOU,UTA,2014,95.0
5129,5129,29,Home,W 104-88 ,240,40,78,0.513,36,67,0.537,4,11,0.364,20,32,0.625,104,31,82,0.378,27,64,0.422,4,18,0.222,22,30,0.733,88,2013-11-05,BRK,UTA,2014,90.0
5130,5130,30,@,L 104-123 ,240,39,88,0.443,27,57,0.474,12,31,0.387,14,20,0.7,104,49,94,0.521,36,67,0.537,13,27,0.481,12,14,0.857,123,2013-11-05,LAL,DAL,2014,129.5
5131,5131,31,@,W 104-98 ,240,39,78,0.5,27,53,0.509,12,25,0.48,14,22,0.636,104,37,85,0.435,27,67,0.403,10,18,0.556,14,19,0.737,98,2013-11-05,PHO,NOP,2014,103.0
5132,5132,32,@,W 104-95 ,240,41,83,0.494,31,60,0.517,10,23,0.435,12,14,0.857,104,31,72,0.431,25,51,0.49,6,21,0.286,27,33,0.818,95,2013-11-05,MIA,TOR,2014,98.0
5133,5133,33,@,L 104-109 ,240,38,85,0.447,26,57,0.456,12,28,0.429,16,22,0.727,104,36,72,0.5,23,49,0.469,13,23,0.565,24,26,0.923,109,2013-11-06,CLE,MIL,2014,115.5
5134,5134,34,Home,W 104-91 ,240,39,80,0.488,29,57,0.509,10,23,0.435,16,18,0.889,104,36,86,0.419,30,64,0.469,6,22,0.273,13,15,0.867,91,2013-11-08,POR,SAC,2014,94.0
5135,5135,35,Home,W 104-94 ,240,43,90,0.478,37,71,0.521,6,19,0.316,12,17,0.706,104,38,82,0.463,30,65,0.462,8,17,0.471,10,18,0.556,94,2013-11-09,ATL,ORL,2014,98.0
5136,5136,36,@,L 104-110 (2OT),290,38,114,0.333,30,89,0.337,8,25,0.32,20,27,0.741,104,37,84,0.44,30,58,0.517,7,26,0.269,29,47,0.617,110,2013-11-11,TOR,HOU,2014,113.5
5137,5137,37,Home,W 104-77 ,240,40,79,0.506,35,63,0.556,5,16,0.313,19,21,0.905,104,30,88,0.341,22,72,0.306,8,16,0.5,9,11,0.818,77,2013-11-15,IND,MIL,2014,81.0
5138,5138,38,@,L 104-110 ,240,37,74,0.5,25,46,0.543,12,28,0.429,18,21,0.857,104,40,74,0.541,35,61,0.574,5,13,0.385,25,30,0.833,110,2013-11-15,DAL,MIA,2014,112.5
5139,5139,39,Home,W 104-88 ,240,41,81,0.506,31,60,0.517,10,21,0.476,12,19,0.632,104,33,74,0.446,22,50,0.44,11,24,0.458,11,15,0.733,88,2013-11-19,MIA,ATL,2014,93.5
5140,5140,40,@,L 104-107 ,240,37,79,0.468,27,50,0.54,10,29,0.345,20,28,0.714,104,39,83,0.47,31,61,0.508,8,22,0.364,21,28,0.75,107,2013-11-19,PHO,SAC,2014,111.0
5141,5141,41,Home,W 104-100 ,240,41,85,0.482,34,70,0.486,7,15,0.467,15,15,1.0,104,37,85,0.435,27,57,0.474,10,28,0.357,16,24,0.667,100,2013-11-19,WAS,MIN,2014,105.0
5142,5142,42,Home,W 104-93 ,240,39,81,0.481,31,60,0.517,8,21,0.381,18,24,0.75,104,39,86,0.453,35,71,0.493,4,15,0.267,11,12,0.917,93,2013-11-20,SAS,BOS,2014,95.0
5143,5143,43,Home,W 104-100 ,240,36,88,0.409,30,71,0.423,6,17,0.353,26,33,0.788,104,41,77,0.532,33,54,0.611,8,23,0.348,10,16,0.625,100,2013-11-22,NOP,CLE,2014,104.0
5144,5144,44,@,W 104-96 ,240,46,95,0.484,35,66,0.53,11,29,0.379,1,3,0.333,104,39,84,0.464,33,63,0.524,6,21,0.286,12,14,0.857,96,2013-11-24,PHO,ORL,2014,99.0
5145,5145,45,@,W 104-98 (OT),265,37,83,0.446,31,63,0.492,6,20,0.3,24,37,0.649,104,42,91,0.462,36,68,0.529,6,23,0.261,8,10,0.8,98,2013-11-29,LAC,SAC,2014,101.0
5146,5146,46,Home,L 104-112 ,240,37,78,0.474,25,51,0.49,12,27,0.444,18,25,0.72,104,39,76,0.513,30,58,0.517,9,18,0.5,25,29,0.862,112,2013-11-30,PHO,UTA,2014,116.5
5147,5147,47,@,L 104-111 ,240,39,89,0.438,34,78,0.436,5,11,0.455,21,24,0.875,104,44,98,0.449,36,75,0.48,8,23,0.348,15,17,0.882,111,2013-12-04,OKC,POR,2014,115.0
5148,5148,48,Home,W 104-96 ,240,39,70,0.557,36,58,0.621,3,12,0.25,23,28,0.821,104,35,80,0.438,24,58,0.414,11,22,0.5,15,21,0.714,96,2013-12-10,BRK,BOS,2014,101.5
5149,5149,49,@,L 104-111 ,240,40,94,0.426,35,74,0.473,5,20,0.25,19,24,0.792,104,39,89,0.438,31,62,0.5,8,27,0.296,25,30,0.833,111,2013-12-12,HOU,POR,2014,115.0
5150,5150,50,Home,W 104-98 ,240,39,76,0.513,30,54,0.556,9,22,0.409,17,20,0.85,104,40,80,0.5,34,65,0.523,6,15,0.4,12,17,0.706,98,2013-12-13,NOP,MEM,2014,101.0
5151,5151,51,Home,W 104-93 ,240,41,91,0.451,36,71,0.507,5,20,0.25,17,24,0.708,104,33,88,0.375,28,70,0.4,5,18,0.278,22,30,0.733,93,2013-12-17,GSW,NOP,2014,95.5
5152,5152,52,@,W 104-102 (OT),265,37,81,0.457,29,66,0.439,8,15,0.533,22,34,0.647,104,41,96,0.427,35,70,0.5,6,26,0.231,14,20,0.7,102,2013-12-18,CHA,TOR,2014,105.0
5153,5153,53,@,W 104-102 ,240,40,89,0.449,29,62,0.468,11,27,0.407,13,19,0.684,104,42,90,0.467,34,59,0.576,8,31,0.258,10,11,0.909,102,2013-12-19,SAS,GSW,2014,106.0
5154,5154,54,Home,W 104-91 ,240,42,78,0.538,35,59,0.593,7,19,0.368,13,15,0.867,104,33,95,0.347,28,73,0.384,5,22,0.227,20,25,0.8,91,2013-12-20,LAL,MIN,2014,93.5
5155,5155,55,@,W 104-98 ,240,36,91,0.396,28,71,0.394,8,20,0.4,24,29,0.828,104,28,76,0.368,21,53,0.396,7,23,0.304,35,36,0.972,98,2013-12-22,TOR,OKC,2014,101.5
5156,5156,56,Home,L 104-111 ,240,38,70,0.543,31,51,0.608,7,19,0.368,21,29,0.724,104,40,79,0.506,29,57,0.509,11,22,0.5,20,23,0.87,111,2013-12-23,HOU,DAL,2014,116.5
5157,5157,57,Home,W 104-94 ,240,39,83,0.47,28,63,0.444,11,20,0.55,15,20,0.75,104,35,75,0.467,24,51,0.471,11,24,0.458,13,15,0.867,94,2013-12-23,MEM,UTA,2014,99.5
5158,5158,58,Home,W 104-93 ,240,34,79,0.43,22,53,0.415,12,26,0.462,24,32,0.75,104,33,88,0.375,24,56,0.429,9,32,0.281,18,25,0.72,93,2013-12-27,BRK,MIL,2014,97.5
5159,5159,59,Home,L 104-108 (OT),265,38,92,0.413,28,76,0.368,10,16,0.625,18,21,0.857,104,42,95,0.442,32,62,0.516,10,33,0.303,14,19,0.737,108,2013-12-29,CLE,GSW,2014,113.0
5160,5160,60,Home,L 104-111 ,240,31,84,0.369,19,47,0.404,12,37,0.324,30,34,0.882,104,39,95,0.411,33,71,0.465,6,24,0.25,27,33,0.818,111,2013-12-29,LAL,PHI,2014,114.0
5161,5161,61,@,L 104-112 ,240,41,91,0.451,34,77,0.442,7,14,0.5,15,20,0.75,104,44,94,0.468,36,70,0.514,8,24,0.333,16,19,0.842,112,2013-12-29,SAC,SAS,2014,116.0
5162,5162,62,@,L 104-134 ,240,34,79,0.43,27,63,0.429,7,16,0.438,29,36,0.806,104,54,93,0.581,33,60,0.55,21,33,0.636,5,7,0.714,134,2014-01-02,CHA,POR,2014,144.5
5163,5163,63,Home,L 104-113 ,240,35,83,0.422,28,60,0.467,7,23,0.304,27,37,0.73,104,42,90,0.467,37,71,0.521,5,19,0.263,24,31,0.774,113,2014-01-02,SAC,PHI,2014,115.5
5164,5164,64,@,W 104-103 ,240,38,92,0.413,27,63,0.429,11,29,0.379,17,23,0.739,104,34,86,0.395,28,70,0.4,6,16,0.375,29,35,0.829,103,2014-01-08,PHO,MIN,2014,106.0
5165,5165,65,Home,W 104-95 (2OT),290,40,86,0.465,33,66,0.5,7,20,0.35,17,21,0.81,104,34,80,0.425,28,57,0.491,6,23,0.261,21,27,0.778,95,2014-01-10,BRK,MIA,2014,98.0
5166,5166,66,Home,W 104-99 ,240,42,86,0.488,36,71,0.507,6,15,0.4,14,23,0.609,104,38,92,0.413,27,62,0.435,11,30,0.367,12,16,0.75,99,2014-01-10,MEM,PHO,2014,104.5
5167,5167,67,Home,L 104-114 ,240,41,95,0.432,33,71,0.465,8,24,0.333,14,20,0.7,104,40,94,0.426,29,64,0.453,11,30,0.367,23,33,0.697,114,2014-01-10,PHI,DET,2014,119.5
5168,5168,68,@,L 104-112 ,240,44,95,0.463,40,81,0.494,4,14,0.286,12,17,0.706,104,40,93,0.43,30,72,0.417,10,21,0.476,22,26,0.846,112,2014-01-11,BOS,POR,2014,117.0
5169,5169,69,Home,W 104-86 ,240,42,74,0.568,33,61,0.541,9,13,0.692,11,14,0.786,104,33,93,0.355,28,76,0.368,5,17,0.294,15,18,0.833,86,2014-01-12,SAS,MIN,2014,88.5
5170,5170,70,@,W 104-92 ,240,37,79,0.468,29,60,0.483,8,19,0.421,22,34,0.647,104,38,101,0.376,35,84,0.417,3,17,0.176,13,14,0.929,92,2014-01-13,HOU,BOS,2014,93.5
5171,5171,71,@,W 104-92 ,240,38,82,0.463,32,57,0.561,6,25,0.24,22,25,0.88,104,33,82,0.402,21,48,0.438,12,34,0.353,14,21,0.667,92,2014-01-16,OKC,HOU,2014,98.0
5172,5172,72,Home,L 104-107 ,240,44,99,0.444,37,76,0.487,7,23,0.304,9,11,0.818,104,37,74,0.5,25,54,0.463,12,20,0.6,21,28,0.75,107,2014-01-17,BOS,LAL,2014,113.0
5173,5173,73,@,W 104-96 (OT),265,39,79,0.494,32,58,0.552,7,21,0.333,19,29,0.655,104,36,75,0.48,29,58,0.5,7,17,0.412,17,23,0.739,96,2014-01-18,MIA,CHA,2014,99.5
5174,5174,74,@,L 104-114 ,240,40,80,0.5,29,57,0.509,11,23,0.478,13,21,0.619,104,41,85,0.482,34,58,0.586,7,27,0.259,25,37,0.676,114,2014-01-18,MIL,HOU,2014,117.5
5175,5175,75,@,W 104-98 ,240,40,81,0.494,34,60,0.567,6,21,0.286,18,31,0.581,104,37,76,0.487,29,55,0.527,8,21,0.381,16,29,0.552,98,2014-01-18,DET,WAS,2014,102.0
5176,5176,76,Home,W 104-101 ,240,41,84,0.488,33,57,0.579,8,27,0.296,14,22,0.636,104,36,84,0.429,32,69,0.464,4,15,0.267,25,34,0.735,101,2014-01-22,MIL,DET,2014,103.0
5177,5177,77,@,W 104-95 ,240,40,84,0.476,32,64,0.5,8,20,0.4,16,22,0.727,104,38,89,0.427,32,69,0.464,6,20,0.3,13,16,0.813,95,2014-01-24,TOR,PHI,2014,98.0
5178,5178,78,@,L 104-115 ,240,38,89,0.427,29,67,0.433,9,22,0.409,19,22,0.864,104,46,95,0.484,42,79,0.532,4,16,0.25,19,24,0.792,115,2014-01-25,MIN,POR,2014,117.0
5179,5179,79,Home,W 104-101 ,240,38,81,0.469,28,57,0.491,10,24,0.417,18,22,0.818,104,39,91,0.429,32,71,0.451,7,20,0.35,16,18,0.889,101,2014-01-25,UTA,WAS,2014,104.5
5180,5180,80,@,W 104-103 ,240,37,79,0.468,28,57,0.491,9,22,0.409,21,26,0.808,104,37,77,0.481,26,53,0.491,11,24,0.458,18,22,0.818,103,2014-01-27,TOR,BRK,2014,108.5
5181,5181,81,@,W 104-92 ,240,42,99,0.424,37,78,0.474,5,21,0.238,15,27,0.556,104,37,94,0.394,32,70,0.457,5,24,0.208,13,16,0.813,92,2014-01-28,IND,LAL,2014,94.5
5182,5182,82,@,W 104-100 ,240,36,77,0.468,28,56,0.5,8,21,0.381,24,28,0.857,104,39,89,0.438,33,73,0.452,6,16,0.375,16,22,0.727,100,2014-02-08,SAS,CHA,2014,103.0
5183,5183,83,@,W 104-92 ,240,41,82,0.5,32,63,0.508,9,19,0.474,13,14,0.929,104,37,80,0.463,31,63,0.492,6,17,0.353,12,17,0.706,92,2014-02-12,SAS,BOS,2014,95.0
5184,5184,84,Home,W 104-83 ,240,38,94,0.404,27,61,0.443,11,33,0.333,17,22,0.773,104,30,78,0.385,26,58,0.448,4,20,0.2,19,23,0.826,83,2014-02-12,TOR,ATL,2014,85.0
5185,5185,85,Home,W 104-100 ,240,35,82,0.427,23,56,0.411,12,26,0.462,22,30,0.733,104,40,80,0.5,29,55,0.527,11,25,0.44,9,16,0.563,100,2014-02-18,MIL,ORL,2014,105.5
5186,5186,86,Home,W 104-91 ,240,40,83,0.482,34,63,0.54,6,20,0.3,18,31,0.581,104,35,87,0.402,29,65,0.446,6,22,0.273,15,20,0.75,91,2014-02-19,MIN,IND,2014,94.0
5187,5187,87,Home,L 104-121 ,240,37,79,0.468,34,60,0.567,3,19,0.158,27,36,0.75,104,43,84,0.512,32,62,0.516,11,22,0.5,24,33,0.727,121,2014-02-22,UTA,MIN,2014,126.5
5188,5188,88,@,W 104-96 ,240,38,82,0.463,25,51,0.49,13,31,0.419,15,22,0.682,104,40,99,0.404,36,86,0.419,4,13,0.308,12,18,0.667,96,2014-02-24,GSW,DET,2014,98.0
5189,5189,89,@,L 104-115 ,240,38,76,0.5,29,57,0.509,9,19,0.474,19,24,0.792,104,43,90,0.478,35,68,0.515,8,22,0.364,21,23,0.913,115,2014-02-26,ATL,BOS,2014,119.0
5190,5190,90,Home,L 104-114 ,240,39,80,0.488,26,49,0.531,13,31,0.419,13,17,0.765,104,40,86,0.465,29,60,0.483,11,26,0.423,23,24,0.958,114,2014-02-26,OKC,CLE,2014,119.5
5191,5191,91,@,L 104-116 ,240,42,78,0.538,37,65,0.569,5,13,0.385,15,17,0.882,104,40,74,0.541,30,51,0.588,10,23,0.435,26,32,0.813,116,2014-02-28,NOP,PHO,2014,121.0
5192,5192,92,Home,W 104-98 ,240,38,79,0.481,30,57,0.526,8,22,0.364,20,23,0.87,104,37,88,0.42,29,65,0.446,8,23,0.348,16,20,0.8,98,2014-03-02,TOR,GSW,2014,102.0
5193,5193,93,Home,L 104-110 ,240,39,81,0.481,30,62,0.484,9,19,0.474,17,21,0.81,104,43,79,0.544,37,66,0.561,6,13,0.462,18,21,0.857,110,2014-03-03,WAS,MEM,2014,113.0
5194,5194,94,@,W 104-96 ,240,40,78,0.513,32,58,0.552,8,20,0.4,16,22,0.727,104,39,86,0.453,32,67,0.478,7,19,0.368,11,19,0.579,96,2014-03-04,LAC,PHO,2014,99.5
5195,5195,95,Home,W 104-91 ,240,44,81,0.543,38,66,0.576,6,15,0.4,10,10,1.0,104,35,78,0.449,27,55,0.491,8,23,0.348,13,22,0.591,91,2014-03-05,WAS,UTA,2014,95.0
5196,5196,96,@,L 104-112 ,240,40,89,0.449,35,69,0.507,5,20,0.25,19,25,0.76,104,42,84,0.5,34,64,0.531,8,20,0.4,20,23,0.87,112,2014-03-07,MIL,NOP,2014,116.0
5197,5197,97,@,W 104-92 ,240,37,80,0.463,27,57,0.474,10,23,0.435,20,28,0.714,104,36,76,0.474,31,54,0.574,5,22,0.227,15,20,0.75,92,2014-03-08,UTA,PHI,2014,94.5
5198,5198,98,Home,W 104-89 ,240,41,77,0.532,29,52,0.558,12,25,0.48,10,16,0.625,104,36,81,0.444,31,58,0.534,5,23,0.217,12,21,0.571,89,2014-03-09,BRK,SAC,2014,91.5
5199,5199,99,Home,L 104-111 ,240,41,95,0.432,34,76,0.447,7,19,0.368,15,20,0.75,104,37,76,0.487,23,52,0.442,14,24,0.583,23,31,0.742,111,2014-03-09,MIN,TOR,2014,118.0
5200,5200,0,@,W 104-96 ,240,40,79,0.506,28,58,0.483,12,21,0.571,12,15,0.8,104,32,75,0.427,24,57,0.421,8,18,0.444,24,28,0.857,96,2014-03-11,SAS,CHI,2014,100.0
5201,5201,1,Home,L 104-112 (OT),265,37,91,0.407,30,68,0.441,7,23,0.304,23,30,0.767,104,41,104,0.394,34,80,0.425,7,24,0.292,23,25,0.92,112,2014-03-15,DET,IND,2014,115.5
5202,5202,2,@,L 104-113 ,240,37,75,0.493,28,52,0.538,9,23,0.391,21,28,0.75,104,40,78,0.513,31,56,0.554,9,22,0.409,24,29,0.828,113,2014-03-16,HOU,MIA,2014,117.5
5203,5203,3,Home,W 104-102 ,240,34,78,0.436,28,61,0.459,6,17,0.353,30,38,0.789,104,41,85,0.482,35,66,0.53,6,19,0.316,14,19,0.737,102,2014-03-16,MIN,SAC,2014,105.0
5204,5204,4,@,L 104-122 ,240,42,91,0.462,37,80,0.463,5,11,0.455,15,21,0.714,104,49,78,0.628,39,62,0.629,10,16,0.625,14,19,0.737,122,2014-03-16,UTA,SAS,2014,127.0
5205,5205,5,Home,W 104-99 ,240,37,75,0.493,28,55,0.509,9,20,0.45,21,35,0.6,104,40,85,0.471,31,58,0.534,9,27,0.333,10,12,0.833,99,2014-03-19,BRK,CHA,2014,103.5
5206,5206,6,Home,L 104-107 (OT),265,35,91,0.385,25,60,0.417,10,31,0.323,24,31,0.774,104,34,84,0.405,23,54,0.426,11,30,0.367,28,33,0.848,107,2014-03-23,DAL,BRK,2014,112.5
5207,5207,7,@,L 104-109 (OT),265,33,90,0.367,23,50,0.46,10,40,0.25,28,32,0.875,104,40,85,0.471,31,65,0.477,9,20,0.45,20,27,0.741,109,2014-03-24,BRK,NOP,2014,113.5
5208,5208,8,Home,L 104-114 ,240,41,96,0.427,31,70,0.443,10,26,0.385,12,14,0.857,104,38,82,0.463,26,52,0.5,12,30,0.4,26,32,0.813,114,2014-03-31,MIN,LAC,2014,120.0
5209,5209,9,@,L 104-116 ,240,41,88,0.466,32,61,0.525,9,27,0.333,13,21,0.619,104,46,76,0.605,31,45,0.689,15,31,0.484,9,11,0.818,116,2014-04-04,DET,BRK,2014,123.5
5210,5210,10,@,W 104-102 ,240,41,85,0.482,30,61,0.492,11,24,0.458,11,19,0.579,104,38,87,0.437,34,71,0.479,4,16,0.25,22,29,0.759,102,2014-04-09,IND,MIL,2014,104.0
5211,5211,11,@,L 104-112 ,240,39,82,0.476,30,56,0.536,9,26,0.346,17,19,0.895,104,43,96,0.448,30,66,0.455,13,30,0.433,13,16,0.813,112,2014-04-11,PHO,SAS,2014,118.5
5212,5212,12,@,L 104-111 ,240,39,88,0.443,30,66,0.455,9,22,0.409,17,21,0.81,104,35,74,0.473,25,47,0.532,10,27,0.37,31,39,0.795,111,2014-04-12,NOP,HOU,2014,116.0
5213,5213,13,Home,W 104-91 ,240,40,84,0.476,32,62,0.516,8,22,0.364,16,19,0.842,104,32,68,0.471,27,60,0.45,5,8,0.625,22,34,0.647,91,2014-04-12,WAS,MIL,2014,93.5
5214,5214,14,Home,W 104-98 ,240,38,85,0.447,34,63,0.54,4,22,0.182,24,29,0.828,104,39,89,0.438,35,72,0.486,4,17,0.235,16,18,0.889,98,2014-04-14,HOU,SAS,2014,100.0
5215,5215,15,Home,L 104-119 ,240,42,81,0.519,36,62,0.581,6,19,0.316,14,20,0.7,104,45,82,0.549,35,58,0.603,10,24,0.417,19,22,0.864,119,2014-04-14,UTA,LAL,2014,124.0
5216,5216,16,@,L 104-110 ,240,34,84,0.405,26,50,0.52,8,34,0.235,28,33,0.848,104,42,101,0.416,32,75,0.427,10,26,0.385,16,22,0.727,110,2014-04-16,LAC,POR,2014,115.0
5217,5217,17,@,W 104-99 ,240,40,86,0.465,32,66,0.485,8,20,0.4,16,22,0.727,104,37,86,0.43,33,67,0.493,4,19,0.211,21,30,0.7,99,2014-04-16,PHO,SAC,2014,101.0
5218,5218,18,@,W 104-80 ,240,36,71,0.507,29,47,0.617,7,24,0.292,25,30,0.833,104,31,85,0.365,28,68,0.412,3,17,0.176,15,17,0.882,80,2014-10-29,CHI,NYK,2015,81.5
5219,5219,19,@,W 104-93 ,240,40,77,0.519,26,50,0.52,14,27,0.519,10,14,0.714,104,38,81,0.469,35,63,0.556,3,18,0.167,14,17,0.824,93,2014-10-29,HOU,UTA,2015,94.5
5220,5220,20,@,L 104-127 ,240,41,88,0.466,37,74,0.5,4,14,0.286,18,25,0.72,104,46,83,0.554,35,60,0.583,11,23,0.478,24,28,0.857,127,2014-11-01,LAL,GSW,2015,132.5
5221,5221,21,Home,W 104-90 ,240,32,76,0.421,20,42,0.476,12,34,0.353,28,40,0.7,104,37,98,0.378,36,73,0.493,1,25,0.04,15,18,0.833,90,2014-11-01,HOU,BOS,2015,90.5
5222,5222,22,Home,L 104-109 ,240,38,89,0.427,31,70,0.443,7,19,0.368,21,28,0.75,104,46,89,0.517,40,64,0.625,6,25,0.24,11,19,0.579,109,2014-11-01,NOP,DAL,2015,112.0
5223,5223,23,@,W 104-93 ,240,32,75,0.427,16,41,0.39,16,34,0.471,24,30,0.8,104,33,74,0.446,22,52,0.423,11,22,0.5,16,23,0.696,93,2014-11-03,HOU,PHI,2015,98.5
5224,5224,24,@,L 104-121 ,240,38,82,0.463,31,63,0.492,7,19,0.368,21,27,0.778,104,43,74,0.581,28,49,0.571,15,25,0.6,20,20,1.0,121,2014-11-05,LAC,GSW,2015,128.5
5225,5225,25,Home,W 104-96 ,240,40,83,0.482,36,69,0.522,4,14,0.286,20,23,0.87,104,39,75,0.52,31,60,0.517,8,15,0.533,10,16,0.625,96,2014-11-09,BRK,ORL,2015,100.0
5226,5226,26,Home,W 104-100 ,240,35,77,0.455,26,56,0.464,9,21,0.429,25,30,0.833,104,39,81,0.481,27,56,0.482,12,25,0.48,10,16,0.625,100,2014-11-11,TOR,ORL,2015,106.0
5227,5227,27,@,L 104-112 ,240,35,74,0.473,26,53,0.491,9,21,0.429,25,32,0.781,104,39,81,0.481,31,57,0.544,8,24,0.333,26,29,0.897,112,2014-11-12,BRK,PHO,2015,116.0
5228,5228,28,Home,L 104-114 ,240,42,84,0.5,42,76,0.553,0,8,0.0,20,24,0.833,104,44,89,0.494,37,62,0.597,7,27,0.259,19,23,0.826,114,2014-11-24,PHI,POR,2015,117.5
5229,5229,29,Home,W 104-100 ,240,37,82,0.451,33,65,0.508,4,17,0.235,26,32,0.813,104,39,84,0.464,25,51,0.49,14,33,0.424,8,11,0.727,100,2014-11-24,TOR,PHO,2015,107.0
5230,5230,30,@,W 104-98 ,240,37,78,0.474,25,50,0.5,12,28,0.429,18,19,0.947,104,35,78,0.449,25,51,0.49,10,27,0.37,18,24,0.75,98,2014-11-26,LAC,DET,2015,103.0
5231,5231,31,@,W 104-88 ,240,39,77,0.506,26,48,0.542,13,29,0.448,13,16,0.813,104,34,83,0.41,28,60,0.467,6,23,0.261,14,25,0.56,88,2014-11-28,MIL,DET,2015,91.0
5232,5232,32,@,L 104-112 ,240,38,75,0.507,32,65,0.492,6,10,0.6,22,26,0.846,104,42,82,0.512,30,58,0.517,12,24,0.5,16,20,0.8,112,2014-11-28,SAC,SAS,2015,118.0
5233,5233,33,@,W 104-93 ,240,37,79,0.468,28,58,0.483,9,21,0.429,21,27,0.778,104,33,91,0.363,22,68,0.324,11,23,0.478,16,24,0.667,93,2014-11-30,GSW,DET,2015,98.5
5234,5234,34,@,L 104-112 ,240,37,84,0.44,30,60,0.5,7,24,0.292,23,27,0.852,104,39,88,0.443,34,71,0.479,5,17,0.294,29,45,0.644,112,2014-12-02,OKC,NOP,2015,114.5
5235,5235,35,Home,L 104-123 ,240,42,87,0.483,34,59,0.576,8,28,0.286,12,15,0.8,104,45,79,0.57,33,58,0.569,12,21,0.571,21,24,0.875,123,2014-12-03,UTA,TOR,2015,129.0
5236,5236,36,@,W 104-87 ,240,43,83,0.518,35,65,0.538,8,18,0.444,10,15,0.667,104,36,90,0.4,31,71,0.437,5,19,0.263,10,15,0.667,87,2014-12-07,NOP,LAL,2015,89.5
5237,5237,37,Home,W 104-93 ,240,40,80,0.5,36,65,0.554,4,15,0.267,20,26,0.769,104,37,78,0.474,28,59,0.475,9,19,0.474,10,13,0.769,93,2014-12-09,NOP,NYK,2015,97.5
5238,5238,38,Home,W 104-96 ,240,39,80,0.488,30,64,0.469,9,16,0.563,17,21,0.81,104,32,75,0.427,26,55,0.473,6,20,0.3,26,31,0.839,96,2014-12-12,WAS,LAC,2015,99.0
5239,5239,39,@,W 104-92 ,240,41,87,0.471,35,67,0.522,6,20,0.3,16,24,0.667,104,36,84,0.429,31,66,0.47,5,18,0.278,15,17,0.882,92,2014-12-16,OKC,SAC,2015,94.5
5240,5240,40,Home,W 104-97 ,240,41,87,0.471,34,64,0.531,7,23,0.304,15,29,0.517,104,37,77,0.481,30,58,0.517,7,19,0.368,16,22,0.727,97,2014-12-17,POR,MIL,2015,100.5
5241,5241,41,@,W 104-103 ,240,37,86,0.43,29,65,0.446,8,21,0.381,22,29,0.759,104,41,85,0.482,31,60,0.517,10,25,0.4,11,15,0.733,103,2014-12-19,OKC,LAL,2015,108.0
5242,5242,42,Home,W 104-86 ,240,42,87,0.483,33,65,0.508,9,22,0.409,11,16,0.688,104,33,85,0.388,25,54,0.463,8,31,0.258,12,15,0.8,86,2014-12-20,CHA,UTA,2015,90.0
5243,5243,43,@,W 104-97 ,240,38,74,0.514,28,48,0.583,10,26,0.385,18,24,0.75,104,34,86,0.395,19,43,0.442,15,43,0.349,14,18,0.778,97,2014-12-20,ATL,HOU,2015,104.5
5244,5244,44,@,W 104-92 ,240,40,78,0.513,34,61,0.557,6,17,0.353,18,25,0.72,104,34,83,0.41,31,69,0.449,3,14,0.214,21,29,0.724,92,2014-12-21,PHO,WAS,2015,93.5
5245,5245,45,@,L 104-107 ,240,37,92,0.402,26,63,0.413,11,29,0.379,19,28,0.679,104,34,76,0.447,22,53,0.415,12,23,0.522,27,35,0.771,107,2014-12-23,LAC,ATL,2015,113.0
5246,5246,46,@,L 104-125 ,240,39,88,0.443,35,75,0.467,4,13,0.308,22,29,0.759,104,44,84,0.524,32,60,0.533,12,24,0.5,25,31,0.806,125,2014-12-23,MIN,CLE,2015,131.0
5247,5247,47,@,W 104-94 (OT),265,40,85,0.471,34,64,0.531,6,21,0.286,18,21,0.857,104,33,90,0.367,26,65,0.4,7,25,0.28,21,26,0.808,94,2014-12-29,MIL,CHO,2015,97.5
5248,5248,48,@,W 104-103 ,240,35,73,0.479,27,55,0.491,8,18,0.444,26,28,0.929,104,40,86,0.465,31,57,0.544,9,29,0.31,14,23,0.609,103,2014-12-29,WAS,HOU,2015,107.5
5249,5249,49,@,L 104-109 (OT),265,45,100,0.45,40,83,0.482,5,17,0.294,9,11,0.818,104,37,100,0.37,31,72,0.431,6,28,0.214,29,40,0.725,109,2015-01-03,BOS,CHI,2015,112.0
5250,5250,50,@,W 104-95 ,240,38,78,0.487,32,59,0.542,6,19,0.316,22,23,0.957,104,36,91,0.396,29,73,0.397,7,18,0.389,16,23,0.696,95,2015-01-05,CHA,BOS,2015,98.5
5251,5251,51,Home,L 104-105 ,240,36,79,0.456,27,58,0.466,9,21,0.429,23,34,0.676,104,41,87,0.471,38,68,0.559,3,19,0.158,20,28,0.714,105,2015-01-06,SAS,DET,2015,106.5
5252,5252,52,Home,W 104-83 ,240,36,92,0.391,26,73,0.356,10,19,0.526,22,28,0.786,104,29,89,0.326,20,59,0.339,9,30,0.3,16,23,0.696,83,2015-01-07,SAC,OKC,2015,87.5
5253,5253,53,@,W 104-90 ,240,39,81,0.481,33,60,0.55,6,21,0.286,20,24,0.833,104,34,75,0.453,25,49,0.51,9,26,0.346,13,18,0.722,90,2015-01-11,MIA,LAC,2015,94.5
5254,5254,54,Home,L 104-108 (OT),265,38,86,0.442,37,68,0.544,1,18,0.056,27,34,0.794,104,43,100,0.43,37,76,0.487,6,24,0.25,16,23,0.696,108,2015-01-13,SAC,DAL,2015,111.0
5255,5255,55,Home,W 104-89 ,240,38,81,0.469,25,52,0.481,13,29,0.448,15,19,0.789,104,30,71,0.423,24,53,0.453,6,18,0.333,23,27,0.852,89,2015-01-14,GSW,MIA,2015,92.0
5256,5256,56,Home,W 104-81 ,240,36,76,0.474,30,57,0.526,6,19,0.316,26,32,0.813,104,30,81,0.37,24,60,0.4,6,21,0.286,15,18,0.833,81,2015-01-22,CHI,SAS,2015,84.0
5257,5257,57,@,W 104-91 ,240,34,73,0.466,25,47,0.532,9,26,0.346,27,34,0.794,104,34,82,0.415,27,64,0.422,7,18,0.389,16,23,0.696,91,2015-01-27,TOR,IND,2015,94.5
5258,5258,58,@,W 104-86 ,240,44,93,0.473,44,82,0.537,0,11,0.0,16,25,0.64,104,33,92,0.359,28,68,0.412,5,24,0.208,15,20,0.75,86,2015-01-31,CHA,DEN,2015,88.5
5259,5259,59,Home,W 104-97 ,240,37,75,0.493,29,55,0.527,8,20,0.4,22,26,0.846,104,38,90,0.422,32,67,0.478,6,23,0.261,15,18,0.833,97,2015-02-02,OKC,ORL,2015,100.0
5260,5260,60,Home,W 104-100 ,240,40,99,0.404,28,71,0.394,12,28,0.429,12,17,0.706,104,33,80,0.413,29,56,0.518,4,24,0.167,30,33,0.909,100,2015-02-04,BOS,DEN,2015,102.0
5261,5261,61,Home,W 104-86 ,240,42,80,0.525,35,60,0.583,7,20,0.35,13,15,0.867,104,35,75,0.467,33,63,0.524,2,12,0.167,14,27,0.519,86,2015-02-10,CHI,SAC,2015,87.0
5262,5262,62,@,W 104-87 ,240,42,88,0.477,32,61,0.525,10,27,0.37,10,11,0.909,104,33,81,0.407,24,60,0.4,9,21,0.429,12,17,0.706,87,2015-02-11,SAS,DET,2015,91.5
5263,5263,63,Home,W 104-89 ,240,38,91,0.418,31,69,0.449,7,22,0.318,21,26,0.808,104,33,91,0.363,24,64,0.375,9,27,0.333,14,17,0.824,89,2015-02-19,OKC,DAL,2015,93.5
5264,5264,64,Home,W 104-98 ,240,39,81,0.481,31,62,0.5,8,19,0.421,18,23,0.783,104,34,89,0.382,25,63,0.397,9,26,0.346,21,22,0.955,98,2015-02-22,IND,GSW,2015,102.5
5265,5265,65,Home,W 104-87 ,240,39,85,0.459,26,50,0.52,13,35,0.371,13,16,0.813,104,34,80,0.425,29,49,0.592,5,31,0.161,14,18,0.778,87,2015-02-25,ATL,DAL,2015,89.5
5266,5266,66,Home,W 104-88 ,240,44,82,0.537,39,67,0.582,5,15,0.333,11,16,0.688,104,31,75,0.413,20,50,0.4,11,25,0.44,15,19,0.789,88,2015-02-25,MIL,PHI,2015,93.5
5267,5267,67,@,W 104-82 ,240,39,68,0.574,30,47,0.638,9,21,0.429,17,21,0.81,104,28,84,0.333,20,52,0.385,8,32,0.25,18,29,0.621,82,2015-02-27,UTA,DEN,2015,86.0
5268,5268,68,Home,W 104-102 ,240,39,76,0.513,33,60,0.55,6,16,0.375,20,27,0.741,104,41,84,0.488,33,63,0.524,8,21,0.381,12,16,0.75,102,2015-02-27,NOP,MIA,2015,106.0
5269,5269,69,@,W 104-94 ,240,40,77,0.519,30,54,0.556,10,23,0.435,14,23,0.609,104,35,82,0.427,26,54,0.481,9,28,0.321,15,18,0.833,94,2015-02-28,BRK,DAL,2015,98.5
5270,5270,70,Home,W 104-96 ,240,39,86,0.453,31,57,0.544,8,29,0.276,18,21,0.857,104,39,90,0.433,25,49,0.51,14,41,0.341,4,9,0.444,96,2015-03-03,ATL,HOU,2015,103.0
5271,5271,71,Home,W 104-103 ,240,39,79,0.494,34,66,0.515,5,13,0.385,21,31,0.677,104,39,86,0.453,33,69,0.478,6,17,0.353,19,21,0.905,103,2015-03-03,CHA,LAL,2015,106.0
5272,5272,72,Home,W 104-89 ,240,38,81,0.469,27,58,0.466,11,23,0.478,17,19,0.895,104,32,87,0.368,26,67,0.388,6,20,0.3,19,26,0.731,89,2015-03-06,GSW,DAL,2015,92.0
5273,5273,73,@,W 104-98 ,240,36,79,0.456,26,56,0.464,10,23,0.435,22,25,0.88,104,38,80,0.475,30,59,0.508,8,21,0.381,14,15,0.933,98,2015-03-06,BOS,NOP,2015,102.0
5274,5274,74,@,L 104-108 ,240,42,98,0.429,31,71,0.437,11,27,0.407,9,9,1.0,104,42,82,0.512,36,61,0.59,6,21,0.286,18,25,0.72,108,2015-03-08,TOR,OKC,2015,111.0
5275,5275,75,Home,W 104-98 ,240,37,81,0.457,31,60,0.517,6,21,0.286,24,38,0.632,104,32,73,0.438,26,56,0.464,6,17,0.353,28,39,0.718,98,2015-03-11,MIA,BRK,2015,101.0
5276,5276,76,@,W 104-95 (OT),265,40,87,0.46,30,63,0.476,10,24,0.417,14,20,0.7,104,36,104,0.346,25,63,0.397,11,41,0.268,12,25,0.48,95,2015-03-11,CHI,PHI,2015,100.5
5277,5277,77,Home,W 104-100 (OT),265,41,91,0.451,38,77,0.494,3,14,0.214,19,27,0.704,104,36,94,0.383,33,80,0.413,3,14,0.214,25,30,0.833,100,2015-03-17,NYK,SAS,2015,101.5
5278,5278,78,@,L 104-108 ,240,41,81,0.506,31,55,0.564,10,26,0.385,12,21,0.571,104,46,87,0.529,39,77,0.506,7,10,0.7,9,14,0.643,108,2015-03-18,POR,MIA,2015,111.5
5279,5279,79,@,L 104-111 ,240,38,80,0.475,31,56,0.554,7,24,0.292,21,24,0.875,104,43,94,0.457,38,82,0.463,5,12,0.417,20,24,0.833,111,2015-03-20,POR,ORL,2015,113.5
5280,5280,80,Home,L 104-106 (OT),265,38,87,0.437,29,59,0.492,9,28,0.321,19,31,0.613,104,37,78,0.474,25,59,0.424,12,19,0.632,20,25,0.8,106,2015-03-23,UTA,MIN,2015,112.0
5281,5281,81,@,L 104-108 ,240,35,75,0.467,28,52,0.538,7,23,0.304,27,29,0.931,104,40,93,0.43,28,64,0.438,12,29,0.414,16,24,0.667,108,2015-03-24,TOR,DET,2015,114.0
5282,5282,82,Home,W 104-99 ,240,38,76,0.5,28,59,0.475,10,17,0.588,18,26,0.692,104,40,90,0.444,34,75,0.453,6,15,0.4,13,19,0.684,99,2015-03-29,IND,DAL,2015,102.0
5283,5283,83,Home,L 104-116 ,240,40,85,0.471,33,59,0.559,7,26,0.269,17,19,0.895,104,45,89,0.506,36,63,0.571,9,26,0.346,17,23,0.739,116,2015-03-30,CHA,BOS,2015,120.5
5284,5284,84,@,W 104-84 ,240,39,82,0.476,29,49,0.592,10,33,0.303,16,18,0.889,104,28,76,0.368,22,60,0.367,6,16,0.375,22,27,0.815,84,2015-03-30,UTA,MIN,2015,87.0
5285,5285,85,@,L 104-107 ,240,40,82,0.488,32,57,0.561,8,25,0.32,16,19,0.842,104,45,94,0.479,41,76,0.539,4,18,0.222,13,16,0.813,107,2015-04-08,PHO,DAL,2015,109.0
5286,5286,86,@,W 104-99 ,240,36,74,0.486,25,40,0.625,11,34,0.324,21,26,0.808,104,42,84,0.5,36,66,0.545,6,18,0.333,9,13,0.692,99,2015-04-08,CLE,MIL,2015,102.0
5287,5287,87,Home,W 104-80 ,240,41,82,0.5,31,54,0.574,10,28,0.357,12,16,0.75,104,30,83,0.361,22,53,0.415,8,30,0.267,12,18,0.667,80,2015-04-10,ATL,CHO,2015,84.0
5288,5288,88,@,W 104-103 ,240,41,85,0.482,37,68,0.544,4,17,0.235,18,24,0.75,104,31,66,0.47,22,45,0.489,9,21,0.429,32,53,0.604,103,2015-04-10,SAS,HOU,2015,107.5
5289,5289,89,Home,L 104-107 ,240,37,81,0.457,31,61,0.508,6,20,0.3,24,44,0.545,104,35,83,0.422,26,57,0.456,9,26,0.346,28,37,0.757,107,2015-04-11,MIA,TOR,2015,111.5
5290,5290,90,@,L 104-116 ,240,41,95,0.432,30,67,0.448,11,28,0.393,11,28,0.393,104,42,79,0.532,32,59,0.542,10,20,0.5,22,35,0.629,116,2015-04-12,OKC,IND,2015,121.0
5291,5291,91,Home,W 104-94 ,240,36,73,0.493,24,53,0.453,12,20,0.6,20,21,0.952,104,33,84,0.393,27,60,0.45,6,24,0.25,22,29,0.759,94,2015-10-28,MIA,CHO,2016,97.0
5292,5292,92,Home,L 104-111 ,240,41,94,0.436,30,70,0.429,11,24,0.458,11,18,0.611,104,42,80,0.525,36,61,0.59,6,19,0.316,21,31,0.677,111,2015-10-28,SAC,LAC,2016,114.0
5293,5293,93,Home,W 104-88 ,240,38,87,0.437,30,56,0.536,8,31,0.258,20,33,0.606,104,35,97,0.361,29,67,0.433,6,30,0.2,12,15,0.8,88,2015-10-29,LAC,DAL,2016,91.0
5294,5294,94,Home,W 104-98 ,240,40,90,0.444,33,72,0.458,7,18,0.389,17,21,0.81,104,38,84,0.452,33,71,0.465,5,13,0.385,17,20,0.85,98,2015-11-05,CHI,OKC,2016,100.5
5295,5295,95,@,W 104-98 ,240,33,78,0.423,26,55,0.473,7,23,0.304,31,40,0.775,104,40,93,0.43,37,74,0.5,3,19,0.158,15,20,0.75,98,2015-11-06,LAL,BRK,2016,99.5
5296,5296,96,@,L 104-119 ,240,39,92,0.424,31,68,0.456,8,24,0.333,18,22,0.818,104,46,93,0.495,29,56,0.518,17,37,0.459,10,18,0.556,119,2015-11-06,DEN,GSW,2016,127.5
5297,5297,97,@,L 104-108 ,240,36,91,0.396,26,62,0.419,10,29,0.345,22,27,0.815,104,40,77,0.519,33,58,0.569,7,19,0.368,21,32,0.656,108,2015-11-09,POR,DEN,2016,111.5
5298,5298,98,@,W 104-95 ,240,38,78,0.487,30,52,0.577,8,26,0.308,20,27,0.741,104,36,80,0.45,27,61,0.443,9,19,0.474,14,19,0.737,95,2015-11-10,CHA,MIN,2016,99.5
5299,5299,99,@,L 104-118 ,240,40,90,0.444,31,64,0.484,9,26,0.346,15,28,0.536,104,44,83,0.53,30,53,0.566,14,30,0.467,16,21,0.762,118,2015-11-12,LAC,PHO,2016,125.0
5300,5300,0,Home,W 104-99 ,240,36,84,0.429,29,63,0.46,7,21,0.333,25,31,0.806,104,38,80,0.475,27,47,0.574,11,33,0.333,12,20,0.6,99,2015-11-17,DET,CLE,2016,104.5
5301,5301,1,Home,W 104-101 (OT),265,41,110,0.373,32,89,0.36,9,21,0.429,13,21,0.619,104,36,85,0.424,32,67,0.478,4,18,0.222,25,30,0.833,101,2015-11-18,ORL,MIN,2016,103.0
5302,5302,2,Home,W 104-90 ,240,40,88,0.455,32,66,0.485,8,22,0.364,16,17,0.941,104,34,84,0.405,25,67,0.373,9,17,0.529,13,16,0.813,90,2015-11-20,NOP,SAS,2016,94.5
5303,5303,3,Home,W 104-81 ,240,41,98,0.418,25,67,0.373,16,31,0.516,6,7,0.857,104,32,79,0.405,26,59,0.441,6,20,0.3,11,16,0.688,81,2015-11-25,DET,MIA,2016,84.0
5304,5304,4,Home,W 104-92 ,240,37,87,0.425,29,59,0.492,8,28,0.286,22,29,0.759,104,32,92,0.348,21,66,0.318,11,26,0.423,17,20,0.85,92,2015-11-27,IND,CHI,2016,97.5
5305,5305,5,Home,L 104-113 ,240,35,81,0.432,26,54,0.481,9,27,0.333,25,33,0.758,104,43,90,0.478,41,80,0.513,2,10,0.2,25,26,0.962,113,2015-12-01,NOP,MEM,2016,114.0
5306,5306,6,Home,L 104-108 ,240,37,79,0.468,30,58,0.517,7,21,0.333,23,31,0.742,104,41,96,0.427,33,71,0.465,8,25,0.32,18,20,0.9,108,2015-12-02,WAS,LAL,2016,112.0
5307,5307,7,Home,L 104-116 ,240,42,89,0.472,34,62,0.548,8,27,0.296,12,21,0.571,104,38,76,0.5,22,45,0.489,16,31,0.516,24,27,0.889,116,2015-12-06,WAS,DAL,2016,124.0
5308,5308,8,Home,W 104-84 ,240,36,84,0.429,28,58,0.483,8,26,0.308,24,35,0.686,104,32,87,0.368,22,53,0.415,10,34,0.294,10,22,0.455,84,2015-12-07,CHA,DET,2016,89.0
5309,5309,9,@,W 104-97 ,240,37,82,0.451,24,51,0.471,13,31,0.419,17,20,0.85,104,40,84,0.476,31,59,0.525,9,25,0.36,8,9,0.889,97,2015-12-07,DAL,NYK,2016,101.5
5310,5310,10,@,L 104-107 ,240,40,85,0.471,28,60,0.467,12,25,0.48,12,16,0.75,104,41,80,0.513,35,56,0.625,6,24,0.25,19,27,0.704,107,2015-12-09,ORL,PHO,2016,110.0
5311,5311,11,Home,W 104-98 (OT),265,35,79,0.443,28,58,0.483,7,21,0.333,27,30,0.9,104,39,94,0.415,31,72,0.431,8,22,0.364,12,20,0.6,98,2015-12-13,OKC,UTA,2016,102.0
5312,5312,12,Home,W 104-94 ,240,38,77,0.494,26,45,0.578,12,32,0.375,16,21,0.762,104,33,80,0.413,24,55,0.436,9,25,0.36,19,27,0.704,94,2015-12-14,DAL,PHO,2016,98.5
5313,5313,13,@,W 104-98 ,240,40,75,0.533,33,54,0.611,7,21,0.333,17,24,0.708,104,42,89,0.472,38,73,0.521,4,16,0.25,10,14,0.714,98,2015-12-16,MIA,BRK,2016,100.0
5314,5314,14,@,W 104-94 ,240,34,73,0.466,24,52,0.462,10,21,0.476,26,28,0.929,104,32,67,0.478,25,47,0.532,7,20,0.35,23,29,0.793,94,2015-12-16,NOP,UTA,2016,97.5
5315,5315,15,Home,W 104-100 ,240,41,88,0.466,29,59,0.492,12,29,0.414,10,13,0.769,104,35,74,0.473,29,54,0.537,6,20,0.3,24,28,0.857,100,2015-12-17,CLE,OKC,2016,103.0
5316,5316,16,Home,W 104-97 ,240,37,89,0.416,30,61,0.492,7,28,0.25,23,26,0.885,104,36,86,0.419,28,70,0.4,8,16,0.5,17,17,1.0,97,2015-12-18,IND,BRK,2016,101.0
5317,5317,17,Home,W 104-88 ,240,44,84,0.524,38,68,0.559,6,16,0.375,10,17,0.588,104,26,71,0.366,22,49,0.449,4,22,0.182,32,38,0.842,88,2015-12-18,PHO,NOP,2016,90.0
5318,5318,18,@,W 104-94 ,240,40,76,0.526,31,55,0.564,9,21,0.429,15,24,0.625,104,35,94,0.372,27,65,0.415,8,29,0.276,16,17,0.941,94,2015-12-20,SAC,TOR,2016,98.0
5319,5319,19,@,W 104-90 ,240,40,85,0.471,35,70,0.5,5,15,0.333,19,24,0.792,104,31,66,0.47,24,43,0.558,7,23,0.304,21,32,0.656,90,2015-12-22,MEM,PHI,2016,93.5
5320,5320,20,Home,W 104-101 ,240,44,84,0.524,37,68,0.544,7,16,0.438,9,13,0.692,104,41,83,0.494,34,54,0.63,7,29,0.241,12,17,0.706,101,2015-12-23,ORL,HOU,2016,104.5
5321,5321,21,@,W 104-96 ,240,42,91,0.462,28,56,0.5,14,35,0.4,6,13,0.462,104,36,87,0.414,23,62,0.371,13,25,0.52,11,17,0.647,96,2015-12-23,DEN,PHO,2016,102.5
5322,5322,22,Home,L 104-111 ,240,34,88,0.386,24,61,0.393,10,27,0.37,26,34,0.765,104,38,79,0.481,26,52,0.5,12,27,0.444,23,27,0.852,111,2015-12-26,PHO,PHI,2016,117.0
5323,5323,23,Home,L 104-109 ,240,36,74,0.486,26,47,0.553,10,27,0.37,22,27,0.815,104,38,79,0.481,25,53,0.472,13,26,0.5,20,24,0.833,109,2015-12-26,UTA,LAC,2016,115.5
5324,5324,24,Home,W 104-97 ,240,40,87,0.46,32,66,0.485,8,21,0.381,16,24,0.667,104,38,88,0.432,32,68,0.471,6,20,0.3,15,24,0.625,97,2015-12-28,CHI,TOR,2016,100.0
5325,5325,25,Home,W 104-89 ,240,45,82,0.549,38,65,0.585,7,17,0.412,7,11,0.636,104,37,83,0.446,32,63,0.508,5,20,0.25,10,15,0.667,89,2015-12-28,ORL,NOP,2016,91.5
5326,5326,26,Home,L 104-112 ,240,38,88,0.432,31,61,0.508,7,27,0.259,21,25,0.84,104,43,94,0.457,34,75,0.453,9,19,0.474,17,23,0.739,112,2015-12-30,BOS,LAL,2016,116.5
5327,5327,27,Home,W 104-94 ,240,36,91,0.396,21,58,0.362,15,33,0.455,17,18,0.944,104,34,85,0.4,24,53,0.453,10,32,0.313,16,18,0.889,94,2016-01-01,TOR,CHO,2016,99.0
5328,5328,28,Home,W 104-79 ,240,34,82,0.415,22,45,0.489,12,37,0.324,24,39,0.615,104,29,76,0.382,23,51,0.451,6,25,0.24,15,17,0.882,79,2016-01-02,CLE,ORL,2016,82.0
5329,5329,29,Home,L 104-116 ,240,39,89,0.438,29,60,0.483,10,29,0.345,16,23,0.696,104,40,89,0.449,33,72,0.458,7,17,0.412,29,39,0.744,116,2016-01-04,OKC,SAC,2016,119.5
5330,5330,30,@,L 104-110 ,240,41,91,0.451,34,69,0.493,7,22,0.318,15,23,0.652,104,45,86,0.523,36,69,0.522,9,17,0.529,11,14,0.786,110,2016-01-13,NYK,BRK,2016,114.5
5331,5331,31,@,L 104-107 ,240,36,78,0.462,28,61,0.459,8,17,0.471,24,30,0.8,104,37,75,0.493,30,45,0.667,7,30,0.233,26,38,0.684,107,2016-01-13,MIN,HOU,2016,110.5
5332,5332,32,Home,W 104-90 ,240,40,94,0.426,29,69,0.42,11,25,0.44,13,16,0.813,104,31,70,0.443,22,46,0.478,9,24,0.375,19,29,0.655,90,2016-01-13,LAC,MIA,2016,94.5
5333,5333,33,Home,L 104-116 ,240,38,85,0.447,30,66,0.455,8,19,0.421,20,28,0.714,104,47,93,0.505,32,58,0.552,15,35,0.429,7,11,0.636,116,2016-01-15,BRK,POR,2016,123.5
5334,5334,34,Home,L 104-118 ,240,38,80,0.475,35,63,0.556,3,17,0.176,25,32,0.781,104,51,98,0.52,40,73,0.548,11,25,0.44,5,10,0.5,118,2016-01-15,IND,WAS,2016,123.5
5335,5335,35,Home,L 104-110 ,240,35,83,0.422,28,63,0.444,7,20,0.35,27,36,0.75,104,41,97,0.423,35,69,0.507,6,28,0.214,22,30,0.733,110,2016-01-19,DEN,OKC,2016,113.0
5336,5336,36,@,W 104-98 ,240,39,87,0.448,29,63,0.46,10,24,0.417,16,23,0.696,104,41,94,0.436,32,63,0.508,9,31,0.29,7,11,0.636,98,2016-01-20,ATL,POR,2016,102.5
5337,5337,37,Home,W 104-101 ,240,36,78,0.462,28,56,0.5,8,22,0.364,24,29,0.828,104,40,84,0.476,29,55,0.527,11,29,0.379,10,19,0.526,101,2016-01-23,DEN,DET,2016,106.5
5338,5338,38,@,L 104-115 ,240,36,79,0.456,21,49,0.429,15,30,0.5,17,22,0.773,104,43,89,0.483,28,45,0.622,15,44,0.341,14,21,0.667,115,2016-01-24,DAL,HOU,2016,122.5
5339,5339,39,@,L 104-111 ,240,42,84,0.5,34,64,0.531,8,20,0.4,12,17,0.706,104,39,86,0.453,30,60,0.5,9,26,0.346,24,30,0.8,111,2016-02-01,MIL,SAC,2016,115.5
5340,5340,40,@,W 104-97 ,240,35,74,0.473,26,47,0.553,9,27,0.333,25,32,0.781,104,37,79,0.468,25,48,0.521,12,31,0.387,11,15,0.733,97,2016-02-02,TOR,PHO,2016,103.0
5341,5341,41,@,W 104-103 ,240,38,88,0.432,31,68,0.456,7,20,0.35,21,25,0.84,104,37,87,0.425,29,57,0.509,8,30,0.267,21,35,0.6,103,2016-02-05,BOS,CLE,2016,107.0
5342,5342,42,@,L 104-108 ,240,38,86,0.442,29,61,0.475,9,25,0.36,19,24,0.792,104,38,81,0.469,26,54,0.481,12,27,0.444,20,25,0.8,108,2016-02-06,WAS,CHO,2016,114.0
5343,5343,43,@,L 104-112 ,240,38,79,0.481,26,46,0.565,12,33,0.364,16,31,0.516,104,41,76,0.539,35,65,0.538,6,11,0.545,24,29,0.828,112,2016-02-06,DET,IND,2016,115.0
5344,5344,44,@,L 104-105 ,240,42,90,0.467,33,65,0.508,9,25,0.36,11,13,0.846,104,42,81,0.519,33,62,0.532,9,19,0.474,12,15,0.8,105,2016-02-08,DEN,BRK,2016,109.5
5345,5345,45,Home,L 104-112 ,240,41,93,0.441,35,72,0.486,6,21,0.286,16,22,0.727,104,37,89,0.416,23,49,0.469,14,40,0.35,24,29,0.828,112,2016-02-10,PHO,GSW,2016,119.0
5346,5346,46,@,L 104-109 ,240,31,75,0.413,20,49,0.408,11,26,0.423,31,31,1.0,104,40,82,0.488,33,61,0.541,7,21,0.333,22,28,0.786,109,2016-02-19,MIN,MEM,2016,112.5
5347,5347,47,@,L 104-110 (OT),265,37,89,0.416,18,48,0.375,19,41,0.463,11,18,0.611,104,41,102,0.402,28,67,0.418,13,35,0.371,15,17,0.882,110,2016-02-19,DAL,ORL,2016,116.5
5348,5348,48,@,W 104-96 ,240,40,79,0.506,30,52,0.577,10,27,0.37,14,15,0.933,104,35,81,0.432,30,59,0.508,5,22,0.227,21,24,0.875,96,2016-02-21,CHA,BRK,2016,98.5
5349,5349,49,@,L 104-112 ,240,43,90,0.478,40,78,0.513,3,12,0.25,15,19,0.789,104,40,80,0.5,30,57,0.526,10,23,0.435,22,25,0.88,112,2016-02-23,BRK,POR,2016,117.0
5350,5350,50,@,L 104-109 ,240,38,90,0.422,29,62,0.468,9,28,0.321,19,26,0.731,104,44,88,0.5,36,65,0.554,8,23,0.348,13,16,0.813,109,2016-02-24,WAS,CHI,2016,113.0
5351,5351,51,@,W 104-94 ,240,37,76,0.487,29,57,0.509,8,19,0.421,22,28,0.786,104,35,84,0.417,27,59,0.458,8,25,0.32,16,22,0.727,94,2016-02-27,SAS,HOU,2016,98.0
5352,5352,52,@,W 104-85 ,240,37,88,0.42,25,58,0.431,12,30,0.4,18,20,0.9,104,33,88,0.375,27,67,0.403,6,21,0.286,13,18,0.722,85,2016-03-01,POR,NYK,2016,88.0
5353,5353,53,Home,W 104-98 ,240,35,79,0.443,30,61,0.492,5,18,0.278,29,33,0.879,104,39,82,0.476,30,56,0.536,9,26,0.346,11,20,0.55,98,2016-03-02,MEM,SAC,2016,102.5
5354,5354,54,@,W 104-99 ,240,38,80,0.475,28,60,0.467,10,20,0.5,18,26,0.692,104,34,76,0.447,31,62,0.5,3,14,0.214,28,32,0.875,99,2016-03-02,IND,MIL,2016,100.5
5355,5355,55,@,W 104-98 ,240,42,84,0.5,31,55,0.564,11,29,0.379,9,13,0.692,104,32,75,0.427,27,61,0.443,5,14,0.357,29,34,0.853,98,2016-03-02,WAS,MIN,2016,100.5
5356,5356,56,Home,W 104-94 ,240,40,80,0.5,34,58,0.586,6,22,0.273,18,21,0.857,104,37,83,0.446,27,57,0.474,10,26,0.385,10,16,0.625,94,2016-03-02,TOR,UTA,2016,99.0
5357,5357,57,@,W 104-101 ,240,42,80,0.525,35,55,0.636,7,25,0.28,13,24,0.542,104,45,94,0.479,38,65,0.585,7,29,0.241,4,6,0.667,101,2016-03-03,SAC,DAL,2016,104.5
5358,5358,58,@,L 104-105 ,240,42,92,0.457,33,69,0.478,9,23,0.391,11,14,0.786,104,41,90,0.456,37,70,0.529,4,20,0.2,19,25,0.76,105,2016-03-04,NYK,BOS,2016,107.0
5359,5359,59,Home,W 104-94 ,240,40,81,0.494,32,58,0.552,8,23,0.348,16,19,0.842,104,37,81,0.457,31,65,0.477,6,16,0.375,14,21,0.667,94,2016-03-05,SAS,SAC,2016,97.0
5360,5360,60,@,W 104-96 ,240,32,76,0.421,25,51,0.49,7,25,0.28,33,43,0.767,104,34,90,0.378,31,71,0.437,3,19,0.158,25,30,0.833,96,2016-03-06,OKC,MIL,2016,97.5
5361,5361,61,Home,W 104-99 ,240,37,78,0.474,27,55,0.491,10,23,0.435,20,25,0.8,104,42,82,0.512,36,70,0.514,6,12,0.5,9,9,1.0,99,2016-03-08,TOR,BRK,2016,102.0
5362,5362,62,Home,L 104-118 ,240,35,86,0.407,23,53,0.434,12,33,0.364,22,32,0.688,104,38,86,0.442,27,53,0.509,11,33,0.333,31,41,0.756,118,2016-03-09,PHI,HOU,2016,123.5
5363,5363,63,Home,W 104-96 ,240,38,82,0.463,31,58,0.534,7,24,0.292,21,29,0.724,104,35,82,0.427,28,59,0.475,7,23,0.304,19,27,0.704,96,2016-03-10,TOR,ATL,2016,99.5
5364,5364,64,@,L 104-112 (OT),265,37,98,0.378,28,73,0.384,9,25,0.36,21,26,0.808,104,37,84,0.44,31,66,0.47,6,18,0.333,32,38,0.842,112,2016-03-12,MIA,TOR,2016,115.0
5365,5365,65,Home,W 104-75 ,240,40,85,0.471,25,55,0.455,15,30,0.5,9,10,0.9,104,33,87,0.379,28,63,0.444,5,24,0.208,4,7,0.571,75,2016-03-13,ATL,IND,2016,77.5
5366,5366,66,@,L 104-107 ,240,37,84,0.44,33,68,0.485,4,16,0.25,26,30,0.867,104,40,95,0.421,29,60,0.483,11,35,0.314,16,20,0.8,107,2016-03-14,MIN,PHO,2016,112.5
5367,5367,67,Home,L 104-109 ,240,36,82,0.439,29,63,0.46,7,19,0.368,25,30,0.833,104,43,87,0.494,35,63,0.556,8,24,0.333,15,24,0.625,109,2016-03-21,MIN,GSW,2016,113.0
5368,5368,68,@,L 104-113 ,240,43,80,0.538,36,64,0.563,7,16,0.438,11,15,0.733,104,40,83,0.482,30,49,0.612,10,34,0.294,23,27,0.852,113,2016-03-23,MIL,CLE,2016,118.0
5369,5369,69,Home,W 104-103 ,240,33,76,0.434,27,59,0.458,6,17,0.353,32,40,0.8,104,37,94,0.394,22,57,0.386,15,37,0.405,14,15,0.933,103,2016-03-23,DEN,PHI,2016,110.5
5370,5370,70,@,L 104-113 ,240,42,91,0.462,34,71,0.479,8,20,0.4,12,23,0.522,104,45,80,0.563,40,67,0.597,5,13,0.385,18,32,0.563,113,2016-03-23,SAC,MIN,2016,115.5
5371,5371,71,Home,W 104-95 ,240,41,89,0.461,33,67,0.493,8,22,0.364,14,19,0.737,104,39,89,0.438,29,51,0.569,10,38,0.263,7,9,0.778,95,2016-03-24,BRK,CLE,2016,100.0
5372,5372,72,@,L 104-110 ,240,44,83,0.53,37,65,0.569,7,18,0.389,9,13,0.692,104,44,77,0.571,37,59,0.627,7,18,0.389,15,18,0.833,110,2016-03-25,MEM,SAS,2016,113.5
5373,5373,73,Home,W 104-101 ,240,41,87,0.471,32,61,0.525,9,26,0.346,13,20,0.65,104,38,85,0.447,31,52,0.596,7,33,0.212,18,27,0.667,101,2016-03-27,IND,HOU,2016,104.5
5374,5374,74,Home,W 104-97 ,240,36,87,0.414,26,53,0.491,10,34,0.294,22,27,0.815,104,34,78,0.436,25,54,0.463,9,24,0.375,20,23,0.87,97,2016-04-06,BOS,NOP,2016,101.5
5375,5375,75,Home,L 104-108 ,240,43,90,0.478,39,75,0.52,4,15,0.267,14,19,0.737,104,39,86,0.453,28,59,0.475,11,27,0.407,19,31,0.613,108,2016-04-06,ORL,DET,2016,113.5
5376,5376,76,@,L 104-125 ,240,42,98,0.429,34,74,0.459,8,24,0.333,12,16,0.75,104,46,87,0.529,26,40,0.65,20,47,0.426,13,16,0.813,125,2016-04-13,MEM,GSW,2016,135.0
5377,5377,77,@,L 104-113 ,240,40,82,0.488,32,58,0.552,8,24,0.333,16,16,1.0,104,39,75,0.52,26,56,0.464,13,19,0.684,22,22,1.0,113,2016-10-25,UTA,POR,2017,119.5
5378,5378,78,@,W 104-98 ,240,39,81,0.481,24,50,0.48,15,31,0.484,11,17,0.647,104,32,79,0.405,23,47,0.489,9,32,0.281,25,33,0.758,98,2016-10-29,BOS,CHO,2017,102.5
5379,5379,79,@,L 104-111 ,240,37,86,0.43,28,61,0.459,9,25,0.36,21,26,0.808,104,40,76,0.526,34,55,0.618,6,21,0.286,25,39,0.641,111,2016-10-29,MEM,NYK,2017,114.0
5380,5380,80,@,W 104-72 ,240,42,85,0.494,37,65,0.569,5,20,0.25,15,23,0.652,104,28,80,0.35,23,62,0.371,5,18,0.278,11,15,0.733,72,2016-10-29,ATL,PHI,2017,74.5
5381,5381,81,Home,L 104-127 ,240,37,86,0.43,23,47,0.489,14,39,0.359,16,21,0.762,104,50,89,0.562,40,63,0.635,10,26,0.385,17,23,0.739,127,2016-11-01,POR,GSW,2017,132.0
5382,5382,82,Home,L 104-117 ,240,37,84,0.44,29,61,0.475,8,23,0.348,22,27,0.815,104,46,89,0.517,37,68,0.544,9,21,0.429,16,21,0.762,117,2016-11-04,CHI,NYK,2017,121.5
5383,5383,83,Home,W 104-98 ,240,38,82,0.463,30,56,0.536,8,26,0.308,20,29,0.69,104,38,82,0.463,30,48,0.625,8,34,0.235,14,18,0.778,98,2016-11-09,CHA,UTA,2017,102.0
5384,5384,84,Home,L 104-122 ,240,40,107,0.374,32,74,0.432,8,33,0.242,16,21,0.762,104,40,84,0.476,24,47,0.511,16,37,0.432,26,30,0.867,122,2016-11-12,PHO,BRK,2017,130.0
5385,5385,85,Home,W 104-88 ,240,43,92,0.467,38,76,0.5,5,16,0.313,13,16,0.813,104,33,88,0.375,28,61,0.459,5,27,0.185,17,22,0.773,88,2016-11-14,DET,OKC,2017,90.5
5386,5386,86,@,L 104-120 ,240,39,79,0.494,31,59,0.525,8,20,0.4,18,29,0.621,104,45,93,0.484,37,76,0.487,8,17,0.471,22,24,0.917,120,2016-11-16,PHO,DEN,2017,124.0
5387,5387,87,@,W 104-88 ,240,44,90,0.489,35,62,0.565,9,28,0.321,7,12,0.583,104,31,83,0.373,20,51,0.392,11,32,0.344,15,19,0.789,88,2016-11-18,GSW,BOS,2017,93.5
5388,5388,88,Home,W 104-81 ,240,40,83,0.482,29,58,0.5,11,25,0.44,13,14,0.929,104,29,93,0.312,23,74,0.311,6,19,0.316,17,20,0.85,81,2016-11-18,CLE,DET,2017,84.0
5389,5389,89,Home,W 104-94 ,240,42,88,0.477,32,61,0.525,10,27,0.37,10,14,0.714,104,34,85,0.4,28,64,0.438,6,21,0.286,20,29,0.69,94,2016-11-20,NYK,ATL,2017,97.0
5390,5390,90,Home,L 104-124 ,240,38,84,0.452,27,60,0.45,11,24,0.458,17,18,0.944,104,43,85,0.506,28,53,0.528,15,32,0.469,23,31,0.742,124,2016-11-23,DAL,LAC,2017,131.5
5391,5391,91,@,W 104-99 (2OT),290,38,99,0.384,28,70,0.4,10,29,0.345,18,24,0.75,104,35,93,0.376,23,57,0.404,12,36,0.333,17,23,0.739,99,2016-11-23,MEM,PHI,2017,105.0
5392,5392,92,@,L 104-119 ,240,36,76,0.474,23,53,0.434,13,23,0.565,19,29,0.655,104,47,100,0.47,35,68,0.515,12,32,0.375,13,17,0.765,119,2016-11-25,NOP,POR,2017,125.0
5393,5393,93,Home,L 104-117 ,240,39,80,0.488,30,48,0.625,9,32,0.281,17,21,0.81,104,40,85,0.471,19,35,0.543,21,50,0.42,16,20,0.8,117,2016-11-25,SAC,HOU,2017,127.5
5394,5394,94,@,W 104-96 ,240,41,86,0.477,33,62,0.532,8,24,0.333,14,20,0.7,104,38,92,0.413,31,64,0.484,7,28,0.25,13,17,0.765,96,2016-11-27,MIL,ORL,2017,99.5
5395,5395,95,@,W 104-85 ,240,36,82,0.439,27,56,0.482,9,26,0.346,23,31,0.742,104,36,89,0.404,29,60,0.483,7,29,0.241,6,13,0.462,85,2016-11-28,CHA,MEM,2017,88.5
5396,5396,96,Home,L 104-112 ,240,38,80,0.475,32,50,0.64,6,30,0.2,22,32,0.688,104,40,83,0.482,29,56,0.518,11,27,0.407,21,26,0.808,112,2016-11-28,MIA,BOS,2017,117.5
5397,5397,97,Home,L 104-106 ,240,34,77,0.442,30,58,0.517,4,19,0.211,32,39,0.821,104,41,91,0.451,28,59,0.475,13,32,0.406,11,15,0.733,106,2016-11-30,MIN,NYK,2017,112.5
5398,5398,98,Home,W 104-84 ,240,37,77,0.481,24,48,0.5,13,29,0.448,17,18,0.944,104,34,90,0.378,25,64,0.391,9,26,0.346,7,13,0.538,84,2016-12-10,UTA,SAC,2017,88.5
5399,5399,99,Home,W 104-74 ,240,40,90,0.444,31,67,0.463,9,23,0.391,15,17,0.882,104,27,76,0.355,18,46,0.391,9,30,0.3,11,20,0.55,74,2016-12-20,GSW,UTA,2017,78.5
5400,5400,0,@,L 104-116 ,240,36,91,0.396,26,56,0.464,10,35,0.286,22,28,0.786,104,42,91,0.462,34,73,0.466,8,18,0.444,24,31,0.774,116,2016-12-20,BRK,TOR,2017,120.0
5401,5401,1,@,W 104-98 ,240,43,81,0.531,35,60,0.583,8,21,0.381,10,15,0.667,104,35,79,0.443,25,52,0.481,10,27,0.37,18,21,0.857,98,2016-12-23,TOR,UTA,2017,103.0
5402,5402,2,Home,W 104-90 ,240,37,82,0.451,22,51,0.431,15,31,0.484,15,18,0.833,104,35,83,0.422,27,51,0.529,8,32,0.25,12,17,0.706,90,2016-12-26,MIN,ATL,2017,94.0
5403,5403,3,@,L 104-111 ,240,37,75,0.493,24,43,0.558,13,32,0.406,17,22,0.773,104,37,70,0.529,25,45,0.556,12,25,0.48,25,30,0.833,111,2016-12-26,DAL,NOP,2017,117.0
5404,5404,4,Home,W 104-92 ,240,38,85,0.447,26,56,0.464,12,29,0.414,16,17,0.941,104,35,93,0.376,28,70,0.4,7,23,0.304,15,16,0.938,92,2016-12-30,NOP,NYK,2017,95.5
5405,5405,5,@,L 104-117 ,240,42,97,0.433,32,59,0.542,10,38,0.263,10,11,0.909,104,43,86,0.5,34,64,0.531,9,22,0.409,22,24,0.917,117,2017-01-01,ORL,IND,2017,121.5
5406,5406,6,@,L 104-115 ,240,38,82,0.463,27,56,0.482,11,26,0.423,17,21,0.81,104,41,74,0.554,24,43,0.558,17,31,0.548,16,17,0.941,115,2017-01-03,UTA,BOS,2017,123.5
5407,5407,7,Home,L 104-105 ,240,42,94,0.447,29,66,0.439,13,28,0.464,7,12,0.583,104,37,78,0.474,28,50,0.56,9,28,0.321,22,31,0.71,105,2017-01-04,NYK,MIL,2017,109.5
5408,5408,8,@,W 104-95 ,240,38,90,0.422,27,58,0.466,11,32,0.344,17,25,0.68,104,40,97,0.412,31,55,0.564,9,42,0.214,6,11,0.545,95,2017-01-12,NOP,BRK,2017,99.5
5409,5409,9,Home,W 104-89 ,240,44,92,0.478,37,69,0.536,7,23,0.304,9,11,0.818,104,35,89,0.393,32,71,0.451,3,18,0.167,16,21,0.762,89,2017-01-12,NYK,CHI,2017,90.5
5410,5410,10,Home,L 104-108 ,240,40,95,0.421,29,63,0.46,11,32,0.344,13,13,1.0,104,40,78,0.513,36,61,0.59,4,17,0.235,24,35,0.686,108,2017-01-15,MEM,CHI,2017,110.0
5411,5411,11,Home,L 104-113 ,240,42,89,0.472,37,75,0.493,5,14,0.357,15,22,0.682,104,35,78,0.449,21,41,0.512,14,37,0.378,29,36,0.806,113,2017-01-16,MIL,PHI,2017,120.0
5412,5412,12,Home,W 104-101 ,240,36,80,0.45,28,51,0.549,8,29,0.276,24,26,0.923,104,33,83,0.398,25,58,0.431,8,25,0.32,27,34,0.794,101,2017-01-18,WAS,MEM,2017,105.0
5413,5413,13,@,W 104-101 ,240,40,84,0.476,35,68,0.515,5,16,0.313,19,25,0.76,104,42,87,0.483,38,65,0.585,4,22,0.182,13,24,0.542,101,2017-01-19,MIN,LAC,2017,103.0
5414,5414,14,@,L 104-118 ,240,37,91,0.407,27,60,0.45,10,31,0.323,20,26,0.769,104,44,86,0.512,35,64,0.547,9,22,0.409,21,25,0.84,118,2017-01-19,DEN,SAS,2017,122.5
5415,5415,15,Home,L 104-109 ,240,41,82,0.5,31,54,0.574,10,28,0.357,12,17,0.706,104,40,82,0.488,31,61,0.508,9,21,0.429,20,26,0.769,109,2017-01-23,DET,SAC,2017,113.5
5416,5416,16,Home,W 104-97 ,240,39,86,0.453,30,54,0.556,9,32,0.281,17,18,0.944,104,35,75,0.467,23,43,0.535,12,32,0.375,15,21,0.714,97,2017-01-30,DAL,CLE,2017,103.0
5417,5417,17,Home,W 104-96 ,240,39,82,0.476,28,56,0.5,11,26,0.423,15,23,0.652,104,37,87,0.425,33,61,0.541,4,26,0.154,18,22,0.818,96,2017-01-30,MIA,BRK,2017,98.0
5418,5418,18,@,L 104-109 ,240,41,78,0.526,33,47,0.702,8,31,0.258,14,25,0.56,104,36,87,0.414,24,51,0.471,12,36,0.333,25,30,0.833,109,2017-02-01,TOR,BOS,2017,115.0
5419,5419,19,Home,W 104-88 ,240,36,78,0.462,25,49,0.51,11,29,0.379,21,27,0.778,104,32,73,0.438,23,50,0.46,9,23,0.391,15,25,0.6,88,2017-02-01,UTA,MIL,2017,92.5
5420,5420,20,Home,L 104-108 ,240,40,88,0.455,31,58,0.534,9,30,0.3,15,20,0.75,104,36,76,0.474,19,45,0.422,17,31,0.548,19,23,0.826,108,2017-02-03,POR,DAL,2017,116.5
5421,5421,21,Home,L 104-111 ,240,39,86,0.453,27,55,0.491,12,31,0.387,14,28,0.5,104,41,84,0.488,25,44,0.568,16,40,0.4,13,18,0.722,111,2017-02-04,NYK,CLE,2017,119.0
5422,5422,22,@,L 104-128 ,240,42,88,0.477,36,63,0.571,6,25,0.24,14,20,0.7,104,44,89,0.494,28,51,0.549,16,38,0.421,24,36,0.667,128,2017-02-07,ORL,HOU,2017,136.0
5423,5423,23,Home,L 104-112 ,240,35,86,0.407,27,55,0.491,8,31,0.258,26,30,0.867,104,42,71,0.592,29,41,0.707,13,30,0.433,15,23,0.652,112,2017-02-11,UTA,BOS,2017,118.5
5424,5424,24,Home,L 104-109 (OT),265,37,103,0.359,21,61,0.344,16,42,0.381,14,25,0.56,104,32,83,0.386,24,55,0.436,8,28,0.286,37,48,0.771,109,2017-02-13,POR,ATL,2017,113.0
5425,5425,25,@,L 104-113 ,240,40,86,0.465,28,62,0.452,12,24,0.5,12,14,0.857,104,39,82,0.476,21,43,0.488,18,39,0.462,17,19,0.895,113,2017-02-15,IND,CLE,2017,122.0
5426,5426,26,Home,W 104-103 ,240,38,90,0.422,32,65,0.492,6,25,0.24,22,22,1.0,104,36,77,0.468,22,40,0.55,14,37,0.378,17,20,0.85,103,2017-02-16,CHI,BOS,2017,110.0
5427,5427,27,@,L 104-119 ,240,42,100,0.42,34,74,0.459,8,26,0.308,12,17,0.706,104,46,87,0.529,31,49,0.633,15,38,0.395,12,15,0.8,119,2017-02-23,NYK,CLE,2017,126.5
5428,5428,28,@,W 104-98 ,240,34,85,0.4,22,50,0.44,12,35,0.343,24,30,0.8,104,35,81,0.432,23,48,0.479,12,33,0.364,16,35,0.457,98,2017-02-26,BOS,DET,2017,104.0
5429,5429,29,Home,L 104-109 ,240,41,84,0.488,29,52,0.558,12,32,0.375,10,13,0.769,104,38,85,0.447,22,46,0.478,16,39,0.41,17,24,0.708,109,2017-02-28,LAL,CHO,2017,117.0
5430,5430,30,Home,W 104-100 ,240,39,82,0.476,34,55,0.618,5,27,0.185,21,27,0.778,104,38,82,0.463,29,54,0.537,9,28,0.321,15,22,0.682,100,2017-03-03,DAL,MEM,2017,104.5
5431,5431,31,Home,W 104-89 ,240,42,86,0.488,35,61,0.574,7,25,0.28,13,16,0.813,104,33,82,0.402,31,60,0.517,2,22,0.091,21,30,0.7,89,2017-03-05,DAL,OKC,2017,90.0
5432,5432,32,Home,W 104-93 ,240,37,86,0.43,29,60,0.483,8,26,0.308,22,28,0.786,104,39,84,0.464,32,64,0.5,7,20,0.35,8,12,0.667,93,2017-03-08,MIL,NYK,2017,96.5
5433,5433,33,@,L 104-114 ,240,42,86,0.488,35,67,0.522,7,19,0.368,13,16,0.813,104,42,84,0.5,28,55,0.509,14,29,0.483,16,21,0.762,114,2017-03-08,SAC,SAS,2017,121.0
5434,5434,34,@,L 103-107 ,240,40,83,0.482,32,64,0.5,8,19,0.421,15,19,0.789,103,40,97,0.412,31,78,0.397,9,19,0.474,18,23,0.783,107,2011-12-26,PHI,POR,2012,111.5
5435,5435,35,@,W 103-83 ,240,41,86,0.477,34,69,0.493,7,17,0.412,14,18,0.778,103,33,80,0.413,31,69,0.449,2,11,0.182,15,18,0.833,83,2011-12-28,PHI,PHO,2012,84.0
5436,5436,36,@,W 103-101 ,240,46,93,0.495,43,79,0.544,3,14,0.214,8,14,0.571,103,39,83,0.47,28,54,0.519,11,29,0.379,12,20,0.6,101,2011-12-30,MIA,MIN,2012,106.5
5437,5437,37,@,W 103-93 ,240,34,76,0.447,28,61,0.459,6,15,0.4,29,36,0.806,103,36,83,0.434,31,63,0.492,5,20,0.25,16,21,0.762,93,2012-01-03,POR,OKC,2012,95.5
5438,5438,38,Home,W 103-85 ,240,39,85,0.459,31,66,0.47,8,19,0.421,17,25,0.68,103,34,93,0.366,32,81,0.395,2,12,0.167,15,18,0.833,85,2012-01-04,ORL,WAS,2012,86.0
5439,5439,39,Home,W 103-100 ,240,37,91,0.407,33,70,0.471,4,21,0.19,25,30,0.833,103,39,76,0.513,30,57,0.526,9,19,0.474,13,21,0.619,100,2012-01-05,SAC,MIL,2012,104.5
5440,5440,40,@,W 103-80 ,240,39,83,0.47,31,55,0.564,8,28,0.286,17,20,0.85,103,29,78,0.372,20,52,0.385,9,26,0.346,13,22,0.591,80,2012-01-07,NYK,DET,2012,84.5
5441,5441,41,@,L 103-106 ,240,45,75,0.6,41,61,0.672,4,14,0.286,9,16,0.563,103,44,85,0.518,35,71,0.493,9,14,0.643,9,10,0.9,106,2012-01-10,SAS,MIL,2012,110.5
5442,5442,42,Home,W 103-89 ,240,40,89,0.449,32,68,0.471,8,21,0.381,15,19,0.789,103,35,80,0.438,31,60,0.517,4,20,0.2,15,16,0.938,89,2012-01-13,HOU,SAC,2012,91.0
5443,5443,43,Home,L 103-110 ,240,41,79,0.519,33,57,0.579,8,22,0.364,13,16,0.813,103,40,80,0.5,25,48,0.521,15,32,0.469,15,19,0.789,110,2012-01-13,PHO,NJN,2012,117.5
5444,5444,44,@,W 103-90 ,240,37,86,0.43,31,70,0.443,6,16,0.375,23,27,0.852,103,38,88,0.432,35,74,0.473,3,14,0.214,11,17,0.647,90,2012-01-14,PHI,WAS,2012,91.5
5445,5445,45,Home,W 103-91 ,240,35,72,0.486,27,51,0.529,8,21,0.381,25,40,0.625,103,29,81,0.358,21,62,0.339,8,19,0.421,25,31,0.806,91,2012-01-22,LAC,TOR,2012,95.0
5446,5446,46,Home,W 103-83 ,240,43,83,0.518,37,67,0.552,6,16,0.375,11,20,0.55,103,32,74,0.432,32,67,0.478,0,7,0.0,19,27,0.704,83,2012-01-23,PHI,WAS,2012,83.0
5447,5447,47,Home,W 103-76 ,240,38,90,0.422,33,75,0.44,5,15,0.333,22,30,0.733,103,32,88,0.364,31,80,0.388,1,8,0.125,11,16,0.688,76,2012-01-27,HOU,WAS,2012,76.5
5448,5448,48,Home,W 103-82 ,240,36,70,0.514,26,53,0.491,10,17,0.588,21,26,0.808,103,32,83,0.386,31,74,0.419,1,9,0.111,17,20,0.85,82,2012-01-30,MIL,DET,2012,82.5
5449,5449,49,Home,L 103-120 ,240,40,77,0.519,31,61,0.508,9,16,0.563,14,17,0.824,103,41,78,0.526,35,63,0.556,6,15,0.4,32,39,0.821,120,2012-02-01,NOP,PHO,2012,123.0
5450,5450,50,@,L 103-109 ,240,42,92,0.457,30,69,0.435,12,23,0.522,7,9,0.778,103,33,73,0.452,20,43,0.465,13,30,0.433,30,39,0.769,109,2012-02-01,WAS,ORL,2012,115.5
5451,5451,51,@,W 103-96 ,240,41,78,0.526,31,55,0.564,10,23,0.435,11,19,0.579,103,35,74,0.473,28,56,0.5,7,18,0.389,19,22,0.864,96,2012-02-08,HOU,POR,2012,99.5
5452,5452,52,@,W 103-89 ,240,42,80,0.525,35,58,0.603,7,22,0.318,12,17,0.706,103,35,87,0.402,28,63,0.444,7,24,0.292,12,15,0.8,89,2012-02-11,SAS,NJN,2012,92.5
5453,5453,53,Home,W 103-87 ,240,40,75,0.533,25,50,0.5,15,25,0.6,8,13,0.615,103,36,85,0.424,30,67,0.448,6,18,0.333,9,12,0.75,87,2012-02-15,ORL,PHI,2012,90.0
5454,5454,54,Home,W 103-102 ,240,41,82,0.5,35,66,0.53,6,16,0.375,15,19,0.789,103,41,83,0.494,33,66,0.5,8,17,0.471,12,18,0.667,102,2012-02-17,MEM,DEN,2012,106.0
5455,5455,55,@,W 103-100 (OT),265,40,92,0.435,28,64,0.438,12,28,0.429,11,21,0.524,103,36,89,0.404,28,63,0.444,8,26,0.308,20,23,0.87,100,2012-02-18,SAS,LAC,2012,104.0
5456,5456,56,@,L 103-104 ,240,35,82,0.427,23,56,0.411,12,26,0.462,21,27,0.778,103,37,73,0.507,33,63,0.524,4,10,0.4,26,38,0.684,104,2012-02-18,GSW,MEM,2012,106.0
5457,5457,57,Home,W 103-101 (OT),265,37,92,0.402,32,70,0.457,5,22,0.227,24,35,0.686,103,36,99,0.364,30,72,0.417,6,27,0.222,23,24,0.958,101,2012-02-20,DEN,MIN,2012,104.0
5458,5458,58,Home,W 103-92 ,240,38,83,0.458,30,64,0.469,8,19,0.421,19,22,0.864,103,32,78,0.41,20,55,0.364,12,23,0.522,16,22,0.727,92,2012-02-20,LAL,POR,2012,98.0
5459,5459,59,Home,W 103-95 ,240,38,86,0.442,31,59,0.525,7,27,0.259,20,28,0.714,103,33,82,0.402,27,59,0.458,6,23,0.261,23,31,0.742,95,2012-02-22,LAC,DEN,2012,98.0
5460,5460,60,Home,W 103-93 ,240,40,76,0.526,37,69,0.536,3,7,0.429,20,28,0.714,103,35,84,0.417,33,72,0.458,2,12,0.167,21,27,0.778,93,2012-02-22,TOR,DET,2012,94.0
5461,5461,61,Home,W 103-96 ,240,37,84,0.44,32,64,0.5,5,20,0.25,24,29,0.828,103,40,85,0.471,35,72,0.486,5,13,0.385,11,22,0.5,96,2012-02-28,SAC,UTA,2012,98.5
5462,5462,62,@,L 103-120 ,240,38,82,0.463,29,62,0.468,9,20,0.45,18,27,0.667,103,43,85,0.506,37,65,0.569,6,20,0.3,28,42,0.667,120,2012-02-29,CLE,NYK,2012,123.0
5463,5463,63,Home,L 103-105 (OT),265,37,86,0.43,27,66,0.409,10,20,0.5,19,24,0.792,103,40,86,0.465,34,72,0.472,6,14,0.429,19,25,0.76,105,2012-03-04,HOU,LAC,2012,108.0
5464,5464,64,Home,W 103-71 ,240,43,89,0.483,37,72,0.514,6,17,0.353,11,15,0.733,103,28,80,0.35,28,72,0.389,0,8,0.0,15,18,0.833,71,2012-03-07,PHI,BOS,2012,71.0
5465,5465,65,Home,L 103-104 ,240,39,84,0.464,31,61,0.508,8,23,0.348,17,22,0.773,103,41,89,0.461,31,65,0.477,10,24,0.417,12,14,0.857,104,2012-03-13,OKC,HOU,2012,109.0
5466,5466,66,Home,L 103-105 ,240,41,78,0.526,36,57,0.632,5,21,0.238,16,19,0.842,103,40,78,0.513,34,65,0.523,6,13,0.462,19,21,0.905,105,2012-03-14,GSW,BOS,2012,108.0
5467,5467,67,@,W 103-90 ,240,36,79,0.456,24,54,0.444,12,25,0.48,19,24,0.792,103,34,78,0.436,29,56,0.518,5,22,0.227,17,25,0.68,90,2012-03-15,OKC,DEN,2012,92.5
5468,5468,68,@,L 103-107 ,240,38,73,0.521,30,55,0.545,8,18,0.444,19,24,0.792,103,36,71,0.507,32,62,0.516,4,9,0.444,31,34,0.912,107,2012-03-17,TOR,CHA,2012,109.0
5469,5469,69,@,W 103-87 ,240,43,85,0.506,35,67,0.522,8,18,0.444,9,12,0.75,103,33,84,0.393,28,64,0.438,5,20,0.25,16,20,0.8,87,2012-03-18,ATL,CLE,2012,89.5
5470,5470,70,@,W 103-99 ,240,43,91,0.473,41,81,0.506,2,10,0.2,15,22,0.682,103,33,73,0.452,31,60,0.517,2,13,0.154,31,40,0.775,99,2012-03-18,UTA,LAL,2012,100.0
5471,5471,71,Home,W 103-102 (OT),265,37,93,0.398,29,73,0.397,8,20,0.4,21,24,0.875,103,36,78,0.462,30,59,0.508,6,19,0.316,24,33,0.727,102,2012-03-21,ATL,CLE,2012,105.0
5472,5472,72,Home,W 103-93 ,240,39,83,0.47,28,60,0.467,11,23,0.478,14,21,0.667,103,38,79,0.481,34,67,0.507,4,12,0.333,13,19,0.684,93,2012-03-21,ORL,PHO,2012,95.0
5473,5473,73,@,W 103-102 ,240,43,91,0.473,40,74,0.541,3,17,0.176,14,17,0.824,103,43,106,0.406,39,91,0.429,4,15,0.267,12,21,0.571,102,2012-03-22,UTA,SAC,2012,104.0
5474,5474,74,Home,W 103-96 ,240,40,85,0.471,34,66,0.515,6,19,0.316,17,26,0.654,103,36,82,0.439,28,62,0.452,8,20,0.4,16,19,0.842,96,2012-03-23,LAL,POR,2012,100.0
5475,5475,75,Home,W 103-87 ,240,39,74,0.527,33,63,0.524,6,11,0.545,19,23,0.826,103,33,71,0.465,26,49,0.531,7,22,0.318,14,14,1.0,87,2012-03-25,OKC,MIA,2012,90.5
5476,5476,76,Home,W 103-85 ,240,45,92,0.489,35,73,0.479,10,19,0.526,3,5,0.6,103,28,70,0.4,19,47,0.404,9,23,0.391,20,28,0.714,85,2012-03-27,PHI,CLE,2012,89.5
5477,5477,77,Home,W 103-86 ,240,41,82,0.5,34,63,0.54,7,19,0.368,14,23,0.609,103,30,80,0.375,25,54,0.463,5,26,0.192,21,32,0.656,86,2012-03-28,LAC,PHO,2012,88.5
5478,5478,78,Home,L 103-104 ,240,31,88,0.352,28,75,0.373,3,13,0.231,38,52,0.731,103,39,90,0.433,35,74,0.473,4,16,0.25,22,32,0.688,104,2012-03-30,UTA,SAC,2012,106.0
5479,5479,79,@,L 103-112 ,240,42,79,0.532,37,65,0.569,5,14,0.357,14,18,0.778,103,38,76,0.5,29,57,0.509,9,19,0.474,27,33,0.818,112,2012-03-31,IND,SAS,2012,116.5
5480,5480,80,Home,W 103-98 ,240,35,85,0.412,29,66,0.439,6,19,0.316,27,34,0.794,103,34,77,0.442,28,58,0.483,6,19,0.316,24,31,0.774,98,2012-04-06,IND,OKC,2012,101.0
5481,5481,81,@,L 103-128 ,240,36,77,0.468,31,65,0.477,5,12,0.417,26,35,0.743,103,51,84,0.607,42,66,0.636,9,18,0.5,17,21,0.81,128,2012-04-06,NOP,SAS,2012,132.5
5482,5482,82,Home,W 103-79 ,240,40,68,0.588,33,53,0.623,7,15,0.467,16,19,0.842,103,29,76,0.382,27,65,0.415,2,11,0.182,19,24,0.792,79,2012-04-08,BOS,PHI,2012,80.0
5483,5483,83,Home,W 103-98 ,240,36,71,0.507,29,55,0.527,7,16,0.438,24,31,0.774,103,36,75,0.48,26,55,0.473,10,20,0.5,16,24,0.667,98,2012-04-09,IND,TOR,2012,103.0
5484,5484,84,Home,W 103-90 ,240,40,83,0.482,29,64,0.453,11,19,0.579,12,14,0.857,103,37,79,0.468,34,68,0.5,3,11,0.273,13,16,0.813,90,2012-04-10,CLE,CHA,2012,91.5
5485,5485,85,@,W 103-91 ,240,40,78,0.513,34,64,0.531,6,14,0.429,17,22,0.773,103,31,87,0.356,27,67,0.403,4,20,0.2,25,29,0.862,91,2012-04-11,UTA,HOU,2012,93.0
5486,5486,86,Home,L 103-112 ,240,38,81,0.469,31,63,0.492,7,18,0.389,20,23,0.87,103,44,88,0.5,35,64,0.547,9,24,0.375,15,20,0.75,112,2012-04-12,GSW,DAL,2012,116.5
5487,5487,87,Home,W 103-97 ,240,38,75,0.507,31,60,0.517,7,15,0.467,20,29,0.69,103,41,92,0.446,36,75,0.48,5,17,0.294,10,15,0.667,97,2012-04-13,LAL,DEN,2012,99.5
5488,5488,88,Home,W 103-65 ,240,39,84,0.464,25,55,0.455,14,29,0.483,11,13,0.846,103,22,79,0.278,18,59,0.305,4,20,0.2,17,21,0.81,65,2012-04-13,NYK,WAS,2012,67.0
5489,5489,89,Home,W 103-98 ,240,34,70,0.486,27,57,0.474,7,13,0.538,28,34,0.824,103,40,83,0.482,35,72,0.486,5,11,0.455,13,17,0.765,98,2012-04-14,MEM,UTA,2012,100.5
5490,5490,90,@,L 103-104 ,240,40,76,0.526,24,44,0.545,16,32,0.5,7,10,0.7,103,45,95,0.474,37,76,0.487,8,19,0.421,6,9,0.667,104,2012-04-15,POR,SAC,2012,108.0
5491,5491,91,@,W 103-87 ,240,43,82,0.524,34,67,0.507,9,15,0.6,8,10,0.8,103,36,79,0.456,31,65,0.477,5,14,0.357,10,16,0.625,87,2012-04-18,PHI,CLE,2012,89.5
5492,5492,92,Home,W 103-91 ,240,42,83,0.506,34,61,0.557,8,22,0.364,11,13,0.846,103,29,60,0.483,27,53,0.509,2,7,0.286,31,38,0.816,91,2012-04-18,MEM,NOH,2012,92.0
5493,5493,93,@,W 103-92 ,240,40,75,0.533,36,63,0.571,4,12,0.333,19,22,0.864,103,38,93,0.409,33,77,0.429,5,16,0.313,11,18,0.611,92,2012-04-20,OKC,SAC,2012,94.5
5494,5494,94,Home,W 103-97 ,240,35,92,0.38,31,77,0.403,4,15,0.267,29,38,0.763,103,38,83,0.458,30,67,0.448,8,16,0.5,13,22,0.591,97,2012-04-23,IND,DET,2012,101.0
5495,5495,95,Home,W 103-94 ,240,38,91,0.418,33,77,0.429,5,14,0.357,22,25,0.88,103,40,90,0.444,35,75,0.467,5,15,0.333,9,13,0.692,94,2012-11-05,MEM,UTA,2013,96.5
5496,5496,96,Home,W 103-73 ,240,40,77,0.519,30,53,0.566,10,24,0.417,13,16,0.813,103,30,80,0.375,27,59,0.458,3,21,0.143,10,17,0.588,73,2012-11-07,MIA,BRK,2013,74.5
5497,5497,97,@,L 103-105 ,240,36,73,0.493,28,51,0.549,8,22,0.364,23,31,0.742,103,40,82,0.488,33,66,0.5,7,16,0.438,18,24,0.75,105,2012-11-07,DET,SAC,2013,108.5
5498,5498,98,@,W 103-90 ,240,41,77,0.532,38,64,0.594,3,13,0.231,18,25,0.72,103,32,75,0.427,25,55,0.455,7,20,0.35,19,30,0.633,90,2012-11-08,LAC,POR,2013,93.5
5499,5499,99,Home,W 103-90 ,240,36,81,0.444,28,56,0.5,8,25,0.32,23,30,0.767,103,36,90,0.4,29,67,0.433,7,23,0.304,11,14,0.786,90,2012-11-11,LAL,SAC,2013,93.5
5500,5500,0,@,W 103-86 ,240,35,72,0.486,21,45,0.467,14,27,0.519,19,22,0.864,103,36,77,0.468,35,66,0.53,1,11,0.091,13,19,0.684,86,2012-11-13,POR,SAC,2013,86.5
5501,5501,1,Home,W 103-83 ,240,39,83,0.47,33,67,0.493,6,16,0.375,19,31,0.613,103,30,81,0.37,28,68,0.412,2,13,0.154,21,25,0.84,83,2012-11-16,IND,DAL,2013,84.0
5502,5502,2,@,W 103-95 ,240,38,74,0.514,28,51,0.549,10,23,0.435,17,20,0.85,103,36,96,0.375,28,71,0.394,8,25,0.32,15,20,0.75,95,2012-11-17,DAL,CLE,2013,99.0
5503,5503,3,Home,W 103-83 ,240,39,72,0.542,35,61,0.574,4,11,0.364,21,26,0.808,103,32,71,0.451,28,54,0.519,4,17,0.235,15,19,0.789,83,2012-11-18,DET,BOS,2013,85.0
5504,5504,4,@,L 103-131 ,240,37,86,0.43,20,47,0.426,17,39,0.436,12,14,0.857,103,46,89,0.517,32,64,0.5,14,25,0.56,25,28,0.893,131,2012-11-23,NYK,HOU,2013,138.0
5505,5505,5,Home,W 103-95 ,240,42,78,0.538,31,53,0.585,11,25,0.44,8,18,0.444,103,32,78,0.41,29,60,0.483,3,18,0.167,28,37,0.757,95,2012-11-23,POR,MIN,2013,96.5
5506,5506,6,@,L 103-105 ,240,40,73,0.548,35,59,0.593,5,14,0.357,18,32,0.563,103,36,78,0.462,28,56,0.5,8,22,0.364,25,34,0.735,105,2012-11-26,DEN,UTA,2013,109.0
5507,5507,7,Home,W 103-82 ,240,38,80,0.475,30,62,0.484,8,18,0.444,19,28,0.679,103,29,74,0.392,24,57,0.421,5,17,0.294,19,24,0.792,82,2012-11-28,MEM,TOR,2013,84.5
5508,5508,8,@,L 103-122 ,240,40,86,0.465,32,62,0.516,8,24,0.333,15,22,0.682,103,47,87,0.54,30,54,0.556,17,33,0.515,11,17,0.647,122,2012-11-30,DEN,LAL,2013,130.5
5509,5509,9,Home,W 103-92 ,240,38,80,0.475,29,60,0.483,9,20,0.45,18,19,0.947,103,34,74,0.459,26,52,0.5,8,22,0.364,16,20,0.8,92,2012-12-01,GSW,IND,2013,96.0
5510,5510,10,Home,L 103-113 ,240,36,86,0.419,30,69,0.435,6,17,0.353,25,39,0.641,103,43,86,0.5,35,63,0.556,8,23,0.348,19,20,0.95,113,2012-12-02,LAL,ORL,2013,117.0
5511,5511,11,@,W 103-87 ,240,37,80,0.463,24,52,0.462,13,28,0.464,16,22,0.727,103,35,85,0.412,28,66,0.424,7,19,0.368,10,18,0.556,87,2012-12-05,LAL,NOH,2013,90.5
5512,5512,12,@,L 103-113 ,240,34,75,0.453,27,56,0.482,7,19,0.368,28,31,0.903,103,41,83,0.494,32,62,0.516,9,21,0.429,22,22,1.0,113,2012-12-14,SAC,OKC,2013,117.5
5513,5513,13,Home,W 103-102 ,240,37,85,0.435,24,50,0.48,13,35,0.371,16,23,0.696,103,40,82,0.488,31,58,0.534,9,24,0.375,13,17,0.765,102,2012-12-15,NYK,CLE,2013,106.5
5514,5514,14,Home,W 103-88 ,240,38,81,0.469,26,56,0.464,12,25,0.48,15,20,0.75,103,38,81,0.469,32,65,0.492,6,16,0.375,6,8,0.75,88,2012-12-15,SAS,BOS,2013,91.0
5515,5515,15,Home,W 103-96 ,240,39,85,0.459,31,55,0.564,8,30,0.267,17,20,0.85,103,32,78,0.41,25,55,0.455,7,23,0.304,25,32,0.781,96,2012-12-16,TOR,HOU,2013,99.5
5516,5516,16,Home,W 103-96 ,240,34,78,0.436,28,60,0.467,6,18,0.333,29,34,0.853,103,35,75,0.467,26,48,0.542,9,27,0.333,17,17,1.0,96,2012-12-18,GSW,NOH,2013,100.5
5517,5517,17,Home,W 103-92 ,240,36,77,0.468,23,52,0.442,13,25,0.52,18,23,0.783,103,37,86,0.43,33,69,0.478,4,17,0.235,14,19,0.737,92,2012-12-18,MIA,MIN,2013,94.0
5518,5518,18,Home,W 103-91 ,240,37,62,0.597,28,45,0.622,9,17,0.529,20,27,0.741,103,36,88,0.409,31,70,0.443,5,18,0.278,14,21,0.667,91,2012-12-19,BOS,CLE,2013,93.5
5519,5519,19,@,L 103-125 ,240,40,89,0.449,34,72,0.472,6,17,0.353,17,24,0.708,103,42,75,0.56,31,48,0.646,11,27,0.407,30,36,0.833,125,2012-12-19,PHI,HOU,2013,130.5
5520,5520,20,@,W 103-77 ,240,38,71,0.535,27,50,0.54,11,21,0.524,16,29,0.552,103,29,80,0.363,26,63,0.413,3,17,0.176,16,24,0.667,77,2012-12-23,LAC,PHO,2013,78.5
5521,5521,21,Home,W 103-97 ,240,38,80,0.475,30,52,0.577,8,28,0.286,19,19,1.0,103,30,71,0.423,25,55,0.455,5,16,0.313,32,38,0.842,97,2012-12-25,MIA,OKC,2013,99.5
5522,5522,22,Home,W 103-100 ,240,35,75,0.467,31,60,0.517,4,15,0.267,29,39,0.744,103,38,82,0.463,29,62,0.468,9,20,0.45,15,19,0.789,100,2012-12-29,BRK,CLE,2013,104.5
5523,5523,23,Home,W 103-97 ,240,39,75,0.52,31,55,0.564,8,20,0.4,17,22,0.773,103,36,86,0.419,27,60,0.45,9,26,0.346,16,21,0.762,97,2013-01-01,DET,SAC,2013,101.5
5524,5524,24,@,W 103-99 ,240,41,86,0.477,33,64,0.516,8,22,0.364,13,20,0.65,103,37,94,0.394,34,72,0.472,3,22,0.136,22,33,0.667,99,2013-01-01,PHI,LAL,2013,100.5
5525,5525,25,@,W 103-94 ,240,41,82,0.5,31,60,0.517,10,22,0.455,11,17,0.647,103,32,79,0.405,22,53,0.415,10,26,0.385,20,26,0.769,94,2013-01-01,DAL,WAS,2013,99.0
5526,5526,26,@,L 103-108 ,240,38,77,0.494,28,55,0.509,10,22,0.455,17,21,0.81,103,40,87,0.46,32,72,0.444,8,15,0.533,20,26,0.769,108,2013-01-08,ATL,MIN,2013,112.0
5527,5527,27,Home,W 103-95 ,240,40,72,0.556,31,53,0.585,9,19,0.474,14,23,0.609,103,36,76,0.474,28,56,0.5,8,20,0.4,15,19,0.789,95,2013-01-11,ATL,UTA,2013,99.0
5528,5528,28,Home,W 103-91 ,240,41,79,0.519,32,56,0.571,9,23,0.391,12,16,0.75,103,35,80,0.438,26,47,0.553,9,33,0.273,12,29,0.414,91,2013-01-11,BOS,HOU,2013,95.5
5529,5529,29,Home,W 103-97 ,240,41,86,0.477,35,71,0.493,6,15,0.4,15,18,0.833,103,35,92,0.38,20,49,0.408,15,43,0.349,12,19,0.632,97,2013-01-11,GSW,POR,2013,104.5
5530,5530,30,@,W 103-87 ,240,39,90,0.433,31,68,0.456,8,22,0.364,17,25,0.68,103,36,91,0.396,35,75,0.467,1,16,0.063,14,19,0.737,87,2013-01-11,DET,MIL,2013,87.5
5531,5531,31,@,W 103-76 ,240,36,87,0.414,28,65,0.431,8,22,0.364,23,28,0.821,103,25,72,0.347,22,63,0.349,3,9,0.333,23,30,0.767,76,2013-01-15,IND,CHA,2013,77.5
5532,5532,32,Home,W 103-82 ,240,44,76,0.579,35,58,0.603,9,18,0.5,6,10,0.6,103,29,69,0.42,28,60,0.467,1,9,0.111,23,28,0.821,82,2013-01-16,SAS,MEM,2013,82.5
5533,5533,33,Home,W 103-88 ,240,36,78,0.462,27,59,0.458,9,19,0.474,22,31,0.71,103,33,83,0.398,29,68,0.426,4,15,0.267,18,25,0.72,88,2013-01-20,DET,BOS,2013,90.0
5534,5534,34,@,L 103-108 ,240,38,88,0.432,29,61,0.475,9,27,0.333,18,21,0.857,103,46,84,0.548,40,64,0.625,6,20,0.3,10,17,0.588,108,2013-01-20,LAL,TOR,2013,111.0
5535,5535,35,Home,W 103-87 ,240,41,88,0.466,32,68,0.471,9,20,0.45,12,18,0.667,103,27,78,0.346,23,59,0.39,4,19,0.211,29,33,0.879,87,2013-01-25,CHI,GSW,2013,89.0
5536,5536,36,@,W 103-100 ,240,40,73,0.548,32,60,0.533,8,13,0.615,15,19,0.789,103,45,83,0.542,41,74,0.554,4,9,0.444,6,9,0.667,100,2013-01-28,MEM,PHI,2013,102.0
5537,5537,37,@,L 103-114 ,240,36,81,0.444,28,60,0.467,8,21,0.381,23,28,0.821,103,36,75,0.48,25,50,0.5,11,25,0.44,31,40,0.775,114,2013-02-05,ATL,IND,2013,119.5
5538,5538,38,Home,W 103-92 ,240,38,74,0.514,28,50,0.56,10,24,0.417,17,23,0.739,103,38,84,0.452,33,72,0.458,5,12,0.417,11,16,0.688,92,2013-02-06,ATL,MEM,2013,94.5
5539,5539,39,@,L 103-118 ,240,40,88,0.455,32,62,0.516,8,26,0.308,15,20,0.75,103,47,79,0.595,35,53,0.66,12,26,0.462,12,16,0.75,118,2013-02-08,POR,HOU,2013,124.0
5540,5540,40,Home,L 103-111 ,240,37,84,0.44,28,64,0.438,9,20,0.45,20,26,0.769,103,40,80,0.5,34,63,0.54,6,17,0.353,25,34,0.735,111,2013-02-09,CLE,DEN,2013,114.0
5541,5541,41,@,W 103-89 ,240,39,75,0.52,31,59,0.525,8,16,0.5,17,20,0.85,103,37,78,0.474,35,66,0.53,2,12,0.167,13,20,0.65,89,2013-02-11,SAS,CHI,2013,90.0
5542,5542,42,@,W 103-90 ,240,37,78,0.474,27,55,0.491,10,23,0.435,19,25,0.76,103,36,72,0.5,29,46,0.63,7,26,0.269,11,16,0.688,90,2013-02-20,MIA,ATL,2013,93.5
5543,5543,43,@,W 103-102 ,240,39,91,0.429,25,63,0.397,14,28,0.5,11,14,0.786,103,41,89,0.461,37,77,0.481,4,12,0.333,16,20,0.8,102,2013-02-23,ATL,MIL,2013,104.0
5544,5544,44,@,L 103-105 ,240,38,84,0.452,19,38,0.5,19,46,0.413,8,14,0.571,103,41,80,0.513,34,64,0.531,7,16,0.438,16,19,0.842,105,2013-02-23,HOU,WAS,2013,108.5
5545,5545,45,@,W 103-99 ,240,34,72,0.472,21,47,0.447,13,25,0.52,22,31,0.71,103,39,87,0.448,31,69,0.449,8,18,0.444,13,19,0.684,99,2013-02-24,LAL,DAL,2013,103.0
5546,5546,46,Home,L 103-114 ,240,41,84,0.488,38,70,0.543,3,14,0.214,18,22,0.818,103,40,79,0.506,26,46,0.565,14,33,0.424,20,24,0.833,114,2013-02-25,DET,ATL,2013,121.0
5547,5547,47,Home,W 103-92 ,240,34,82,0.415,29,69,0.42,5,13,0.385,30,32,0.938,103,35,78,0.449,33,58,0.569,2,20,0.1,20,25,0.8,92,2013-02-27,CLE,TOR,2013,93.0
5548,5548,48,@,L 103-105 ,240,36,83,0.434,29,63,0.46,7,20,0.35,24,34,0.706,103,43,95,0.453,36,74,0.486,7,21,0.333,12,17,0.706,105,2013-03-01,OKC,DEN,2013,108.5
5549,5549,49,@,L 103-136 ,240,38,80,0.475,26,53,0.491,12,27,0.444,15,24,0.625,103,46,80,0.575,32,46,0.696,14,34,0.412,30,40,0.75,136,2013-03-03,DAL,HOU,2013,143.0
5550,5550,50,@,W 103-92 ,240,45,86,0.523,41,75,0.547,4,11,0.364,9,11,0.818,103,33,72,0.458,27,58,0.466,6,14,0.429,20,26,0.769,92,2013-03-08,MEM,CLE,2013,95.0
5551,5551,51,@,W 103-93 ,240,38,78,0.487,25,50,0.5,13,28,0.464,14,19,0.737,103,37,82,0.451,31,67,0.463,6,15,0.4,13,20,0.65,93,2013-03-09,MIL,GSW,2013,96.0
5552,5552,52,Home,W 103-90 ,240,42,81,0.519,36,65,0.554,6,16,0.375,13,15,0.867,103,34,80,0.425,27,60,0.45,7,20,0.35,15,18,0.833,90,2013-03-11,UTA,DET,2013,93.5
5553,5553,53,Home,L 103-105 ,240,39,72,0.542,29,51,0.569,10,21,0.476,15,24,0.625,103,42,85,0.494,35,65,0.538,7,20,0.35,14,21,0.667,105,2013-03-18,BOS,MIA,2013,108.5
5554,5554,54,@,W 103-100 ,240,40,87,0.46,29,61,0.475,11,26,0.423,12,16,0.75,103,39,81,0.481,28,58,0.483,11,23,0.478,11,17,0.647,100,2013-03-22,WAS,LAL,2013,105.5
5555,5555,55,Home,W 103-89 ,240,38,68,0.559,30,53,0.566,8,15,0.533,19,26,0.731,103,34,83,0.41,27,61,0.443,7,22,0.318,14,18,0.778,89,2013-03-22,MIA,DET,2013,92.5
5556,5556,56,Home,W 103-83 ,240,43,82,0.524,39,71,0.549,4,11,0.364,13,18,0.722,103,32,79,0.405,22,53,0.415,10,26,0.385,9,13,0.692,83,2013-03-24,OKC,POR,2013,88.0
5557,5557,57,Home,L 103-117 ,240,42,85,0.494,33,61,0.541,9,24,0.375,10,12,0.833,103,47,96,0.49,39,75,0.52,8,21,0.381,15,21,0.714,117,2013-03-24,SAC,PHI,2013,121.0
5558,5558,58,@,L 103-109 ,240,36,91,0.396,30,65,0.462,6,26,0.231,25,36,0.694,103,43,90,0.478,33,67,0.493,10,23,0.435,13,19,0.684,109,2013-03-25,LAL,GSW,2013,114.0
5559,5559,59,Home,W 103-80 ,240,29,63,0.46,21,49,0.429,8,14,0.571,37,41,0.902,103,27,84,0.321,22,64,0.344,5,20,0.25,21,29,0.724,80,2013-03-27,OKC,WAS,2013,82.5
5560,5560,60,Home,W 103-88 ,240,44,85,0.518,38,70,0.543,6,15,0.4,9,13,0.692,103,34,76,0.447,28,60,0.467,6,16,0.375,14,19,0.737,88,2013-03-27,UTA,PHO,2013,91.0
5561,5561,61,@,W 103-78 ,240,40,84,0.476,33,69,0.478,7,15,0.467,16,26,0.615,103,32,83,0.386,28,69,0.406,4,14,0.286,10,14,0.714,78,2013-03-28,IND,DAL,2013,80.0
5562,5562,62,@,L 103-113 ,240,34,77,0.442,29,57,0.509,5,20,0.25,30,39,0.769,103,45,93,0.484,38,74,0.514,7,19,0.368,16,22,0.727,113,2013-03-28,LAL,MIL,2013,116.5
5563,5563,63,Home,L 103-117 ,240,42,94,0.447,35,74,0.473,7,20,0.35,12,23,0.522,103,44,83,0.53,37,65,0.569,7,18,0.389,22,24,0.917,117,2013-03-28,PHO,SAC,2013,120.5
5564,5564,64,Home,W 103-94 ,240,40,79,0.506,36,68,0.529,4,11,0.364,19,21,0.905,103,34,81,0.42,25,54,0.463,9,27,0.333,17,21,0.81,94,2013-03-29,MEM,HOU,2013,98.5
5565,5565,65,@,W 103-98 ,240,38,82,0.463,28,52,0.538,10,30,0.333,17,26,0.654,103,39,86,0.453,32,62,0.516,7,24,0.292,13,16,0.813,98,2013-03-30,LAL,SAC,2013,101.5
5566,5566,66,@,L 103-111 ,240,39,93,0.419,33,78,0.423,6,15,0.4,19,21,0.905,103,44,98,0.449,35,69,0.507,9,29,0.31,14,22,0.636,111,2013-04-01,ORL,HOU,2013,115.5
5567,5567,67,@,L 103-113 (OT),265,39,101,0.386,31,73,0.425,8,28,0.286,17,26,0.654,103,51,109,0.468,43,94,0.457,8,15,0.533,3,8,0.375,113,2013-04-10,MIL,ORL,2013,117.0
5568,5568,68,@,W 103-98 ,240,33,75,0.44,16,34,0.471,17,41,0.415,20,23,0.87,103,36,80,0.45,25,57,0.439,11,23,0.478,15,21,0.714,98,2013-04-10,MIA,WAS,2013,103.5
5569,5569,69,@,W 103-97 ,240,38,80,0.475,31,59,0.525,7,21,0.333,20,25,0.8,103,34,76,0.447,25,57,0.439,9,19,0.474,20,25,0.8,97,2013-04-15,MEM,DAL,2013,101.5
5570,5570,70,Home,W 103-99 ,240,39,81,0.481,31,57,0.544,8,24,0.333,17,23,0.739,103,37,78,0.474,36,65,0.554,1,13,0.077,24,32,0.75,99,2013-04-17,BRK,DET,2013,99.5
5571,5571,71,@,L 103-116 ,240,41,83,0.494,33,62,0.532,8,21,0.381,13,23,0.565,103,42,93,0.452,28,64,0.438,14,29,0.483,18,28,0.643,116,2013-10-29,LAC,LAL,2014,123.0
5572,5572,72,@,L 103-105 ,240,40,90,0.444,31,68,0.456,9,22,0.409,14,26,0.538,103,38,89,0.427,29,64,0.453,9,25,0.36,20,24,0.833,105,2013-11-03,ATL,LAL,2014,109.5
5573,5573,73,Home,W 103-93 ,240,37,70,0.529,26,43,0.605,11,27,0.407,18,27,0.667,103,35,82,0.427,23,52,0.442,12,30,0.4,11,16,0.688,93,2013-11-03,MIA,WAS,2014,99.0
5574,5574,74,Home,W 103-96 ,240,35,82,0.427,33,64,0.516,2,18,0.111,31,37,0.838,103,32,80,0.4,18,43,0.419,14,37,0.378,18,22,0.818,96,2013-11-03,OKC,PHO,2014,103.0
5575,5575,75,@,L 103-114 ,240,36,80,0.45,28,58,0.483,8,22,0.364,23,28,0.821,103,40,83,0.482,31,63,0.492,9,20,0.45,25,32,0.781,114,2013-11-08,DEN,PHO,2014,118.5
5576,5576,76,@,W 103-94 ,240,35,76,0.461,25,49,0.51,10,27,0.37,23,28,0.821,103,33,81,0.407,28,68,0.412,5,13,0.385,23,29,0.793,94,2013-11-11,ATL,CHA,2014,96.5
5577,5577,77,@,L 103-109 ,240,42,91,0.462,39,77,0.506,3,14,0.214,16,21,0.762,103,42,82,0.512,31,59,0.525,11,23,0.478,14,15,0.933,109,2013-11-11,DET,POR,2014,114.5
5578,5578,78,@,L 103-111 ,240,35,75,0.467,29,59,0.492,6,16,0.375,27,33,0.818,103,39,86,0.453,33,58,0.569,6,28,0.214,27,34,0.794,111,2013-11-13,OKC,LAC,2014,114.0
5579,5579,79,@,W 103-87 ,240,31,67,0.463,23,52,0.442,8,15,0.533,33,39,0.846,103,35,82,0.427,29,61,0.475,6,21,0.286,11,17,0.647,87,2013-11-13,TOR,MEM,2014,90.0
5580,5580,80,@,L 103-113 ,240,40,86,0.465,35,67,0.522,5,19,0.263,18,23,0.783,103,39,81,0.481,29,58,0.5,10,23,0.435,25,31,0.806,113,2013-11-15,PHI,ATL,2014,118.0
5581,5581,81,@,L 103-110 ,240,36,85,0.424,27,62,0.435,9,23,0.391,22,33,0.667,103,40,77,0.519,30,54,0.556,10,23,0.435,20,30,0.667,110,2013-11-16,BRK,LAC,2014,115.0
5582,5582,82,@,W 103-96 (OT),265,36,81,0.444,26,60,0.433,10,21,0.476,21,22,0.955,103,37,93,0.398,31,68,0.456,6,25,0.24,16,22,0.727,96,2013-11-16,CLE,WAS,2014,99.0
5583,5583,83,@,W 103-96 (OT),265,33,87,0.379,24,57,0.421,9,30,0.3,28,36,0.778,103,37,100,0.37,29,70,0.414,8,30,0.267,14,17,0.824,96,2013-11-20,IND,NYK,2014,100.0
5584,5584,84,Home,W 103-93 ,240,38,75,0.507,31,58,0.534,7,17,0.412,20,27,0.741,103,39,78,0.5,32,58,0.552,7,20,0.35,8,12,0.667,93,2013-11-22,DAL,UTA,2014,96.5
5585,5585,85,Home,W 103-102 ,240,33,68,0.485,22,43,0.512,11,25,0.44,26,45,0.578,103,37,88,0.42,32,71,0.451,5,17,0.294,23,30,0.767,102,2013-11-23,LAC,SAC,2014,104.5
5586,5586,86,Home,W 103-99 ,240,44,99,0.444,37,81,0.457,7,18,0.389,8,10,0.8,103,32,76,0.421,23,53,0.434,9,23,0.391,26,34,0.765,99,2013-11-27,DAL,GSW,2014,103.5
5587,5587,87,Home,W 103-86 ,240,38,76,0.5,27,53,0.509,11,23,0.478,16,26,0.615,103,32,86,0.372,28,68,0.412,4,18,0.222,18,27,0.667,86,2013-11-29,BOS,CLE,2014,88.0
5588,5588,88,@,W 103-99 ,240,38,77,0.494,28,56,0.5,10,21,0.476,17,23,0.739,103,34,76,0.447,21,41,0.512,13,35,0.371,18,21,0.857,99,2013-12-01,NOP,NYK,2014,105.5
5589,5589,89,@,L 103-113 ,240,37,89,0.416,28,60,0.467,9,29,0.31,20,26,0.769,103,49,87,0.563,40,68,0.588,9,19,0.474,6,9,0.667,113,2013-12-01,MIN,OKC,2014,117.5
5590,5590,90,@,L 103-109 ,240,40,83,0.482,31,55,0.564,9,28,0.321,14,20,0.7,103,43,79,0.544,33,62,0.532,10,17,0.588,13,16,0.813,109,2013-12-02,HOU,UTA,2014,114.0
5591,5591,91,@,L 103-112 ,240,40,77,0.519,32,57,0.561,8,20,0.4,15,18,0.833,103,40,79,0.506,28,50,0.56,12,29,0.414,20,25,0.8,112,2013-12-03,TOR,GSW,2014,118.0
5592,5592,92,@,W 103-82 ,240,43,78,0.551,39,60,0.65,4,18,0.222,13,19,0.684,103,24,82,0.293,19,60,0.317,5,22,0.227,29,39,0.744,82,2013-12-07,MIA,MIN,2014,84.5
5593,5593,93,@,W 103-92 ,240,35,83,0.422,28,61,0.459,7,22,0.318,26,34,0.765,103,40,88,0.455,37,72,0.514,3,16,0.188,9,14,0.643,92,2013-12-07,DEN,PHI,2014,93.5
5594,5594,94,Home,L 103-116 ,240,38,83,0.458,28,60,0.467,10,23,0.435,17,19,0.895,103,45,82,0.549,32,59,0.542,13,23,0.565,13,16,0.813,116,2013-12-10,TOR,SAS,2014,122.5
5595,5595,95,@,W 103-93 ,240,38,84,0.452,30,63,0.476,8,21,0.381,19,20,0.95,103,36,85,0.424,29,64,0.453,7,21,0.333,14,24,0.583,93,2013-12-13,UTA,DEN,2014,96.5
5596,5596,96,Home,W 103-99 ,240,39,83,0.47,36,73,0.493,3,10,0.3,22,31,0.71,103,36,79,0.456,24,56,0.429,12,23,0.522,15,20,0.75,99,2013-12-13,DET,BRK,2014,105.0
5597,5597,97,@,W 103-99 ,240,35,88,0.398,23,54,0.426,12,34,0.353,21,31,0.677,103,35,85,0.412,31,68,0.456,4,17,0.235,25,29,0.862,99,2013-12-20,PHO,DEN,2014,101.0
5598,5598,98,@,L 103-122 ,240,43,74,0.581,36,52,0.692,7,22,0.318,10,24,0.417,103,51,83,0.614,41,60,0.683,10,23,0.435,10,14,0.714,122,2013-12-20,SAC,MIA,2014,127.0
5599,5599,99,@,W 103-86 ,240,38,83,0.458,29,55,0.527,9,28,0.321,18,19,0.947,103,29,76,0.382,23,50,0.46,6,26,0.231,22,25,0.88,86,2013-12-23,IND,BRK,2014,89.0
5600,5600,0,@,W 103-98 ,240,39,86,0.453,29,65,0.446,10,21,0.476,15,19,0.789,103,37,89,0.416,29,64,0.453,8,25,0.32,16,22,0.727,98,2013-12-23,NYK,ORL,2014,102.0
5601,5601,1,@,L 103-105 ,240,40,81,0.494,36,63,0.571,4,18,0.222,19,23,0.826,103,40,95,0.421,30,71,0.423,10,24,0.417,15,22,0.682,105,2013-12-25,LAC,GSW,2014,110.0
5602,5602,2,@,L 103-108 (OT),265,38,86,0.442,27,54,0.5,11,32,0.344,16,21,0.762,103,41,83,0.494,36,63,0.571,5,20,0.25,21,25,0.84,108,2013-12-27,MIA,SAC,2014,110.5
5603,5603,3,@,L 103-105 ,240,40,80,0.5,33,57,0.579,7,23,0.304,16,23,0.696,103,40,88,0.455,31,65,0.477,9,23,0.391,16,20,0.8,105,2013-12-27,LAL,UTA,2014,109.5
5604,5604,4,Home,W 103-100 ,240,38,83,0.458,29,58,0.5,9,25,0.36,18,25,0.72,103,37,79,0.468,28,61,0.459,9,18,0.5,17,24,0.708,100,2013-12-28,BOS,CLE,2014,104.5
5605,5605,5,Home,L 103-113 ,240,42,92,0.457,36,75,0.48,6,17,0.353,13,19,0.684,103,45,83,0.542,36,68,0.529,9,15,0.6,14,23,0.609,113,2014-01-04,SAC,CHA,2014,117.5
5606,5606,6,Home,L 103-104 ,240,34,86,0.395,28,70,0.4,6,16,0.375,29,35,0.829,103,38,92,0.413,27,63,0.429,11,29,0.379,17,23,0.739,104,2014-01-08,MIN,PHO,2014,109.5
5607,5607,7,Home,W 103-83 ,240,41,80,0.513,38,66,0.576,3,14,0.214,18,19,0.947,103,26,78,0.333,18,51,0.353,8,27,0.296,23,29,0.793,83,2014-01-10,SAC,ORL,2014,87.0
5608,5608,8,Home,W 103-97 ,240,38,81,0.469,32,67,0.478,6,14,0.429,21,26,0.808,103,37,79,0.468,33,68,0.485,4,11,0.364,19,20,0.95,97,2014-01-11,CHI,CHA,2014,99.0
5609,5609,9,@,L 103-118 ,240,37,84,0.44,30,58,0.517,7,26,0.269,22,35,0.629,103,44,79,0.557,36,61,0.59,8,18,0.444,22,29,0.759,118,2014-01-13,DEN,UTA,2014,122.0
5610,5610,10,@,W 103-100 ,240,37,72,0.514,33,59,0.559,4,13,0.308,25,41,0.61,103,35,77,0.455,27,57,0.474,8,20,0.4,22,29,0.759,100,2014-01-15,HOU,NOP,2014,104.0
5611,5611,11,Home,W 103-78 ,240,40,82,0.488,34,62,0.548,6,20,0.3,17,20,0.85,103,34,97,0.351,32,78,0.41,2,19,0.105,8,12,0.667,78,2014-01-18,CHI,PHI,2014,79.0
5612,5612,12,@,L 103-117 ,240,36,82,0.439,27,54,0.5,9,28,0.321,22,30,0.733,103,46,91,0.505,38,72,0.528,8,19,0.421,17,26,0.654,117,2014-01-19,DEN,PHO,2014,121.0
5613,5613,13,Home,L 103-112 ,240,40,79,0.506,38,65,0.585,2,14,0.143,21,29,0.724,103,40,72,0.556,31,51,0.608,9,21,0.429,23,37,0.622,112,2014-01-20,DET,LAC,2014,116.5
5614,5614,14,@,W 103-80 ,240,37,75,0.493,23,37,0.622,14,38,0.368,15,20,0.75,103,24,71,0.338,16,46,0.348,8,25,0.32,24,37,0.649,80,2014-01-20,BRK,NYK,2014,84.0
5615,5615,15,@,W 103-101 ,240,37,73,0.507,30,56,0.536,7,17,0.412,22,24,0.917,103,37,85,0.435,31,67,0.463,6,18,0.333,21,28,0.75,101,2014-01-24,NOP,DET,2014,104.0
5616,5616,16,@,W 103-91 ,240,40,76,0.526,36,55,0.655,4,21,0.19,19,25,0.76,103,34,90,0.378,30,63,0.476,4,27,0.148,19,27,0.704,91,2014-01-25,OKC,PHI,2014,93.0
5617,5617,17,Home,W 103-88 ,240,38,91,0.418,28,66,0.424,10,25,0.4,17,21,0.81,103,28,83,0.337,22,62,0.355,6,21,0.286,26,33,0.788,88,2014-01-26,GSW,POR,2014,91.0
5618,5618,18,@,L 103-110 ,240,39,75,0.52,28,52,0.538,11,23,0.478,14,18,0.778,103,43,90,0.478,32,64,0.5,11,26,0.423,13,18,0.722,110,2014-01-26,LAL,NYK,2014,115.5
5619,5619,19,Home,L 103-104 ,240,37,77,0.481,26,53,0.491,11,24,0.458,18,22,0.818,103,37,79,0.468,28,57,0.491,9,22,0.409,21,26,0.808,104,2014-01-27,BRK,TOR,2014,108.5
5620,5620,20,Home,W 103-87 ,240,39,86,0.453,33,66,0.5,6,20,0.3,19,28,0.679,103,32,77,0.416,24,57,0.421,8,20,0.4,15,25,0.6,87,2014-01-28,DET,ORL,2014,91.0
5621,5621,21,@,L 103-110 ,240,45,88,0.511,42,66,0.636,3,22,0.136,10,17,0.588,103,36,73,0.493,30,58,0.517,6,15,0.4,32,42,0.762,110,2014-01-29,WAS,LAC,2014,113.0
5622,5622,22,@,L 103-107 ,240,38,75,0.507,31,54,0.574,7,21,0.333,20,23,0.87,103,38,80,0.475,36,61,0.59,2,19,0.105,29,36,0.806,107,2014-01-31,SAC,DAL,2014,108.0
5623,5623,23,@,L 103-106 ,240,40,87,0.46,34,67,0.507,6,20,0.3,17,25,0.68,103,35,76,0.461,27,58,0.466,8,18,0.444,28,35,0.8,106,2014-02-01,TOR,POR,2014,110.0
5624,5624,24,Home,W 103-89 ,240,46,93,0.495,42,80,0.525,4,13,0.308,7,10,0.7,103,29,73,0.397,22,52,0.423,7,21,0.333,24,29,0.828,89,2014-02-06,BRK,SAS,2014,92.5
5625,5625,25,Home,W 103-81 ,240,38,81,0.469,28,63,0.444,10,18,0.556,17,22,0.773,103,31,76,0.408,19,41,0.463,12,35,0.343,7,14,0.5,81,2014-02-07,DAL,UTA,2014,87.0
5626,5626,26,Home,W 103-102 ,240,38,80,0.475,33,68,0.485,5,12,0.417,22,26,0.846,103,37,73,0.507,27,51,0.529,10,22,0.455,18,19,0.947,102,2014-02-07,ORL,OKC,2014,107.0
5627,5627,27,@,W 103-97 ,240,36,76,0.474,27,49,0.551,9,27,0.333,22,30,0.733,103,35,76,0.461,23,48,0.479,12,28,0.429,15,17,0.882,97,2014-02-11,MIA,PHO,2014,103.0
5628,5628,28,Home,L 103-107 ,240,40,83,0.482,30,55,0.545,10,28,0.357,13,22,0.591,103,39,88,0.443,31,60,0.517,8,28,0.286,21,24,0.875,107,2014-02-13,LAL,OKC,2014,111.0
5629,5629,29,Home,L 103-113 ,240,35,81,0.432,29,60,0.483,6,21,0.286,27,38,0.711,103,44,88,0.5,35,68,0.515,9,20,0.45,16,21,0.762,113,2014-02-18,LAC,SAS,2014,117.5
5630,5630,30,@,W 103-93 ,240,42,74,0.568,35,58,0.603,7,16,0.438,12,15,0.8,103,38,81,0.469,34,66,0.515,4,15,0.267,13,21,0.619,93,2014-02-18,TOR,WAS,2014,95.0
5631,5631,31,@,W 103-81 ,240,41,75,0.547,36,54,0.667,5,21,0.238,16,21,0.762,103,28,74,0.378,26,54,0.481,2,20,0.1,23,30,0.767,81,2014-02-20,MIA,OKC,2014,82.0
5632,5632,32,Home,L 103-107 ,240,38,84,0.452,24,51,0.471,14,33,0.424,13,16,0.813,103,37,88,0.42,29,64,0.453,8,24,0.333,25,29,0.862,107,2014-02-25,ATL,CHI,2014,111.0
5633,5633,33,Home,L 103-129 ,240,36,90,0.4,31,72,0.431,5,18,0.278,26,31,0.839,103,41,72,0.569,30,50,0.6,11,22,0.5,36,42,0.857,129,2014-02-25,SAC,HOU,2014,134.5
5634,5634,34,Home,W 103-83 ,240,37,83,0.446,32,69,0.464,5,14,0.357,24,30,0.8,103,30,84,0.357,25,63,0.397,5,21,0.238,18,22,0.818,83,2014-02-26,CHI,GSW,2014,85.5
5635,5635,35,@,L 103-108 ,240,38,77,0.494,23,49,0.469,15,28,0.536,12,18,0.667,103,45,92,0.489,41,79,0.519,4,13,0.308,14,21,0.667,108,2014-02-26,LAL,MEM,2014,110.0
5636,5636,36,Home,L 103-126 ,240,36,95,0.379,26,70,0.371,10,25,0.4,21,23,0.913,103,44,92,0.478,30,57,0.526,14,35,0.4,24,31,0.774,126,2014-02-28,NYK,GSW,2014,133.0
5637,5637,37,Home,L 103-122 ,240,38,84,0.452,33,62,0.532,5,22,0.227,22,32,0.688,103,45,89,0.506,33,63,0.524,12,26,0.462,20,28,0.714,122,2014-03-01,PHI,WAS,2014,128.0
5638,5638,38,@,L 103-106 ,240,38,80,0.475,31,53,0.585,7,27,0.259,20,29,0.69,103,40,78,0.513,32,55,0.582,8,23,0.348,18,27,0.667,106,2014-03-04,MIA,HOU,2014,110.0
5639,5639,39,Home,W 103-94 ,240,38,74,0.514,23,48,0.479,15,26,0.577,12,13,0.923,103,34,79,0.43,28,64,0.438,6,15,0.4,20,25,0.8,94,2014-03-05,BRK,MEM,2014,97.0
5640,5640,40,Home,W 103-98 ,240,37,79,0.468,33,66,0.5,4,13,0.308,25,34,0.735,103,38,83,0.458,31,57,0.544,7,26,0.269,15,21,0.714,98,2014-03-07,DAL,POR,2014,101.5
5641,5641,41,Home,W 103-90 ,240,38,88,0.432,27,64,0.422,11,24,0.458,16,22,0.727,103,32,83,0.386,28,62,0.452,4,21,0.19,22,30,0.733,90,2014-03-12,SAS,POR,2014,92.0
5642,5642,42,@,W 103-94 ,240,40,82,0.488,30,60,0.5,10,22,0.455,13,18,0.722,103,35,77,0.455,24,48,0.5,11,29,0.379,13,19,0.684,94,2014-03-14,CLE,GSW,2014,99.5
5643,5643,43,Home,L 103-111 ,240,41,86,0.477,38,75,0.507,3,11,0.273,18,21,0.857,103,38,78,0.487,24,45,0.533,14,33,0.424,21,27,0.778,111,2014-03-14,NOP,POR,2014,118.0
5644,5644,44,@,W 103-77 ,240,38,70,0.543,34,55,0.618,4,15,0.267,23,32,0.719,103,31,83,0.373,25,60,0.417,6,23,0.261,9,19,0.474,77,2014-03-15,MEM,PHI,2014,80.0
5645,5645,45,Home,W 103-89 ,240,37,82,0.451,27,55,0.491,10,27,0.37,19,21,0.905,103,35,77,0.455,31,64,0.484,4,13,0.308,15,20,0.75,89,2014-03-18,GSW,ORL,2014,91.0
5646,5646,46,@,L 103-116 ,240,38,90,0.422,26,63,0.413,12,27,0.444,15,17,0.882,103,41,81,0.506,27,46,0.587,14,35,0.4,20,25,0.8,116,2014-03-20,WAS,POR,2014,123.0
5647,5647,47,@,L 103-112 ,240,42,93,0.452,30,64,0.469,12,29,0.414,7,13,0.538,103,45,83,0.542,34,54,0.63,11,29,0.379,11,17,0.647,112,2014-03-22,DET,LAC,2014,117.5
5648,5648,48,Home,W 103-94 ,240,37,80,0.463,31,64,0.484,6,16,0.375,23,29,0.793,103,37,82,0.451,31,63,0.492,6,19,0.316,14,17,0.824,94,2014-03-23,LAL,ORL,2014,97.0
5649,5649,49,@,L 103-108 ,240,38,83,0.458,31,64,0.484,7,19,0.368,20,25,0.8,103,43,88,0.489,35,68,0.515,8,20,0.4,14,20,0.7,108,2014-03-26,DEN,SAS,2014,112.0
5650,5650,50,Home,L 103-109 ,240,37,79,0.468,27,59,0.458,10,20,0.5,19,27,0.704,103,38,82,0.463,27,56,0.482,11,26,0.423,22,25,0.88,109,2014-03-27,DAL,LAC,2014,114.5
5651,5651,51,@,L 103-105 ,240,40,76,0.526,34,58,0.586,6,18,0.333,17,20,0.85,103,40,86,0.465,35,66,0.53,5,20,0.25,20,22,0.909,105,2014-03-28,BOS,TOR,2014,107.5
5652,5652,52,Home,W 103-100 ,240,34,70,0.486,27,47,0.574,7,23,0.304,28,35,0.8,103,42,81,0.519,39,71,0.549,3,10,0.3,13,19,0.684,100,2014-03-29,DAL,SAC,2014,101.5
5653,5653,53,Home,W 103-95 ,240,36,84,0.429,29,53,0.547,7,31,0.226,24,30,0.8,103,36,77,0.468,25,47,0.532,11,30,0.367,12,20,0.6,95,2014-03-31,ATL,PHI,2014,100.5
5654,5654,54,@,W 103-77 ,240,37,80,0.463,29,63,0.46,8,17,0.471,21,25,0.84,103,26,69,0.377,20,55,0.364,6,14,0.429,19,24,0.792,77,2014-03-31,SAS,IND,2014,80.0
5655,5655,55,@,L 103-107 ,240,36,87,0.414,27,61,0.443,9,26,0.346,22,30,0.733,103,34,75,0.453,24,50,0.48,10,25,0.4,29,39,0.744,107,2014-04-02,HOU,TOR,2014,112.0
5656,5656,56,@,L 103-106 ,240,44,87,0.506,37,69,0.536,7,18,0.389,8,12,0.667,103,41,79,0.519,30,56,0.536,11,23,0.478,13,13,1.0,106,2014-04-11,CHA,BOS,2014,111.5
5657,5657,57,@,L 103-106 ,240,35,88,0.398,28,66,0.424,7,22,0.318,26,30,0.867,103,41,82,0.5,35,65,0.538,6,17,0.353,18,27,0.667,106,2014-04-13,MIN,SAC,2014,109.0
5658,5658,58,Home,L 103-111 ,240,40,77,0.519,33,59,0.559,7,18,0.389,16,21,0.762,103,41,76,0.539,33,52,0.635,8,24,0.333,21,26,0.808,111,2014-04-16,MIL,ATL,2014,115.0
5659,5659,59,Home,W 103-91 ,240,38,81,0.469,30,56,0.536,8,25,0.32,19,28,0.679,103,34,89,0.382,28,68,0.412,6,21,0.286,17,30,0.567,91,2014-10-29,IND,PHI,2015,94.0
5660,5660,60,Home,W 103-94 ,240,34,81,0.42,30,71,0.423,4,10,0.4,31,35,0.886,103,34,83,0.41,25,57,0.439,9,26,0.346,17,19,0.895,94,2014-10-31,SAC,POR,2015,98.5
5661,5661,61,@,L 103-112 (OT),265,40,93,0.43,36,75,0.48,4,18,0.222,19,25,0.76,103,46,91,0.505,41,81,0.506,5,10,0.5,15,19,0.789,112,2014-11-07,MIN,ORL,2015,114.5
5662,5662,62,Home,W 103-84 ,240,35,80,0.438,26,58,0.448,9,22,0.409,24,31,0.774,103,30,83,0.361,27,64,0.422,3,19,0.158,21,32,0.656,84,2014-11-07,TOR,WAS,2015,85.5
5663,5663,63,Home,W 103-96 ,240,33,81,0.407,24,59,0.407,9,22,0.409,28,36,0.778,103,40,84,0.476,32,63,0.508,8,21,0.381,8,11,0.727,96,2014-11-08,ATL,NYK,2015,100.0
5664,5664,64,@,L 103-107 ,240,38,81,0.469,29,59,0.492,9,22,0.409,18,22,0.818,103,40,83,0.482,37,72,0.514,3,11,0.273,24,33,0.727,107,2014-11-12,DET,WAS,2015,108.5
5665,5665,65,@,L 103-114 ,240,35,74,0.473,25,53,0.472,10,21,0.476,23,25,0.92,103,42,75,0.56,31,47,0.66,11,28,0.393,19,23,0.826,114,2014-11-14,MIA,ATL,2015,119.5
5666,5666,66,@,W 103-95 ,240,39,91,0.429,32,75,0.427,7,16,0.438,18,19,0.947,103,37,86,0.43,29,57,0.509,8,29,0.276,13,14,0.929,95,2014-11-14,CHA,PHO,2015,99.0
5667,5667,67,Home,W 103-88 ,240,38,74,0.514,34,68,0.5,4,6,0.667,23,27,0.852,103,36,84,0.429,31,65,0.477,5,19,0.263,11,16,0.688,88,2014-11-20,SAC,CHI,2015,90.5
5668,5668,68,@,W 103-86 ,240,40,85,0.471,35,69,0.507,5,16,0.313,18,19,0.947,103,31,81,0.383,28,67,0.418,3,14,0.214,21,34,0.618,86,2014-11-26,MIL,MIN,2015,87.5
5669,5669,69,Home,L 103-117 ,240,33,74,0.446,27,55,0.491,6,19,0.316,31,35,0.886,103,44,87,0.506,29,49,0.592,15,38,0.395,14,16,0.875,117,2014-11-29,MIL,HOU,2015,124.5
5670,5670,70,Home,L 103-110 ,240,36,85,0.424,30,64,0.469,6,21,0.286,25,31,0.806,103,40,89,0.449,32,59,0.542,8,30,0.267,22,30,0.733,110,2014-11-29,PHI,DAL,2015,114.0
5671,5671,71,Home,L 103-109 ,240,38,89,0.427,26,60,0.433,12,29,0.414,15,25,0.6,103,36,83,0.434,27,57,0.474,9,26,0.346,28,35,0.8,109,2014-12-01,PHI,SAS,2015,113.5
5672,5672,72,@,W 103-101 ,240,41,87,0.471,32,61,0.525,9,26,0.346,12,17,0.706,103,36,84,0.429,29,66,0.439,7,18,0.389,22,30,0.733,101,2014-12-01,DEN,UTA,2015,104.5
5673,5673,73,Home,L 103-105 ,240,41,81,0.506,34,61,0.557,7,20,0.35,14,19,0.737,103,43,86,0.5,38,64,0.594,5,22,0.227,14,17,0.824,105,2014-12-02,DEN,POR,2015,107.5
5674,5674,74,Home,W 103-102 ,240,42,88,0.477,38,70,0.543,4,18,0.222,15,18,0.833,103,37,79,0.468,27,57,0.474,10,22,0.455,18,22,0.818,102,2014-12-05,CHA,NYK,2015,107.0
5675,5675,75,@,W 103-91 ,240,35,71,0.493,26,48,0.542,9,23,0.391,24,31,0.774,103,32,84,0.381,24,56,0.429,8,28,0.286,19,30,0.633,91,2014-12-05,OKC,PHI,2015,95.0
5676,5676,76,Home,W 103-87 ,240,43,73,0.589,35,60,0.583,8,13,0.615,9,11,0.818,103,39,80,0.488,34,64,0.531,5,16,0.313,4,8,0.5,87,2014-12-07,MEM,MIA,2015,89.5
5677,5677,77,@,W 103-99 ,240,36,85,0.424,26,57,0.456,10,28,0.357,21,29,0.724,103,41,79,0.519,36,60,0.6,5,19,0.263,12,14,0.857,99,2014-12-07,POR,NYK,2015,101.5
5678,5678,78,@,W 103-97 ,240,43,80,0.538,34,63,0.54,9,17,0.529,8,12,0.667,103,37,77,0.481,20,42,0.476,17,35,0.486,6,9,0.667,97,2014-12-09,MIA,PHO,2015,105.5
5679,5679,79,@,W 103-96 ,240,42,88,0.477,35,64,0.547,7,24,0.292,12,14,0.857,103,35,89,0.393,26,62,0.419,9,27,0.333,17,22,0.773,96,2014-12-10,LAC,IND,2015,100.5
5680,5680,80,Home,W 103-94 ,240,38,87,0.437,31,61,0.508,7,26,0.269,20,22,0.909,103,31,85,0.365,22,57,0.386,9,28,0.321,23,30,0.767,94,2014-12-11,OKC,CLE,2015,98.5
5681,5681,81,Home,L 103-105 ,240,39,83,0.47,29,52,0.558,10,31,0.323,15,19,0.789,103,40,84,0.476,36,69,0.522,4,15,0.267,21,27,0.778,105,2014-12-12,PHO,DET,2015,107.0
5682,5682,82,Home,W 103-97 ,240,34,75,0.453,22,52,0.423,12,23,0.522,23,30,0.767,103,38,82,0.463,32,73,0.438,6,9,0.667,15,19,0.789,97,2014-12-18,CHI,NYK,2015,100.0
5683,5683,83,Home,L 103-104 ,240,41,85,0.482,31,60,0.517,10,25,0.4,11,15,0.733,103,37,86,0.43,29,65,0.446,8,21,0.381,22,29,0.759,104,2014-12-19,LAL,OKC,2015,108.0
5684,5684,84,@,W 103-97 ,240,32,73,0.438,22,47,0.468,10,26,0.385,29,33,0.879,103,37,94,0.394,35,81,0.432,2,13,0.154,21,24,0.875,97,2014-12-19,CHI,MEM,2015,98.0
5685,5685,85,Home,L 103-105 ,240,40,75,0.533,31,56,0.554,9,19,0.474,14,19,0.737,103,39,79,0.494,36,65,0.554,3,14,0.214,24,33,0.727,105,2014-12-19,MIA,WAS,2015,106.5
5686,5686,86,@,W 103-95 ,240,34,73,0.466,27,57,0.474,7,16,0.438,28,37,0.757,103,37,72,0.514,31,52,0.596,6,20,0.3,15,21,0.714,95,2014-12-27,MEM,MIA,2015,98.0
5687,5687,87,@,W 103-80 ,240,41,91,0.451,24,60,0.4,17,31,0.548,4,9,0.444,103,31,82,0.378,26,53,0.491,5,29,0.172,13,17,0.765,80,2014-12-28,DET,CLE,2015,82.5
5688,5688,88,Home,L 103-104 ,240,40,86,0.465,31,57,0.544,9,29,0.31,14,23,0.609,103,35,73,0.479,27,55,0.491,8,18,0.444,26,28,0.929,104,2014-12-29,HOU,WAS,2015,108.0
5689,5689,89,Home,L 103-111 ,240,39,87,0.448,31,61,0.508,8,26,0.308,17,27,0.63,103,40,76,0.526,26,51,0.51,14,25,0.56,17,26,0.654,111,2014-12-30,DEN,LAL,2015,118.0
5690,5690,90,@,W 103-95 ,240,42,88,0.477,38,72,0.528,4,16,0.25,15,22,0.682,103,33,83,0.398,23,52,0.442,10,31,0.323,19,25,0.76,95,2015-01-08,CHA,TOR,2015,100.0
5691,5691,91,Home,L 103-106 ,240,38,96,0.396,25,53,0.472,13,43,0.302,14,18,0.778,103,40,82,0.488,30,59,0.508,10,23,0.435,16,24,0.667,106,2015-01-09,DET,ATL,2015,111.0
5692,5692,92,@,L 103-107 (OT),265,41,103,0.398,31,69,0.449,10,34,0.294,11,16,0.688,103,34,92,0.37,25,69,0.362,9,23,0.391,30,34,0.882,107,2015-01-09,BOS,IND,2015,111.5
5693,5693,93,Home,W 103-92 ,240,36,76,0.474,26,50,0.52,10,26,0.385,21,26,0.808,103,37,92,0.402,34,71,0.479,3,21,0.143,15,20,0.75,92,2015-01-10,POR,ORL,2015,93.5
5694,5694,94,Home,W 103-84 ,240,42,86,0.488,36,69,0.522,6,17,0.353,13,17,0.765,103,33,78,0.423,22,46,0.478,11,32,0.344,7,12,0.583,84,2015-01-11,SAC,CLE,2015,89.5
5695,5695,95,@,W 103-92 ,240,39,83,0.47,36,66,0.545,3,17,0.176,22,29,0.759,103,36,75,0.48,26,49,0.531,10,26,0.385,10,12,0.833,92,2015-01-14,MEM,BRK,2015,97.0
5696,5696,96,Home,L 103-119 ,240,42,85,0.494,37,69,0.536,5,16,0.313,14,16,0.875,103,48,89,0.539,35,64,0.547,13,25,0.52,10,12,0.833,119,2015-01-16,BOS,CHI,2015,125.5
5697,5697,97,@,W 103-95 ,240,34,76,0.447,24,51,0.471,10,25,0.4,25,33,0.758,103,36,85,0.424,33,63,0.524,3,22,0.136,20,22,0.909,95,2015-01-19,DAL,MEM,2015,96.5
5698,5698,98,@,W 103-100 ,240,37,79,0.468,32,59,0.542,5,20,0.25,24,30,0.8,103,39,84,0.464,34,66,0.515,5,18,0.278,17,24,0.708,100,2015-01-21,BRK,SAC,2015,102.5
5699,5699,99,Home,L 103-105 (OT),265,38,100,0.38,31,70,0.443,7,30,0.233,20,26,0.769,103,40,102,0.392,34,73,0.466,6,29,0.207,19,23,0.826,105,2015-01-21,WAS,OKC,2015,108.0
5700,5700,0,Home,W 103-93 ,240,40,83,0.482,30,58,0.517,10,25,0.4,13,13,1.0,103,36,87,0.414,26,61,0.426,10,26,0.385,11,18,0.611,93,2015-01-23,ATL,OKC,2015,98.0
5701,5701,1,Home,W 103-96 ,240,35,87,0.402,22,56,0.393,13,31,0.419,20,20,1.0,103,40,82,0.488,35,67,0.522,5,15,0.333,11,14,0.786,96,2015-01-24,POR,WAS,2015,98.5
5702,5702,2,Home,W 103-94 ,240,36,76,0.474,29,58,0.5,7,18,0.389,24,26,0.923,103,37,78,0.474,33,66,0.5,4,12,0.333,16,25,0.64,94,2015-01-26,MEM,ORL,2015,96.0
5703,5703,3,@,W 103-95 ,240,39,93,0.419,30,59,0.508,9,34,0.265,16,17,0.941,103,35,83,0.422,27,59,0.458,8,24,0.333,17,23,0.739,95,2015-01-27,CLE,DET,2015,99.0
5704,5704,4,Home,W 103-82 ,240,42,79,0.532,36,61,0.59,6,18,0.333,13,18,0.722,103,34,81,0.42,29,65,0.446,5,16,0.313,9,13,0.692,82,2015-01-29,IND,NYK,2015,84.5
5705,5705,5,@,L 103-108 ,240,42,92,0.457,35,64,0.547,7,28,0.25,12,17,0.706,103,36,86,0.419,23,61,0.377,13,25,0.52,23,26,0.885,108,2015-01-30,LAC,NOP,2015,114.5
5706,5706,6,Home,W 103-94 ,240,37,74,0.5,29,51,0.569,8,23,0.348,21,25,0.84,103,34,76,0.447,29,62,0.468,5,14,0.357,21,25,0.84,94,2015-01-30,PHI,MIN,2015,96.5
5707,5707,7,Home,W 103-102 ,240,36,76,0.474,29,53,0.547,7,23,0.304,24,34,0.706,103,39,85,0.459,33,72,0.458,6,13,0.462,18,26,0.692,102,2015-02-03,POR,UTA,2015,105.0
5708,5708,8,@,L 103-110 ,240,42,84,0.5,32,63,0.508,10,21,0.476,9,14,0.643,103,44,84,0.524,30,52,0.577,14,32,0.438,8,14,0.571,110,2015-02-04,ORL,SAS,2015,117.0
5709,5709,9,Home,W 103-99 ,240,37,79,0.468,29,58,0.5,8,21,0.381,21,26,0.808,103,40,89,0.449,29,54,0.537,11,35,0.314,8,12,0.667,99,2015-02-06,IND,CLE,2015,104.5
5710,5710,10,Home,W 103-97 (OT),265,43,83,0.518,38,68,0.559,5,15,0.333,12,14,0.857,103,39,97,0.402,28,71,0.394,11,26,0.423,8,13,0.615,97,2015-02-06,ORL,LAL,2015,102.5
5711,5711,11,@,W 103-102 ,240,37,84,0.44,30,65,0.462,7,19,0.368,22,25,0.88,103,36,77,0.468,28,63,0.444,8,14,0.571,22,28,0.786,102,2015-02-08,IND,CHO,2015,106.0
5712,5712,12,Home,W 103-97 ,240,37,89,0.416,30,71,0.423,7,18,0.389,22,25,0.88,103,38,76,0.5,29,51,0.569,9,25,0.36,12,19,0.632,97,2015-02-09,MIL,BRK,2015,101.5
5713,5713,13,@,L 103-111 ,240,36,84,0.429,28,62,0.452,8,22,0.364,23,30,0.767,103,39,80,0.488,32,65,0.492,7,15,0.467,26,32,0.813,111,2015-02-11,SAC,MIL,2015,114.5
5714,5714,14,Home,L 103-110 ,240,40,93,0.43,33,69,0.478,7,24,0.292,16,20,0.8,103,42,95,0.442,37,77,0.481,5,18,0.278,21,26,0.808,110,2015-02-21,CHA,OKC,2015,112.5
5715,5715,15,Home,W 103-98 ,240,39,82,0.476,33,59,0.559,6,23,0.261,19,26,0.731,103,36,78,0.462,23,44,0.523,13,34,0.382,13,17,0.765,98,2015-02-22,ORL,PHI,2015,104.5
5716,5716,16,Home,W 103-98 ,240,33,75,0.44,26,56,0.464,7,19,0.368,30,38,0.789,103,34,81,0.42,26,52,0.5,8,29,0.276,22,28,0.786,98,2015-02-28,NYK,TOR,2015,102.0
5717,5717,17,@,L 103-105 (OT),265,40,98,0.408,28,58,0.483,12,40,0.3,11,21,0.524,103,34,74,0.459,23,44,0.523,11,30,0.367,26,33,0.788,105,2015-03-01,CLE,HOU,2015,110.5
5718,5718,18,Home,L 103-114 ,240,41,78,0.526,33,58,0.569,8,20,0.4,13,19,0.684,103,41,80,0.513,30,53,0.566,11,27,0.407,21,24,0.875,114,2015-03-02,PHI,TOR,2015,119.5
5719,5719,19,@,L 103-104 ,240,39,86,0.453,33,69,0.478,6,17,0.353,19,21,0.905,103,39,79,0.494,34,66,0.515,5,13,0.385,21,31,0.677,104,2015-03-03,LAL,CHO,2015,106.5
5720,5720,20,Home,W 103-94 ,240,40,85,0.471,35,65,0.538,5,20,0.25,18,20,0.9,103,37,91,0.407,30,69,0.435,7,22,0.318,13,15,0.867,94,2015-03-06,CHA,TOR,2015,97.5
5721,5721,21,Home,W 103-93 ,240,38,91,0.418,32,63,0.508,6,28,0.214,21,25,0.84,103,37,102,0.363,31,73,0.425,6,29,0.207,13,17,0.765,93,2015-03-06,HOU,DET,2015,96.0
5722,5722,22,Home,W 103-98 ,240,38,87,0.437,31,65,0.477,7,22,0.318,20,30,0.667,103,35,89,0.393,20,55,0.364,15,34,0.441,13,16,0.813,98,2015-03-08,ORL,BOS,2015,105.5
5723,5723,23,Home,L 103-114 ,240,37,71,0.521,33,56,0.589,4,15,0.267,25,31,0.806,103,44,75,0.587,35,60,0.583,9,15,0.6,17,21,0.81,114,2015-03-09,MIL,NOP,2015,118.5
5724,5724,24,@,L 103-109 (OT),265,35,91,0.385,31,77,0.403,4,14,0.286,29,36,0.806,103,39,79,0.494,30,57,0.526,9,22,0.409,22,28,0.786,109,2015-03-12,MIL,IND,2015,113.5
5725,5725,25,@,L 103-114 ,240,39,92,0.424,31,73,0.425,8,19,0.421,17,22,0.773,103,41,82,0.5,33,65,0.508,8,17,0.471,24,37,0.649,114,2015-03-13,GSW,DEN,2015,118.0
5726,5726,26,Home,L 103-110 ,240,38,81,0.469,31,61,0.508,7,20,0.35,20,25,0.8,103,38,84,0.452,26,53,0.491,12,31,0.387,22,30,0.733,110,2015-03-16,SAC,ATL,2015,116.0
5727,5727,27,Home,W 103-86 ,240,34,82,0.415,24,58,0.414,10,24,0.417,25,28,0.893,103,32,81,0.395,26,62,0.419,6,19,0.316,16,21,0.762,86,2015-03-18,CHI,IND,2015,89.0
5728,5728,28,Home,L 103-114 ,240,39,80,0.488,32,66,0.485,7,14,0.5,18,24,0.75,103,38,76,0.5,30,56,0.536,8,20,0.4,30,38,0.789,114,2015-03-18,MIL,SAS,2015,118.0
5729,5729,29,@,W 103-82 ,240,41,79,0.519,34,67,0.507,7,12,0.583,14,19,0.737,103,32,76,0.421,28,58,0.483,4,18,0.222,14,17,0.824,82,2015-03-23,MEM,NYK,2015,84.0
5730,5730,30,Home,L 103-116 ,240,39,83,0.47,30,62,0.484,9,21,0.429,16,19,0.842,103,45,74,0.608,33,51,0.647,12,23,0.522,14,17,0.824,116,2015-03-25,TOR,CHI,2015,122.0
5731,5731,31,@,W 103-101 ,240,38,85,0.447,29,59,0.492,9,26,0.346,18,28,0.643,103,33,75,0.44,28,61,0.459,5,14,0.357,30,38,0.789,101,2015-03-25,IND,WAS,2015,103.5
5732,5732,32,Home,W 103-89 ,240,42,83,0.506,38,66,0.576,4,17,0.235,15,18,0.833,103,36,82,0.439,30,68,0.441,6,14,0.429,11,12,0.917,89,2015-03-29,SAS,MEM,2015,92.0
5733,5733,33,@,W 103-91 ,240,35,86,0.407,22,57,0.386,13,29,0.448,20,23,0.87,103,39,93,0.419,34,76,0.447,5,17,0.294,8,9,0.889,91,2015-04-01,SAS,ORL,2015,93.5
5734,5734,34,Home,W 103-100 ,240,36,83,0.434,27,64,0.422,9,19,0.474,22,30,0.733,103,42,95,0.442,33,73,0.452,9,22,0.409,7,10,0.7,100,2015-04-07,NOP,GSW,2015,104.5
5735,5735,35,Home,L 103-113 ,240,45,84,0.536,38,66,0.576,7,18,0.389,6,10,0.6,103,36,80,0.45,28,52,0.538,8,28,0.286,33,34,0.971,113,2015-04-08,DET,BOS,2015,117.0
5736,5736,36,@,L 103-105 ,240,34,79,0.43,22,53,0.415,12,26,0.462,23,31,0.742,103,38,82,0.463,30,59,0.508,8,23,0.348,21,24,0.875,105,2015-04-08,CHI,ORL,2015,109.0
5737,5737,37,Home,W 103-91 ,240,36,74,0.486,23,43,0.535,13,31,0.419,18,25,0.72,103,33,75,0.44,26,59,0.441,7,16,0.438,18,28,0.643,91,2015-04-08,UTA,SAC,2015,94.5
5738,5738,38,Home,L 103-107 ,240,40,89,0.449,29,66,0.439,11,23,0.478,12,23,0.522,103,38,79,0.481,27,60,0.45,11,19,0.579,20,22,0.909,107,2015-04-10,DET,IND,2015,112.5
5739,5739,39,Home,L 103-104 ,240,31,66,0.47,22,45,0.489,9,21,0.429,32,53,0.604,103,41,85,0.482,37,68,0.544,4,17,0.235,18,24,0.75,104,2015-04-10,HOU,SAS,2015,106.0
5740,5740,40,@,L 103-116 ,240,37,81,0.457,28,57,0.491,9,24,0.375,20,28,0.714,103,44,97,0.454,34,66,0.515,10,31,0.323,18,24,0.75,116,2015-04-10,SAC,OKC,2015,121.0
5741,5741,41,@,L 103-110 ,240,38,101,0.376,26,68,0.382,12,33,0.364,15,22,0.682,103,37,82,0.451,30,61,0.492,7,21,0.333,29,37,0.784,110,2015-04-13,DEN,LAC,2015,113.5
5742,5742,42,@,L 103-108 ,240,45,79,0.57,42,69,0.609,3,10,0.3,10,13,0.769,103,43,83,0.518,38,73,0.521,5,10,0.5,17,25,0.68,108,2015-04-15,SAS,NOP,2015,110.5
5743,5743,43,Home,L 103-112 ,240,37,78,0.474,25,48,0.521,12,30,0.4,17,24,0.708,103,41,82,0.5,34,66,0.515,7,16,0.438,23,29,0.793,112,2015-10-29,IND,MEM,2016,115.5
5744,5744,44,Home,L 103-113 ,240,32,85,0.376,25,59,0.424,7,26,0.269,32,41,0.78,103,36,82,0.439,25,56,0.446,11,26,0.423,30,35,0.857,113,2015-10-30,BOS,TOR,2016,118.5
5745,5745,45,@,W 103-93 ,240,40,87,0.46,29,57,0.509,11,30,0.367,12,16,0.75,103,31,85,0.365,21,51,0.412,10,34,0.294,21,28,0.75,93,2015-11-01,DAL,LAL,2016,98.0
5746,5746,46,@,W 103-96 ,240,38,73,0.521,29,50,0.58,9,23,0.391,18,26,0.692,103,36,79,0.456,30,60,0.5,6,19,0.316,18,22,0.818,96,2015-11-02,MIL,BRK,2016,99.0
5747,5747,47,@,W 103-94 ,240,42,90,0.467,35,72,0.486,7,18,0.389,12,12,1.0,103,32,90,0.356,20,54,0.37,12,36,0.333,18,25,0.72,94,2015-11-03,ORL,NOP,2016,100.0
5748,5748,48,@,W 103-89 ,240,40,83,0.482,37,63,0.587,3,20,0.15,20,25,0.8,103,29,74,0.392,22,54,0.407,7,20,0.35,24,40,0.6,89,2015-11-03,MEM,SAC,2016,92.5
5749,5749,49,@,W 103-98 ,240,33,79,0.418,28,65,0.431,5,14,0.357,32,39,0.821,103,39,82,0.476,31,59,0.525,8,23,0.348,12,14,0.857,98,2015-11-04,TOR,OKC,2016,102.0
5750,5750,50,@,W 103-94 ,240,38,92,0.413,30,53,0.566,8,39,0.205,19,22,0.864,103,38,87,0.437,32,68,0.471,6,19,0.316,12,16,0.75,94,2015-11-07,GSW,SAC,2016,97.0
5751,5751,51,@,L 103-124 ,240,38,84,0.452,31,68,0.456,7,16,0.438,20,26,0.769,103,49,94,0.521,45,74,0.608,4,20,0.2,22,30,0.733,124,2015-11-08,PHO,OKC,2016,126.0
5752,5752,52,Home,L 103-120 ,240,41,76,0.539,32,51,0.627,9,25,0.36,12,18,0.667,103,47,96,0.49,36,66,0.545,11,30,0.367,15,22,0.682,120,2015-11-08,POR,DET,2016,125.5
5753,5753,53,Home,W 103-102 ,240,39,79,0.494,31,55,0.564,8,24,0.333,17,24,0.708,103,42,79,0.532,32,57,0.561,10,22,0.455,8,9,0.889,102,2015-11-11,DEN,MIL,2016,107.0
5754,5754,54,Home,L 103-119 ,240,40,87,0.46,28,58,0.483,12,29,0.414,11,17,0.647,103,43,89,0.483,38,71,0.535,5,18,0.278,28,31,0.903,119,2015-11-11,PHI,TOR,2016,121.5
5755,5755,55,@,L 103-107 ,240,42,83,0.506,35,63,0.556,7,20,0.35,12,13,0.923,103,41,86,0.477,31,61,0.508,10,25,0.4,15,23,0.652,107,2015-11-13,MIN,IND,2016,112.0
5756,5756,56,@,W 103-91 ,240,36,97,0.371,32,76,0.421,4,21,0.19,27,35,0.771,103,36,79,0.456,31,55,0.564,5,24,0.208,14,30,0.467,91,2015-11-17,MIN,MIA,2016,93.5
5757,5757,57,Home,W 103-97 ,240,38,89,0.427,29,59,0.492,9,30,0.3,18,24,0.75,103,38,86,0.442,33,70,0.471,5,16,0.313,16,18,0.889,97,2015-11-18,ATL,SAC,2016,99.5
5758,5758,58,@,L 103-108 (OT),265,35,88,0.398,26,58,0.448,9,30,0.3,24,29,0.828,103,32,92,0.348,18,48,0.375,14,44,0.318,30,35,0.857,108,2015-11-18,POR,HOU,2016,115.0
5759,5759,59,@,L 103-110 ,240,43,95,0.453,35,63,0.556,8,32,0.25,9,9,1.0,103,38,85,0.447,31,68,0.456,7,17,0.412,27,40,0.675,110,2015-11-18,NOP,OKC,2016,113.5
5760,5760,60,@,W 103-97 ,240,41,83,0.494,32,64,0.5,9,19,0.474,12,14,0.857,103,37,91,0.407,29,64,0.453,8,27,0.296,15,21,0.714,97,2015-11-18,CHI,PHO,2016,101.0
5761,5761,61,@,L 103-117 ,240,40,81,0.494,30,59,0.508,10,22,0.455,13,21,0.619,103,43,81,0.531,25,46,0.543,18,35,0.514,13,22,0.591,117,2015-11-23,ORL,CLE,2016,126.0
5762,5762,62,Home,W 103-99 ,240,40,79,0.506,29,54,0.537,11,25,0.44,12,22,0.545,103,36,82,0.439,22,53,0.415,14,29,0.483,13,16,0.813,99,2015-11-25,TOR,CLE,2016,106.0
5763,5763,63,Home,W 103-87 ,240,37,79,0.468,30,55,0.545,7,24,0.292,22,26,0.846,103,31,90,0.344,22,61,0.361,9,29,0.31,16,20,0.8,87,2015-11-27,OKC,DET,2016,91.5
5764,5764,64,Home,L 103-107 ,240,38,99,0.384,27,66,0.409,11,33,0.333,16,22,0.727,103,34,83,0.41,25,56,0.446,9,27,0.333,30,37,0.811,107,2015-11-29,LAL,IND,2016,111.5
5765,5765,65,Home,L 103-106 ,240,40,89,0.449,34,70,0.486,6,19,0.316,17,22,0.773,103,40,82,0.488,26,53,0.491,14,29,0.483,12,15,0.8,106,2015-11-30,UTA,GSW,2016,113.0
5766,5766,66,Home,W 103-91 ,240,37,79,0.468,23,47,0.489,14,32,0.438,15,23,0.652,103,33,89,0.371,25,55,0.455,8,34,0.235,17,24,0.708,91,2015-12-01,PHI,LAL,2016,95.0
5767,5767,67,@,W 103-91 ,240,32,76,0.421,25,56,0.446,7,20,0.35,32,39,0.821,103,30,79,0.38,24,52,0.462,6,27,0.222,25,39,0.641,91,2015-12-02,IND,LAC,2016,94.0
5768,5768,68,@,W 103-83 ,240,40,80,0.5,30,62,0.484,10,18,0.556,13,18,0.722,103,30,80,0.375,28,64,0.438,2,16,0.125,21,25,0.84,83,2015-12-03,SAS,MEM,2016,84.0
5769,5769,69,@,W 103-94 ,240,40,89,0.449,32,66,0.485,8,23,0.348,15,15,1.0,103,31,72,0.431,17,39,0.436,14,33,0.424,18,24,0.75,94,2015-12-03,ORL,UTA,2016,101.0
5770,5770,70,Home,W 103-101 ,240,37,82,0.451,25,51,0.49,12,31,0.387,17,25,0.68,103,40,90,0.444,34,70,0.486,6,20,0.3,15,18,0.833,101,2015-12-05,LAC,ORL,2016,104.0
5771,5771,71,Home,L 103-109 ,240,38,83,0.458,33,68,0.485,5,15,0.333,22,26,0.846,103,39,77,0.506,29,57,0.509,10,20,0.5,21,30,0.7,109,2015-12-05,MIN,POR,2016,114.0
5772,5772,72,@,W 103-101 ,240,41,92,0.446,34,75,0.453,7,17,0.412,14,17,0.824,103,41,90,0.456,35,69,0.507,6,21,0.286,13,18,0.722,101,2015-12-07,PHO,CHI,2016,104.0
5773,5773,73,Home,L 103-114 ,240,41,69,0.594,36,53,0.679,5,16,0.313,16,22,0.727,103,46,92,0.5,37,74,0.5,9,18,0.5,13,17,0.765,114,2015-12-07,MIA,WAS,2016,118.5
5774,5774,74,Home,L 103-109 ,240,39,89,0.438,34,64,0.531,5,25,0.2,20,24,0.833,103,40,83,0.482,28,50,0.56,12,33,0.364,17,25,0.68,109,2015-12-09,WAS,HOU,2016,115.0
5775,5775,75,@,W 103-78 ,240,36,74,0.486,26,54,0.481,10,20,0.5,21,22,0.955,103,30,80,0.375,25,56,0.446,5,24,0.208,13,16,0.813,78,2015-12-12,SAS,ATL,2016,80.5
5776,5776,76,Home,L 103-105 (OT),265,37,89,0.416,31,70,0.443,6,19,0.316,23,31,0.742,103,44,97,0.454,38,78,0.487,6,19,0.316,11,15,0.733,105,2015-12-14,DET,LAC,2016,108.0
5777,5777,77,@,L 103-128 ,240,41,91,0.451,36,69,0.522,5,22,0.227,16,18,0.889,103,46,88,0.523,31,56,0.554,15,32,0.469,21,27,0.778,128,2015-12-16,PHO,GSW,2016,135.5
5778,5778,78,Home,W 103-90 ,240,36,75,0.48,25,54,0.463,11,21,0.524,20,24,0.833,103,38,88,0.432,33,72,0.458,5,16,0.313,9,11,0.818,90,2015-12-16,LAC,MIL,2016,92.5
5779,5779,79,@,W 103-100 ,240,39,78,0.5,28,56,0.5,11,22,0.5,14,20,0.7,103,38,81,0.469,34,69,0.493,4,12,0.333,20,24,0.833,100,2015-12-20,ATL,ORL,2016,102.0
5780,5780,80,Home,W 103-99 ,240,35,74,0.473,23,48,0.479,12,26,0.462,21,27,0.778,103,40,92,0.435,29,63,0.46,11,29,0.379,8,11,0.727,99,2015-12-22,TOR,DAL,2016,104.5
5781,5781,81,Home,W 103-85 ,240,39,83,0.47,30,60,0.5,9,23,0.391,16,16,1.0,103,33,80,0.413,26,60,0.433,7,20,0.35,12,14,0.857,85,2015-12-23,GSW,UTA,2016,88.5
5782,5782,82,Home,W 103-93 ,240,38,84,0.452,28,62,0.452,10,22,0.455,17,26,0.654,103,38,79,0.481,34,65,0.523,4,14,0.286,13,15,0.867,93,2015-12-28,DAL,MIL,2016,95.0
5783,5783,83,@,L 103-122 ,240,37,95,0.389,24,64,0.375,13,31,0.419,16,28,0.571,103,43,89,0.483,23,47,0.489,20,42,0.476,16,24,0.667,122,2015-12-28,SAC,GSW,2016,132.0
5784,5784,84,@,L 103-110 ,240,37,87,0.425,25,60,0.417,12,27,0.444,17,19,0.895,103,41,87,0.471,29,55,0.527,12,32,0.375,16,20,0.8,110,2015-12-30,DEN,POR,2016,116.0
5785,5785,85,Home,W 103-91 ,240,43,92,0.467,35,66,0.53,8,26,0.308,9,10,0.9,103,40,85,0.471,35,65,0.538,5,20,0.25,6,8,0.75,91,2016-01-01,WAS,ORL,2016,93.5
5786,5786,86,@,L 103-121 ,240,37,74,0.5,28,52,0.538,9,22,0.409,20,33,0.606,103,45,86,0.523,32,62,0.516,13,24,0.542,18,19,0.947,121,2016-01-02,HOU,SAS,2016,127.5
5787,5787,87,@,W 103-94 ,240,41,92,0.446,35,71,0.493,6,21,0.286,15,19,0.789,103,32,85,0.376,26,57,0.456,6,28,0.214,24,27,0.889,94,2016-01-04,BOS,BRK,2016,97.0
5788,5788,88,Home,W 103-100 (OT),265,34,90,0.378,29,68,0.426,5,22,0.227,30,39,0.769,103,37,94,0.394,29,66,0.439,8,28,0.286,18,25,0.72,100,2016-01-04,MIA,IND,2016,104.0
5789,5789,89,Home,W 103-94 ,240,39,75,0.52,32,52,0.615,7,23,0.304,18,26,0.692,103,38,78,0.487,31,50,0.62,7,28,0.25,11,17,0.647,94,2016-01-07,HOU,UTA,2016,97.5
5790,5790,90,@,W 103-95 ,240,36,73,0.493,29,55,0.527,7,18,0.389,24,30,0.8,103,40,92,0.435,34,68,0.5,6,24,0.25,9,13,0.692,95,2016-01-08,MIA,PHO,2016,98.0
5791,5791,91,Home,W 103-89 ,240,43,92,0.467,35,65,0.538,8,27,0.296,9,14,0.643,103,38,82,0.463,33,73,0.452,5,9,0.556,8,10,0.8,89,2016-01-09,DET,BRK,2016,91.5
5792,5792,92,@,L 103-107 (OT),265,43,90,0.478,34,59,0.576,9,31,0.29,8,10,0.8,103,39,89,0.438,25,51,0.49,14,38,0.368,15,23,0.652,107,2016-01-10,IND,HOU,2016,114.0
5793,5793,93,@,L 103-111 ,240,41,91,0.451,34,72,0.472,7,19,0.368,14,16,0.875,103,41,86,0.477,34,63,0.54,7,23,0.304,22,30,0.733,111,2016-01-11,MIA,GSW,2016,114.5
5794,5794,94,Home,W 103-94 ,240,40,90,0.444,31,64,0.484,9,26,0.346,14,20,0.7,103,37,91,0.407,32,61,0.525,5,30,0.167,15,20,0.75,94,2016-01-13,BOS,IND,2016,96.5
5795,5795,95,Home,W 103-101 ,240,37,76,0.487,28,60,0.467,9,16,0.563,20,25,0.8,103,37,72,0.514,22,40,0.55,15,32,0.469,12,17,0.706,101,2016-01-14,MEM,DET,2016,108.5
5796,5796,96,Home,L 103-106 (OT),265,44,97,0.454,35,74,0.473,9,23,0.391,6,8,0.75,103,37,90,0.411,29,66,0.439,8,24,0.333,24,31,0.774,106,2016-01-14,ORL,TOR,2016,110.0
5797,5797,97,@,W 103-101 ,240,34,74,0.459,29,63,0.46,5,11,0.455,30,42,0.714,103,35,83,0.422,29,49,0.592,6,34,0.176,25,34,0.735,101,2016-01-14,SAC,UTA,2016,104.0
5798,5798,98,@,L 103-117 ,240,35,89,0.393,25,62,0.403,10,27,0.37,23,28,0.821,103,42,96,0.438,28,66,0.424,14,30,0.467,19,29,0.655,117,2016-01-15,PHO,BOS,2016,124.0
5799,5799,99,Home,L 103-110 ,240,38,96,0.396,25,57,0.439,13,39,0.333,14,19,0.737,103,36,76,0.474,23,51,0.451,13,25,0.52,25,33,0.758,110,2016-01-16,LAC,SAC,2016,116.5
5800,5800,0,Home,W 103-95 ,240,39,82,0.476,34,72,0.472,5,10,0.5,20,26,0.769,103,35,77,0.455,30,57,0.526,5,20,0.25,20,24,0.833,95,2016-01-16,MEM,NYK,2016,97.5
5801,5801,1,@,L 103-121 ,240,34,69,0.493,27,52,0.519,7,17,0.412,28,32,0.875,103,47,93,0.505,37,62,0.597,10,31,0.323,17,22,0.773,121,2016-01-23,LAL,POR,2016,126.0
5802,5802,2,@,L 103-113 ,240,39,83,0.47,33,64,0.516,6,19,0.316,19,28,0.679,103,39,81,0.481,28,53,0.528,11,28,0.393,24,36,0.667,113,2016-01-26,PHO,PHI,2016,118.5
5803,5803,3,@,L 103-111 ,240,36,84,0.429,29,63,0.46,7,21,0.333,24,32,0.75,103,41,96,0.427,32,68,0.471,9,28,0.321,20,24,0.833,111,2016-01-27,DEN,BOS,2016,115.5
5804,5804,4,Home,W 103-83 ,240,38,80,0.475,28,52,0.538,10,28,0.357,17,20,0.85,103,29,79,0.367,28,63,0.444,1,16,0.063,24,27,0.889,83,2016-01-28,MEM,MIL,2016,83.5
5805,5805,5,Home,W 103-93 ,240,37,85,0.435,29,65,0.446,8,20,0.4,21,29,0.724,103,38,87,0.437,31,69,0.449,7,18,0.389,10,20,0.5,93,2016-01-28,TOR,NYK,2016,96.5
5806,5806,6,Home,L 103-107 ,240,38,80,0.475,36,68,0.529,2,12,0.167,25,28,0.893,103,37,74,0.5,30,56,0.536,7,18,0.389,26,32,0.813,107,2016-01-29,MIL,MIA,2016,110.5
5807,5807,7,Home,W 103-90 ,240,40,76,0.526,30,51,0.588,10,25,0.4,13,16,0.813,103,35,75,0.467,33,65,0.508,2,10,0.2,18,26,0.692,90,2016-01-29,UTA,MIN,2016,91.0
5808,5808,8,@,L 103-117 ,240,40,81,0.494,34,63,0.54,6,18,0.333,17,21,0.81,103,45,82,0.549,36,59,0.61,9,23,0.391,18,21,0.857,117,2016-01-30,SAS,CLE,2016,121.5
5809,5809,9,@,L 103-105 ,240,40,84,0.476,31,64,0.484,9,20,0.45,14,23,0.609,103,43,93,0.462,32,66,0.485,11,27,0.407,8,10,0.8,105,2016-01-30,BRK,NOP,2016,110.5
5810,5810,10,Home,L 103-110 ,240,38,81,0.469,28,56,0.5,10,25,0.4,17,23,0.739,103,40,85,0.471,28,66,0.424,12,19,0.632,18,25,0.72,110,2016-02-04,POR,TOR,2016,116.0
5811,5811,11,Home,L 103-104 ,240,37,87,0.425,29,57,0.509,8,30,0.267,21,35,0.6,103,38,88,0.432,31,68,0.456,7,20,0.35,21,25,0.84,104,2016-02-05,CLE,BOS,2016,107.5
5812,5812,12,Home,W 103-98 ,240,38,81,0.469,28,52,0.538,10,29,0.345,17,22,0.773,103,35,76,0.461,30,61,0.492,5,15,0.333,23,26,0.885,98,2016-02-06,PHI,BRK,2016,100.5
5813,5813,13,@,W 103-89 ,240,39,70,0.557,28,50,0.56,11,20,0.55,14,17,0.824,103,36,80,0.45,28,52,0.538,8,28,0.286,9,17,0.529,89,2016-02-08,TOR,DET,2016,93.0
5814,5814,14,@,W 103-92 ,240,39,83,0.47,33,64,0.516,6,19,0.316,19,24,0.792,103,38,88,0.432,28,61,0.459,10,27,0.37,6,7,0.857,92,2016-02-10,DEN,DET,2016,97.0
5815,5815,15,@,L 103-116 ,240,37,77,0.481,26,43,0.605,11,34,0.324,18,34,0.529,103,41,89,0.461,33,61,0.541,8,28,0.286,26,34,0.765,116,2016-02-10,HOU,POR,2016,120.0
5816,5816,16,Home,W 103-89 ,240,42,86,0.488,35,68,0.515,7,18,0.389,12,21,0.571,103,31,77,0.403,27,62,0.435,4,15,0.267,23,29,0.793,89,2016-02-18,WAS,UTA,2016,91.0
5817,5817,17,@,W 103-95 ,240,42,83,0.506,37,66,0.561,5,17,0.294,14,16,0.875,103,36,84,0.429,31,72,0.431,5,12,0.417,18,25,0.72,95,2016-02-20,NYK,MIN,2016,97.5
5818,5818,18,@,L 103-129 ,240,37,77,0.481,25,49,0.51,12,28,0.429,17,27,0.63,103,41,85,0.482,28,51,0.549,13,34,0.382,34,36,0.944,129,2016-02-21,PHI,DAL,2016,135.5
5819,5819,19,@,L 103-114 ,240,37,76,0.487,27,47,0.574,10,29,0.345,19,27,0.704,103,45,91,0.495,32,59,0.542,13,32,0.406,11,17,0.647,114,2016-02-24,CHA,CLE,2016,120.5
5820,5820,20,Home,L 103-116 ,240,35,86,0.407,26,58,0.448,9,28,0.321,24,30,0.8,103,43,89,0.483,31,56,0.554,12,33,0.364,18,22,0.818,116,2016-02-24,DAL,OKC,2016,122.0
5821,5821,21,Home,W 103-88 ,240,37,89,0.416,30,55,0.545,7,34,0.206,22,24,0.917,103,32,88,0.364,27,68,0.397,5,20,0.25,19,22,0.864,88,2016-02-26,ATL,CHI,2016,90.5
5822,5822,22,@,W 103-94 ,240,40,94,0.426,33,71,0.465,7,23,0.304,16,17,0.941,103,35,82,0.427,27,57,0.474,8,25,0.32,16,21,0.762,94,2016-02-26,WAS,PHI,2016,98.0
5823,5823,23,@,W 103-95 ,240,38,87,0.437,33,66,0.5,5,21,0.238,22,27,0.815,103,39,94,0.415,32,72,0.444,7,22,0.318,10,12,0.833,95,2016-02-27,POR,CHI,2016,98.5
5824,5824,24,@,W 103-96 ,240,36,75,0.48,33,55,0.6,3,20,0.15,28,36,0.778,103,40,75,0.533,32,50,0.64,8,25,0.32,8,10,0.8,96,2016-02-29,MEM,DEN,2016,100.0
5825,5825,25,Home,W 103-98 ,240,40,98,0.408,31,66,0.47,9,32,0.281,14,21,0.667,103,39,98,0.398,29,63,0.46,10,35,0.286,10,11,0.909,98,2016-03-02,LAC,OKC,2016,103.0
5826,5826,26,@,L 103-120 ,240,37,80,0.463,27,57,0.474,10,23,0.435,19,27,0.704,103,42,82,0.512,32,52,0.615,10,30,0.333,26,34,0.765,120,2016-03-05,BOS,CLE,2016,125.0
5827,5827,27,@,L 103-123 ,240,35,78,0.449,24,47,0.511,11,31,0.355,22,23,0.957,103,44,84,0.524,32,62,0.516,12,22,0.545,23,28,0.821,123,2016-03-06,POR,DET,2016,129.0
5828,5828,28,Home,W 103-98 ,240,36,81,0.444,28,67,0.418,8,14,0.571,23,30,0.767,103,37,85,0.435,26,54,0.481,11,31,0.355,13,22,0.591,98,2016-03-06,MIA,PHI,2016,103.5
5829,5829,29,@,L 103-108 ,240,39,80,0.488,35,65,0.538,4,15,0.267,21,24,0.875,103,41,90,0.456,29,60,0.483,12,30,0.4,14,17,0.824,108,2016-03-07,MIN,CHO,2016,114.0
5830,5830,30,Home,L 103-106 ,240,36,80,0.45,29,51,0.569,7,29,0.241,24,29,0.828,103,41,86,0.477,35,66,0.53,6,20,0.3,18,22,0.818,106,2016-03-07,CLE,MEM,2016,109.0
5831,5831,31,@,L 103-118 ,240,36,76,0.474,27,46,0.587,9,30,0.3,22,27,0.815,103,42,83,0.506,32,58,0.552,10,25,0.4,24,29,0.828,118,2016-03-11,DET,CHO,2016,123.0
5832,5832,32,Home,W 103-92 ,240,40,81,0.494,36,68,0.529,4,13,0.308,19,24,0.792,103,35,89,0.393,29,60,0.483,6,29,0.207,16,21,0.762,92,2016-03-12,MIL,NOP,2016,95.0
5833,5833,33,Home,W 103-98 ,240,39,84,0.464,34,72,0.472,5,12,0.417,20,28,0.714,103,36,94,0.383,28,63,0.444,8,31,0.258,18,22,0.818,98,2016-03-15,IND,BOS,2016,102.0
5834,5834,34,Home,W 103-69 ,240,43,88,0.489,32,63,0.508,11,25,0.44,6,9,0.667,103,28,82,0.341,22,56,0.393,6,26,0.231,7,14,0.5,69,2016-03-17,UTA,PHO,2016,72.0
5835,5835,35,Home,L 103-109 ,240,37,82,0.451,26,60,0.433,11,22,0.5,18,22,0.818,103,38,76,0.5,25,48,0.521,13,28,0.464,20,27,0.741,109,2016-03-18,ORL,CLE,2016,115.5
5836,5836,36,@,L 103-115 ,240,42,80,0.525,37,66,0.561,5,14,0.357,14,21,0.667,103,46,94,0.489,36,70,0.514,10,24,0.417,13,21,0.619,115,2016-03-19,BRK,DET,2016,120.0
5837,5837,37,@,W 103-97 ,240,39,90,0.433,31,70,0.443,8,20,0.4,17,19,0.895,103,30,76,0.395,19,48,0.396,11,28,0.393,26,34,0.765,97,2016-03-21,MEM,PHO,2016,102.5
5838,5838,38,@,L 103-104 ,240,37,94,0.394,22,57,0.386,15,37,0.405,14,15,0.933,103,33,76,0.434,27,59,0.458,6,17,0.353,32,40,0.8,104,2016-03-23,PHI,DEN,2016,107.0
5839,5839,39,@,L 103-109 ,240,42,96,0.438,33,66,0.5,9,30,0.3,10,11,0.909,103,40,89,0.449,33,62,0.532,7,27,0.259,22,25,0.88,109,2016-03-23,DAL,POR,2016,112.5
5840,5840,40,@,W 103-96 (OT),265,39,89,0.438,27,54,0.5,12,35,0.343,13,18,0.722,103,37,92,0.402,28,60,0.467,9,32,0.281,13,29,0.448,96,2016-03-30,GSW,UTA,2016,100.5
5841,5841,41,@,W 103-100 ,240,37,77,0.481,26,53,0.491,11,24,0.458,18,22,0.818,103,36,90,0.4,27,65,0.415,9,25,0.36,19,22,0.864,100,2016-03-31,CHI,HOU,2016,104.5
5842,5842,42,@,L 103-112 ,240,34,76,0.447,25,50,0.5,9,26,0.346,26,27,0.963,103,45,83,0.542,29,54,0.537,16,29,0.552,6,13,0.462,112,2016-04-03,CHA,CLE,2016,120.0
5843,5843,43,Home,W 103-90 ,240,39,95,0.411,28,61,0.459,11,34,0.324,14,19,0.737,103,30,81,0.37,18,50,0.36,12,31,0.387,18,30,0.6,90,2016-04-05,ATL,PHO,2016,96.0
5844,5844,44,Home,W 103-81 ,240,40,78,0.513,33,58,0.569,7,20,0.35,16,26,0.615,103,26,83,0.313,20,63,0.317,6,20,0.3,23,25,0.92,81,2016-04-05,LAC,LAL,2016,84.0
5845,5845,45,@,L 103-121 ,240,39,92,0.424,32,75,0.427,7,17,0.412,18,24,0.75,103,48,95,0.505,40,67,0.597,8,28,0.286,17,20,0.85,121,2016-04-06,BRK,WAS,2016,125.0
5846,5846,46,Home,W 103-93 ,240,30,60,0.5,18,29,0.621,12,31,0.387,31,39,0.795,103,35,87,0.402,28,65,0.431,7,22,0.318,16,22,0.727,93,2016-04-08,DAL,MEM,2016,96.5
5847,5847,47,@,W 103-96 ,240,41,93,0.441,28,56,0.5,13,37,0.351,8,15,0.533,103,39,89,0.438,29,63,0.46,10,26,0.385,8,12,0.667,96,2016-04-13,TOR,BRK,2016,101.0
5848,5848,48,@,L 103-117 ,240,42,91,0.462,34,64,0.531,8,27,0.296,11,18,0.611,103,47,86,0.547,36,57,0.632,11,29,0.379,12,19,0.632,117,2016-04-13,ORL,CHO,2016,122.5
5849,5849,49,@,W 103-97 ,240,39,94,0.415,33,72,0.458,6,22,0.273,19,26,0.731,103,36,84,0.429,29,60,0.483,7,24,0.292,18,25,0.72,97,2016-10-26,OKC,PHI,2017,100.5
5850,5850,50,Home,W 103-94 ,240,38,87,0.437,28,54,0.519,10,33,0.303,17,20,0.85,103,37,98,0.378,30,74,0.405,7,24,0.292,13,20,0.65,94,2016-10-28,BRK,IND,2017,97.5
5851,5851,51,@,L 103-106 ,240,37,70,0.529,30,48,0.625,7,22,0.318,22,31,0.71,103,39,85,0.459,30,59,0.508,9,26,0.346,19,25,0.76,106,2016-10-29,MIN,SAC,2017,110.5
5852,5852,52,@,L 103-112 (OT),265,38,86,0.442,33,61,0.541,5,25,0.2,22,25,0.88,103,39,88,0.443,24,57,0.421,15,31,0.484,19,26,0.731,112,2016-10-30,WAS,MEM,2017,119.5
5853,5853,53,@,W 103-101 ,240,42,93,0.452,36,68,0.529,6,25,0.24,13,17,0.765,103,40,81,0.494,31,61,0.508,9,20,0.45,12,16,0.75,101,2016-11-01,ORL,PHI,2017,105.5
5854,5854,54,Home,L 103-113 ,240,42,72,0.583,39,62,0.629,3,10,0.3,16,24,0.667,103,43,77,0.558,33,52,0.635,10,25,0.4,17,25,0.68,113,2016-11-02,WAS,TOR,2017,118.0
5855,5855,55,Home,W 103-86 ,240,40,84,0.476,33,64,0.516,7,20,0.35,16,22,0.727,103,31,94,0.33,24,69,0.348,7,25,0.28,17,20,0.85,86,2016-11-05,DET,DEN,2017,89.5
5856,5856,56,Home,W 103-93 ,240,43,86,0.5,33,58,0.569,10,28,0.357,7,11,0.636,103,35,86,0.407,24,56,0.429,11,30,0.367,12,20,0.6,93,2016-11-16,IND,CLE,2017,98.5
5857,5857,57,@,L 103-105 ,240,40,92,0.435,26,52,0.5,14,40,0.35,9,14,0.643,103,40,84,0.476,28,59,0.475,12,25,0.48,13,14,0.929,105,2016-11-16,HOU,OKC,2017,111.0
5858,5858,58,@,L 103-107 ,240,38,86,0.442,32,64,0.5,6,22,0.273,21,26,0.808,103,45,96,0.469,36,67,0.537,9,29,0.31,8,8,1.0,107,2016-11-22,POR,NYK,2017,111.5
5859,5859,59,Home,L 103-109 ,240,42,91,0.462,30,57,0.526,12,34,0.353,7,9,0.778,103,38,81,0.469,27,57,0.474,11,24,0.458,22,25,0.88,109,2016-11-25,BOS,SAS,2017,114.5
5860,5860,60,Home,L 103-112 ,240,36,81,0.444,29,62,0.468,7,19,0.368,24,25,0.96,103,40,79,0.506,36,61,0.59,4,18,0.222,28,34,0.824,112,2016-11-28,MIN,UTA,2017,114.0
5861,5861,61,Home,L 103-112 ,240,36,91,0.396,30,72,0.417,6,19,0.316,25,28,0.893,103,46,92,0.5,38,70,0.543,8,22,0.364,12,18,0.667,112,2016-11-28,NYK,OKC,2017,116.0
5862,5862,62,Home,W 103-100 ,240,41,88,0.466,31,58,0.534,10,30,0.333,11,15,0.733,103,35,81,0.432,28,60,0.467,7,21,0.333,23,29,0.793,100,2016-12-03,MEM,LAL,2017,103.5
5863,5863,63,@,L 103-112 ,240,34,91,0.374,23,50,0.46,11,41,0.268,24,33,0.727,103,40,85,0.471,34,61,0.557,6,24,0.25,26,36,0.722,112,2016-12-03,BRK,MIL,2017,115.0
5864,5864,64,Home,L 103-114 ,240,38,89,0.427,27,64,0.422,11,25,0.44,16,27,0.593,103,48,98,0.49,41,73,0.562,7,25,0.28,11,16,0.688,114,2016-12-06,MIA,NYK,2017,117.5
5865,5865,65,Home,W 103-95 ,240,43,88,0.489,39,69,0.565,4,19,0.211,13,15,0.867,103,34,80,0.425,23,53,0.434,11,27,0.407,16,20,0.8,95,2016-12-07,ATL,MIA,2017,100.5
5866,5866,66,@,L 103-111 ,240,32,69,0.464,18,44,0.409,14,25,0.56,25,26,0.962,103,39,80,0.488,24,48,0.5,15,32,0.469,18,24,0.75,111,2016-12-09,IND,DAL,2017,118.5
5867,5867,67,@,W 103-100 ,240,36,84,0.429,26,55,0.473,10,29,0.345,21,25,0.84,103,35,87,0.402,28,59,0.475,7,28,0.25,23,27,0.852,100,2016-12-09,NYK,SAC,2017,103.5
5868,5868,68,Home,W 103-86 ,240,37,81,0.457,25,50,0.5,12,31,0.387,17,23,0.739,103,35,86,0.407,31,64,0.484,4,22,0.182,12,15,0.8,86,2016-12-13,CLE,MEM,2017,88.0
5869,5869,69,Home,W 103-90 ,240,45,96,0.469,36,64,0.563,9,32,0.281,4,8,0.5,103,38,93,0.409,33,72,0.458,5,21,0.238,9,19,0.474,90,2016-12-15,GSW,NYK,2017,92.5
5870,5870,70,Home,W 103-100 ,240,37,65,0.569,29,43,0.674,8,22,0.364,21,27,0.778,103,35,77,0.455,23,49,0.469,12,28,0.429,18,21,0.857,100,2016-12-16,UTA,DAL,2017,106.0
5871,5871,71,Home,W 103-91 ,240,37,84,0.44,32,66,0.485,5,18,0.278,24,28,0.857,103,38,96,0.396,31,74,0.419,7,22,0.318,8,10,0.8,91,2016-12-23,CHA,CHI,2017,94.5
5872,5872,72,@,L 103-113 ,240,37,88,0.42,28,58,0.483,9,30,0.3,20,29,0.69,103,41,85,0.482,29,54,0.537,12,31,0.387,19,21,0.905,113,2016-12-27,MEM,BOS,2017,119.0
5873,5873,73,@,L 103-105 ,240,42,94,0.447,35,69,0.507,7,25,0.28,12,17,0.706,103,42,81,0.519,32,53,0.604,10,28,0.357,11,14,0.786,105,2016-12-28,MIN,DEN,2017,110.0
5874,5874,74,Home,L 103-115 ,240,39,83,0.47,31,62,0.5,8,21,0.381,17,24,0.708,103,45,91,0.495,30,60,0.5,15,31,0.484,10,14,0.714,115,2017-01-02,NYK,ORL,2017,122.5
5875,5875,75,Home,W 103-95 ,240,36,81,0.444,28,55,0.509,8,26,0.308,23,29,0.793,103,38,92,0.413,31,68,0.456,7,24,0.292,12,21,0.571,95,2017-01-11,OKC,MEM,2017,98.5
5876,5876,76,@,W 103-101 ,240,36,83,0.434,19,39,0.487,17,44,0.386,14,19,0.737,103,36,84,0.429,25,54,0.463,11,30,0.367,18,21,0.857,101,2017-01-13,BOS,ATL,2017,106.5
5877,5877,77,@,L 103-109 ,240,36,90,0.4,27,51,0.529,9,39,0.231,22,28,0.786,103,42,90,0.467,33,61,0.541,9,29,0.31,16,24,0.667,109,2017-01-17,HOU,MIA,2017,113.5
5878,5878,78,@,L 103-118 ,240,37,85,0.435,33,66,0.5,4,19,0.211,25,31,0.806,103,43,85,0.506,24,43,0.558,19,42,0.452,13,19,0.684,118,2017-01-19,PHO,CLE,2017,127.5
5879,5879,79,Home,L 103-115 ,240,33,83,0.398,26,56,0.464,7,27,0.259,30,35,0.857,103,40,79,0.506,31,57,0.544,9,22,0.409,26,28,0.929,115,2017-01-22,TOR,PHO,2017,119.5
5880,5880,80,Home,L 103-109 ,240,38,86,0.442,31,60,0.517,7,26,0.269,20,25,0.8,103,35,76,0.461,27,54,0.5,8,22,0.364,31,35,0.886,109,2017-01-23,IND,NYK,2017,113.0
5881,5881,81,Home,W 103-93 ,240,35,76,0.461,25,50,0.5,10,26,0.385,23,31,0.742,103,35,85,0.412,28,63,0.444,7,22,0.318,16,21,0.762,93,2017-01-24,DEN,UTA,2017,96.5
5882,5882,82,Home,L 103-113 ,240,38,92,0.413,31,69,0.449,7,23,0.304,20,21,0.952,103,39,82,0.476,28,54,0.519,11,28,0.393,24,27,0.889,113,2017-01-25,CHA,GSW,2017,118.5
5883,5883,83,Home,W 103-95 ,240,39,83,0.47,33,57,0.579,6,26,0.231,19,24,0.792,103,39,92,0.424,32,69,0.464,7,23,0.304,10,12,0.833,95,2017-01-25,DAL,NYK,2017,98.5
5884,5884,84,Home,L 103-109 ,240,36,81,0.444,26,54,0.481,10,27,0.37,21,27,0.778,103,42,81,0.519,32,63,0.508,10,18,0.556,15,17,0.882,109,2017-01-26,MIN,IND,2017,114.0
5885,5885,85,@,L 103-119 ,240,33,85,0.388,21,57,0.368,12,28,0.429,25,29,0.862,103,48,93,0.516,35,63,0.556,13,30,0.433,10,14,0.714,119,2017-01-27,SAS,NOP,2017,125.5
5886,5886,86,@,L 103-116 ,240,46,89,0.517,42,77,0.545,4,12,0.333,7,12,0.583,103,42,80,0.525,28,52,0.538,14,28,0.5,18,23,0.783,116,2017-01-28,DET,MIA,2017,123.0
5887,5887,87,Home,L 103-105 ,240,38,85,0.447,28,58,0.483,10,27,0.37,17,22,0.773,103,32,77,0.416,20,48,0.417,12,29,0.414,29,35,0.829,105,2017-02-03,SAC,PHO,2017,111.0
5888,5888,88,@,W 103-95 ,240,40,87,0.46,35,68,0.515,5,19,0.263,18,20,0.9,103,32,76,0.421,19,42,0.452,13,34,0.382,18,21,0.857,95,2017-02-05,TOR,BRK,2017,101.5
5889,5889,89,Home,L 103-111 ,240,34,84,0.405,21,50,0.42,13,34,0.382,22,29,0.759,103,39,74,0.527,28,52,0.538,11,22,0.5,22,25,0.88,111,2017-02-08,PHI,SAS,2017,116.5
5890,5890,90,@,W 103-92 ,240,41,82,0.5,32,63,0.508,9,19,0.474,12,15,0.8,103,39,92,0.424,34,75,0.453,5,17,0.294,9,13,0.692,92,2017-02-10,SAS,DET,2017,94.5
5891,5891,91,Home,L 103-112 ,240,38,82,0.463,26,45,0.578,12,37,0.324,15,18,0.833,103,39,77,0.506,30,55,0.545,9,22,0.409,25,27,0.926,112,2017-02-13,BRK,MEM,2017,116.5
5892,5892,92,@,L 103-104 ,240,36,77,0.468,22,40,0.55,14,37,0.378,17,20,0.85,103,38,90,0.422,32,65,0.492,6,25,0.24,22,22,1.0,104,2017-02-16,BOS,CHI,2017,107.0
5893,5893,93,Home,L 103-112 ,240,34,86,0.395,27,64,0.422,7,22,0.318,28,39,0.718,103,41,81,0.506,32,62,0.516,9,19,0.474,21,27,0.778,112,2017-02-23,ORL,POR,2017,116.5
5894,5894,94,Home,W 103-99 ,240,36,78,0.462,23,47,0.489,13,31,0.419,18,23,0.783,103,37,91,0.407,27,58,0.466,10,33,0.303,15,22,0.682,99,2017-03-01,BOS,CLE,2017,104.0
5895,5895,95,Home,L 103-122 ,240,42,94,0.447,30,60,0.5,12,34,0.353,7,13,0.538,103,37,87,0.425,17,35,0.486,20,52,0.385,28,33,0.848,122,2017-03-01,LAC,HOU,2017,132.0
5896,5896,96,@,L 103-120 ,240,35,89,0.393,25,55,0.455,10,34,0.294,23,28,0.821,103,46,77,0.597,39,58,0.672,7,19,0.368,21,25,0.84,120,2017-03-02,CHA,PHO,2017,123.5
5897,5897,97,@,L 102-104 ,240,38,90,0.422,29,64,0.453,9,26,0.346,17,21,0.81,102,37,63,0.587,31,49,0.633,6,14,0.429,24,32,0.75,104,2011-12-29,DAL,OKC,2012,107.0
5898,5898,98,@,L 102-111 ,240,35,87,0.402,31,67,0.463,4,20,0.2,28,33,0.848,102,41,79,0.519,33,59,0.559,8,20,0.4,21,23,0.913,111,2011-12-29,DEN,POR,2012,115.0
5899,5899,99,Home,W 102-81 ,240,39,73,0.534,31,53,0.585,8,20,0.4,16,25,0.64,102,30,85,0.353,23,67,0.343,7,18,0.389,14,19,0.737,81,2011-12-30,MIL,WAS,2012,84.5
5900,5900,0,Home,W 102-99 ,240,35,79,0.443,29,63,0.46,6,16,0.375,26,33,0.788,102,37,77,0.481,33,64,0.516,4,13,0.308,21,29,0.724,99,2011-12-30,UTA,PHI,2012,101.0
5901,5901,1,Home,W 102-96 ,240,37,75,0.493,25,48,0.521,12,27,0.444,16,24,0.667,102,32,70,0.457,27,57,0.474,5,13,0.385,27,29,0.931,96,2012-01-01,ORL,TOR,2012,98.5
5902,5902,2,Home,W 102-91 ,240,39,87,0.448,31,64,0.484,8,23,0.348,16,21,0.762,102,36,72,0.5,29,55,0.527,7,17,0.412,12,20,0.6,91,2012-01-02,PHO,GSW,2012,94.5
5903,5903,3,@,W 102-96 (OT),265,42,95,0.442,35,75,0.467,7,20,0.35,11,16,0.688,102,40,87,0.46,33,69,0.478,7,18,0.389,9,13,0.692,96,2012-01-06,ATL,CHA,2012,99.5
5904,5904,4,Home,W 102-77 ,240,37,79,0.468,30,59,0.508,7,20,0.35,21,25,0.84,102,25,77,0.325,23,58,0.397,2,19,0.105,25,35,0.714,77,2012-01-06,PHO,POR,2012,78.0
5905,5905,5,Home,W 102-93 ,240,37,78,0.474,26,56,0.464,11,22,0.5,17,17,1.0,102,33,74,0.446,30,69,0.435,3,5,0.6,24,24,1.0,93,2012-01-12,MIL,DET,2012,94.5
5906,5906,6,Home,W 102-76 ,240,39,75,0.52,29,53,0.547,10,22,0.455,14,18,0.778,102,29,78,0.372,24,54,0.444,5,24,0.208,13,16,0.813,76,2012-01-13,DAL,MIL,2012,78.5
5907,5907,7,Home,W 102-94 ,240,35,85,0.412,26,64,0.406,9,21,0.429,23,30,0.767,102,35,77,0.455,30,65,0.462,5,12,0.417,19,25,0.76,94,2012-01-14,LAC,LAL,2012,96.5
5908,5908,8,Home,W 102-91 ,240,40,81,0.494,35,62,0.565,5,19,0.263,17,23,0.739,102,38,91,0.418,33,76,0.434,5,15,0.333,10,14,0.714,91,2012-01-15,SAS,PHO,2012,93.5
5909,5909,9,@,W 102-94 ,240,39,80,0.488,35,65,0.538,4,15,0.267,20,29,0.69,102,38,86,0.442,34,69,0.493,4,17,0.235,14,26,0.538,94,2012-01-16,CLE,CHA,2012,96.0
5910,5910,10,Home,W 102-86 ,240,47,87,0.54,44,77,0.571,3,10,0.3,5,9,0.556,102,33,78,0.423,32,66,0.485,1,12,0.083,19,25,0.76,86,2012-01-16,MEM,CHI,2012,86.5
5911,5911,11,@,W 102-93 ,240,36,71,0.507,19,36,0.528,17,35,0.486,13,22,0.591,102,30,73,0.411,25,53,0.472,5,20,0.25,28,33,0.848,93,2012-01-16,ORL,NYK,2012,95.5
5912,5912,12,@,L 102-105 ,240,37,77,0.481,33,58,0.569,4,19,0.211,24,30,0.8,102,33,86,0.384,25,65,0.385,8,21,0.381,31,43,0.721,105,2012-01-18,OKC,WAS,2012,109.0
5913,5913,13,@,L 102-105 ,240,42,94,0.447,35,72,0.486,7,22,0.318,11,15,0.733,102,44,79,0.557,38,57,0.667,6,22,0.273,11,12,0.917,105,2012-01-21,SAS,HOU,2012,108.0
5914,5914,14,Home,L 102-104 ,240,42,83,0.506,36,71,0.507,6,12,0.5,12,13,0.923,102,41,75,0.547,34,59,0.576,7,16,0.438,15,20,0.75,104,2012-01-23,NOP,SAS,2012,107.5
5915,5915,15,@,W 102-83 ,240,38,83,0.458,25,51,0.49,13,32,0.406,13,19,0.684,102,31,78,0.397,28,67,0.418,3,11,0.273,18,18,1.0,83,2012-01-24,ORL,IND,2012,84.5
5916,5916,16,@,W 102-99 ,240,40,76,0.526,34,65,0.523,6,11,0.545,16,21,0.762,102,39,83,0.47,35,72,0.486,4,11,0.364,17,29,0.586,99,2012-01-28,WAS,CHA,2012,101.0
5917,5917,17,Home,L 102-105 ,240,44,90,0.489,40,74,0.541,4,16,0.25,10,14,0.714,102,39,74,0.527,33,62,0.532,6,12,0.5,21,29,0.724,105,2012-02-02,NYK,CHI,2012,108.0
5918,5918,18,Home,W 102-94 ,240,34,80,0.425,25,54,0.463,9,26,0.346,25,36,0.694,102,33,90,0.367,26,72,0.361,7,18,0.389,21,27,0.778,94,2012-02-03,ORL,CLE,2012,97.5
5919,5919,19,Home,L 102-107 (OT),265,40,86,0.465,29,56,0.518,11,30,0.367,11,16,0.688,102,36,82,0.439,23,51,0.451,13,31,0.419,22,25,0.88,107,2012-02-06,ORL,LAC,2012,113.5
5920,5920,20,Home,W 102-89 ,240,35,83,0.422,18,41,0.439,17,42,0.405,15,21,0.714,102,36,76,0.474,31,61,0.508,5,15,0.333,12,17,0.706,89,2012-02-08,ORL,MIA,2012,91.5
5921,5921,21,Home,W 102-96 ,240,39,86,0.453,32,68,0.471,7,18,0.389,17,21,0.81,102,38,82,0.463,33,57,0.579,5,25,0.2,15,19,0.789,96,2012-02-13,GSW,PHO,2012,98.5
5922,5922,22,Home,W 102-89 ,240,36,85,0.424,24,55,0.436,12,30,0.4,18,22,0.818,102,33,80,0.413,27,59,0.458,6,21,0.286,17,25,0.68,89,2012-02-13,ORL,MIN,2012,92.0
5923,5923,23,Home,W 102-84 ,240,37,80,0.463,27,54,0.5,10,26,0.385,18,22,0.818,102,30,84,0.357,24,57,0.421,6,27,0.222,18,31,0.581,84,2012-02-15,DAL,DEN,2012,87.0
5924,5924,24,Home,W 102-84 ,240,35,83,0.422,24,62,0.387,11,21,0.524,21,28,0.75,102,30,76,0.395,25,54,0.463,5,22,0.227,19,28,0.679,84,2012-02-15,LAC,WAS,2012,86.5
5925,5925,25,Home,W 102-90 ,240,43,85,0.506,39,69,0.565,4,16,0.25,12,16,0.75,102,38,85,0.447,31,67,0.463,7,18,0.389,7,15,0.467,90,2012-02-15,MIN,CHA,2012,93.5
5926,5926,26,@,L 102-103 ,240,41,83,0.494,33,66,0.5,8,17,0.471,12,18,0.667,102,41,82,0.5,35,66,0.53,6,16,0.375,15,19,0.789,103,2012-02-17,DEN,MEM,2012,106.0
5927,5927,27,Home,W 102-90 ,240,34,80,0.425,27,60,0.45,7,20,0.35,27,32,0.844,102,35,78,0.449,32,60,0.533,3,18,0.167,17,25,0.68,90,2012-02-19,PHO,LAL,2012,91.5
5928,5928,28,Home,L 102-106 ,240,40,84,0.476,37,76,0.487,3,8,0.375,19,23,0.826,102,36,78,0.462,26,57,0.456,10,21,0.476,24,30,0.8,106,2012-02-20,UTA,SAS,2012,111.0
5929,5929,29,@,W 102-88 ,240,34,85,0.4,27,69,0.391,7,16,0.438,27,32,0.844,102,31,88,0.352,23,69,0.333,8,19,0.421,18,23,0.783,88,2012-02-22,IND,CHA,2012,92.0
5930,5930,30,Home,W 102-88 ,240,42,85,0.494,38,71,0.535,4,14,0.286,14,19,0.737,102,31,79,0.392,24,62,0.387,7,17,0.412,19,22,0.864,88,2012-02-23,MIA,NYK,2012,91.5
5931,5931,31,Home,W 102-78 ,240,37,84,0.44,32,73,0.438,5,11,0.455,23,32,0.719,102,29,85,0.341,26,63,0.413,3,22,0.136,17,24,0.708,78,2012-02-28,IND,GSW,2012,79.5
5932,5932,32,Home,W 102-96 ,240,40,87,0.46,37,71,0.521,3,16,0.188,19,28,0.679,102,39,96,0.406,35,81,0.432,4,15,0.267,14,16,0.875,96,2012-02-29,BOS,MIL,2012,98.0
5933,5933,33,@,W 102-95 ,240,34,75,0.453,19,39,0.487,15,36,0.417,19,27,0.704,102,37,90,0.411,31,74,0.419,6,16,0.375,15,19,0.789,95,2012-02-29,ORL,WAS,2012,98.0
5934,5934,34,Home,L 102-105 ,240,40,84,0.476,31,59,0.525,9,25,0.36,13,19,0.684,102,38,74,0.514,30,56,0.536,8,18,0.444,21,27,0.778,105,2012-03-01,ORL,OKC,2012,109.0
5935,5935,35,Home,W 102-72 ,240,39,82,0.476,29,62,0.468,10,20,0.5,14,21,0.667,102,31,83,0.373,28,67,0.418,3,16,0.188,7,10,0.7,72,2012-03-02,SAS,CHA,2012,73.5
5936,5936,36,@,W 102-99 ,240,38,81,0.469,34,70,0.486,4,11,0.364,22,32,0.688,102,38,72,0.528,32,56,0.571,6,16,0.375,17,20,0.85,99,2012-03-02,MEM,TOR,2012,102.0
5937,5937,37,Home,W 102-96 ,240,36,75,0.48,26,52,0.5,10,23,0.435,20,24,0.833,102,38,85,0.447,34,69,0.493,4,16,0.25,16,21,0.762,96,2012-03-03,DAL,UTA,2012,98.0
5938,5938,38,@,W 102-84 ,240,35,80,0.438,26,61,0.426,9,19,0.474,23,32,0.719,102,33,81,0.407,29,69,0.42,4,12,0.333,14,21,0.667,84,2012-03-03,IND,NOH,2012,86.0
5939,5939,39,Home,L 102-105 ,240,37,81,0.457,29,61,0.475,8,20,0.4,20,26,0.769,102,39,82,0.476,33,64,0.516,6,18,0.333,21,27,0.778,105,2012-03-09,MIN,LAL,2012,108.0
5940,5940,40,@,L 102-106 ,240,38,85,0.447,32,73,0.438,6,12,0.5,20,23,0.87,102,36,77,0.468,26,58,0.448,10,19,0.526,24,26,0.923,106,2012-03-14,MIA,CHI,2012,111.0
5941,5941,41,Home,W 102-88 ,240,40,83,0.482,28,56,0.5,12,27,0.444,10,13,0.769,102,38,78,0.487,33,67,0.493,5,11,0.455,7,9,0.778,88,2012-03-16,ATL,WAS,2012,90.5
5942,5942,42,@,W 102-88 ,240,32,77,0.416,25,53,0.472,7,24,0.292,31,40,0.775,102,32,79,0.405,28,60,0.467,4,19,0.211,20,27,0.741,88,2012-03-17,NYK,IND,2012,90.0
5943,5943,43,@,W 102-94 ,240,41,81,0.506,33,65,0.508,8,16,0.5,12,13,0.923,102,36,86,0.419,26,63,0.413,10,23,0.435,12,14,0.857,94,2012-03-17,NOP,NJN,2012,99.0
5944,5944,44,Home,W 102-89 ,240,35,72,0.486,27,58,0.466,8,14,0.571,24,26,0.923,102,37,85,0.435,31,63,0.492,6,22,0.273,9,20,0.45,89,2012-03-20,IND,LAC,2012,92.0
5945,5945,45,@,L 102-103 (OT),265,36,78,0.462,30,59,0.508,6,19,0.316,24,33,0.727,102,37,93,0.398,29,73,0.397,8,20,0.4,21,24,0.875,103,2012-03-21,CLE,ATL,2012,107.0
5946,5946,46,Home,L 102-103 ,240,43,106,0.406,39,91,0.429,4,15,0.267,12,21,0.571,102,43,91,0.473,40,74,0.541,3,17,0.176,14,17,0.824,103,2012-03-22,SAC,UTA,2012,104.5
5947,5947,47,@,L 102-121 ,240,36,78,0.462,30,60,0.5,6,18,0.333,24,32,0.75,102,48,81,0.593,41,66,0.621,7,15,0.467,18,29,0.621,121,2012-03-23,DEN,UTA,2012,124.5
5948,5948,48,Home,W 102-101 (OT),265,41,103,0.398,38,80,0.475,3,23,0.13,17,26,0.654,102,39,87,0.448,36,73,0.493,3,14,0.214,20,25,0.8,101,2012-03-24,CHI,TOR,2012,102.5
5949,5949,49,Home,W 102-89 ,240,39,88,0.443,34,72,0.472,5,16,0.313,19,22,0.864,102,35,79,0.443,32,65,0.492,3,14,0.214,16,22,0.727,89,2012-03-24,BRK,CHA,2012,90.5
5950,5950,50,@,W 102-96 ,240,44,86,0.512,38,73,0.521,6,13,0.462,8,10,0.8,102,31,73,0.425,24,55,0.436,7,18,0.389,27,30,0.9,96,2012-03-25,MEM,LAL,2012,99.5
5951,5951,51,@,W 102-95 ,240,33,73,0.452,31,61,0.508,2,12,0.167,34,45,0.756,102,33,79,0.418,29,67,0.433,4,12,0.333,25,35,0.714,95,2012-03-26,BOS,CHA,2012,97.0
5952,5952,52,@,W 102-87 ,240,43,79,0.544,36,68,0.529,7,11,0.636,9,14,0.643,102,33,74,0.446,23,46,0.5,10,28,0.357,11,15,0.733,87,2012-03-28,NOP,GSW,2012,92.0
5953,5953,53,@,W 102-93 ,240,42,91,0.462,37,79,0.468,5,12,0.417,13,17,0.765,102,35,84,0.417,31,73,0.425,4,11,0.364,19,23,0.826,93,2012-03-29,OKC,LAL,2012,95.0
5954,5954,54,@,W 102-100 ,240,35,81,0.432,27,61,0.443,8,20,0.4,24,30,0.8,102,40,76,0.526,33,61,0.541,7,15,0.467,13,16,0.813,100,2012-03-30,BRK,GSW,2012,103.5
5955,5955,55,Home,L 102-104 (OT),265,44,101,0.436,35,80,0.438,9,21,0.429,5,10,0.5,102,37,83,0.446,31,68,0.456,6,15,0.4,24,28,0.857,104,2012-04-01,HOU,IND,2012,107.0
5956,5956,56,@,W 102-97 ,240,41,84,0.488,37,69,0.536,4,15,0.267,16,21,0.762,102,35,81,0.432,23,59,0.39,12,22,0.545,15,18,0.833,97,2012-04-02,UTA,POR,2012,103.0
5957,5957,57,Home,W 102-95 ,240,43,76,0.566,40,65,0.615,3,11,0.273,13,19,0.684,102,33,72,0.458,23,48,0.479,10,24,0.417,19,24,0.792,95,2012-04-03,DET,ORL,2012,100.0
5958,5958,58,Home,W 102-83 ,240,37,90,0.411,31,70,0.443,6,20,0.3,22,26,0.846,102,28,79,0.354,21,58,0.362,7,21,0.333,20,22,0.909,83,2012-04-13,IND,CLE,2012,86.5
5959,5959,59,@,W 102-86 ,240,41,74,0.554,37,62,0.597,4,12,0.333,16,23,0.696,102,29,72,0.403,24,50,0.48,5,22,0.227,23,31,0.742,86,2012-04-15,TOR,ATL,2012,88.5
5960,5960,60,Home,L 102-105 ,240,40,94,0.426,32,65,0.492,8,29,0.276,14,17,0.824,102,38,80,0.475,29,62,0.468,9,18,0.5,20,29,0.69,105,2012-04-16,HOU,DEN,2012,109.5
5961,5961,61,@,W 102-97 ,240,37,89,0.416,24,65,0.369,13,24,0.542,15,18,0.833,102,34,76,0.447,29,62,0.468,5,14,0.357,24,32,0.75,97,2012-04-17,IND,PHI,2012,99.5
5962,5962,62,Home,W 102-98 ,240,38,70,0.543,35,63,0.556,3,7,0.429,23,27,0.852,102,36,78,0.462,30,54,0.556,6,24,0.25,20,30,0.667,98,2012-04-18,BOS,ORL,2012,101.0
5963,5963,63,Home,L 102-127 ,240,41,92,0.446,35,71,0.493,6,21,0.286,14,20,0.7,102,47,80,0.588,39,59,0.661,8,21,0.381,25,31,0.806,127,2012-04-18,SAC,SAS,2012,131.0
5964,5964,64,@,L 102-109 ,240,40,80,0.5,32,61,0.525,8,19,0.421,14,20,0.7,102,43,86,0.5,32,62,0.516,11,24,0.458,12,14,0.857,109,2012-04-24,LAC,ATL,2012,114.5
5965,5965,65,Home,W 102-95 ,240,33,82,0.402,19,44,0.432,14,38,0.368,22,28,0.786,102,31,70,0.443,26,53,0.491,5,17,0.294,28,32,0.875,95,2012-04-25,ORL,CHA,2012,97.5
5966,5966,66,Home,L 102-131 ,240,40,89,0.449,30,62,0.484,10,27,0.37,12,19,0.632,102,56,89,0.629,51,79,0.646,5,10,0.5,14,20,0.7,131,2012-04-26,MIN,DEN,2012,133.5
5967,5967,67,Home,L 102-109 ,240,40,85,0.471,33,63,0.524,7,22,0.318,15,17,0.882,102,38,90,0.422,30,60,0.5,8,30,0.267,25,29,0.862,109,2012-11-02,ATL,HOU,2013,113.0
5968,5968,68,Home,W 102-89 ,240,42,86,0.488,37,71,0.521,5,15,0.333,13,18,0.722,102,32,84,0.381,25,58,0.431,7,26,0.269,18,27,0.667,89,2012-11-02,ORL,DEN,2013,92.5
5969,5969,69,@,L 102-105 ,240,39,83,0.47,33,67,0.493,6,16,0.375,18,29,0.621,102,41,79,0.519,32,55,0.582,9,24,0.375,14,21,0.667,105,2012-11-03,CLE,MIL,2013,109.5
5970,5970,70,Home,W 102-97 ,240,36,85,0.424,28,63,0.444,8,22,0.364,22,28,0.786,102,35,75,0.467,28,62,0.452,7,13,0.538,20,25,0.8,97,2012-11-15,BRK,BOS,2013,100.5
5971,5971,71,@,L 102-114 ,240,45,92,0.489,40,78,0.513,5,14,0.357,7,15,0.467,102,42,89,0.472,34,68,0.5,8,21,0.381,22,28,0.786,114,2012-11-16,PHO,LAL,2013,118.0
5972,5972,72,Home,W 102-94 ,240,39,79,0.494,30,57,0.526,9,22,0.409,15,20,0.75,102,37,75,0.493,33,59,0.559,4,16,0.25,16,18,0.889,94,2012-11-18,POR,CHI,2013,96.0
5973,5973,73,Home,W 102-98 ,240,36,82,0.439,33,71,0.465,3,11,0.273,27,30,0.9,102,44,93,0.473,42,77,0.545,2,16,0.125,8,11,0.727,98,2012-11-19,CHA,MIL,2013,99.0
5974,5974,74,Home,W 102-91 ,240,37,92,0.402,28,71,0.394,9,21,0.429,19,23,0.826,102,30,86,0.349,23,65,0.354,7,21,0.333,24,31,0.774,91,2012-11-19,UTA,HOU,2013,94.5
5975,5975,75,@,W 102-80 ,240,37,83,0.446,23,47,0.489,14,36,0.389,14,19,0.737,102,29,69,0.42,21,51,0.412,8,18,0.444,14,21,0.667,80,2012-11-20,NYK,NOH,2013,84.0
5976,5976,76,Home,W 102-93 ,240,40,75,0.533,33,60,0.55,7,15,0.467,15,19,0.789,102,38,83,0.458,32,60,0.533,6,23,0.261,11,15,0.733,93,2012-11-21,GSW,BRK,2013,96.0
5977,5977,77,Home,W 102-91 ,240,40,84,0.476,35,65,0.538,5,19,0.263,17,30,0.567,102,35,80,0.438,28,63,0.444,7,17,0.412,14,18,0.778,91,2012-11-23,DEN,GSW,2013,94.5
5978,5978,78,@,L 102-104 ,240,40,80,0.5,30,63,0.476,10,17,0.588,12,16,0.75,102,36,83,0.434,33,68,0.485,3,15,0.2,29,33,0.879,104,2012-11-23,SAC,UTA,2013,105.5
5979,5979,79,Home,W 102-84 ,240,40,75,0.533,35,62,0.565,5,13,0.385,17,21,0.81,102,33,85,0.388,27,72,0.375,6,13,0.462,12,20,0.6,84,2012-11-25,DEN,NOH,2013,87.0
5980,5980,80,@,W 102-88 ,240,35,73,0.479,24,52,0.462,11,21,0.524,21,25,0.84,102,33,72,0.458,28,59,0.475,5,13,0.385,17,21,0.81,88,2012-11-28,NYK,MIL,2013,90.5
5981,5981,81,Home,W 102-89 ,240,40,78,0.513,33,58,0.569,7,20,0.35,15,19,0.789,102,33,75,0.44,27,47,0.574,6,28,0.214,17,27,0.63,89,2012-12-01,MIA,BRK,2013,92.0
5982,5982,82,@,W 102-94 ,240,40,92,0.435,32,69,0.464,8,23,0.348,14,16,0.875,102,37,81,0.457,30,64,0.469,7,17,0.412,13,18,0.722,94,2012-12-03,ORL,GSW,2013,97.5
5983,5983,83,Home,W 102-81 ,240,43,82,0.524,38,70,0.543,5,12,0.417,11,11,1.0,102,29,76,0.382,21,57,0.368,8,19,0.421,15,23,0.652,81,2012-12-03,NOP,MIL,2013,85.0
5984,5984,84,Home,L 102-109 ,240,37,87,0.425,26,54,0.481,11,33,0.333,17,23,0.739,102,46,90,0.511,37,71,0.521,9,19,0.474,8,10,0.8,109,2012-12-07,BRK,GSW,2013,113.5
5985,5985,85,Home,L 102-132 ,240,37,79,0.468,31,64,0.484,6,15,0.4,22,31,0.71,102,50,90,0.556,31,56,0.554,19,34,0.559,13,15,0.867,132,2012-12-08,CHA,SAS,2013,141.5
5986,5986,86,Home,W 102-83 ,240,36,79,0.456,30,60,0.5,6,19,0.316,24,34,0.706,102,30,77,0.39,20,51,0.392,10,26,0.385,13,17,0.765,83,2012-12-09,LAC,TOR,2013,88.0
5987,5987,87,Home,L 102-113 ,240,42,78,0.538,31,54,0.574,11,24,0.458,7,10,0.7,102,47,88,0.534,40,71,0.563,7,17,0.412,12,17,0.706,113,2012-12-14,NOP,MIN,2013,116.5
5988,5988,88,@,W 102-96 ,240,37,82,0.451,29,53,0.547,8,29,0.276,20,28,0.714,102,36,83,0.434,28,62,0.452,8,21,0.381,16,20,0.8,96,2012-12-14,LAL,WAS,2013,100.0
5989,5989,89,Home,W 102-72 ,240,40,79,0.506,32,52,0.615,8,27,0.296,14,21,0.667,102,27,72,0.375,20,52,0.385,7,20,0.35,11,15,0.733,72,2012-12-15,MIA,WAS,2013,75.5
5990,5990,90,@,L 102-103 ,240,40,82,0.488,31,58,0.534,9,24,0.375,13,17,0.765,102,37,85,0.435,24,50,0.48,13,35,0.371,16,23,0.696,103,2012-12-15,CLE,NYK,2013,109.5
5991,5991,91,Home,W 102-93 ,240,44,82,0.537,38,68,0.559,6,14,0.429,8,8,1.0,102,39,96,0.406,32,71,0.451,7,25,0.28,8,12,0.667,93,2012-12-17,ORL,MIN,2013,96.5
5992,5992,92,@,W 102-94 ,240,38,78,0.487,25,54,0.463,13,24,0.542,13,16,0.813,102,36,86,0.419,28,65,0.431,8,21,0.381,14,14,1.0,94,2012-12-28,ATL,CLE,2013,98.0
5993,5993,93,Home,W 102-79 ,240,41,77,0.532,33,54,0.611,8,23,0.348,12,17,0.706,102,31,70,0.443,27,48,0.563,4,22,0.182,13,16,0.813,79,2013-01-02,TOR,POR,2013,81.0
5994,5994,94,@,L 102-107 ,240,35,76,0.461,29,51,0.569,6,25,0.24,26,36,0.722,102,41,82,0.5,35,68,0.515,6,14,0.429,19,25,0.76,107,2013-01-04,LAL,LAC,2013,110.0
5995,5995,95,@,W 102-97 ,240,37,86,0.43,21,62,0.339,16,24,0.667,12,13,0.923,102,38,91,0.418,33,75,0.44,5,16,0.313,16,18,0.889,97,2013-01-05,POR,MIN,2013,99.5
5996,5996,96,@,W 102-96 ,240,39,74,0.527,33,56,0.589,6,18,0.333,18,20,0.9,102,31,76,0.408,17,44,0.386,14,32,0.438,20,26,0.769,96,2013-01-07,BOS,NYK,2013,103.0
5997,5997,97,Home,L 102-112 ,240,42,88,0.477,38,80,0.475,4,8,0.5,14,22,0.636,102,44,82,0.537,34,60,0.567,10,22,0.455,14,21,0.667,112,2013-01-09,CHA,UTA,2013,117.0
5998,5998,98,@,W 102-90 ,240,40,84,0.476,35,67,0.522,5,17,0.294,17,22,0.773,102,35,84,0.417,26,59,0.441,9,25,0.36,11,18,0.611,90,2013-01-14,OKC,PHO,2013,94.5
5999,5999,99,@,W 102-87 ,240,33,72,0.458,22,41,0.537,11,31,0.355,25,31,0.806,102,35,79,0.443,29,62,0.468,6,17,0.353,11,22,0.5,87,2013-01-17,NYK,DET,2013,90.0
6000,6000,0,@,L 102-110 ,240,42,95,0.442,34,79,0.43,8,16,0.5,10,13,0.769,102,41,79,0.519,34,63,0.54,7,16,0.438,21,33,0.636,110,2013-01-22,PHI,MIL,2013,113.5
6001,6001,1,@,L 102-106 ,240,38,81,0.469,28,64,0.438,10,17,0.588,16,23,0.696,102,43,80,0.538,35,55,0.636,8,25,0.32,12,23,0.522,106,2013-01-23,NOP,SAS,2013,110.0
6002,6002,2,Home,W 102-84 ,240,43,80,0.538,34,59,0.576,9,21,0.429,7,13,0.538,102,34,81,0.42,31,67,0.463,3,14,0.214,13,16,0.813,84,2013-01-25,LAL,UTA,2013,85.5
6003,6003,3,Home,W 102-101 ,240,37,73,0.507,32,62,0.516,5,11,0.455,23,26,0.885,102,37,77,0.481,27,57,0.474,10,20,0.5,17,23,0.739,101,2013-01-26,CHA,MIN,2013,106.0
6004,6004,4,@,L 102-109 ,240,39,93,0.419,26,65,0.4,13,28,0.464,11,11,1.0,102,41,101,0.406,28,71,0.394,13,30,0.433,14,20,0.7,109,2013-01-26,GSW,MIL,2013,115.5
6005,6005,5,Home,L 102-104 ,240,40,90,0.444,30,67,0.448,10,23,0.435,12,16,0.75,102,40,79,0.506,29,56,0.518,11,23,0.478,13,18,0.722,104,2013-01-27,ORL,DET,2013,109.5
6006,6006,6,Home,W 102-101 ,240,37,78,0.474,30,64,0.469,7,14,0.5,21,30,0.7,102,39,85,0.459,28,62,0.452,11,23,0.478,12,17,0.706,101,2013-01-28,DEN,IND,2013,106.5
6007,6007,7,Home,L 102-114 ,240,38,87,0.437,32,68,0.471,6,19,0.316,20,23,0.87,102,46,86,0.535,40,71,0.563,6,15,0.4,16,20,0.8,114,2013-01-28,TOR,GSW,2013,117.0
6008,6008,8,Home,W 102-78 ,240,38,69,0.551,29,53,0.547,9,16,0.563,17,21,0.81,102,30,73,0.411,26,54,0.481,4,19,0.211,14,17,0.824,78,2013-01-30,SAS,CHA,2013,80.0
6009,6009,9,Home,W 102-89 ,240,39,70,0.557,32,53,0.604,7,17,0.412,17,24,0.708,102,33,70,0.471,28,56,0.5,5,14,0.357,18,24,0.75,89,2013-02-01,IND,MIA,2013,91.5
6010,6010,10,@,W 102-88 ,240,41,80,0.513,31,52,0.596,10,28,0.357,10,16,0.625,102,33,74,0.446,26,51,0.51,7,23,0.304,15,18,0.833,88,2013-02-10,LAC,NYK,2013,91.5
6011,6011,11,Home,W 102-89 ,240,40,78,0.513,32,62,0.516,8,16,0.5,14,18,0.778,102,34,69,0.493,29,56,0.518,5,13,0.385,16,25,0.64,89,2013-02-10,TOR,NOH,2013,91.5
6012,6012,12,@,W 102-90 ,240,42,74,0.568,38,62,0.613,4,12,0.333,14,17,0.824,102,36,95,0.379,31,72,0.431,5,23,0.217,13,22,0.591,90,2013-02-11,WAS,MIL,2013,92.5
6013,6013,13,@,W 102-98 ,240,41,82,0.5,38,69,0.551,3,13,0.231,17,20,0.85,102,33,80,0.413,27,60,0.45,6,20,0.3,26,32,0.813,98,2013-02-19,PHO,POR,2013,101.0
6014,6014,14,Home,L 102-108 ,240,34,90,0.378,25,65,0.385,9,25,0.36,25,29,0.862,102,35,75,0.467,25,45,0.556,10,30,0.333,28,35,0.8,108,2013-02-19,SAC,SAS,2013,113.0
6015,6015,15,Home,L 102-103 ,240,41,89,0.461,37,77,0.481,4,12,0.333,16,20,0.8,102,39,91,0.429,25,63,0.397,14,28,0.5,11,14,0.786,103,2013-02-23,MIL,ATL,2013,110.0
6016,6016,16,Home,W 102-72 ,240,36,79,0.456,30,62,0.484,6,17,0.353,24,27,0.889,102,25,86,0.291,21,68,0.309,4,18,0.222,18,24,0.75,72,2013-02-24,OKC,CHI,2013,74.0
6017,6017,17,@,W 102-91 ,240,38,78,0.487,33,61,0.541,5,17,0.294,21,26,0.808,102,37,83,0.446,33,68,0.485,4,15,0.267,13,23,0.565,91,2013-02-27,ATL,UTA,2013,93.0
6018,6018,18,@,L 102-130 ,240,39,85,0.459,32,64,0.5,7,21,0.333,17,19,0.895,102,51,84,0.607,42,64,0.656,9,20,0.45,19,23,0.826,130,2013-03-01,SAC,SAS,2013,134.5
6019,6019,19,@,W 102-97 ,240,36,78,0.462,24,48,0.5,12,30,0.4,18,21,0.857,102,37,73,0.507,31,53,0.585,6,20,0.3,17,24,0.708,97,2013-03-04,NYK,CLE,2013,100.0
6020,6020,20,Home,L 102-105 ,240,37,80,0.463,29,59,0.492,8,21,0.381,20,26,0.769,102,43,87,0.494,36,66,0.545,7,21,0.333,12,16,0.75,105,2013-03-04,NOP,ORL,2013,108.5
6021,6021,21,Home,L 102-108 ,240,38,88,0.432,29,64,0.453,9,24,0.375,17,20,0.85,102,38,78,0.487,27,50,0.54,11,28,0.393,21,29,0.724,108,2013-03-06,NOP,LAL,2013,113.5
6022,6022,22,@,L 102-107 (OT),265,40,88,0.455,31,61,0.508,9,27,0.333,13,17,0.765,102,40,78,0.513,30,58,0.517,10,20,0.5,17,20,0.85,107,2013-03-08,ATL,BOS,2013,112.0
6023,6023,23,@,W 102-99 ,240,41,78,0.526,30,56,0.536,11,22,0.5,9,15,0.6,102,39,96,0.406,30,66,0.455,9,30,0.3,12,19,0.632,99,2013-03-08,DAL,DET,2013,103.5
6024,6024,24,Home,W 102-93 ,240,42,79,0.532,34,58,0.586,8,21,0.381,10,13,0.769,102,37,77,0.481,27,56,0.482,10,21,0.476,9,11,0.818,93,2013-03-08,MIA,PHI,2013,98.0
6025,6025,25,@,W 102-97 ,240,39,76,0.513,36,65,0.554,3,11,0.273,21,31,0.677,102,32,79,0.405,27,63,0.429,5,16,0.313,28,29,0.966,97,2013-03-12,MEM,POR,2013,99.5
6026,6026,26,@,L 102-113 ,240,42,96,0.438,32,65,0.492,10,31,0.323,8,8,1.0,102,41,72,0.569,29,44,0.659,12,28,0.429,19,29,0.655,113,2013-03-17,SAC,LAL,2013,119.0
6027,6027,27,Home,W 102-95 ,240,42,87,0.483,33,68,0.485,9,19,0.474,9,13,0.692,102,36,83,0.434,23,57,0.404,13,26,0.5,10,13,0.769,95,2013-03-19,MIL,POR,2013,101.5
6028,6028,28,Home,W 102-78 ,240,38,79,0.481,35,67,0.522,3,12,0.25,23,30,0.767,102,31,101,0.307,28,82,0.341,3,19,0.158,13,22,0.591,78,2013-03-22,IND,MIL,2013,79.5
6029,6029,29,@,W 102-100 ,240,35,76,0.461,31,62,0.5,4,14,0.286,28,31,0.903,102,41,99,0.414,35,78,0.449,6,21,0.286,12,17,0.706,100,2013-03-24,BRK,PHO,2013,103.0
6030,6030,30,@,L 102-109 (OT),265,38,85,0.447,28,52,0.538,10,33,0.303,16,25,0.64,102,40,82,0.488,34,59,0.576,6,23,0.261,23,27,0.852,109,2013-03-26,LAC,DAL,2013,112.0
6031,6031,31,@,L 102-111 ,240,34,73,0.466,24,47,0.511,10,26,0.385,24,31,0.774,102,38,77,0.494,29,58,0.5,9,19,0.474,26,30,0.867,111,2013-03-29,CHA,NYK,2013,115.5
6032,6032,32,@,L 102-104 ,240,41,81,0.506,33,62,0.532,8,19,0.421,12,21,0.571,102,39,74,0.527,33,59,0.559,6,15,0.4,20,21,0.952,104,2013-03-29,LAC,SAS,2013,107.0
6033,6033,33,Home,W 102-94 ,240,37,81,0.457,28,51,0.549,9,30,0.3,19,26,0.731,102,41,81,0.506,38,69,0.551,3,12,0.25,9,15,0.6,94,2013-04-01,ATL,CLE,2013,95.5
6034,6034,34,@,L 102-131 ,240,37,73,0.507,31,54,0.574,6,19,0.316,22,28,0.786,102,51,100,0.51,37,73,0.507,14,27,0.519,15,17,0.882,131,2013-04-01,CHA,MIL,2013,138.0
6035,6035,35,@,L 102-112 ,240,39,67,0.582,26,44,0.591,13,23,0.565,11,17,0.647,102,45,83,0.542,36,61,0.59,9,22,0.409,13,18,0.722,112,2013-04-01,POR,UTA,2013,116.5
6036,6036,36,@,W 102-90 ,240,37,71,0.521,23,44,0.523,14,27,0.519,14,20,0.7,102,30,60,0.5,22,40,0.55,8,20,0.4,22,27,0.815,90,2013-04-02,NYK,MIA,2013,94.0
6037,6037,37,Home,L 102-112 ,240,34,87,0.391,28,66,0.424,6,21,0.286,28,34,0.824,102,42,86,0.488,32,56,0.571,10,30,0.333,18,21,0.857,112,2013-04-03,SAC,HOU,2013,117.0
6038,6038,38,@,W 102-91 ,240,37,89,0.416,25,62,0.403,12,27,0.444,16,17,0.941,102,34,85,0.4,28,68,0.412,6,17,0.353,17,21,0.81,91,2013-04-10,PHO,DAL,2013,94.0
6039,6039,39,@,W 102-84 ,240,42,75,0.56,33,58,0.569,9,17,0.529,9,13,0.692,102,31,74,0.419,29,64,0.453,2,10,0.2,20,33,0.606,84,2013-04-15,CHI,ORL,2013,85.0
6040,6040,40,@,L 102-113 ,240,34,78,0.436,24,53,0.453,10,25,0.4,24,32,0.75,102,39,78,0.5,30,54,0.556,9,24,0.375,26,33,0.788,113,2013-10-30,WAS,DET,2014,117.5
6041,6041,41,Home,W 102-95 ,240,36,77,0.468,26,54,0.481,10,23,0.435,20,31,0.645,102,40,88,0.455,33,65,0.508,7,23,0.304,8,14,0.571,95,2013-11-01,ATL,TOR,2014,98.5
6042,6042,42,Home,L 102-109 ,240,41,94,0.436,32,68,0.471,9,26,0.346,11,17,0.647,102,48,94,0.511,42,71,0.592,6,23,0.261,7,14,0.5,109,2013-11-01,WAS,PHI,2014,112.0
6043,6043,43,@,W 102-94 ,240,40,86,0.465,36,70,0.514,4,16,0.25,18,20,0.9,102,35,83,0.422,26,64,0.406,9,19,0.474,15,20,0.75,94,2013-11-05,SAS,DEN,2014,98.5
6044,6044,44,@,W 102-97 ,240,30,71,0.423,22,50,0.44,8,21,0.381,34,42,0.81,102,35,82,0.427,27,54,0.5,8,28,0.286,19,23,0.826,97,2013-11-05,CHA,NYK,2014,101.0
6045,6045,45,Home,L 102-116 ,240,39,83,0.47,33,65,0.508,6,18,0.333,18,26,0.692,102,43,98,0.439,25,65,0.385,18,33,0.545,12,16,0.75,116,2013-11-06,PHI,WAS,2014,125.0
6046,6046,46,Home,W 102-97 ,240,38,71,0.535,33,55,0.6,5,16,0.313,21,33,0.636,102,36,73,0.493,28,49,0.571,8,24,0.333,17,21,0.81,97,2013-11-07,MIA,LAC,2014,101.0
6047,6047,47,Home,W 102-88 ,240,41,80,0.513,32,59,0.542,9,21,0.429,11,14,0.786,102,35,77,0.455,27,60,0.45,8,17,0.471,10,16,0.625,88,2013-11-16,GSW,UTA,2014,92.0
6048,6048,48,Home,L 102-106 ,240,34,86,0.395,27,63,0.429,7,23,0.304,27,32,0.844,102,39,81,0.481,34,69,0.493,5,12,0.417,23,30,0.767,106,2013-11-18,LAC,MEM,2014,108.5
6049,6049,49,@,W 102-98 ,240,40,81,0.494,28,57,0.491,12,24,0.5,10,16,0.625,102,34,90,0.378,29,68,0.426,5,22,0.227,25,31,0.806,98,2013-11-20,LAC,MIN,2014,100.5
6050,6050,50,Home,W 102-95 ,240,39,82,0.476,28,58,0.483,11,24,0.458,13,17,0.765,102,34,82,0.415,25,60,0.417,9,22,0.409,18,28,0.643,95,2013-11-22,LAL,GSW,2014,99.5
6051,6051,51,@,W 102-86 ,240,42,79,0.532,35,62,0.565,7,17,0.412,11,16,0.688,102,35,80,0.438,32,69,0.464,3,11,0.273,13,17,0.765,86,2013-11-22,SAS,MEM,2014,87.5
6052,6052,52,Home,W 102-100 ,240,35,79,0.443,24,47,0.511,11,32,0.344,21,30,0.7,102,35,87,0.402,28,66,0.424,7,21,0.333,23,25,0.92,100,2013-11-23,DEN,DAL,2014,103.5
6053,6053,53,@,L 102-103 ,240,37,88,0.42,32,71,0.451,5,17,0.294,23,30,0.767,102,33,68,0.485,22,43,0.512,11,25,0.44,26,45,0.578,103,2013-11-23,SAC,LAC,2014,108.5
6054,6054,54,Home,W 102-91 ,240,37,84,0.44,28,59,0.475,9,25,0.36,19,22,0.864,102,38,85,0.447,32,70,0.457,6,15,0.4,9,14,0.643,91,2013-11-25,POR,NYK,2014,94.0
6055,6055,55,@,W 102-101 ,240,40,88,0.455,33,69,0.478,7,19,0.368,15,21,0.714,102,41,87,0.471,32,68,0.471,9,19,0.474,10,13,0.769,101,2013-11-26,GSW,NOP,2014,105.5
6056,6056,56,@,W 102-100 ,240,39,77,0.506,35,63,0.556,4,14,0.286,20,22,0.909,102,34,78,0.436,23,52,0.442,11,26,0.423,21,22,0.955,100,2013-11-26,BRK,TOR,2014,105.5
6057,6057,57,Home,L 102-106 ,240,44,100,0.44,43,92,0.467,1,8,0.125,13,25,0.52,102,36,80,0.45,22,49,0.449,14,31,0.452,20,30,0.667,106,2013-11-29,DET,LAL,2014,113.0
6058,6058,58,@,L 102-106 ,240,39,88,0.443,30,66,0.455,9,22,0.409,15,17,0.882,102,36,76,0.474,31,63,0.492,5,13,0.385,29,33,0.879,106,2013-12-02,IND,POR,2014,108.5
6059,6059,59,Home,W 102-100 ,240,42,78,0.538,36,60,0.6,6,18,0.333,12,17,0.706,102,42,96,0.438,31,65,0.477,11,31,0.355,5,5,1.0,100,2013-12-02,SAS,ATL,2014,105.5
6060,6060,60,Home,L 102-112 (OT),265,36,89,0.404,28,70,0.4,8,19,0.421,22,30,0.733,102,39,94,0.415,36,79,0.456,3,15,0.2,31,38,0.816,112,2013-12-07,UTA,SAC,2014,113.5
6061,6061,61,Home,W 102-93 ,240,33,74,0.446,25,54,0.463,8,20,0.4,28,30,0.933,102,26,70,0.371,20,46,0.435,6,24,0.25,35,52,0.673,93,2013-12-12,BRK,LAC,2014,96.0
6062,6062,62,Home,W 102-93 ,240,37,85,0.435,30,61,0.492,7,24,0.292,21,28,0.75,102,37,85,0.435,30,61,0.492,7,24,0.292,12,19,0.632,93,2013-12-15,DEN,NOP,2014,96.5
6063,6063,63,@,L 102-106 ,240,34,80,0.425,23,58,0.397,11,22,0.5,23,33,0.697,102,35,79,0.443,22,52,0.423,13,27,0.481,23,34,0.676,106,2013-12-15,GSW,PHO,2014,112.5
6064,6064,64,@,W 102-101 ,240,39,72,0.542,28,54,0.519,11,18,0.611,13,17,0.765,102,33,79,0.418,22,49,0.449,11,30,0.367,24,31,0.774,101,2013-12-16,WAS,NYK,2014,106.5
6065,6065,65,Home,L 102-104 (OT),265,41,96,0.427,35,70,0.5,6,26,0.231,14,20,0.7,102,37,81,0.457,29,66,0.439,8,15,0.533,22,34,0.647,104,2013-12-18,TOR,CHA,2014,108.0
6066,6066,66,Home,L 102-104 ,240,42,90,0.467,34,59,0.576,8,31,0.258,10,11,0.909,102,40,89,0.449,29,62,0.468,11,27,0.407,13,19,0.684,104,2013-12-19,GSW,SAS,2014,109.5
6067,6067,67,Home,W 102-83 ,240,38,98,0.388,26,67,0.388,12,31,0.387,14,19,0.737,102,26,80,0.325,22,60,0.367,4,20,0.2,27,33,0.818,83,2013-12-21,GSW,LAL,2014,85.0
6068,6068,68,@,L 102-109 ,240,36,81,0.444,21,42,0.5,15,39,0.385,15,21,0.714,102,41,74,0.554,33,53,0.623,8,21,0.381,19,24,0.792,109,2013-12-29,ATL,ORL,2014,113.0
6069,6069,69,Home,L 102-114 ,240,36,91,0.396,31,66,0.47,5,25,0.2,25,35,0.714,102,43,92,0.467,34,69,0.493,9,23,0.391,19,28,0.679,114,2014-01-01,DEN,PHI,2014,118.5
6070,6070,70,Home,W 102-100 ,240,34,74,0.459,24,48,0.5,10,26,0.385,24,28,0.857,102,37,89,0.416,28,65,0.431,9,24,0.375,17,24,0.708,100,2014-01-03,HOU,NYK,2014,104.5
6071,6071,71,Home,W 102-97 ,240,38,81,0.469,35,70,0.5,3,11,0.273,23,27,0.852,102,39,77,0.506,32,55,0.582,7,22,0.318,12,21,0.571,97,2014-01-05,MIA,TOR,2014,100.5
6072,6072,72,Home,W 102-98 ,240,34,77,0.442,29,58,0.5,5,19,0.263,29,35,0.829,102,36,78,0.462,27,52,0.519,9,26,0.346,17,23,0.739,98,2014-01-08,BRK,GSW,2014,102.5
6073,6073,73,@,W 102-96 ,240,38,80,0.475,28,59,0.475,10,21,0.476,16,26,0.615,102,35,78,0.449,31,65,0.477,4,13,0.308,22,27,0.815,96,2014-01-08,WAS,NOP,2014,98.0
6074,6074,74,Home,W 102-92 ,240,44,82,0.537,35,58,0.603,9,24,0.375,5,10,0.5,102,37,68,0.544,30,47,0.638,7,21,0.333,11,21,0.524,92,2014-01-09,NYK,MIA,2014,95.5
6075,6075,75,Home,L 102-113 ,240,39,81,0.481,30,61,0.492,9,20,0.45,15,27,0.556,102,45,83,0.542,38,69,0.551,7,14,0.5,16,20,0.8,113,2014-01-10,UTA,CLE,2014,116.5
6076,6076,76,@,W 102-92 ,240,39,82,0.476,33,64,0.516,6,18,0.333,18,23,0.783,102,36,78,0.462,31,59,0.525,5,19,0.263,15,21,0.714,92,2014-01-11,NYK,PHI,2014,94.5
6077,6077,77,@,W 102-88 ,240,39,75,0.52,32,57,0.561,7,18,0.389,17,28,0.607,102,34,79,0.43,25,58,0.431,9,21,0.429,11,19,0.579,88,2014-01-13,WAS,CHI,2014,92.5
6078,6078,78,Home,W 102-100 (OT),265,39,102,0.382,32,81,0.395,7,21,0.333,17,24,0.708,102,35,83,0.422,27,58,0.466,8,25,0.32,22,26,0.846,100,2014-01-20,CHI,LAL,2014,104.0
6079,6079,79,@,W 102-97 ,240,38,83,0.458,34,63,0.54,4,20,0.2,22,28,0.786,102,33,81,0.407,28,58,0.483,5,23,0.217,26,33,0.788,97,2014-01-20,DAL,CLE,2014,99.5
6080,6080,80,@,W 102-94 ,240,41,91,0.451,33,72,0.458,8,19,0.421,12,15,0.8,102,35,86,0.407,25,56,0.446,10,30,0.333,14,20,0.7,94,2014-01-20,IND,GSW,2014,99.0
6081,6081,81,@,L 102-109 ,240,40,88,0.455,31,63,0.492,9,25,0.36,13,21,0.619,102,45,78,0.577,37,58,0.638,8,20,0.4,11,23,0.478,109,2014-01-23,LAL,MIA,2014,113.0
6082,6082,82,@,W 102-94 ,240,39,91,0.429,31,74,0.419,8,17,0.471,16,20,0.8,102,38,87,0.437,37,72,0.514,1,15,0.067,17,24,0.708,94,2014-01-30,PHO,IND,2014,94.5
6083,6083,83,@,L 102-113 ,240,39,87,0.448,29,66,0.439,10,21,0.476,14,24,0.583,102,43,83,0.518,36,67,0.537,7,16,0.438,20,25,0.8,113,2014-01-31,MIL,ORL,2014,116.5
6084,6084,84,Home,W 102-87 ,240,38,74,0.514,36,62,0.581,2,12,0.167,24,37,0.649,102,29,81,0.358,19,51,0.373,10,30,0.333,19,28,0.679,87,2014-02-01,LAC,UTA,2014,92.0
6085,6085,85,@,L 102-108 ,240,37,71,0.521,29,51,0.569,8,20,0.4,20,28,0.714,102,32,72,0.444,22,47,0.468,10,25,0.4,34,39,0.872,108,2014-02-03,PHI,BRK,2014,113.0
6086,6086,86,Home,W 102-96 ,240,39,85,0.459,32,65,0.492,7,20,0.35,17,21,0.81,102,34,83,0.41,28,65,0.431,6,18,0.333,22,29,0.759,96,2014-02-03,MIA,DET,2014,99.0
6087,6087,87,@,W 102-95 ,240,38,81,0.469,33,63,0.524,5,18,0.278,21,25,0.84,102,36,79,0.456,30,65,0.462,6,14,0.429,17,20,0.85,95,2014-02-03,SAS,NOP,2014,98.0
6088,6088,88,Home,W 102-87 ,240,40,83,0.482,29,61,0.475,11,22,0.5,11,15,0.733,102,32,77,0.416,28,63,0.444,4,14,0.286,19,20,0.95,87,2014-02-06,GSW,CHI,2014,89.0
6089,6089,89,@,L 102-103 ,240,37,73,0.507,27,51,0.529,10,22,0.455,18,19,0.947,102,38,80,0.475,33,68,0.485,5,12,0.417,22,26,0.846,103,2014-02-07,OKC,ORL,2014,105.5
6090,6090,90,@,W 102-91 ,240,37,82,0.451,27,59,0.458,10,23,0.435,18,20,0.9,102,33,92,0.359,22,65,0.338,11,27,0.407,14,15,0.933,91,2014-02-09,DAL,BOS,2014,96.5
6091,6091,91,@,W 102-86 ,240,42,88,0.477,35,68,0.515,7,20,0.35,11,14,0.786,102,31,72,0.431,25,56,0.446,6,16,0.375,18,25,0.72,86,2014-02-10,BOS,MIL,2014,89.0
6092,6092,92,@,W 102-98 ,240,41,79,0.519,35,66,0.53,6,13,0.462,14,17,0.824,102,39,80,0.488,33,64,0.516,6,16,0.375,14,19,0.737,98,2014-02-12,NOP,MIL,2014,101.0
6093,6093,93,Home,W 102-99 (OT),265,37,93,0.398,28,66,0.424,9,27,0.333,19,24,0.792,102,37,101,0.366,28,71,0.394,9,30,0.3,16,25,0.64,99,2014-02-20,GSW,HOU,2014,103.5
6094,6094,94,Home,W 102-96 ,240,42,87,0.483,37,72,0.514,5,15,0.333,13,15,0.867,102,31,80,0.388,24,56,0.429,7,24,0.292,27,43,0.628,96,2014-02-21,MEM,LAC,2014,99.5
6095,6095,95,Home,W 102-94 ,240,39,91,0.429,32,71,0.451,7,20,0.35,17,17,1.0,102,37,82,0.451,31,69,0.449,6,13,0.462,14,18,0.778,94,2014-02-21,POR,UTA,2014,97.0
6096,6096,96,Home,L 102-113 ,240,40,82,0.488,38,71,0.535,2,11,0.182,20,30,0.667,102,44,90,0.489,36,67,0.537,8,23,0.348,17,22,0.773,113,2014-02-22,DET,DAL,2014,117.0
6097,6097,97,Home,L 102-108 ,240,39,76,0.513,32,59,0.542,7,17,0.412,17,26,0.654,102,36,76,0.474,24,51,0.471,12,25,0.48,24,32,0.75,108,2014-02-23,LAL,BRK,2014,114.0
6098,6098,98,@,W 102-97 ,240,39,77,0.506,34,64,0.531,5,13,0.385,19,23,0.826,102,38,89,0.427,31,68,0.456,7,21,0.333,14,17,0.824,97,2014-03-01,IND,BOS,2014,100.5
6099,6099,99,Home,W 102-96 ,240,37,81,0.457,32,54,0.593,5,27,0.185,23,24,0.958,102,33,83,0.398,26,60,0.433,7,23,0.304,23,35,0.657,96,2014-03-01,POR,DEN,2014,99.5
6100,6100,0,Home,L 102-116 ,240,36,82,0.439,30,65,0.462,6,17,0.353,24,29,0.828,102,43,83,0.518,39,69,0.565,4,14,0.286,26,32,0.813,116,2014-03-05,MIL,SAC,2014,118.0
6101,6101,1,Home,W 102-78 ,240,35,79,0.443,22,50,0.44,13,29,0.448,19,21,0.905,102,29,88,0.33,25,61,0.41,4,27,0.148,16,19,0.842,78,2014-03-05,POR,ATL,2014,80.0
6102,6102,2,Home,W 102-97 ,240,36,74,0.486,23,45,0.511,13,29,0.448,17,20,0.85,102,37,89,0.416,34,70,0.486,3,19,0.158,20,26,0.769,97,2014-03-13,ATL,MIL,2014,98.5
6103,6103,3,@,L 102-131 ,240,37,94,0.394,24,67,0.358,13,27,0.481,15,25,0.6,102,45,89,0.506,32,59,0.542,13,30,0.433,28,30,0.933,131,2014-03-13,LAL,OKC,2014,137.5
6104,6104,4,Home,W 102-80 ,240,42,94,0.447,34,66,0.515,8,28,0.286,10,15,0.667,102,29,83,0.349,21,59,0.356,8,24,0.333,14,20,0.7,80,2014-03-16,LAC,CLE,2014,84.0
6105,6105,5,@,L 102-104 ,240,41,85,0.482,35,66,0.53,6,19,0.316,14,19,0.737,102,34,78,0.436,28,61,0.459,6,17,0.353,30,38,0.789,104,2014-03-16,SAC,MIN,2014,107.0
6106,6106,6,@,W 102-94 ,240,36,83,0.434,28,68,0.412,8,15,0.533,22,27,0.815,102,37,81,0.457,26,57,0.456,11,24,0.458,9,19,0.474,94,2014-03-19,CHI,PHI,2014,99.5
6107,6107,7,@,W 102-95 ,240,38,89,0.427,28,58,0.483,10,31,0.323,16,20,0.8,102,36,81,0.444,28,59,0.475,8,22,0.364,15,24,0.625,95,2014-03-20,OKC,CLE,2014,99.0
6108,6108,8,@,L 102-105 ,240,41,85,0.482,36,70,0.514,5,15,0.333,15,18,0.833,102,40,91,0.44,29,64,0.453,11,27,0.407,14,18,0.778,105,2014-03-23,WAS,DEN,2014,110.5
6109,6109,9,@,W 102-95 ,240,38,74,0.514,26,50,0.52,12,24,0.5,14,16,0.875,102,30,72,0.417,22,49,0.449,8,23,0.348,27,33,0.818,95,2014-03-24,PHO,ATL,2014,99.0
6110,6110,10,Home,W 102-100 ,240,36,70,0.514,32,57,0.561,4,13,0.308,26,33,0.788,102,35,88,0.398,21,56,0.375,14,32,0.438,16,26,0.615,100,2014-03-25,CLE,TOR,2014,107.0
6111,6111,11,Home,L 102-133 ,240,35,87,0.402,29,64,0.453,6,23,0.261,26,35,0.743,102,55,98,0.561,42,74,0.568,13,24,0.542,10,14,0.714,133,2014-03-28,DEN,SAS,2014,139.5
6112,6112,12,Home,W 102-95 ,240,36,71,0.507,30,57,0.526,6,14,0.429,24,32,0.75,102,33,68,0.485,26,47,0.553,7,21,0.333,22,27,0.815,95,2014-03-28,NOP,UTA,2014,98.5
6113,6113,13,Home,L 102-107 ,240,40,87,0.46,30,58,0.517,10,29,0.345,12,16,0.75,102,37,70,0.529,29,54,0.537,8,16,0.5,25,31,0.806,107,2014-03-30,BOS,CHI,2014,111.0
6114,6114,14,@,W 102-97 ,240,38,80,0.475,35,69,0.507,3,11,0.273,23,31,0.742,102,36,73,0.493,31,59,0.525,5,14,0.357,20,26,0.769,97,2014-03-31,SAC,NOP,2014,99.5
6115,6115,15,Home,W 102-88 ,240,43,81,0.531,38,65,0.585,5,16,0.313,11,16,0.688,102,40,95,0.421,36,84,0.429,4,11,0.364,4,6,0.667,88,2014-04-02,MIN,MEM,2014,90.0
6116,6116,16,@,L 102-107 ,240,37,96,0.385,25,68,0.368,12,28,0.429,16,20,0.8,102,42,86,0.488,37,71,0.521,5,15,0.333,18,27,0.667,107,2014-04-02,LAL,SAC,2014,109.5
6117,6117,17,Home,L 102-111 ,240,38,87,0.437,29,54,0.537,9,33,0.273,17,21,0.81,102,39,77,0.506,33,58,0.569,6,19,0.316,27,37,0.73,111,2014-04-04,BOS,PHI,2014,114.0
6118,6118,18,Home,W 102-90 ,240,31,84,0.369,24,62,0.387,7,22,0.318,33,42,0.786,102,31,68,0.456,29,60,0.483,2,8,0.25,26,35,0.743,90,2014-04-04,CHI,MIL,2014,91.0
6119,6119,19,Home,W 102-69 ,240,42,93,0.452,32,63,0.508,10,30,0.333,8,12,0.667,102,25,78,0.321,24,68,0.353,1,10,0.1,18,25,0.72,69,2014-04-04,GSW,SAC,2014,69.5
6120,6120,20,Home,W 102-94 ,240,40,84,0.476,30,62,0.484,10,22,0.455,12,16,0.75,102,33,78,0.423,27,67,0.403,6,11,0.545,22,28,0.786,94,2014-04-04,TOR,IND,2014,97.0
6121,6121,21,@,W 102-98 ,240,36,81,0.444,24,54,0.444,12,27,0.444,18,22,0.818,102,38,79,0.481,37,70,0.529,1,9,0.111,21,27,0.778,98,2014-04-05,TOR,MIL,2014,98.5
6122,6122,22,@,L 102-130 ,240,39,86,0.453,35,73,0.479,4,13,0.308,20,28,0.714,102,52,90,0.578,35,57,0.614,17,33,0.515,9,9,1.0,130,2014-04-06,UTA,GSW,2014,138.5
6123,6123,23,Home,W 102-91 ,240,34,61,0.557,22,34,0.647,12,27,0.444,22,30,0.733,102,33,88,0.375,18,46,0.391,15,42,0.357,10,13,0.769,91,2014-04-06,MIA,NYK,2014,98.5
6124,6124,24,@,W 102-95 ,240,37,86,0.43,31,69,0.449,6,17,0.353,22,32,0.688,102,34,89,0.382,25,54,0.463,9,35,0.257,18,24,0.75,95,2014-04-08,DET,ATL,2014,99.5
6125,6125,25,@,L 102-107 ,240,38,73,0.521,23,48,0.479,15,25,0.6,11,12,0.917,102,43,78,0.551,36,58,0.621,7,20,0.35,14,21,0.667,107,2014-04-09,MIA,MEM,2014,110.5
6126,6126,26,Home,L 102-104 ,240,38,87,0.437,34,71,0.479,4,16,0.25,22,29,0.759,102,41,85,0.482,30,61,0.492,11,24,0.458,11,19,0.579,104,2014-04-09,MIL,IND,2014,109.5
6127,6127,27,@,W 102-87 ,240,41,82,0.5,30,61,0.492,11,21,0.524,9,12,0.75,102,34,80,0.425,30,63,0.476,4,17,0.235,15,16,0.938,87,2014-04-09,CHI,MIN,2014,89.0
6128,6128,28,Home,W 102-97 ,240,38,72,0.528,29,52,0.558,9,20,0.45,17,23,0.739,102,36,84,0.429,29,56,0.518,7,28,0.25,18,19,0.947,97,2014-04-13,IND,OKC,2014,100.5
6129,6129,29,@,W 102-90 ,240,42,88,0.477,34,73,0.466,8,15,0.533,10,13,0.769,102,35,80,0.438,24,53,0.453,11,27,0.407,9,11,0.818,90,2014-04-13,MEM,LAL,2014,95.5
6130,6130,30,Home,L 102-118 ,240,39,84,0.464,32,54,0.593,7,30,0.233,17,23,0.739,102,50,88,0.568,44,70,0.629,6,18,0.333,12,17,0.706,118,2014-04-16,BOS,WAS,2014,121.0
6131,6131,31,@,L 102-109 ,240,40,80,0.5,27,58,0.466,13,22,0.591,9,17,0.529,102,37,90,0.411,29,64,0.453,8,26,0.308,27,33,0.818,109,2014-10-29,ATL,TOR,2015,113.0
6132,6132,32,@,L 102-120 ,240,36,83,0.434,22,48,0.458,14,35,0.4,16,18,0.889,102,47,85,0.553,39,64,0.609,8,21,0.381,18,23,0.783,120,2014-10-30,UTA,DAL,2015,124.0
6133,6133,33,Home,W 102-92 ,240,35,69,0.507,28,49,0.571,7,20,0.35,25,33,0.758,102,31,81,0.383,19,49,0.388,12,32,0.375,18,21,0.857,92,2014-11-01,ATL,IND,2015,98.0
6134,6134,34,@,W 102-90 ,240,42,87,0.483,35,61,0.574,7,26,0.269,11,13,0.846,102,32,76,0.421,31,59,0.525,1,17,0.059,25,35,0.714,90,2014-11-01,BRK,DET,2015,90.5
6135,6135,35,Home,W 102-91 ,240,37,80,0.463,31,60,0.517,6,20,0.3,22,31,0.71,102,35,80,0.438,28,54,0.519,7,26,0.269,14,20,0.7,91,2014-11-01,OKC,DEN,2015,94.5
6136,6136,36,@,L 102-107 ,240,37,79,0.468,33,63,0.524,4,16,0.25,24,39,0.615,102,35,70,0.5,26,46,0.565,9,24,0.375,28,38,0.737,107,2014-11-02,TOR,MIA,2015,111.5
6137,6137,37,@,W 102-91 ,240,40,80,0.5,31,63,0.492,9,17,0.529,13,17,0.765,102,32,69,0.464,24,48,0.5,8,21,0.381,19,21,0.905,91,2014-11-05,MEM,PHO,2015,95.0
6138,6138,38,Home,W 102-100 ,240,39,77,0.506,32,56,0.571,7,21,0.333,17,22,0.773,102,30,72,0.417,24,56,0.429,6,16,0.375,34,40,0.85,100,2014-11-05,UTA,CLE,2015,103.0
6139,6139,39,@,L 102-106 ,240,36,80,0.45,26,55,0.473,10,25,0.4,20,25,0.8,102,40,81,0.494,35,69,0.507,5,12,0.417,21,30,0.7,106,2014-11-08,POR,LAC,2015,108.5
6140,6140,40,Home,W 102-92 ,240,41,78,0.526,36,65,0.554,5,13,0.385,15,17,0.882,102,35,87,0.402,31,71,0.437,4,16,0.25,18,23,0.783,92,2014-11-08,MIA,MIN,2015,94.0
6141,6141,41,Home,W 102-91 ,240,39,88,0.443,32,68,0.471,7,20,0.35,17,20,0.85,102,34,80,0.425,27,66,0.409,7,14,0.5,16,25,0.64,91,2014-11-10,CHI,DET,2015,94.5
6142,6142,42,@,L 102-107 ,240,41,87,0.471,34,65,0.523,7,22,0.318,13,17,0.765,102,41,78,0.526,37,67,0.552,4,11,0.364,21,26,0.808,107,2014-11-11,LAL,MEM,2015,109.0
6143,6143,43,Home,W 102-100 ,240,40,93,0.43,32,68,0.471,8,25,0.32,14,16,0.875,102,35,75,0.467,28,59,0.475,7,16,0.438,23,27,0.852,100,2014-11-11,POR,CHO,2015,103.5
6144,6144,44,@,L 102-109 ,240,35,84,0.417,28,63,0.444,7,21,0.333,25,32,0.781,102,45,82,0.549,37,63,0.587,8,19,0.421,11,18,0.611,109,2014-11-12,LAL,NOP,2015,113.0
6145,6145,45,@,W 102-100 ,240,36,70,0.514,26,48,0.542,10,22,0.455,20,25,0.8,102,39,82,0.476,34,74,0.459,5,8,0.625,17,20,0.85,100,2014-11-14,UTA,NYK,2015,102.5
6146,6146,46,Home,W 102-93 ,240,38,76,0.5,31,57,0.544,7,19,0.368,19,23,0.826,102,38,85,0.447,33,66,0.5,5,19,0.263,12,19,0.632,93,2014-11-17,POR,NOP,2015,95.5
6147,6147,47,Home,L 102-105 ,240,37,84,0.44,27,62,0.435,10,22,0.455,18,21,0.857,102,34,82,0.415,22,54,0.407,12,28,0.429,25,29,0.862,105,2014-11-19,WAS,DAL,2015,111.0
6148,6148,48,Home,L 102-106 ,240,36,84,0.429,27,64,0.422,9,20,0.45,21,29,0.724,102,36,85,0.424,29,60,0.483,7,25,0.28,27,34,0.794,106,2014-11-25,WAS,ATL,2015,109.5
6149,6149,49,@,L 102-109 (OT),265,39,92,0.424,25,64,0.391,14,28,0.5,10,16,0.625,102,38,95,0.4,34,64,0.531,4,31,0.129,29,38,0.763,109,2014-11-26,NYK,DAL,2015,111.0
6150,6150,50,Home,W 102-89 ,240,42,94,0.447,30,59,0.508,12,35,0.343,6,15,0.4,102,31,71,0.437,26,55,0.473,5,16,0.313,22,28,0.786,89,2014-11-26,HOU,SAC,2015,91.5
6151,6151,51,Home,L 102-109 ,240,37,92,0.402,31,70,0.443,6,22,0.273,22,29,0.759,102,37,90,0.411,32,73,0.438,5,17,0.294,30,37,0.811,109,2014-11-28,BOS,CHI,2015,111.5
6152,6152,52,@,W 102-85 ,240,38,81,0.469,29,56,0.518,9,25,0.36,17,22,0.773,102,32,82,0.39,22,45,0.489,10,37,0.27,11,15,0.733,85,2014-11-28,LAC,HOU,2015,90.0
6153,6153,53,Home,L 102-106 ,240,38,91,0.418,24,58,0.414,14,33,0.424,12,16,0.75,102,40,86,0.465,29,60,0.483,11,26,0.423,15,22,0.682,106,2014-11-28,TOR,DAL,2015,111.5
6154,6154,54,@,W 102-84 ,240,34,69,0.493,27,45,0.6,7,24,0.292,27,34,0.794,102,32,86,0.372,30,72,0.417,2,14,0.143,18,24,0.75,84,2014-11-30,CHI,BRK,2015,85.0
6155,6155,55,@,L 102-109 (OT),265,37,102,0.363,29,75,0.387,8,27,0.296,20,29,0.69,102,37,93,0.398,24,63,0.381,13,30,0.433,22,27,0.815,109,2014-12-03,DET,BOS,2015,115.5
6156,6156,56,@,W 102-95 ,240,37,80,0.463,25,52,0.481,12,28,0.429,16,21,0.762,102,36,90,0.4,34,75,0.453,2,15,0.133,21,23,0.913,95,2014-12-03,CHI,CHO,2015,96.0
6157,6157,57,Home,L 102-112 ,240,36,64,0.563,30,48,0.625,6,16,0.375,24,32,0.75,102,40,74,0.541,28,49,0.571,12,25,0.48,20,23,0.87,112,2014-12-03,MIA,ATL,2015,118.0
6158,6158,58,@,L 102-103 ,240,37,79,0.468,27,57,0.474,10,22,0.455,18,22,0.818,102,42,88,0.477,38,70,0.543,4,18,0.222,15,18,0.833,103,2014-12-05,NYK,CHO,2015,105.0
6159,6159,59,Home,W 102-101 (OT),265,36,83,0.434,34,73,0.466,2,10,0.2,28,40,0.7,102,36,96,0.375,30,70,0.429,6,26,0.231,23,29,0.793,101,2014-12-05,SAC,IND,2015,104.0
6160,6160,60,Home,L 102-112 ,240,36,83,0.434,29,62,0.468,7,21,0.333,23,27,0.852,102,40,89,0.449,28,59,0.475,12,30,0.4,20,25,0.8,112,2014-12-06,CHI,GSW,2015,118.0
6161,6161,61,@,L 102-125 ,240,42,84,0.5,38,69,0.551,4,15,0.267,14,17,0.824,102,49,84,0.583,37,53,0.698,12,31,0.387,15,19,0.789,125,2014-12-07,MIL,DAL,2015,131.0
6162,6162,62,@,W 102-86 ,240,42,91,0.462,37,69,0.536,5,22,0.227,13,14,0.929,102,32,88,0.364,30,77,0.39,2,11,0.182,20,29,0.69,86,2014-12-08,GSW,MIN,2015,87.0
6163,6163,63,Home,W 102-82 ,240,38,85,0.447,30,62,0.484,8,23,0.348,18,27,0.667,102,30,82,0.366,23,60,0.383,7,22,0.318,15,21,0.714,82,2014-12-10,DEN,MIA,2015,85.5
6164,6164,64,Home,W 102-100 ,240,34,78,0.436,28,60,0.467,6,18,0.333,28,45,0.622,102,40,90,0.444,36,71,0.507,4,19,0.211,16,23,0.696,100,2014-12-17,LAC,IND,2015,102.0
6165,6165,65,@,L 102-106 ,240,43,81,0.531,35,57,0.614,8,24,0.333,8,15,0.533,102,37,81,0.457,25,55,0.455,12,26,0.462,20,27,0.741,106,2014-12-20,MIL,LAC,2015,112.0
6166,6166,66,Home,L 102-105 ,240,39,90,0.433,28,62,0.452,11,28,0.393,13,20,0.65,102,40,81,0.494,33,62,0.532,7,19,0.368,18,27,0.667,105,2014-12-22,DAL,ATL,2015,108.5
6167,6167,67,Home,W 102-96 ,240,43,91,0.473,37,68,0.544,6,23,0.261,10,14,0.714,102,36,82,0.439,29,57,0.509,7,25,0.28,17,22,0.773,96,2014-12-23,BRK,DEN,2015,99.5
6168,6168,68,@,W 102-91 ,240,44,86,0.512,37,70,0.529,7,16,0.438,7,10,0.7,102,36,80,0.45,32,58,0.552,4,22,0.182,15,19,0.789,91,2014-12-25,WAS,NYK,2015,93.0
6169,6169,69,Home,W 102-98 ,240,42,83,0.506,37,65,0.569,5,18,0.278,13,24,0.542,102,36,99,0.364,25,70,0.357,11,29,0.379,15,20,0.75,98,2014-12-26,DAL,LAL,2015,103.5
6170,6170,70,@,L 102-106 ,240,41,103,0.398,38,88,0.432,3,15,0.2,17,24,0.708,102,39,95,0.411,36,76,0.474,3,19,0.158,25,32,0.781,106,2014-12-26,MIN,DEN,2015,107.5
6171,6171,71,@,W 102-94 ,240,38,83,0.458,30,63,0.476,8,20,0.4,18,24,0.75,102,36,86,0.419,28,62,0.452,8,24,0.333,14,18,0.778,94,2014-12-27,ORL,CHO,2015,98.0
6172,6172,72,Home,L 102-116 ,240,37,87,0.425,33,70,0.471,4,17,0.235,24,34,0.706,102,43,88,0.489,33,65,0.508,10,23,0.435,20,32,0.625,116,2014-12-28,DEN,TOR,2015,121.0
6173,6173,73,@,W 102-101 ,240,41,77,0.532,30,52,0.577,11,25,0.44,9,13,0.692,102,33,63,0.524,26,49,0.531,7,14,0.5,28,40,0.7,101,2014-12-29,ORL,MIA,2015,104.5
6174,6174,74,Home,W 102-97 (OT),265,38,95,0.4,26,59,0.441,12,36,0.333,14,18,0.778,102,40,99,0.404,36,77,0.468,4,22,0.182,13,15,0.867,97,2014-12-30,POR,TOR,2015,99.0
6175,6175,75,Home,W 102-83 ,240,38,88,0.432,21,45,0.467,17,43,0.395,9,14,0.643,102,29,76,0.382,26,58,0.448,3,18,0.167,22,26,0.846,83,2014-12-31,HOU,CHO,2015,84.5
6176,6176,76,@,L 102-109 ,240,39,84,0.464,28,63,0.444,11,21,0.524,13,15,0.867,102,44,83,0.53,36,64,0.563,8,19,0.421,13,19,0.684,109,2015-01-02,WAS,OKC,2015,113.0
6177,6177,77,@,W 102-96 ,240,37,81,0.457,30,56,0.536,7,25,0.28,21,27,0.778,102,37,88,0.42,34,68,0.5,3,20,0.15,19,22,0.864,96,2015-01-06,PHO,MIL,2015,97.5
6178,6178,78,@,L 102-117 ,240,37,81,0.457,31,55,0.564,6,26,0.231,22,23,0.957,102,45,91,0.495,33,63,0.524,12,28,0.429,15,20,0.75,117,2015-01-07,IND,GSW,2015,123.0
6179,6179,79,Home,W 102-86 ,240,41,86,0.477,33,71,0.465,8,15,0.533,12,19,0.632,102,32,83,0.386,22,57,0.386,10,26,0.385,12,19,0.632,86,2015-01-09,WAS,CHI,2015,91.0
6180,6180,80,Home,L 102-109 ,240,39,76,0.513,31,52,0.596,8,24,0.333,16,23,0.696,102,37,78,0.474,28,48,0.583,9,30,0.3,26,36,0.722,109,2015-01-15,LAL,CLE,2015,113.5
6181,6181,81,@,W 102-80 ,240,37,81,0.457,33,69,0.478,4,12,0.333,24,31,0.774,102,31,73,0.425,27,56,0.482,4,17,0.235,14,16,0.875,80,2015-01-16,BRK,WAS,2015,82.0
6182,6182,82,Home,W 102-98 ,240,39,77,0.506,31,62,0.5,8,15,0.533,16,24,0.667,102,36,93,0.387,23,57,0.404,13,36,0.361,13,15,0.867,98,2015-01-17,MEM,POR,2015,104.5
6183,6183,83,Home,W 102-93 ,240,39,82,0.476,30,61,0.492,9,21,0.429,15,19,0.789,102,33,84,0.393,21,55,0.382,12,29,0.414,15,21,0.714,93,2015-01-19,LAC,BOS,2015,99.0
6184,6184,84,@,W 102-98 ,240,38,78,0.487,29,62,0.468,9,16,0.563,17,20,0.85,102,37,82,0.451,31,64,0.484,6,18,0.333,18,18,1.0,98,2015-01-23,CHI,DAL,2015,101.0
6185,6185,85,Home,W 102-98 ,240,38,80,0.475,31,61,0.508,7,19,0.368,19,22,0.864,102,40,83,0.482,32,62,0.516,8,21,0.381,10,15,0.667,98,2015-01-26,LAC,DEN,2015,102.0
6186,6186,86,Home,L 102-109 ,240,38,75,0.507,31,55,0.564,7,20,0.35,19,26,0.731,102,39,71,0.549,30,55,0.545,9,16,0.563,22,30,0.733,109,2015-01-27,MIA,MIL,2015,113.5
6187,6187,87,@,L 102-113 ,240,39,87,0.448,30,63,0.476,9,24,0.375,15,18,0.833,102,38,82,0.463,26,49,0.531,12,33,0.364,25,26,0.962,113,2015-01-28,BRK,ATL,2015,119.0
6188,6188,88,@,L 102-119 ,240,35,73,0.479,28,56,0.5,7,17,0.412,25,29,0.862,102,43,84,0.512,26,50,0.52,17,34,0.5,16,19,0.842,119,2015-01-28,SAC,TOR,2015,127.5
6189,6189,89,Home,W 102-100 ,240,41,83,0.494,29,56,0.518,12,27,0.444,8,18,0.444,102,42,89,0.472,34,66,0.515,8,23,0.348,8,25,0.32,100,2015-02-02,BRK,LAC,2015,104.0
6190,6190,90,@,W 102-101 ,240,36,83,0.434,33,72,0.458,3,11,0.273,27,34,0.794,102,42,84,0.5,36,68,0.529,6,16,0.375,11,18,0.611,101,2015-02-02,MEM,PHO,2015,104.0
6191,6191,91,@,L 102-103 ,240,39,85,0.459,33,72,0.458,6,13,0.462,18,26,0.692,102,36,76,0.474,29,53,0.547,7,23,0.304,24,34,0.706,103,2015-02-03,UTA,POR,2015,106.5
6192,6192,92,Home,W 102-101 ,240,37,72,0.514,31,61,0.508,6,11,0.545,22,27,0.815,102,39,80,0.488,32,64,0.5,7,16,0.438,16,24,0.667,101,2015-02-04,MIN,MIA,2015,104.5
6193,6193,93,@,W 102-91 ,240,45,85,0.529,40,70,0.571,5,15,0.333,7,11,0.636,102,37,97,0.381,30,72,0.417,7,25,0.28,10,13,0.769,91,2015-02-04,OKC,NOP,2015,94.5
6194,6194,94,Home,W 102-90 ,240,43,86,0.5,38,67,0.567,5,19,0.263,11,17,0.647,102,32,82,0.39,29,69,0.42,3,13,0.231,23,33,0.697,90,2015-02-07,UTA,SAC,2015,91.5
6195,6195,95,Home,L 102-103 ,240,36,77,0.468,28,63,0.444,8,14,0.571,22,28,0.786,102,37,84,0.44,30,65,0.462,7,19,0.368,22,25,0.88,103,2015-02-08,CHA,IND,2015,106.5
6196,6196,96,Home,W 102-86 ,240,35,86,0.407,25,56,0.446,10,30,0.333,22,23,0.957,102,34,93,0.366,27,77,0.351,7,16,0.438,11,11,1.0,86,2015-02-11,POR,LAL,2015,89.5
6197,6197,97,@,L 102-113 ,240,31,93,0.333,26,75,0.347,5,18,0.278,35,39,0.897,102,39,94,0.415,27,56,0.482,12,38,0.316,23,34,0.676,113,2015-02-23,MIN,HOU,2015,119.0
6198,6198,98,@,W 102-93 ,240,34,77,0.442,20,40,0.5,14,37,0.378,20,24,0.833,102,33,82,0.402,24,58,0.414,9,24,0.375,18,30,0.6,93,2015-02-24,CLE,DET,2015,97.5
6199,6199,99,Home,W 102-96 ,240,38,74,0.514,27,49,0.551,11,25,0.44,15,19,0.789,102,39,92,0.424,32,71,0.451,7,21,0.333,11,15,0.733,96,2015-02-25,NOP,BRK,2015,99.5
6200,6200,0,Home,W 102-90 ,240,39,80,0.488,33,64,0.516,6,16,0.375,18,25,0.72,102,34,84,0.405,30,68,0.441,4,16,0.25,18,23,0.783,90,2015-02-25,SAC,MEM,2015,92.0
6201,6201,1,Home,W 102-98 ,240,39,84,0.464,30,52,0.577,9,32,0.281,15,17,0.882,102,38,85,0.447,34,68,0.5,4,17,0.235,18,20,0.9,98,2015-02-27,HOU,BRK,2015,100.0
6202,6202,2,@,L 102-104 ,240,41,84,0.488,33,63,0.524,8,21,0.381,12,16,0.75,102,39,76,0.513,33,60,0.55,6,16,0.375,20,27,0.741,104,2015-02-27,MIA,NOP,2015,107.0
6203,6203,3,Home,W 102-93 ,240,38,79,0.481,32,63,0.508,6,16,0.375,20,22,0.909,102,35,74,0.473,25,53,0.472,10,21,0.476,13,16,0.813,93,2015-03-02,DAL,NOP,2015,98.0
6204,6204,4,Home,W 102-93 ,240,37,73,0.507,23,39,0.59,14,34,0.412,14,25,0.56,102,34,80,0.425,29,66,0.439,5,14,0.357,20,25,0.8,93,2015-03-04,GSW,MIL,2015,95.5
6205,6205,5,@,W 102-100 ,240,42,83,0.506,38,67,0.567,4,16,0.25,14,17,0.824,102,42,86,0.488,31,58,0.534,11,28,0.393,5,5,1.0,100,2015-03-04,MEM,HOU,2015,105.5
6206,6206,6,@,L 102-115 ,240,34,81,0.42,25,54,0.463,9,27,0.333,25,27,0.926,102,42,84,0.5,29,53,0.547,13,31,0.419,18,20,0.9,115,2015-03-11,ATL,DEN,2015,121.5
6207,6207,7,Home,W 102-92 ,240,34,79,0.43,22,46,0.478,12,33,0.364,22,31,0.71,102,35,79,0.443,30,56,0.536,5,23,0.217,17,24,0.708,92,2015-03-13,TOR,MIA,2015,94.5
6208,6208,8,Home,W 102-89 ,240,41,83,0.494,35,65,0.538,6,18,0.333,14,23,0.609,102,32,73,0.438,27,59,0.458,5,14,0.357,20,30,0.667,89,2015-03-15,PHO,NYK,2015,91.5
6209,6209,9,@,L 102-107 ,240,40,87,0.46,31,59,0.525,9,28,0.321,13,14,0.929,102,39,80,0.488,26,49,0.531,13,31,0.419,16,24,0.667,107,2015-03-18,ORL,DAL,2015,113.5
6210,6210,10,Home,L 102-117 ,240,41,87,0.471,31,53,0.585,10,34,0.294,10,12,0.833,102,46,92,0.5,38,77,0.494,8,15,0.533,17,24,0.708,117,2015-03-21,HOU,PHO,2015,121.0
6211,6211,11,Home,W 102-88 ,240,43,84,0.512,34,64,0.531,9,20,0.45,7,12,0.583,102,35,79,0.443,28,64,0.438,7,15,0.467,11,18,0.611,88,2015-03-27,NOP,SAC,2015,91.5
6212,6212,12,@,L 102-109 ,240,40,83,0.482,32,58,0.552,8,25,0.32,14,22,0.636,102,39,82,0.476,32,64,0.5,7,18,0.389,24,29,0.828,109,2015-03-29,DET,MIA,2015,112.5
6213,6213,13,Home,W 102-78 ,240,38,90,0.422,29,68,0.426,9,22,0.409,17,24,0.708,102,31,88,0.352,26,66,0.394,5,22,0.227,11,18,0.611,78,2015-04-01,CHA,DET,2015,80.5
6214,6214,14,@,W 102-86 ,240,38,77,0.494,34,55,0.618,4,22,0.182,22,27,0.815,102,29,84,0.345,22,67,0.328,7,17,0.412,21,26,0.808,86,2015-04-08,IND,NYK,2015,89.5
6215,6215,15,Home,W 102-92 ,240,35,72,0.486,31,56,0.554,4,16,0.25,28,36,0.778,102,40,96,0.417,36,81,0.444,4,15,0.267,8,13,0.615,92,2015-04-13,SAC,LAL,2015,94.0
6216,6216,16,Home,W 102-92 ,240,39,86,0.453,33,61,0.541,6,25,0.24,18,21,0.857,102,33,77,0.429,27,56,0.482,6,21,0.286,20,22,0.909,92,2015-10-30,CLE,MIA,2016,95.0
6217,6217,17,Home,W 102-75 ,240,40,86,0.465,31,64,0.484,9,22,0.409,13,13,1.0,102,31,77,0.403,26,61,0.426,5,16,0.313,8,15,0.533,75,2015-10-30,SAS,BRK,2016,77.5
6218,6218,18,Home,W 102-96 ,240,37,81,0.457,29,55,0.527,8,26,0.308,20,23,0.87,102,36,98,0.367,27,68,0.397,9,30,0.3,15,21,0.714,96,2015-11-02,LAC,PHO,2016,100.5
6219,6219,19,@,W 102-91 ,240,37,82,0.451,32,65,0.492,5,17,0.294,23,26,0.885,102,33,86,0.384,26,63,0.413,7,23,0.304,18,25,0.72,91,2015-11-03,TOR,DAL,2016,94.5
6220,6220,20,Home,W 102-99 ,240,42,87,0.483,34,64,0.531,8,23,0.348,10,14,0.714,102,37,81,0.457,30,59,0.508,7,22,0.318,18,20,0.9,99,2015-11-04,WAS,SAS,2016,102.5
6221,6221,21,@,L 102-108 ,240,41,79,0.519,31,56,0.554,10,23,0.435,10,15,0.667,102,45,88,0.511,35,62,0.565,10,26,0.385,8,12,0.667,108,2015-11-06,PHI,CLE,2016,113.0
6222,6222,22,@,W 102-93 (OT),265,39,96,0.406,32,80,0.4,7,16,0.438,17,27,0.63,102,33,93,0.355,22,61,0.361,11,32,0.344,16,23,0.696,93,2015-11-07,MIN,CHI,2016,98.5
6223,6223,23,@,W 102-91 ,240,38,79,0.481,32,62,0.516,6,17,0.353,20,31,0.645,102,32,77,0.416,28,53,0.528,4,24,0.167,23,32,0.719,91,2015-11-11,IND,BOS,2016,93.0
6224,6224,24,@,L 102-103 ,240,42,79,0.532,32,57,0.561,10,22,0.455,8,9,0.889,102,39,79,0.494,31,55,0.564,8,24,0.333,17,24,0.708,103,2015-11-11,MIL,DEN,2016,107.0
6225,6225,25,Home,W 102-97 ,240,37,84,0.44,33,68,0.485,4,16,0.25,24,31,0.774,102,36,95,0.379,21,62,0.339,15,33,0.455,10,12,0.833,97,2015-11-13,CHI,CHO,2016,104.5
6226,6226,26,Home,W 102-85 ,240,39,97,0.402,31,72,0.431,8,25,0.32,16,21,0.762,102,30,86,0.349,25,69,0.362,5,17,0.294,20,28,0.714,85,2015-11-13,OKC,PHI,2016,87.5
6227,6227,27,Home,W 102-93 ,240,32,76,0.421,22,49,0.449,10,27,0.37,28,31,0.903,102,34,87,0.391,26,62,0.419,8,25,0.32,17,23,0.739,93,2015-11-13,ORL,UTA,2016,97.0
6228,6228,28,Home,W 102-94 ,240,36,89,0.404,26,69,0.377,10,20,0.5,20,21,0.952,102,36,82,0.439,31,62,0.5,5,20,0.25,17,25,0.68,94,2015-11-17,NYK,CHO,2016,96.5
6229,6229,29,Home,L 102-106 ,240,38,92,0.413,30,66,0.455,8,26,0.308,18,24,0.75,102,37,72,0.514,30,52,0.577,7,20,0.35,25,35,0.714,106,2015-11-18,BOS,DAL,2016,109.5
6230,6230,30,Home,W 102-93 ,240,39,83,0.47,31,55,0.564,8,28,0.286,16,17,0.941,102,35,80,0.438,29,60,0.483,6,20,0.3,17,21,0.81,93,2015-11-20,DAL,UTA,2016,96.0
6231,6231,31,@,W 102-91 ,240,34,78,0.436,19,45,0.422,15,33,0.455,19,24,0.792,102,35,77,0.455,27,52,0.519,8,25,0.32,13,17,0.765,91,2015-11-20,TOR,LAL,2016,95.0
6232,6232,32,Home,W 102-91 ,240,38,90,0.422,30,65,0.462,8,25,0.32,18,24,0.75,102,38,86,0.442,31,62,0.5,7,24,0.292,8,16,0.5,91,2015-11-20,POR,LAC,2016,94.5
6233,6233,33,Home,L 102-107 ,240,35,81,0.432,23,53,0.434,12,28,0.429,20,28,0.714,102,34,80,0.425,22,55,0.4,12,25,0.48,27,34,0.794,107,2015-11-21,HOU,NYK,2016,113.0
6234,6234,34,@,W 102-93 ,240,39,80,0.488,36,64,0.563,3,16,0.188,21,23,0.913,102,30,71,0.423,20,37,0.541,10,34,0.294,23,27,0.852,93,2015-11-25,MEM,HOU,2016,98.0
6235,6235,35,@,W 102-91 ,240,39,77,0.506,33,64,0.516,6,13,0.462,18,25,0.72,102,38,75,0.507,34,63,0.54,4,12,0.333,11,17,0.647,91,2015-11-25,UTA,LAC,2016,93.0
6236,6236,36,Home,L 102-107 ,240,38,86,0.442,26,57,0.456,12,29,0.414,14,17,0.824,102,40,94,0.426,29,67,0.433,11,27,0.407,16,20,0.8,107,2015-11-29,TOR,PHO,2016,112.5
6237,6237,37,Home,W 102-87 ,240,33,85,0.388,25,66,0.379,8,19,0.421,28,56,0.5,102,33,87,0.379,28,64,0.438,5,23,0.217,16,27,0.593,87,2015-11-30,LAC,POR,2016,89.5
6238,6238,38,Home,W 102-95 ,240,34,82,0.415,27,59,0.458,7,23,0.304,27,39,0.692,102,39,87,0.448,35,69,0.507,4,18,0.222,13,14,0.929,95,2015-12-04,DET,MIL,2016,97.0
6239,6239,39,@,W 102-96 ,240,37,89,0.416,27,55,0.491,10,34,0.294,18,25,0.72,102,37,89,0.416,28,64,0.438,9,25,0.36,13,19,0.684,96,2015-12-05,CHA,CHI,2016,100.5
6240,6240,40,Home,W 102-93 ,240,34,74,0.459,25,49,0.51,9,25,0.36,25,32,0.781,102,34,83,0.41,27,64,0.422,7,19,0.368,18,20,0.9,93,2015-12-07,TOR,LAL,2016,96.5
6241,6241,41,@,L 102-107 ,240,42,101,0.416,38,80,0.475,4,21,0.19,14,14,1.0,102,37,85,0.435,29,64,0.453,8,21,0.381,25,30,0.833,107,2015-12-16,MIN,NYK,2016,111.0
6242,6242,42,Home,W 102-94 ,240,39,84,0.464,37,69,0.536,2,15,0.133,22,31,0.71,102,32,73,0.438,21,41,0.512,11,32,0.344,19,26,0.731,94,2015-12-18,ORL,POR,2016,99.5
6243,6243,43,Home,L 102-105 ,240,43,95,0.453,34,69,0.493,9,26,0.346,7,13,0.538,102,43,94,0.457,36,74,0.486,7,20,0.35,12,14,0.857,105,2015-12-21,CHI,BRK,2016,108.5
6244,6244,44,Home,W 102-95 ,240,33,71,0.465,26,43,0.605,7,28,0.25,29,41,0.707,102,29,83,0.349,17,42,0.405,12,41,0.293,25,31,0.806,95,2015-12-21,HOU,CHO,2016,101.0
6245,6245,45,@,W 102-89 ,240,36,85,0.424,29,56,0.518,7,29,0.241,23,26,0.885,102,29,81,0.358,21,53,0.396,8,28,0.286,23,32,0.719,89,2015-12-23,BOS,CHO,2016,93.0
6246,6246,46,@,W 102-88 ,240,40,80,0.5,31,54,0.574,9,26,0.346,13,14,0.929,102,35,75,0.467,31,63,0.492,4,12,0.333,14,18,0.778,88,2015-12-26,IND,MIN,2016,90.0
6247,6247,47,Home,W 102-100 (OT),265,37,86,0.43,31,68,0.456,6,18,0.333,22,27,0.815,102,37,97,0.381,30,75,0.4,7,22,0.318,19,24,0.792,100,2015-12-30,CHI,IND,2016,103.5
6248,6248,48,@,L 102-111 ,240,38,87,0.437,27,59,0.458,11,28,0.393,15,22,0.682,102,41,84,0.488,22,51,0.431,19,33,0.576,10,13,0.769,111,2016-01-06,CHA,PHO,2016,120.5
6249,6249,49,@,L 102-115 ,240,36,80,0.45,30,55,0.545,6,25,0.24,24,36,0.667,102,42,83,0.506,29,55,0.527,13,28,0.464,18,24,0.75,115,2016-01-21,LAC,CLE,2016,121.5
6250,6250,50,@,W 102-101 ,240,36,72,0.5,30,51,0.588,6,21,0.286,24,29,0.828,102,36,80,0.45,27,50,0.54,9,30,0.3,20,26,0.769,101,2016-01-21,MEM,DEN,2016,105.5
6251,6251,51,Home,W 102-98 ,240,38,94,0.404,23,50,0.46,15,44,0.341,11,16,0.688,102,39,85,0.459,36,71,0.507,3,14,0.214,17,22,0.773,98,2016-01-22,HOU,MIL,2016,99.5
6252,6252,52,@,L 102-108 (OT),265,40,86,0.465,30,58,0.517,10,28,0.357,12,14,0.857,102,43,100,0.43,37,82,0.451,6,18,0.333,16,25,0.64,108,2016-01-25,ORL,MEM,2016,111.0
6253,6253,53,@,W 102-98 ,240,45,83,0.542,42,74,0.568,3,9,0.333,9,10,0.9,102,36,71,0.507,27,53,0.509,9,18,0.5,17,23,0.739,98,2016-01-26,MIA,BRK,2016,102.5
6254,6254,54,Home,W 102-73 ,240,40,81,0.494,28,50,0.56,12,31,0.387,10,15,0.667,102,25,68,0.368,19,43,0.442,6,25,0.24,17,21,0.81,73,2016-01-27,UTA,CHO,2016,76.0
6255,6255,55,Home,W 102-84 ,240,36,84,0.429,29,64,0.453,7,20,0.35,23,26,0.885,102,35,85,0.412,28,59,0.475,7,26,0.269,7,12,0.583,84,2016-01-29,NYK,PHO,2016,87.5
6256,6256,56,@,L 102-115 ,240,38,85,0.447,32,68,0.471,6,17,0.353,20,27,0.741,102,44,84,0.524,28,49,0.571,16,35,0.457,11,16,0.688,115,2016-02-02,MIA,HOU,2016,123.0
6257,6257,57,Home,W 102-95 ,240,42,96,0.438,35,75,0.467,7,21,0.333,11,13,0.846,102,32,85,0.376,21,51,0.412,11,34,0.324,20,28,0.714,95,2016-02-03,BOS,DET,2016,100.5
6258,6258,58,Home,L 102-108 ,240,33,75,0.44,22,43,0.512,11,32,0.344,25,34,0.735,102,39,77,0.506,31,60,0.517,8,17,0.471,22,26,0.846,108,2016-02-03,LAC,MIN,2016,112.0
6259,6259,59,Home,L 102-107 ,240,42,88,0.477,36,68,0.529,6,20,0.3,12,19,0.632,102,40,88,0.455,29,67,0.433,11,21,0.524,16,21,0.762,107,2016-02-03,SAC,CHI,2016,112.5
6260,6260,60,Home,W 102-96 ,240,39,76,0.513,29,49,0.592,10,27,0.37,14,20,0.7,102,38,91,0.418,25,60,0.417,13,31,0.419,7,9,0.778,96,2016-02-05,ATL,IND,2016,102.5
6261,6261,61,@,L 102-106 ,240,34,86,0.395,24,56,0.429,10,30,0.333,24,27,0.889,102,39,88,0.443,31,64,0.484,8,24,0.333,20,25,0.8,106,2016-02-06,LAL,SAS,2016,110.0
6262,6262,62,Home,L 102-116 ,240,36,81,0.444,34,69,0.493,2,12,0.167,28,35,0.8,102,47,97,0.485,37,73,0.507,10,24,0.417,12,20,0.6,116,2016-02-08,MIN,NOP,2016,121.0
6263,6263,63,Home,L 102-105 ,240,38,91,0.418,31,66,0.47,7,25,0.28,19,29,0.655,102,41,82,0.5,32,58,0.552,9,24,0.375,14,21,0.667,105,2016-02-21,ORL,IND,2016,109.5
6264,6264,64,@,W 102-92 ,240,39,89,0.438,25,44,0.568,14,45,0.311,10,12,0.833,102,36,86,0.419,26,52,0.5,10,34,0.294,10,16,0.625,92,2016-02-22,GSW,ATL,2016,97.0
6265,6265,65,@,W 102-91 ,240,37,88,0.42,25,58,0.431,12,30,0.4,16,24,0.667,102,38,78,0.487,31,66,0.47,7,12,0.583,8,12,0.667,91,2016-02-27,DET,MIL,2016,94.5
6266,6266,66,Home,L 102-111 ,240,40,93,0.43,37,79,0.468,3,14,0.214,19,25,0.76,102,41,81,0.506,27,57,0.474,14,24,0.583,15,21,0.714,111,2016-02-28,IND,POR,2016,118.0
6267,6267,67,Home,W 102-89 ,240,39,97,0.402,32,76,0.421,7,21,0.333,17,22,0.773,102,38,99,0.384,32,80,0.4,6,19,0.316,7,11,0.636,89,2016-03-02,ORL,CHI,2016,92.0
6268,6268,68,@,W 102-84 ,240,35,78,0.449,30,64,0.469,5,14,0.357,27,39,0.692,102,35,101,0.347,28,74,0.378,7,27,0.259,7,14,0.5,84,2016-03-04,PHO,ORL,2016,87.5
6269,6269,69,Home,L 102-112 ,240,36,95,0.379,27,64,0.422,9,31,0.29,21,27,0.778,102,39,88,0.443,34,72,0.472,5,16,0.313,29,36,0.806,112,2016-03-04,PHI,MIA,2016,114.5
6270,6270,70,Home,W 102-89 ,240,42,79,0.532,38,63,0.603,4,16,0.25,14,18,0.778,102,36,92,0.391,30,66,0.455,6,26,0.231,11,15,0.733,89,2016-03-05,NYK,DET,2016,92.0
6271,6271,71,@,W 102-96 ,240,38,85,0.447,29,58,0.5,9,27,0.333,17,30,0.567,102,39,86,0.453,30,56,0.536,9,30,0.3,9,11,0.818,96,2016-03-09,DET,DAL,2016,100.5
6272,6272,72,@,W 102-98 ,240,40,88,0.455,35,62,0.565,5,26,0.192,17,25,0.68,102,34,91,0.374,26,60,0.433,8,31,0.258,22,28,0.786,98,2016-03-11,HOU,BOS,2016,102.0
6273,6273,73,@,L 102-118 ,240,40,86,0.465,34,65,0.523,6,21,0.286,16,20,0.8,102,46,94,0.489,35,70,0.5,11,24,0.458,15,15,1.0,118,2016-03-17,BRK,CHI,2016,123.5
6274,6274,74,@,L 102-113 ,240,31,66,0.47,19,36,0.528,12,30,0.4,28,39,0.718,102,40,82,0.488,36,67,0.537,4,15,0.267,29,36,0.806,113,2016-03-19,LAC,MEM,2016,115.0
6275,6275,75,Home,L 102-117 ,240,38,78,0.487,25,45,0.556,13,33,0.394,13,17,0.765,102,46,91,0.505,33,66,0.5,13,25,0.52,12,20,0.6,117,2016-03-21,ATL,WAS,2016,123.5
6276,6276,76,@,L 102-109 ,240,40,88,0.455,31,59,0.525,9,29,0.31,13,16,0.813,102,41,91,0.451,29,67,0.433,12,24,0.5,15,23,0.652,109,2016-03-21,SAC,CHI,2016,115.0
6277,6277,77,@,L 102-118 ,240,39,98,0.398,31,73,0.425,8,25,0.32,16,19,0.842,102,43,80,0.538,32,56,0.571,11,24,0.458,21,25,0.84,118,2016-03-23,ORL,DET,2016,123.5
6278,6278,78,@,W 102-99 ,240,35,84,0.417,27,55,0.491,8,29,0.276,24,27,0.889,102,37,85,0.435,30,54,0.556,7,31,0.226,18,21,0.857,99,2016-03-26,BOS,PHO,2016,102.5
6279,6279,79,@,W 102-100 ,240,36,85,0.424,31,63,0.492,5,22,0.227,25,28,0.893,102,40,106,0.377,31,84,0.369,9,22,0.409,11,15,0.733,100,2016-03-28,ATL,CHI,2016,104.5
6280,6280,80,Home,W 102-94 ,240,38,87,0.437,27,62,0.435,11,25,0.44,15,23,0.652,102,36,86,0.419,31,63,0.492,5,23,0.217,17,27,0.63,94,2016-03-29,GSW,WAS,2016,96.5
6281,6281,81,Home,W 102-100 (OT),265,37,102,0.363,31,82,0.378,6,20,0.3,22,29,0.759,102,41,86,0.477,38,69,0.551,3,17,0.176,15,26,0.577,100,2016-03-30,LAL,MIA,2016,101.5
6282,6282,82,Home,L 102-115 ,240,34,83,0.41,18,46,0.391,16,37,0.432,18,26,0.692,102,44,84,0.524,36,61,0.59,8,23,0.348,19,23,0.826,115,2016-04-02,PHI,IND,2016,119.0
6283,6283,83,Home,W 102-95 ,240,35,77,0.455,30,57,0.526,5,20,0.25,27,30,0.9,102,40,80,0.5,34,62,0.548,6,18,0.333,9,10,0.9,95,2016-04-02,SAS,TOR,2016,98.0
6284,6284,84,@,W 102-98 ,240,39,74,0.527,32,48,0.667,7,26,0.269,17,22,0.773,102,40,85,0.471,38,78,0.487,2,7,0.286,16,20,0.8,98,2016-04-03,CHI,MIL,2016,99.0
6285,6285,85,Home,L 102-124 ,240,37,88,0.42,27,58,0.466,10,30,0.333,18,27,0.667,102,46,87,0.529,31,54,0.574,15,33,0.455,17,24,0.708,124,2016-04-05,DEN,OKC,2016,131.5
6286,6286,86,Home,W 102-98 ,240,40,86,0.465,34,64,0.531,6,22,0.273,16,19,0.842,102,36,85,0.424,33,71,0.465,3,14,0.214,23,28,0.821,98,2016-04-08,DEN,SAS,2016,99.5
6287,6287,87,@,L 102-110 ,240,34,81,0.42,23,57,0.404,11,24,0.458,23,27,0.852,102,42,79,0.532,32,57,0.561,10,22,0.455,16,21,0.762,110,2016-04-08,LAL,NOP,2016,115.0
6288,6288,88,Home,L 102-109 ,240,32,91,0.352,18,54,0.333,14,37,0.378,24,36,0.667,102,43,91,0.473,39,75,0.52,4,16,0.25,19,30,0.633,109,2016-04-08,PHI,NYK,2016,111.0
6289,6289,89,@,W 102-99 (OT),265,37,83,0.446,24,54,0.444,13,29,0.448,15,19,0.789,102,36,82,0.439,25,51,0.49,11,31,0.355,16,23,0.696,99,2016-04-08,LAC,UTA,2016,104.5
6290,6290,90,@,L 102-105 ,240,36,83,0.434,17,43,0.395,19,40,0.475,11,18,0.611,102,40,89,0.449,32,65,0.492,8,24,0.333,17,21,0.81,105,2016-04-09,CLE,CHI,2016,109.0
6291,6291,91,Home,W 102-90 ,240,41,80,0.513,35,61,0.574,6,19,0.316,14,20,0.7,102,36,80,0.45,26,53,0.491,10,27,0.37,8,9,0.889,90,2016-04-12,IND,NYK,2016,95.0
6292,6292,92,Home,W 102-98 (OT),265,37,87,0.425,33,73,0.452,4,14,0.286,24,32,0.75,102,35,87,0.402,29,62,0.468,6,25,0.24,22,25,0.88,98,2016-04-12,SAS,OKC,2016,101.0
6293,6293,93,Home,W 102-98 ,240,36,80,0.45,25,56,0.446,11,24,0.458,19,27,0.704,102,36,86,0.419,30,68,0.441,6,18,0.333,20,29,0.69,98,2016-10-26,MEM,MIN,2017,101.0
6294,6294,94,Home,L 102-107 ,240,38,92,0.413,35,73,0.479,3,19,0.158,23,26,0.885,102,37,83,0.446,29,59,0.492,8,24,0.333,25,33,0.758,107,2016-10-26,NOP,DEN,2017,111.0
6295,6295,95,@,W 102-94 ,240,36,79,0.456,30,61,0.492,6,18,0.333,24,27,0.889,102,28,70,0.4,22,50,0.44,6,20,0.3,32,38,0.842,94,2016-10-27,SAS,SAC,2017,97.0
6296,6296,96,@,L 102-105 ,240,33,81,0.407,24,59,0.407,9,22,0.409,27,35,0.771,102,41,88,0.466,37,72,0.514,4,16,0.25,19,25,0.76,105,2016-10-31,DEN,TOR,2017,107.0
6297,6297,97,Home,W 102-89 ,240,41,89,0.461,33,76,0.434,8,13,0.615,12,21,0.571,102,35,86,0.407,28,64,0.438,7,22,0.318,12,15,0.8,89,2016-11-01,DET,NYK,2017,92.5
6298,6298,98,@,W 102-99 ,240,39,81,0.481,33,59,0.559,6,22,0.273,18,25,0.72,102,35,88,0.398,26,66,0.394,9,22,0.409,20,25,0.8,99,2016-11-03,DEN,MIN,2017,103.5
6299,6299,99,Home,W 102-94 ,240,38,84,0.452,28,54,0.519,10,30,0.333,16,23,0.696,102,38,80,0.475,31,62,0.5,7,18,0.389,11,17,0.647,94,2016-11-03,ORL,SAC,2017,97.5
6300,6300,0,@,W 102-101 ,240,37,91,0.407,23,53,0.434,14,38,0.368,14,18,0.778,102,40,87,0.46,26,49,0.531,14,38,0.368,7,12,0.583,101,2016-11-05,CLE,PHI,2017,108.0
6301,6301,1,Home,W 102-94 ,240,39,81,0.481,31,56,0.554,8,25,0.32,16,20,0.8,102,38,84,0.452,33,63,0.524,5,21,0.238,13,18,0.722,94,2016-11-08,SAC,NOP,2017,96.5
6302,6302,2,Home,L 102-112 ,240,31,74,0.419,19,40,0.475,12,34,0.353,28,31,0.903,102,43,83,0.518,32,57,0.561,11,26,0.423,15,22,0.682,112,2016-11-09,OKC,TOR,2017,117.5
6303,6303,3,@,W 102-91 ,240,40,81,0.494,34,61,0.557,6,20,0.3,16,19,0.842,102,38,81,0.469,33,64,0.516,5,17,0.294,10,19,0.526,91,2016-11-12,UTA,MIA,2017,93.5
6304,6304,4,@,W 102-96 ,240,36,76,0.474,28,55,0.509,8,21,0.381,22,26,0.846,102,35,73,0.479,27,45,0.6,8,28,0.286,18,22,0.818,96,2016-11-14,MEM,UTA,2017,100.0
6305,6305,5,@,L 102-105 ,240,42,85,0.494,34,62,0.548,8,23,0.348,10,12,0.833,102,42,93,0.452,33,68,0.485,9,25,0.36,12,19,0.632,105,2016-11-16,DET,NYK,2017,109.5
6306,6306,6,@,L 102-109 ,240,38,91,0.418,30,68,0.441,8,23,0.348,18,25,0.72,102,42,77,0.545,32,49,0.653,10,28,0.357,15,22,0.682,109,2016-11-16,WAS,PHI,2017,114.0
6307,6307,7,@,L 102-111 ,240,39,76,0.513,27,49,0.551,12,27,0.444,12,17,0.706,102,42,94,0.447,30,62,0.484,12,32,0.375,15,20,0.75,111,2016-11-19,UTA,HOU,2017,117.0
6308,6308,8,Home,W 102-95 ,240,36,77,0.468,25,50,0.5,11,27,0.407,19,23,0.826,102,33,77,0.429,24,47,0.511,9,30,0.3,20,24,0.833,95,2016-11-19,LAC,CHI,2017,99.5
6309,6309,9,Home,W 102-99 ,240,36,81,0.444,25,54,0.463,11,27,0.407,19,25,0.76,102,34,85,0.4,25,61,0.41,9,24,0.375,22,24,0.917,99,2016-11-20,SAC,TOR,2017,103.5
6310,6310,10,Home,L 102-115 ,240,38,78,0.487,24,36,0.667,14,42,0.333,12,12,1.0,102,43,88,0.489,31,65,0.477,12,23,0.522,17,21,0.81,115,2016-11-23,HOU,TOR,2017,121.0
6311,6311,11,@,L 102-107 ,240,37,98,0.378,25,66,0.379,12,32,0.375,16,20,0.8,102,35,80,0.438,27,58,0.466,8,22,0.364,29,42,0.69,107,2016-11-26,NYK,CHO,2017,111.0
6312,6312,12,@,L 102-115 ,240,41,89,0.461,31,54,0.574,10,35,0.286,10,12,0.833,102,45,81,0.556,34,59,0.576,11,22,0.5,14,17,0.824,115,2016-11-26,MIN,GSW,2017,120.5
6313,6313,13,Home,L 102-111 ,240,36,81,0.444,26,51,0.51,10,30,0.333,20,28,0.714,102,39,79,0.494,34,65,0.523,5,14,0.357,28,35,0.8,111,2016-12-04,LAC,IND,2017,113.5
6314,6314,14,@,W 102-99 ,240,37,80,0.463,27,49,0.551,10,31,0.323,18,28,0.643,102,34,77,0.442,27,55,0.491,7,22,0.318,24,32,0.75,99,2016-12-05,OKC,ATL,2017,102.5
6315,6315,15,Home,W 102-91 ,240,40,88,0.455,32,67,0.478,8,21,0.381,14,21,0.667,102,33,75,0.44,31,60,0.517,2,15,0.133,23,32,0.719,91,2016-12-06,DET,CHI,2017,92.0
6316,6316,16,@,W 102-99 ,240,36,92,0.391,25,50,0.5,11,42,0.262,19,30,0.633,102,34,81,0.42,27,53,0.509,7,28,0.25,24,31,0.774,99,2016-12-09,HOU,OKC,2017,102.5
6317,6317,17,Home,W 102-95 ,240,36,86,0.419,26,59,0.441,10,27,0.37,20,28,0.714,102,36,87,0.414,33,66,0.5,3,21,0.143,20,24,0.833,95,2016-12-15,NOP,IND,2017,96.5
6318,6318,18,@,W 102-98 ,240,36,83,0.434,29,58,0.5,7,25,0.28,23,29,0.793,102,38,93,0.409,32,66,0.485,6,27,0.222,16,25,0.64,98,2016-12-16,LAC,MIA,2017,101.0
6319,6319,19,@,W 102-100 ,240,36,77,0.468,24,54,0.444,12,23,0.522,18,25,0.72,102,35,92,0.38,29,54,0.537,6,38,0.158,24,27,0.889,100,2016-12-20,SAS,HOU,2017,103.0
6320,6320,20,@,L 102-119 ,240,39,90,0.433,28,51,0.549,11,39,0.282,13,20,0.65,102,47,86,0.547,31,50,0.62,16,36,0.444,9,13,0.692,119,2016-12-20,DEN,LAC,2017,127.0
6321,6321,21,@,L 102-113 ,240,36,77,0.468,27,55,0.491,9,22,0.409,21,29,0.724,102,43,87,0.494,28,60,0.467,15,27,0.556,12,19,0.632,113,2016-12-21,MIL,CLE,2017,120.5
6322,6322,22,Home,L 102-109 ,240,35,82,0.427,28,59,0.475,7,23,0.304,25,29,0.862,102,38,92,0.413,28,53,0.528,10,39,0.256,23,27,0.852,109,2016-12-22,IND,BOS,2017,114.0
6323,6323,23,@,L 102-111 ,240,37,85,0.435,27,56,0.482,10,29,0.345,18,22,0.818,102,40,84,0.476,32,59,0.542,8,25,0.32,23,30,0.767,111,2016-12-25,LAC,LAL,2017,115.0
6324,6324,24,Home,L 102-106 ,240,39,84,0.464,30,59,0.508,9,25,0.36,15,20,0.75,102,36,82,0.439,25,51,0.49,11,31,0.355,23,28,0.821,106,2016-12-26,LAC,DEN,2017,111.5
6325,6325,25,@,L 102-112 ,240,35,76,0.461,25,51,0.49,10,25,0.4,22,28,0.786,102,44,86,0.512,31,60,0.517,13,26,0.5,11,16,0.688,112,2016-12-26,MEM,ORL,2017,118.5
6326,6326,26,Home,W 102-100 ,240,39,87,0.448,32,62,0.516,7,25,0.28,17,21,0.81,102,39,79,0.494,30,54,0.556,9,25,0.36,13,18,0.722,100,2016-12-26,SAC,PHI,2017,104.5
6327,6327,27,@,L 102-107 ,240,40,85,0.471,34,64,0.531,6,21,0.286,16,23,0.696,102,40,79,0.506,28,50,0.56,12,29,0.414,15,20,0.75,107,2016-12-26,MIL,WAS,2017,113.0
6328,6328,28,@,W 102-100 ,240,38,75,0.507,29,49,0.592,9,26,0.346,17,24,0.708,102,39,83,0.47,35,67,0.522,4,16,0.25,18,22,0.818,100,2016-12-27,UTA,LAL,2017,102.0
6329,6329,29,Home,W 102-98 (OT),265,37,101,0.366,30,74,0.405,7,27,0.259,21,27,0.778,102,35,93,0.376,28,66,0.424,7,27,0.259,21,26,0.808,98,2016-12-28,ATL,NYK,2017,101.5
6330,6330,30,Home,W 102-98 ,240,40,87,0.46,30,58,0.517,10,29,0.345,12,21,0.571,102,37,94,0.394,26,57,0.456,11,37,0.297,13,18,0.722,98,2016-12-28,NOP,LAC,2017,103.5
6331,6331,31,Home,W 102-89 ,240,35,74,0.473,23,49,0.469,12,25,0.48,20,22,0.909,102,31,79,0.392,22,51,0.431,9,28,0.321,18,23,0.783,89,2016-12-28,POR,SAC,2017,93.5
6332,6332,32,@,L 102-116 ,240,30,77,0.39,20,46,0.435,10,31,0.323,32,35,0.914,102,42,82,0.512,25,49,0.51,17,33,0.515,15,28,0.536,116,2017-01-03,MEM,LAL,2017,124.5
6333,6333,33,Home,L 102-107 ,240,40,78,0.513,32,58,0.552,8,20,0.4,14,17,0.824,102,35,72,0.486,23,44,0.523,12,28,0.429,25,29,0.862,107,2017-01-04,SAC,MIA,2017,113.0
6334,6334,34,@,W 102-95 ,240,38,85,0.447,31,68,0.456,7,17,0.412,19,22,0.864,102,36,79,0.456,27,50,0.54,9,29,0.31,14,17,0.824,95,2017-01-05,PHO,DAL,2017,99.5
6335,6335,35,Home,W 102-85 ,240,36,89,0.404,23,55,0.418,13,34,0.382,17,20,0.85,102,30,75,0.4,26,54,0.481,4,21,0.19,21,25,0.84,85,2017-01-07,SAS,CHO,2017,87.0
6336,6336,36,Home,W 102-86 ,240,40,93,0.43,30,63,0.476,10,30,0.333,12,16,0.75,102,28,82,0.341,19,52,0.365,9,30,0.3,21,28,0.75,86,2017-01-11,POR,CLE,2017,90.5
6337,6337,37,Home,W 102-93 ,240,36,76,0.474,22,38,0.579,14,38,0.368,16,20,0.8,102,28,85,0.329,22,62,0.355,6,23,0.261,31,32,0.969,93,2017-01-13,PHI,CHO,2017,96.0
6338,6338,38,@,W 102-97 ,240,41,95,0.432,32,70,0.457,9,25,0.36,11,16,0.688,102,36,83,0.434,30,57,0.526,6,26,0.231,19,24,0.792,97,2017-01-15,DET,LAL,2017,100.0
6339,6339,39,Home,W 102-93 ,240,39,82,0.476,30,60,0.5,9,22,0.409,15,19,0.789,102,34,81,0.42,27,53,0.509,7,28,0.25,18,19,0.947,93,2017-01-20,ATL,CHI,2017,96.5
6340,6340,40,Home,W 102-99 ,240,34,83,0.41,28,66,0.424,6,17,0.353,28,33,0.848,102,37,84,0.44,28,58,0.483,9,26,0.346,16,21,0.762,99,2017-01-21,CHI,SAC,2017,103.5
6341,6341,41,@,L 102-105 ,240,41,88,0.466,33,58,0.569,8,30,0.267,12,20,0.6,102,38,86,0.442,25,56,0.446,13,30,0.433,16,27,0.593,105,2017-01-23,GSW,MIA,2017,111.5
6342,6342,42,Home,W 102-86 ,240,37,84,0.44,27,59,0.458,10,25,0.4,18,23,0.783,102,31,80,0.388,24,57,0.421,7,23,0.304,17,24,0.708,86,2017-01-27,TOR,MIL,2017,89.5
6343,6343,43,@,W 102-95 ,240,41,80,0.513,30,54,0.556,11,26,0.423,9,10,0.9,102,29,62,0.468,19,37,0.514,10,25,0.4,27,29,0.931,95,2017-01-28,MEM,UTA,2017,100.0
6344,6344,44,Home,W 102-86 ,240,38,89,0.427,32,68,0.471,6,21,0.286,20,27,0.741,102,30,88,0.341,21,63,0.333,9,25,0.36,17,23,0.739,86,2017-02-02,SAS,PHI,2017,90.5
6345,6345,45,@,L 102-114 ,240,40,83,0.482,37,64,0.578,3,19,0.158,19,22,0.864,102,38,80,0.475,25,54,0.463,13,26,0.5,25,33,0.758,114,2017-02-03,MEM,OKC,2017,120.5
6346,6346,46,Home,W 102-94 ,240,37,80,0.463,32,66,0.485,5,14,0.357,23,32,0.719,102,34,87,0.391,24,59,0.407,10,28,0.357,16,21,0.762,94,2017-02-03,ORL,TOR,2017,99.0
6347,6347,47,@,L 102-125 ,240,35,84,0.417,29,61,0.475,6,23,0.261,26,31,0.839,102,48,82,0.585,36,60,0.6,12,22,0.545,17,23,0.739,125,2017-02-04,PHI,MIA,2017,131.0
6348,6348,48,@,L 102-107 ,240,35,84,0.417,25,55,0.455,10,29,0.345,22,28,0.786,102,37,88,0.42,21,36,0.583,16,52,0.308,17,20,0.85,107,2017-02-05,LAC,BOS,2017,115.0
6349,6349,49,@,L 102-121 ,240,37,86,0.43,31,63,0.492,6,23,0.261,22,26,0.846,102,51,97,0.526,47,81,0.58,4,16,0.25,15,24,0.625,121,2017-02-08,LAL,DET,2017,123.0
6350,6350,50,Home,L 102-107 ,240,37,85,0.435,24,48,0.5,13,37,0.351,15,20,0.75,102,40,85,0.471,26,51,0.51,14,34,0.412,13,20,0.65,107,2017-02-11,CHA,LAC,2017,114.0
6351,6351,51,@,L 102-133 ,240,37,94,0.394,29,72,0.403,8,22,0.364,20,26,0.769,102,42,85,0.494,24,49,0.49,18,36,0.5,31,39,0.795,133,2017-02-11,PHO,HOU,2017,142.0
6352,6352,52,@,W 102-101 ,240,36,84,0.429,28,53,0.528,8,31,0.258,22,29,0.759,102,38,75,0.507,30,59,0.508,8,16,0.5,17,25,0.68,101,2017-02-12,DET,TOR,2017,105.0
6353,6353,53,Home,W 102-89 ,240,40,79,0.506,34,58,0.586,6,21,0.286,16,16,1.0,102,34,78,0.436,27,57,0.474,7,21,0.333,14,19,0.737,89,2017-02-13,MIL,DET,2017,92.5
6354,6354,54,Home,W 102-92 ,240,40,78,0.513,29,52,0.558,11,26,0.423,11,11,1.0,102,35,84,0.417,26,57,0.456,9,27,0.333,13,23,0.565,92,2017-02-24,IND,MEM,2017,96.5
6355,6355,55,@,W 102-92 ,240,34,72,0.472,23,48,0.479,11,24,0.458,23,32,0.719,102,37,87,0.425,29,65,0.446,8,22,0.364,10,13,0.769,92,2017-02-26,UTA,WAS,2017,96.0
6356,6356,56,Home,W 102-95 ,240,35,70,0.5,25,42,0.595,10,28,0.357,22,26,0.846,102,37,83,0.446,26,53,0.491,11,30,0.367,10,16,0.625,95,2017-02-27,CLE,MIL,2017,100.5
6357,6357,57,@,W 102-88 ,240,40,95,0.421,32,72,0.444,8,23,0.348,14,20,0.7,102,36,82,0.439,30,65,0.462,6,17,0.353,10,15,0.667,88,2017-02-27,MIN,SAC,2017,91.0
6358,6358,58,@,L 102-105 ,240,33,84,0.393,26,63,0.413,7,21,0.333,29,33,0.879,102,36,83,0.434,27,55,0.491,9,28,0.321,24,31,0.774,105,2017-03-03,NYK,PHI,2017,109.5
6359,6359,59,Home,L 102-112 ,240,36,80,0.45,27,50,0.54,9,30,0.3,21,25,0.84,102,41,90,0.456,25,63,0.397,16,27,0.593,14,17,0.824,112,2017-03-04,DEN,CHO,2017,120.0
6360,6360,60,@,L 102-116 ,240,34,83,0.41,24,48,0.5,10,35,0.286,24,29,0.828,102,39,73,0.534,30,53,0.566,9,20,0.45,29,47,0.617,116,2017-03-06,BOS,LAC,2017,120.5
6361,6361,61,Home,W 102-92 ,240,41,88,0.466,35,68,0.515,6,20,0.3,14,21,0.667,102,35,84,0.417,29,65,0.446,6,19,0.316,16,20,0.8,92,2017-03-09,OKC,SAS,2017,95.0
6362,6362,62,Home,W 101-79 ,240,38,85,0.447,35,67,0.522,3,18,0.167,22,28,0.786,101,31,82,0.378,28,66,0.424,3,16,0.188,14,22,0.636,79,2011-12-27,POR,SAC,2012,80.5
6363,6363,63,Home,W 101-83 ,240,32,75,0.427,23,52,0.442,9,23,0.391,28,35,0.8,101,30,77,0.39,24,61,0.393,6,16,0.375,17,22,0.773,83,2011-12-28,ATL,WAS,2012,86.0
6364,6364,64,Home,L 101-114 ,240,41,80,0.513,34,65,0.523,7,15,0.467,12,20,0.6,101,39,78,0.5,32,61,0.525,7,17,0.412,29,34,0.853,114,2011-12-30,LAC,CHI,2012,117.5
6365,6365,65,Home,L 101-103 ,240,39,83,0.47,28,54,0.519,11,29,0.379,12,20,0.6,101,46,93,0.495,43,79,0.544,3,14,0.214,8,14,0.571,103,2011-12-30,MIN,MIA,2012,104.5
6366,6366,66,@,L 101-115 ,240,40,90,0.444,36,76,0.474,4,14,0.286,17,19,0.895,101,45,90,0.5,35,69,0.507,10,21,0.476,15,26,0.577,115,2012-01-03,CHA,CLE,2012,120.0
6367,6367,67,@,W 101-93 ,240,41,86,0.477,37,70,0.529,4,16,0.25,15,18,0.833,101,35,79,0.443,32,69,0.464,3,10,0.3,20,25,0.8,93,2012-01-04,PHI,NOH,2012,94.5
6368,6368,68,Home,W 101-95 ,240,37,78,0.474,27,61,0.443,10,17,0.588,17,24,0.708,101,37,80,0.463,28,60,0.467,9,20,0.45,12,19,0.632,95,2012-01-04,SAS,GSW,2012,99.5
6369,6369,69,@,W 101-90 ,240,38,76,0.5,33,61,0.541,5,15,0.333,20,24,0.833,101,28,83,0.337,18,50,0.36,10,33,0.303,24,32,0.75,90,2012-01-07,MIA,NJN,2012,95.0
6370,6370,70,Home,L 101-106 ,240,36,77,0.468,25,55,0.455,11,22,0.5,18,21,0.857,101,42,78,0.538,33,57,0.579,9,21,0.429,13,19,0.684,106,2012-01-09,BRK,ATL,2012,110.5
6371,6371,71,Home,W 101-95 (OT),265,42,92,0.457,37,76,0.487,5,16,0.313,12,17,0.706,101,41,96,0.427,38,75,0.507,3,21,0.143,10,12,0.833,95,2012-01-11,SAS,HOU,2012,96.5
6372,6372,72,@,W 101-90 ,240,39,89,0.438,29,70,0.414,10,19,0.526,13,21,0.619,101,34,75,0.453,26,54,0.481,8,21,0.381,14,20,0.7,90,2012-01-12,CLE,PHO,2012,94.0
6373,6373,73,Home,W 101-91 ,240,37,80,0.463,29,59,0.492,8,21,0.381,19,35,0.543,101,33,78,0.423,25,54,0.463,8,24,0.333,17,26,0.654,91,2012-01-16,LAC,NJN,2012,95.0
6374,6374,74,@,W 101-98 ,240,36,81,0.444,30,66,0.455,6,15,0.4,23,33,0.697,101,33,71,0.465,22,50,0.44,11,21,0.524,21,28,0.75,98,2012-01-20,MIN,LAC,2012,103.5
6375,6375,75,Home,W 101-89 ,240,41,88,0.466,34,69,0.493,7,19,0.368,12,21,0.571,101,32,80,0.4,25,62,0.403,7,18,0.389,18,25,0.72,89,2012-01-23,POR,SAC,2012,92.5
6376,6376,76,@,W 101-98 ,240,37,71,0.521,32,56,0.571,5,15,0.333,22,25,0.88,101,36,72,0.5,29,50,0.58,7,22,0.318,19,25,0.76,98,2012-01-25,MIA,DET,2012,101.5
6377,6377,77,Home,W 101-93 ,240,41,79,0.519,30,59,0.508,11,20,0.55,8,14,0.571,101,34,83,0.41,26,62,0.419,8,21,0.381,17,20,0.85,93,2012-01-25,GSW,POR,2012,97.0
6378,6378,78,Home,W 101-91 ,240,34,64,0.531,29,51,0.569,5,13,0.385,28,33,0.848,101,35,75,0.467,34,68,0.5,1,7,0.143,20,21,0.952,91,2012-01-25,OKC,NOH,2012,91.5
6379,6379,79,@,L 101-116 ,240,39,84,0.464,34,72,0.472,5,12,0.417,18,22,0.818,101,45,82,0.549,34,63,0.54,11,19,0.579,15,22,0.682,116,2012-01-27,UTA,DAL,2012,121.5
6380,6380,80,Home,L 101-107 (OT),265,38,93,0.409,31,77,0.403,7,16,0.438,18,22,0.818,101,40,82,0.488,30,66,0.455,10,16,0.625,17,25,0.68,107,2012-01-27,DET,ATL,2012,112.0
6381,6381,81,Home,W 101-100 (OT),265,44,100,0.44,40,80,0.5,4,20,0.2,9,12,0.75,101,39,94,0.415,27,69,0.391,12,25,0.48,10,19,0.526,100,2012-01-29,DAL,SAS,2012,106.0
6382,6382,82,Home,L 101-106 ,240,40,104,0.385,35,83,0.422,5,21,0.238,16,23,0.696,101,40,79,0.506,32,60,0.533,8,19,0.421,18,23,0.783,106,2012-01-29,MIN,LAL,2012,110.0
6383,6383,83,@,L 101-119 ,240,36,79,0.456,33,67,0.493,3,12,0.25,26,34,0.765,101,45,96,0.469,37,72,0.514,8,24,0.333,21,25,0.84,119,2012-02-02,UTA,GSW,2012,123.0
6384,6384,84,Home,W 101-94 ,240,34,71,0.479,27,54,0.5,7,17,0.412,26,33,0.788,101,37,87,0.425,33,74,0.446,4,13,0.308,16,20,0.8,94,2012-02-03,OKC,MEM,2012,96.0
6385,6385,85,Home,L 101-109 ,240,37,85,0.435,28,61,0.459,9,24,0.375,18,27,0.667,101,41,79,0.519,28,54,0.519,13,25,0.52,14,22,0.636,109,2012-02-09,DEN,GSW,2012,115.5
6386,6386,86,@,L 101-106 ,240,37,77,0.481,30,59,0.508,7,18,0.389,20,26,0.769,101,40,99,0.404,33,79,0.418,7,20,0.35,19,26,0.731,106,2012-02-09,OKC,SAC,2012,109.5
6387,6387,87,@,W 101-87 ,240,35,74,0.473,31,54,0.574,4,20,0.2,27,32,0.844,101,38,80,0.475,35,71,0.493,3,9,0.333,8,13,0.615,87,2012-02-10,OKC,UTA,2012,88.5
6388,6388,88,@,W 101-99 ,240,38,80,0.475,28,59,0.475,10,21,0.476,15,18,0.833,101,37,69,0.536,31,52,0.596,6,17,0.353,19,27,0.704,99,2012-02-15,ATL,PHO,2012,102.0
6389,6389,89,Home,W 101-85 ,240,37,72,0.514,27,53,0.509,10,19,0.526,17,24,0.708,101,32,81,0.395,27,67,0.403,5,14,0.357,16,20,0.8,85,2012-02-19,HOU,UTA,2012,87.5
6390,6390,90,@,L 101-103 (OT),265,36,99,0.364,30,72,0.417,6,27,0.222,23,24,0.958,101,37,92,0.402,32,70,0.457,5,22,0.227,24,35,0.686,103,2012-02-20,MIN,DEN,2012,105.5
6391,6391,91,Home,W 101-93 ,240,36,80,0.45,28,54,0.519,8,26,0.308,21,24,0.875,101,33,91,0.363,26,77,0.338,7,14,0.5,20,23,0.87,93,2012-02-20,OKC,NOH,2012,96.5
6392,6392,92,Home,W 101-100 ,240,34,78,0.436,25,60,0.417,9,18,0.5,24,32,0.75,101,37,95,0.389,30,78,0.385,7,17,0.412,19,24,0.792,100,2012-02-21,CLE,DET,2012,103.5
6393,6393,93,Home,W 101-98 ,240,40,87,0.46,32,66,0.485,8,21,0.381,13,21,0.619,101,37,83,0.446,29,62,0.468,8,21,0.381,16,26,0.615,98,2012-03-03,WAS,CLE,2012,102.0
6394,6394,94,Home,L 101-104 ,240,31,80,0.388,29,66,0.439,2,14,0.143,37,39,0.949,101,33,68,0.485,28,51,0.549,5,17,0.294,33,44,0.75,104,2012-03-04,CHA,NJN,2012,106.5
6395,6395,95,@,W 101-96 ,240,38,83,0.458,30,64,0.469,8,19,0.421,17,22,0.773,101,31,70,0.443,26,55,0.473,5,15,0.333,29,40,0.725,96,2012-03-06,ATL,IND,2012,98.5
6396,6396,96,Home,W 101-100 ,240,33,72,0.458,23,47,0.489,10,25,0.4,25,31,0.806,101,35,76,0.461,24,54,0.444,11,22,0.5,19,27,0.704,100,2012-03-07,BRK,LAC,2012,105.5
6397,6397,97,@,L 101-106 ,240,32,81,0.395,24,60,0.4,8,21,0.381,29,37,0.784,101,43,92,0.467,36,66,0.545,7,26,0.269,13,19,0.684,106,2012-03-07,LAL,WAS,2012,109.5
6398,6398,98,Home,L 101-107 (OT),265,44,85,0.518,41,75,0.547,3,10,0.3,10,13,0.769,101,37,82,0.451,32,63,0.508,5,19,0.263,28,35,0.8,107,2012-03-14,NOP,LAL,2012,109.5
6399,6399,99,Home,W 101-96 ,240,38,84,0.452,29,59,0.492,9,25,0.36,16,21,0.762,101,35,84,0.417,27,63,0.429,8,21,0.381,18,20,0.9,96,2012-03-15,DAL,CHA,2012,100.0
6400,6400,0,@,L 101-109 ,240,40,78,0.513,32,63,0.508,8,15,0.533,13,18,0.722,101,41,83,0.494,31,63,0.492,10,20,0.5,17,22,0.773,109,2012-03-16,DET,PHO,2012,114.0
6401,6401,1,@,W 101-92 ,240,39,89,0.438,25,60,0.417,14,29,0.483,9,10,0.9,101,39,79,0.494,36,70,0.514,3,9,0.333,11,14,0.786,92,2012-03-21,GSW,NOH,2012,93.5
6402,6402,2,@,L 101-102 (OT),265,39,87,0.448,36,73,0.493,3,14,0.214,20,25,0.8,101,41,103,0.398,38,80,0.475,3,23,0.13,17,26,0.654,102,2012-03-24,TOR,CHI,2012,103.5
6403,6403,3,@,W 101-99 (OT),265,37,80,0.463,31,58,0.534,6,22,0.273,21,24,0.875,101,37,96,0.385,28,71,0.394,9,25,0.36,16,18,0.889,99,2012-03-24,DAL,HOU,2012,103.5
6404,6404,4,Home,W 101-85 ,240,36,72,0.5,31,56,0.554,5,16,0.313,24,33,0.727,101,33,78,0.423,24,63,0.381,9,15,0.6,10,14,0.714,85,2012-03-24,LAC,MEM,2012,89.5
6405,6405,5,Home,W 101-79 ,240,38,78,0.487,32,58,0.552,6,20,0.3,19,30,0.633,101,28,76,0.368,22,57,0.386,6,19,0.316,17,22,0.773,79,2012-03-24,NYK,DET,2012,82.0
6406,6406,6,Home,L 101-117 ,240,35,74,0.473,24,52,0.462,11,22,0.5,20,24,0.833,101,44,81,0.543,29,47,0.617,15,34,0.441,14,19,0.737,117,2012-03-26,TOR,ORL,2012,124.5
6407,6407,7,Home,L 101-104 ,240,39,91,0.429,33,72,0.458,6,19,0.316,17,18,0.944,101,36,86,0.419,31,66,0.47,5,20,0.25,27,34,0.794,104,2012-03-27,GSW,LAL,2012,106.5
6408,6408,8,@,L 101-108 ,240,42,84,0.5,35,61,0.574,7,23,0.304,10,17,0.588,101,44,88,0.5,39,77,0.506,5,11,0.455,15,16,0.938,108,2012-03-27,ATL,MIL,2012,110.5
6409,6409,9,Home,L 101-113 ,240,39,72,0.542,34,58,0.586,5,14,0.357,18,19,0.947,101,44,77,0.571,39,63,0.619,5,14,0.357,20,24,0.833,113,2012-03-30,TOR,MIA,2012,115.5
6410,6410,10,Home,L 101-104 ,240,37,88,0.42,29,56,0.518,8,32,0.25,19,25,0.76,101,40,72,0.556,32,53,0.604,8,19,0.421,16,21,0.762,104,2012-04-01,ORL,DEN,2012,108.0
6411,6411,11,Home,W 101-88 ,240,37,81,0.457,25,57,0.439,12,24,0.5,15,19,0.789,101,32,86,0.372,26,67,0.388,6,19,0.316,18,19,0.947,88,2012-04-04,POR,NJN,2012,91.0
6412,6412,12,Home,W 101-96 ,240,39,81,0.481,35,66,0.53,4,15,0.267,19,27,0.704,101,37,78,0.474,30,63,0.476,7,15,0.467,15,22,0.682,96,2012-04-06,ATL,DET,2012,99.5
6413,6413,13,Home,W 101-86 ,240,41,83,0.494,37,67,0.552,4,16,0.25,15,21,0.714,101,32,87,0.368,22,61,0.361,10,26,0.385,12,20,0.6,86,2012-04-15,DEN,HOU,2012,91.0
6414,6414,14,@,W 101-98 ,240,36,71,0.507,30,53,0.566,6,18,0.333,23,27,0.852,101,41,82,0.5,36,66,0.545,5,16,0.313,11,16,0.688,98,2012-04-16,MIA,NJN,2012,100.5
6415,6415,15,Home,W 101-74 ,240,44,78,0.564,39,63,0.619,5,15,0.333,8,11,0.727,101,28,75,0.373,22,52,0.423,6,23,0.261,12,17,0.706,74,2012-04-22,DEN,ORL,2012,77.0
6416,6416,16,@,L 101-109 ,240,37,80,0.463,26,56,0.464,11,24,0.458,16,22,0.727,101,38,81,0.469,33,68,0.485,5,13,0.385,28,36,0.778,109,2012-04-23,CLE,MEM,2012,111.5
6417,6417,17,Home,W 101-73 ,240,46,83,0.554,44,65,0.677,2,18,0.111,7,12,0.583,101,25,73,0.342,21,58,0.362,4,15,0.267,19,23,0.826,73,2012-04-23,WAS,CHA,2012,75.0
6418,6418,18,Home,L 101-106 ,240,39,79,0.494,29,55,0.527,10,24,0.417,13,15,0.867,101,40,90,0.444,32,67,0.478,8,23,0.348,18,30,0.6,106,2012-04-25,OKC,DEN,2012,110.0
6419,6419,19,Home,L 101-107 ,240,45,87,0.517,43,79,0.544,2,8,0.25,9,12,0.75,101,42,96,0.438,33,65,0.508,9,31,0.29,14,17,0.824,107,2012-04-26,GSW,SAS,2012,111.5
6420,6420,20,Home,W 101-92 ,240,38,74,0.514,33,59,0.559,5,15,0.333,20,29,0.69,101,33,86,0.384,31,72,0.431,2,14,0.143,24,30,0.8,92,2012-10-31,LAC,MEM,2013,93.0
6421,6421,21,Home,L 101-108 ,240,39,74,0.527,30,49,0.612,9,25,0.36,14,16,0.875,101,40,92,0.435,26,63,0.413,14,29,0.483,14,22,0.636,108,2012-11-05,LAC,CLE,2013,115.0
6422,6422,22,Home,W 101-79 ,240,41,87,0.471,33,69,0.478,8,18,0.444,11,13,0.846,101,27,79,0.342,21,59,0.356,6,20,0.3,19,22,0.864,79,2012-11-05,SAS,IND,2013,82.0
6423,6423,23,Home,W 101-77 ,240,36,90,0.4,28,62,0.452,8,28,0.286,21,28,0.75,101,29,86,0.337,22,61,0.361,7,25,0.28,12,20,0.6,77,2012-11-09,LAL,GSW,2013,80.5
6424,6424,24,@,W 101-91 ,240,40,78,0.513,34,63,0.54,6,15,0.4,15,19,0.789,101,34,78,0.436,30,60,0.5,4,18,0.222,19,22,0.864,91,2012-11-09,MIL,WAS,2013,93.0
6425,6425,25,Home,W 101-97 (OT),265,40,95,0.421,37,75,0.493,3,20,0.15,18,28,0.643,101,32,79,0.405,23,60,0.383,9,19,0.474,24,30,0.8,97,2012-11-10,CHA,DAL,2013,101.5
6426,6426,26,Home,L 101-107 (2OT),290,39,102,0.382,30,77,0.39,9,25,0.36,14,23,0.609,101,43,113,0.381,38,89,0.427,5,24,0.208,16,27,0.593,107,2012-11-10,GSW,DEN,2013,109.5
6427,6427,27,@,W 101-95 ,240,41,81,0.506,38,65,0.585,3,16,0.188,16,16,1.0,101,34,74,0.459,31,65,0.477,3,9,0.333,24,31,0.774,95,2012-11-12,BOS,CHI,2013,96.5
6428,6428,28,@,L 101-114 ,240,38,87,0.437,35,73,0.479,3,14,0.214,22,26,0.846,101,42,77,0.545,37,55,0.673,5,22,0.227,25,31,0.806,114,2012-11-13,CLE,BRK,2013,116.5
6429,6429,29,@,L 101-107 ,240,39,81,0.481,26,54,0.481,13,27,0.481,10,11,0.909,101,39,78,0.5,36,67,0.537,3,11,0.273,26,33,0.788,107,2012-11-14,WAS,DAL,2013,108.5
6430,6430,30,Home,W 101-80 ,240,37,75,0.493,32,59,0.542,5,16,0.313,22,30,0.733,101,30,89,0.337,28,75,0.373,2,14,0.143,18,22,0.818,80,2012-11-17,LAC,CHI,2013,81.0
6431,6431,31,Home,L 101-105 (OT),265,37,86,0.43,27,65,0.415,10,21,0.476,17,24,0.708,101,37,91,0.407,28,67,0.418,9,24,0.375,22,30,0.733,105,2012-11-19,DAL,GSW,2013,109.5
6432,6432,32,Home,W 101-100 (OT),265,40,92,0.435,31,67,0.463,9,25,0.36,12,21,0.571,101,38,89,0.427,31,69,0.449,7,20,0.35,17,24,0.708,100,2012-11-21,ATL,WAS,2013,103.5
6433,6433,33,@,W 101-94 ,240,35,79,0.443,26,58,0.448,9,21,0.429,22,26,0.846,101,34,89,0.382,24,61,0.393,10,28,0.357,16,25,0.64,94,2012-11-21,DEN,MIN,2013,99.0
6434,6434,34,@,W 101-91 ,240,42,78,0.538,31,56,0.554,11,22,0.5,6,14,0.429,101,31,83,0.373,23,61,0.377,8,22,0.364,21,26,0.808,91,2012-11-23,ATL,CHA,2013,95.0
6435,6435,35,@,L 101-104 ,240,39,83,0.47,35,72,0.486,4,11,0.364,19,20,0.95,101,39,81,0.481,30,62,0.484,9,19,0.474,17,23,0.739,104,2012-11-25,PHO,PHI,2013,108.5
6436,6436,36,@,L 101-108 ,240,36,85,0.424,30,66,0.455,6,19,0.316,23,31,0.742,101,42,80,0.525,33,65,0.508,9,15,0.6,15,22,0.682,108,2012-11-26,POR,DET,2013,112.5
6437,6437,37,@,L 101-117 ,240,42,86,0.488,34,63,0.54,8,23,0.348,9,12,0.75,101,44,83,0.53,31,57,0.544,13,26,0.5,16,21,0.762,117,2012-11-27,TOR,HOU,2013,123.5
6438,6438,38,Home,W 101-78 ,240,34,69,0.493,28,59,0.475,6,10,0.6,27,33,0.818,101,28,81,0.346,24,63,0.381,4,18,0.222,18,20,0.9,78,2012-11-28,CHI,DAL,2013,80.0
6439,6439,39,Home,W 101-95 ,240,37,81,0.457,33,62,0.532,4,19,0.211,23,26,0.885,101,31,82,0.378,25,60,0.417,6,22,0.273,27,35,0.771,95,2012-11-28,LAC,MIN,2013,98.0
6440,6440,40,Home,W 101-97 ,240,39,81,0.481,31,67,0.463,8,14,0.571,15,22,0.682,101,37,77,0.481,31,61,0.508,6,16,0.375,17,19,0.895,97,2012-11-30,TOR,PHO,2013,100.0
6441,6441,41,@,L 101-105 ,240,41,89,0.461,33,61,0.541,8,28,0.286,11,16,0.688,101,38,79,0.481,31,60,0.517,7,19,0.368,22,29,0.759,105,2012-12-04,MIA,WAS,2013,108.5
6442,6442,42,@,W 101-97 ,240,35,81,0.432,26,59,0.441,9,22,0.409,22,27,0.815,101,37,87,0.425,28,62,0.452,9,25,0.36,14,23,0.609,97,2012-12-08,GSW,WAS,2013,101.5
6443,6443,43,Home,W 101-92 ,240,39,67,0.582,30,46,0.652,9,21,0.429,14,22,0.636,101,32,75,0.427,23,47,0.489,9,28,0.321,19,20,0.95,92,2012-12-10,MIA,ATL,2013,96.5
6444,6444,44,@,W 101-94 ,240,37,80,0.463,31,63,0.492,6,17,0.353,21,34,0.618,101,34,81,0.42,29,68,0.426,5,13,0.385,21,31,0.677,94,2012-12-11,DEN,DET,2013,96.5
6445,6445,45,Home,W 101-89 ,240,37,76,0.487,27,49,0.551,10,27,0.37,17,23,0.739,101,34,85,0.4,26,65,0.4,8,20,0.4,13,17,0.765,89,2012-12-14,HOU,BOS,2013,93.0
6446,6446,46,Home,W 101-90 ,240,41,85,0.482,33,63,0.524,8,22,0.364,11,15,0.733,101,34,83,0.41,31,70,0.443,3,13,0.231,19,24,0.792,90,2012-12-17,PHO,SAC,2013,91.5
6447,6447,47,Home,W 101-100 ,240,35,88,0.398,25,57,0.439,10,31,0.323,21,27,0.778,101,38,95,0.4,28,71,0.394,10,24,0.417,14,22,0.636,100,2012-12-18,LAL,CHA,2013,105.0
6448,6448,48,Home,W 101-93 ,240,33,92,0.359,19,56,0.339,14,36,0.389,21,26,0.808,101,38,98,0.388,38,76,0.5,0,22,0.0,17,24,0.708,93,2012-12-20,POR,DEN,2013,93.0
6449,6449,49,Home,W 101-83 ,240,38,73,0.521,26,54,0.481,12,19,0.632,13,16,0.813,101,31,86,0.36,26,64,0.406,5,22,0.227,16,21,0.762,83,2012-12-29,GSW,BOS,2013,85.5
6450,6450,50,@,W 101-97 ,240,37,83,0.446,31,67,0.463,6,16,0.375,21,30,0.7,101,40,86,0.465,34,64,0.531,6,22,0.273,11,20,0.55,97,2013-01-03,MIN,DEN,2013,100.0
6451,6451,51,Home,L 101-115 ,240,39,87,0.448,33,73,0.452,6,14,0.429,17,23,0.739,101,45,83,0.542,32,50,0.64,13,33,0.394,12,19,0.632,115,2013-01-04,MIL,HOU,2013,121.5
6452,6452,52,Home,L 101-108 (OT),265,40,80,0.5,32,54,0.593,8,26,0.308,13,19,0.684,101,40,92,0.435,37,79,0.468,3,13,0.231,25,29,0.862,108,2013-01-06,DET,CHA,2013,109.5
6453,6453,53,Home,W 101-99 ,240,38,87,0.437,28,69,0.406,10,18,0.556,15,18,0.833,101,34,80,0.425,28,55,0.509,6,25,0.24,25,30,0.833,99,2013-01-07,WAS,OKC,2013,102.0
6454,6454,54,Home,L 101-116 ,240,39,98,0.398,33,70,0.471,6,28,0.214,17,22,0.773,101,44,87,0.506,35,58,0.603,9,29,0.31,19,28,0.679,116,2013-01-11,LAL,OKC,2013,120.5
6455,6455,55,Home,W 101-98 (OT),265,40,85,0.471,37,73,0.507,3,12,0.25,18,21,0.857,101,35,76,0.461,25,51,0.49,10,25,0.4,18,22,0.818,98,2013-01-11,MEM,SAS,2013,103.0
6456,6456,56,Home,L 101-108 ,240,37,90,0.411,26,68,0.382,11,22,0.5,16,23,0.696,101,39,68,0.574,34,57,0.596,5,11,0.455,25,34,0.735,108,2013-01-11,NYK,CHI,2013,110.5
6457,6457,57,Home,L 101-104 ,240,43,88,0.489,34,66,0.515,9,22,0.409,6,6,1.0,101,39,81,0.481,28,56,0.5,11,25,0.44,15,19,0.789,104,2013-01-12,LAC,ORL,2013,109.5
6458,6458,58,@,L 101-108 (OT),265,40,88,0.455,29,63,0.46,11,25,0.44,10,13,0.769,101,47,91,0.516,43,72,0.597,4,19,0.211,10,14,0.714,108,2013-01-18,TOR,PHI,2013,110.0
6459,6459,59,Home,W 101-77 ,240,47,90,0.522,43,81,0.531,4,9,0.444,3,8,0.375,101,29,71,0.408,26,54,0.481,3,17,0.176,16,25,0.64,77,2013-01-25,MEM,BRK,2013,78.5
6460,6460,60,@,L 101-114 ,240,39,88,0.443,36,74,0.486,3,14,0.214,20,33,0.606,101,48,83,0.578,40,66,0.606,8,17,0.471,10,17,0.588,114,2013-01-25,MIN,WAS,2013,118.0
6461,6461,61,@,L 101-102 ,240,37,77,0.481,27,57,0.474,10,20,0.5,17,23,0.739,101,37,73,0.507,32,62,0.516,5,11,0.455,23,26,0.885,102,2013-01-26,MIN,CHA,2013,104.5
6462,6462,62,Home,W 101-100 ,240,35,75,0.467,24,50,0.48,11,25,0.44,20,21,0.952,101,40,81,0.494,33,65,0.508,7,16,0.438,13,17,0.765,100,2013-01-26,POR,LAC,2013,103.5
6463,6463,63,@,L 101-102 ,240,39,85,0.459,28,62,0.452,11,23,0.478,12,17,0.706,101,37,78,0.474,30,64,0.469,7,14,0.5,21,30,0.7,102,2013-01-28,IND,DEN,2013,105.5
6464,6464,64,@,L 101-111 ,240,39,88,0.443,35,72,0.486,4,16,0.25,19,22,0.864,101,39,74,0.527,33,60,0.55,6,14,0.429,27,34,0.794,111,2013-02-04,CHI,IND,2013,114.0
6465,6465,65,Home,L 101-105 ,240,38,89,0.427,29,68,0.426,9,21,0.429,16,20,0.8,101,40,77,0.519,31,51,0.608,9,26,0.346,16,23,0.696,105,2013-02-11,DAL,ATL,2013,109.5
6466,6466,66,@,L 101-108 ,240,40,86,0.465,36,70,0.514,4,16,0.25,17,24,0.708,101,41,75,0.547,35,62,0.565,6,13,0.462,20,24,0.833,108,2013-02-12,SAC,MEM,2013,111.0
6467,6467,67,Home,W 101-77 ,240,41,95,0.432,35,76,0.461,6,19,0.316,13,19,0.684,101,26,82,0.317,21,66,0.318,5,16,0.313,20,28,0.714,77,2013-02-13,IND,CHA,2013,79.5
6468,6468,68,Home,L 101-125 ,240,38,75,0.507,32,55,0.582,6,20,0.3,19,27,0.704,101,46,89,0.517,30,59,0.508,16,30,0.533,17,22,0.773,125,2013-02-14,LAL,LAC,2013,133.0
6469,6469,69,@,L 101-115 ,240,39,83,0.47,34,66,0.515,5,17,0.294,18,24,0.75,101,39,78,0.5,29,57,0.509,10,21,0.476,27,33,0.818,115,2013-02-19,GSW,UTA,2013,120.0
6470,6470,70,@,L 101-107 (OT),265,37,95,0.389,33,73,0.452,4,22,0.182,23,32,0.719,101,39,94,0.415,34,73,0.466,5,21,0.238,24,30,0.8,107,2013-02-22,SAS,GSW,2013,109.5
6471,6471,71,@,W 101-98 ,240,40,81,0.494,35,64,0.547,5,17,0.294,16,19,0.842,101,39,78,0.5,30,57,0.526,9,21,0.429,11,15,0.733,98,2013-02-26,CLE,CHI,2013,102.5
6472,6472,72,@,W 101-97 ,240,37,76,0.487,25,56,0.446,12,20,0.6,15,18,0.833,101,40,87,0.46,35,73,0.479,5,14,0.357,12,15,0.8,97,2013-02-26,BRK,NOH,2013,99.5
6473,6473,73,Home,L 101-125 ,240,37,83,0.446,31,64,0.484,6,19,0.316,21,25,0.84,101,46,84,0.548,36,62,0.581,10,22,0.455,23,29,0.793,125,2013-02-27,ORL,SAC,2013,130.0
6474,6474,74,Home,L 101-105 (OT),265,35,81,0.432,29,64,0.453,6,17,0.353,25,35,0.714,101,44,95,0.463,41,83,0.494,3,12,0.25,14,21,0.667,105,2013-02-27,SAS,PHO,2013,106.5
6475,6475,75,Home,L 101-109 ,240,41,100,0.41,36,79,0.456,5,21,0.238,14,18,0.778,101,42,83,0.506,31,64,0.484,11,19,0.579,14,16,0.875,109,2013-03-05,PHI,BOS,2013,114.5
6476,6476,76,@,L 101-104 ,240,38,87,0.437,29,68,0.426,9,19,0.474,16,19,0.842,101,37,90,0.411,30,74,0.405,7,16,0.438,23,29,0.793,104,2013-03-06,UTA,CLE,2013,107.5
6477,6477,77,@,L 101-117 ,240,38,79,0.481,25,50,0.5,13,29,0.448,12,15,0.8,101,47,87,0.54,35,58,0.603,12,29,0.414,11,14,0.786,117,2013-03-06,MIL,LAC,2013,123.0
6478,6478,78,Home,W 101-83 ,240,40,74,0.541,32,60,0.533,8,14,0.571,13,18,0.722,101,33,90,0.367,24,70,0.343,9,20,0.45,8,8,1.0,83,2013-03-06,SAS,CHI,2013,87.5
6479,6479,79,@,L 101-112 ,240,40,76,0.526,35,59,0.593,5,17,0.294,16,24,0.667,101,41,86,0.477,34,67,0.507,7,19,0.368,23,24,0.958,112,2013-03-16,DET,POR,2013,115.5
6480,6480,80,Home,L 101-107 ,240,38,83,0.458,29,62,0.468,9,21,0.429,16,16,1.0,101,39,80,0.488,34,59,0.576,5,21,0.238,24,30,0.8,107,2013-03-17,DAL,OKC,2013,109.5
6481,6481,81,Home,W 101-100 ,240,43,86,0.5,38,70,0.543,5,16,0.313,10,13,0.769,101,38,90,0.422,26,62,0.419,12,28,0.429,12,14,0.857,100,2013-03-18,PHI,POR,2013,106.0
6482,6482,82,@,L 101-116 ,240,36,80,0.45,27,54,0.5,9,26,0.346,20,26,0.769,101,37,73,0.507,23,45,0.511,14,28,0.5,28,34,0.824,116,2013-03-19,LAC,SAC,2013,123.0
6483,6483,83,@,L 101-107 ,240,35,83,0.422,30,61,0.492,5,22,0.227,26,26,1.0,101,35,75,0.467,27,59,0.458,8,16,0.5,29,40,0.725,107,2013-03-20,TOR,CHA,2013,111.0
6484,6484,84,Home,W 101-72 ,240,41,78,0.526,35,58,0.603,6,20,0.3,13,19,0.684,101,29,79,0.367,23,59,0.39,6,20,0.3,8,10,0.8,72,2013-03-20,LAC,PHI,2013,75.0
6485,6485,85,Home,W 101-100 ,240,37,76,0.487,30,65,0.462,7,11,0.636,20,27,0.741,101,43,78,0.551,36,60,0.6,7,18,0.389,7,11,0.636,100,2013-03-21,DEN,PHI,2013,103.5
6486,6486,86,Home,W 101-98 ,240,40,75,0.533,34,57,0.596,6,18,0.333,15,18,0.833,101,41,98,0.418,40,79,0.506,1,19,0.053,15,18,0.833,98,2013-03-21,SAC,MIN,2013,98.5
6487,6487,87,Home,W 101-95 ,240,37,85,0.435,33,71,0.465,4,14,0.286,23,32,0.719,101,39,86,0.453,31,58,0.534,8,28,0.286,9,17,0.529,95,2013-03-23,DEN,SAC,2013,99.0
6488,6488,88,Home,W 101-92 ,240,37,75,0.493,27,55,0.491,10,20,0.5,17,22,0.773,101,36,88,0.409,29,71,0.408,7,17,0.412,13,16,0.813,92,2013-03-23,GSW,WAS,2013,95.5
6489,6489,89,Home,W 101-95 ,240,37,79,0.468,28,53,0.528,9,26,0.346,18,24,0.75,101,34,74,0.459,25,49,0.51,9,25,0.36,18,24,0.75,95,2013-03-23,LAC,BRK,2013,99.5
6490,6490,90,Home,W 101-97 ,240,40,85,0.471,32,63,0.508,8,22,0.364,13,18,0.722,101,37,77,0.481,30,57,0.526,7,20,0.35,16,23,0.696,97,2013-03-27,CHI,MIA,2013,100.5
6491,6491,91,@,L 101-108 ,240,33,70,0.471,27,49,0.551,6,21,0.286,29,35,0.829,101,38,74,0.514,25,43,0.581,13,31,0.419,19,22,0.864,108,2013-03-27,MEM,NYK,2013,114.5
6492,6492,92,Home,W 101-93 ,240,37,83,0.446,32,68,0.471,5,15,0.333,22,27,0.815,101,36,79,0.456,31,63,0.492,5,16,0.313,16,20,0.8,93,2013-03-29,MIN,OKC,2013,95.5
6493,6493,93,Home,W 101-81 ,240,36,81,0.444,28,57,0.491,8,24,0.333,21,33,0.636,101,34,81,0.42,27,62,0.435,7,19,0.368,6,12,0.5,81,2013-04-02,LAL,DAL,2013,84.5
6494,6494,94,@,L 101-126 ,240,35,77,0.455,28,60,0.467,7,17,0.412,24,25,0.96,101,52,93,0.559,43,72,0.597,9,21,0.429,13,18,0.722,126,2013-04-03,PHO,LAC,2013,130.5
6495,6495,95,@,W 101-90 ,240,37,80,0.463,28,64,0.438,9,16,0.563,18,24,0.75,101,34,73,0.466,29,56,0.518,5,17,0.294,17,27,0.63,90,2013-04-05,PHI,ATL,2013,92.5
6496,6496,96,Home,W 101-83 ,240,41,89,0.461,29,53,0.547,12,36,0.333,7,8,0.875,101,29,76,0.382,17,46,0.37,12,30,0.4,13,18,0.722,83,2013-04-05,NYK,MIL,2013,89.0
6497,6497,97,@,L 101-107 ,240,40,75,0.533,34,60,0.567,6,15,0.4,15,21,0.714,101,36,83,0.434,30,69,0.435,6,14,0.429,29,38,0.763,107,2013-04-06,DET,MIN,2013,110.0
6498,6498,98,@,W 101-98 ,240,37,72,0.514,30,54,0.556,7,18,0.389,20,24,0.833,101,37,86,0.43,27,69,0.391,10,17,0.588,14,20,0.7,98,2013-04-09,TOR,CHI,2013,103.0
6499,6499,99,Home,W 101-98 ,240,37,86,0.43,31,56,0.554,6,30,0.2,21,24,0.875,101,38,86,0.442,31,74,0.419,7,12,0.583,15,19,0.789,98,2013-04-09,HOU,PHO,2013,101.5
6500,6500,0,@,W 101-93 ,240,34,74,0.459,26,55,0.473,8,19,0.421,25,28,0.893,101,37,81,0.457,31,65,0.477,6,16,0.375,13,17,0.765,93,2013-04-10,BRK,BOS,2013,96.0
6501,6501,1,Home,L 101-124 ,240,37,88,0.42,30,67,0.448,7,21,0.333,20,22,0.909,101,49,91,0.538,41,69,0.594,8,22,0.364,18,19,0.947,124,2013-04-10,PHI,ATL,2013,128.0
6502,6502,2,@,W 101-91 ,240,40,79,0.506,30,51,0.588,10,28,0.357,11,17,0.647,101,34,79,0.43,28,57,0.491,6,22,0.273,17,24,0.708,91,2013-04-12,NYK,CLE,2013,94.0
6503,6503,3,@,L 101-109 ,240,41,85,0.482,35,62,0.565,6,23,0.261,13,13,1.0,101,39,71,0.549,27,48,0.563,12,23,0.522,19,28,0.679,109,2013-04-12,BOS,MIA,2013,115.0
6504,6504,4,@,L 101-108 ,240,39,89,0.438,28,69,0.406,11,20,0.55,12,15,0.8,101,42,77,0.545,36,60,0.6,6,17,0.353,18,21,0.857,108,2013-04-12,SAC,SAS,2013,111.0
6505,6505,5,@,L 101-106 ,240,41,77,0.532,37,66,0.561,4,11,0.364,15,20,0.75,101,43,92,0.467,36,77,0.468,7,15,0.467,13,27,0.481,106,2013-04-15,WAS,BRK,2013,109.5
6506,6506,6,@,L 101-109 ,240,39,87,0.448,33,65,0.508,6,22,0.273,17,21,0.81,101,41,83,0.494,32,58,0.552,9,25,0.36,18,22,0.818,109,2013-04-15,PHI,DET,2013,113.5
6507,6507,7,Home,W 101-94 ,240,40,76,0.526,29,56,0.518,11,20,0.55,10,16,0.625,101,39,93,0.419,31,78,0.397,8,15,0.533,8,15,0.533,94,2013-10-30,SAS,MEM,2014,98.0
6508,6508,8,@,W 101-98 ,240,33,81,0.407,27,62,0.435,6,19,0.316,29,33,0.879,101,36,79,0.456,30,57,0.526,6,22,0.273,20,30,0.667,98,2013-10-30,OKC,UTA,2014,101.0
6509,6509,9,Home,W 101-100 ,240,33,68,0.485,25,52,0.481,8,16,0.5,27,39,0.692,101,32,67,0.478,25,53,0.472,7,14,0.5,29,36,0.806,100,2013-11-01,BRK,MIA,2014,103.5
6510,6510,10,Home,L 101-110 ,240,36,79,0.456,30,62,0.484,6,17,0.353,23,32,0.719,101,35,70,0.5,23,46,0.5,12,24,0.5,28,34,0.824,110,2013-11-01,SAC,LAC,2014,116.0
6511,6511,11,Home,L 101-116 ,240,36,87,0.414,26,56,0.464,10,31,0.323,19,29,0.655,101,41,75,0.547,35,53,0.66,6,22,0.273,28,34,0.824,116,2013-11-05,POR,HOU,2014,119.0
6512,6512,12,@,W 101-91 ,240,42,90,0.467,30,64,0.469,12,26,0.462,5,9,0.556,101,31,76,0.408,27,60,0.45,4,16,0.25,25,30,0.833,91,2013-11-08,NYK,CHA,2014,93.0
6513,6513,13,Home,W 101-94 ,240,38,78,0.487,31,56,0.554,7,22,0.318,18,23,0.783,101,39,88,0.443,35,75,0.467,4,13,0.308,12,13,0.923,94,2013-11-10,PHO,NOP,2014,96.0
6514,6514,14,Home,L 101-113 ,240,36,77,0.468,29,60,0.483,7,17,0.412,22,30,0.733,101,37,86,0.43,27,65,0.415,10,21,0.476,29,35,0.829,113,2013-11-23,GSW,POR,2014,118.0
6515,6515,15,@,L 101-112 ,240,40,100,0.4,32,74,0.432,8,26,0.308,13,17,0.765,101,41,79,0.519,24,48,0.5,17,31,0.548,13,16,0.813,112,2013-11-23,MIN,HOU,2014,120.5
6516,6516,16,Home,W 101-99 ,240,37,78,0.474,31,53,0.585,6,25,0.24,21,26,0.808,101,34,73,0.466,24,50,0.48,10,23,0.435,21,29,0.724,99,2013-11-23,MIA,ORL,2014,104.0
6517,6517,17,Home,L 101-102 ,240,41,87,0.471,32,68,0.471,9,19,0.474,10,13,0.769,101,40,88,0.455,33,69,0.478,7,19,0.368,15,21,0.714,102,2013-11-26,NOP,GSW,2014,105.5
6518,6518,18,Home,L 101-112 ,240,40,83,0.482,35,63,0.556,5,20,0.25,16,20,0.8,101,41,75,0.547,33,50,0.66,8,25,0.32,22,25,0.88,112,2013-11-29,UTA,PHO,2014,116.0
6519,6519,19,@,L 101-108 ,240,36,81,0.444,29,64,0.453,7,17,0.412,22,26,0.846,101,38,78,0.487,26,54,0.481,12,24,0.5,20,30,0.667,108,2013-11-30,ATL,WAS,2014,114.0
6520,6520,20,@,W 101-81 ,240,38,80,0.475,27,60,0.45,11,20,0.55,14,18,0.778,101,29,77,0.377,26,64,0.406,3,13,0.231,20,26,0.769,81,2013-12-05,LAC,MEM,2014,82.5
6521,6521,21,@,W 101-92 ,240,38,86,0.442,34,68,0.5,4,18,0.222,21,28,0.75,101,31,87,0.356,22,61,0.361,9,26,0.346,21,27,0.778,92,2013-12-10,OKC,ATL,2014,96.5
6522,6522,22,Home,L 101-122 ,240,35,78,0.449,31,65,0.477,4,13,0.308,27,33,0.818,101,48,89,0.539,35,66,0.53,13,23,0.565,13,15,0.867,122,2013-12-11,SAC,UTA,2014,128.5
6523,6523,23,Home,W 101-99 (OT),265,38,89,0.427,31,68,0.456,7,21,0.333,18,24,0.75,101,42,100,0.42,38,86,0.442,4,14,0.286,11,18,0.611,99,2013-12-13,ATL,WAS,2014,101.0
6524,6524,24,@,W 101-93 ,240,35,79,0.443,23,53,0.434,12,26,0.462,19,25,0.76,101,37,83,0.446,32,68,0.471,5,15,0.333,14,20,0.7,93,2013-12-15,MIN,MEM,2014,95.5
6525,6525,25,Home,W 101-98 ,240,39,87,0.448,34,68,0.5,5,19,0.263,18,20,0.9,101,37,82,0.451,30,58,0.517,7,24,0.292,17,26,0.654,98,2013-12-15,OKC,ORL,2014,101.5
6526,6526,26,Home,W 101-97 ,240,38,86,0.442,31,65,0.477,7,21,0.333,18,23,0.783,101,37,98,0.378,29,69,0.42,8,29,0.276,15,26,0.577,97,2013-12-16,BOS,MIN,2014,101.0
6527,6527,27,@,W 101-96 ,240,38,88,0.432,31,68,0.456,7,20,0.35,18,28,0.643,101,35,81,0.432,29,64,0.453,6,17,0.353,20,27,0.741,96,2013-12-16,DET,IND,2014,99.0
6528,6528,28,Home,L 101-102 ,240,33,79,0.418,22,49,0.449,11,30,0.367,24,31,0.774,101,39,72,0.542,28,54,0.519,11,18,0.611,13,17,0.765,102,2013-12-16,NYK,WAS,2014,107.5
6529,6529,29,Home,L 101-107 (2OT),290,34,82,0.415,26,60,0.433,8,22,0.364,25,35,0.714,101,38,101,0.376,21,60,0.35,17,41,0.415,14,19,0.737,107,2013-12-18,MIL,NYK,2014,115.5
6530,6530,30,Home,L 101-108 ,240,38,82,0.463,31,67,0.463,7,15,0.467,18,24,0.75,101,41,87,0.471,34,69,0.493,7,18,0.389,19,24,0.792,108,2013-12-18,PHO,SAS,2014,111.5
6531,6531,31,@,W 101-95 ,240,41,80,0.513,32,53,0.604,9,27,0.333,10,17,0.588,101,33,79,0.418,19,43,0.442,14,36,0.389,15,26,0.577,95,2013-12-25,MIA,LAL,2014,102.0
6532,6532,32,@,L 101-115 ,240,37,95,0.389,26,66,0.394,11,29,0.379,16,22,0.727,101,44,95,0.463,35,62,0.565,9,33,0.273,18,23,0.783,115,2013-12-28,PHI,PHO,2014,119.5
6533,6533,33,Home,L 101-105 ,240,37,77,0.481,23,45,0.511,14,32,0.438,13,19,0.684,101,39,76,0.513,30,59,0.508,9,17,0.529,18,20,0.9,105,2014-01-02,SAS,NYK,2014,109.5
6534,6534,34,@,W 101-100 ,240,39,87,0.448,33,60,0.55,6,27,0.222,17,25,0.68,101,37,80,0.463,27,49,0.551,10,31,0.323,16,19,0.842,100,2014-01-03,GSW,ATL,2014,105.0
6535,6535,35,@,W 101-88 ,240,40,79,0.506,29,57,0.509,11,22,0.5,10,13,0.769,101,34,82,0.415,30,70,0.429,4,12,0.333,16,17,0.941,88,2014-01-03,TOR,WAS,2014,90.0
6536,6536,36,@,W 101-99 ,240,40,88,0.455,36,74,0.486,4,14,0.286,17,24,0.708,101,36,99,0.364,33,77,0.429,3,22,0.136,24,30,0.8,99,2014-01-04,PHI,POR,2014,100.5
6537,6537,37,Home,W 101-81 ,240,35,83,0.422,24,52,0.462,11,31,0.355,20,24,0.833,101,30,84,0.357,23,65,0.354,7,19,0.368,14,21,0.667,81,2014-01-06,LAC,ORL,2014,84.5
6538,6538,38,@,W 101-80 ,240,39,85,0.459,29,53,0.547,10,32,0.313,13,20,0.65,101,31,80,0.388,26,65,0.4,5,15,0.333,13,18,0.722,80,2014-01-07,GSW,MIL,2014,82.5
6539,6539,39,@,L 101-112 ,240,35,89,0.393,29,55,0.527,6,34,0.176,25,31,0.806,101,40,68,0.588,32,50,0.64,8,18,0.444,24,31,0.774,112,2014-01-07,OKC,UTA,2014,116.0
6540,6540,40,Home,W 101-88 ,240,37,90,0.411,23,59,0.39,14,31,0.452,13,18,0.722,101,30,85,0.353,24,61,0.393,6,24,0.25,22,27,0.815,88,2014-01-09,DEN,OKC,2014,91.0
6541,6541,41,Home,W 101-85 ,240,35,86,0.407,25,61,0.41,10,25,0.4,21,27,0.778,101,32,81,0.395,20,50,0.4,12,31,0.387,9,14,0.643,85,2014-01-11,OKC,MIL,2014,91.0
6542,6542,42,@,L 101-108 ,240,38,80,0.475,29,53,0.547,9,27,0.333,16,24,0.667,101,43,83,0.518,37,68,0.544,6,15,0.4,16,20,0.8,108,2014-01-12,ATL,MEM,2014,111.0
6543,6543,43,@,W 101-95 ,240,35,67,0.522,30,55,0.545,5,12,0.417,26,31,0.839,101,38,87,0.437,31,76,0.408,7,11,0.636,12,17,0.706,95,2014-01-13,SAS,NOP,2014,98.5
6544,6544,44,Home,L 101-111 ,240,38,82,0.463,28,57,0.491,10,25,0.4,15,21,0.714,101,39,74,0.527,32,59,0.542,7,15,0.467,26,35,0.743,111,2014-01-17,ORL,CHA,2014,114.5
6545,6545,45,@,W 101-86 ,240,38,80,0.475,30,57,0.526,8,23,0.348,17,20,0.85,101,31,84,0.369,29,64,0.453,2,20,0.1,22,37,0.595,86,2014-01-17,MIA,PHI,2014,87.0
6546,6546,46,Home,W 101-90 ,240,40,81,0.494,30,53,0.566,10,28,0.357,11,13,0.846,101,33,72,0.458,26,53,0.491,7,19,0.368,17,23,0.739,90,2014-01-21,BRK,ORL,2014,93.5
6547,6547,47,@,L 101-104 ,240,36,84,0.429,32,69,0.464,4,15,0.267,25,34,0.735,101,41,84,0.488,33,57,0.579,8,27,0.296,14,22,0.636,104,2014-01-22,DET,MIL,2014,108.0
6548,6548,48,@,W 101-83 ,240,43,80,0.538,38,67,0.567,5,13,0.385,10,13,0.769,101,32,75,0.427,27,48,0.563,5,27,0.185,14,19,0.737,83,2014-01-24,OKC,BOS,2014,85.5
6549,6549,49,Home,L 101-103 ,240,37,85,0.435,31,67,0.463,6,18,0.333,21,28,0.75,101,37,73,0.507,30,56,0.536,7,17,0.412,22,24,0.917,103,2014-01-24,DET,NOP,2014,106.5
6550,6550,50,@,W 101-95 ,240,39,86,0.453,33,70,0.471,6,16,0.375,17,23,0.739,101,34,71,0.479,27,49,0.551,7,22,0.318,20,25,0.8,95,2014-01-24,WAS,PHO,2014,98.5
6551,6551,51,@,L 101-104 ,240,39,91,0.429,32,71,0.451,7,20,0.35,16,18,0.889,101,38,81,0.469,28,57,0.491,10,24,0.417,18,22,0.818,104,2014-01-25,WAS,UTA,2014,109.0
6552,6552,52,@,L 101-113 ,240,38,76,0.5,32,54,0.593,6,22,0.273,19,23,0.826,101,43,74,0.581,35,55,0.636,8,19,0.421,19,20,0.95,113,2014-01-26,SAS,MIA,2014,117.0
6553,6553,53,@,W 101-98 ,240,33,78,0.423,28,64,0.438,5,14,0.357,30,42,0.714,101,39,100,0.39,30,72,0.417,9,28,0.321,11,13,0.846,98,2014-01-29,CHA,DEN,2014,102.5
6554,6554,54,Home,W 101-98 ,240,36,81,0.444,25,63,0.397,11,18,0.611,18,21,0.857,101,34,78,0.436,19,44,0.432,15,34,0.441,15,24,0.625,98,2014-02-03,MIL,NYK,2014,105.5
6555,6555,55,@,W 101-92 ,240,35,78,0.449,29,60,0.483,6,18,0.333,25,31,0.806,101,31,80,0.388,23,52,0.442,8,28,0.286,22,29,0.759,92,2014-02-04,CHI,PHO,2014,96.0
6556,6556,56,@,L 101-109 ,240,36,84,0.429,26,59,0.441,10,25,0.4,19,24,0.792,101,32,81,0.395,28,69,0.406,4,12,0.333,41,51,0.804,109,2014-02-05,TOR,SAC,2014,111.0
6557,6557,57,@,W 101-95 ,240,42,85,0.494,34,61,0.557,8,24,0.333,9,13,0.692,101,40,90,0.444,34,75,0.453,6,15,0.4,9,11,0.818,95,2014-02-08,HOU,MIL,2014,98.0
6558,6558,58,@,L 101-108 ,240,39,77,0.506,33,65,0.508,6,12,0.5,17,26,0.654,101,36,76,0.474,26,52,0.5,10,24,0.417,26,33,0.788,108,2014-02-10,NOP,TOR,2014,113.0
6559,6559,59,Home,L 101-106 (OT),265,41,90,0.456,32,66,0.485,9,24,0.375,10,14,0.714,101,40,85,0.471,30,62,0.484,10,23,0.435,16,19,0.842,106,2014-02-12,NYK,SAC,2014,111.0
6560,6560,60,Home,W 101-93 ,240,33,80,0.413,28,60,0.467,5,20,0.25,30,37,0.811,101,35,89,0.393,29,67,0.433,6,22,0.273,17,24,0.708,93,2014-02-19,CLE,ORL,2014,96.0
6561,6561,61,@,W 101-92 ,240,39,86,0.453,36,67,0.537,3,19,0.158,20,24,0.833,101,33,79,0.418,27,62,0.435,6,17,0.353,20,28,0.714,92,2014-02-19,GSW,SAC,2014,95.0
6562,6562,62,@,W 101-90 ,240,39,76,0.513,31,58,0.534,8,18,0.444,15,26,0.577,101,35,82,0.427,31,61,0.508,4,21,0.19,16,20,0.8,90,2014-02-20,DEN,MIL,2014,92.0
6563,6563,63,Home,W 101-92 ,240,40,83,0.482,33,61,0.541,7,22,0.318,14,19,0.737,101,38,97,0.392,34,75,0.453,4,22,0.182,12,17,0.706,92,2014-02-21,LAL,BOS,2014,94.0
6564,6564,64,Home,L 101-110 ,240,42,95,0.442,39,80,0.488,3,15,0.2,14,18,0.778,101,42,87,0.483,37,69,0.536,5,18,0.278,21,32,0.656,110,2014-02-25,PHO,MIN,2014,112.5
6565,6565,65,Home,W 101-93 ,240,41,93,0.441,33,69,0.478,8,24,0.333,11,13,0.846,101,34,77,0.442,26,52,0.5,8,25,0.32,17,24,0.708,93,2014-02-26,LAC,HOU,2014,97.0
6566,6566,66,@,W 101-90 ,240,39,94,0.415,30,76,0.395,9,18,0.5,14,16,0.875,101,32,87,0.368,27,65,0.415,5,22,0.227,21,28,0.75,90,2014-02-26,ORL,PHI,2014,92.5
6567,6567,67,Home,W 101-96 ,240,38,74,0.514,32,59,0.542,6,15,0.4,19,22,0.864,101,38,87,0.437,26,63,0.413,12,24,0.5,8,11,0.727,96,2014-02-27,IND,MIL,2014,102.0
6568,6568,68,Home,L 101-122 ,240,38,79,0.481,28,60,0.467,10,19,0.526,15,20,0.75,101,43,90,0.478,29,57,0.509,14,33,0.424,22,24,0.917,122,2014-03-04,CLE,SAS,2014,129.0
6569,6569,69,@,W 101-89 ,240,40,82,0.488,34,60,0.567,6,22,0.273,15,24,0.625,101,38,84,0.452,35,70,0.5,3,14,0.214,10,12,0.833,89,2014-03-05,HOU,ORL,2014,90.5
6570,6570,70,Home,W 101-92 ,240,36,77,0.468,27,48,0.563,9,29,0.31,20,22,0.909,101,37,86,0.43,34,69,0.493,3,17,0.176,15,20,0.75,92,2014-03-07,CHA,CLE,2014,93.5
6571,6571,71,@,L 101-114 ,240,38,94,0.404,34,81,0.42,4,13,0.308,21,30,0.7,101,41,91,0.451,35,71,0.493,6,20,0.3,26,33,0.788,114,2014-03-07,DET,MIN,2014,117.0
6572,6572,72,Home,W 101-97 ,240,34,70,0.486,23,50,0.46,11,20,0.55,22,31,0.71,101,35,71,0.493,29,48,0.604,6,23,0.261,21,24,0.875,97,2014-03-10,BRK,TOR,2014,100.0
6573,6573,73,@,L 101-112 ,240,39,74,0.527,34,59,0.576,5,15,0.333,18,29,0.621,101,41,85,0.482,33,65,0.508,8,20,0.4,22,30,0.733,112,2014-03-11,MIL,MIN,2014,116.0
6574,6574,74,Home,L 101-110 ,240,39,90,0.433,29,54,0.537,10,36,0.278,13,22,0.591,101,38,81,0.469,26,57,0.456,12,24,0.5,22,27,0.815,110,2014-03-12,PHO,CLE,2014,116.0
6575,6575,75,Home,W 101-87 ,240,37,88,0.42,29,68,0.426,8,20,0.4,19,25,0.76,101,34,78,0.436,25,56,0.446,9,22,0.409,10,24,0.417,87,2014-03-12,TOR,DET,2014,91.5
6576,6576,76,Home,L 101-108 ,240,40,85,0.471,35,59,0.593,5,26,0.192,16,21,0.762,101,42,79,0.532,29,58,0.5,13,21,0.619,11,12,0.917,108,2014-03-12,UTA,DAL,2014,114.5
6577,6577,77,Home,L 101-105 (OT),265,43,97,0.443,36,72,0.5,7,25,0.28,8,10,0.8,101,36,90,0.4,26,67,0.388,10,23,0.435,23,29,0.793,105,2014-03-14,ORL,WAS,2014,110.0
6578,6578,78,@,W 101-94 ,240,39,67,0.582,30,46,0.652,9,21,0.429,14,22,0.636,101,35,90,0.389,27,64,0.422,8,26,0.308,16,18,0.889,94,2014-03-14,IND,PHI,2014,98.0
6579,6579,79,Home,W 101-94 ,240,36,77,0.468,28,51,0.549,8,26,0.308,21,25,0.84,101,34,71,0.479,23,50,0.46,11,21,0.524,15,22,0.682,94,2014-03-15,WAS,BRK,2014,99.5
6580,6580,80,@,W 101-92 ,240,39,68,0.574,30,48,0.625,9,20,0.45,14,18,0.778,101,37,89,0.416,30,71,0.423,7,18,0.389,11,16,0.688,92,2014-03-16,CHA,MIL,2014,95.5
6581,6581,81,Home,W 101-96 ,240,39,77,0.506,26,49,0.531,13,28,0.464,10,12,0.833,101,40,81,0.494,36,64,0.563,4,17,0.235,12,15,0.8,96,2014-03-19,BOS,MIA,2014,98.0
6582,6582,82,Home,W 101-97 ,240,39,79,0.494,33,65,0.508,6,14,0.429,17,25,0.68,101,34,80,0.425,25,49,0.51,9,31,0.29,20,28,0.714,97,2014-03-29,WAS,ATL,2014,101.5
6583,6583,83,Home,W 101-94 ,240,39,79,0.494,34,61,0.557,5,18,0.278,18,24,0.75,101,34,93,0.366,27,77,0.351,7,16,0.438,19,28,0.679,94,2014-04-02,IND,DET,2014,97.5
6584,6584,84,Home,L 101-105 ,240,36,79,0.456,26,56,0.464,10,23,0.435,19,27,0.704,101,41,80,0.513,35,59,0.593,6,21,0.286,17,23,0.739,105,2014-04-05,PHI,BRK,2014,108.0
6585,6585,85,Home,L 101-107 ,240,36,86,0.419,28,59,0.475,8,27,0.296,21,34,0.618,101,38,90,0.422,33,69,0.478,5,21,0.238,26,32,0.813,107,2014-04-09,LAC,OKC,2014,109.5
6586,6586,86,Home,W 101-98 ,240,39,79,0.494,28,55,0.509,11,24,0.458,12,15,0.8,101,36,78,0.462,28,61,0.459,8,17,0.471,18,23,0.783,98,2014-04-12,DAL,PHO,2014,102.0
6587,6587,87,Home,W 101-94 ,240,35,84,0.417,28,62,0.452,7,22,0.318,24,29,0.828,101,34,79,0.43,32,66,0.485,2,13,0.154,24,32,0.75,94,2014-04-12,DEN,UTA,2014,95.0
6588,6588,88,@,L 101-117 ,240,35,82,0.427,31,73,0.425,4,9,0.444,27,33,0.818,101,41,81,0.506,32,62,0.516,9,19,0.474,26,36,0.722,117,2014-04-12,SAC,LAC,2014,121.5
6589,6589,89,Home,W 101-89 ,240,35,79,0.443,26,50,0.52,9,29,0.31,22,30,0.733,101,31,77,0.403,22,45,0.489,9,32,0.281,18,22,0.818,89,2014-04-14,NOP,OKC,2014,93.5
6590,6590,90,@,W 101-86 ,240,41,88,0.466,30,65,0.462,11,23,0.478,8,11,0.727,101,32,79,0.405,27,64,0.422,5,15,0.333,17,24,0.708,86,2014-04-16,IND,ORL,2014,88.5
6591,6591,91,Home,W 101-84 ,240,41,101,0.406,37,84,0.44,4,17,0.235,15,31,0.484,101,32,84,0.381,28,73,0.384,4,11,0.364,16,21,0.762,84,2014-10-28,NOP,ORL,2015,86.0
6592,6592,92,Home,W 101-100 ,240,37,70,0.529,23,42,0.548,14,28,0.5,13,16,0.813,101,38,78,0.487,30,57,0.526,8,21,0.381,16,19,0.842,100,2014-10-28,SAS,DAL,2015,104.0
6593,6593,93,@,L 101-105 ,240,39,86,0.453,33,74,0.446,6,12,0.5,17,23,0.739,101,43,82,0.524,39,67,0.582,4,15,0.267,15,20,0.75,105,2014-10-29,MIN,MEM,2015,107.0
6594,6594,94,@,L 101-107 ,240,36,77,0.468,26,50,0.52,10,27,0.37,19,24,0.792,101,41,81,0.506,31,58,0.534,10,23,0.435,15,17,0.882,107,2014-11-03,UTA,LAC,2015,112.0
6595,6595,95,Home,W 101-82 ,240,37,75,0.493,29,50,0.58,8,25,0.32,19,25,0.76,101,31,85,0.365,22,64,0.344,9,21,0.429,11,14,0.786,82,2014-11-04,POR,CLE,2015,86.5
6596,6596,96,Home,W 101-98 ,240,39,85,0.459,30,58,0.517,9,27,0.333,14,16,0.875,101,40,88,0.455,35,69,0.507,5,19,0.263,13,13,1.0,98,2014-11-07,BOS,IND,2015,100.5
6597,6597,97,Home,L 101-110 ,240,40,85,0.471,29,56,0.518,11,29,0.379,10,15,0.667,101,40,84,0.476,34,61,0.557,6,23,0.261,24,33,0.727,110,2014-11-07,DEN,CLE,2015,113.0
6598,6598,98,Home,L 101-106 ,240,42,92,0.457,34,74,0.459,8,18,0.444,9,15,0.6,101,42,81,0.519,35,62,0.565,7,19,0.368,15,20,0.75,106,2014-11-08,CHI,BOS,2015,109.5
6599,6599,99,Home,W 101-93 ,240,36,78,0.462,30,60,0.5,6,18,0.333,23,27,0.852,101,36,80,0.45,30,56,0.536,6,24,0.25,15,22,0.682,93,2014-11-09,OKC,SAC,2015,96.0
6600,6600,0,Home,L 101-113 ,240,36,81,0.444,30,69,0.435,6,12,0.5,23,30,0.767,101,43,89,0.483,30,61,0.492,13,28,0.464,14,19,0.737,113,2014-11-12,MIN,HOU,2015,119.5
6601,6601,1,Home,W 101-85 ,240,35,80,0.438,25,56,0.446,10,24,0.417,21,27,0.778,101,36,80,0.45,34,61,0.557,2,19,0.105,11,14,0.786,85,2014-11-14,ORL,MIL,2015,86.0
6602,6602,2,@,W 101-90 ,240,41,83,0.494,35,63,0.556,6,20,0.3,13,21,0.619,101,34,86,0.395,27,65,0.415,7,21,0.333,15,21,0.714,90,2014-11-19,BOS,PHI,2015,93.5
6603,6603,3,Home,W 101-88 ,240,41,82,0.5,35,59,0.593,6,23,0.261,13,19,0.684,101,35,82,0.427,29,65,0.446,6,17,0.353,12,19,0.632,88,2014-11-21,GSW,UTA,2015,91.0
6604,6604,4,Home,L 101-113 ,240,37,90,0.411,31,73,0.425,6,17,0.353,21,27,0.778,101,40,81,0.494,32,55,0.582,8,26,0.308,25,30,0.833,113,2014-11-22,MIN,SAC,2015,117.0
6605,6605,5,@,W 101-94 (OT),265,34,90,0.378,24,53,0.453,10,37,0.27,23,38,0.605,101,33,89,0.371,30,65,0.462,3,24,0.125,25,34,0.735,94,2014-11-23,DEN,LAL,2015,95.5
6606,6606,6,Home,L 101-106 ,240,38,87,0.437,32,68,0.471,6,19,0.316,19,23,0.826,101,42,99,0.424,35,73,0.479,7,26,0.269,15,16,0.938,106,2014-11-28,CHA,GSW,2015,109.5
6607,6607,7,@,L 101-127 ,240,35,82,0.427,33,70,0.471,2,12,0.167,29,40,0.725,101,41,80,0.513,26,46,0.565,15,34,0.441,30,36,0.833,127,2014-12-01,MIN,LAC,2015,134.5
6608,6608,8,Home,L 101-103 ,240,36,84,0.429,29,66,0.439,7,18,0.389,22,30,0.733,101,41,87,0.471,32,61,0.525,9,26,0.346,12,17,0.706,103,2014-12-01,UTA,DEN,2015,107.5
6609,6609,9,Home,L 101-107 ,240,37,80,0.463,32,68,0.471,5,12,0.417,22,26,0.846,101,40,84,0.476,26,59,0.441,14,25,0.56,13,16,0.813,107,2014-12-05,MEM,SAS,2015,114.0
6610,6610,10,@,L 101-102 (OT),265,36,96,0.375,30,70,0.429,6,26,0.231,23,29,0.793,101,36,83,0.434,34,73,0.466,2,10,0.2,28,40,0.7,102,2014-12-05,IND,SAC,2015,103.0
6611,6611,11,Home,L 101-108 (OT),265,34,87,0.391,28,64,0.438,6,23,0.261,27,35,0.771,101,40,87,0.46,33,64,0.516,7,23,0.304,21,30,0.7,108,2014-12-06,DET,PHI,2015,111.5
6612,6612,12,@,L 101-123 ,240,35,83,0.422,29,67,0.433,6,16,0.375,25,32,0.781,101,47,82,0.573,40,64,0.625,7,18,0.389,22,25,0.88,123,2014-12-06,MIN,SAS,2015,126.5
6613,6613,13,Home,W 101-93 ,240,36,88,0.409,28,71,0.394,8,17,0.471,21,26,0.808,101,34,93,0.366,23,66,0.348,11,27,0.407,14,21,0.667,93,2014-12-07,BOS,WAS,2015,98.5
6614,6614,14,Home,W 101-92 ,240,35,74,0.473,32,66,0.485,3,8,0.375,28,36,0.778,101,32,79,0.405,29,62,0.468,3,17,0.176,25,37,0.676,92,2014-12-08,SAC,UTA,2015,93.5
6615,6615,15,@,L 101-105 ,240,42,82,0.512,35,59,0.593,7,23,0.304,10,10,1.0,101,39,79,0.494,30,53,0.566,9,26,0.346,18,21,0.857,105,2014-12-09,TOR,CLE,2015,109.5
6616,6616,16,@,L 101-114 ,240,34,84,0.405,30,63,0.476,4,21,0.19,29,35,0.829,101,41,82,0.5,37,61,0.607,4,21,0.19,28,34,0.824,114,2014-12-09,MIL,OKC,2015,116.0
6617,6617,17,@,W 101-95 ,240,40,81,0.494,34,65,0.523,6,16,0.375,15,18,0.833,101,37,85,0.435,30,63,0.476,7,22,0.318,14,18,0.778,95,2014-12-12,NYK,BOS,2015,98.5
6618,6618,18,@,W 101-94 ,240,39,73,0.534,35,62,0.565,4,11,0.364,19,24,0.792,101,37,83,0.446,25,61,0.41,12,22,0.545,8,12,0.667,94,2014-12-19,UTA,ORL,2015,100.0
6619,6619,19,@,W 101-99 ,240,43,90,0.478,36,70,0.514,7,20,0.35,8,10,0.8,101,38,83,0.458,33,63,0.524,5,20,0.25,18,24,0.75,99,2014-12-21,NOP,OKC,2015,101.5
6620,6620,20,@,L 101-108 ,240,33,87,0.379,23,61,0.377,10,26,0.385,25,30,0.833,101,38,79,0.481,31,56,0.554,7,23,0.304,25,36,0.694,108,2014-12-21,LAL,SAC,2015,111.5
6621,6621,21,Home,L 101-108 ,240,39,82,0.476,31,61,0.508,8,21,0.381,15,20,0.75,101,36,82,0.439,28,61,0.459,8,21,0.381,28,36,0.778,108,2014-12-23,MIL,CHO,2015,112.0
6622,6622,22,Home,W 101-91 ,240,40,84,0.476,33,63,0.524,7,21,0.333,14,17,0.824,101,32,72,0.444,26,46,0.565,6,26,0.231,21,33,0.636,91,2014-12-25,MIA,CLE,2015,94.0
6623,6623,23,Home,W 101-88 ,240,45,90,0.5,40,77,0.519,5,13,0.385,6,10,0.6,101,32,79,0.405,26,55,0.473,6,24,0.25,18,24,0.75,88,2014-12-27,WAS,BOS,2015,91.0
6624,6624,24,Home,W 101-79 ,240,38,81,0.469,22,45,0.489,16,36,0.444,9,12,0.75,101,31,93,0.333,24,66,0.364,7,27,0.259,10,15,0.667,79,2014-12-28,POR,NYK,2015,82.5
6625,6625,25,Home,W 101-97 ,240,37,81,0.457,27,58,0.466,10,23,0.435,17,22,0.773,101,38,92,0.413,30,73,0.411,8,19,0.421,13,22,0.591,97,2014-12-29,LAC,UTA,2015,101.0
6626,6626,26,Home,L 101-102 ,240,33,63,0.524,26,49,0.531,7,14,0.5,28,40,0.7,101,41,77,0.532,30,52,0.577,11,25,0.44,9,13,0.692,102,2014-12-29,MIA,ORL,2015,107.5
6627,6627,27,@,L 101-109 ,240,37,84,0.44,24,53,0.453,13,31,0.419,14,21,0.667,101,40,79,0.506,30,50,0.6,10,29,0.345,19,26,0.731,109,2014-12-30,CLE,ATL,2015,114.0
6628,6628,28,@,L 101-106 ,240,37,92,0.402,32,78,0.41,5,14,0.357,22,27,0.815,101,38,91,0.418,30,76,0.395,8,15,0.533,22,25,0.88,106,2015-01-01,DEN,CHI,2015,110.0
6629,6629,29,Home,L 101-119 ,240,38,89,0.427,26,55,0.473,12,34,0.353,13,19,0.684,101,45,96,0.469,32,69,0.464,13,27,0.481,16,17,0.941,119,2015-01-02,BOS,DAL,2015,125.5
6630,6630,30,@,W 101-89 ,240,38,75,0.507,27,55,0.491,11,20,0.55,14,21,0.667,101,34,86,0.395,28,67,0.418,6,19,0.316,15,18,0.833,89,2015-01-03,UTA,MIN,2015,92.0
6631,6631,31,Home,W 101-92 ,240,43,78,0.551,39,62,0.629,4,16,0.25,11,18,0.611,101,40,82,0.488,36,68,0.529,4,14,0.286,8,13,0.615,92,2015-01-03,SAS,WAS,2015,94.0
6632,6632,32,Home,L 101-110 ,240,38,89,0.427,28,65,0.431,10,24,0.417,15,18,0.833,101,46,84,0.548,39,65,0.6,7,19,0.368,11,16,0.688,110,2015-01-05,MIN,DEN,2015,113.5
6633,6633,33,Home,L 101-105 ,240,35,81,0.432,31,58,0.534,4,23,0.174,27,34,0.794,101,35,74,0.473,28,61,0.459,7,13,0.538,28,30,0.933,105,2015-01-05,UTA,IND,2015,108.5
6634,6634,34,Home,W 101-91 ,240,39,76,0.513,31,60,0.517,8,16,0.5,15,21,0.714,101,34,82,0.415,23,56,0.411,11,26,0.423,12,16,0.75,91,2015-01-07,WAS,NYK,2015,96.5
6635,6635,35,Home,W 101-84 ,240,36,90,0.4,29,69,0.42,7,21,0.333,22,31,0.71,101,30,76,0.395,24,62,0.387,6,14,0.429,18,23,0.783,84,2015-01-09,LAL,ORL,2015,87.0
6636,6636,36,Home,L 101-110 ,240,39,80,0.488,34,62,0.548,5,18,0.278,18,30,0.6,101,41,87,0.471,31,67,0.463,10,20,0.5,18,19,0.947,110,2015-01-13,IND,MIN,2015,115.0
6637,6637,37,Home,W 101-93 ,240,37,75,0.493,31,63,0.492,6,12,0.5,21,24,0.875,101,38,96,0.396,29,67,0.433,9,29,0.31,8,12,0.667,93,2015-01-13,WAS,SAS,2015,97.5
6638,6638,38,@,L 101-112 ,240,35,81,0.432,24,52,0.462,11,29,0.379,20,28,0.714,101,41,86,0.477,25,50,0.5,16,36,0.444,14,19,0.737,112,2015-01-15,OKC,HOU,2015,120.0
6639,6639,39,@,W 101-99 ,240,32,71,0.451,18,40,0.45,14,31,0.452,23,28,0.821,101,42,92,0.457,37,79,0.468,5,13,0.385,10,12,0.833,99,2015-01-22,UTA,MIL,2015,101.5
6640,6640,40,@,L 101-126 ,240,34,82,0.415,30,65,0.462,4,17,0.235,29,34,0.853,101,45,94,0.479,28,54,0.519,17,40,0.425,19,22,0.864,126,2015-01-23,SAC,GSW,2015,134.5
6641,6641,41,Home,W 101-83 ,240,37,79,0.468,31,65,0.477,6,14,0.429,21,25,0.84,101,31,81,0.383,22,57,0.386,9,24,0.375,12,22,0.545,83,2015-01-24,MEM,PHI,2015,87.5
6642,6642,42,Home,W 101-86 ,240,41,81,0.506,30,64,0.469,11,17,0.647,8,10,0.8,101,31,86,0.36,25,61,0.41,6,25,0.24,18,25,0.72,86,2015-01-24,MIL,DET,2015,89.0
6643,6643,43,Home,W 101-95 ,240,35,83,0.422,30,61,0.492,5,22,0.227,26,30,0.867,101,39,82,0.476,31,65,0.477,8,17,0.471,9,13,0.692,95,2015-01-25,SAS,MIL,2015,99.0
6644,6644,44,Home,W 101-90 ,240,38,80,0.475,27,49,0.551,11,31,0.355,14,22,0.636,101,30,84,0.357,27,66,0.409,3,18,0.167,27,32,0.844,90,2015-01-30,CLE,SAC,2015,91.5
6645,6645,45,@,L 101-114 ,240,39,87,0.448,28,55,0.509,11,32,0.344,12,19,0.632,101,41,82,0.5,31,57,0.544,10,25,0.4,22,35,0.629,114,2015-01-31,HOU,DET,2015,119.0
6646,6646,46,Home,L 101-102 ,240,42,84,0.5,36,68,0.529,6,16,0.375,11,18,0.611,101,36,83,0.434,33,72,0.458,3,11,0.273,27,34,0.794,102,2015-02-02,PHO,MEM,2015,103.5
6647,6647,47,Home,W 101-90 ,240,38,92,0.413,30,65,0.462,8,27,0.296,17,23,0.739,101,31,89,0.348,23,64,0.359,8,25,0.32,20,26,0.769,90,2015-02-04,HOU,CHI,2015,94.0
6648,6648,48,@,L 101-102 ,240,39,80,0.488,32,64,0.5,7,16,0.438,16,24,0.667,101,37,72,0.514,31,61,0.508,6,11,0.545,22,27,0.815,102,2015-02-04,MIA,MIN,2015,105.0
6649,6649,49,@,W 101-78 ,240,41,96,0.427,29,62,0.468,12,34,0.353,7,10,0.7,101,29,79,0.367,26,58,0.448,3,21,0.143,17,22,0.773,78,2015-02-05,DAL,SAC,2015,79.5
6650,6650,50,@,L 101-111 (OT),265,37,89,0.416,27,57,0.474,10,32,0.313,17,24,0.708,101,43,105,0.41,29,69,0.42,14,36,0.389,11,16,0.688,111,2015-02-07,POR,DAL,2015,118.0
6651,6651,51,Home,L 101-112 ,240,37,79,0.468,27,48,0.563,10,31,0.323,17,22,0.773,101,39,76,0.513,34,64,0.531,5,12,0.417,29,34,0.853,112,2015-02-08,DET,MIN,2015,114.5
6652,6652,52,@,L 101-109 ,240,40,100,0.4,34,78,0.436,6,22,0.273,15,26,0.577,101,40,83,0.482,32,61,0.525,8,22,0.364,21,26,0.808,109,2015-02-20,BOS,SAC,2015,113.0
6653,6653,53,@,W 101-83 ,240,40,79,0.506,28,46,0.609,12,33,0.364,9,15,0.6,101,37,99,0.374,34,80,0.425,3,19,0.158,6,7,0.857,83,2015-02-22,CLE,NYK,2015,84.5
6654,6654,54,Home,W 101-93 ,240,40,85,0.471,34,67,0.507,6,18,0.333,15,22,0.682,101,34,87,0.391,30,70,0.429,4,17,0.235,21,29,0.724,93,2015-02-27,LAL,MIL,2015,95.0
6655,6655,55,@,W 101-97 ,240,38,64,0.594,34,53,0.642,4,11,0.364,21,29,0.724,101,34,88,0.386,27,69,0.391,7,19,0.368,22,27,0.815,97,2015-02-28,MEM,MIN,2015,100.5
6656,6656,56,@,W 101-74 ,240,41,92,0.446,37,73,0.507,4,19,0.211,15,17,0.882,101,25,84,0.298,20,68,0.294,5,16,0.313,19,24,0.792,74,2015-02-28,SAS,PHO,2015,76.5
6657,6657,57,Home,L 101-106 ,240,40,109,0.367,32,78,0.41,8,31,0.258,13,17,0.765,101,40,95,0.421,28,61,0.459,12,34,0.353,14,17,0.824,106,2015-03-01,BOS,GSW,2015,112.0
6658,6658,58,Home,L 101-108 ,240,40,90,0.444,31,65,0.477,9,25,0.36,12,18,0.667,101,40,97,0.412,29,65,0.446,11,32,0.344,17,23,0.739,108,2015-03-01,LAL,OKC,2015,113.5
6659,6659,59,Home,L 101-108 ,240,39,89,0.438,36,75,0.48,3,14,0.214,20,25,0.8,101,41,79,0.519,35,62,0.565,6,17,0.353,20,23,0.87,108,2015-03-08,DET,CHO,2015,111.0
6660,6660,60,@,W 101-91 ,240,42,84,0.5,37,70,0.529,5,14,0.357,12,17,0.706,101,35,80,0.438,25,58,0.431,10,22,0.455,11,14,0.786,91,2015-03-09,MEM,CHI,2015,96.0
6661,6661,61,@,W 101-94 ,240,36,77,0.468,27,59,0.458,9,18,0.5,20,26,0.769,101,38,90,0.422,33,72,0.458,5,18,0.278,13,21,0.619,94,2015-03-12,NYK,LAL,2015,96.5
6662,6662,62,Home,W 101-91 ,240,33,89,0.371,26,70,0.371,7,19,0.368,28,33,0.848,101,31,82,0.378,16,50,0.32,15,32,0.469,14,19,0.737,91,2015-03-13,CHA,CHI,2015,98.5
6663,6663,63,Home,L 101-112 ,240,34,76,0.447,26,54,0.481,8,22,0.364,25,36,0.694,101,41,77,0.532,33,59,0.559,8,18,0.444,22,32,0.688,112,2015-03-20,DAL,MEM,2015,116.0
6664,6664,64,Home,W 101-91 ,240,37,78,0.474,28,57,0.491,9,21,0.429,18,25,0.72,101,36,91,0.396,30,73,0.411,6,18,0.333,13,16,0.813,91,2015-03-20,SAC,CHO,2015,94.0
6665,6665,65,Home,W 101-89 ,240,38,81,0.469,33,58,0.569,5,23,0.217,20,23,0.87,101,35,88,0.398,30,68,0.441,5,20,0.25,14,20,0.7,89,2015-03-20,SAS,BOS,2015,91.5
6666,6666,66,Home,W 101-87 ,240,39,81,0.481,34,67,0.507,5,14,0.357,18,22,0.818,101,32,89,0.36,23,62,0.371,9,27,0.333,14,21,0.667,87,2015-03-22,LAL,PHI,2015,91.5
6667,6667,67,Home,W 101-94 ,240,42,87,0.483,35,65,0.538,7,22,0.318,10,13,0.769,101,36,85,0.424,28,57,0.491,8,28,0.286,14,18,0.778,94,2015-03-24,DAL,SAS,2015,98.0
6668,6668,68,@,W 101-99 (OT),265,39,92,0.424,33,66,0.5,6,26,0.231,17,18,0.944,101,33,78,0.423,27,56,0.482,6,22,0.273,27,30,0.9,99,2015-03-25,LAL,MIN,2015,102.0
6669,6669,69,Home,L 101-103 ,240,33,75,0.44,28,61,0.459,5,14,0.357,30,38,0.789,101,38,85,0.447,29,59,0.492,9,26,0.346,18,28,0.643,103,2015-03-25,WAS,IND,2015,107.5
6670,6670,70,Home,W 101-88 ,240,36,79,0.456,27,50,0.54,9,29,0.31,20,24,0.833,101,34,75,0.453,30,58,0.517,4,17,0.235,16,23,0.696,88,2015-03-30,ATL,MIL,2015,90.0
6671,6671,71,Home,L 101-108 ,240,37,84,0.44,29,58,0.5,8,26,0.308,19,27,0.704,101,34,77,0.442,23,46,0.5,11,31,0.355,29,40,0.725,108,2015-04-02,DAL,HOU,2015,113.5
6672,6672,72,Home,L 101-110 ,240,39,88,0.443,31,64,0.484,8,24,0.333,15,16,0.938,101,45,85,0.529,36,61,0.59,9,24,0.375,11,18,0.611,110,2015-04-03,BOS,MIL,2015,114.5
6673,6673,73,@,W 101-95 ,240,34,87,0.391,20,58,0.345,14,29,0.483,19,28,0.679,101,37,78,0.474,31,61,0.508,6,17,0.353,15,25,0.6,95,2015-04-03,NOP,SAC,2015,98.0
6674,6674,74,Home,W 101-87 ,240,43,93,0.462,36,77,0.468,7,16,0.438,8,12,0.667,101,31,84,0.369,24,63,0.381,7,21,0.333,18,20,0.9,87,2015-04-03,WAS,NYK,2015,90.5
6675,6675,75,Home,W 101-91 ,240,37,72,0.514,34,59,0.576,3,13,0.231,24,29,0.828,101,38,99,0.384,28,67,0.418,10,32,0.313,5,8,0.625,91,2015-04-05,NYK,PHI,2015,96.0
6676,6676,76,@,W 101-95 ,240,40,87,0.46,32,63,0.508,8,24,0.333,13,18,0.722,101,38,79,0.481,33,64,0.516,5,15,0.333,14,24,0.583,95,2015-04-05,UTA,SAC,2015,97.5
6677,6677,77,@,L 101-119 ,240,36,75,0.48,31,59,0.525,5,16,0.313,24,35,0.686,101,44,88,0.5,31,58,0.534,13,30,0.433,18,24,0.75,119,2015-04-08,LAL,DEN,2015,125.5
6678,6678,78,@,W 101-99 ,240,39,94,0.415,30,64,0.469,9,30,0.3,14,15,0.933,101,41,89,0.461,34,69,0.493,7,20,0.35,10,10,1.0,99,2015-04-10,TOR,ORL,2015,102.5
6679,6679,79,@,L 101-110 ,240,35,79,0.443,24,55,0.436,11,24,0.458,20,26,0.769,101,42,93,0.452,31,62,0.5,11,31,0.355,15,21,0.714,110,2015-04-11,MIN,GSW,2015,115.5
6680,6680,80,Home,W 101-90 ,240,39,96,0.406,35,75,0.467,4,21,0.19,19,27,0.704,101,38,83,0.458,30,60,0.5,8,23,0.348,6,9,0.667,90,2015-04-13,OKC,POR,2015,94.0
6681,6681,81,Home,L 101-112 ,240,39,80,0.488,28,54,0.519,11,26,0.423,12,20,0.6,101,42,87,0.483,27,49,0.551,15,38,0.395,13,18,0.722,112,2015-04-14,PHO,LAC,2015,119.5
6682,6682,82,Home,W 101-88 ,240,39,80,0.488,30,56,0.536,9,24,0.375,14,23,0.609,101,38,79,0.481,31,59,0.525,7,20,0.35,5,13,0.385,88,2015-04-15,BRK,ORL,2015,91.5
6683,6683,83,Home,L 101-105 ,240,38,83,0.458,33,54,0.611,5,29,0.172,20,25,0.8,101,39,89,0.438,27,58,0.466,12,31,0.387,15,20,0.75,105,2015-04-15,PHI,MIA,2015,111.0
6684,6684,84,Home,L 101-112 ,240,38,93,0.409,32,64,0.5,6,29,0.207,19,21,0.905,101,42,83,0.506,32,59,0.542,10,24,0.417,18,26,0.692,112,2015-10-29,NYK,ATL,2016,117.0
6685,6685,85,Home,W 101-91 ,240,34,80,0.425,25,57,0.439,9,23,0.391,24,28,0.857,101,38,79,0.481,35,66,0.53,3,13,0.231,12,18,0.667,91,2015-10-31,MEM,BRK,2016,92.5
6686,6686,86,@,W 101-90 ,240,39,94,0.415,28,62,0.452,11,32,0.344,12,16,0.75,101,33,79,0.418,25,49,0.51,8,30,0.267,16,28,0.571,90,2015-10-31,PHO,POR,2016,94.0
6687,6687,87,Home,L 101-106 ,240,34,79,0.43,31,66,0.47,3,13,0.231,30,39,0.769,101,41,89,0.461,32,59,0.542,9,30,0.3,15,20,0.75,106,2015-11-02,MIN,POR,2016,110.5
6688,6688,88,Home,W 101-87 ,240,37,76,0.487,29,54,0.537,8,22,0.364,19,24,0.792,101,36,83,0.434,31,62,0.5,5,21,0.238,10,13,0.769,87,2015-11-04,ATL,BRK,2016,89.5
6689,6689,89,Home,W 101-97 ,240,38,83,0.458,30,59,0.508,8,24,0.333,17,25,0.68,101,39,90,0.433,33,72,0.458,6,18,0.333,13,19,0.684,97,2015-11-08,CLE,IND,2016,100.0
6690,6690,90,Home,W 101-88 ,240,38,84,0.452,33,64,0.516,5,20,0.25,20,27,0.741,101,34,77,0.442,23,55,0.418,11,22,0.5,9,12,0.75,88,2015-11-10,MIA,LAL,2016,93.5
6691,6691,91,Home,L 101-125 ,240,38,97,0.392,33,73,0.452,5,24,0.208,20,26,0.769,101,44,86,0.512,29,63,0.46,15,23,0.652,22,29,0.759,125,2015-11-10,WAS,OKC,2016,132.5
6692,6692,92,Home,W 101-99 ,240,40,100,0.4,27,72,0.375,13,28,0.464,8,12,0.667,101,39,79,0.494,32,57,0.561,7,22,0.318,14,18,0.778,99,2015-11-11,ORL,LAL,2016,102.5
6693,6693,93,Home,L 101-113 ,240,39,88,0.443,30,66,0.455,9,22,0.409,14,23,0.609,101,46,82,0.561,39,67,0.582,7,15,0.467,14,18,0.778,113,2015-11-11,POR,SAS,2016,116.5
6694,6694,94,Home,W 101-92 ,240,37,74,0.5,28,58,0.483,9,16,0.563,18,24,0.75,101,34,89,0.382,25,57,0.439,9,32,0.281,15,20,0.75,92,2015-11-11,SAC,DET,2016,96.5
6695,6695,95,Home,W 101-100 ,240,36,86,0.419,30,70,0.429,6,16,0.375,23,27,0.852,101,33,69,0.478,25,47,0.532,8,22,0.364,26,29,0.897,100,2015-11-13,MEM,POR,2016,104.0
6696,6696,96,Home,W 101-96 ,240,37,79,0.468,30,60,0.5,7,19,0.368,20,26,0.769,101,33,74,0.446,26,47,0.553,7,27,0.259,23,35,0.657,96,2015-11-14,LAC,DET,2016,99.5
6697,6697,97,@,L 101-107 ,240,38,87,0.437,23,56,0.411,15,31,0.484,10,14,0.714,101,39,76,0.513,29,51,0.569,10,25,0.4,19,24,0.792,107,2015-11-15,TOR,SAC,2016,112.0
6698,6698,98,@,L 101-120 ,240,37,77,0.481,28,57,0.491,9,20,0.45,18,20,0.9,101,45,93,0.484,34,63,0.54,11,30,0.367,19,25,0.76,120,2015-11-16,LAL,PHO,2016,125.5
6699,6699,99,@,L 101-104 (OT),265,36,85,0.424,32,67,0.478,4,18,0.222,25,30,0.833,101,41,110,0.373,32,89,0.36,9,21,0.429,13,21,0.619,104,2015-11-18,MIN,ORL,2016,108.5
6700,6700,0,@,L 101-111 ,240,35,82,0.427,21,45,0.467,14,37,0.378,17,21,0.81,101,40,79,0.506,35,64,0.547,5,15,0.333,26,33,0.788,111,2015-11-22,BOS,BRK,2016,113.5
6701,6701,1,Home,W 101-87 ,240,39,83,0.47,31,57,0.544,8,26,0.308,15,15,1.0,101,31,87,0.356,21,55,0.382,10,32,0.313,15,18,0.833,87,2015-11-25,CHA,WAS,2016,92.0
6702,6702,2,Home,L 101-116 ,240,35,80,0.438,23,50,0.46,12,30,0.4,19,21,0.905,101,35,75,0.467,21,36,0.583,14,39,0.359,32,36,0.889,116,2015-11-27,MEM,ATL,2016,123.0
6703,6703,3,@,W 101-91 ,240,37,77,0.481,28,52,0.538,9,25,0.36,18,19,0.947,101,37,86,0.43,29,64,0.453,8,22,0.364,9,15,0.6,91,2015-11-27,MIN,SAC,2016,95.0
6704,6704,4,@,L 101-120 ,240,39,100,0.39,29,75,0.387,10,25,0.4,13,15,0.867,101,39,80,0.488,23,50,0.46,16,30,0.533,26,31,0.839,120,2015-11-28,SAC,GSW,2016,128.0
6705,6705,5,Home,W 101-87 ,240,38,82,0.463,29,64,0.453,9,18,0.5,16,21,0.762,101,29,69,0.42,24,52,0.462,5,17,0.294,24,30,0.8,87,2015-11-28,UTA,NOP,2016,89.5
6706,6706,6,@,L 101-108 ,240,36,88,0.409,29,63,0.46,7,25,0.28,22,25,0.88,101,36,87,0.414,28,60,0.467,8,27,0.296,28,39,0.718,108,2015-12-02,NOP,HOU,2016,112.0
6707,6707,7,@,L 101-103 ,240,40,90,0.444,34,70,0.486,6,20,0.3,15,18,0.833,101,37,82,0.451,25,51,0.49,12,31,0.387,17,25,0.68,103,2015-12-05,ORL,LAC,2016,109.0
6708,6708,8,Home,L 101-103 ,240,41,90,0.456,35,69,0.507,6,21,0.286,13,18,0.722,101,41,92,0.446,34,75,0.453,7,17,0.412,14,17,0.824,103,2015-12-07,CHI,PHO,2016,106.5
6709,6709,9,@,L 101-108 ,240,33,73,0.452,25,54,0.463,8,19,0.421,27,34,0.794,101,39,87,0.448,29,57,0.509,10,30,0.333,20,24,0.833,108,2015-12-13,MIN,PHO,2016,113.0
6710,6710,10,@,L 101-105 ,240,36,82,0.439,28,57,0.491,8,25,0.32,21,27,0.778,101,35,81,0.432,22,49,0.449,13,32,0.406,22,29,0.759,105,2015-12-14,NOP,POR,2016,111.5
6711,6711,11,Home,L 101-109 ,240,34,77,0.442,24,54,0.444,10,23,0.435,23,31,0.742,101,41,88,0.466,37,68,0.544,4,20,0.2,23,29,0.793,109,2015-12-18,BOS,ATL,2016,111.0
6712,6712,12,@,L 101-109 ,240,39,93,0.419,29,60,0.483,10,33,0.303,13,16,0.813,101,40,79,0.506,31,59,0.525,9,20,0.45,20,23,0.87,109,2015-12-19,CHA,WAS,2016,113.5
6713,6713,13,@,W 101-95 ,240,41,79,0.519,36,63,0.571,5,16,0.313,14,24,0.583,101,33,74,0.446,25,56,0.446,8,18,0.444,21,24,0.875,95,2015-12-20,MIL,PHO,2016,99.0
6714,6714,14,@,L 101-104 ,240,41,83,0.494,34,54,0.63,7,29,0.241,12,17,0.706,101,44,84,0.524,37,68,0.544,7,16,0.438,9,13,0.692,104,2015-12-23,HOU,ORL,2016,107.5
6715,6715,15,Home,L 101-108 ,240,43,79,0.544,34,60,0.567,9,19,0.474,6,13,0.462,101,38,77,0.494,28,57,0.491,10,20,0.5,22,23,0.957,108,2015-12-26,ORL,MIA,2016,113.0
6716,6716,16,Home,W 101-86 ,240,39,81,0.481,32,71,0.451,7,10,0.7,16,17,0.941,101,38,86,0.442,33,68,0.485,5,18,0.278,5,6,0.833,86,2015-12-26,SAS,DEN,2016,88.5
6717,6717,17,@,W 101-97 ,240,33,71,0.465,16,30,0.533,17,41,0.415,18,25,0.72,101,36,79,0.456,25,54,0.463,11,25,0.44,14,20,0.7,97,2015-12-28,CLE,PHO,2016,102.5
6718,6718,18,Home,W 101-95 ,240,37,72,0.514,32,55,0.582,5,17,0.294,22,28,0.786,101,39,82,0.476,36,71,0.507,3,11,0.273,14,24,0.583,95,2015-12-28,SAS,MIN,2016,96.5
6719,6719,19,@,L 101-111 ,240,38,86,0.442,31,65,0.477,7,21,0.333,18,19,0.947,101,45,87,0.517,30,53,0.566,15,34,0.441,6,6,1.0,111,2016-01-04,CHA,GSW,2016,118.5
6720,6720,20,Home,L 101-107 ,240,37,87,0.425,22,48,0.458,15,39,0.385,12,19,0.632,101,40,84,0.476,35,66,0.53,5,18,0.278,22,24,0.917,107,2016-01-05,ATL,NYK,2016,109.5
6721,6721,21,Home,W 101-92 ,240,39,94,0.415,30,72,0.417,9,22,0.409,14,17,0.824,101,35,98,0.357,30,73,0.411,5,25,0.2,17,22,0.773,92,2016-01-07,CHI,BOS,2016,94.5
6722,6722,22,Home,W 101-98 ,240,31,84,0.369,27,68,0.397,4,16,0.25,35,40,0.875,101,37,88,0.42,30,66,0.455,7,22,0.318,17,23,0.739,98,2016-01-10,MEM,BOS,2016,101.5
6723,6723,23,@,L 101-106 ,240,35,85,0.412,23,56,0.411,12,29,0.414,19,24,0.792,101,43,93,0.462,40,80,0.5,3,13,0.231,17,28,0.607,106,2016-01-12,CHI,MIL,2016,107.5
6724,6724,24,@,W 101-96 ,240,39,84,0.464,30,62,0.484,9,22,0.409,14,18,0.778,101,36,81,0.444,29,63,0.46,7,18,0.389,17,23,0.739,96,2016-01-12,OKC,MIN,2016,99.5
6725,6725,25,@,L 101-106 ,240,38,72,0.528,37,64,0.578,1,8,0.125,24,34,0.706,101,38,84,0.452,26,57,0.456,12,27,0.444,18,24,0.75,106,2016-01-13,MIL,WAS,2016,112.0
6726,6726,26,@,L 101-103 ,240,37,72,0.514,22,40,0.55,15,32,0.469,12,17,0.706,101,37,76,0.487,28,60,0.467,9,16,0.563,20,25,0.8,103,2016-01-14,DET,MEM,2016,107.5
6727,6727,27,Home,L 101-103 ,240,35,83,0.422,29,49,0.592,6,34,0.176,25,34,0.735,101,34,74,0.459,29,63,0.46,5,11,0.455,30,42,0.714,103,2016-01-14,UTA,SAC,2016,105.5
6728,6728,28,@,L 101-108 (OT),265,43,100,0.43,34,70,0.486,9,30,0.3,6,6,1.0,101,40,96,0.417,37,86,0.43,3,10,0.3,25,37,0.676,108,2016-01-15,ATL,MIL,2016,109.5
6729,6729,29,Home,L 101-111 ,240,42,95,0.442,37,69,0.536,5,26,0.192,12,20,0.6,101,44,84,0.524,35,63,0.556,9,21,0.429,14,20,0.7,111,2016-01-18,DET,CHI,2016,115.5
6730,6730,30,Home,W 101-99 ,240,35,75,0.467,27,56,0.482,8,19,0.421,23,30,0.767,101,36,74,0.486,30,55,0.545,6,19,0.316,21,23,0.913,99,2016-01-18,MEM,NOP,2016,102.0
6731,6731,31,Home,L 101-102 ,240,36,80,0.45,27,50,0.54,9,30,0.3,20,26,0.769,101,36,72,0.5,30,51,0.588,6,21,0.286,24,29,0.828,102,2016-01-21,DEN,MEM,2016,105.0
6732,6732,32,@,L 101-110 ,240,38,89,0.427,35,76,0.461,3,13,0.231,22,26,0.846,101,43,96,0.448,35,73,0.479,8,23,0.348,16,21,0.762,110,2016-01-22,CHI,BOS,2016,114.0
6733,6733,33,Home,W 101-81 ,240,35,75,0.467,22,50,0.44,13,25,0.52,18,21,0.857,101,33,81,0.407,29,64,0.453,4,17,0.235,11,17,0.647,81,2016-01-22,TOR,MIA,2016,83.0
6734,6734,34,@,L 101-104 ,240,40,84,0.476,29,55,0.527,11,29,0.379,10,19,0.526,101,36,78,0.462,28,56,0.5,8,22,0.364,24,29,0.828,104,2016-01-23,DET,DEN,2016,108.0
6735,6735,35,@,L 101-106 ,240,37,79,0.468,28,60,0.467,9,19,0.474,18,22,0.818,101,34,68,0.5,29,51,0.569,5,17,0.294,33,36,0.917,106,2016-01-23,MEM,MIN,2016,108.5
6736,6736,36,@,W 101-82 ,240,36,96,0.375,23,60,0.383,13,36,0.361,16,26,0.615,101,27,80,0.338,19,51,0.373,8,29,0.276,20,23,0.87,82,2016-01-31,CHA,LAL,2016,86.0
6737,6737,37,@,W 101-96 ,240,37,86,0.43,32,65,0.492,5,21,0.238,22,28,0.786,101,37,84,0.44,29,62,0.468,8,22,0.364,14,20,0.7,96,2016-02-07,DEN,NYK,2016,100.0
6738,6738,38,Home,L 101-119 ,240,40,70,0.571,36,58,0.621,4,12,0.333,17,24,0.708,101,47,89,0.528,41,75,0.547,6,14,0.429,19,26,0.731,119,2016-02-09,MIA,SAS,2016,122.0
6739,6739,39,@,W 101-98 ,240,39,88,0.443,30,66,0.455,9,22,0.409,14,22,0.636,101,42,96,0.438,37,70,0.529,5,26,0.192,9,10,0.9,98,2016-02-19,IND,OKC,2016,100.5
6740,6740,40,Home,L 101-121 ,240,34,73,0.466,28,52,0.538,6,21,0.286,27,34,0.794,101,47,97,0.485,37,65,0.569,10,32,0.313,17,20,0.85,121,2016-02-21,DEN,BOS,2016,126.0
6741,6741,41,Home,W 101-93 (OT),265,38,100,0.38,36,87,0.414,2,13,0.154,23,34,0.676,101,36,92,0.391,31,77,0.403,5,15,0.333,16,25,0.64,93,2016-02-22,MIA,IND,2016,95.5
6742,6742,42,@,L 101-108 ,240,28,76,0.368,16,47,0.34,12,29,0.414,33,43,0.767,101,44,86,0.512,39,70,0.557,5,16,0.313,15,25,0.6,108,2016-02-22,LAL,MIL,2016,110.5
6743,6743,43,Home,W 101-89 ,240,39,96,0.406,34,80,0.425,5,16,0.313,18,22,0.818,101,36,87,0.414,35,74,0.473,1,13,0.077,16,23,0.696,89,2016-02-27,BOS,MIA,2016,89.5
6744,6744,44,@,L 101-128 ,240,34,90,0.378,27,67,0.403,7,23,0.304,26,37,0.703,101,47,89,0.528,34,53,0.642,13,36,0.361,21,21,1.0,128,2016-02-28,MIN,DAL,2016,134.5
6745,6745,45,@,L 101-114 ,240,39,80,0.488,29,59,0.492,10,21,0.476,13,18,0.722,101,41,71,0.577,29,48,0.604,12,23,0.522,20,27,0.741,114,2016-02-28,TOR,DET,2016,120.0
6746,6746,46,@,L 101-107 ,240,39,89,0.438,34,71,0.479,5,18,0.278,18,27,0.667,101,41,83,0.494,30,57,0.526,11,26,0.423,14,21,0.667,107,2016-03-01,BRK,LAL,2016,112.5
6747,6747,47,Home,L 101-104 ,240,45,94,0.479,38,65,0.585,7,29,0.241,4,6,0.667,101,42,80,0.525,35,55,0.636,7,25,0.28,13,24,0.542,104,2016-03-03,DAL,SAC,2016,107.5
6748,6748,48,@,L 101-108 ,240,37,90,0.411,28,62,0.452,9,28,0.321,18,21,0.857,101,38,79,0.481,25,48,0.521,13,31,0.419,19,23,0.826,108,2016-03-04,IND,CHO,2016,114.5
6749,6749,49,@,L 101-116 ,240,42,87,0.483,35,65,0.538,7,22,0.318,10,14,0.714,101,43,83,0.518,29,59,0.492,14,24,0.583,16,20,0.8,116,2016-03-04,MIN,MIL,2016,123.0
6750,6750,50,@,L 101-109 ,240,39,86,0.453,28,64,0.438,11,22,0.5,12,13,0.923,101,44,93,0.473,38,76,0.5,6,17,0.353,15,19,0.789,109,2016-03-10,CHI,SAS,2016,112.0
6751,6751,51,Home,W 101-94 ,240,38,85,0.447,25,56,0.446,13,29,0.448,12,16,0.75,101,34,83,0.41,30,63,0.476,4,20,0.2,22,25,0.88,94,2016-03-11,LAC,NYK,2016,96.0
6752,6752,52,@,W 101-94 (OT),265,32,88,0.364,25,66,0.379,7,22,0.318,30,38,0.789,101,35,91,0.385,27,63,0.429,8,28,0.286,16,23,0.696,94,2016-03-17,TOR,IND,2016,98.0
6753,6753,53,@,W 101-93 ,240,38,87,0.437,29,69,0.42,9,18,0.5,16,23,0.696,101,35,83,0.422,26,51,0.51,9,32,0.281,14,20,0.7,93,2016-03-19,DEN,CHO,2016,97.5
6754,6754,54,@,L 101-122 ,240,40,76,0.526,30,52,0.577,10,24,0.417,11,13,0.846,101,46,84,0.548,35,65,0.538,11,19,0.579,19,23,0.826,122,2016-03-19,CLE,MIA,2016,127.5
6755,6755,55,Home,L 101-122 ,240,39,92,0.424,27,62,0.435,12,30,0.4,11,12,0.917,101,45,84,0.536,28,42,0.667,17,42,0.405,15,22,0.682,122,2016-03-23,WAS,ATL,2016,130.5
6756,6756,56,Home,W 101-90 ,240,41,97,0.423,36,65,0.554,5,32,0.156,14,17,0.824,101,35,84,0.417,32,71,0.451,3,13,0.231,17,26,0.654,90,2016-03-25,ATL,MIL,2016,91.5
6757,6757,57,@,L 101-104 ,240,38,85,0.447,31,52,0.596,7,33,0.212,18,27,0.667,101,41,87,0.471,32,61,0.525,9,26,0.346,13,20,0.65,104,2016-03-27,HOU,IND,2016,108.5
6758,6758,58,@,W 101-88 ,240,39,72,0.542,32,54,0.593,7,18,0.389,16,29,0.552,101,33,87,0.379,26,59,0.441,7,28,0.25,15,17,0.882,88,2016-03-27,WAS,LAL,2016,91.5
6759,6759,59,@,W 101-87 ,240,37,72,0.514,32,57,0.561,5,15,0.333,22,30,0.733,101,33,83,0.398,27,64,0.422,6,19,0.316,15,24,0.625,87,2016-03-28,SAS,MEM,2016,90.0
6760,6760,60,Home,W 101-95 ,240,40,90,0.444,27,61,0.443,13,29,0.448,8,9,0.889,101,36,83,0.434,26,56,0.464,10,27,0.37,13,17,0.765,95,2016-03-31,NOP,DEN,2016,100.0
6761,6761,61,@,W 101-86 ,240,39,81,0.481,29,54,0.537,10,27,0.37,13,17,0.765,101,33,78,0.423,25,51,0.49,8,27,0.296,12,19,0.632,86,2016-04-03,UTA,PHO,2016,90.0
6762,6762,62,@,L 101-112 ,240,39,80,0.488,32,64,0.5,7,16,0.438,16,23,0.696,101,45,83,0.542,33,58,0.569,12,25,0.48,10,11,0.909,112,2016-04-07,SAS,GSW,2016,118.0
6763,6763,63,Home,L 101-105 ,240,41,100,0.41,36,78,0.462,5,22,0.227,14,17,0.824,101,41,83,0.494,35,66,0.53,6,17,0.353,17,28,0.607,105,2016-04-11,PHO,SAC,2016,108.0
6764,6764,64,@,W 101-92 ,240,36,81,0.444,25,49,0.51,11,32,0.344,18,22,0.818,101,35,77,0.455,26,44,0.591,9,33,0.273,13,18,0.722,92,2016-04-11,DAL,UTA,2016,96.5
6765,6765,65,Home,W 101-96 ,240,41,85,0.482,35,60,0.583,6,25,0.24,13,15,0.867,101,39,83,0.47,30,53,0.566,9,30,0.3,9,15,0.6,96,2016-04-13,LAL,UTA,2016,100.5
6766,6766,66,@,L 101-118 ,240,43,88,0.489,36,70,0.514,7,18,0.389,8,9,0.889,101,45,86,0.523,36,65,0.554,9,21,0.429,19,21,0.905,118,2016-10-29,IND,CHI,2017,122.5
6767,6767,67,Home,L 101-103 ,240,40,81,0.494,31,61,0.508,9,20,0.45,12,16,0.75,101,42,93,0.452,36,68,0.529,6,25,0.24,13,17,0.765,103,2016-11-01,PHI,ORL,2017,106.0
6768,6768,68,@,L 101-109 ,240,37,88,0.42,28,63,0.444,9,25,0.36,18,21,0.857,101,41,76,0.539,28,49,0.571,13,27,0.481,14,17,0.824,109,2016-11-02,DET,BRK,2017,115.5
6769,6769,69,Home,L 101-102 ,240,40,87,0.46,26,49,0.531,14,38,0.368,7,12,0.583,101,37,91,0.407,23,53,0.434,14,38,0.368,14,18,0.778,102,2016-11-05,PHI,CLE,2017,109.0
6770,6770,70,@,W 101-99 ,240,37,78,0.474,27,48,0.563,10,30,0.333,17,22,0.773,101,33,84,0.393,26,61,0.426,7,23,0.304,26,30,0.867,99,2016-11-09,HOU,SAS,2017,102.5
6771,6771,71,Home,L 101-125 ,240,38,94,0.404,25,58,0.431,13,36,0.361,12,17,0.706,101,46,85,0.541,32,55,0.582,14,30,0.467,19,20,0.95,125,2016-11-10,DEN,GSW,2017,132.0
6772,6772,72,@,W 101-91 ,240,38,74,0.514,29,47,0.617,9,27,0.333,16,22,0.727,101,34,85,0.4,26,64,0.406,8,21,0.381,15,20,0.75,91,2016-11-10,LAL,SAC,2017,95.0
6773,6773,73,@,L 101-113 ,240,33,88,0.375,21,54,0.389,12,34,0.353,23,26,0.885,101,45,82,0.549,36,58,0.621,9,24,0.375,14,20,0.7,113,2016-11-18,POR,NOP,2017,117.5
6774,6774,74,Home,W 101-94 ,240,37,78,0.474,26,52,0.5,11,26,0.423,16,20,0.8,101,34,88,0.386,27,57,0.474,7,31,0.226,19,28,0.679,94,2016-11-21,PHI,MIA,2017,97.5
6775,6775,75,@,L 101-106 ,240,39,91,0.429,28,64,0.438,11,27,0.407,12,15,0.8,101,37,91,0.407,27,63,0.429,10,28,0.357,22,34,0.647,106,2016-11-21,PHO,WAS,2017,111.0
6776,6776,76,@,L 101-116 ,240,32,76,0.421,25,51,0.49,7,25,0.28,30,38,0.789,101,44,94,0.468,32,66,0.485,12,28,0.429,16,17,0.941,116,2016-11-23,OKC,SAC,2017,122.0
6777,6777,77,Home,W 101-95 (OT),265,35,85,0.412,25,60,0.417,10,25,0.4,21,26,0.808,101,38,93,0.409,35,72,0.486,3,21,0.143,16,26,0.615,95,2016-11-28,WAS,SAC,2017,96.5
6778,6778,78,@,L 101-118 ,240,32,75,0.427,18,36,0.5,14,39,0.359,23,31,0.742,101,46,86,0.535,39,67,0.582,7,19,0.368,19,23,0.826,118,2016-11-29,CLE,MIL,2017,121.5
6779,6779,79,@,L 101-120 ,240,37,91,0.407,26,61,0.426,11,30,0.367,16,22,0.727,101,41,74,0.554,26,46,0.565,15,28,0.536,23,27,0.852,120,2016-11-29,HOU,UTA,2017,127.5
6780,6780,80,Home,W 101-92 ,240,41,89,0.461,35,61,0.574,6,28,0.214,13,26,0.5,101,36,98,0.367,30,70,0.429,6,28,0.214,14,19,0.737,92,2016-12-04,OKC,NOP,2017,95.0
6781,6781,81,Home,L 101-109 ,240,37,89,0.416,24,53,0.453,13,36,0.361,14,18,0.778,101,40,79,0.506,37,61,0.607,3,18,0.167,26,28,0.929,109,2016-12-05,DAL,CHO,2017,110.5
6782,6782,82,Home,L 101-107 ,240,39,87,0.448,34,73,0.466,5,14,0.357,18,23,0.783,101,38,80,0.475,25,48,0.521,13,32,0.406,18,29,0.621,107,2016-12-05,LAL,UTA,2017,113.5
6783,6783,83,@,W 101-94 ,240,34,82,0.415,25,62,0.403,9,20,0.45,24,27,0.889,101,31,83,0.373,14,41,0.341,17,42,0.405,15,22,0.682,94,2016-12-09,TOR,BOS,2017,102.5
6784,6784,84,@,L 101-130 ,240,36,87,0.414,29,60,0.483,7,27,0.259,22,25,0.88,101,50,94,0.532,36,68,0.529,14,26,0.538,16,18,0.889,130,2016-12-10,BRK,SAS,2017,137.0
6785,6785,85,@,L 101-112 ,240,39,84,0.464,34,61,0.557,5,23,0.217,18,22,0.818,101,45,88,0.511,36,62,0.581,9,26,0.346,13,19,0.684,112,2016-12-12,WAS,MIA,2017,116.5
6786,6786,86,@,L 101-108 ,240,37,84,0.44,27,53,0.509,10,31,0.323,17,20,0.85,101,44,80,0.55,36,58,0.621,8,22,0.364,12,14,0.857,108,2016-12-14,BOS,SAS,2017,112.0
6787,6787,87,@,L 101-114 ,240,39,90,0.433,31,68,0.456,8,22,0.364,15,20,0.75,101,41,81,0.506,34,65,0.523,7,16,0.438,25,34,0.735,114,2016-12-17,PHO,OKC,2017,117.5
6788,6788,88,Home,L 101-117 ,240,38,86,0.442,25,51,0.49,13,35,0.371,12,16,0.75,101,47,104,0.452,35,67,0.522,12,37,0.324,11,14,0.786,117,2016-12-22,BRK,GSW,2017,123.0
6789,6789,89,@,L 101-106 ,240,37,92,0.402,31,73,0.425,6,19,0.316,21,25,0.84,101,39,83,0.47,28,55,0.509,11,28,0.393,17,22,0.773,106,2016-12-22,SAS,LAC,2017,111.5
6790,6790,90,Home,W 101-99 ,240,35,88,0.398,32,75,0.427,3,13,0.231,28,29,0.966,101,37,86,0.43,24,53,0.453,13,33,0.394,12,16,0.75,99,2016-12-28,CHI,BRK,2017,105.5
6791,6791,91,Home,L 101-120 ,240,42,86,0.488,33,52,0.635,9,34,0.265,8,10,0.8,101,46,84,0.548,36,60,0.6,10,24,0.417,18,19,0.947,120,2016-12-28,ORL,CHO,2017,125.0
6792,6792,92,@,W 101-89 ,240,38,77,0.494,24,46,0.522,14,31,0.452,11,14,0.786,101,32,68,0.471,25,49,0.51,7,19,0.368,18,25,0.72,89,2016-12-29,DAL,LAL,2017,92.5
6793,6793,93,@,L 101-111 ,240,35,84,0.417,29,61,0.475,6,23,0.261,25,31,0.806,101,39,81,0.481,32,62,0.516,7,19,0.368,26,30,0.867,111,2016-12-30,CHI,IND,2017,114.5
6794,6794,94,@,W 101-89 ,240,39,93,0.419,32,69,0.464,7,24,0.292,16,20,0.8,101,33,78,0.423,27,51,0.529,6,27,0.222,17,23,0.739,89,2017-01-02,UTA,BRK,2017,92.0
6795,6795,95,Home,W 101-91 ,240,37,86,0.43,25,47,0.532,12,39,0.308,15,21,0.714,101,38,87,0.437,32,61,0.525,6,26,0.231,9,12,0.75,91,2017-01-02,HOU,WAS,2017,94.0
6796,6796,96,Home,W 101-93 ,240,36,91,0.396,28,70,0.4,8,21,0.381,21,28,0.75,101,34,73,0.466,27,53,0.509,7,20,0.35,18,21,0.857,93,2017-01-05,TOR,UTA,2017,96.5
6797,6797,97,Home,L 101-107 ,240,37,80,0.463,28,57,0.491,9,23,0.391,18,20,0.9,101,41,84,0.488,31,52,0.596,10,32,0.313,15,18,0.833,107,2017-01-08,MIL,WAS,2017,112.0
6798,6798,98,Home,W 101-92 ,240,40,71,0.563,34,55,0.618,6,16,0.375,15,21,0.714,101,36,78,0.462,23,50,0.46,13,28,0.464,7,9,0.778,92,2017-01-09,MIN,DAL,2017,98.5
6799,6799,99,Home,W 101-99 ,240,42,83,0.506,31,61,0.508,11,22,0.5,6,9,0.667,101,35,88,0.398,25,61,0.41,10,27,0.37,19,21,0.905,99,2017-01-10,WAS,CHI,2017,104.0
6800,6800,0,Home,L 101-103 ,240,36,84,0.429,25,54,0.463,11,30,0.367,18,21,0.857,101,36,83,0.434,19,39,0.487,17,44,0.386,14,19,0.737,103,2017-01-13,ATL,BOS,2017,111.5
6801,6801,1,@,L 101-116 ,240,35,84,0.417,23,55,0.418,12,29,0.414,19,27,0.704,101,44,89,0.494,36,67,0.537,8,22,0.364,20,23,0.87,116,2017-01-15,NYK,TOR,2017,120.0
6802,6802,2,Home,L 101-106 ,240,40,81,0.494,35,59,0.593,5,22,0.227,16,17,0.941,101,41,89,0.461,33,66,0.5,8,23,0.348,16,24,0.667,106,2017-01-16,PHO,UTA,2017,110.0
6803,6803,3,@,L 101-120 ,240,37,88,0.42,29,62,0.468,8,26,0.308,19,25,0.76,101,42,86,0.488,29,63,0.46,13,23,0.565,23,25,0.92,120,2017-01-16,POR,WAS,2017,126.5
6804,6804,4,@,L 101-104 ,240,33,83,0.398,25,58,0.431,8,25,0.32,27,34,0.794,101,36,80,0.45,28,51,0.549,8,29,0.276,24,26,0.923,104,2017-01-18,MEM,WAS,2017,108.0
6805,6805,5,Home,L 101-104 ,240,42,87,0.483,38,65,0.585,4,22,0.182,13,24,0.542,101,40,84,0.476,35,68,0.515,5,16,0.313,19,25,0.76,104,2017-01-19,LAC,MIN,2017,106.5
6806,6806,6,Home,W 101-99 ,240,36,78,0.462,26,56,0.464,10,22,0.455,19,25,0.76,101,39,92,0.424,29,58,0.5,10,34,0.294,11,19,0.579,99,2017-01-25,MEM,TOR,2017,104.0
6807,6807,7,@,L 101-120 ,240,34,83,0.41,23,44,0.523,11,39,0.282,22,25,0.88,101,47,87,0.54,42,66,0.636,5,21,0.238,21,26,0.808,120,2017-01-29,HOU,IND,2017,122.5
6808,6808,8,Home,L 101-105 ,240,39,83,0.47,31,61,0.508,8,22,0.364,15,23,0.652,101,39,87,0.448,27,53,0.509,12,34,0.353,15,16,0.938,105,2017-01-29,SAS,DAL,2017,111.0
6809,6809,9,@,L 101-117 ,240,34,93,0.366,29,69,0.42,5,24,0.208,28,35,0.8,101,49,88,0.557,42,66,0.636,7,22,0.318,12,15,0.8,117,2017-01-31,NYK,WAS,2017,120.5
6810,6810,10,Home,L 101-102 ,240,38,75,0.507,30,59,0.508,8,16,0.5,17,25,0.68,101,36,84,0.429,28,53,0.528,8,31,0.258,22,29,0.759,102,2017-02-12,TOR,DET,2017,106.0
6811,6811,11,@,L 101-137 ,240,35,93,0.376,26,67,0.388,9,26,0.346,22,28,0.786,101,49,88,0.557,39,64,0.609,10,24,0.417,29,34,0.853,137,2017-02-15,LAL,PHO,2017,142.0
6812,6812,12,@,W 101-90 ,240,34,81,0.42,26,52,0.5,8,29,0.276,25,31,0.806,101,34,83,0.41,29,58,0.5,5,25,0.2,17,22,0.773,90,2017-03-01,NYK,ORL,2017,92.5
6813,6813,13,@,L 101-112 ,240,36,64,0.563,28,45,0.622,8,19,0.421,21,36,0.583,101,44,80,0.55,34,55,0.618,10,25,0.4,14,15,0.933,112,2017-03-03,LAC,MIL,2017,117.0
6814,6814,14,@,W 101-98 (OT),265,40,95,0.421,34,68,0.5,6,27,0.222,15,25,0.6,101,35,91,0.385,27,66,0.409,8,25,0.32,20,24,0.833,98,2017-03-03,SAS,NOP,2017,102.0
6815,6815,15,@,W 101-91 ,240,41,85,0.482,35,60,0.583,6,25,0.24,13,16,0.813,101,35,83,0.422,29,66,0.439,6,17,0.353,15,20,0.75,91,2017-03-04,LAC,CHI,2017,94.0
6816,6816,16,Home,W 101-94 ,240,38,87,0.437,32,60,0.533,6,27,0.222,19,23,0.826,101,35,75,0.467,28,54,0.519,7,21,0.333,17,20,0.85,94,2017-03-04,MIL,TOR,2017,97.5
6817,6817,17,@,L 101-108 ,240,37,80,0.463,30,59,0.508,7,21,0.333,20,21,0.952,101,37,85,0.435,20,44,0.455,17,41,0.415,17,24,0.708,108,2017-03-08,CHA,MIA,2017,116.5
6818,6818,18,@,L 101-106 ,240,39,84,0.464,28,45,0.622,11,39,0.282,12,19,0.632,101,41,87,0.471,32,61,0.525,9,26,0.346,15,19,0.789,106,2017-03-09,CLE,DET,2017,110.5
6819,6819,19,Home,L 100-104 ,240,39,87,0.448,36,65,0.554,3,22,0.136,19,26,0.731,100,35,78,0.449,30,62,0.484,5,16,0.313,29,31,0.935,104,2011-12-26,MIN,OKC,2012,106.5
6820,6820,20,Home,W 100-91 ,240,35,75,0.467,26,57,0.456,9,18,0.5,21,35,0.6,100,37,88,0.42,36,72,0.5,1,16,0.063,16,19,0.842,91,2011-12-26,SAC,LAL,2012,91.5
6821,6821,21,@,L 100-117 ,240,38,79,0.481,31,63,0.492,7,16,0.438,17,25,0.68,100,46,86,0.535,40,67,0.597,6,19,0.316,19,26,0.731,117,2011-12-28,UTA,DEN,2012,120.0
6822,6822,22,@,W 100-79 ,240,37,84,0.44,25,56,0.446,12,28,0.429,14,24,0.583,100,30,83,0.361,25,68,0.368,5,15,0.333,14,18,0.778,79,2011-12-30,ORL,CHA,2012,81.5
6823,6823,23,Home,W 100-92 ,240,38,83,0.458,28,63,0.444,10,20,0.5,14,21,0.667,100,35,83,0.422,32,72,0.444,3,11,0.273,19,23,0.826,92,2012-01-02,BOS,WAS,2012,93.5
6824,6824,24,Home,W 100-87 ,240,39,80,0.488,34,64,0.531,5,16,0.313,17,20,0.85,100,31,77,0.403,26,58,0.448,5,19,0.263,20,26,0.769,87,2012-01-02,DAL,OKC,2012,89.5
6825,6825,25,@,W 100-92 ,240,39,82,0.476,30,66,0.455,9,16,0.563,13,20,0.65,100,34,73,0.466,29,60,0.483,5,13,0.385,19,28,0.679,92,2012-01-02,ATL,MIA,2012,94.5
6826,6826,26,@,L 100-103 ,240,39,76,0.513,30,57,0.526,9,19,0.474,13,21,0.619,100,37,91,0.407,33,70,0.471,4,21,0.19,25,30,0.833,103,2012-01-05,MIL,SAC,2012,105.0
6827,6827,27,@,W 100-86 ,240,38,69,0.551,34,54,0.63,4,15,0.267,20,27,0.741,100,30,69,0.435,24,56,0.429,6,13,0.462,20,25,0.8,86,2012-01-10,DAL,DET,2012,89.0
6828,6828,28,@,W 100-95 ,240,34,74,0.459,28,59,0.475,6,15,0.4,26,32,0.813,100,39,85,0.459,34,73,0.466,5,12,0.417,12,20,0.6,95,2012-01-10,OKC,MEM,2012,97.5
6829,6829,29,Home,L 100-111 ,240,33,78,0.423,25,56,0.446,8,22,0.364,26,32,0.813,100,43,81,0.531,32,61,0.525,11,20,0.55,14,21,0.667,111,2012-01-10,MIN,CHI,2012,116.5
6830,6830,30,@,L 100-112 ,240,35,84,0.417,30,64,0.469,5,20,0.25,25,32,0.781,100,38,76,0.5,31,63,0.492,7,13,0.538,29,38,0.763,112,2012-01-14,GSW,CHA,2012,115.5
6831,6831,31,@,L 100-107 ,240,37,72,0.514,29,56,0.518,8,16,0.5,18,27,0.667,100,37,75,0.493,26,46,0.565,11,29,0.379,22,25,0.88,107,2012-01-18,GSW,NJN,2012,112.5
6832,6832,32,@,W 100-86 ,240,39,82,0.476,31,60,0.517,8,22,0.364,14,20,0.7,100,27,73,0.37,21,51,0.412,6,22,0.273,26,33,0.788,86,2012-01-20,MIL,NYK,2012,89.0
6833,6833,33,@,W 100-94 ,240,37,72,0.514,32,60,0.533,5,12,0.417,21,30,0.7,100,37,77,0.481,35,62,0.565,2,15,0.133,18,21,0.857,94,2012-01-22,BOS,WAS,2012,95.0
6834,6834,34,@,L 100-107 ,240,39,92,0.424,32,68,0.471,7,24,0.292,15,16,0.938,100,41,90,0.456,36,73,0.493,5,17,0.294,20,33,0.606,107,2012-01-27,MIL,CHI,2012,109.5
6835,6835,35,Home,W 100-89 ,240,40,80,0.5,35,61,0.574,5,19,0.263,15,16,0.938,100,36,82,0.439,30,63,0.476,6,19,0.316,11,17,0.647,89,2012-01-28,MIL,LAL,2012,92.0
6836,6836,36,@,L 100-101 (OT),265,39,94,0.415,27,69,0.391,12,25,0.48,10,19,0.526,100,44,100,0.44,40,80,0.5,4,20,0.2,9,12,0.75,101,2012-01-29,SAS,DAL,2012,103.0
6837,6837,37,@,L 100-112 ,240,38,78,0.487,29,56,0.518,9,22,0.409,15,23,0.652,100,45,80,0.563,32,55,0.582,13,25,0.52,9,15,0.6,112,2012-01-30,OKC,LAC,2012,118.5
6838,6838,38,Home,W 100-97 (OT),265,33,86,0.384,27,74,0.365,6,12,0.5,28,35,0.8,100,35,80,0.438,28,57,0.491,7,23,0.304,20,27,0.741,97,2012-01-31,MEM,DEN,2012,100.5
6839,6839,39,@,W 100-77 ,240,41,80,0.513,34,62,0.548,7,18,0.389,11,13,0.846,100,27,73,0.37,23,53,0.434,4,20,0.2,19,23,0.826,77,2012-01-31,ATL,TOR,2012,79.0
6840,6840,40,Home,W 100-64 ,240,39,75,0.52,27,51,0.529,12,24,0.5,10,12,0.833,100,25,73,0.342,19,59,0.322,6,14,0.429,8,18,0.444,64,2012-02-01,BOS,TOR,2012,67.0
6841,6841,41,Home,W 100-91 ,240,37,82,0.451,31,62,0.5,6,20,0.3,20,23,0.87,100,39,91,0.429,37,81,0.457,2,10,0.2,11,14,0.786,91,2012-02-04,MIN,HOU,2012,92.0
6842,6842,42,@,W 100-92 ,240,37,78,0.474,29,54,0.537,8,24,0.333,18,25,0.72,100,34,81,0.42,31,72,0.431,3,9,0.333,21,26,0.808,92,2012-02-06,SAC,NOH,2012,93.5
6843,6843,43,@,W 100-90 ,240,37,84,0.44,32,69,0.464,5,15,0.333,21,26,0.808,100,38,93,0.409,31,79,0.392,7,14,0.5,7,11,0.636,90,2012-02-08,SAS,PHI,2012,93.5
6844,6844,44,@,W 100-98 ,240,40,84,0.476,33,65,0.508,7,19,0.368,13,22,0.591,100,37,84,0.44,31,65,0.477,6,19,0.316,18,19,0.947,98,2012-02-11,NYK,MIN,2012,101.0
6845,6845,45,Home,L 100-105 ,240,37,72,0.514,26,45,0.578,11,27,0.407,15,15,1.0,100,41,88,0.466,35,73,0.479,6,15,0.4,17,20,0.85,105,2012-02-15,BRK,MEM,2012,108.0
6846,6846,46,Home,W 100-85 ,240,39,77,0.506,32,53,0.604,7,24,0.292,15,17,0.882,100,33,87,0.379,29,69,0.42,4,18,0.222,15,20,0.75,85,2012-02-15,NYK,SAC,2012,87.0
6847,6847,47,@,L 100-114 ,240,38,84,0.452,36,73,0.493,2,11,0.182,22,26,0.846,100,47,89,0.528,42,74,0.568,5,15,0.333,15,19,0.789,114,2012-02-17,WAS,UTA,2012,116.5
6848,6848,48,Home,L 100-103 (OT),265,36,89,0.404,28,63,0.444,8,26,0.308,20,23,0.87,100,40,92,0.435,28,64,0.438,12,28,0.429,11,21,0.524,103,2012-02-18,LAC,SAS,2012,109.0
6849,6849,49,@,W 100-92 ,240,32,82,0.39,17,51,0.333,15,31,0.484,21,29,0.724,100,34,85,0.4,29,64,0.453,5,21,0.238,19,26,0.731,92,2012-02-20,BRK,NYK,2012,94.5
6850,6850,50,@,L 100-101 ,240,37,95,0.389,30,78,0.385,7,17,0.412,19,24,0.792,100,34,78,0.436,25,60,0.417,9,18,0.5,24,32,0.75,101,2012-02-21,DET,CLE,2012,105.5
6851,6851,51,Home,W 100-98 ,240,31,77,0.403,20,55,0.364,11,22,0.5,27,38,0.711,100,39,85,0.459,38,78,0.487,1,7,0.143,19,24,0.792,98,2012-02-22,MIN,UTA,2012,98.5
6852,6852,52,Home,W 100-85 ,240,36,77,0.468,29,52,0.558,7,25,0.28,21,25,0.84,100,30,78,0.385,26,65,0.4,4,13,0.308,21,23,0.913,85,2012-02-23,OKC,LAL,2012,87.0
6853,6853,53,Home,L 100-108 ,240,37,79,0.468,28,59,0.475,9,20,0.45,17,23,0.739,100,44,92,0.478,32,69,0.464,12,23,0.522,8,8,1.0,108,2012-03-01,SAC,LAC,2012,114.0
6854,6854,54,Home,W 100-83 ,240,37,75,0.493,31,64,0.484,6,11,0.545,20,22,0.909,100,29,76,0.382,27,67,0.403,2,9,0.222,23,29,0.793,83,2012-03-03,MEM,DET,2012,84.0
6855,6855,55,Home,L 100-109 ,240,37,81,0.457,28,58,0.483,9,23,0.391,17,27,0.63,100,40,80,0.5,35,71,0.493,5,9,0.556,24,29,0.828,109,2012-03-05,CLE,UTA,2012,111.5
6856,6856,56,Home,L 100-120 ,240,36,85,0.424,28,63,0.444,8,22,0.364,20,36,0.556,100,45,83,0.542,30,60,0.5,15,23,0.652,15,16,0.938,120,2012-03-05,WAS,GSW,2012,127.5
6857,6857,57,Home,W 100-84 ,240,38,80,0.475,34,70,0.486,4,10,0.4,20,27,0.741,100,31,80,0.388,18,45,0.4,13,35,0.371,9,17,0.529,84,2012-03-06,CHA,ORL,2012,90.5
6858,6858,58,@,W 100-99 ,240,37,82,0.451,30,59,0.508,7,23,0.304,19,23,0.826,100,35,81,0.432,31,61,0.508,4,20,0.2,25,32,0.781,99,2012-03-07,CLE,DEN,2012,101.0
6859,6859,59,@,L 100-101 ,240,35,76,0.461,24,54,0.444,11,22,0.5,19,27,0.704,100,33,72,0.458,23,47,0.489,10,25,0.4,25,31,0.806,101,2012-03-07,LAC,NJN,2012,106.0
6860,6860,60,@,W 100-89 ,240,39,79,0.494,28,58,0.483,11,21,0.524,11,12,0.917,100,36,85,0.424,28,58,0.483,8,27,0.296,9,11,0.818,89,2012-03-16,POR,CHI,2012,93.0
6861,6861,61,@,L 100-115 ,240,32,81,0.395,24,62,0.387,8,19,0.421,28,34,0.824,100,41,81,0.506,30,56,0.536,11,25,0.44,22,28,0.786,115,2012-03-16,IND,NYK,2012,120.5
6862,6862,62,Home,L 100-105 ,240,34,81,0.42,28,58,0.483,6,23,0.261,26,31,0.839,100,41,89,0.461,36,74,0.486,5,15,0.333,18,27,0.667,105,2012-03-19,BRK,CLE,2012,107.5
6863,6863,63,@,L 100-116 ,240,39,88,0.443,32,66,0.485,7,22,0.318,15,20,0.75,100,45,95,0.474,38,76,0.5,7,19,0.368,19,25,0.76,116,2012-03-21,MIN,SAS,2012,119.5
6864,6864,64,@,W 100-91 ,240,43,89,0.483,36,72,0.5,7,17,0.412,7,10,0.7,100,36,90,0.4,33,75,0.44,3,15,0.2,16,20,0.8,91,2012-03-22,BOS,MIL,2012,92.5
6865,6865,65,@,L 100-117 ,240,41,81,0.506,38,66,0.576,3,15,0.2,15,22,0.682,100,45,99,0.455,33,64,0.516,12,35,0.343,15,15,1.0,117,2012-03-25,DEN,MIN,2012,123.0
6866,6866,66,Home,L 100-107 ,240,41,87,0.471,34,68,0.5,7,19,0.368,11,12,0.917,100,45,92,0.489,39,65,0.6,6,27,0.222,11,13,0.846,107,2012-03-27,PHO,SAS,2012,110.0
6867,6867,67,Home,W 100-84 ,240,40,82,0.488,33,66,0.5,7,16,0.438,13,15,0.867,100,35,77,0.455,29,57,0.509,6,20,0.3,8,13,0.615,84,2012-03-28,BRK,IND,2012,87.0
6868,6868,68,Home,W 100-90 ,240,37,73,0.507,33,54,0.611,4,19,0.211,22,26,0.846,100,31,70,0.443,25,53,0.472,6,17,0.353,22,33,0.667,90,2012-03-30,ATL,NYK,2012,93.0
6869,6869,69,Home,L 100-102 ,240,40,76,0.526,33,61,0.541,7,15,0.467,13,16,0.813,100,35,81,0.432,27,61,0.443,8,20,0.4,24,30,0.8,102,2012-03-30,GSW,NJN,2012,106.0
6870,6870,70,@,W 100-79 ,240,44,90,0.489,40,78,0.513,4,12,0.333,8,11,0.727,100,26,75,0.347,20,51,0.392,6,24,0.25,21,25,0.84,79,2012-03-30,BOS,MIN,2012,82.0
6871,6871,71,@,W 100-98 ,240,38,80,0.475,31,58,0.534,7,22,0.318,17,21,0.81,100,35,78,0.449,24,46,0.522,11,32,0.344,17,28,0.607,98,2012-03-30,DAL,ORL,2012,103.5
6872,6872,72,Home,L 100-109 ,240,39,85,0.459,38,75,0.507,1,10,0.1,21,32,0.656,100,40,90,0.444,35,68,0.515,5,22,0.227,24,28,0.857,109,2012-04-03,SAC,PHO,2012,111.5
6873,6873,73,Home,W 100-99 (OT),265,39,102,0.382,31,68,0.456,8,34,0.235,14,20,0.7,100,35,89,0.393,28,67,0.418,7,22,0.318,22,31,0.71,99,2012-04-08,NYK,CHI,2012,102.5
6874,6874,74,@,L 100-110 ,240,41,92,0.446,32,67,0.478,9,25,0.36,9,17,0.529,100,41,92,0.446,34,78,0.436,7,14,0.5,21,28,0.75,110,2012-04-10,SAC,DAL,2012,113.5
6875,6875,75,@,W 100-98 ,240,38,81,0.469,33,65,0.508,5,16,0.313,19,21,0.905,100,31,76,0.408,19,50,0.38,12,26,0.462,24,27,0.889,98,2012-04-11,LAC,OKC,2012,104.0
6876,6876,76,@,W 100-84 ,240,36,79,0.456,25,50,0.5,11,29,0.379,17,21,0.81,100,28,75,0.373,22,56,0.393,6,19,0.316,22,29,0.759,84,2012-04-15,ORL,CLE,2012,87.0
6877,6877,77,@,W 100-94 (OT),265,39,91,0.429,34,74,0.459,5,17,0.294,17,23,0.739,100,33,84,0.393,27,69,0.391,6,15,0.4,22,28,0.786,94,2012-04-15,CHI,DET,2012,97.0
6878,6878,78,@,L 100-113 ,240,40,80,0.5,31,62,0.5,9,18,0.5,11,15,0.733,100,48,90,0.533,37,72,0.514,11,18,0.611,6,6,1.0,113,2012-04-16,PHI,ORL,2012,118.5
6879,6879,79,@,W 100-68 ,240,40,83,0.482,31,64,0.484,9,19,0.474,11,19,0.579,100,25,84,0.298,24,76,0.316,1,8,0.125,17,23,0.739,68,2012-04-18,CHI,CHA,2012,68.5
6880,6880,80,Home,W 100-88 ,240,37,87,0.425,33,74,0.446,4,13,0.308,22,29,0.759,100,34,84,0.405,29,61,0.475,5,23,0.217,15,23,0.652,88,2012-04-24,UTA,PHO,2012,90.5
6881,6881,81,@,L 100-107 ,240,37,82,0.451,30,64,0.469,7,18,0.389,19,25,0.76,100,37,81,0.457,31,66,0.47,6,15,0.4,27,37,0.73,107,2012-11-03,TOR,BRK,2013,110.0
6882,6882,82,@,L 100-110 ,240,38,77,0.494,33,64,0.516,5,13,0.385,19,22,0.864,100,42,74,0.568,35,61,0.574,7,13,0.538,19,23,0.826,110,2012-11-03,UTA,SAS,2013,113.5
6883,6883,83,Home,W 100-84 ,240,39,77,0.506,28,50,0.56,11,27,0.407,11,18,0.611,100,34,79,0.43,26,62,0.419,8,17,0.471,8,10,0.8,84,2012-11-04,NYK,PHI,2013,88.0
6884,6884,84,Home,W 100-94 (OT),265,34,81,0.42,30,68,0.441,4,13,0.308,28,34,0.824,100,39,95,0.411,29,66,0.439,10,29,0.345,6,7,0.857,94,2012-11-07,BOS,WAS,2013,99.0
6885,6885,85,Home,L 100-106 ,240,37,76,0.487,33,66,0.5,4,10,0.4,22,31,0.71,100,40,82,0.488,33,69,0.478,7,13,0.538,19,23,0.826,106,2012-11-09,BOS,PHI,2013,109.5
6886,6886,86,@,L 100-110 ,240,41,76,0.539,34,60,0.567,7,16,0.438,11,18,0.611,100,43,94,0.457,36,82,0.439,7,12,0.583,17,21,0.81,110,2012-11-12,DEN,PHO,2013,113.5
6887,6887,87,Home,W 100-96 ,240,36,80,0.45,26,51,0.51,10,29,0.345,18,22,0.818,100,34,84,0.405,26,60,0.433,8,24,0.333,20,21,0.952,96,2012-11-14,HOU,NOH,2013,100.0
6888,6888,88,@,L 100-107 ,240,35,77,0.455,26,56,0.464,9,21,0.429,21,29,0.724,100,35,72,0.486,25,51,0.49,10,21,0.476,27,32,0.844,107,2012-11-14,MIA,LAC,2013,112.0
6889,6889,89,Home,L 100-104 ,240,38,87,0.437,30,58,0.517,8,29,0.276,16,21,0.762,100,39,86,0.453,28,60,0.467,11,26,0.423,15,23,0.652,104,2012-11-15,SAS,NYK,2013,109.5
6890,6890,90,@,L 100-126 ,240,39,78,0.5,35,67,0.522,4,11,0.364,18,26,0.692,100,47,88,0.534,31,61,0.508,16,27,0.593,16,20,0.8,126,2012-11-17,DEN,SAS,2013,134.0
6891,6891,91,@,L 100-101 (OT),265,38,89,0.427,31,69,0.449,7,20,0.35,17,24,0.708,100,40,92,0.435,31,67,0.463,9,25,0.36,12,21,0.571,101,2012-11-21,WAS,ATL,2013,105.5
6892,6892,92,Home,L 100-112 ,240,41,77,0.532,38,69,0.551,3,8,0.375,15,17,0.882,100,45,77,0.584,37,61,0.607,8,16,0.5,14,19,0.737,112,2012-11-21,BOS,SAS,2013,116.0
6893,6893,93,@,L 100-108 ,240,37,79,0.468,31,55,0.564,6,24,0.25,20,24,0.833,100,39,80,0.488,30,63,0.476,9,17,0.529,21,24,0.875,108,2012-11-23,OKC,BOS,2013,112.5
6894,6894,94,@,L 100-121 ,240,37,78,0.474,28,58,0.483,9,20,0.45,17,22,0.773,100,38,79,0.481,21,46,0.457,17,33,0.515,28,31,0.903,121,2012-11-25,DET,NYK,2013,129.5
6895,6895,95,Home,W 100-98 ,240,35,75,0.467,29,61,0.475,6,14,0.429,24,32,0.75,100,37,81,0.457,32,62,0.516,5,19,0.263,19,22,0.864,98,2012-11-27,PHI,DAL,2013,100.5
6896,6896,96,@,L 100-105 ,240,36,80,0.45,26,50,0.52,10,30,0.333,18,24,0.75,100,42,86,0.488,37,73,0.507,5,13,0.385,16,19,0.842,105,2012-11-29,SAS,MIA,2013,107.5
6897,6897,97,@,W 100-79 ,240,40,79,0.506,33,63,0.524,7,16,0.438,13,17,0.765,100,30,81,0.37,24,57,0.421,6,24,0.25,13,18,0.722,79,2012-12-01,OKC,NOH,2013,82.0
6898,6898,98,@,W 100-98 ,240,39,92,0.424,26,51,0.51,13,41,0.317,9,13,0.692,100,39,83,0.47,32,67,0.478,7,16,0.438,13,15,0.867,98,2012-12-05,NYK,CHA,2013,101.5
6899,6899,99,@,L 100-107 ,240,35,86,0.407,29,63,0.46,6,23,0.261,24,28,0.857,100,38,82,0.463,32,67,0.478,6,15,0.4,25,34,0.735,107,2012-12-05,TOR,SAC,2013,110.0
6900,6900,0,@,W 100-97 ,240,36,78,0.462,22,50,0.44,14,28,0.5,14,18,0.778,100,36,68,0.529,32,50,0.64,4,18,0.222,21,28,0.75,97,2012-12-11,NYK,BRK,2013,99.0
6901,6901,1,Home,W 100-94 ,240,37,84,0.44,26,57,0.456,11,27,0.407,15,26,0.577,100,31,75,0.413,24,48,0.5,7,27,0.259,25,40,0.625,94,2012-12-11,CLE,LAL,2013,97.5
6902,6902,2,@,W 100-94 ,240,37,85,0.435,28,62,0.452,9,23,0.391,17,25,0.68,100,35,82,0.427,30,66,0.455,5,16,0.313,19,24,0.792,94,2012-12-12,LAC,CHA,2013,96.5
6903,6903,3,Home,W 100-89 ,240,37,74,0.5,32,65,0.492,5,9,0.556,21,24,0.875,100,35,81,0.432,30,71,0.423,5,10,0.5,14,19,0.737,89,2012-12-18,CHI,BOS,2013,91.5
6904,6904,4,@,L 100-107 ,240,37,86,0.43,24,51,0.471,13,35,0.371,13,15,0.867,100,39,72,0.542,35,61,0.574,4,11,0.364,25,29,0.862,107,2012-12-18,PHI,DAL,2013,109.0
6905,6905,5,@,L 100-101 ,240,38,95,0.4,28,71,0.394,10,24,0.417,14,22,0.636,100,35,88,0.398,25,57,0.439,10,31,0.323,21,27,0.778,101,2012-12-18,CHA,LAL,2013,106.0
6906,6906,6,@,W 100-95 (OT),265,34,78,0.436,25,54,0.463,9,24,0.375,23,34,0.676,100,36,95,0.379,30,77,0.39,6,18,0.333,17,22,0.773,95,2012-12-18,ATL,WAS,2013,98.0
6907,6907,7,@,W 100-92 ,240,36,84,0.429,27,59,0.458,9,25,0.36,19,20,0.95,100,36,94,0.383,27,70,0.386,9,24,0.375,11,17,0.647,92,2012-12-19,OKC,ATL,2013,96.5
6908,6908,8,Home,W 100-86 ,240,38,83,0.458,27,54,0.5,11,29,0.379,13,17,0.765,100,35,78,0.449,25,53,0.472,10,25,0.4,6,9,0.667,86,2012-12-19,NYK,BRK,2013,91.0
6909,6909,9,Home,W 100-68 ,240,38,90,0.422,28,66,0.424,10,24,0.417,14,21,0.667,100,28,85,0.329,26,73,0.356,2,12,0.167,10,13,0.769,68,2012-12-21,DET,WAS,2013,69.0
6910,6910,10,@,L 100-115 ,240,33,90,0.367,25,69,0.362,8,21,0.381,26,35,0.743,100,44,85,0.518,30,58,0.517,14,27,0.519,13,16,0.813,115,2012-12-21,CHA,GSW,2013,122.0
6911,6911,11,@,L 100-112 ,240,40,80,0.5,37,67,0.552,3,13,0.231,17,24,0.708,100,45,93,0.484,34,68,0.5,11,25,0.44,11,19,0.579,112,2012-12-25,DEN,LAC,2013,117.5
6912,6912,12,Home,W 100-94 ,240,37,77,0.481,32,56,0.571,5,21,0.238,21,31,0.677,100,38,89,0.427,29,63,0.46,9,26,0.346,9,16,0.563,94,2012-12-25,LAL,NYK,2013,98.5
6913,6913,13,Home,W 100-80 ,240,34,71,0.479,26,52,0.5,8,19,0.421,24,29,0.828,100,33,78,0.423,26,60,0.433,7,18,0.389,7,12,0.583,80,2012-12-26,SAS,TOR,2013,83.5
6914,6914,14,@,L 100-109 ,240,38,80,0.475,33,65,0.508,5,15,0.333,19,22,0.864,100,44,80,0.55,34,60,0.567,10,20,0.5,11,14,0.786,109,2012-12-29,IND,ATL,2013,114.0
6915,6915,15,@,L 100-103 ,240,38,82,0.463,29,62,0.468,9,20,0.45,15,19,0.789,100,35,75,0.467,31,60,0.517,4,15,0.267,29,39,0.744,103,2012-12-29,CLE,BRK,2013,105.0
6916,6916,16,Home,L 100-105 ,240,36,84,0.429,26,47,0.553,10,37,0.27,18,24,0.75,100,41,81,0.506,30,48,0.625,11,33,0.333,12,18,0.667,105,2013-01-01,NYK,POR,2013,110.5
6917,6917,17,Home,W 100-83 ,240,39,82,0.476,27,55,0.491,12,27,0.444,10,16,0.625,100,28,77,0.364,19,43,0.442,9,34,0.265,18,21,0.857,83,2013-01-03,NYK,SAS,2013,87.5
6918,6918,18,Home,W 100-94 ,240,31,78,0.397,21,59,0.356,10,19,0.526,28,36,0.778,100,35,81,0.432,29,62,0.468,6,19,0.316,18,20,0.9,94,2013-01-07,UTA,DAL,2013,97.0
6919,6919,19,@,L 100-107 ,240,37,84,0.44,29,52,0.558,8,32,0.25,18,22,0.818,100,43,87,0.494,37,69,0.536,6,18,0.333,15,19,0.789,107,2013-01-12,HOU,PHI,2013,110.0
6920,6920,20,Home,W 100-87 ,240,35,81,0.432,24,51,0.471,11,30,0.367,19,25,0.76,100,33,82,0.402,29,59,0.492,4,23,0.174,17,22,0.773,87,2013-01-13,NYK,NOH,2013,89.0
6921,6921,21,Home,W 100-89 ,240,39,80,0.488,31,59,0.525,8,21,0.381,14,20,0.7,100,33,79,0.418,27,64,0.422,6,15,0.4,17,24,0.708,89,2013-01-14,BOS,CHA,2013,92.0
6922,6922,22,@,L 100-105 ,240,33,84,0.393,22,57,0.386,11,27,0.407,23,30,0.767,100,33,86,0.384,28,64,0.438,5,22,0.227,34,43,0.791,105,2013-01-16,HOU,DAL,2013,107.5
6923,6923,23,@,W 100-99 (OT),265,36,75,0.48,31,60,0.517,5,15,0.333,23,32,0.719,100,38,91,0.418,35,77,0.455,3,14,0.214,20,28,0.714,99,2013-01-18,CHI,BOS,2013,100.5
6924,6924,24,Home,L 100-106 ,240,37,79,0.468,26,48,0.542,11,31,0.355,15,21,0.714,100,37,79,0.468,33,67,0.493,4,12,0.333,28,38,0.737,106,2013-01-18,ORL,CHA,2013,108.0
6925,6925,25,@,W 100-94 ,240,29,74,0.392,19,45,0.422,10,29,0.345,32,41,0.78,100,34,81,0.42,28,66,0.424,6,15,0.4,20,24,0.833,94,2013-01-21,HOU,CHA,2013,97.0
6926,6926,26,Home,W 100-80 ,240,44,78,0.564,42,67,0.627,2,11,0.182,10,12,0.833,100,30,80,0.375,24,57,0.421,6,23,0.261,14,17,0.824,80,2013-01-23,POR,IND,2013,83.0
6927,6927,27,@,W 100-82 ,240,34,71,0.479,23,50,0.46,11,21,0.524,21,26,0.808,100,31,80,0.388,28,60,0.467,3,20,0.15,17,20,0.85,82,2013-01-25,HOU,NOH,2013,83.5
6928,6928,28,@,L 100-101 ,240,40,81,0.494,33,65,0.508,7,16,0.438,13,17,0.765,100,35,75,0.467,24,50,0.48,11,25,0.44,20,21,0.952,101,2013-01-26,LAC,POR,2013,106.5
6929,6929,29,Home,W 100-98 (2OT),290,36,88,0.409,31,68,0.456,5,20,0.25,23,27,0.852,100,39,96,0.406,34,73,0.466,5,23,0.217,15,20,0.75,98,2013-01-27,BOS,MIA,2013,100.5
6930,6930,30,Home,L 100-103 ,240,45,83,0.542,41,74,0.554,4,9,0.444,6,9,0.667,100,40,73,0.548,32,60,0.533,8,13,0.615,15,19,0.789,103,2013-01-28,PHI,MEM,2013,107.0
6931,6931,31,Home,W 100-97 ,240,36,84,0.429,29,64,0.453,7,20,0.35,21,25,0.84,100,36,81,0.444,28,56,0.5,8,25,0.32,17,24,0.708,97,2013-01-31,GSW,DAL,2013,101.0
6932,6932,32,Home,L 100-111 ,240,41,89,0.461,31,67,0.463,10,22,0.455,8,18,0.444,100,39,92,0.424,27,60,0.45,12,32,0.375,21,25,0.84,111,2013-02-01,MIN,LAL,2013,117.0
6933,6933,33,@,W 100-85 ,240,40,75,0.533,37,63,0.587,3,12,0.25,17,23,0.739,100,28,75,0.373,24,57,0.421,4,18,0.222,25,32,0.781,85,2013-02-03,MIA,TOR,2013,87.0
6934,6934,34,@,W 100-98 ,240,41,70,0.586,34,52,0.654,7,18,0.389,11,16,0.688,100,40,85,0.471,37,72,0.514,3,13,0.231,15,19,0.789,98,2013-02-04,POR,MIN,2013,99.5
6935,6935,35,Home,W 100-86 ,240,39,81,0.481,34,71,0.479,5,10,0.5,17,26,0.654,100,29,82,0.354,23,63,0.365,6,19,0.316,22,29,0.759,86,2013-02-06,UTA,MIL,2013,89.0
6936,6936,36,Home,L 100-111 ,240,35,74,0.473,22,50,0.44,13,24,0.542,17,23,0.739,100,45,86,0.523,36,70,0.514,9,16,0.563,12,18,0.667,111,2013-02-08,ATL,NOH,2013,115.5
6937,6937,37,@,W 100-93 ,240,36,80,0.45,28,54,0.519,8,26,0.308,20,25,0.8,100,38,89,0.427,34,75,0.453,4,14,0.286,13,19,0.684,93,2013-02-08,LAL,CHA,2013,95.0
6938,6938,38,@,W 100-98 (OT),265,42,96,0.438,40,87,0.46,2,9,0.222,14,19,0.737,100,35,78,0.449,26,56,0.464,9,22,0.409,19,28,0.679,98,2013-02-08,TOR,IND,2013,102.5
6939,6939,39,@,W 100-94 ,240,38,81,0.469,30,55,0.545,8,26,0.308,16,20,0.8,100,37,80,0.463,36,67,0.537,1,13,0.077,19,27,0.704,94,2013-02-08,NYK,MIN,2013,94.5
6940,6940,40,Home,L 100-105 ,240,34,86,0.395,27,69,0.391,7,17,0.412,25,28,0.893,100,41,83,0.494,33,66,0.5,8,17,0.471,15,19,0.789,105,2013-02-09,MIL,DET,2013,109.0
6941,6941,41,@,W 100-92 ,240,39,75,0.52,31,61,0.508,8,14,0.571,14,17,0.824,100,40,79,0.506,35,61,0.574,5,18,0.278,7,11,0.636,92,2013-02-11,MIN,CLE,2013,94.5
6942,6942,42,@,L 100-123 ,240,33,80,0.413,29,64,0.453,4,16,0.25,30,36,0.833,100,43,92,0.467,30,58,0.517,13,34,0.382,24,26,0.923,123,2013-02-13,SAC,DAL,2013,129.5
6943,6943,43,Home,L 100-110 ,240,32,73,0.438,29,60,0.483,3,13,0.231,33,34,0.971,100,41,88,0.466,30,59,0.508,11,29,0.379,17,22,0.773,110,2013-02-14,OKC,MIA,2013,115.5
6944,6944,44,@,L 100-105 ,240,37,76,0.487,30,61,0.492,7,15,0.467,19,22,0.864,100,38,77,0.494,33,63,0.524,5,14,0.357,24,34,0.706,105,2013-02-20,NOP,CLE,2013,107.5
6945,6945,45,Home,L 100-104 ,240,37,91,0.407,32,74,0.432,5,17,0.294,21,24,0.875,100,40,84,0.476,32,64,0.5,8,20,0.4,16,19,0.842,104,2013-02-22,NOP,DAL,2013,108.0
6946,6946,46,Home,W 100-98 ,240,35,80,0.438,28,62,0.452,7,18,0.389,23,28,0.821,100,35,75,0.467,25,47,0.532,10,28,0.357,18,23,0.783,98,2013-02-22,TOR,NYK,2013,103.0
6947,6947,47,@,W 100-99 ,240,37,81,0.457,30,64,0.469,7,17,0.412,19,23,0.826,100,37,85,0.435,36,74,0.486,1,11,0.091,24,31,0.774,99,2013-02-24,GSW,MIN,2013,99.5
6948,6948,48,Home,W 100-95 ,240,35,81,0.432,28,61,0.459,7,20,0.35,23,31,0.742,100,39,78,0.5,32,59,0.542,7,19,0.368,10,16,0.625,95,2013-03-01,NOP,DET,2013,98.5
6949,6949,49,@,W 100-77 ,240,42,92,0.457,34,71,0.479,8,21,0.381,8,10,0.8,100,32,88,0.364,30,70,0.429,2,18,0.111,11,14,0.786,77,2013-03-10,DAL,MIN,2013,78.0
6950,6950,50,Home,W 100-96 ,240,33,84,0.393,25,61,0.41,8,23,0.348,26,34,0.765,100,36,86,0.419,29,65,0.446,7,21,0.333,17,27,0.63,96,2013-03-10,TOR,CLE,2013,99.5
6951,6951,51,Home,W 100-74 ,240,35,77,0.455,29,60,0.483,6,17,0.353,24,30,0.8,100,27,66,0.409,23,53,0.434,4,13,0.308,16,25,0.64,74,2013-03-12,CHA,BOS,2013,76.0
6952,6952,52,@,L 100-108 ,240,39,81,0.481,33,57,0.579,6,24,0.25,16,20,0.8,100,36,74,0.486,25,43,0.581,11,31,0.355,25,31,0.806,108,2013-03-15,MIN,HOU,2013,113.5
6953,6953,53,@,L 100-101 ,240,38,90,0.422,26,62,0.419,12,28,0.429,12,14,0.857,100,43,86,0.5,38,70,0.543,5,16,0.313,10,13,0.769,101,2013-03-18,POR,PHI,2013,103.5
6954,6954,54,Home,W 100-93 ,240,34,76,0.447,28,53,0.528,6,23,0.261,26,32,0.813,100,36,79,0.456,31,62,0.5,5,17,0.294,16,20,0.8,93,2013-03-20,HOU,UTA,2013,95.5
6955,6955,55,@,L 100-101 ,240,43,78,0.551,36,60,0.6,7,18,0.389,7,11,0.636,100,37,76,0.487,30,65,0.462,7,11,0.636,20,27,0.741,101,2013-03-21,PHI,DEN,2013,104.5
6956,6956,56,Home,L 100-103 ,240,39,81,0.481,28,58,0.483,11,23,0.478,11,17,0.647,100,40,87,0.46,29,61,0.475,11,26,0.423,12,16,0.75,103,2013-03-22,LAL,WAS,2013,108.5
6957,6957,57,Home,L 100-102 ,240,41,99,0.414,35,78,0.449,6,21,0.286,12,17,0.706,100,35,76,0.461,31,62,0.5,4,14,0.286,28,31,0.903,102,2013-03-24,PHO,BRK,2013,104.0
6958,6958,58,Home,W 100-94 ,240,40,84,0.476,32,61,0.525,8,23,0.348,12,15,0.8,100,36,80,0.45,29,59,0.492,7,21,0.333,15,25,0.6,94,2013-03-25,IND,ATL,2013,97.5
6959,6959,59,@,W 100-85 ,240,39,90,0.433,31,62,0.5,8,28,0.286,14,18,0.778,100,31,69,0.449,25,49,0.51,6,20,0.3,17,22,0.773,85,2013-03-26,NYK,BOS,2013,88.0
6960,6960,60,@,W 100-91 ,240,35,78,0.449,29,60,0.483,6,18,0.333,24,28,0.857,100,32,83,0.386,26,62,0.419,6,21,0.286,21,26,0.808,91,2013-03-27,IND,HOU,2013,94.0
6961,6961,61,Home,W 100-92 ,240,42,89,0.472,34,73,0.466,8,16,0.5,8,9,0.889,100,37,89,0.416,31,65,0.477,6,24,0.25,12,13,0.923,92,2013-03-27,PHI,MIL,2013,95.0
6962,6962,62,Home,W 100-99 ,240,35,76,0.461,25,61,0.41,10,15,0.667,20,27,0.741,100,42,88,0.477,42,78,0.538,0,10,0.0,15,17,0.882,99,2013-03-27,SAS,DEN,2013,99.0
6963,6963,63,Home,W 100-98 ,240,40,79,0.506,34,61,0.557,6,18,0.333,14,18,0.778,100,38,80,0.475,26,59,0.441,12,21,0.571,10,18,0.556,98,2013-03-30,DAL,CHI,2013,104.0
6964,6964,64,Home,W 100-92 ,240,38,73,0.521,33,57,0.579,5,16,0.313,19,27,0.704,100,38,76,0.5,36,68,0.529,2,8,0.25,14,23,0.609,92,2013-03-30,PHI,CHA,2013,93.0
6965,6965,65,@,L 100-110 ,240,42,81,0.519,35,65,0.538,7,16,0.438,9,14,0.643,100,40,83,0.482,35,65,0.538,5,18,0.278,25,27,0.926,110,2013-04-01,BOS,MIN,2013,112.5
6966,6966,66,Home,W 100-88 ,240,38,82,0.463,26,58,0.448,12,24,0.5,12,13,0.923,100,33,83,0.398,25,62,0.403,8,21,0.381,14,17,0.824,88,2013-04-04,OKC,SAS,2013,92.0
6967,6967,67,Home,W 100-83 ,240,36,76,0.474,30,57,0.526,6,19,0.316,22,29,0.759,100,30,83,0.361,27,73,0.37,3,10,0.3,20,23,0.87,83,2013-04-06,MIL,TOR,2013,84.5
6968,6968,68,@,L 100-107 ,240,36,78,0.462,28,56,0.5,8,22,0.364,20,21,0.952,100,42,72,0.583,34,59,0.576,8,13,0.615,15,17,0.882,107,2013-04-12,MIN,UTA,2013,111.0
6969,6969,69,@,L 100-121 ,240,39,100,0.39,31,75,0.413,8,25,0.32,14,17,0.824,100,45,83,0.542,32,56,0.571,13,27,0.481,18,24,0.75,121,2013-04-14,SAC,HOU,2013,127.5
6970,6970,70,@,L 100-101 ,240,32,67,0.478,25,53,0.472,7,14,0.5,29,36,0.806,100,33,68,0.485,25,52,0.481,8,16,0.5,27,39,0.692,101,2013-11-01,MIA,BRK,2014,105.0
6971,6971,71,Home,W 100-81 ,240,33,77,0.429,25,57,0.439,8,20,0.4,26,33,0.788,100,29,83,0.349,22,52,0.423,7,31,0.226,16,19,0.842,81,2013-11-01,MIN,OKC,2014,84.5
6972,6972,72,Home,L 100-109 ,240,40,89,0.449,31,57,0.544,9,32,0.281,11,13,0.846,100,35,79,0.443,25,52,0.481,10,27,0.37,29,38,0.763,109,2013-11-03,NYK,MIN,2014,114.0
6973,6973,73,Home,L 100-105 ,240,35,80,0.438,25,49,0.51,10,31,0.323,20,21,0.952,100,39,81,0.481,31,59,0.525,8,22,0.364,19,26,0.731,105,2013-11-05,SAC,ATL,2014,109.0
6974,6974,74,@,W 100-81 ,240,36,80,0.45,31,63,0.492,5,17,0.294,23,27,0.852,100,31,77,0.403,28,60,0.467,3,17,0.176,16,23,0.696,81,2013-11-11,DEN,UTA,2014,82.5
6975,6975,75,@,W 100-98 (OT),265,38,87,0.437,36,75,0.48,2,12,0.167,22,29,0.759,100,34,79,0.43,24,51,0.471,10,28,0.357,20,25,0.8,98,2013-11-15,BRK,PHO,2014,103.0
6976,6976,76,Home,L 100-108 ,240,37,70,0.529,33,55,0.6,4,15,0.267,22,28,0.786,100,43,84,0.512,33,57,0.579,10,27,0.37,12,18,0.667,108,2013-11-16,ORL,DAL,2014,113.0
6977,6977,77,@,L 100-104 ,240,37,85,0.435,27,57,0.474,10,28,0.357,16,24,0.667,100,41,85,0.482,34,70,0.486,7,15,0.467,15,15,1.0,104,2013-11-19,MIN,WAS,2014,107.5
6978,6978,78,@,L 100-104 ,240,41,77,0.532,33,54,0.611,8,23,0.348,10,16,0.625,100,36,88,0.409,30,71,0.423,6,17,0.353,26,33,0.788,104,2013-11-22,CLE,NOP,2014,107.0
6979,6979,79,@,L 100-102 ,240,35,87,0.402,28,66,0.424,7,21,0.333,23,25,0.92,100,35,79,0.443,24,47,0.511,11,32,0.344,21,30,0.7,102,2013-11-23,DAL,DEN,2014,107.5
6980,6980,80,Home,W 100-86 ,240,40,87,0.46,32,61,0.525,8,26,0.308,12,15,0.8,100,35,84,0.417,27,60,0.45,8,24,0.333,8,15,0.533,86,2013-11-24,LAL,SAC,2014,90.0
6981,6981,81,Home,L 100-102 ,240,34,78,0.436,23,52,0.442,11,26,0.423,21,22,0.955,100,39,77,0.506,35,63,0.556,4,14,0.286,20,22,0.909,102,2013-11-26,TOR,BRK,2014,104.0
6982,6982,82,@,W 100-93 ,240,36,80,0.45,33,71,0.465,3,9,0.333,25,31,0.806,100,38,89,0.427,31,69,0.449,7,20,0.35,10,13,0.769,93,2013-11-27,MEM,BOS,2014,96.5
6983,6983,83,@,W 100-92 (OT),265,37,74,0.5,27,48,0.563,10,26,0.385,16,22,0.727,100,37,85,0.435,27,60,0.45,10,25,0.4,8,10,0.8,92,2013-11-27,WAS,MIL,2014,97.0
6984,6984,84,@,L 100-115 ,240,38,88,0.432,31,65,0.477,7,23,0.304,17,19,0.895,100,41,89,0.461,31,61,0.508,10,28,0.357,23,39,0.59,115,2013-12-01,PHI,DET,2014,120.0
6985,6985,85,Home,L 100-105 ,240,36,82,0.439,32,67,0.478,4,15,0.267,24,31,0.774,100,39,89,0.438,31,63,0.492,8,26,0.308,19,26,0.731,105,2013-12-01,LAC,IND,2014,109.0
6986,6986,86,@,L 100-102 ,240,42,96,0.438,31,65,0.477,11,31,0.355,5,5,1.0,100,42,78,0.538,36,60,0.6,6,18,0.333,12,17,0.706,102,2013-12-02,ATL,SAS,2014,105.0
6987,6987,87,@,L 100-108 ,240,37,78,0.474,29,60,0.483,8,18,0.444,18,21,0.857,100,38,77,0.494,27,53,0.509,11,24,0.458,21,27,0.778,108,2013-12-03,MIL,BOS,2014,113.5
6988,6988,88,@,W 100-97 ,240,37,86,0.43,26,62,0.419,11,24,0.458,15,22,0.682,100,38,94,0.404,31,72,0.431,7,22,0.318,14,15,0.933,97,2013-12-04,DAL,NOP,2014,100.5
6989,6989,89,Home,L 100-106 ,240,37,86,0.43,27,64,0.422,10,22,0.455,16,22,0.727,100,41,86,0.477,29,54,0.537,12,32,0.375,12,18,0.667,106,2013-12-06,SAC,LAL,2014,112.0
6990,6990,90,Home,L 100-111 ,240,41,91,0.451,28,65,0.431,13,26,0.5,5,6,0.833,100,38,71,0.535,29,52,0.558,9,19,0.474,26,28,0.929,111,2013-12-07,SAS,IND,2014,115.5
6991,6991,91,Home,L 100-116 ,240,34,81,0.42,28,66,0.424,6,15,0.4,26,34,0.765,100,40,71,0.563,31,53,0.585,9,18,0.5,27,33,0.818,116,2013-12-11,MEM,OKC,2014,120.5
6992,6992,92,Home,L 100-109 ,240,37,85,0.435,26,55,0.473,11,30,0.367,15,16,0.938,100,42,87,0.483,34,66,0.515,8,21,0.381,17,20,0.85,109,2013-12-13,ORL,CLE,2014,113.0
6993,6993,93,@,L 100-108 ,240,37,84,0.44,28,61,0.459,9,23,0.391,17,21,0.81,100,39,82,0.476,29,57,0.509,10,25,0.4,20,24,0.833,108,2013-12-13,PHI,TOR,2014,113.0
6994,6994,94,@,W 100-84 ,240,41,88,0.466,33,68,0.485,8,20,0.4,10,12,0.833,100,35,89,0.393,29,69,0.42,6,20,0.3,8,11,0.727,84,2013-12-14,SAS,UTA,2014,87.0
6995,6995,95,@,L 100-114 ,240,39,82,0.476,34,61,0.557,5,21,0.238,17,21,0.81,100,45,92,0.489,34,65,0.523,11,27,0.407,13,15,0.867,114,2013-12-16,LAL,ATL,2014,119.5
6996,6996,96,Home,W 100-84 ,240,37,69,0.536,27,54,0.5,10,15,0.667,16,24,0.667,100,36,90,0.4,32,72,0.444,4,18,0.222,8,9,0.889,84,2013-12-21,CHI,CLE,2014,86.0
6997,6997,97,Home,L 100-105 ,240,39,82,0.476,31,62,0.5,8,20,0.4,14,23,0.609,100,39,79,0.494,27,56,0.482,12,23,0.522,15,23,0.652,105,2013-12-21,ORL,SAC,2014,111.0
6998,6998,98,Home,L 100-113 ,240,35,82,0.427,26,63,0.413,9,19,0.474,21,26,0.808,100,43,88,0.489,31,61,0.508,12,27,0.444,15,18,0.833,113,2013-12-21,SAS,OKC,2014,119.0
6999,6999,99,Home,L 100-113 ,240,31,74,0.419,24,57,0.421,7,17,0.412,31,42,0.738,100,41,83,0.494,33,66,0.5,8,17,0.471,23,27,0.852,113,2013-12-23,SAC,NOP,2014,117.0
7000,7000,0,Home,W 100-92 ,240,31,71,0.437,26,47,0.553,5,24,0.208,33,40,0.825,100,38,93,0.409,33,75,0.44,5,18,0.278,11,20,0.55,92,2013-12-26,HOU,MEM,2014,94.5
7001,7001,1,@,L 100-103 ,240,37,79,0.468,28,61,0.459,9,18,0.5,17,24,0.708,100,38,83,0.458,29,58,0.5,9,25,0.36,18,25,0.72,103,2013-12-28,CLE,BOS,2014,107.5
7002,7002,2,@,L 100-115 ,240,39,80,0.488,32,59,0.542,7,21,0.333,15,20,0.75,100,36,80,0.45,21,48,0.438,15,32,0.469,28,34,0.824,115,2013-12-28,NYK,TOR,2014,122.5
7003,7003,3,@,W 100-98 ,240,41,86,0.477,35,62,0.565,6,24,0.25,12,14,0.857,100,36,79,0.456,30,56,0.536,6,23,0.261,20,23,0.87,98,2013-12-30,DAL,MIN,2014,101.0
7004,7004,4,Home,L 100-101 ,240,37,80,0.463,27,49,0.551,10,31,0.323,16,19,0.842,100,39,87,0.448,33,60,0.55,6,27,0.222,17,25,0.68,101,2014-01-03,ATL,GSW,2014,104.0
7005,7005,5,@,L 100-102 ,240,37,89,0.416,28,65,0.431,9,24,0.375,17,24,0.708,100,34,74,0.459,24,48,0.5,10,26,0.385,24,28,0.857,102,2014-01-03,NYK,HOU,2014,107.0
7006,7006,6,@,L 100-116 ,240,37,68,0.544,27,47,0.574,10,21,0.476,16,20,0.8,100,41,85,0.482,29,58,0.5,12,27,0.444,22,25,0.88,116,2014-01-04,MIL,PHO,2014,122.0
7007,7007,7,Home,L 100-103 ,240,35,77,0.455,27,57,0.474,8,20,0.4,22,29,0.759,100,37,72,0.514,33,59,0.559,4,13,0.308,25,41,0.61,103,2014-01-15,NOP,HOU,2014,105.0
7008,7008,8,Home,L 100-109 ,240,38,84,0.452,30,64,0.469,8,20,0.4,16,20,0.8,100,41,86,0.477,33,70,0.471,8,16,0.5,19,20,0.95,109,2014-01-17,SAS,POR,2014,113.0
7009,7009,9,Home,W 100-95 ,240,32,65,0.492,23,49,0.469,9,16,0.563,27,33,0.818,100,39,95,0.411,29,66,0.439,10,29,0.345,7,10,0.7,95,2014-01-20,CHA,TOR,2014,100.0
7010,7010,10,@,L 100-102 (OT),265,35,83,0.422,27,58,0.466,8,25,0.32,22,26,0.846,100,39,102,0.382,32,81,0.395,7,21,0.333,17,24,0.708,102,2014-01-20,LAL,CHI,2014,105.5
7011,7011,11,@,L 100-124 ,240,38,75,0.507,33,60,0.55,5,15,0.333,19,28,0.679,100,45,83,0.542,34,67,0.507,11,16,0.688,23,32,0.719,124,2014-01-22,IND,PHO,2014,129.5
7012,7012,12,Home,W 100-92 ,240,37,81,0.457,32,69,0.464,5,12,0.417,21,27,0.778,100,36,77,0.468,33,62,0.532,3,15,0.2,17,19,0.895,92,2014-01-26,NOP,ORL,2014,93.5
7013,7013,13,@,W 100-89 ,240,39,74,0.527,35,61,0.574,4,13,0.308,18,23,0.783,100,33,80,0.413,27,65,0.415,6,15,0.4,17,27,0.63,89,2014-01-28,NOP,CLE,2014,92.0
7014,7014,14,@,W 100-90 ,240,37,85,0.435,29,64,0.453,8,21,0.381,18,20,0.9,100,36,80,0.45,28,59,0.475,8,21,0.381,10,14,0.714,90,2014-01-31,TOR,DEN,2014,94.0
7015,7015,15,Home,L 100-110 ,240,36,93,0.387,30,67,0.448,6,26,0.231,22,27,0.815,100,46,88,0.523,44,77,0.571,2,11,0.182,16,22,0.727,110,2014-01-31,LAL,CHA,2014,111.0
7016,7016,16,Home,W 100-90 ,240,37,84,0.44,30,67,0.448,7,17,0.412,19,22,0.864,100,37,81,0.457,32,62,0.516,5,19,0.263,11,12,0.917,90,2014-02-03,WAS,POR,2014,92.5
7017,7017,17,@,L 100-110 ,240,36,95,0.379,29,79,0.367,7,16,0.438,21,31,0.677,100,39,84,0.464,29,61,0.475,10,23,0.435,22,26,0.846,110,2014-02-05,MIL,DEN,2014,115.0
7018,7018,18,@,L 100-105 ,240,38,84,0.452,24,54,0.444,14,30,0.467,10,14,0.714,100,40,86,0.465,35,72,0.486,5,14,0.357,20,22,0.909,105,2014-02-05,ATL,NOP,2014,107.5
7019,7019,19,Home,L 100-104 ,240,39,89,0.438,33,73,0.452,6,16,0.375,16,22,0.727,100,36,77,0.468,28,56,0.5,8,21,0.381,24,28,0.857,104,2014-02-08,CHA,SAS,2014,108.0
7020,7020,20,@,L 100-112 ,240,38,86,0.442,29,62,0.468,9,24,0.375,15,20,0.75,100,40,73,0.548,28,46,0.609,12,27,0.444,20,27,0.741,112,2014-02-09,NYK,OKC,2014,118.0
7021,7021,21,@,L 100-109 ,240,43,82,0.524,38,65,0.585,5,17,0.294,9,11,0.818,100,43,90,0.478,38,74,0.514,5,16,0.313,18,26,0.692,109,2014-02-10,SAS,DET,2014,111.5
7022,7022,22,Home,W 100-85 ,240,43,85,0.506,35,65,0.538,8,20,0.4,6,13,0.462,100,35,80,0.438,25,57,0.439,10,23,0.435,5,9,0.556,85,2014-02-11,CHI,ATL,2014,90.0
7023,7023,23,@,L 100-105 ,240,37,80,0.463,29,61,0.475,8,19,0.421,18,23,0.783,100,37,87,0.425,34,71,0.479,3,16,0.188,28,32,0.875,105,2014-02-12,PHI,UTA,2014,106.5
7024,7024,24,@,L 100-104 ,240,40,80,0.5,29,55,0.527,11,25,0.44,9,16,0.563,100,35,82,0.427,23,56,0.411,12,26,0.462,22,30,0.733,104,2014-02-18,ORL,MIL,2014,110.0
7025,7025,25,Home,W 100-94 ,240,36,82,0.439,25,54,0.463,11,28,0.393,17,26,0.654,100,34,87,0.391,29,70,0.414,5,17,0.294,21,28,0.75,94,2014-02-19,PHO,BOS,2014,96.5
7026,7026,26,Home,L 100-110 ,240,35,83,0.422,26,56,0.464,9,27,0.333,21,32,0.656,100,36,80,0.45,27,62,0.435,9,18,0.5,29,40,0.725,110,2014-02-22,MIL,IND,2014,114.5
7027,7027,27,@,W 100-95 ,240,28,76,0.368,16,45,0.356,12,31,0.387,32,38,0.842,100,37,103,0.359,33,83,0.398,4,20,0.2,17,26,0.654,95,2014-02-25,POR,DEN,2014,97.0
7028,7028,28,@,W 100-91 ,240,36,71,0.507,27,52,0.519,9,19,0.474,19,28,0.679,100,34,85,0.4,23,54,0.426,11,31,0.355,12,17,0.706,91,2014-02-28,CHI,DAL,2014,96.5
7029,7029,29,@,L 100-110 ,240,36,92,0.391,31,71,0.437,5,21,0.238,23,25,0.92,100,38,93,0.409,32,68,0.471,6,25,0.24,28,33,0.848,110,2014-03-17,LAC,DEN,2014,113.0
7030,7030,30,@,W 100-96 ,240,34,75,0.453,22,45,0.489,12,30,0.4,20,31,0.645,100,37,72,0.514,30,50,0.6,7,22,0.318,15,22,0.682,96,2014-03-18,MIA,CLE,2014,99.5
7031,7031,31,Home,L 100-107 ,240,36,67,0.537,32,54,0.593,4,13,0.308,24,32,0.75,100,36,86,0.419,27,64,0.422,9,22,0.409,26,32,0.813,107,2014-03-19,NOP,TOR,2014,111.5
7032,7032,32,Home,L 100-106 ,240,35,77,0.455,23,50,0.46,12,27,0.444,18,19,0.947,100,42,69,0.609,33,51,0.647,9,18,0.5,13,17,0.765,106,2014-03-23,NYK,CLE,2014,110.5
7033,7033,33,@,W 100-89 ,240,39,82,0.476,27,55,0.491,12,27,0.444,10,18,0.556,100,32,86,0.372,28,65,0.431,4,21,0.19,21,25,0.84,89,2014-03-24,HOU,CHA,2014,91.0
7034,7034,34,@,L 100-102 ,240,35,88,0.398,21,56,0.375,14,32,0.438,16,26,0.615,100,36,70,0.514,32,57,0.561,4,13,0.308,26,33,0.788,102,2014-03-25,TOR,CLE,2014,104.0
7035,7035,35,@,W 100-85 ,240,37,80,0.463,27,54,0.5,10,26,0.385,16,21,0.762,100,34,84,0.405,30,62,0.484,4,22,0.182,13,17,0.765,85,2014-03-27,POR,ATL,2014,87.0
7036,7036,36,Home,W 100-93 ,240,40,81,0.494,31,61,0.508,9,20,0.45,11,14,0.786,100,41,81,0.506,39,69,0.565,2,12,0.167,9,16,0.563,93,2014-03-28,GSW,MEM,2014,94.0
7037,7037,37,@,L 100-103 ,240,42,81,0.519,39,71,0.549,3,10,0.3,13,19,0.684,100,34,70,0.486,27,47,0.574,7,23,0.304,28,35,0.8,103,2014-03-29,SAC,DAL,2014,106.5
7038,7038,38,Home,W 100-94 ,240,34,78,0.436,31,57,0.544,3,21,0.143,29,34,0.853,100,38,79,0.481,29,62,0.468,9,17,0.529,9,13,0.692,94,2014-03-31,CHA,WAS,2014,98.5
7039,7039,39,Home,W 100-92 ,240,32,83,0.386,30,72,0.417,2,11,0.182,34,38,0.895,100,29,80,0.363,22,57,0.386,7,23,0.304,27,32,0.844,92,2014-04-04,MEM,DEN,2014,95.5
7040,7040,40,Home,W 100-96 ,240,33,64,0.516,29,53,0.547,4,11,0.364,30,35,0.857,100,34,73,0.466,26,54,0.481,8,19,0.421,20,29,0.69,96,2014-04-04,UTA,NOP,2014,100.0
7041,7041,41,Home,W 100-92 ,240,43,79,0.544,34,62,0.548,9,17,0.529,5,9,0.556,100,36,77,0.468,35,63,0.556,1,14,0.071,19,28,0.679,92,2014-04-05,ORL,MIN,2014,92.5
7042,7042,42,Home,W 100-94 ,240,41,87,0.471,36,65,0.554,5,22,0.227,13,15,0.867,100,38,90,0.422,34,78,0.436,4,12,0.333,14,18,0.778,94,2014-04-06,POR,NOP,2014,96.0
7043,7043,43,@,L 100-122 ,240,34,96,0.354,25,68,0.368,9,28,0.321,23,32,0.719,100,53,93,0.57,42,67,0.627,11,26,0.423,5,9,0.556,122,2014-04-09,DET,CLE,2014,127.5
7044,7044,44,Home,W 100-99 ,240,38,75,0.507,31,52,0.596,7,23,0.304,17,22,0.773,100,39,91,0.429,34,80,0.425,5,11,0.455,16,22,0.727,99,2014-04-09,POR,SAC,2014,101.5
7045,7045,45,Home,L 100-109 ,240,39,83,0.47,34,71,0.479,5,12,0.417,17,21,0.81,100,38,88,0.432,22,54,0.407,16,34,0.471,17,22,0.773,109,2014-04-10,DAL,SAS,2014,117.0
7046,7046,46,@,W 100-99 ,240,39,104,0.375,29,70,0.414,10,34,0.294,12,19,0.632,100,40,88,0.455,34,65,0.523,6,23,0.261,13,15,0.867,99,2014-04-10,DEN,GSW,2014,102.0
7047,7047,47,Home,L 100-108 ,240,30,76,0.395,15,43,0.349,15,33,0.455,25,31,0.806,100,35,73,0.479,29,49,0.592,6,24,0.25,32,36,0.889,108,2014-04-11,TOR,NYK,2014,111.0
7048,7048,48,Home,W 100-89 ,240,37,81,0.457,28,56,0.5,9,25,0.36,17,21,0.81,100,29,74,0.392,23,52,0.442,6,22,0.273,25,32,0.781,89,2014-04-13,NYK,CHI,2014,92.0
7049,7049,49,@,L 100-110 ,240,38,73,0.521,32,63,0.508,6,10,0.6,18,26,0.692,100,38,81,0.469,24,49,0.49,14,32,0.438,20,26,0.769,110,2014-04-14,MIL,TOR,2014,117.0
7050,7050,50,@,W 100-87 ,240,38,74,0.514,28,51,0.549,10,23,0.435,14,16,0.875,100,30,73,0.411,20,43,0.465,10,30,0.333,17,22,0.773,87,2014-04-16,PHI,MIA,2014,92.0
7051,7051,51,@,L 100-105 ,240,35,81,0.432,21,51,0.412,14,30,0.467,16,24,0.667,100,43,82,0.524,37,70,0.529,6,12,0.5,13,20,0.65,105,2014-04-16,HOU,NOP,2014,108.0
7052,7052,52,Home,L 100-113 ,240,41,99,0.414,31,69,0.449,10,30,0.333,8,10,0.8,100,45,91,0.495,34,64,0.531,11,27,0.407,12,17,0.706,113,2014-04-16,SAS,LAL,2014,118.5
7053,7053,53,@,L 100-101 ,240,38,78,0.487,30,57,0.526,8,21,0.381,16,19,0.842,100,37,70,0.529,23,42,0.548,14,28,0.5,13,16,0.813,101,2014-10-28,DAL,SAS,2015,108.0
7054,7054,54,Home,W 100-91 ,240,38,81,0.469,33,63,0.524,5,18,0.278,19,19,1.0,100,37,80,0.463,31,59,0.525,6,21,0.286,11,13,0.846,91,2014-11-04,NOP,CHO,2015,94.0
7055,7055,55,Home,W 100-88 ,240,32,81,0.395,24,50,0.48,8,31,0.258,28,33,0.848,100,34,65,0.523,28,44,0.636,6,21,0.286,14,25,0.56,88,2014-11-04,TOR,OKC,2015,91.0
7056,7056,56,@,L 100-102 ,240,30,72,0.417,24,56,0.429,6,16,0.375,34,40,0.85,100,39,77,0.506,32,56,0.571,7,21,0.333,17,22,0.773,102,2014-11-05,CLE,UTA,2015,105.5
7057,7057,57,@,W 100-99 ,240,40,85,0.471,32,64,0.5,8,21,0.381,12,14,0.857,100,36,80,0.45,31,62,0.5,5,18,0.278,22,29,0.759,99,2014-11-08,NOP,SAS,2015,101.5
7058,7058,58,@,L 100-116 ,240,36,91,0.396,31,78,0.397,5,13,0.385,23,30,0.767,100,45,100,0.45,29,69,0.42,16,31,0.516,10,14,0.714,116,2014-11-09,DEN,POR,2015,124.0
7059,7059,59,Home,L 100-113 ,240,38,70,0.543,31,50,0.62,7,20,0.35,17,20,0.85,100,46,93,0.495,36,68,0.529,10,25,0.4,11,15,0.733,113,2014-11-11,GSW,SAS,2015,118.0
7060,7060,60,@,L 100-102 ,240,35,75,0.467,28,59,0.475,7,16,0.438,23,27,0.852,100,40,93,0.43,32,68,0.471,8,25,0.32,14,16,0.875,102,2014-11-11,CHA,POR,2015,106.0
7061,7061,61,@,L 100-104 ,240,39,81,0.481,27,56,0.482,12,25,0.48,10,16,0.625,100,35,77,0.455,26,56,0.464,9,21,0.429,25,30,0.833,104,2014-11-11,ORL,TOR,2015,108.5
7062,7062,62,Home,W 100-97 ,240,39,76,0.513,30,56,0.536,9,20,0.45,13,18,0.722,100,43,86,0.5,38,63,0.603,5,23,0.217,6,12,0.5,97,2014-11-12,ATL,UTA,2015,99.5
7063,7063,63,@,W 100-93 ,240,37,77,0.481,33,62,0.532,4,15,0.267,22,32,0.688,100,35,89,0.393,27,64,0.422,8,25,0.32,15,21,0.714,93,2014-11-13,CHI,TOR,2015,97.0
7064,7064,64,Home,L 100-102 ,240,39,82,0.476,34,74,0.459,5,8,0.625,17,20,0.85,100,36,70,0.514,26,48,0.542,10,22,0.455,20,25,0.8,102,2014-11-14,NYK,UTA,2015,107.0
7065,7065,65,Home,W 100-75 ,240,36,81,0.444,26,55,0.473,10,26,0.385,18,21,0.857,100,27,83,0.325,23,57,0.404,4,26,0.154,17,24,0.708,75,2014-11-17,SAS,PHI,2015,77.0
7066,7066,66,Home,L 100-106 ,240,38,86,0.442,34,75,0.453,4,11,0.364,20,29,0.69,100,39,79,0.494,30,55,0.545,9,24,0.375,19,24,0.792,106,2014-11-18,SAC,NOP,2015,110.5
7067,7067,67,@,L 100-107 ,240,36,79,0.456,26,56,0.464,10,23,0.435,18,25,0.72,100,40,82,0.488,30,53,0.566,10,29,0.345,17,22,0.773,107,2014-11-19,OKC,DEN,2015,112.0
7068,7068,68,Home,L 100-105 ,240,42,91,0.462,35,71,0.493,7,20,0.35,9,15,0.6,100,39,82,0.476,35,66,0.53,4,16,0.25,23,32,0.719,105,2014-11-21,CHA,ORL,2015,107.0
7069,7069,69,@,L 100-117 ,240,38,88,0.432,29,61,0.475,9,27,0.333,15,21,0.714,100,48,91,0.527,40,75,0.533,8,16,0.5,13,14,0.929,117,2014-11-21,BOS,MEM,2015,121.0
7070,7070,70,Home,L 100-111 ,240,36,84,0.429,31,69,0.449,5,15,0.333,23,26,0.885,100,43,93,0.462,35,75,0.467,8,18,0.444,17,22,0.773,111,2014-11-22,MIL,WAS,2015,115.0
7071,7071,71,Home,L 100-111 ,240,40,80,0.5,32,56,0.571,8,24,0.333,12,21,0.571,100,37,77,0.481,24,51,0.471,13,26,0.5,24,36,0.667,111,2014-11-24,DAL,IND,2015,117.5
7072,7072,72,@,L 100-104 ,240,39,84,0.464,25,51,0.49,14,33,0.424,8,11,0.727,100,37,82,0.451,33,65,0.508,4,17,0.235,26,32,0.813,104,2014-11-24,PHO,TOR,2015,106.0
7073,7073,73,@,L 100-106 ,240,40,87,0.46,30,66,0.455,10,21,0.476,10,18,0.556,100,41,74,0.554,36,59,0.61,5,15,0.333,19,29,0.655,106,2014-11-26,IND,SAS,2015,108.5
7074,7074,74,Home,W 100-91 ,240,38,76,0.5,33,59,0.559,5,17,0.294,19,22,0.864,100,36,89,0.404,29,65,0.446,7,24,0.292,12,16,0.75,91,2014-11-28,ATL,NOP,2015,94.5
7075,7075,75,Home,W 100-95 ,240,33,81,0.407,22,54,0.407,11,27,0.407,23,31,0.742,100,34,93,0.366,27,65,0.415,7,28,0.25,20,26,0.769,95,2014-12-06,HOU,PHO,2015,98.5
7076,7076,76,@,L 100-120 ,240,38,80,0.475,30,57,0.526,8,23,0.348,16,25,0.64,100,43,78,0.551,26,46,0.565,17,32,0.531,17,24,0.708,120,2014-12-06,NOP,LAC,2015,128.5
7077,7077,77,Home,W 100-96 ,240,40,80,0.5,36,66,0.545,4,14,0.286,16,22,0.727,100,39,84,0.464,35,64,0.547,4,20,0.2,14,23,0.609,96,2014-12-09,UTA,SAS,2015,98.0
7078,7078,78,@,W 100-95 ,240,36,72,0.5,29,52,0.558,7,20,0.35,21,31,0.677,100,34,77,0.442,26,49,0.531,8,28,0.286,19,22,0.864,95,2014-12-12,MIA,UTA,2015,99.0
7079,7079,79,Home,W 100-99 ,240,37,74,0.5,27,53,0.509,10,21,0.476,16,21,0.762,100,35,84,0.417,27,57,0.474,8,27,0.296,21,24,0.875,99,2014-12-13,ORL,ATL,2015,103.0
7080,7080,80,@,W 100-94 ,240,34,81,0.42,29,64,0.453,5,17,0.294,27,34,0.794,100,38,90,0.422,35,80,0.438,3,10,0.3,15,20,0.75,94,2014-12-14,LAL,MIN,2015,95.5
7081,7081,81,@,L 100-102 ,240,40,90,0.444,36,71,0.507,4,19,0.211,16,23,0.696,100,34,78,0.436,28,60,0.467,6,18,0.333,28,45,0.622,102,2014-12-17,IND,LAC,2015,105.0
7082,7082,82,Home,L 100-110 ,240,41,94,0.436,33,69,0.478,8,25,0.32,10,15,0.667,100,42,88,0.477,34,61,0.557,8,27,0.296,18,24,0.75,110,2014-12-19,DET,TOR,2015,114.0
7083,7083,83,Home,W 100-84 ,240,37,78,0.474,31,57,0.544,6,21,0.286,20,26,0.769,100,33,83,0.398,27,60,0.45,6,23,0.261,12,15,0.8,84,2014-12-21,MIA,BOS,2015,87.0
7084,7084,84,@,W 100-96 ,240,42,84,0.5,36,65,0.554,6,19,0.316,10,14,0.714,100,36,77,0.468,31,66,0.47,5,11,0.455,19,24,0.792,96,2014-12-21,IND,MIN,2015,98.5
7085,7085,85,Home,W 100-95 ,240,39,83,0.47,32,65,0.492,7,18,0.389,15,23,0.652,100,33,85,0.388,26,62,0.419,7,23,0.304,22,29,0.759,95,2014-12-23,ORL,BOS,2015,98.5
7086,7086,86,Home,W 100-86 ,240,34,87,0.391,25,55,0.455,9,32,0.281,23,31,0.742,100,34,80,0.425,28,52,0.538,6,28,0.214,12,22,0.545,86,2014-12-25,LAC,GSW,2015,89.0
7087,7087,87,@,L 100-107 ,240,41,88,0.466,37,74,0.5,4,14,0.286,14,16,0.875,100,41,89,0.461,35,69,0.507,6,20,0.3,19,22,0.864,107,2014-12-27,NOP,CHI,2015,110.0
7088,7088,88,Home,W 100-94 ,240,38,79,0.481,31,60,0.517,7,19,0.368,17,22,0.773,100,38,82,0.463,30,65,0.462,8,17,0.471,10,14,0.714,94,2014-12-30,UTA,MIN,2015,98.0
7089,7089,89,@,W 100-98 ,240,41,72,0.569,34,52,0.654,7,20,0.35,11,18,0.611,100,37,88,0.42,26,66,0.394,11,22,0.5,13,20,0.65,98,2015-01-02,BRK,ORL,2015,103.5
7090,7090,90,Home,W 100-95 ,240,38,89,0.427,27,66,0.409,11,23,0.478,13,18,0.722,100,37,83,0.446,30,57,0.526,7,26,0.269,14,21,0.667,95,2015-01-09,SAS,PHO,2015,98.5
7091,7091,91,@,L 100-120 ,240,38,86,0.442,26,56,0.464,12,30,0.4,12,17,0.706,100,46,88,0.523,33,57,0.579,13,31,0.419,15,21,0.714,120,2015-01-10,DAL,LAC,2015,126.5
7092,7092,92,@,L 100-108 ,240,31,75,0.413,25,60,0.417,6,15,0.4,32,37,0.865,100,37,88,0.42,29,64,0.453,8,24,0.333,26,31,0.839,108,2015-01-12,NOP,BOS,2015,112.0
7093,7093,93,@,L 100-107 ,240,36,82,0.439,23,47,0.489,13,35,0.371,15,20,0.75,100,40,76,0.526,33,56,0.589,7,20,0.35,20,27,0.741,107,2015-01-13,CLE,PHO,2015,110.5
7094,7094,94,@,W 100-94 ,240,37,88,0.42,29,65,0.446,8,23,0.348,18,19,0.947,100,35,87,0.402,29,61,0.475,6,26,0.231,18,20,0.9,94,2015-01-14,LAC,POR,2015,97.0
7095,7095,95,Home,W 100-84 ,240,38,82,0.463,28,53,0.528,10,29,0.345,14,22,0.636,100,31,80,0.388,28,61,0.459,3,19,0.158,19,31,0.613,84,2015-01-14,TOR,PHI,2015,85.5
7096,7096,96,@,L 100-115 ,240,34,75,0.453,26,58,0.448,8,17,0.471,24,35,0.686,100,43,86,0.5,30,54,0.556,13,32,0.406,16,22,0.727,115,2015-01-19,LAL,PHO,2015,121.5
7097,7097,97,Home,L 100-103 ,240,39,84,0.464,34,66,0.515,5,18,0.278,17,24,0.708,100,37,79,0.468,32,59,0.542,5,20,0.25,24,30,0.8,103,2015-01-21,SAC,BRK,2015,105.5
7098,7098,98,@,W 100-99 ,240,37,75,0.493,28,54,0.519,9,21,0.429,17,27,0.63,100,37,89,0.416,31,68,0.456,6,21,0.286,19,26,0.731,99,2015-01-23,BOS,DEN,2015,102.0
7099,7099,99,@,L 100-112 ,240,37,71,0.521,31,55,0.564,6,16,0.375,20,25,0.8,100,45,80,0.563,35,52,0.673,10,28,0.357,12,18,0.667,112,2015-01-25,MIN,ATL,2015,117.0
7100,7100,0,Home,L 100-120 ,240,34,80,0.425,24,51,0.471,10,29,0.345,22,27,0.815,100,43,87,0.494,33,64,0.516,10,23,0.435,24,36,0.667,120,2015-01-25,PHO,LAC,2015,125.0
7101,7101,1,Home,W 100-92 ,240,40,91,0.44,32,74,0.432,8,17,0.471,12,17,0.706,100,34,85,0.4,29,63,0.46,5,22,0.227,19,22,0.864,92,2015-01-28,NYK,OKC,2015,94.5
7102,7102,2,Home,L 100-115 ,240,37,82,0.451,32,64,0.5,5,18,0.278,21,30,0.7,100,45,87,0.517,33,62,0.532,12,25,0.48,13,18,0.722,115,2015-01-29,ORL,MIL,2015,121.0
7103,7103,3,@,L 100-110 ,240,37,86,0.43,29,59,0.492,8,27,0.296,18,25,0.72,100,42,94,0.447,33,69,0.478,9,25,0.36,17,28,0.607,110,2015-01-30,GSW,UTA,2015,114.5
7104,7104,4,@,L 100-102 ,240,42,89,0.472,34,66,0.515,8,23,0.348,8,25,0.32,100,41,83,0.494,29,56,0.518,12,27,0.444,8,18,0.444,102,2015-02-02,LAC,BRK,2015,108.0
7105,7105,5,Home,W 100-94 ,240,39,84,0.464,29,53,0.547,10,31,0.323,12,18,0.667,100,34,82,0.415,31,69,0.449,3,13,0.231,23,26,0.885,94,2015-02-02,DAL,MIN,2015,95.5
7106,7106,6,@,L 100-115 ,240,40,89,0.449,33,67,0.493,7,22,0.318,13,17,0.765,100,43,86,0.5,34,63,0.54,9,23,0.391,20,23,0.87,115,2015-02-02,ATL,NOP,2015,119.5
7107,7107,7,@,L 100-104 ,240,33,80,0.413,29,56,0.518,4,24,0.167,30,33,0.909,100,40,99,0.404,28,71,0.394,12,28,0.429,12,17,0.706,104,2015-02-04,DEN,BOS,2015,110.0
7108,7108,8,@,W 100-90 ,240,38,80,0.475,32,67,0.478,6,13,0.462,18,22,0.818,100,33,73,0.452,26,50,0.52,7,23,0.304,17,26,0.654,90,2015-02-04,MEM,UTA,2015,93.5
7109,7109,9,Home,W 100-93 ,240,38,84,0.452,24,57,0.421,14,27,0.519,10,14,0.714,100,37,80,0.463,30,60,0.5,7,20,0.35,12,18,0.667,93,2015-02-06,PHO,UTA,2015,96.5
7110,7110,10,@,W 100-96 ,240,39,93,0.419,30,72,0.417,9,21,0.429,13,19,0.684,100,33,79,0.418,20,57,0.351,13,22,0.591,17,20,0.85,96,2015-02-09,UTA,NOP,2015,102.5
7111,7111,11,@,L 100-111 ,240,36,87,0.414,24,50,0.48,12,37,0.324,16,26,0.615,100,44,93,0.473,35,69,0.507,9,24,0.375,14,18,0.778,111,2015-02-20,HOU,DAL,2015,115.5
7112,7112,12,Home,W 100-91 ,240,38,84,0.452,32,62,0.516,6,22,0.273,18,33,0.545,100,33,78,0.423,28,62,0.452,5,16,0.313,20,22,0.909,91,2015-02-20,DET,CHI,2015,93.5
7113,7113,13,Home,W 100-97 ,240,40,78,0.513,30,56,0.536,10,22,0.455,10,16,0.625,100,35,84,0.417,30,61,0.492,5,23,0.217,22,31,0.71,97,2015-02-23,NOP,TOR,2015,99.5
7114,7114,14,@,W 100-97 ,240,40,89,0.449,38,78,0.487,2,11,0.182,18,21,0.857,100,34,73,0.466,27,61,0.443,7,12,0.583,22,34,0.647,97,2015-02-25,LAL,UTA,2015,100.5
7115,7115,15,Home,L 100-102 ,240,42,86,0.488,31,58,0.534,11,28,0.393,5,5,1.0,100,42,83,0.506,38,67,0.567,4,16,0.25,14,17,0.824,102,2015-03-04,HOU,MEM,2015,104.0
7116,7116,16,Home,W 100-94 ,240,32,79,0.405,29,63,0.46,3,16,0.188,33,43,0.767,100,38,88,0.432,31,70,0.443,7,18,0.389,11,17,0.647,94,2015-03-04,MIA,LAL,2015,97.5
7117,7117,17,@,W 100-85 ,240,42,92,0.457,34,72,0.472,8,20,0.4,8,10,0.8,100,32,82,0.39,29,64,0.453,3,18,0.167,18,25,0.72,85,2015-03-04,DEN,MIN,2015,86.5
7118,7118,18,Home,L 100-105 ,240,41,87,0.471,36,67,0.537,5,20,0.25,13,15,0.867,100,37,79,0.468,29,58,0.5,8,21,0.381,23,27,0.852,105,2015-03-04,ORL,PHO,2015,109.0
7119,7119,19,Home,L 100-108 (OT),265,34,97,0.351,26,75,0.347,8,22,0.364,24,29,0.828,100,39,91,0.429,36,65,0.554,3,26,0.115,27,35,0.771,108,2015-03-06,BRK,PHO,2015,109.5
7120,7120,20,Home,L 100-114 ,240,38,92,0.413,29,62,0.468,9,30,0.3,15,19,0.789,100,40,86,0.465,30,58,0.517,10,28,0.357,24,32,0.75,114,2015-03-07,DEN,HOU,2015,119.0
7121,7121,21,@,W 100-93 ,240,38,78,0.487,29,52,0.558,9,26,0.346,15,22,0.682,100,38,82,0.463,36,68,0.529,2,14,0.143,15,21,0.714,93,2015-03-08,DAL,LAL,2015,94.0
7122,7122,22,@,W 100-90 ,240,39,87,0.448,33,62,0.532,6,25,0.24,16,17,0.941,100,29,69,0.42,25,52,0.481,4,17,0.235,28,34,0.824,90,2015-03-09,BOS,MIA,2015,92.0
7123,7123,23,@,L 100-105 ,240,38,91,0.418,27,60,0.45,11,31,0.355,13,23,0.565,100,42,92,0.457,32,59,0.542,10,33,0.303,11,14,0.786,105,2015-03-11,HOU,POR,2015,110.0
7124,7124,24,@,W 100-98 ,240,32,86,0.372,25,56,0.446,7,30,0.233,29,36,0.806,100,36,82,0.439,24,56,0.429,12,26,0.462,14,24,0.583,98,2015-03-15,HOU,LAC,2015,104.0
7125,7125,25,@,L 100-109 ,240,37,83,0.446,28,54,0.519,9,29,0.31,17,24,0.708,100,40,87,0.46,32,66,0.485,8,21,0.381,21,30,0.7,109,2015-03-15,CHI,OKC,2015,113.0
7126,7126,26,@,L 100-104 (OT),265,36,94,0.383,33,80,0.413,3,14,0.214,25,30,0.833,100,41,91,0.451,38,77,0.494,3,14,0.214,19,27,0.704,104,2015-03-17,SAS,NYK,2015,105.5
7127,7127,27,@,L 100-105 ,240,42,87,0.483,36,70,0.514,6,17,0.353,10,15,0.667,100,35,79,0.443,23,50,0.46,12,29,0.414,23,27,0.852,105,2015-03-18,MIN,TOR,2015,111.0
7128,7128,28,@,L 100-107 ,240,38,75,0.507,26,53,0.491,12,22,0.545,12,16,0.75,100,42,91,0.462,35,68,0.515,7,23,0.304,16,23,0.696,107,2015-03-22,NOP,LAC,2015,110.5
7129,7129,29,Home,L 100-119 ,240,41,85,0.482,37,68,0.544,4,17,0.235,14,17,0.824,100,42,90,0.467,30,62,0.484,12,28,0.429,23,30,0.767,119,2015-03-22,ORL,DEN,2015,125.0
7130,7130,30,Home,L 100-110 ,240,40,90,0.444,32,66,0.485,8,24,0.333,12,19,0.632,100,31,65,0.477,18,41,0.439,13,24,0.542,35,37,0.946,110,2015-03-23,IND,HOU,2015,116.5
7131,7131,31,@,L 100-115 ,240,37,86,0.43,22,56,0.393,15,30,0.5,11,14,0.786,100,42,80,0.525,30,54,0.556,12,26,0.462,19,22,0.864,115,2015-03-28,ATL,CHO,2015,121.0
7132,7132,32,Home,W 100-87 ,240,39,86,0.453,33,59,0.559,6,27,0.222,16,18,0.889,100,34,81,0.42,28,66,0.424,6,15,0.4,13,23,0.565,87,2015-04-01,BOS,IND,2015,90.0
7133,7133,33,@,W 100-98 ,240,41,81,0.506,32,65,0.492,9,16,0.563,9,12,0.75,100,37,81,0.457,26,58,0.448,11,23,0.478,13,15,0.867,98,2015-04-01,BRK,NYK,2015,103.5
7134,7134,34,Home,W 100-92 ,240,38,80,0.475,34,59,0.576,4,21,0.19,20,28,0.714,100,36,88,0.409,32,71,0.451,4,17,0.235,16,26,0.615,92,2015-04-03,MEM,OKC,2015,94.0
7135,7135,35,@,L 100-105 ,240,35,84,0.417,26,59,0.441,9,25,0.36,21,27,0.778,100,39,81,0.481,32,57,0.561,7,24,0.292,20,30,0.667,105,2015-04-07,LAL,LAC,2015,108.5
7136,7136,36,@,L 100-105 ,240,39,91,0.429,34,73,0.466,5,18,0.278,17,21,0.81,100,40,81,0.494,37,66,0.561,3,15,0.2,22,28,0.786,105,2015-04-07,CHA,MIA,2015,106.5
7137,7137,37,@,L 100-103 ,240,42,95,0.442,33,73,0.452,9,22,0.409,7,10,0.7,100,36,83,0.434,27,64,0.422,9,19,0.474,22,30,0.733,103,2015-04-07,GSW,NOP,2015,107.5
7138,7138,38,@,W 100-90 ,240,35,85,0.412,26,50,0.52,9,35,0.257,21,26,0.808,100,34,83,0.41,21,51,0.412,13,32,0.406,9,17,0.529,90,2015-04-13,HOU,CHO,2015,96.5
7139,7139,39,Home,W 100-93 ,240,39,83,0.47,36,73,0.493,3,10,0.3,19,23,0.826,100,35,85,0.412,29,64,0.453,6,21,0.286,17,28,0.607,93,2015-04-13,MIA,ORL,2015,96.0
7140,7140,40,@,W 100-88 ,240,37,84,0.44,31,63,0.492,6,21,0.286,20,24,0.833,100,31,78,0.397,27,64,0.422,4,14,0.286,22,28,0.786,88,2015-04-13,NOP,MIN,2015,90.0
7141,7141,41,Home,L 100-105 ,240,41,89,0.461,34,68,0.5,7,21,0.333,11,16,0.688,100,42,85,0.494,29,55,0.527,13,30,0.433,8,14,0.571,105,2015-04-15,MIL,BOS,2015,111.5
7142,7142,42,Home,L 100-115 ,240,39,93,0.419,39,84,0.464,0,9,0.0,22,28,0.786,100,42,78,0.538,28,50,0.56,14,28,0.5,17,20,0.85,115,2015-10-28,BRK,CHI,2016,122.0
7143,7143,43,Home,L 100-107 ,240,38,85,0.447,31,61,0.508,7,24,0.292,17,23,0.739,100,42,81,0.519,34,59,0.576,8,22,0.364,15,20,0.75,107,2015-11-02,PHI,CLE,2016,111.0
7144,7144,44,Home,W 100-98 ,240,35,91,0.385,27,68,0.397,8,23,0.348,22,29,0.759,100,35,83,0.422,25,56,0.446,10,27,0.37,18,22,0.818,98,2015-11-04,IND,BOS,2016,103.0
7145,7145,45,@,W 100-92 ,240,37,74,0.5,29,52,0.558,8,22,0.364,18,36,0.5,100,37,92,0.402,27,62,0.435,10,30,0.333,8,13,0.615,92,2015-11-06,DET,PHO,2016,97.0
7146,7146,46,@,W 100-84 ,240,36,75,0.48,25,48,0.521,11,27,0.407,17,23,0.739,100,24,70,0.343,21,55,0.382,3,15,0.2,33,36,0.917,84,2015-11-11,GSW,MEM,2016,85.5
7147,7147,47,@,L 100-101 ,240,33,69,0.478,25,47,0.532,8,22,0.364,26,29,0.897,100,36,86,0.419,30,70,0.429,6,16,0.375,23,27,0.852,101,2015-11-13,POR,MEM,2016,104.0
7148,7148,48,Home,W 100-81 ,240,34,77,0.442,25,56,0.446,9,21,0.429,23,27,0.852,100,30,82,0.366,23,59,0.39,7,23,0.304,14,20,0.7,81,2015-11-13,TOR,NOP,2016,84.5
7149,7149,49,@,W 100-85 ,240,39,82,0.476,30,59,0.508,9,23,0.391,13,20,0.65,100,28,77,0.364,22,52,0.423,6,25,0.24,23,29,0.793,85,2015-11-15,BOS,OKC,2016,88.0
7150,7150,50,@,L 100-115 ,240,38,73,0.521,35,65,0.538,3,8,0.375,21,26,0.808,100,40,71,0.563,29,47,0.617,11,24,0.458,24,30,0.8,115,2015-11-19,MIL,CLE,2016,120.5
7151,7151,51,Home,W 100-95 ,240,36,78,0.462,33,66,0.5,3,12,0.25,25,27,0.926,100,32,78,0.41,22,47,0.468,10,31,0.323,21,27,0.778,95,2015-11-23,MIN,PHI,2016,100.0
7152,7152,52,Home,W 100-91 ,240,34,86,0.395,29,70,0.414,5,16,0.313,27,32,0.844,100,31,83,0.373,22,56,0.393,9,27,0.333,20,25,0.8,91,2015-11-25,ORL,NYK,2016,95.5
7153,7153,53,@,L 100-106 ,240,37,93,0.398,30,74,0.405,7,19,0.368,19,22,0.864,100,39,90,0.433,29,62,0.468,10,28,0.357,18,20,0.9,106,2015-11-30,OKC,ATL,2016,111.0
7154,7154,54,Home,W 100-87 ,240,37,74,0.5,27,48,0.563,10,26,0.385,16,20,0.8,100,32,86,0.372,19,59,0.322,13,27,0.481,10,13,0.769,87,2015-12-04,ATL,LAL,2016,93.5
7155,7155,55,@,W 100-96 ,240,39,84,0.464,27,58,0.466,12,26,0.462,10,18,0.556,100,37,81,0.457,29,52,0.558,8,29,0.276,14,20,0.7,96,2015-12-04,HOU,DAL,2016,100.0
7156,7156,56,@,L 100-105 ,240,40,79,0.506,29,53,0.547,11,26,0.423,9,16,0.563,100,40,79,0.506,31,58,0.534,9,21,0.429,16,20,0.8,105,2015-12-08,POR,CLE,2016,109.5
7157,7157,57,@,L 100-105 ,240,39,91,0.429,33,70,0.471,6,21,0.286,16,23,0.696,100,38,92,0.413,33,69,0.478,5,23,0.217,24,28,0.857,105,2015-12-09,CHI,BOS,2016,107.5
7158,7158,58,Home,W 100-91 ,240,37,74,0.5,31,60,0.517,6,14,0.429,20,27,0.741,100,34,87,0.391,30,56,0.536,4,31,0.129,19,22,0.864,91,2015-12-10,BRK,PHI,2016,93.0
7159,7159,59,Home,L 100-105 ,240,35,79,0.443,30,60,0.5,5,19,0.263,25,30,0.833,100,43,86,0.5,35,62,0.565,8,24,0.333,11,18,0.611,105,2015-12-12,BRK,LAC,2016,109.0
7160,7160,60,Home,W 100-97 ,240,37,77,0.481,30,55,0.545,7,22,0.318,19,23,0.826,100,40,77,0.519,33,58,0.569,7,19,0.368,10,14,0.714,97,2015-12-13,MIA,MEM,2016,100.5
7161,7161,61,@,W 100-88 ,240,40,89,0.449,33,73,0.452,7,16,0.438,13,15,0.867,100,33,84,0.393,25,51,0.49,8,33,0.242,14,15,0.933,88,2015-12-14,MIA,ATL,2016,92.0
7162,7162,62,Home,L 100-112 ,240,36,77,0.468,32,67,0.478,4,10,0.4,24,31,0.774,100,41,73,0.562,31,55,0.564,10,18,0.556,20,27,0.741,112,2015-12-15,MIN,DEN,2016,117.0
7163,7163,63,@,L 100-104 ,240,35,74,0.473,29,54,0.537,6,20,0.3,24,28,0.857,100,41,88,0.466,29,59,0.492,12,29,0.414,10,13,0.769,104,2015-12-17,OKC,CLE,2016,110.0
7164,7164,64,@,W 100-85 ,240,38,80,0.475,35,68,0.515,3,12,0.25,21,24,0.875,100,32,78,0.41,27,57,0.474,5,21,0.238,16,20,0.8,85,2015-12-20,MIN,BRK,2016,87.5
7165,7165,65,Home,L 100-103 ,240,38,81,0.469,34,69,0.493,4,12,0.333,20,24,0.833,100,39,78,0.5,28,56,0.5,11,22,0.5,14,20,0.7,103,2015-12-20,ORL,ATL,2016,108.5
7166,7166,66,@,W 100-99 ,240,40,85,0.471,36,68,0.529,4,17,0.235,16,20,0.8,100,41,87,0.471,34,65,0.523,7,22,0.318,10,14,0.714,99,2015-12-21,OKC,LAC,2016,102.5
7167,7167,67,@,L 100-107 ,240,38,89,0.427,31,68,0.456,7,21,0.333,17,33,0.515,100,43,89,0.483,37,69,0.536,6,20,0.3,15,20,0.75,107,2015-12-23,DET,ATL,2016,110.0
7168,7168,68,@,L 100-113 ,240,37,81,0.457,30,61,0.492,7,20,0.35,19,29,0.655,100,51,85,0.6,46,73,0.63,5,12,0.417,6,8,0.75,113,2015-12-23,PHI,MIL,2016,115.5
7169,7169,69,Home,W 100-91 ,240,37,82,0.451,26,57,0.456,11,25,0.44,15,19,0.789,100,33,72,0.458,30,55,0.545,3,17,0.176,22,32,0.688,91,2015-12-23,WAS,MEM,2016,92.5
7170,7170,70,Home,W 100-91 ,240,36,85,0.424,28,65,0.431,8,20,0.4,20,29,0.69,100,33,89,0.371,29,70,0.414,4,19,0.211,21,24,0.875,91,2015-12-27,BOS,NYK,2016,93.0
7171,7171,71,@,L 100-102 (OT),265,37,97,0.381,30,75,0.4,7,22,0.318,19,24,0.792,100,37,86,0.43,31,68,0.456,6,18,0.333,22,27,0.815,102,2015-12-30,IND,CHI,2016,105.0
7172,7172,72,Home,W 100-93 ,240,36,82,0.439,27,56,0.482,9,26,0.346,19,21,0.905,100,35,83,0.422,32,63,0.508,3,20,0.15,20,22,0.909,93,2015-12-30,ORL,BRK,2016,94.5
7173,7173,73,@,W 100-97 ,240,38,93,0.409,35,75,0.467,3,18,0.167,21,22,0.955,100,34,88,0.386,27,56,0.482,7,32,0.219,22,28,0.786,97,2016-01-02,BRK,BOS,2016,100.5
7174,7174,74,@,L 100-122 ,240,36,73,0.493,28,54,0.519,8,19,0.421,20,29,0.69,100,41,74,0.554,24,41,0.585,17,33,0.515,23,26,0.885,122,2016-01-04,TOR,CLE,2016,130.5
7175,7175,75,@,L 100-103 (OT),265,37,94,0.394,29,66,0.439,8,28,0.286,18,25,0.72,100,34,90,0.378,29,68,0.426,5,22,0.227,30,39,0.769,103,2016-01-04,IND,MIA,2016,105.5
7176,7176,76,@,W 100-91 ,240,37,87,0.425,30,59,0.508,7,28,0.25,19,22,0.864,100,34,92,0.37,27,62,0.435,7,30,0.233,16,20,0.8,91,2016-01-06,DAL,NOP,2016,94.5
7177,7177,77,Home,W 100-99 ,240,41,93,0.441,37,80,0.463,4,13,0.308,14,17,0.824,100,38,91,0.418,29,70,0.414,9,21,0.429,14,17,0.824,99,2016-01-08,SAS,NYK,2016,103.5
7178,7178,78,Home,W 100-88 ,240,39,84,0.464,32,60,0.533,7,24,0.292,15,18,0.833,100,32,80,0.4,29,67,0.433,3,13,0.231,21,30,0.7,88,2016-01-10,NYK,MIL,2016,89.5
7179,7179,79,Home,L 100-114 ,240,34,81,0.42,25,59,0.424,9,22,0.409,23,27,0.852,100,48,99,0.485,39,75,0.52,9,24,0.375,9,10,0.9,114,2016-01-11,CHI,WAS,2016,118.5
7180,7180,80,@,L 100-112 ,240,39,76,0.513,34,62,0.548,5,14,0.357,17,19,0.895,100,43,85,0.506,30,61,0.492,13,24,0.542,13,18,0.722,112,2016-01-18,BRK,TOR,2016,118.5
7181,7181,81,@,L 100-107 ,240,33,80,0.413,20,56,0.357,13,24,0.542,21,29,0.724,100,38,77,0.494,33,64,0.516,5,13,0.385,26,31,0.839,107,2016-01-26,ORL,MIL,2016,109.5
7182,7182,82,Home,L 100-105 ,240,40,82,0.488,33,66,0.5,7,16,0.438,13,15,0.867,100,42,98,0.429,32,68,0.471,10,30,0.333,11,16,0.688,105,2016-02-01,BRK,DET,2016,110.0
7183,7183,83,Home,L 100-114 ,240,36,81,0.444,29,58,0.5,7,23,0.304,21,31,0.677,100,44,88,0.5,32,64,0.5,12,24,0.5,14,17,0.824,114,2016-02-03,BRK,IND,2016,120.0
7184,7184,84,@,W 100-93 ,240,37,81,0.457,28,56,0.5,9,25,0.36,17,33,0.515,100,33,83,0.398,26,66,0.394,7,17,0.412,20,29,0.69,93,2016-02-07,LAC,MIA,2016,96.5
7185,7185,85,@,L 100-120 ,240,36,82,0.439,27,59,0.458,9,23,0.391,19,29,0.655,100,45,94,0.479,29,59,0.492,16,35,0.457,14,19,0.737,120,2016-02-08,SAC,CLE,2016,128.0
7186,7186,86,Home,W 100-96 ,240,39,82,0.476,31,63,0.492,8,19,0.421,14,21,0.667,100,33,70,0.471,26,49,0.531,7,21,0.333,23,30,0.767,96,2016-02-10,NOP,UTA,2016,99.5
7187,7187,87,Home,L 100-116 ,240,30,82,0.366,19,47,0.404,11,35,0.314,29,35,0.829,100,37,78,0.474,30,54,0.556,7,24,0.292,35,56,0.625,116,2016-02-19,PHO,HOU,2016,119.5
7188,7188,88,Home,W 100-95 ,240,37,84,0.44,31,66,0.47,6,18,0.333,20,29,0.69,100,38,101,0.376,31,77,0.403,7,24,0.292,12,17,0.706,95,2016-02-29,BOS,UTA,2016,98.5
7189,7189,89,Home,W 100-96 ,240,35,83,0.422,26,54,0.481,9,29,0.31,21,25,0.84,100,37,80,0.463,29,62,0.468,8,18,0.444,14,15,0.933,96,2016-02-29,CLE,IND,2016,100.0
7190,7190,90,Home,W 100-95 ,240,36,81,0.444,33,46,0.717,3,35,0.086,25,38,0.658,100,36,90,0.4,22,53,0.415,14,37,0.378,9,13,0.692,95,2016-03-02,HOU,NOP,2016,102.0
7191,7191,91,@,L 100-108 ,240,35,87,0.402,26,52,0.5,9,35,0.257,21,30,0.7,100,36,79,0.456,27,58,0.466,9,21,0.429,27,34,0.794,108,2016-03-05,HOU,CHI,2016,112.5
7192,7192,92,@,W 100-99 ,240,37,83,0.446,30,62,0.484,7,21,0.333,19,20,0.95,100,39,89,0.438,33,74,0.446,6,15,0.4,15,24,0.625,99,2016-03-05,IND,WAS,2016,102.0
7193,7193,93,Home,L 100-109 ,240,32,80,0.4,22,58,0.379,10,22,0.455,26,33,0.788,100,37,71,0.521,25,43,0.581,12,28,0.429,23,30,0.767,109,2016-03-06,MEM,PHO,2016,115.0
7194,7194,94,Home,W 100-90 ,240,39,78,0.5,29,53,0.547,10,25,0.4,12,15,0.8,100,36,91,0.396,29,73,0.397,7,18,0.389,11,17,0.647,90,2016-03-07,CHI,MIL,2016,93.5
7195,7195,95,Home,L 100-107 ,240,35,88,0.398,27,63,0.429,8,25,0.32,22,25,0.88,100,41,79,0.519,37,64,0.578,4,15,0.267,21,34,0.618,107,2016-03-11,SAC,ORL,2016,109.0
7196,7196,96,@,L 100-116 ,240,36,86,0.419,29,65,0.446,7,21,0.333,21,29,0.724,100,42,80,0.525,34,56,0.607,8,24,0.333,24,29,0.828,116,2016-03-12,WAS,DEN,2016,120.0
7197,7197,97,Home,L 100-109 ,240,39,70,0.557,27,43,0.628,12,27,0.444,10,13,0.769,100,45,89,0.506,39,75,0.52,6,14,0.429,13,21,0.619,109,2016-03-13,BRK,MIL,2016,112.0
7198,7198,98,@,L 100-105 ,240,40,83,0.482,32,61,0.525,8,22,0.364,12,18,0.667,100,35,81,0.432,29,61,0.475,6,20,0.3,29,45,0.644,105,2016-03-20,ORL,TOR,2016,108.0
7199,7199,99,Home,L 100-105 ,240,34,74,0.459,26,56,0.464,8,18,0.444,24,27,0.889,100,39,82,0.476,29,54,0.537,10,28,0.357,17,21,0.81,105,2016-03-22,BRK,CHO,2016,110.0
7200,7200,0,@,L 100-107 ,240,40,80,0.5,36,65,0.554,4,15,0.267,16,23,0.696,100,39,77,0.506,33,58,0.569,6,19,0.316,23,24,0.958,107,2016-03-22,MEM,LAL,2016,110.0
7201,7201,1,Home,L 100-102 ,240,40,106,0.377,31,84,0.369,9,22,0.409,11,15,0.733,100,36,85,0.424,31,63,0.492,5,22,0.227,25,28,0.893,102,2016-03-28,CHI,ATL,2016,104.5
7202,7202,2,Home,L 100-119 ,240,38,93,0.409,30,69,0.435,8,24,0.333,16,23,0.696,100,41,86,0.477,30,60,0.5,11,26,0.423,26,32,0.813,119,2016-03-28,TOR,OKC,2016,124.5
7203,7203,3,Home,L 100-106 ,240,31,86,0.36,17,46,0.37,14,40,0.35,24,28,0.857,100,38,79,0.481,29,54,0.537,9,25,0.36,21,42,0.5,106,2016-03-29,CLE,HOU,2016,110.5
7204,7204,4,@,W 100-85 ,240,38,87,0.437,31,62,0.5,7,25,0.28,17,18,0.944,100,30,96,0.313,14,52,0.269,16,44,0.364,9,10,0.9,85,2016-03-29,CHA,PHI,2016,93.0
7205,7205,5,@,L 100-102 (OT),265,41,86,0.477,38,69,0.551,3,17,0.176,15,26,0.577,100,37,102,0.363,31,82,0.378,6,20,0.3,22,29,0.759,102,2016-03-30,MIA,LAL,2016,105.0
7206,7206,6,Home,W 100-92 ,240,36,75,0.48,24,51,0.471,12,24,0.5,16,22,0.727,100,36,80,0.45,28,63,0.444,8,17,0.471,12,18,0.667,92,2016-03-30,SAS,NOP,2016,96.0
7207,7207,7,Home,L 100-103 ,240,36,90,0.4,27,65,0.415,9,25,0.36,19,22,0.864,100,37,77,0.481,26,53,0.491,11,24,0.458,18,22,0.818,103,2016-03-31,HOU,CHI,2016,108.5
7208,7208,8,Home,W 100-91 ,240,36,84,0.429,29,57,0.509,7,27,0.259,21,27,0.778,100,33,90,0.367,23,51,0.451,10,39,0.256,15,21,0.714,91,2016-04-01,CHA,PHI,2016,96.0
7209,7209,9,Home,L 100-107 ,240,37,90,0.411,31,69,0.449,6,21,0.286,20,29,0.69,100,41,91,0.451,33,61,0.541,8,30,0.267,17,22,0.773,107,2016-04-03,LAL,BOS,2016,111.0
7210,7210,10,@,W 100-99 ,240,39,87,0.448,29,51,0.569,10,36,0.278,12,13,0.923,100,37,96,0.385,30,75,0.4,7,21,0.333,18,20,0.9,99,2016-04-09,GSW,MEM,2016,102.5
7211,7211,11,Home,L 100-121 ,240,39,95,0.411,32,74,0.432,7,21,0.333,15,20,0.75,100,43,83,0.518,33,58,0.569,10,25,0.4,25,31,0.806,121,2016-04-09,NOP,PHO,2016,126.0
7212,7212,12,@,W 100-84 ,240,36,79,0.456,24,48,0.5,12,31,0.387,16,21,0.762,100,32,80,0.4,26,53,0.491,6,27,0.222,14,19,0.737,84,2016-04-10,UTA,DEN,2016,87.0
7213,7213,13,Home,L 100-114 ,240,34,89,0.382,26,65,0.4,8,24,0.333,24,29,0.828,100,41,81,0.506,27,49,0.551,14,32,0.438,18,22,0.818,114,2016-04-11,BOS,CHO,2016,121.0
7214,7214,14,Home,L 100-129 ,240,40,85,0.471,33,52,0.635,7,33,0.212,13,18,0.722,100,47,98,0.48,35,74,0.473,12,24,0.5,23,26,0.885,129,2016-10-25,GSW,SAS,2017,135.0
7215,7215,15,Home,L 100-106 ,240,37,90,0.411,29,67,0.433,8,23,0.348,18,25,0.72,100,35,83,0.422,27,54,0.5,8,29,0.276,28,33,0.848,106,2016-10-30,PHO,GSW,2017,110.0
7216,7216,16,@,L 100-107 ,240,35,81,0.432,28,61,0.459,7,20,0.35,23,31,0.742,100,41,87,0.471,27,55,0.491,14,32,0.438,11,17,0.647,107,2016-11-02,CHI,BOS,2017,114.0
7217,7217,17,@,W 100-86 ,240,37,83,0.446,31,63,0.492,6,20,0.3,20,22,0.909,100,30,80,0.375,19,54,0.352,11,26,0.423,15,24,0.625,86,2016-11-04,SAS,UTA,2017,91.5
7218,7218,18,@,W 100-94 ,240,32,71,0.451,18,38,0.474,14,33,0.424,22,27,0.815,100,31,81,0.383,25,55,0.455,6,26,0.231,26,32,0.813,94,2016-11-06,POR,MEM,2017,97.0
7219,7219,19,@,L 100-122 ,240,40,94,0.426,31,61,0.508,9,33,0.273,11,15,0.733,100,41,84,0.488,29,52,0.558,12,32,0.375,28,32,0.875,122,2016-11-07,IND,CHO,2017,128.0
7220,7220,20,@,L 100-107 ,240,32,89,0.36,23,67,0.343,9,22,0.409,27,32,0.844,100,38,84,0.452,30,62,0.484,8,22,0.364,23,30,0.767,107,2016-11-09,DET,PHO,2017,111.0
7221,7221,21,Home,L 100-106 ,240,34,89,0.382,19,42,0.452,15,47,0.319,17,21,0.81,100,41,76,0.539,36,58,0.621,5,18,0.278,19,24,0.792,106,2016-11-12,HOU,SAS,2017,108.5
7222,7222,22,Home,W 100-93 ,240,39,92,0.424,25,54,0.463,14,38,0.368,8,15,0.533,100,36,95,0.379,25,66,0.379,11,29,0.379,10,12,0.833,93,2016-11-13,CLE,CHO,2017,98.5
7223,7223,23,@,L 100-107 ,240,39,98,0.398,31,66,0.47,8,32,0.25,14,18,0.778,100,35,72,0.486,25,40,0.625,10,32,0.313,27,31,0.871,107,2016-11-16,MIL,ATL,2017,112.0
7224,7224,24,Home,W 100-96 ,240,37,90,0.411,27,61,0.443,10,29,0.345,16,24,0.667,100,39,84,0.464,32,56,0.571,7,28,0.25,11,17,0.647,96,2016-11-18,CHA,ATL,2017,99.5
7225,7225,25,Home,L 100-112 ,240,42,88,0.477,36,66,0.545,6,22,0.273,10,14,0.714,100,40,75,0.533,31,51,0.608,9,24,0.375,23,29,0.793,112,2016-11-26,WAS,SAS,2017,116.5
7226,7226,26,@,L 100-105 ,240,36,86,0.419,29,57,0.509,7,29,0.241,21,30,0.7,100,37,85,0.435,25,50,0.5,12,35,0.343,19,24,0.792,105,2016-11-28,ATL,GSW,2017,111.0
7227,7227,27,@,L 100-103 ,240,35,81,0.432,28,60,0.467,7,21,0.333,23,29,0.793,100,41,88,0.466,31,58,0.534,10,30,0.333,11,15,0.733,103,2016-12-03,LAL,MEM,2017,108.0
7228,7228,28,Home,L 100-103 ,240,35,87,0.402,28,59,0.475,7,28,0.25,23,27,0.852,100,36,84,0.429,26,55,0.473,10,29,0.345,21,25,0.84,103,2016-12-09,SAC,NYK,2017,108.0
7229,7229,29,@,L 100-105 ,240,42,91,0.462,37,71,0.521,5,20,0.25,11,18,0.611,100,38,84,0.452,37,76,0.487,1,8,0.125,28,31,0.903,105,2016-12-10,MIA,CHI,2017,105.5
7230,7230,30,@,L 100-122 ,240,42,89,0.472,38,65,0.585,4,24,0.167,12,17,0.706,100,42,81,0.519,28,56,0.5,14,25,0.56,24,28,0.857,122,2016-12-12,MIL,TOR,2017,129.0
7231,7231,31,@,L 100-122 ,240,40,98,0.408,31,71,0.437,9,27,0.333,11,20,0.55,100,42,94,0.447,18,33,0.545,24,61,0.393,14,19,0.737,122,2016-12-16,NOP,HOU,2017,134.0
7232,7232,32,@,W 100-89 ,240,36,79,0.456,27,49,0.551,9,30,0.3,19,22,0.864,100,32,88,0.364,26,57,0.456,6,31,0.194,19,24,0.792,89,2016-12-16,LAL,PHI,2017,92.0
7233,7233,33,@,L 100-103 ,240,35,77,0.455,23,49,0.469,12,28,0.429,18,21,0.857,100,37,65,0.569,29,43,0.674,8,22,0.364,21,27,0.778,103,2016-12-16,DAL,UTA,2017,107.0
7234,7234,34,@,L 100-113 ,240,41,89,0.461,31,63,0.492,10,26,0.385,8,14,0.571,100,42,86,0.488,31,64,0.484,11,22,0.5,18,22,0.818,113,2016-12-18,NOP,SAS,2017,118.5
7235,7235,35,Home,L 100-102 ,240,35,92,0.38,29,54,0.537,6,38,0.158,24,27,0.889,100,36,77,0.468,24,54,0.444,12,23,0.522,18,25,0.72,102,2016-12-20,HOU,SAS,2017,108.0
7236,7236,36,@,L 100-112 ,240,39,83,0.47,35,71,0.493,4,12,0.333,18,23,0.783,100,42,82,0.512,34,58,0.586,8,24,0.333,20,24,0.833,112,2016-12-25,MIN,OKC,2017,116.0
7237,7237,37,@,L 100-119 ,240,39,86,0.453,32,68,0.471,7,18,0.389,15,20,0.75,100,48,85,0.565,39,67,0.582,9,18,0.5,14,19,0.737,119,2016-12-25,CHI,SAS,2017,123.5
7238,7238,38,@,L 100-102 ,240,39,79,0.494,30,54,0.556,9,25,0.36,13,18,0.722,100,39,87,0.448,32,62,0.516,7,25,0.28,17,21,0.81,102,2016-12-26,PHI,SAC,2017,105.5
7239,7239,39,Home,L 100-102 ,240,39,83,0.47,35,67,0.522,4,16,0.25,18,22,0.818,100,38,75,0.507,29,49,0.592,9,26,0.346,17,24,0.708,102,2016-12-27,LAL,UTA,2017,106.5
7240,7240,40,Home,W 100-83 ,240,35,73,0.479,20,47,0.426,15,26,0.577,15,28,0.536,100,35,87,0.402,29,63,0.46,6,24,0.25,7,8,0.875,83,2016-12-29,UTA,PHI,2017,86.0
7241,7241,41,@,L 100-127 ,240,38,92,0.413,30,60,0.5,8,32,0.25,16,27,0.593,100,48,96,0.5,38,68,0.559,10,28,0.357,21,29,0.724,127,2017-01-06,MIA,LAL,2017,132.0
7242,7242,42,@,W 100-93 ,240,39,86,0.453,24,37,0.649,15,49,0.306,7,12,0.583,100,38,91,0.418,30,68,0.441,8,23,0.348,9,13,0.692,93,2017-01-06,HOU,ORL,2017,97.0
7243,7243,43,Home,W 100-94 ,240,32,73,0.438,19,50,0.38,13,23,0.565,23,29,0.793,100,36,82,0.439,24,55,0.436,12,27,0.444,10,16,0.625,94,2017-01-10,SAC,DET,2017,100.0
7244,7244,44,Home,W 100-92 ,240,38,79,0.481,25,45,0.556,13,34,0.382,11,19,0.579,100,31,85,0.365,22,54,0.407,9,31,0.29,21,25,0.84,92,2017-01-10,UTA,CLE,2017,96.5
7245,7245,45,@,L 100-121 ,240,38,90,0.422,30,62,0.484,8,28,0.286,16,19,0.842,100,46,85,0.541,36,64,0.563,10,21,0.476,19,27,0.704,121,2017-01-18,OKC,GSW,2017,126.0
7246,7246,46,Home,L 100-106 ,240,35,72,0.486,26,51,0.51,9,21,0.429,21,27,0.778,100,39,75,0.52,32,54,0.593,7,21,0.333,21,25,0.84,106,2017-01-18,SAC,IND,2017,109.5
7247,7247,47,@,L 100-109 ,240,39,77,0.506,29,57,0.509,10,20,0.5,12,17,0.706,100,39,84,0.464,33,60,0.55,6,24,0.25,25,32,0.781,109,2017-01-21,IND,UTA,2017,112.0
7248,7248,48,@,W 100-92 ,240,35,77,0.455,28,55,0.509,7,22,0.318,23,30,0.767,100,35,85,0.412,28,63,0.444,7,22,0.318,15,20,0.75,92,2017-01-24,CHI,ORL,2017,95.5
7249,7249,49,@,W 100-88 ,240,41,89,0.461,32,65,0.492,9,24,0.375,9,11,0.818,100,33,79,0.418,30,66,0.455,3,13,0.231,19,25,0.76,88,2017-01-27,MIA,CHI,2017,89.5
7250,7250,50,Home,L 100-128 ,240,38,100,0.38,28,63,0.444,10,37,0.27,14,17,0.824,100,49,81,0.605,43,66,0.652,6,15,0.4,24,30,0.8,128,2017-02-01,OKC,CHI,2017,131.0
7251,7251,51,Home,L 100-116 ,240,35,73,0.479,25,51,0.49,10,22,0.455,20,24,0.833,100,35,73,0.479,18,42,0.429,17,31,0.548,29,37,0.784,116,2017-02-11,IND,MIL,2017,124.5
7252,7252,52,@,L 100-116 ,240,39,88,0.443,27,53,0.509,12,35,0.343,10,14,0.714,100,46,88,0.523,39,74,0.527,7,14,0.5,17,19,0.895,116,2017-02-23,DEN,SAC,2017,119.5
7253,7253,53,Home,W 100-96 ,240,39,76,0.513,33,56,0.589,6,20,0.3,16,18,0.889,100,40,83,0.482,35,69,0.507,5,14,0.357,11,16,0.688,96,2017-02-26,MIL,PHO,2017,98.5
7254,7254,54,Home,W 100-95 ,240,36,64,0.563,26,43,0.605,10,21,0.476,18,24,0.75,100,35,77,0.455,21,44,0.477,14,33,0.424,11,13,0.846,95,2017-03-01,ATL,DAL,2017,102.0
7255,7255,55,Home,L 100-109 ,240,35,81,0.432,24,59,0.407,11,22,0.5,19,22,0.864,100,34,74,0.459,23,46,0.5,11,28,0.393,30,36,0.833,109,2017-03-01,SAC,BRK,2017,114.5
7256,7256,56,Home,W 100-99 ,240,35,74,0.473,26,45,0.578,9,29,0.31,21,24,0.875,100,37,81,0.457,30,58,0.517,7,23,0.304,18,25,0.72,99,2017-03-01,SAS,IND,2017,102.5
7257,7257,57,@,L 100-104 ,240,38,82,0.463,29,54,0.537,9,28,0.321,15,22,0.682,100,39,82,0.476,34,55,0.618,5,27,0.185,21,27,0.778,104,2017-03-03,MEM,DAL,2017,106.5
7258,7258,58,Home,W 100-88 ,240,35,86,0.407,24,55,0.436,11,31,0.355,19,21,0.905,100,37,81,0.457,25,51,0.49,12,30,0.4,2,3,0.667,88,2017-03-06,CHA,IND,2017,94.0
7259,7259,59,Home,W 99-91 ,240,36,77,0.468,32,62,0.516,4,15,0.267,23,31,0.742,99,34,82,0.415,26,58,0.448,8,24,0.333,15,22,0.682,91,2011-12-26,GSW,CHI,2012,95.0
7260,7260,60,Home,W 99-82 ,240,38,73,0.521,29,57,0.509,9,16,0.563,14,22,0.636,99,21,67,0.313,15,45,0.333,6,22,0.273,34,41,0.829,82,2011-12-29,LAL,NYK,2012,85.0
7261,7261,61,Home,W 99-86 ,240,32,72,0.444,25,47,0.532,7,25,0.28,28,38,0.737,99,33,72,0.458,27,58,0.466,6,14,0.429,14,18,0.778,86,2011-12-30,DAL,TOR,2012,89.0
7262,7262,62,@,L 99-102 ,240,37,77,0.481,33,64,0.516,4,13,0.308,21,29,0.724,99,35,79,0.443,29,63,0.46,6,16,0.375,26,33,0.788,102,2011-12-30,PHI,UTA,2012,105.0
7263,7263,63,Home,W 99-90 ,240,33,71,0.465,31,53,0.585,2,18,0.111,31,37,0.838,99,35,88,0.398,31,65,0.477,4,23,0.174,16,24,0.667,90,2012-01-01,DEN,LAL,2012,92.0
7264,7264,64,Home,W 99-82 ,240,36,85,0.424,26,63,0.413,10,22,0.455,17,24,0.708,99,29,77,0.377,22,53,0.415,7,24,0.292,17,21,0.81,82,2012-01-01,MIN,DAL,2012,85.5
7265,7265,65,@,L 99-108 ,240,41,96,0.427,30,65,0.462,11,31,0.355,6,7,0.857,99,41,78,0.526,36,64,0.563,5,14,0.357,21,27,0.778,108,2012-01-03,HOU,LAL,2012,110.5
7266,7266,66,@,W 99-83 ,240,40,76,0.526,35,64,0.547,5,12,0.417,14,21,0.667,99,36,88,0.409,35,82,0.427,1,6,0.167,10,12,0.833,83,2012-01-04,CHI,DET,2012,83.5
7267,7267,67,@,W 99-96 ,240,39,89,0.438,33,71,0.465,6,18,0.333,15,21,0.714,99,41,85,0.482,35,71,0.493,6,14,0.429,8,13,0.615,96,2012-01-06,NYK,WAS,2012,99.0
7268,7268,68,Home,W 99-77 ,240,39,77,0.506,37,68,0.544,2,9,0.222,19,26,0.731,99,29,89,0.326,24,73,0.329,5,16,0.313,14,21,0.667,77,2012-01-07,IND,CHA,2012,79.5
7269,7269,69,Home,W 99-83 ,240,39,80,0.488,37,63,0.587,2,17,0.118,19,23,0.826,99,34,80,0.425,27,60,0.45,7,20,0.35,8,12,0.667,83,2012-01-10,LAL,PHO,2012,86.5
7270,7270,70,Home,W 99-83 ,240,38,74,0.514,32,57,0.561,6,17,0.353,17,25,0.68,99,34,84,0.405,29,66,0.439,5,18,0.278,10,14,0.714,83,2012-01-13,SAS,POR,2012,85.5
7271,7271,71,Home,W 99-60 ,240,37,81,0.457,30,65,0.462,7,16,0.438,18,25,0.72,99,22,86,0.256,20,65,0.308,2,21,0.095,14,18,0.778,60,2012-01-14,DAL,SAC,2012,61.0
7272,7272,72,@,L 99-108 ,240,35,75,0.467,31,65,0.477,4,10,0.4,25,31,0.806,99,35,78,0.449,30,68,0.441,5,10,0.5,33,41,0.805,108,2012-01-14,NOP,MEM,2012,110.5
7273,7273,73,@,W 99-91 ,240,38,73,0.521,35,58,0.603,3,15,0.2,20,27,0.741,99,31,74,0.419,24,55,0.436,7,19,0.368,22,26,0.846,91,2012-01-15,GSW,DET,2012,94.5
7274,7274,74,Home,W 99-86 ,240,37,80,0.463,27,54,0.5,10,26,0.385,15,19,0.789,99,35,79,0.443,31,62,0.5,4,17,0.235,12,20,0.6,86,2012-01-16,MIN,SAC,2012,88.0
7275,7275,75,Home,W 99-79 ,240,41,77,0.532,34,61,0.557,7,16,0.438,10,14,0.714,99,28,82,0.341,24,68,0.353,4,14,0.286,19,27,0.704,79,2012-01-23,OKC,DET,2012,81.0
7276,7276,76,@,W 99-96 ,240,34,82,0.415,26,67,0.388,8,15,0.533,23,25,0.92,99,39,82,0.476,34,66,0.515,5,16,0.313,13,17,0.765,96,2012-01-24,TOR,PHO,2012,98.5
7277,7277,77,Home,L 99-105 ,240,38,93,0.409,30,62,0.484,8,31,0.258,15,20,0.75,99,39,91,0.429,25,62,0.403,14,29,0.483,13,17,0.765,105,2012-01-25,HOU,MIL,2012,112.0
7278,7278,78,@,W 99-96 ,240,36,79,0.456,25,51,0.49,11,28,0.393,16,21,0.762,99,38,81,0.469,32,62,0.516,6,19,0.316,14,24,0.583,96,2012-01-27,BRK,CLE,2012,99.0
7279,7279,79,Home,W 99-89 ,240,37,80,0.463,35,70,0.5,2,10,0.2,23,26,0.885,99,30,84,0.357,12,41,0.293,18,43,0.419,11,14,0.786,89,2012-01-27,MIA,NYK,2012,98.0
7280,7280,80,Home,L 99-102 ,240,39,83,0.47,35,72,0.486,4,11,0.364,17,29,0.586,99,40,76,0.526,34,65,0.523,6,11,0.545,16,21,0.762,102,2012-01-28,CHA,WAS,2012,105.0
7281,7281,81,Home,L 99-122 ,240,35,80,0.438,23,59,0.39,12,21,0.571,17,20,0.85,99,48,87,0.552,34,60,0.567,14,27,0.519,12,18,0.667,122,2012-01-30,PHO,DAL,2012,129.0
7282,7282,82,@,L 99-106 ,240,35,74,0.473,23,45,0.511,12,29,0.414,17,23,0.739,99,38,73,0.521,34,62,0.548,4,11,0.364,26,36,0.722,106,2012-01-31,BRK,IND,2012,108.0
7283,7283,83,Home,L 99-109 ,240,34,91,0.374,31,74,0.419,3,17,0.176,28,37,0.757,99,38,84,0.452,31,69,0.449,7,15,0.467,26,34,0.765,109,2012-02-01,MIN,IND,2012,112.5
7284,7284,84,Home,W 99-96 ,240,38,79,0.481,30,56,0.536,8,23,0.348,15,25,0.6,99,40,82,0.488,35,64,0.547,5,18,0.278,11,14,0.786,96,2012-02-01,BRK,DET,2012,98.5
7285,7285,85,Home,W 99-91 ,240,35,76,0.461,28,58,0.483,7,18,0.389,22,31,0.71,99,36,79,0.456,27,57,0.474,9,22,0.409,10,13,0.769,91,2012-02-01,SAS,HOU,2012,95.5
7286,7286,86,Home,W 99-81 ,240,39,89,0.438,35,74,0.473,4,15,0.267,17,17,1.0,99,34,83,0.41,30,64,0.469,4,19,0.211,9,14,0.643,81,2012-02-03,HOU,PHO,2012,83.0
7287,7287,87,@,W 99-79 ,240,40,77,0.519,32,64,0.5,8,13,0.615,11,20,0.55,99,32,81,0.395,27,69,0.391,5,12,0.417,10,14,0.714,79,2012-02-03,MIA,PHI,2012,81.5
7288,7288,88,Home,W 99-92 ,240,37,83,0.446,35,69,0.507,2,14,0.143,23,26,0.885,99,30,72,0.417,20,46,0.435,10,26,0.385,22,26,0.846,92,2012-02-04,NYK,NJN,2012,97.0
7289,7289,89,@,W 99-90 ,240,41,79,0.519,30,55,0.545,11,24,0.458,6,7,0.857,99,33,84,0.393,27,60,0.45,6,24,0.25,18,21,0.857,90,2012-02-06,PHO,ATL,2012,93.0
7290,7290,90,@,W 99-90 ,240,35,81,0.432,25,62,0.403,10,19,0.526,19,24,0.792,99,34,78,0.436,31,56,0.554,3,22,0.136,19,33,0.576,90,2012-02-06,HOU,DEN,2012,91.5
7291,7291,91,Home,W 99-88 ,240,35,73,0.479,26,45,0.578,9,28,0.321,20,31,0.645,99,33,76,0.434,31,65,0.477,2,11,0.182,20,26,0.769,88,2012-02-06,NYK,UTA,2012,89.0
7292,7292,92,@,L 99-104 ,240,37,78,0.474,33,68,0.485,4,10,0.4,21,23,0.913,99,41,87,0.471,37,73,0.507,4,14,0.286,18,22,0.818,104,2012-02-07,UTA,IND,2012,106.0
7293,7293,93,Home,W 99-92 ,240,36,71,0.507,29,53,0.547,7,18,0.389,20,26,0.769,99,32,78,0.41,29,63,0.46,3,15,0.2,25,29,0.862,92,2012-02-08,CLE,LAC,2012,93.5
7294,7294,94,@,W 99-92 ,240,39,73,0.534,37,64,0.578,2,9,0.222,19,29,0.655,99,33,78,0.423,23,51,0.451,10,27,0.37,16,20,0.8,92,2012-02-08,DET,NJN,2012,97.0
7295,7295,95,Home,L 99-105 ,240,37,90,0.411,28,66,0.424,9,24,0.375,16,17,0.941,99,33,72,0.458,21,47,0.447,12,25,0.48,27,37,0.73,105,2012-02-08,TOR,MIL,2012,111.0
7296,7296,96,@,W 99-84 ,240,35,79,0.443,29,65,0.446,6,14,0.429,23,30,0.767,99,31,84,0.369,28,70,0.4,3,14,0.214,19,25,0.76,84,2012-02-11,PHI,CLE,2012,85.5
7297,7297,97,@,W 99-94 ,240,35,81,0.432,20,44,0.455,15,37,0.405,14,21,0.667,99,39,93,0.419,30,71,0.423,9,22,0.409,7,7,1.0,94,2012-02-11,ORL,MIL,2012,98.5
7298,7298,98,@,W 99-95 ,240,36,83,0.434,30,69,0.435,6,14,0.429,21,32,0.656,99,39,84,0.464,36,71,0.507,3,13,0.231,14,25,0.56,95,2012-02-14,SAS,DET,2012,96.5
7299,7299,99,Home,L 99-101 ,240,37,69,0.536,31,52,0.596,6,17,0.353,19,27,0.704,99,38,80,0.475,28,59,0.475,10,21,0.476,15,18,0.833,101,2012-02-15,PHO,ATL,2012,106.0
7300,7300,0,@,L 99-111 ,240,41,90,0.456,33,64,0.516,8,26,0.308,9,13,0.692,99,44,83,0.53,39,72,0.542,5,11,0.455,18,24,0.75,111,2012-02-17,PHO,LAL,2012,113.5
7301,7301,1,Home,W 99-82 ,240,38,80,0.475,30,58,0.517,8,22,0.364,15,24,0.625,99,32,81,0.395,24,52,0.462,8,29,0.276,10,18,0.556,82,2012-02-22,NYK,ATL,2012,86.0
7302,7302,2,Home,L 99-114 ,240,37,83,0.446,30,64,0.469,7,19,0.368,18,21,0.857,99,41,86,0.477,28,59,0.475,13,27,0.481,19,23,0.826,114,2012-02-23,DEN,SAS,2012,120.5
7303,7303,3,Home,W 99-95 ,240,41,90,0.456,38,72,0.528,3,18,0.167,14,20,0.7,99,36,89,0.404,32,80,0.4,4,9,0.444,19,22,0.864,95,2012-02-28,CHI,NOH,2012,97.0
7304,7304,4,Home,W 99-94 ,240,39,86,0.453,31,63,0.492,8,23,0.348,13,15,0.867,99,32,85,0.376,26,67,0.388,6,18,0.333,24,28,0.857,94,2012-03-02,ATL,MIL,2012,97.0
7305,7305,5,Home,L 99-102 ,240,38,72,0.528,32,56,0.571,6,16,0.375,17,20,0.85,99,38,81,0.469,34,70,0.486,4,11,0.364,22,32,0.688,102,2012-03-02,TOR,MEM,2012,104.0
7306,7306,6,Home,W 99-98 ,240,38,90,0.422,35,80,0.438,3,10,0.3,20,27,0.741,99,37,75,0.493,29,58,0.5,8,17,0.471,16,22,0.727,98,2012-03-02,UTA,MIA,2012,102.0
7307,7307,7,@,W 99-94 ,240,36,86,0.419,30,69,0.435,6,17,0.353,21,28,0.75,99,32,72,0.444,22,45,0.489,10,27,0.37,20,27,0.741,94,2012-03-04,DEN,SAS,2012,99.0
7308,7308,8,@,W 99-93 ,240,39,87,0.448,38,80,0.475,1,7,0.143,20,24,0.833,99,32,68,0.471,29,61,0.475,3,7,0.429,26,37,0.703,93,2012-03-07,UTA,CHA,2012,94.5
7309,7309,9,Home,L 99-100 ,240,35,81,0.432,31,61,0.508,4,20,0.2,25,32,0.781,99,37,82,0.451,30,59,0.508,7,23,0.304,19,23,0.826,100,2012-03-07,DEN,CLE,2012,103.5
7310,7310,10,Home,W 99-98 ,240,38,76,0.5,30,53,0.566,8,23,0.348,15,23,0.652,99,42,77,0.545,39,68,0.574,3,9,0.333,11,12,0.917,98,2012-03-07,SAC,NOH,2012,99.5
7311,7311,11,@,W 99-94 ,240,32,76,0.421,21,50,0.42,11,26,0.423,24,31,0.774,99,35,86,0.407,30,64,0.469,5,22,0.227,19,26,0.731,94,2012-03-08,ORL,CHI,2012,96.5
7312,7312,12,Home,L 99-110 ,240,39,82,0.476,34,66,0.515,5,16,0.313,16,25,0.64,99,40,78,0.513,36,61,0.59,4,17,0.235,26,27,0.963,110,2012-03-10,WAS,POR,2012,112.0
7313,7313,13,Home,L 99-106 ,240,38,82,0.463,28,53,0.528,10,29,0.345,13,17,0.765,99,42,82,0.512,35,61,0.574,7,21,0.333,15,23,0.652,106,2012-03-11,SAC,ATL,2012,109.5
7314,7314,14,Home,L 99-105 ,240,40,86,0.465,36,73,0.493,4,13,0.308,15,19,0.789,99,35,73,0.479,29,55,0.527,6,18,0.333,29,35,0.829,105,2012-03-11,TOR,MIL,2012,108.0
7315,7315,15,@,L 99-104 ,240,37,80,0.463,34,69,0.493,3,11,0.273,22,31,0.71,99,40,93,0.43,35,79,0.443,5,14,0.357,19,28,0.679,104,2012-03-12,NYK,CHI,2012,106.5
7316,7316,16,Home,L 99-105 ,240,37,76,0.487,33,59,0.559,4,17,0.235,21,29,0.724,99,43,92,0.467,33,67,0.493,10,25,0.4,9,11,0.818,105,2012-03-12,BRK,MIL,2012,110.0
7317,7317,17,@,W 99-89 ,240,39,75,0.52,33,57,0.579,6,18,0.333,15,17,0.882,99,34,75,0.453,30,61,0.492,4,14,0.286,17,19,0.895,89,2012-03-15,WAS,NOH,2012,91.0
7318,7318,18,@,L 99-106 ,240,39,79,0.494,28,55,0.509,11,24,0.458,10,18,0.556,99,37,79,0.468,26,55,0.473,11,24,0.458,21,25,0.84,106,2012-03-17,SAS,DAL,2012,111.5
7319,7319,19,Home,W 99-92 (OT),265,42,101,0.416,40,88,0.455,2,13,0.154,13,16,0.813,99,33,80,0.413,27,55,0.491,6,25,0.24,20,25,0.8,92,2012-03-17,UTA,GSW,2012,95.0
7320,7320,20,Home,L 99-103 ,240,33,73,0.452,31,60,0.517,2,13,0.154,31,40,0.775,99,43,91,0.473,41,81,0.506,2,10,0.2,15,22,0.682,103,2012-03-18,LAL,UTA,2012,104.0
7321,7321,21,Home,W 99-86 ,240,40,85,0.471,33,65,0.508,7,20,0.35,12,19,0.632,99,35,82,0.427,34,71,0.479,1,11,0.091,15,22,0.682,86,2012-03-18,PHO,HOU,2012,86.5
7322,7322,22,@,L 99-115 ,240,38,92,0.413,32,67,0.478,6,25,0.24,17,17,1.0,99,44,96,0.458,36,68,0.529,8,28,0.286,19,21,0.905,115,2012-03-18,MIN,SAC,2012,119.0
7323,7323,23,Home,W 99-95 ,240,36,76,0.474,35,67,0.522,1,9,0.111,26,35,0.743,99,36,80,0.45,30,65,0.462,6,15,0.4,17,24,0.708,95,2012-03-20,MIA,PHO,2012,98.0
7324,7324,24,Home,W 99-86 ,240,41,92,0.446,38,82,0.463,3,10,0.3,14,18,0.778,99,36,74,0.486,32,64,0.5,4,10,0.4,10,13,0.769,86,2012-03-23,PHI,BOS,2012,88.0
7325,7325,25,Home,L 99-101 (OT),265,37,96,0.385,28,71,0.394,9,25,0.36,16,18,0.889,99,37,80,0.463,31,58,0.534,6,22,0.273,21,24,0.875,101,2012-03-24,HOU,DAL,2012,104.0
7326,7326,26,Home,W 99-93 ,240,39,80,0.488,27,52,0.519,12,28,0.429,9,13,0.692,99,33,71,0.465,26,58,0.448,7,13,0.538,20,21,0.952,93,2012-03-29,POR,NOH,2012,96.5
7327,7327,27,@,W 99-88 ,240,38,73,0.521,36,56,0.643,2,17,0.118,21,29,0.724,99,36,98,0.367,30,76,0.395,6,22,0.273,10,11,0.909,88,2012-03-30,DEN,CHA,2012,91.0
7328,7328,28,@,W 99-95 ,240,37,88,0.42,33,73,0.452,4,15,0.267,21,28,0.75,99,34,82,0.415,29,65,0.446,5,17,0.294,22,28,0.786,95,2012-03-31,MEM,MIL,2012,97.5
7329,7329,29,Home,L 99-111 ,240,39,90,0.433,36,73,0.493,3,17,0.176,18,23,0.783,99,43,92,0.467,33,64,0.516,10,28,0.357,15,20,0.75,111,2012-03-31,SAC,NJN,2012,116.0
7330,7330,30,Home,W 99-92 ,240,37,77,0.481,33,60,0.55,4,17,0.235,21,23,0.913,99,34,71,0.479,26,51,0.51,8,20,0.4,16,20,0.8,92,2012-04-01,TOR,WAS,2012,96.0
7331,7331,31,@,W 99-93 ,240,42,89,0.472,38,76,0.5,4,13,0.308,11,14,0.786,99,40,83,0.482,35,66,0.53,5,17,0.294,8,17,0.471,93,2012-04-02,HOU,CHI,2012,95.5
7332,7332,32,Home,W 99-93 ,240,35,75,0.467,32,62,0.516,3,13,0.231,26,32,0.813,99,38,83,0.458,35,73,0.479,3,10,0.3,14,17,0.824,93,2012-04-03,MIA,PHI,2012,94.5
7333,7333,33,@,W 99-78 ,240,39,77,0.506,30,56,0.536,9,21,0.429,12,12,1.0,99,34,79,0.43,31,67,0.463,3,12,0.25,7,8,0.875,78,2012-04-04,TOR,PHI,2012,79.5
7334,7334,34,Home,W 99-94 ,240,36,68,0.529,32,58,0.552,4,10,0.4,23,39,0.59,99,33,78,0.423,26,57,0.456,7,21,0.333,21,29,0.724,94,2012-04-05,DET,WAS,2012,97.5
7335,7335,35,@,W 99-97 (OT),265,41,94,0.436,33,73,0.452,8,21,0.381,9,11,0.818,99,42,93,0.452,35,69,0.507,7,24,0.292,6,8,0.75,97,2012-04-06,POR,DAL,2012,100.5
7336,7336,36,@,L 99-105 ,240,34,82,0.415,26,60,0.433,8,22,0.364,23,29,0.793,99,37,92,0.402,26,65,0.4,11,27,0.407,20,31,0.645,105,2012-04-06,PHO,DEN,2012,110.5
7337,7337,37,Home,W 99-90 ,240,40,82,0.488,36,69,0.522,4,13,0.308,15,19,0.789,99,33,81,0.407,23,56,0.411,10,25,0.4,14,18,0.778,90,2012-04-07,NOP,MIN,2012,95.0
7338,7338,38,@,L 99-100 (OT),265,35,89,0.393,28,67,0.418,7,22,0.318,22,31,0.71,99,39,102,0.382,31,68,0.456,8,34,0.235,14,20,0.7,100,2012-04-08,CHI,NYK,2012,104.0
7339,7339,39,Home,L 99-105 ,240,37,84,0.44,28,61,0.459,9,23,0.391,16,26,0.615,99,37,92,0.402,30,73,0.411,7,19,0.368,24,26,0.923,105,2012-04-14,MIL,IND,2012,108.5
7340,7340,40,Home,L 99-120 ,240,38,93,0.409,30,73,0.411,8,20,0.4,15,17,0.882,99,36,92,0.391,24,65,0.369,12,27,0.444,36,43,0.837,120,2012-04-16,GSW,SAS,2012,126.0
7341,7341,41,@,W 99-87 ,240,37,79,0.468,33,63,0.524,4,16,0.25,21,28,0.75,99,38,90,0.422,34,71,0.479,4,19,0.211,7,10,0.7,87,2012-04-18,LAL,GSW,2012,89.0
7342,7342,42,@,L 99-105 (OT),265,37,89,0.416,26,58,0.448,11,31,0.355,14,25,0.56,99,41,87,0.471,37,67,0.552,4,20,0.2,19,24,0.792,105,2012-04-19,HOU,NOH,2012,107.0
7343,7343,43,Home,W 99-96 ,240,40,84,0.476,30,58,0.517,10,26,0.385,9,15,0.6,99,36,73,0.493,31,57,0.544,5,16,0.313,19,22,0.864,96,2012-04-21,HOU,GSW,2012,98.5
7344,7344,44,Home,W 99-93 ,240,36,77,0.468,27,53,0.509,9,24,0.375,18,24,0.75,99,34,70,0.486,23,45,0.511,11,25,0.44,14,25,0.56,93,2012-04-25,NYK,LAC,2012,98.5
7345,7345,45,@,W 99-91 ,240,40,85,0.471,35,70,0.5,5,15,0.333,14,18,0.778,99,38,77,0.494,35,64,0.547,3,13,0.231,12,31,0.387,91,2012-10-30,DAL,LAL,2013,92.5
7346,7346,46,@,W 99-95 ,240,38,80,0.475,32,60,0.533,6,20,0.3,17,26,0.654,99,35,80,0.438,31,63,0.492,4,17,0.235,21,23,0.913,95,2012-10-31,SAS,NOH,2013,97.0
7347,7347,47,@,W 99-88 ,240,40,86,0.465,32,68,0.471,8,18,0.444,11,12,0.917,99,33,74,0.446,28,60,0.467,5,14,0.357,17,21,0.81,88,2012-11-02,MIL,BOS,2013,90.5
7348,7348,48,@,L 99-126 ,240,39,91,0.429,36,74,0.486,3,17,0.176,18,24,0.75,99,49,80,0.613,33,55,0.6,16,25,0.64,12,15,0.8,126,2012-11-03,CHA,DAL,2013,134.0
7349,7349,49,@,L 99-124 ,240,35,88,0.398,28,67,0.418,7,21,0.333,22,29,0.759,99,47,86,0.547,32,60,0.533,15,26,0.577,15,19,0.789,124,2012-11-05,PHO,MIA,2013,131.5
7350,7350,50,Home,W 99-93 ,240,40,84,0.476,38,78,0.487,2,6,0.333,17,24,0.708,99,36,86,0.419,28,67,0.418,8,19,0.421,13,17,0.765,93,2012-11-06,CHI,ORL,2013,97.0
7351,7351,51,@,L 99-107 ,240,40,83,0.482,33,62,0.532,7,21,0.333,12,18,0.667,99,43,83,0.518,35,61,0.574,8,22,0.364,13,21,0.619,107,2012-11-09,CHA,NOH,2013,111.0
7352,7352,52,@,W 99-89 ,240,41,84,0.488,32,60,0.533,9,24,0.375,8,11,0.727,99,37,75,0.493,32,61,0.525,5,14,0.357,10,17,0.588,89,2012-11-13,NYK,ORL,2013,91.5
7353,7353,53,Home,W 99-85 ,240,38,91,0.418,35,75,0.467,3,16,0.188,20,25,0.8,99,30,80,0.375,25,60,0.417,5,20,0.25,20,31,0.645,85,2012-11-14,MIL,IND,2013,87.5
7354,7354,54,Home,W 99-93 ,240,40,87,0.46,30,69,0.435,10,18,0.556,9,10,0.9,99,36,81,0.444,29,59,0.492,7,22,0.318,14,18,0.778,93,2012-11-16,PHI,UTA,2013,96.5
7355,7355,55,@,W 99-90 ,240,36,75,0.48,31,58,0.534,5,17,0.294,22,25,0.88,99,37,80,0.463,31,62,0.5,6,18,0.333,10,19,0.526,90,2012-11-18,BRK,SAC,2013,93.0
7356,7356,56,Home,W 99-95 (OT),265,37,89,0.416,30,60,0.5,7,29,0.241,18,24,0.75,99,36,99,0.364,32,84,0.381,4,15,0.267,19,22,0.864,95,2012-12-01,SAS,MEM,2013,97.0
7357,7357,57,@,L 99-106 ,240,39,80,0.488,31,57,0.544,8,23,0.348,13,19,0.684,99,40,90,0.444,28,61,0.459,12,29,0.414,14,17,0.824,106,2012-12-02,PHO,NYK,2013,112.0
7358,7358,58,Home,W 99-92 ,240,36,80,0.45,27,54,0.5,9,26,0.346,18,19,0.947,99,34,79,0.43,28,57,0.491,6,22,0.273,18,22,0.818,92,2012-12-05,IND,POR,2013,95.0
7359,7359,59,@,L 99-110 ,240,35,84,0.417,30,72,0.417,5,12,0.417,24,29,0.828,99,40,85,0.471,34,64,0.531,6,21,0.286,24,28,0.857,110,2012-12-05,MIL,SAS,2013,113.0
7360,7360,60,@,L 99-131 ,240,33,82,0.402,26,58,0.448,7,24,0.292,26,31,0.839,99,45,91,0.495,32,68,0.471,13,23,0.565,28,35,0.8,131,2012-12-07,TOR,UTA,2013,137.5
7361,7361,61,@,L 99-117 ,240,36,78,0.462,27,54,0.5,9,24,0.375,18,20,0.9,99,48,93,0.516,41,70,0.586,7,23,0.304,14,24,0.583,117,2012-12-08,PHO,LAC,2013,120.5
7362,7362,62,@,W 99-80 ,240,36,86,0.419,27,67,0.403,9,19,0.474,18,22,0.818,99,29,75,0.387,21,54,0.389,8,21,0.381,14,18,0.778,80,2012-12-08,SAC,POR,2013,84.0
7363,7363,63,Home,W 99-93 ,240,34,76,0.447,25,52,0.481,9,24,0.375,22,30,0.733,99,35,89,0.393,28,64,0.438,7,25,0.28,16,20,0.8,93,2012-12-12,HOU,WAS,2013,96.5
7364,7364,64,Home,W 99-96 ,240,41,84,0.488,33,65,0.508,8,19,0.421,9,15,0.6,99,37,87,0.425,29,68,0.426,8,19,0.421,14,18,0.778,96,2012-12-12,UTA,SAS,2013,100.0
7365,7365,65,Home,W 99-94 ,240,36,69,0.522,32,59,0.542,4,10,0.4,23,26,0.885,99,39,94,0.415,32,75,0.427,7,19,0.368,9,10,0.9,94,2012-12-14,DEN,MEM,2013,97.5
7366,7366,66,Home,W 99-85 ,240,41,86,0.477,32,65,0.492,9,21,0.429,8,11,0.727,99,34,92,0.37,27,72,0.375,7,20,0.35,10,11,0.909,85,2012-12-14,ORL,GSW,2013,88.5
7367,7367,67,Home,W 99-84 ,240,38,83,0.458,32,70,0.457,6,13,0.462,17,22,0.773,99,33,82,0.402,30,71,0.423,3,11,0.273,15,21,0.714,84,2012-12-14,PHO,UTA,2013,85.5
7368,7368,68,@,W 99-86 ,240,38,85,0.447,34,74,0.459,4,11,0.364,19,24,0.792,99,31,74,0.419,26,57,0.456,5,17,0.294,19,24,0.792,86,2012-12-15,MEM,UTA,2013,88.5
7369,7369,69,Home,L 99-113 ,240,36,70,0.514,29,54,0.537,7,16,0.438,20,30,0.667,99,39,75,0.52,27,51,0.529,12,24,0.5,23,27,0.852,113,2012-12-18,CLE,TOR,2013,119.0
7370,7370,70,Home,W 99-93 ,240,37,84,0.44,28,64,0.438,9,20,0.45,16,23,0.696,99,33,82,0.402,28,62,0.452,5,20,0.25,22,26,0.846,93,2012-12-20,MIN,OKC,2013,95.5
7371,7371,71,@,W 99-94 (OT),265,36,83,0.434,31,67,0.463,5,16,0.313,22,36,0.611,99,36,94,0.383,31,70,0.443,5,24,0.208,17,20,0.85,94,2012-12-21,MIL,BOS,2013,96.5
7372,7372,72,@,W 99-89 ,240,39,80,0.488,34,64,0.531,5,16,0.313,16,25,0.64,99,32,80,0.4,27,64,0.422,5,16,0.313,20,26,0.769,89,2012-12-21,IND,CLE,2013,91.5
7373,7373,73,Home,W 99-80 ,240,44,86,0.512,36,67,0.537,8,19,0.421,3,7,0.429,99,31,79,0.392,22,54,0.407,9,25,0.36,9,12,0.75,80,2012-12-21,PHI,ATL,2013,84.5
7374,7374,74,Home,W 99-94 ,240,39,76,0.513,35,58,0.603,4,18,0.222,17,23,0.739,99,39,86,0.453,37,70,0.529,2,16,0.125,14,16,0.875,94,2012-12-21,SAS,NOH,2013,95.0
7375,7375,75,@,W 99-89 ,240,37,71,0.521,28,55,0.509,9,16,0.563,16,23,0.696,99,35,90,0.389,30,75,0.4,5,15,0.333,14,17,0.824,89,2012-12-26,PHI,MEM,2013,91.5
7376,7376,76,@,W 99-97 ,240,40,88,0.455,31,66,0.47,9,22,0.409,10,14,0.714,99,38,83,0.458,30,62,0.484,8,21,0.381,13,16,0.813,97,2012-12-26,NYK,PHO,2013,101.0
7377,7377,77,@,L 99-109 ,240,39,77,0.506,30,48,0.625,9,29,0.31,12,16,0.75,99,43,74,0.581,31,55,0.564,12,19,0.632,11,17,0.647,109,2012-12-28,MIA,DET,2013,115.0
7378,7378,78,Home,L 99-103 ,240,37,94,0.394,34,72,0.472,3,22,0.136,22,33,0.667,99,41,86,0.477,33,64,0.516,8,22,0.364,13,20,0.65,103,2013-01-01,LAL,PHI,2013,107.0
7379,7379,79,@,W 99-96 (OT),265,39,86,0.453,31,65,0.477,8,21,0.381,13,16,0.813,99,39,85,0.459,32,66,0.485,7,19,0.368,11,13,0.846,96,2013-01-05,NOP,DAL,2013,99.5
7380,7380,80,Home,W 99-71 ,240,38,82,0.463,30,61,0.492,8,21,0.381,15,16,0.938,99,29,81,0.358,23,60,0.383,6,21,0.286,7,14,0.5,71,2013-01-06,MIA,WAS,2013,74.0
7381,7381,81,@,L 99-101 ,240,34,80,0.425,28,55,0.509,6,25,0.24,25,30,0.833,99,38,87,0.437,28,69,0.406,10,18,0.556,15,18,0.833,101,2013-01-07,OKC,WAS,2013,106.0
7382,7382,82,@,L 99-108 ,240,37,90,0.411,33,70,0.471,4,20,0.2,21,26,0.808,99,42,91,0.462,33,74,0.446,9,17,0.529,15,19,0.789,108,2013-01-08,PHO,MIL,2013,112.5
7383,7383,83,Home,W 99-83 ,240,37,81,0.457,25,58,0.431,12,23,0.522,13,20,0.65,99,37,84,0.44,30,62,0.484,7,22,0.318,2,5,0.4,83,2013-01-09,CLE,ATL,2013,86.5
7384,7384,84,Home,W 99-93 ,240,38,79,0.481,28,55,0.509,10,24,0.417,13,21,0.619,99,36,84,0.429,30,66,0.455,6,18,0.333,15,18,0.833,93,2013-01-09,LAC,DAL,2013,96.0
7385,7385,85,Home,W 99-79 ,240,34,75,0.453,28,62,0.452,6,13,0.462,25,32,0.781,99,31,79,0.392,24,65,0.369,7,14,0.5,10,16,0.625,79,2013-01-11,BRK,PHO,2013,82.5
7386,7386,86,Home,W 99-78 ,240,39,86,0.453,27,59,0.458,12,27,0.444,9,11,0.818,99,28,75,0.373,25,63,0.397,3,12,0.25,19,22,0.864,78,2013-01-11,TOR,CHA,2013,79.5
7387,7387,87,Home,L 99-128 ,240,38,87,0.437,29,69,0.42,9,18,0.5,14,19,0.737,99,45,80,0.563,28,43,0.651,17,37,0.459,21,24,0.875,128,2013-01-12,SAC,MIA,2013,136.5
7388,7388,88,@,W 99-73 ,240,35,76,0.461,30,62,0.484,5,14,0.357,24,32,0.75,99,27,89,0.303,21,69,0.304,6,20,0.3,13,17,0.765,73,2013-01-14,LAC,MEM,2013,76.0
7389,7389,89,Home,L 99-111 ,240,39,82,0.476,28,61,0.459,11,21,0.524,10,13,0.769,99,44,83,0.53,34,65,0.523,10,18,0.556,13,18,0.722,111,2013-01-15,PHI,NOH,2013,116.0
7390,7390,90,@,W 99-90 ,240,40,83,0.482,38,70,0.543,2,13,0.154,17,23,0.739,99,31,72,0.431,21,50,0.42,10,22,0.455,18,28,0.643,90,2013-01-17,MIA,LAL,2013,95.0
7391,7391,91,Home,L 99-100 (OT),265,38,91,0.418,35,77,0.455,3,14,0.214,20,28,0.714,99,36,75,0.48,31,60,0.517,5,15,0.333,23,32,0.719,100,2013-01-18,BOS,CHI,2013,102.5
7392,7392,92,@,L 99-106 ,240,38,83,0.458,27,53,0.509,11,30,0.367,12,22,0.545,99,39,75,0.52,27,53,0.509,12,22,0.545,16,18,0.889,106,2013-01-21,LAC,GSW,2013,112.0
7393,7393,93,@,L 99-104 ,240,36,78,0.462,31,62,0.5,5,16,0.313,22,27,0.815,99,37,84,0.44,31,61,0.508,6,23,0.261,24,27,0.889,104,2013-01-23,OKC,GSW,2013,107.0
7394,7394,94,@,L 99-108 ,240,41,81,0.506,35,69,0.507,6,12,0.5,11,14,0.786,99,41,83,0.494,34,59,0.576,7,24,0.292,19,23,0.826,108,2013-01-26,PHO,SAS,2013,111.5
7395,7395,95,@,W 99-98 ,240,37,78,0.474,31,67,0.463,6,11,0.545,19,22,0.864,99,40,82,0.488,35,65,0.538,5,17,0.294,13,18,0.722,98,2013-01-26,CLE,TOR,2013,100.5
7396,7396,96,Home,W 99-81 ,240,39,73,0.534,34,57,0.596,5,16,0.313,16,20,0.8,99,29,73,0.397,23,56,0.411,6,17,0.353,17,26,0.654,81,2013-01-30,BOS,SAC,2013,84.0
7397,7397,97,@,L 99-104 ,240,37,78,0.474,29,56,0.518,8,22,0.364,17,28,0.607,99,34,68,0.5,30,56,0.536,4,12,0.333,32,46,0.696,104,2013-01-30,NOP,UTA,2013,106.0
7398,7398,98,@,L 99-117 ,240,35,88,0.398,29,68,0.426,6,20,0.3,23,26,0.885,99,45,83,0.542,41,69,0.594,4,14,0.286,23,43,0.535,117,2013-02-01,CLE,DET,2013,119.0
7399,7399,99,Home,L 99-109 ,240,38,89,0.427,34,74,0.459,4,15,0.267,19,25,0.76,99,40,88,0.455,32,67,0.478,8,21,0.381,21,25,0.84,109,2013-02-01,PHO,DAL,2013,113.0
7400,7400,0,@,L 99-105 ,240,39,90,0.433,31,71,0.437,8,19,0.421,13,16,0.813,99,38,75,0.507,28,57,0.491,10,18,0.556,19,28,0.679,105,2013-02-02,UTA,POR,2013,110.0
7401,7401,1,Home,W 99-94 ,240,41,81,0.506,40,69,0.58,1,12,0.083,16,24,0.667,99,34,80,0.425,26,55,0.473,8,25,0.32,18,20,0.9,94,2013-02-04,MIA,CHA,2013,98.0
7402,7402,2,Home,W 99-85 ,240,36,79,0.456,22,45,0.489,14,34,0.412,13,16,0.813,99,38,90,0.422,35,77,0.455,3,13,0.231,6,12,0.5,85,2013-02-04,NYK,DET,2013,86.5
7403,7403,3,@,L 99-105 ,240,36,84,0.429,26,54,0.481,10,30,0.333,17,19,0.895,99,41,86,0.477,31,66,0.47,10,20,0.5,13,19,0.684,105,2013-02-06,POR,DAL,2013,110.0
7404,7404,4,@,W 99-95 ,240,35,73,0.479,31,54,0.574,4,19,0.211,25,30,0.833,99,34,82,0.415,30,64,0.469,4,18,0.222,23,26,0.885,95,2013-02-06,BOS,TOR,2013,97.0
7405,7405,5,Home,W 99-93 ,240,36,79,0.456,28,59,0.475,8,20,0.4,19,23,0.826,99,36,74,0.486,30,57,0.526,6,17,0.353,15,20,0.75,93,2013-02-08,MEM,GSW,2013,96.0
7406,7406,6,Home,W 99-63 ,240,41,87,0.471,36,75,0.48,5,12,0.417,12,18,0.667,99,24,74,0.324,22,57,0.386,2,17,0.118,13,13,1.0,63,2013-02-13,NOP,POR,2013,64.0
7407,7407,7,Home,L 99-105 ,240,36,89,0.404,25,64,0.391,11,25,0.44,16,21,0.762,99,40,81,0.494,32,64,0.5,8,17,0.471,17,23,0.739,105,2013-02-20,CHA,DET,2013,109.0
7408,7408,8,@,L 99-113 ,240,39,82,0.476,30,62,0.484,9,20,0.45,12,20,0.6,99,42,83,0.506,35,61,0.574,7,22,0.318,22,31,0.71,113,2013-02-20,BOS,LAL,2013,116.5
7409,7409,9,Home,L 99-113 ,240,37,82,0.451,35,71,0.493,2,11,0.182,23,30,0.767,99,44,83,0.53,37,64,0.578,7,19,0.368,18,22,0.818,113,2013-02-23,CHA,DEN,2013,116.5
7410,7410,10,Home,L 99-103 ,240,39,87,0.448,31,69,0.449,8,18,0.444,13,19,0.684,99,34,72,0.472,21,47,0.447,13,25,0.52,22,31,0.71,103,2013-02-24,DAL,LAL,2013,109.5
7411,7411,11,Home,L 99-100 ,240,37,85,0.435,36,74,0.486,1,11,0.091,24,31,0.774,99,37,81,0.457,30,64,0.469,7,17,0.412,19,23,0.826,100,2013-02-24,MIN,GSW,2013,103.5
7412,7412,12,Home,W 99-93 ,240,32,75,0.427,24,42,0.571,8,33,0.242,27,35,0.771,99,36,85,0.424,32,72,0.444,4,13,0.308,17,20,0.85,93,2013-02-24,NYK,PHI,2013,95.0
7413,7413,13,@,W 99-91 ,240,39,80,0.488,35,57,0.614,4,23,0.174,17,21,0.81,99,32,75,0.427,23,50,0.46,9,25,0.36,18,25,0.72,91,2013-02-28,LAC,IND,2013,95.5
7414,7414,14,Home,W 99-98 ,240,38,78,0.487,28,57,0.491,10,21,0.476,13,18,0.722,99,41,82,0.5,33,60,0.55,8,22,0.364,8,15,0.533,98,2013-03-03,LAL,ATL,2013,102.0
7415,7415,15,@,W 99-93 ,240,39,84,0.464,31,64,0.484,8,20,0.4,13,19,0.684,99,32,74,0.432,24,45,0.533,8,29,0.276,21,26,0.808,93,2013-03-03,MIA,NYK,2013,97.0
7416,7416,16,@,W 99-78 ,240,34,67,0.507,21,40,0.525,13,27,0.481,18,22,0.818,99,32,84,0.381,28,66,0.424,4,18,0.222,10,15,0.667,78,2013-03-06,BRK,CHA,2013,80.0
7417,7417,17,Home,L 99-102 ,240,39,96,0.406,30,66,0.455,9,30,0.3,12,19,0.632,99,41,78,0.526,30,56,0.536,11,22,0.5,9,15,0.6,102,2013-03-08,DET,DAL,2013,107.5
7418,7418,18,Home,W 99-91 ,240,41,83,0.494,29,56,0.518,12,27,0.444,5,7,0.714,99,40,86,0.465,35,74,0.473,5,12,0.417,6,10,0.6,91,2013-03-10,ORL,PHI,2013,93.5
7419,7419,19,@,W 99-93 ,240,33,78,0.423,20,52,0.385,13,26,0.5,20,30,0.667,99,37,99,0.374,25,72,0.347,12,27,0.444,7,9,0.778,93,2013-03-15,LAL,IND,2013,99.0
7420,7420,20,Home,W 99-76 ,240,42,87,0.483,34,67,0.507,8,20,0.4,7,15,0.467,99,29,87,0.333,24,65,0.369,5,22,0.227,13,16,0.813,76,2013-03-18,PHO,LAL,2013,78.5
7421,7421,21,@,W 99-89 ,240,41,84,0.488,31,63,0.492,10,21,0.476,7,10,0.7,99,39,89,0.438,35,75,0.467,4,14,0.286,7,11,0.636,89,2013-03-21,POR,CHI,2013,91.0
7422,7422,22,@,W 99-94 ,240,38,71,0.535,28,49,0.571,10,22,0.455,13,24,0.542,99,36,79,0.456,25,47,0.532,11,32,0.344,11,14,0.786,94,2013-03-22,NYK,TOR,2013,99.5
7423,7423,23,Home,L 99-104 ,240,42,92,0.457,37,71,0.521,5,21,0.238,10,18,0.556,99,39,78,0.5,29,52,0.558,10,26,0.385,16,21,0.762,104,2013-03-24,MIL,ATL,2013,109.0
7424,7424,24,@,L 99-100 ,240,42,88,0.477,42,78,0.538,0,10,0.0,15,17,0.882,99,35,76,0.461,25,61,0.41,10,15,0.667,20,27,0.741,100,2013-03-27,DEN,SAS,2013,105.0
7425,7425,25,@,W 99-82 ,240,44,82,0.537,40,69,0.58,4,13,0.308,7,9,0.778,99,31,76,0.408,26,58,0.448,5,18,0.278,15,23,0.652,82,2013-03-29,TOR,DET,2013,84.5
7426,7426,26,Home,L 99-109 ,240,37,98,0.378,25,69,0.362,12,29,0.414,13,15,0.867,99,40,75,0.533,36,59,0.61,4,16,0.25,25,32,0.781,109,2013-03-30,MIL,OKC,2013,111.0
7427,7427,27,@,W 99-86 ,240,37,73,0.507,31,63,0.492,6,10,0.6,19,27,0.704,99,29,67,0.433,24,51,0.471,5,16,0.313,23,34,0.676,86,2013-03-30,MEM,MIN,2013,88.5
7428,7428,28,Home,W 99-97 ,240,36,80,0.45,33,65,0.508,3,15,0.2,24,29,0.828,99,35,83,0.422,30,71,0.423,5,12,0.417,22,25,0.88,97,2013-04-06,SAS,ATL,2013,99.5
7429,7429,29,Home,W 99-85 ,240,39,73,0.534,30,55,0.545,9,18,0.5,12,17,0.706,99,33,73,0.452,30,58,0.517,3,15,0.2,16,25,0.64,85,2013-04-07,DET,CHI,2013,86.5
7430,7430,30,Home,W 99-94 ,240,32,79,0.405,28,63,0.444,4,16,0.25,31,46,0.674,99,39,85,0.459,36,75,0.48,3,10,0.3,13,15,0.867,94,2013-04-09,IND,CLE,2013,95.5
7431,7431,31,@,L 99-120 ,240,35,77,0.455,27,57,0.474,8,20,0.4,21,30,0.7,99,45,80,0.563,25,44,0.568,20,36,0.556,10,14,0.714,120,2013-04-09,WAS,NYK,2013,130.0
7432,7432,32,@,L 99-103 ,240,37,78,0.474,36,65,0.554,1,13,0.077,24,32,0.75,99,39,81,0.481,31,57,0.544,8,24,0.333,17,23,0.739,103,2013-04-17,DET,BRK,2013,107.0
7433,7433,33,Home,W 99-87 ,240,42,82,0.512,36,66,0.545,6,16,0.375,9,11,0.818,99,31,84,0.369,27,73,0.37,4,11,0.364,21,28,0.75,87,2013-04-17,DAL,NOH,2013,89.0
7434,7434,34,Home,W 99-95 (OT),265,33,90,0.367,23,58,0.397,10,32,0.313,23,34,0.676,99,35,84,0.417,27,51,0.529,8,33,0.242,17,24,0.708,95,2013-04-17,LAL,HOU,2013,99.0
7435,7435,35,@,W 99-88 ,240,40,93,0.43,31,72,0.431,9,21,0.429,10,13,0.769,99,35,82,0.427,29,70,0.414,6,12,0.5,12,14,0.857,88,2013-04-17,GSW,POR,2013,91.0
7436,7436,36,@,L 99-111 ,240,37,87,0.425,34,71,0.479,3,16,0.188,22,26,0.846,99,32,80,0.4,25,61,0.41,7,19,0.368,40,46,0.87,111,2013-11-02,MEM,DAL,2014,114.5
7437,7437,37,@,W 99-91 ,240,38,73,0.521,29,52,0.558,9,21,0.429,14,23,0.609,99,33,87,0.379,28,62,0.452,5,25,0.2,20,25,0.8,91,2013-11-05,IND,DET,2014,93.5
7438,7438,38,@,W 99-84 ,240,38,78,0.487,34,65,0.523,4,13,0.308,19,21,0.905,99,34,71,0.479,30,56,0.536,4,15,0.267,12,14,0.857,84,2013-11-06,NOP,MEM,2014,86.0
7439,7439,39,Home,W 99-96 ,240,41,85,0.482,35,69,0.507,6,16,0.375,11,15,0.733,99,42,85,0.494,35,66,0.53,7,19,0.368,5,9,0.556,96,2013-11-06,SAS,PHO,2014,99.5
7440,7440,40,@,W 99-98 ,240,36,92,0.391,20,57,0.351,16,35,0.457,11,15,0.733,99,29,77,0.377,22,50,0.44,7,27,0.259,33,52,0.635,98,2013-11-07,LAL,HOU,2014,101.5
7441,7441,41,@,L 99-111 ,240,37,94,0.394,29,73,0.397,8,21,0.381,17,26,0.654,99,40,100,0.4,34,79,0.43,6,21,0.286,25,37,0.676,111,2013-11-13,LAL,DEN,2014,114.0
7442,7442,42,@,L 99-114 ,240,42,87,0.483,34,64,0.531,8,23,0.348,7,17,0.412,99,47,90,0.522,37,65,0.569,10,25,0.4,10,10,1.0,114,2013-11-17,DET,LAL,2014,119.0
7443,7443,43,@,L 99-101 ,240,34,73,0.466,24,50,0.48,10,23,0.435,21,29,0.724,99,37,78,0.474,31,53,0.585,6,25,0.24,21,26,0.808,101,2013-11-23,ORL,MIA,2014,104.0
7444,7444,44,@,W 99-94 ,240,34,85,0.4,21,55,0.382,13,30,0.433,18,22,0.818,99,31,83,0.373,20,53,0.377,11,30,0.367,21,26,0.808,94,2013-11-27,LAL,BRK,2014,99.5
7445,7445,45,@,W 99-74 ,240,32,84,0.381,22,59,0.373,10,25,0.4,25,32,0.781,99,26,83,0.313,23,74,0.311,3,9,0.333,19,28,0.679,74,2013-11-27,IND,CHA,2014,75.5
7446,7446,46,@,L 99-103 ,240,32,76,0.421,23,53,0.434,9,23,0.391,26,34,0.765,99,44,99,0.444,37,81,0.457,7,18,0.389,8,10,0.8,103,2013-11-27,GSW,DAL,2014,106.5
7447,7447,47,@,W 99-79 ,240,42,79,0.532,36,62,0.581,6,17,0.353,9,12,0.75,99,34,77,0.442,32,65,0.492,2,12,0.167,9,19,0.474,79,2013-11-27,CHI,DET,2014,80.0
7448,7448,48,Home,W 99-98 ,240,36,69,0.522,28,51,0.549,8,18,0.444,19,25,0.76,99,35,76,0.461,31,61,0.508,4,15,0.267,24,28,0.857,98,2013-12-01,MIA,CHA,2014,100.0
7449,7449,49,Home,L 99-103 ,240,34,76,0.447,21,41,0.512,13,35,0.371,18,21,0.857,99,38,77,0.494,28,56,0.5,10,21,0.476,17,23,0.739,103,2013-12-01,NYK,NOP,2014,108.0
7450,7450,50,@,L 99-106 ,240,39,74,0.527,30,54,0.556,9,20,0.45,12,14,0.857,99,37,96,0.385,30,76,0.395,7,20,0.35,25,29,0.862,106,2013-12-11,PHI,MIN,2014,109.5
7451,7451,51,@,L 99-101 (OT),265,42,100,0.42,38,86,0.442,4,14,0.286,11,18,0.611,99,38,89,0.427,31,68,0.456,7,21,0.333,18,24,0.75,101,2013-12-13,WAS,ATL,2014,104.5
7452,7452,52,@,L 99-103 ,240,36,79,0.456,24,56,0.429,12,23,0.522,15,20,0.75,99,39,83,0.47,36,73,0.493,3,10,0.3,22,31,0.71,103,2013-12-13,BRK,DET,2014,104.5
7453,7453,53,Home,W 99-94 ,240,36,76,0.474,28,55,0.509,8,21,0.381,19,25,0.76,99,39,83,0.47,35,71,0.493,4,12,0.333,12,17,0.706,94,2013-12-13,IND,CHA,2014,96.0
7454,7454,54,@,W 99-77 ,240,40,83,0.482,35,68,0.515,5,15,0.333,14,18,0.778,99,31,86,0.36,25,68,0.368,6,18,0.333,9,12,0.75,77,2013-12-14,TOR,CHI,2014,80.0
7455,7455,55,Home,L 99-103 ,240,35,85,0.412,31,68,0.456,4,17,0.235,25,29,0.862,99,35,88,0.398,23,54,0.426,12,34,0.353,21,31,0.677,103,2013-12-20,DEN,PHO,2014,109.0
7456,7456,56,Home,L 99-106 ,240,42,87,0.483,38,67,0.567,4,20,0.2,11,18,0.611,99,41,87,0.471,33,66,0.5,8,21,0.381,16,22,0.727,106,2013-12-21,BOS,WAS,2014,110.0
7457,7457,57,@,L 99-112 ,240,37,81,0.457,30,60,0.5,7,21,0.333,18,25,0.72,99,41,91,0.451,32,68,0.471,9,23,0.391,21,27,0.778,112,2013-12-23,TOR,SAS,2014,116.5
7458,7458,58,@,L 99-120 ,240,33,70,0.471,23,48,0.479,10,22,0.455,23,28,0.821,99,47,91,0.516,39,72,0.542,8,19,0.421,18,25,0.72,120,2013-12-28,DEN,MEM,2014,124.0
7459,7459,59,Home,L 99-106 ,240,36,82,0.439,30,62,0.484,6,20,0.3,21,35,0.6,99,39,78,0.5,32,59,0.542,7,19,0.368,21,27,0.778,106,2013-12-30,DET,WAS,2014,109.5
7460,7460,60,@,W 99-91 ,240,44,92,0.478,41,78,0.526,3,14,0.214,8,14,0.571,99,37,90,0.411,29,60,0.483,8,30,0.267,9,16,0.563,91,2014-01-02,MEM,PHO,2014,95.0
7461,7461,61,@,L 99-110 ,240,38,86,0.442,30,60,0.5,8,26,0.308,15,23,0.652,99,42,81,0.519,32,57,0.561,10,24,0.417,16,21,0.762,110,2014-01-03,UTA,LAL,2014,115.0
7462,7462,62,Home,W 99-82 ,240,39,83,0.47,32,61,0.525,7,22,0.318,14,19,0.737,99,31,68,0.456,28,59,0.475,3,9,0.333,17,26,0.654,82,2014-01-04,IND,NOP,2014,83.5
7463,7463,63,Home,L 99-101 ,240,36,99,0.364,33,77,0.429,3,22,0.136,24,30,0.8,99,40,88,0.455,36,74,0.486,4,14,0.286,17,24,0.708,101,2014-01-04,POR,PHI,2014,103.0
7464,7464,64,@,L 99-113 ,240,36,88,0.409,29,64,0.453,7,24,0.292,20,25,0.8,99,39,86,0.453,32,58,0.552,7,28,0.25,28,50,0.56,113,2014-01-08,LAL,HOU,2014,116.5
7465,7465,65,Home,W 99-97 ,240,38,92,0.413,30,66,0.455,8,26,0.308,15,21,0.714,99,38,85,0.447,31,66,0.47,7,19,0.368,14,16,0.875,97,2014-01-10,GSW,BOS,2014,100.5
7466,7466,66,@,L 99-104 ,240,38,92,0.413,27,62,0.435,11,30,0.367,12,16,0.75,99,42,86,0.488,36,71,0.507,6,15,0.4,14,23,0.609,104,2014-01-10,PHO,MEM,2014,107.0
7467,7467,67,@,L 99-107 ,240,37,88,0.42,33,70,0.471,4,18,0.222,21,31,0.677,99,37,84,0.44,32,66,0.485,5,18,0.278,28,35,0.8,107,2014-01-20,PHI,WAS,2014,109.5
7468,7468,68,Home,W 99-81 ,240,41,88,0.466,34,69,0.493,7,19,0.368,10,14,0.714,99,30,81,0.37,21,49,0.429,9,32,0.281,12,17,0.706,81,2014-01-25,MEM,HOU,2014,85.5
7469,7469,69,@,W 99-90 ,240,34,82,0.415,25,55,0.455,9,27,0.333,22,28,0.786,99,34,86,0.395,29,70,0.414,5,16,0.313,17,24,0.708,90,2014-01-26,PHO,CLE,2014,92.5
7470,7470,70,@,L 99-106 ,240,37,90,0.411,32,68,0.471,5,22,0.227,20,26,0.769,99,32,80,0.4,25,60,0.417,7,20,0.35,35,53,0.66,106,2014-01-27,SAC,UTA,2014,109.5
7471,7471,71,@,W 99-89 ,240,41,75,0.547,37,61,0.607,4,14,0.286,13,16,0.813,99,38,79,0.481,33,58,0.569,5,21,0.238,8,8,1.0,89,2014-01-29,MEM,SAC,2014,91.5
7472,7472,72,Home,L 99-125 ,240,32,87,0.368,26,65,0.4,6,22,0.273,29,37,0.784,99,45,89,0.506,37,73,0.507,8,16,0.5,27,34,0.794,125,2014-01-31,PHI,ATL,2014,129.0
7473,7473,73,Home,W 99-90 ,240,38,79,0.481,32,69,0.464,6,10,0.6,17,22,0.773,99,30,76,0.395,21,53,0.396,9,23,0.391,21,25,0.84,90,2014-02-01,MEM,MIL,2014,94.5
7474,7474,74,Home,W 99-70 ,240,36,69,0.522,34,61,0.557,2,8,0.25,25,34,0.735,99,22,78,0.282,18,58,0.31,4,20,0.2,22,34,0.647,70,2014-02-03,SAC,CHI,2014,72.0
7475,7475,75,@,L 99-109 ,240,33,79,0.418,23,58,0.397,10,21,0.476,23,26,0.885,99,37,83,0.446,29,66,0.439,8,17,0.471,27,38,0.711,109,2014-02-04,LAL,MIN,2014,113.0
7476,7476,76,Home,W 99-89 ,240,40,88,0.455,31,66,0.47,9,22,0.409,10,15,0.667,99,31,87,0.356,26,72,0.361,5,15,0.333,22,24,0.917,89,2014-02-07,BOS,SAC,2014,91.5
7477,7477,77,@,L 99-109 ,240,34,74,0.459,26,48,0.542,8,26,0.308,23,33,0.697,99,41,86,0.477,29,65,0.446,12,21,0.571,15,23,0.652,109,2014-02-11,SAC,CLE,2014,115.0
7478,7478,78,Home,L 99-105 ,240,37,82,0.451,28,58,0.483,9,24,0.375,16,17,0.941,99,41,82,0.5,32,59,0.542,9,23,0.391,14,20,0.7,105,2014-02-19,UTA,BRK,2014,109.5
7479,7479,79,@,L 99-102 (OT),265,37,101,0.366,28,71,0.394,9,30,0.3,16,25,0.64,99,37,93,0.398,28,66,0.424,9,27,0.333,19,24,0.792,102,2014-02-20,HOU,GSW,2014,106.5
7480,7480,80,@,W 99-93 ,240,35,79,0.443,25,47,0.532,10,32,0.313,19,24,0.792,99,34,84,0.405,29,67,0.433,5,17,0.294,20,24,0.833,93,2014-02-25,TOR,CLE,2014,95.5
7481,7481,81,Home,W 99-79 ,240,43,88,0.489,39,73,0.534,4,15,0.267,9,12,0.75,99,28,80,0.35,14,51,0.275,14,29,0.483,9,14,0.643,79,2014-02-28,CLE,UTA,2014,86.0
7482,7482,82,@,L 99-116 ,240,30,68,0.441,22,46,0.478,8,22,0.364,31,40,0.775,99,41,82,0.5,33,60,0.55,8,22,0.364,26,30,0.867,116,2014-03-02,CHA,OKC,2014,120.0
7483,7483,83,Home,W 99-87 ,240,34,73,0.466,24,52,0.462,10,21,0.476,21,28,0.75,99,30,72,0.417,25,53,0.472,5,19,0.263,22,37,0.595,87,2014-03-07,TOR,SAC,2014,89.5
7484,7484,84,Home,W 99-90 ,240,40,80,0.5,30,59,0.508,10,21,0.476,9,9,1.0,99,36,89,0.404,24,58,0.414,12,31,0.387,6,9,0.667,90,2014-03-10,MIA,WAS,2014,96.0
7485,7485,85,Home,W 99-89 ,240,38,87,0.437,31,69,0.449,7,18,0.389,16,19,0.842,99,34,84,0.405,31,69,0.449,3,15,0.2,18,30,0.6,89,2014-03-11,DET,SAC,2014,90.5
7486,7486,86,@,L 99-109 ,240,35,86,0.407,28,69,0.406,7,17,0.412,22,29,0.759,99,47,84,0.56,41,72,0.569,6,12,0.5,9,13,0.692,109,2014-03-11,POR,MEM,2014,112.0
7487,7487,87,Home,W 99-86 ,240,36,71,0.507,27,54,0.5,9,17,0.529,18,22,0.818,99,33,74,0.446,31,66,0.47,2,8,0.25,18,27,0.667,86,2014-03-14,TOR,MEM,2014,87.0
7488,7488,88,Home,W 99-90 ,240,31,81,0.383,25,63,0.397,6,18,0.333,31,38,0.816,99,35,81,0.432,26,58,0.448,9,23,0.391,11,20,0.55,90,2014-03-17,IND,PHI,2014,94.5
7489,7489,89,@,L 99-104 ,240,40,85,0.471,31,58,0.534,9,27,0.333,10,12,0.833,99,37,75,0.493,28,55,0.509,9,20,0.45,21,35,0.6,104,2014-03-19,CHA,BRK,2014,108.5
7490,7490,90,@,W 99-79 ,240,36,93,0.387,31,68,0.456,5,25,0.2,22,27,0.815,99,32,80,0.4,28,66,0.424,4,14,0.286,11,18,0.611,79,2014-03-21,SAS,SAC,2014,81.0
7491,7491,91,@,W 99-90 ,240,35,89,0.393,25,61,0.41,10,28,0.357,19,25,0.76,99,31,77,0.403,28,62,0.452,3,15,0.2,25,29,0.862,90,2014-03-22,SAS,GSW,2014,91.5
7492,7492,92,@,W 99-90 ,240,36,80,0.45,25,57,0.439,11,23,0.478,16,18,0.889,99,32,79,0.405,23,57,0.404,9,22,0.409,17,22,0.773,90,2014-03-26,TOR,BOS,2014,94.5
7493,7493,93,Home,L 99-107 ,240,33,69,0.478,27,52,0.519,6,17,0.353,27,35,0.771,99,40,73,0.548,25,47,0.532,15,26,0.577,12,13,0.923,107,2014-03-26,SAC,NYK,2014,114.5
7494,7494,94,@,W 99-93 ,240,37,75,0.493,23,47,0.489,14,28,0.5,11,12,0.917,99,37,81,0.457,31,62,0.5,6,19,0.316,13,21,0.619,93,2014-03-26,PHO,WAS,2014,96.0
7495,7495,95,@,L 99-114 ,240,39,83,0.47,36,71,0.507,3,12,0.25,18,27,0.667,99,43,86,0.5,31,53,0.585,12,33,0.364,16,22,0.727,114,2014-03-30,MIN,BRK,2014,120.0
7496,7496,96,@,L 99-115 ,240,35,91,0.385,27,55,0.491,8,36,0.222,21,28,0.75,99,44,83,0.53,39,65,0.6,5,18,0.278,22,24,0.917,115,2014-03-30,PHO,LAL,2014,117.5
7497,7497,97,@,L 99-100 ,240,39,91,0.429,34,80,0.425,5,11,0.455,16,22,0.727,99,38,75,0.507,31,52,0.596,7,23,0.304,17,22,0.773,100,2014-04-09,SAC,POR,2014,103.5
7498,7498,98,Home,L 99-100 ,240,40,88,0.455,34,65,0.523,6,23,0.261,13,15,0.867,99,39,104,0.375,29,70,0.414,10,34,0.294,12,19,0.632,100,2014-04-10,GSW,DEN,2014,105.0
7499,7499,99,Home,L 99-111 ,240,40,86,0.465,34,73,0.466,6,13,0.462,13,16,0.813,99,40,87,0.46,29,65,0.446,11,22,0.5,20,24,0.833,111,2014-04-11,UTA,POR,2014,116.5
7500,7500,0,Home,L 99-111 ,240,37,90,0.411,32,72,0.444,5,18,0.278,20,30,0.667,99,42,90,0.467,30,60,0.5,12,30,0.4,15,18,0.833,111,2014-04-12,CLE,BOS,2014,117.0
7501,7501,1,Home,L 99-104 ,240,37,86,0.43,33,67,0.493,4,19,0.211,21,30,0.7,99,40,86,0.465,32,66,0.485,8,20,0.4,16,22,0.727,104,2014-04-16,SAC,PHO,2014,108.0
7502,7502,2,@,L 99-119 ,240,37,86,0.43,33,73,0.452,4,13,0.308,21,25,0.84,99,45,82,0.549,29,50,0.58,16,32,0.5,13,18,0.722,119,2014-10-29,LAL,PHO,2015,127.0
7503,7503,3,@,L 99-110 ,240,37,90,0.411,29,71,0.408,8,19,0.421,17,21,0.81,99,38,74,0.514,24,50,0.48,14,24,0.583,20,26,0.769,110,2014-11-07,NYK,BRK,2015,117.0
7504,7504,4,Home,L 99-100 ,240,36,80,0.45,31,62,0.5,5,18,0.278,22,29,0.759,99,40,85,0.471,32,64,0.5,8,21,0.381,12,14,0.857,100,2014-11-08,SAS,NOP,2015,104.0
7505,7505,5,@,L 99-107 ,240,39,89,0.438,36,73,0.493,3,16,0.188,18,20,0.9,99,41,90,0.456,30,56,0.536,11,34,0.324,14,21,0.667,107,2014-11-13,BRK,GSW,2015,112.5
7506,7506,6,@,W 99-90 ,240,37,77,0.481,30,59,0.508,7,18,0.389,18,25,0.72,99,35,83,0.422,31,66,0.47,4,17,0.235,16,23,0.696,90,2014-11-15,IND,CHI,2015,92.0
7507,7507,7,@,L 99-115 ,240,34,69,0.493,25,53,0.472,9,16,0.563,22,28,0.786,99,44,89,0.494,33,67,0.493,11,22,0.5,16,22,0.727,115,2014-11-19,NYK,MIN,2015,120.5
7508,7508,8,Home,W 99-89 ,240,38,80,0.475,33,56,0.589,5,24,0.208,18,26,0.692,99,31,83,0.373,27,62,0.435,4,21,0.19,23,24,0.958,89,2014-11-21,ATL,DET,2015,91.0
7509,7509,9,@,W 99-92 ,240,37,71,0.521,25,45,0.556,12,26,0.462,13,18,0.722,99,35,78,0.449,32,62,0.516,3,16,0.188,19,27,0.704,92,2014-11-22,MIA,ORL,2015,93.5
7510,7510,10,Home,W 99-87 ,240,41,79,0.519,33,58,0.569,8,21,0.381,9,11,0.818,99,34,91,0.374,25,64,0.391,9,27,0.333,10,10,1.0,87,2014-11-22,SAS,BRK,2015,91.5
7511,7511,11,@,W 99-89 ,240,37,77,0.481,32,63,0.508,5,14,0.357,20,24,0.833,99,33,79,0.418,30,62,0.484,3,17,0.176,20,29,0.69,89,2014-11-25,SAC,NOP,2015,90.5
7512,7512,12,@,W 99-93 ,240,36,80,0.45,31,58,0.534,5,22,0.227,22,25,0.88,99,33,81,0.407,25,62,0.403,8,19,0.421,19,24,0.792,93,2014-11-26,MEM,LAL,2015,97.0
7513,7513,13,@,W 99-91 ,240,35,71,0.493,27,47,0.574,8,24,0.333,21,28,0.75,99,34,85,0.4,25,61,0.41,9,24,0.375,14,17,0.824,91,2014-11-26,BRK,PHI,2015,95.5
7514,7514,14,Home,L 99-112 ,240,39,97,0.402,31,69,0.449,8,28,0.286,13,18,0.722,99,45,84,0.536,39,71,0.549,6,13,0.462,16,26,0.615,112,2014-11-28,POR,MEM,2015,115.0
7515,7515,15,@,L 99-116 ,240,41,85,0.482,37,72,0.514,4,13,0.308,13,17,0.765,99,43,86,0.5,31,61,0.508,12,25,0.48,18,26,0.692,116,2014-12-02,IND,PHO,2015,122.0
7516,7516,16,Home,L 99-103 ,240,41,79,0.519,36,60,0.6,5,19,0.263,12,14,0.857,99,36,85,0.424,26,57,0.456,10,28,0.357,21,29,0.724,103,2014-12-07,NYK,POR,2015,108.0
7517,7517,17,@,L 99-100 ,240,35,84,0.417,27,57,0.474,8,27,0.296,21,24,0.875,99,37,74,0.5,27,53,0.509,10,21,0.476,16,21,0.762,100,2014-12-13,ATL,ORL,2015,105.0
7518,7518,18,@,W 99-91 ,240,34,74,0.459,29,58,0.5,5,16,0.313,26,35,0.743,99,34,83,0.41,26,67,0.388,8,16,0.5,15,21,0.714,91,2014-12-14,SAS,DEN,2015,95.0
7519,7519,19,@,W 99-90 ,240,38,82,0.463,33,64,0.516,5,18,0.278,18,22,0.818,99,33,86,0.384,27,61,0.443,6,25,0.24,18,23,0.783,90,2014-12-18,NOP,HOU,2015,93.0
7520,7520,20,Home,W 99-93 ,240,37,86,0.43,28,60,0.467,9,26,0.346,16,20,0.8,99,32,77,0.416,29,64,0.453,3,13,0.231,26,26,1.0,93,2014-12-20,DAL,SAS,2015,94.5
7521,7521,21,@,W 99-90 ,240,35,78,0.449,25,53,0.472,10,25,0.4,19,23,0.826,99,35,88,0.398,28,66,0.424,7,22,0.318,13,16,0.813,90,2014-12-20,PHO,NYK,2015,93.5
7522,7522,22,Home,L 99-101 ,240,38,83,0.458,33,63,0.524,5,20,0.25,18,24,0.75,99,43,90,0.478,36,70,0.514,7,20,0.35,8,10,0.8,101,2014-12-21,OKC,NOP,2015,104.5
7523,7523,23,@,W 99-91 ,240,39,85,0.459,34,68,0.5,5,17,0.294,16,24,0.667,99,38,89,0.427,33,80,0.413,5,9,0.556,10,16,0.625,91,2014-12-23,CHI,WAS,2015,93.5
7524,7524,24,@,L 99-107 ,240,37,76,0.487,28,56,0.5,9,20,0.45,16,20,0.8,99,36,80,0.45,28,59,0.475,8,21,0.381,27,39,0.692,107,2014-12-29,SAC,BRK,2015,111.0
7525,7525,25,Home,W 99-78 ,240,36,82,0.439,21,48,0.438,15,34,0.441,12,20,0.6,99,32,84,0.381,28,67,0.418,4,17,0.235,10,15,0.667,78,2014-12-31,LAC,NYK,2015,80.0
7526,7526,26,Home,W 99-83 ,240,40,95,0.421,32,68,0.471,8,27,0.296,11,15,0.733,99,29,77,0.377,26,63,0.413,3,14,0.214,22,30,0.733,83,2015-01-08,POR,MIA,2015,84.5
7527,7527,27,Home,W 99-94 ,240,42,91,0.462,35,70,0.5,7,21,0.333,8,9,0.889,99,36,74,0.486,29,53,0.547,7,21,0.333,15,22,0.682,94,2015-01-09,OKC,UTA,2015,97.5
7528,7528,28,Home,L 99-113 ,240,39,84,0.464,34,63,0.54,5,21,0.238,16,18,0.889,99,41,86,0.477,25,46,0.543,16,40,0.4,15,20,0.75,113,2015-01-12,BRK,HOU,2015,121.0
7529,7529,29,Home,L 99-105 ,240,34,79,0.43,21,52,0.404,13,27,0.481,18,24,0.75,99,40,78,0.513,35,63,0.556,5,15,0.333,20,25,0.8,105,2015-01-14,CHI,WAS,2015,107.5
7530,7530,30,@,L 99-110 ,240,42,91,0.462,34,69,0.493,8,22,0.364,7,12,0.583,99,48,87,0.552,43,72,0.597,5,15,0.333,9,11,0.818,110,2015-01-16,MIN,PHO,2015,112.5
7531,7531,31,@,W 99-90 ,240,40,77,0.519,35,61,0.574,5,16,0.313,14,27,0.519,99,36,82,0.439,32,65,0.492,4,17,0.235,14,18,0.778,90,2015-01-17,WAS,BRK,2015,92.0
7532,7532,32,Home,L 99-107 ,240,37,80,0.463,28,54,0.519,9,26,0.346,16,20,0.8,99,40,84,0.476,29,58,0.5,11,26,0.423,16,21,0.762,107,2015-01-17,CHI,ATL,2015,112.5
7533,7533,33,Home,L 99-127 ,240,35,88,0.398,27,65,0.415,8,23,0.348,21,27,0.778,99,48,83,0.578,39,58,0.672,9,25,0.36,22,32,0.688,127,2015-01-18,ORL,OKC,2015,131.5
7534,7534,34,Home,W 99-92 ,240,38,78,0.487,28,55,0.509,10,23,0.435,13,17,0.765,99,35,84,0.417,27,57,0.474,8,27,0.296,14,20,0.7,92,2015-01-19,NYK,NOP,2015,96.0
7535,7535,35,Home,L 99-109 ,240,37,79,0.468,32,65,0.492,5,14,0.357,20,29,0.69,99,38,84,0.452,27,57,0.474,11,27,0.407,22,27,0.815,109,2015-01-20,DEN,SAS,2015,114.5
7536,7536,36,Home,L 99-101 ,240,42,92,0.457,37,79,0.468,5,13,0.385,10,12,0.833,99,32,71,0.451,18,40,0.45,14,31,0.452,23,28,0.821,101,2015-01-22,MIL,UTA,2015,108.0
7537,7537,37,Home,L 99-100 ,240,37,89,0.416,31,68,0.456,6,21,0.286,19,26,0.731,99,37,75,0.493,28,54,0.519,9,21,0.429,17,27,0.63,100,2015-01-23,DEN,BOS,2015,104.5
7538,7538,38,Home,W 99-85 ,240,36,84,0.429,29,60,0.483,7,24,0.292,20,27,0.741,99,33,83,0.398,28,70,0.4,5,13,0.385,14,20,0.7,85,2015-01-23,SAS,LAL,2015,87.5
7539,7539,39,@,W 99-87 ,240,35,87,0.402,22,43,0.512,13,44,0.295,16,21,0.762,99,34,79,0.43,33,66,0.5,1,13,0.077,18,25,0.72,87,2015-01-25,HOU,LAL,2015,87.5
7540,7540,40,Home,L 99-106 ,240,38,78,0.487,32,61,0.525,6,17,0.353,17,23,0.739,99,43,83,0.518,35,63,0.556,8,20,0.4,12,18,0.667,106,2015-01-25,ORL,IND,2015,110.0
7541,7541,41,Home,W 99-74 ,240,39,86,0.453,32,70,0.457,7,16,0.438,14,19,0.737,99,28,81,0.346,26,66,0.394,2,15,0.133,16,21,0.762,74,2015-01-26,NOP,PHI,2015,75.0
7542,7542,42,@,W 99-90 ,240,35,74,0.473,27,55,0.491,8,19,0.421,21,23,0.913,99,35,82,0.427,26,58,0.448,9,24,0.375,11,19,0.579,90,2015-01-26,BOS,UTA,2015,94.5
7543,7543,43,Home,W 99-94 ,240,34,85,0.4,19,48,0.396,15,37,0.405,16,18,0.889,99,35,80,0.438,25,49,0.51,10,31,0.323,14,17,0.824,94,2015-01-28,CLE,POR,2015,99.0
7544,7544,44,Home,W 99-94 ,240,36,88,0.409,22,53,0.415,14,35,0.4,13,15,0.867,99,35,82,0.427,25,57,0.439,10,25,0.4,14,16,0.875,94,2015-01-28,HOU,DAL,2015,99.0
7545,7545,45,Home,W 99-69 ,240,39,88,0.443,36,72,0.5,3,16,0.188,18,27,0.667,99,29,87,0.333,27,61,0.443,2,26,0.077,9,10,0.9,69,2015-01-29,MEM,DEN,2015,70.0
7546,7546,46,@,L 99-105 ,240,39,87,0.448,28,57,0.491,11,30,0.367,10,11,0.909,99,40,84,0.476,29,61,0.475,11,23,0.478,14,22,0.636,105,2015-01-30,POR,ATL,2015,110.5
7547,7547,47,Home,W 99-93 ,240,39,90,0.433,33,68,0.485,6,22,0.273,15,17,0.882,99,36,87,0.414,32,69,0.464,4,18,0.222,17,27,0.63,93,2015-01-30,PHO,CHI,2015,95.0
7548,7548,48,@,W 99-94 ,240,34,80,0.425,29,65,0.446,5,15,0.333,26,29,0.897,99,33,80,0.413,28,55,0.509,5,25,0.2,23,25,0.92,94,2015-01-31,SAC,IND,2015,96.5
7549,7549,49,@,L 99-103 ,240,40,89,0.449,29,54,0.537,11,35,0.314,8,12,0.667,99,37,79,0.468,29,58,0.5,8,21,0.381,21,26,0.808,103,2015-02-06,CLE,IND,2015,107.0
7550,7550,50,@,L 99-110 ,240,39,81,0.481,33,62,0.532,6,19,0.316,15,20,0.75,99,41,84,0.488,24,51,0.471,17,33,0.515,11,18,0.611,110,2015-02-20,SAS,GSW,2015,118.5
7551,7551,51,@,L 99-126 ,240,30,88,0.341,26,72,0.361,4,16,0.25,35,46,0.761,99,46,95,0.484,32,60,0.533,14,35,0.4,20,28,0.714,126,2015-02-21,SAC,LAC,2015,133.0
7552,7552,52,Home,W 99-92 ,240,38,79,0.481,30,60,0.5,8,19,0.421,15,18,0.833,99,38,84,0.452,29,58,0.5,9,26,0.346,7,11,0.636,92,2015-02-24,DAL,TOR,2015,96.5
7553,7553,53,@,L 99-110 ,240,39,92,0.424,28,63,0.444,11,29,0.379,10,19,0.526,99,36,77,0.468,27,49,0.551,9,28,0.321,29,35,0.829,110,2015-02-26,GSW,CLE,2015,114.5
7554,7554,54,Home,W 99-95 ,240,37,78,0.474,30,58,0.517,7,20,0.35,18,25,0.72,99,38,79,0.481,30,53,0.566,8,26,0.308,11,21,0.524,95,2015-02-28,WAS,DET,2015,99.0
7555,7555,55,@,W 99-92 ,240,36,74,0.486,31,52,0.596,5,22,0.227,22,30,0.733,99,37,92,0.402,28,59,0.475,9,33,0.273,9,17,0.529,92,2015-03-01,NOP,DEN,2015,96.5
7556,7556,56,Home,L 99-110 ,240,39,86,0.453,36,74,0.486,3,12,0.25,18,23,0.783,99,41,83,0.494,31,59,0.525,10,24,0.417,18,20,0.9,110,2015-03-01,SAC,POR,2015,115.0
7557,7557,57,Home,W 99-97 ,240,38,82,0.463,31,59,0.525,7,23,0.304,16,18,0.889,99,37,79,0.468,27,52,0.519,10,27,0.37,13,19,0.684,97,2015-03-06,WAS,MIA,2015,102.0
7558,7558,58,@,L 99-129 ,240,41,82,0.5,29,50,0.58,12,32,0.375,5,12,0.417,99,51,84,0.607,35,56,0.625,16,28,0.571,11,16,0.688,129,2015-03-13,LAC,DAL,2015,137.0
7559,7559,59,@,L 99-113 ,240,34,78,0.436,31,66,0.47,3,12,0.25,28,31,0.903,99,44,101,0.436,33,77,0.429,11,24,0.458,14,14,1.0,113,2015-03-13,MIN,OKC,2015,118.5
7560,7560,60,@,L 99-118 ,240,41,91,0.451,34,66,0.515,7,25,0.28,10,12,0.833,99,46,80,0.575,35,59,0.593,11,21,0.524,15,17,0.882,118,2015-03-13,DET,POR,2015,123.5
7561,7561,61,Home,W 99-92 ,240,35,77,0.455,26,53,0.491,9,24,0.375,20,28,0.714,99,32,79,0.405,27,65,0.415,5,14,0.357,23,29,0.793,92,2015-03-17,LAC,CHO,2015,94.5
7562,7562,62,@,L 99-113 ,240,37,86,0.43,31,67,0.463,6,19,0.316,19,23,0.826,99,45,86,0.523,33,63,0.524,12,23,0.522,11,17,0.647,113,2015-03-20,WAS,LAC,2015,119.0
7563,7563,63,@,W 99-85 ,240,35,84,0.417,21,50,0.42,14,34,0.412,15,22,0.682,99,29,84,0.345,21,55,0.382,8,29,0.276,19,27,0.704,85,2015-03-25,PHI,DEN,2015,89.0
7564,7564,64,Home,L 99-101 (OT),265,33,78,0.423,27,56,0.482,6,22,0.273,27,30,0.9,99,39,92,0.424,33,66,0.5,6,26,0.231,17,18,0.944,101,2015-03-25,MIN,LAL,2015,104.0
7565,7565,65,Home,L 99-108 ,240,38,87,0.437,32,62,0.516,6,25,0.24,17,26,0.654,99,40,81,0.494,32,60,0.533,8,21,0.381,20,23,0.87,108,2015-03-25,PHO,SAC,2015,112.0
7566,7566,66,Home,W 99-86 ,240,37,72,0.514,31,54,0.574,6,18,0.333,19,24,0.792,99,32,82,0.39,21,47,0.447,11,35,0.314,11,15,0.733,86,2015-03-27,ATL,MIA,2015,91.5
7567,7567,67,@,L 99-107 ,240,42,91,0.462,36,73,0.493,6,18,0.333,9,11,0.818,99,42,87,0.483,34,59,0.576,8,28,0.286,15,21,0.714,107,2015-03-29,LAL,BRK,2015,111.0
7568,7568,68,@,L 99-104 ,240,40,90,0.444,34,75,0.453,6,15,0.4,13,19,0.684,99,38,76,0.5,28,59,0.475,10,17,0.588,18,26,0.692,104,2015-03-29,DAL,IND,2015,109.0
7569,7569,69,@,W 99-91 ,240,34,80,0.425,25,51,0.49,9,29,0.31,22,33,0.667,99,29,75,0.387,25,60,0.417,4,15,0.267,29,37,0.784,91,2015-03-29,HOU,WAS,2015,93.0
7570,7570,70,Home,W 99-96 ,240,35,78,0.449,27,56,0.482,8,22,0.364,21,27,0.778,99,35,84,0.417,27,57,0.474,8,27,0.296,18,31,0.581,96,2015-03-30,TOR,HOU,2015,100.0
7571,7571,71,Home,L 99-113 ,240,41,77,0.532,36,63,0.571,5,14,0.357,12,19,0.632,99,42,76,0.553,29,46,0.63,13,30,0.433,16,23,0.696,113,2015-04-01,MIN,TOR,2015,119.5
7572,7572,72,@,L 99-131 ,240,39,80,0.488,29,57,0.509,10,23,0.435,11,17,0.647,99,49,82,0.598,32,49,0.653,17,33,0.515,16,19,0.842,131,2015-04-04,BRK,ATL,2015,139.5
7573,7573,73,Home,W 99-98 ,240,36,73,0.493,24,47,0.511,12,26,0.462,15,23,0.652,99,37,77,0.481,32,57,0.561,5,20,0.25,19,26,0.731,98,2015-04-04,DET,MIA,2015,100.5
7574,7574,74,Home,W 99-90 ,240,36,84,0.429,30,68,0.441,6,16,0.375,21,23,0.913,99,39,85,0.459,32,69,0.464,7,16,0.438,5,10,0.5,90,2015-04-04,POR,NOP,2015,93.5
7575,7575,75,Home,W 99-94 ,240,35,83,0.422,19,46,0.413,16,37,0.432,13,22,0.591,99,34,76,0.447,23,49,0.469,11,27,0.407,15,21,0.714,94,2015-04-05,CLE,CHI,2015,99.5
7576,7576,76,Home,L 99-104 ,240,42,84,0.5,36,66,0.545,6,18,0.333,9,13,0.692,99,36,74,0.486,25,40,0.625,11,34,0.324,21,26,0.808,104,2015-04-08,MIL,CLE,2015,109.5
7577,7577,77,@,W 99-90 ,240,38,84,0.452,30,62,0.484,8,22,0.364,15,21,0.714,99,32,77,0.416,23,43,0.535,9,34,0.265,17,25,0.68,90,2015-04-10,BOS,CLE,2015,94.5
7578,7578,78,@,W 99-91 ,240,37,76,0.487,31,59,0.525,6,17,0.353,19,29,0.655,99,34,72,0.472,29,59,0.492,5,13,0.385,18,24,0.75,91,2015-04-10,MIL,NYK,2015,93.5
7579,7579,79,Home,L 99-101 ,240,41,89,0.461,34,69,0.493,7,20,0.35,10,10,1.0,99,39,94,0.415,30,64,0.469,9,30,0.3,14,15,0.933,101,2015-04-10,ORL,TOR,2015,105.5
7580,7580,80,@,L 99-108 ,240,36,87,0.414,27,58,0.466,9,29,0.31,18,24,0.75,99,39,85,0.459,30,64,0.469,9,21,0.429,21,27,0.778,108,2015-04-12,ATL,WAS,2015,112.5
7581,7581,81,Home,W 99-95 (2OT),290,40,105,0.381,31,75,0.413,9,30,0.3,10,17,0.588,99,37,104,0.356,30,80,0.375,7,24,0.292,14,17,0.824,95,2015-04-14,IND,WAS,2015,98.5
7582,7582,82,Home,L 99-122 ,240,36,94,0.383,29,70,0.414,7,24,0.292,20,25,0.8,99,46,84,0.548,38,67,0.567,8,17,0.471,22,41,0.537,122,2015-04-15,LAL,SAC,2015,126.0
7583,7583,83,@,L 99-106 ,240,32,86,0.372,23,63,0.365,9,23,0.391,26,31,0.839,99,36,80,0.45,29,62,0.468,7,18,0.389,27,39,0.692,106,2015-10-28,IND,TOR,2016,109.5
7584,7584,84,@,W 99-71 ,240,36,88,0.409,29,75,0.387,7,13,0.538,20,25,0.8,99,19,63,0.302,13,48,0.271,6,15,0.4,27,37,0.73,71,2015-10-30,UTA,PHI,2016,74.0
7585,7585,85,@,L 99-102 ,240,37,81,0.457,30,59,0.508,7,22,0.318,18,20,0.9,99,42,87,0.483,34,64,0.531,8,23,0.348,10,14,0.714,102,2015-11-04,SAS,WAS,2016,106.0
7586,7586,86,@,W 99-92 ,240,35,81,0.432,32,67,0.478,3,14,0.214,26,29,0.897,99,33,81,0.407,29,57,0.509,4,24,0.167,22,28,0.786,92,2015-11-06,MIL,NYK,2016,94.0
7587,7587,87,@,L 99-114 ,240,38,78,0.487,30,54,0.556,8,24,0.333,15,17,0.882,99,43,92,0.467,30,59,0.508,13,33,0.394,15,15,1.0,114,2015-11-07,WAS,ATL,2016,120.5
7588,7588,88,Home,W 99-95 ,240,33,84,0.393,24,57,0.421,9,27,0.333,24,29,0.828,99,36,94,0.383,27,67,0.403,9,27,0.333,14,23,0.609,95,2015-11-08,NYK,LAL,2016,99.5
7589,7589,89,@,W 99-83 ,240,38,86,0.442,31,56,0.554,7,30,0.233,16,19,0.842,99,30,73,0.411,24,56,0.429,6,17,0.353,17,23,0.739,83,2015-11-10,BOS,MIL,2016,86.0
7590,7590,90,@,L 99-101 ,240,39,79,0.494,32,57,0.561,7,22,0.318,14,18,0.778,99,40,100,0.4,27,72,0.375,13,28,0.464,8,12,0.667,101,2015-11-11,LAL,ORL,2016,107.5
7591,7591,91,@,L 99-107 (OT),265,41,98,0.418,39,80,0.488,2,18,0.111,15,16,0.938,99,43,97,0.443,31,63,0.492,12,34,0.353,9,10,0.9,107,2015-11-14,BRK,GSW,2016,113.0
7592,7592,92,@,L 99-108 ,240,38,87,0.437,34,69,0.493,4,18,0.222,19,24,0.792,99,39,83,0.47,27,54,0.5,12,29,0.414,18,26,0.692,108,2015-11-14,ORL,WAS,2016,114.0
7593,7593,93,@,L 99-104 ,240,38,80,0.475,27,47,0.574,11,33,0.333,12,20,0.6,99,36,84,0.429,29,63,0.46,7,21,0.333,25,31,0.806,104,2015-11-17,CLE,DET,2016,107.5
7594,7594,94,Home,W 99-95 ,240,34,82,0.415,25,61,0.41,9,21,0.429,22,29,0.759,99,31,82,0.378,23,51,0.451,8,31,0.258,25,35,0.714,95,2015-11-25,MIN,ATL,2016,99.0
7595,7595,95,@,L 99-110 ,240,43,94,0.457,40,81,0.494,3,13,0.231,10,12,0.833,99,41,78,0.526,31,54,0.574,10,24,0.417,18,21,0.857,110,2015-11-25,BRK,OKC,2016,115.0
7596,7596,96,@,L 99-103 ,240,36,82,0.439,22,53,0.415,14,29,0.483,13,16,0.813,99,40,79,0.506,29,54,0.537,11,25,0.44,12,22,0.545,103,2015-11-25,CLE,TOR,2016,108.5
7597,7597,97,@,L 99-107 ,240,37,82,0.451,29,66,0.439,8,16,0.5,17,21,0.81,99,39,75,0.52,31,53,0.585,8,22,0.364,21,33,0.636,107,2015-11-29,MIN,LAC,2016,111.0
7598,7598,98,Home,W 99-90 ,240,36,89,0.404,30,72,0.417,6,17,0.353,21,27,0.778,99,36,93,0.387,31,78,0.397,5,15,0.333,13,22,0.591,90,2015-12-02,CHI,DEN,2016,92.5
7599,7599,99,Home,L 99-116 ,240,35,94,0.372,26,63,0.413,9,31,0.29,20,30,0.667,99,46,88,0.523,30,54,0.556,16,34,0.471,8,11,0.727,116,2015-12-02,CHA,GSW,2016,124.0
7600,7600,0,Home,W 99-87 ,240,38,88,0.432,34,69,0.493,4,19,0.211,19,22,0.864,99,32,86,0.372,23,56,0.411,9,30,0.3,14,24,0.583,87,2015-12-02,NYK,PHI,2016,91.5
7601,7601,1,Home,W 99-84 ,240,37,68,0.544,30,52,0.577,7,16,0.438,18,29,0.621,99,31,85,0.365,25,57,0.439,6,28,0.214,16,24,0.667,84,2015-12-05,MIA,CLE,2016,87.0
7602,7602,2,Home,W 99-81 ,240,40,81,0.494,29,54,0.537,11,27,0.407,8,17,0.471,99,29,75,0.387,23,54,0.426,6,21,0.286,17,24,0.708,81,2015-12-09,CHA,MIA,2016,84.0
7603,7603,3,Home,W 99-97 ,240,42,93,0.452,39,77,0.506,3,16,0.188,12,16,0.75,99,33,83,0.398,24,54,0.444,9,29,0.31,22,28,0.786,97,2015-12-10,SAC,NYK,2016,101.5
7604,7604,4,Home,L 99-123 ,240,32,80,0.4,25,60,0.417,7,20,0.35,28,37,0.757,99,39,78,0.5,21,41,0.512,18,37,0.486,27,30,0.9,123,2015-12-11,MEM,CHO,2016,132.0
7605,7605,5,@,L 99-109 (OT),265,35,97,0.361,26,58,0.448,9,39,0.231,20,28,0.714,99,37,85,0.435,27,56,0.482,10,29,0.345,25,31,0.806,109,2015-12-17,TOR,CHO,2016,114.0
7606,7606,6,Home,W 99-95 ,240,39,82,0.476,33,64,0.516,6,18,0.333,15,16,0.938,99,38,81,0.469,31,58,0.534,7,23,0.304,12,17,0.706,95,2015-12-18,MIN,SAC,2016,98.5
7607,7607,7,@,L 99-113 ,240,36,79,0.456,34,66,0.515,2,13,0.154,25,32,0.781,99,46,89,0.517,34,64,0.531,12,25,0.48,9,16,0.563,113,2015-12-21,MIN,BOS,2016,119.0
7608,7608,8,Home,L 99-100 ,240,41,87,0.471,34,65,0.523,7,22,0.318,10,14,0.714,99,40,85,0.471,36,68,0.529,4,17,0.235,16,20,0.8,100,2015-12-21,LAC,OKC,2016,102.0
7609,7609,9,Home,L 99-107 ,240,39,76,0.513,32,52,0.615,7,24,0.292,14,16,0.875,99,44,86,0.512,34,64,0.531,10,22,0.455,9,11,0.818,107,2015-12-21,NYK,ORL,2016,112.0
7610,7610,10,@,L 99-113 ,240,37,91,0.407,30,69,0.435,7,22,0.318,18,22,0.818,99,42,83,0.506,28,59,0.475,14,24,0.583,15,17,0.882,113,2015-12-21,SAC,WAS,2016,120.0
7611,7611,11,@,L 99-103 ,240,40,92,0.435,29,63,0.46,11,29,0.379,8,11,0.727,99,35,74,0.473,23,48,0.479,12,26,0.462,21,27,0.778,103,2015-12-22,DAL,TOR,2016,109.0
7612,7612,12,@,W 99-93 ,240,39,84,0.464,35,61,0.574,4,23,0.174,17,23,0.739,99,35,91,0.385,29,66,0.439,6,25,0.24,17,25,0.68,93,2015-12-26,BOS,DET,2016,96.0
7613,7613,13,Home,W 99-90 (OT),265,38,87,0.437,34,72,0.472,4,15,0.267,19,20,0.95,99,35,79,0.443,24,50,0.48,11,29,0.379,9,18,0.5,90,2015-12-29,MEM,MIA,2016,95.5
7614,7614,14,@,L 99-130 ,240,41,89,0.461,32,66,0.485,9,23,0.391,8,17,0.471,99,49,81,0.605,37,58,0.638,12,23,0.522,20,25,0.8,130,2016-01-02,PHI,LAC,2016,136.0
7615,7615,15,@,L 99-109 ,240,39,73,0.534,37,68,0.544,2,5,0.4,19,24,0.792,99,48,87,0.552,44,67,0.657,4,20,0.2,9,14,0.643,109,2016-01-04,MIN,PHI,2016,111.0
7616,7616,16,@,W 99-94 ,240,33,74,0.446,23,47,0.489,10,27,0.37,23,36,0.639,99,34,91,0.374,28,63,0.444,6,28,0.214,20,27,0.741,94,2016-01-06,DET,BOS,2016,97.0
7617,7617,17,Home,L 99-125 ,240,36,79,0.456,29,63,0.46,7,16,0.438,20,26,0.769,99,43,81,0.531,30,54,0.556,13,27,0.481,26,29,0.897,125,2016-01-08,MIN,CLE,2016,131.5
7618,7618,18,@,L 99-100 ,240,38,91,0.418,29,70,0.414,9,21,0.429,14,17,0.824,99,41,93,0.441,37,80,0.463,4,13,0.308,14,17,0.824,100,2016-01-08,NYK,SAS,2016,102.0
7619,7619,19,Home,L 99-105 ,240,38,74,0.514,33,60,0.55,5,14,0.357,18,24,0.75,99,42,76,0.553,29,53,0.547,13,23,0.565,8,10,0.8,105,2016-01-09,ORL,WAS,2016,111.5
7620,7620,20,Home,L 99-109 ,240,38,91,0.418,32,68,0.471,6,23,0.261,17,26,0.654,99,41,85,0.482,36,71,0.507,5,14,0.357,22,27,0.815,109,2016-01-12,DET,SAS,2016,111.5
7621,7621,21,Home,W 99-85 ,240,39,88,0.443,28,62,0.452,11,26,0.423,10,15,0.667,99,31,76,0.408,23,57,0.404,8,19,0.421,15,22,0.682,85,2016-01-13,POR,UTA,2016,89.0
7622,7622,22,Home,W 99-95 ,240,38,83,0.458,33,66,0.5,5,17,0.294,18,22,0.818,99,38,82,0.463,28,56,0.5,10,26,0.385,9,11,0.818,95,2016-01-14,SAS,CLE,2016,100.0
7623,7623,23,Home,W 99-74 ,240,40,88,0.455,33,66,0.5,7,22,0.318,12,12,1.0,99,30,72,0.417,26,58,0.448,4,14,0.286,10,11,0.909,74,2016-01-17,OKC,MIA,2016,76.0
7624,7624,24,@,L 99-101 ,240,36,74,0.486,30,55,0.545,6,19,0.316,21,23,0.913,99,35,75,0.467,27,56,0.482,8,19,0.421,23,30,0.767,101,2016-01-18,NOP,MEM,2016,105.0
7625,7625,25,@,L 99-114 ,240,36,76,0.474,33,62,0.532,3,14,0.214,24,31,0.774,99,42,83,0.506,32,60,0.533,10,23,0.435,20,23,0.87,114,2016-01-19,MIN,NOP,2016,119.0
7626,7626,26,@,L 99-115 ,240,38,91,0.418,31,61,0.508,7,30,0.233,16,20,0.8,99,46,86,0.535,41,74,0.554,5,12,0.417,18,18,1.0,115,2016-01-21,DET,NOP,2016,117.5
7627,7627,27,@,L 99-116 ,240,39,74,0.527,33,59,0.559,6,15,0.4,15,18,0.833,99,43,94,0.457,26,63,0.413,17,31,0.548,13,17,0.765,116,2016-01-23,MIL,NOP,2016,124.5
7628,7628,28,@,L 99-130 ,240,28,73,0.384,20,43,0.465,8,30,0.267,35,52,0.673,99,50,90,0.556,38,67,0.567,12,23,0.522,18,21,0.857,130,2016-01-27,HOU,SAS,2016,136.0
7629,7629,29,@,W 99-96 ,240,39,81,0.481,32,61,0.525,7,20,0.35,14,20,0.7,99,39,85,0.459,35,65,0.538,4,20,0.2,14,26,0.538,96,2016-02-04,LAL,NOP,2016,98.0
7630,7630,30,Home,W 99-84 ,240,39,90,0.433,25,49,0.51,14,41,0.341,7,7,1.0,99,34,87,0.391,29,64,0.453,5,23,0.217,11,16,0.688,84,2016-02-06,CLE,NOP,2016,86.5
7631,7631,31,Home,W 99-92 ,240,36,82,0.439,32,68,0.471,4,14,0.286,23,32,0.719,99,34,88,0.386,28,56,0.5,6,32,0.188,18,24,0.75,92,2016-02-11,MIL,WAS,2016,95.0
7632,7632,32,Home,W 99-97 ,240,37,73,0.507,31,56,0.554,6,17,0.353,19,26,0.731,99,35,74,0.473,23,50,0.46,12,24,0.5,15,21,0.714,97,2016-02-26,TOR,CLE,2016,103.0
7633,7633,33,@,L 99-113 ,240,32,80,0.4,23,51,0.451,9,29,0.31,26,30,0.867,99,39,79,0.494,28,48,0.583,11,31,0.355,24,34,0.706,113,2016-02-28,CLE,WAS,2016,118.5
7634,7634,34,Home,L 99-104 ,240,34,76,0.447,31,62,0.5,3,14,0.214,28,32,0.875,99,38,80,0.475,28,60,0.467,10,20,0.5,18,26,0.692,104,2016-03-02,MIL,IND,2016,109.0
7635,7635,35,Home,L 99-119 ,240,34,85,0.4,21,52,0.404,13,33,0.394,18,26,0.692,99,40,81,0.494,30,56,0.536,10,25,0.4,29,35,0.829,119,2016-03-02,PHI,CHO,2016,124.0
7636,7636,36,Home,L 99-100 ,240,39,89,0.438,33,74,0.446,6,15,0.4,15,24,0.625,99,37,83,0.446,30,62,0.484,7,21,0.333,19,20,0.95,100,2016-03-05,WAS,IND,2016,103.5
7637,7637,37,Home,W 99-91 ,240,32,78,0.41,25,62,0.403,7,16,0.438,28,30,0.933,99,34,96,0.354,30,68,0.441,4,28,0.143,19,22,0.864,91,2016-03-07,IND,SAS,2016,93.0
7638,7638,38,@,L 99-104 ,240,42,82,0.512,36,70,0.514,6,12,0.5,9,9,1.0,99,37,78,0.474,27,55,0.491,10,23,0.435,20,25,0.8,104,2016-03-08,BRK,TOR,2016,109.0
7639,7639,39,@,W 99-96 ,240,37,86,0.43,30,65,0.462,7,21,0.333,18,21,0.857,99,36,84,0.429,30,57,0.526,6,27,0.222,18,25,0.72,96,2016-03-11,MIN,OKC,2016,99.0
7640,7640,40,Home,L 99-108 ,240,38,81,0.469,29,60,0.483,9,21,0.429,14,21,0.667,99,39,82,0.476,27,54,0.5,12,28,0.429,18,22,0.818,108,2016-03-13,SAC,UTA,2016,114.0
7641,7641,41,@,L 99-107 ,240,35,83,0.422,24,58,0.414,11,25,0.44,18,21,0.857,99,40,100,0.4,29,63,0.46,11,37,0.297,16,21,0.762,107,2016-03-16,ORL,CHO,2016,112.5
7642,7642,42,Home,W 99-98 ,240,39,88,0.443,29,51,0.569,10,37,0.27,11,13,0.846,99,37,79,0.468,30,57,0.526,7,22,0.318,17,19,0.895,98,2016-03-16,CLE,DAL,2016,101.5
7643,7643,43,@,W 99-94 ,240,40,90,0.444,34,63,0.54,6,27,0.222,13,19,0.684,99,35,91,0.385,29,58,0.5,6,33,0.182,18,26,0.692,94,2016-03-17,WAS,PHI,2016,97.0
7644,7644,44,Home,W 99-89 ,240,39,87,0.448,31,58,0.534,8,29,0.276,13,17,0.765,99,32,81,0.395,22,60,0.367,10,21,0.476,15,17,0.882,89,2016-03-19,WAS,NYK,2016,94.0
7645,7645,45,Home,L 99-113 ,240,34,87,0.391,27,71,0.38,7,16,0.438,24,30,0.8,99,44,88,0.5,41,69,0.594,3,19,0.158,22,27,0.815,113,2016-03-22,NOP,MIA,2016,114.5
7646,7646,46,Home,L 99-102 ,240,37,85,0.435,30,54,0.556,7,31,0.226,18,21,0.857,99,35,84,0.417,27,55,0.491,8,29,0.276,24,27,0.889,102,2016-03-26,PHO,BOS,2016,106.0
7647,7647,47,@,L 99-110 ,240,41,77,0.532,38,66,0.576,3,11,0.273,14,18,0.778,99,48,84,0.571,43,68,0.632,5,16,0.313,9,12,0.75,110,2016-03-28,BRK,MIA,2016,112.5
7648,7648,48,Home,W 99-91 ,240,32,75,0.427,24,56,0.429,8,19,0.421,27,37,0.73,99,36,89,0.404,26,58,0.448,10,31,0.323,9,13,0.692,91,2016-03-28,NOP,NYK,2016,96.0
7649,7649,49,@,W 99-79 ,240,37,84,0.44,28,53,0.528,9,31,0.29,16,18,0.889,99,30,87,0.345,22,64,0.344,8,23,0.348,11,17,0.647,79,2016-03-30,LAC,MIN,2016,83.0
7650,7650,50,@,W 99-95 ,240,30,71,0.423,18,43,0.419,12,28,0.429,27,29,0.931,99,37,91,0.407,30,72,0.417,7,19,0.368,14,17,0.824,95,2016-04-01,TOR,MEM,2016,98.5
7651,7651,51,Home,L 99-106 ,240,36,93,0.387,29,70,0.414,7,23,0.304,20,26,0.769,99,38,86,0.442,28,60,0.467,10,26,0.385,20,25,0.8,106,2016-04-01,PHO,WAS,2016,111.0
7652,7652,52,@,L 99-113 ,240,39,92,0.424,29,67,0.433,10,25,0.4,11,20,0.55,99,41,83,0.494,27,46,0.587,14,37,0.378,17,20,0.85,113,2016-04-08,BRK,CHO,2016,120.0
7653,7653,53,@,L 99-112 ,240,38,86,0.442,32,67,0.478,6,19,0.316,17,23,0.739,99,36,77,0.468,22,45,0.489,14,32,0.438,26,29,0.897,112,2016-04-08,WAS,DET,2016,119.0
7654,7654,54,Home,L 99-102 (OT),265,36,82,0.439,25,51,0.49,11,31,0.355,16,23,0.696,99,37,83,0.446,24,54,0.444,13,29,0.448,15,19,0.789,102,2016-04-08,UTA,LAC,2016,108.5
7655,7655,55,Home,L 99-100 ,240,37,96,0.385,30,75,0.4,7,21,0.333,18,20,0.9,99,39,87,0.448,29,51,0.569,10,36,0.278,12,13,0.923,100,2016-04-09,MEM,GSW,2016,105.0
7656,7656,56,@,W 99-93 ,240,38,78,0.487,31,58,0.534,7,20,0.35,16,22,0.727,99,34,84,0.405,29,66,0.439,5,18,0.278,20,30,0.667,93,2016-04-12,MIA,DET,2016,95.5
7657,7657,57,@,L 99-107 ,240,40,94,0.426,33,69,0.478,7,25,0.28,12,18,0.667,99,39,89,0.438,28,53,0.528,11,36,0.306,18,22,0.818,107,2016-04-13,DEN,POR,2016,112.5
7658,7658,58,@,L 99-114 ,240,40,94,0.426,34,74,0.459,6,20,0.3,13,18,0.722,99,44,88,0.5,32,62,0.516,12,26,0.462,14,18,0.778,114,2016-10-27,WAS,ATL,2017,120.0
7659,7659,59,@,L 99-105 ,240,38,76,0.5,30,53,0.566,8,23,0.348,15,24,0.625,99,36,92,0.391,25,67,0.373,11,25,0.44,22,30,0.733,105,2016-10-27,BOS,CHI,2017,110.5
7660,7660,60,@,L 99-105 ,240,38,84,0.452,30,56,0.536,8,28,0.286,15,26,0.577,99,36,88,0.409,25,51,0.49,11,37,0.297,22,30,0.733,105,2016-10-29,ORL,CLE,2017,110.5
7661,7661,61,Home,L 99-106 ,240,37,80,0.463,30,60,0.5,7,20,0.35,18,26,0.692,99,37,82,0.451,27,64,0.422,10,18,0.556,22,26,0.846,106,2016-10-30,MIA,SAS,2017,111.0
7662,7662,62,Home,L 99-118 ,240,37,85,0.435,29,65,0.446,8,20,0.4,17,25,0.68,99,42,89,0.472,27,49,0.551,15,40,0.375,19,27,0.704,118,2016-11-02,NYK,HOU,2017,125.5
7663,7663,63,Home,L 99-102 ,240,35,88,0.398,26,66,0.394,9,22,0.409,20,25,0.8,99,39,81,0.481,33,59,0.559,6,22,0.273,18,25,0.72,102,2016-11-03,MIN,DEN,2017,105.0
7664,7664,64,@,W 99-95 ,240,36,86,0.419,26,56,0.464,10,30,0.333,17,24,0.708,99,35,87,0.402,26,51,0.51,9,36,0.25,16,21,0.762,95,2016-11-04,CHA,BRK,2017,99.5
7665,7665,65,@,W 99-88 ,240,32,85,0.376,24,58,0.414,8,27,0.296,27,33,0.818,99,31,84,0.369,22,58,0.379,9,26,0.346,17,22,0.773,88,2016-11-04,LAC,MEM,2017,92.5
7666,7666,66,Home,L 99-101 ,240,33,84,0.393,26,61,0.426,7,23,0.304,26,30,0.867,99,37,78,0.474,27,48,0.563,10,30,0.333,17,22,0.773,101,2016-11-09,SAS,HOU,2017,106.0
7667,7667,67,Home,L 99-105 ,240,36,86,0.419,30,59,0.508,6,27,0.222,21,28,0.75,99,35,80,0.438,27,55,0.491,8,25,0.32,27,33,0.818,105,2016-11-12,IND,BOS,2017,109.0
7668,7668,68,Home,L 99-126 ,240,39,90,0.433,33,70,0.471,6,20,0.3,15,19,0.789,99,52,94,0.553,36,64,0.563,16,30,0.533,6,7,0.857,126,2016-11-12,NOP,LAL,2017,134.0
7669,7669,69,@,L 99-125 ,240,33,71,0.465,25,47,0.532,8,24,0.333,25,30,0.833,99,42,80,0.525,29,53,0.547,13,27,0.481,28,42,0.667,125,2016-11-13,LAL,MIN,2017,131.5
7670,7670,70,@,L 99-102 ,240,34,85,0.4,25,61,0.41,9,24,0.375,22,24,0.917,99,36,81,0.444,25,54,0.463,11,27,0.407,19,25,0.76,102,2016-11-20,TOR,SAC,2017,107.5
7671,7671,71,@,W 99-96 ,240,35,78,0.449,25,47,0.532,10,31,0.323,19,27,0.704,99,36,87,0.414,29,70,0.414,7,17,0.412,17,24,0.708,96,2016-11-21,HOU,DET,2017,99.5
7672,7672,72,@,W 99-93 ,240,38,84,0.452,26,46,0.565,12,38,0.316,11,14,0.786,99,36,86,0.419,32,62,0.516,4,24,0.167,17,25,0.68,93,2016-11-21,BOS,MIN,2017,95.0
7673,7673,73,Home,L 99-104 (2OT),290,35,93,0.376,23,57,0.404,12,36,0.333,17,23,0.739,99,38,99,0.384,28,70,0.4,10,29,0.345,18,24,0.75,104,2016-11-23,PHI,MEM,2017,109.0
7674,7674,74,Home,L 99-105 ,240,40,79,0.506,28,50,0.56,12,29,0.414,7,12,0.583,99,38,82,0.463,24,50,0.48,14,32,0.438,15,19,0.789,105,2016-11-25,MIL,TOR,2017,112.0
7675,7675,75,Home,W 99-92 ,240,36,89,0.404,27,65,0.415,9,24,0.375,18,24,0.75,99,38,86,0.442,32,64,0.5,6,22,0.273,10,15,0.667,92,2016-12-03,POR,MIA,2017,95.0
7676,7676,76,Home,L 99-102 ,240,34,77,0.442,27,55,0.491,7,22,0.318,24,32,0.75,99,37,80,0.463,27,49,0.551,10,31,0.323,18,28,0.643,102,2016-12-05,ATL,OKC,2017,107.0
7677,7677,77,@,W 99-88 ,240,39,91,0.429,27,51,0.529,12,40,0.3,9,13,0.692,99,33,84,0.393,26,59,0.441,7,25,0.28,15,22,0.682,88,2016-12-08,PHI,NOP,2017,91.5
7678,7678,78,Home,L 99-106 ,240,37,89,0.416,27,51,0.529,10,38,0.263,15,21,0.714,99,39,80,0.488,27,51,0.529,12,29,0.414,16,23,0.696,106,2016-12-08,UTA,GSW,2017,112.0
7679,7679,79,Home,L 99-102 ,240,34,81,0.42,27,53,0.509,7,28,0.25,24,31,0.774,99,36,92,0.391,25,50,0.5,11,42,0.262,19,30,0.633,102,2016-12-09,OKC,HOU,2017,107.5
7680,7680,80,Home,W 99-96 ,240,41,83,0.494,38,62,0.613,3,21,0.143,14,27,0.519,99,40,90,0.444,29,58,0.5,11,32,0.344,5,8,0.625,96,2016-12-11,OKC,BOS,2017,101.5
7681,7681,81,@,W 99-94 ,240,38,86,0.442,32,65,0.492,6,21,0.286,17,22,0.773,99,38,87,0.437,34,72,0.472,4,15,0.267,14,19,0.737,94,2016-12-13,MIN,CHI,2017,96.0
7682,7682,82,Home,L 99-107 ,240,40,86,0.465,30,60,0.5,10,26,0.385,9,16,0.563,99,43,88,0.489,31,61,0.508,12,27,0.444,9,13,0.692,107,2016-12-17,ATL,CHO,2017,113.0
7683,7683,83,Home,W 99-79 ,240,34,77,0.442,21,44,0.477,13,33,0.394,18,22,0.818,99,30,76,0.395,22,45,0.489,8,31,0.258,11,17,0.647,79,2016-12-18,DAL,SAC,2017,83.0
7684,7684,84,@,L 99-119 ,240,38,85,0.447,30,55,0.545,8,30,0.267,15,18,0.833,99,45,99,0.455,37,64,0.578,8,35,0.229,21,24,0.875,119,2016-12-23,BRK,CLE,2017,123.0
7685,7685,85,@,L 99-101 ,240,37,86,0.43,24,53,0.453,13,33,0.394,12,16,0.75,99,35,88,0.398,32,75,0.427,3,13,0.231,28,29,0.966,101,2016-12-28,BRK,CHI,2017,102.5
7686,7686,86,Home,W 99-91 ,240,37,83,0.446,28,62,0.452,9,21,0.429,16,23,0.696,99,30,75,0.4,23,48,0.479,7,27,0.259,24,29,0.828,91,2016-12-29,PHO,TOR,2017,94.5
7687,7687,87,@,L 99-108 ,240,39,93,0.419,31,61,0.508,8,32,0.25,13,15,0.867,99,42,84,0.5,31,51,0.608,11,33,0.333,13,15,0.867,108,2016-12-30,DAL,GSW,2017,113.5
7688,7688,88,@,L 99-116 ,240,40,74,0.541,32,56,0.571,8,18,0.444,11,17,0.647,99,43,77,0.558,30,52,0.577,13,25,0.52,17,21,0.81,116,2016-12-30,MIL,MIN,2017,122.5
7689,7689,89,Home,W 99-90 ,240,36,77,0.468,27,54,0.5,9,23,0.391,18,22,0.818,99,36,91,0.396,30,68,0.441,6,23,0.261,12,16,0.75,90,2017-01-03,PHO,MIA,2017,93.0
7690,7690,90,Home,L 99-127 ,240,39,86,0.453,32,61,0.525,7,25,0.28,14,17,0.824,99,51,90,0.567,39,66,0.591,12,24,0.5,13,17,0.765,127,2017-01-05,DEN,SAS,2017,133.0
7691,7691,91,@,W 99-94 ,240,38,90,0.422,29,67,0.433,9,23,0.391,14,17,0.824,99,34,93,0.366,19,58,0.328,15,35,0.429,11,14,0.786,94,2017-01-05,ATL,NOP,2017,101.5
7692,7692,92,@,L 99-101 ,240,35,88,0.398,25,61,0.41,10,27,0.37,19,21,0.905,99,42,83,0.506,31,61,0.508,11,22,0.5,6,9,0.667,101,2017-01-10,CHI,WAS,2017,106.5
7693,7693,93,@,L 99-107 ,240,39,84,0.464,32,61,0.525,7,23,0.304,14,21,0.667,99,43,101,0.426,35,81,0.432,8,20,0.4,13,23,0.565,107,2017-01-14,NOP,CHI,2017,111.0
7694,7694,94,@,W 99-98 ,240,37,78,0.474,26,50,0.52,11,28,0.393,14,18,0.778,99,37,82,0.451,31,68,0.456,6,14,0.429,18,22,0.818,98,2017-01-17,DAL,CHI,2017,101.0
7695,7695,95,Home,W 99-95 ,240,35,73,0.479,26,53,0.491,9,20,0.45,20,29,0.69,99,37,82,0.451,23,46,0.5,14,36,0.389,7,11,0.636,95,2017-01-19,MIA,DAL,2017,102.0
7696,7696,96,@,L 99-102 ,240,37,84,0.44,28,58,0.483,9,26,0.346,16,21,0.762,99,34,83,0.41,28,66,0.424,6,17,0.353,28,33,0.848,102,2017-01-21,SAC,CHI,2017,105.0
7697,7697,97,Home,L 99-109 ,240,35,90,0.389,27,58,0.466,8,32,0.25,21,25,0.84,99,43,80,0.538,33,55,0.6,10,25,0.4,13,17,0.765,109,2017-01-23,CHA,WAS,2017,114.0
7698,7698,98,@,L 99-101 ,240,39,92,0.424,29,58,0.5,10,34,0.294,11,19,0.579,99,36,78,0.462,26,56,0.464,10,22,0.455,19,25,0.76,101,2017-01-25,TOR,MEM,2017,106.0
7699,7699,99,Home,L 99-119 ,240,32,80,0.4,23,55,0.418,9,25,0.36,26,35,0.743,99,45,92,0.489,31,62,0.5,14,30,0.467,15,20,0.75,119,2017-02-01,DEN,MEM,2017,126.0
7700,7700,0,Home,L 99-107 ,240,35,84,0.417,25,58,0.431,10,26,0.385,19,24,0.792,99,32,77,0.416,22,49,0.449,10,28,0.357,33,39,0.846,107,2017-02-04,MIN,MEM,2017,112.0
7701,7701,1,@,L 99-105 ,240,35,87,0.402,25,59,0.424,10,28,0.357,19,21,0.905,99,40,98,0.408,36,80,0.45,4,18,0.222,21,28,0.75,105,2017-02-05,POR,OKC,2017,107.0
7702,7702,2,Home,L 99-108 ,240,35,81,0.432,27,61,0.443,8,20,0.4,21,28,0.75,99,41,92,0.446,34,69,0.493,7,23,0.304,19,21,0.905,108,2017-02-10,BRK,MIA,2017,111.5
7703,7703,3,@,L 99-105 ,240,34,82,0.415,21,51,0.412,13,31,0.419,18,21,0.857,99,35,78,0.449,24,47,0.511,11,31,0.355,24,27,0.889,105,2017-02-12,NOP,SAC,2017,110.5
7704,7704,4,Home,L 99-105 ,240,34,78,0.436,23,47,0.489,11,31,0.355,20,26,0.769,99,41,86,0.477,29,53,0.547,12,33,0.364,11,17,0.647,105,2017-02-13,CHA,PHI,2017,111.0
7705,7705,5,Home,L 99-112 ,240,38,94,0.404,27,60,0.45,11,34,0.324,12,18,0.667,99,41,86,0.477,35,68,0.515,6,18,0.333,24,28,0.857,112,2017-02-15,DEN,MIN,2017,115.0
7706,7706,6,Home,W 99-84 ,240,37,79,0.468,23,42,0.548,14,37,0.378,11,12,0.917,99,32,79,0.405,25,53,0.472,7,26,0.269,13,19,0.684,84,2017-02-15,LAC,ATL,2017,87.5
7707,7707,7,Home,L 99-129 ,240,36,86,0.419,30,55,0.545,6,31,0.194,21,26,0.808,99,45,91,0.495,25,40,0.625,20,51,0.392,19,24,0.792,129,2017-02-23,NOP,HOU,2017,139.0
7708,7708,8,Home,L 99-117 ,240,37,80,0.463,23,43,0.535,14,37,0.378,11,15,0.733,99,46,93,0.495,31,63,0.492,15,30,0.5,10,16,0.625,117,2017-02-25,CLE,CHI,2017,124.5
7709,7709,9,@,W 99-85 ,240,34,85,0.4,20,47,0.426,14,38,0.368,17,18,0.944,99,31,79,0.392,20,51,0.392,11,28,0.393,12,15,0.8,85,2017-02-25,CHA,SAC,2017,90.5
7710,7710,10,@,L 99-103 ,240,37,91,0.407,27,58,0.466,10,33,0.303,15,22,0.682,99,36,78,0.462,23,47,0.489,13,31,0.419,18,23,0.783,103,2017-03-01,CLE,BOS,2017,109.5
7711,7711,11,@,L 99-100 ,240,37,81,0.457,30,58,0.517,7,23,0.304,18,25,0.72,99,35,74,0.473,26,45,0.578,9,29,0.31,21,24,0.875,100,2017-03-01,IND,SAS,2017,104.5
7712,7712,12,@,L 99-110 ,240,35,91,0.385,27,63,0.429,8,28,0.286,21,25,0.84,99,45,90,0.5,40,73,0.548,5,17,0.294,15,19,0.789,110,2017-03-03,MIA,ORL,2017,112.5
7713,7713,13,@,W 99-86 ,240,37,84,0.44,27,55,0.491,10,29,0.345,15,19,0.789,99,37,84,0.44,31,54,0.574,6,30,0.2,6,9,0.667,86,2017-03-08,BOS,GSW,2017,89.0
7714,7714,14,Home,W 98-95 ,240,40,94,0.426,38,78,0.487,2,16,0.125,16,20,0.8,98,28,70,0.4,22,56,0.393,6,14,0.429,33,45,0.733,95,2011-12-27,MIL,MIN,2012,98.0
7715,7715,15,@,W 98-95 ,240,29,77,0.377,19,52,0.365,10,25,0.4,30,38,0.789,98,34,87,0.391,32,71,0.451,2,16,0.125,25,33,0.758,95,2011-12-28,OKC,MEM,2012,96.0
7716,7716,16,Home,L 98-108 ,240,35,83,0.422,27,66,0.409,8,17,0.471,20,34,0.588,98,43,80,0.538,37,68,0.544,6,12,0.5,16,21,0.762,108,2011-12-29,SAC,CHI,2012,111.0
7717,7717,17,@,L 98-105 ,240,38,82,0.463,29,62,0.468,9,20,0.45,13,14,0.929,98,37,77,0.481,33,62,0.532,4,15,0.267,27,38,0.711,105,2011-12-30,BRK,ATL,2012,107.0
7718,7718,18,Home,W 98-91 (OT),265,36,94,0.383,34,84,0.405,2,10,0.2,24,32,0.75,98,34,88,0.386,29,63,0.46,5,25,0.2,18,31,0.581,91,2011-12-30,IND,CLE,2012,93.5
7719,7719,19,Home,W 98-82 ,240,38,78,0.487,22,52,0.423,16,26,0.615,6,11,0.545,98,27,71,0.38,20,49,0.408,7,22,0.318,21,28,0.75,82,2012-01-01,CLE,NJN,2012,85.5
7720,7720,20,Home,W 98-89 ,240,38,91,0.418,30,69,0.435,8,22,0.364,14,21,0.667,98,37,82,0.451,32,65,0.492,5,17,0.294,10,15,0.667,89,2012-01-04,DAL,PHO,2012,91.5
7721,7721,21,@,W 98-87 ,240,37,80,0.463,29,63,0.46,8,17,0.471,16,22,0.727,98,31,79,0.392,27,59,0.458,4,20,0.2,21,31,0.677,87,2012-01-06,CLE,MIN,2012,89.0
7722,7722,22,@,W 98-95 ,240,36,85,0.424,29,64,0.453,7,21,0.333,19,22,0.864,98,38,87,0.437,33,73,0.452,5,14,0.357,14,15,0.933,95,2012-01-07,OKC,HOU,2012,97.5
7723,7723,23,Home,W 98-78 ,240,38,92,0.413,32,69,0.464,6,23,0.261,16,18,0.889,98,29,79,0.367,26,55,0.473,3,24,0.125,17,24,0.708,78,2012-01-08,POR,CLE,2012,79.5
7724,7724,24,@,W 98-91 ,240,30,81,0.37,23,57,0.404,7,24,0.292,31,34,0.912,98,34,80,0.425,28,60,0.467,6,20,0.3,17,21,0.81,91,2012-01-11,SAC,TOR,2012,94.0
7725,7725,25,@,W 98-81 ,240,40,82,0.488,33,68,0.485,7,14,0.5,11,16,0.688,98,33,74,0.446,32,66,0.485,1,8,0.125,14,16,0.875,81,2012-01-13,DET,CHA,2012,81.5
7726,7726,26,@,L 98-120 ,240,38,80,0.475,28,55,0.509,10,25,0.4,12,17,0.706,98,46,79,0.582,30,53,0.566,16,26,0.615,12,19,0.632,120,2012-01-17,SAS,MIA,2012,128.0
7727,7727,27,Home,W 98-87 ,240,38,85,0.447,29,67,0.433,9,18,0.5,13,18,0.722,98,34,81,0.42,28,61,0.459,6,20,0.3,13,16,0.813,87,2012-01-19,MIA,LAL,2012,90.0
7728,7728,28,@,W 98-81 ,240,39,68,0.574,34,59,0.576,5,9,0.556,15,20,0.75,98,29,66,0.439,25,56,0.446,4,10,0.4,19,26,0.731,81,2012-01-20,MEM,DET,2012,83.0
7729,7729,29,Home,L 98-101 ,240,33,71,0.465,22,50,0.44,11,21,0.524,21,28,0.75,98,36,81,0.444,30,66,0.455,6,15,0.4,23,33,0.697,101,2012-01-20,LAC,MIN,2012,104.0
7730,7730,30,@,L 98-108 ,240,37,83,0.446,29,62,0.468,8,21,0.381,16,21,0.762,98,41,79,0.519,36,64,0.563,5,15,0.333,21,29,0.724,108,2012-01-21,MIN,UTA,2012,110.5
7731,7731,31,@,W 98-96 ,240,36,77,0.468,26,59,0.441,10,18,0.556,16,19,0.842,98,36,86,0.419,34,77,0.442,2,9,0.222,22,33,0.667,96,2012-01-22,IND,LAL,2012,97.0
7732,7732,32,Home,L 98-101 ,240,36,72,0.5,29,50,0.58,7,22,0.318,19,25,0.76,98,37,71,0.521,32,56,0.571,5,15,0.333,22,25,0.88,101,2012-01-25,DET,MIA,2012,103.5
7733,7733,33,Home,W 98-91 ,240,35,72,0.486,26,50,0.52,9,22,0.409,19,27,0.704,98,30,84,0.357,24,66,0.364,6,18,0.333,25,31,0.806,91,2012-01-26,LAC,MEM,2012,94.0
7734,7734,34,@,W 98-88 ,240,34,75,0.453,28,55,0.509,6,20,0.3,24,31,0.774,98,37,92,0.402,34,78,0.436,3,14,0.214,11,13,0.846,88,2012-01-30,CHI,WAS,2012,89.5
7735,7735,35,Home,W 98-82 ,240,40,84,0.476,36,73,0.493,4,11,0.364,14,19,0.737,98,32,74,0.432,25,57,0.439,7,17,0.412,11,16,0.688,82,2012-02-01,PHI,CHI,2012,85.5
7736,7736,36,@,W 98-87 ,240,37,87,0.425,25,62,0.403,12,25,0.48,12,16,0.75,98,35,83,0.422,29,67,0.433,6,16,0.375,11,13,0.846,87,2012-02-03,IND,DAL,2012,90.0
7737,7737,37,@,W 98-87 ,240,44,88,0.5,40,79,0.506,4,9,0.444,6,9,0.667,98,32,74,0.432,27,59,0.458,5,15,0.333,18,27,0.667,87,2012-02-04,PHI,ATL,2012,89.5
7738,7738,38,Home,W 98-80 ,240,36,73,0.493,29,53,0.547,7,20,0.35,19,21,0.905,98,32,87,0.368,29,73,0.397,3,14,0.214,13,16,0.813,80,2012-02-05,BOS,MEM,2012,81.5
7739,7739,39,Home,W 98-92 ,240,34,73,0.466,33,64,0.516,1,9,0.111,29,37,0.784,98,30,78,0.385,24,62,0.387,6,16,0.375,26,37,0.703,92,2012-02-10,MEM,IND,2012,95.0
7740,7740,40,Home,L 98-100 ,240,37,84,0.44,31,65,0.477,6,19,0.316,18,19,0.947,98,40,84,0.476,33,65,0.508,7,19,0.368,13,22,0.591,100,2012-02-11,MIN,NYK,2012,103.5
7741,7741,41,@,W 98-84 ,240,39,78,0.5,31,55,0.564,8,23,0.348,12,15,0.8,98,27,77,0.351,19,56,0.339,8,21,0.381,22,28,0.786,84,2012-02-11,PHO,SAC,2012,88.0
7742,7742,42,@,W 98-77 ,240,37,79,0.468,31,64,0.484,6,15,0.4,18,21,0.857,98,29,89,0.326,28,78,0.359,1,11,0.091,18,19,0.947,77,2012-02-12,WAS,DET,2012,77.5
7743,7743,43,@,W 98-88 ,240,42,83,0.506,37,70,0.529,5,13,0.385,9,13,0.692,98,34,78,0.436,32,68,0.471,2,10,0.2,18,23,0.783,88,2012-02-12,UTA,MEM,2012,89.0
7744,7744,44,@,W 98-89 ,240,36,83,0.434,30,65,0.462,6,18,0.333,20,24,0.833,98,30,73,0.411,23,56,0.411,7,17,0.412,22,30,0.733,89,2012-02-13,PHI,CHA,2012,92.5
7745,7745,45,@,W 98-88 ,240,35,74,0.473,31,62,0.5,4,12,0.333,24,29,0.828,98,34,77,0.442,33,71,0.465,1,6,0.167,19,32,0.594,88,2012-02-15,DET,BOS,2012,88.5
7746,7746,46,Home,W 98-87 ,240,36,77,0.468,26,50,0.52,10,27,0.37,16,23,0.696,98,32,87,0.368,27,71,0.38,5,16,0.313,18,27,0.667,87,2012-02-15,CLE,IND,2012,89.5
7747,7747,47,Home,L 98-111 ,240,40,85,0.471,30,65,0.462,10,20,0.5,8,10,0.8,98,43,77,0.558,38,62,0.613,5,15,0.333,20,23,0.87,111,2012-02-17,HOU,MIN,2012,113.5
7748,7748,48,@,W 98-91 ,240,37,74,0.5,31,59,0.525,6,15,0.4,18,23,0.783,98,35,84,0.417,33,68,0.485,2,16,0.125,19,28,0.679,91,2012-02-17,CHA,TOR,2012,92.0
7749,7749,49,@,L 98-100 ,240,39,85,0.459,38,78,0.487,1,7,0.143,19,24,0.792,98,31,77,0.403,20,55,0.364,11,22,0.5,27,38,0.711,100,2012-02-22,UTA,MIN,2012,105.5
7750,7750,50,@,L 98-99 ,240,37,75,0.493,29,58,0.5,8,17,0.471,16,22,0.727,98,38,90,0.422,35,80,0.438,3,10,0.3,20,27,0.741,99,2012-03-02,MIA,UTA,2012,100.5
7751,7751,51,@,L 98-114 ,240,37,79,0.468,31,63,0.492,6,16,0.375,18,27,0.667,98,42,81,0.519,28,54,0.519,14,27,0.519,16,27,0.593,114,2012-03-03,MIL,ORL,2012,121.0
7752,7752,52,@,L 98-101 ,240,37,83,0.446,29,62,0.468,8,21,0.381,16,26,0.615,98,40,87,0.46,32,66,0.485,8,21,0.381,13,21,0.619,101,2012-03-03,CLE,WAS,2012,105.0
7753,7753,53,@,L 98-99 ,240,42,77,0.545,39,68,0.574,3,9,0.333,11,12,0.917,98,38,76,0.5,30,53,0.566,8,23,0.348,15,23,0.652,99,2012-03-07,NOP,SAC,2012,103.0
7754,7754,54,@,L 98-116 ,240,29,70,0.414,26,59,0.441,3,11,0.273,37,44,0.841,98,45,76,0.592,39,64,0.609,6,12,0.5,20,24,0.833,116,2012-03-07,HOU,TOR,2012,119.0
7755,7755,55,Home,W 98-91 ,240,41,86,0.477,37,75,0.493,4,11,0.364,12,15,0.8,98,36,86,0.419,31,72,0.431,5,14,0.357,14,19,0.737,91,2012-03-10,PHO,MEM,2012,93.5
7756,7756,56,@,L 98-107 ,240,35,80,0.438,33,68,0.485,2,12,0.167,26,38,0.684,98,44,87,0.506,38,65,0.585,6,22,0.273,13,15,0.867,107,2012-03-13,WAS,DAL,2012,110.0
7757,7757,57,@,L 98-104 (OT),265,40,91,0.44,32,68,0.471,8,23,0.348,10,11,0.909,98,36,73,0.493,25,45,0.556,11,28,0.393,21,37,0.568,104,2012-03-13,MIA,ORL,2012,109.5
7758,7758,58,Home,W 98-84 ,240,38,79,0.481,31,62,0.5,7,17,0.412,15,17,0.882,98,31,81,0.383,30,71,0.423,1,10,0.1,21,25,0.84,84,2012-03-14,BRK,TOR,2012,84.5
7759,7759,59,Home,L 98-120 ,240,35,79,0.443,25,57,0.439,10,22,0.455,18,20,0.9,98,45,93,0.484,35,71,0.493,10,22,0.455,20,22,0.909,120,2012-03-16,GSW,MIL,2012,125.0
7760,7760,60,Home,W 98-91 ,240,34,74,0.459,27,54,0.5,7,20,0.35,23,31,0.742,98,36,76,0.474,33,61,0.541,3,15,0.2,16,17,0.941,91,2012-03-17,DEN,BOS,2012,92.5
7761,7761,61,@,W 98-77 ,240,38,81,0.469,29,65,0.446,9,16,0.563,13,20,0.65,98,32,80,0.4,27,63,0.429,5,17,0.294,8,9,0.889,77,2012-03-28,CHI,ATL,2012,79.5
7762,7762,62,Home,W 98-89 ,240,38,73,0.521,31,59,0.525,7,14,0.5,15,20,0.75,98,35,94,0.372,34,79,0.43,1,15,0.067,18,26,0.692,89,2012-03-30,HOU,MEM,2012,89.5
7763,7763,63,Home,W 98-97 ,240,39,75,0.52,31,54,0.574,8,21,0.381,12,19,0.632,98,39,78,0.5,31,59,0.525,8,19,0.421,11,15,0.733,97,2012-03-30,LAC,POR,2012,101.0
7764,7764,64,Home,L 98-100 ,240,35,78,0.449,24,46,0.522,11,32,0.344,17,28,0.607,98,38,80,0.475,31,58,0.534,7,22,0.318,17,21,0.81,100,2012-03-30,ORL,DAL,2012,103.5
7765,7765,65,Home,L 98-112 ,240,36,81,0.444,29,63,0.46,7,18,0.389,19,20,0.95,98,43,83,0.518,39,73,0.534,4,10,0.4,22,29,0.759,112,2012-04-02,WAS,MIL,2012,114.0
7766,7766,66,Home,W 98-94 ,240,37,80,0.463,28,63,0.444,9,17,0.529,15,24,0.625,98,38,82,0.463,31,64,0.484,7,18,0.389,11,16,0.688,94,2012-04-03,MEM,GSW,2012,97.5
7767,7767,67,Home,W 98-93 ,240,31,83,0.373,21,59,0.356,10,24,0.417,26,29,0.897,98,35,81,0.432,30,64,0.469,5,17,0.294,18,20,0.9,93,2012-04-04,MIA,OKC,2012,95.5
7768,7768,68,@,L 98-107 ,240,39,95,0.411,31,69,0.449,8,26,0.308,12,13,0.923,98,48,84,0.571,46,73,0.63,2,11,0.182,9,17,0.529,107,2012-04-04,CLE,MIL,2012,108.0
7769,7769,69,@,L 98-103 ,240,34,77,0.442,28,58,0.483,6,19,0.316,24,31,0.774,98,35,85,0.412,29,66,0.439,6,19,0.316,27,34,0.794,103,2012-04-06,OKC,IND,2012,106.0
7770,7770,70,@,L 98-110 ,240,38,84,0.452,33,72,0.458,5,12,0.417,17,22,0.773,98,45,80,0.563,38,62,0.613,7,18,0.389,13,19,0.684,110,2012-04-06,WAS,NJN,2012,113.5
7771,7771,71,@,L 98-104 ,240,39,86,0.453,30,64,0.469,9,22,0.409,11,12,0.917,98,38,79,0.481,32,63,0.508,6,16,0.375,22,25,0.88,104,2012-04-06,GSW,UTA,2012,107.0
7772,7772,72,Home,W 98-75 ,240,36,83,0.434,29,60,0.483,7,23,0.304,19,29,0.655,98,28,75,0.373,25,56,0.446,3,19,0.158,16,23,0.696,75,2012-04-08,MIA,DET,2012,76.5
7773,7773,73,@,L 98-103 ,240,36,75,0.48,26,55,0.473,10,20,0.5,16,24,0.667,98,36,71,0.507,29,55,0.527,7,16,0.438,24,31,0.774,103,2012-04-09,TOR,IND,2012,106.5
7774,7774,74,Home,W 98-86 ,240,39,90,0.433,30,70,0.429,9,20,0.45,11,16,0.688,98,31,73,0.425,24,52,0.462,7,21,0.333,17,21,0.81,86,2012-04-10,CHI,NYK,2012,89.5
7775,7775,75,Home,L 98-104 (OT),265,40,88,0.455,37,67,0.552,3,21,0.143,15,19,0.789,98,36,77,0.468,28,57,0.491,8,20,0.4,24,32,0.75,104,2012-04-11,CLE,IND,2012,108.0
7776,7776,76,Home,L 98-100 ,240,31,76,0.408,19,50,0.38,12,26,0.462,24,27,0.889,98,38,81,0.469,33,65,0.508,5,16,0.313,19,21,0.905,100,2012-04-11,OKC,LAC,2012,102.5
7777,7777,77,@,W 98-84 ,240,40,89,0.449,29,66,0.439,11,23,0.478,7,12,0.583,98,33,81,0.407,20,57,0.351,13,24,0.542,5,9,0.556,84,2012-04-11,LAL,SAS,2012,90.5
7778,7778,78,@,L 98-103 ,240,40,83,0.482,35,72,0.486,5,11,0.455,13,17,0.765,98,34,70,0.486,27,57,0.474,7,13,0.538,28,34,0.824,103,2012-04-14,UTA,MEM,2012,106.5
7779,7779,79,@,W 98-89 ,240,34,66,0.515,31,58,0.534,3,8,0.375,27,33,0.818,98,38,87,0.437,34,73,0.466,4,14,0.286,9,12,0.75,89,2012-04-14,CLE,WAS,2012,91.0
7780,7780,80,Home,L 98-101 ,240,41,82,0.5,36,66,0.545,5,16,0.313,11,16,0.688,98,36,71,0.507,30,53,0.566,6,18,0.333,23,27,0.852,101,2012-04-16,BRK,MIA,2012,104.0
7781,7781,81,@,L 98-102 ,240,36,78,0.462,30,54,0.556,6,24,0.25,20,30,0.667,98,38,70,0.543,35,63,0.556,3,7,0.429,23,27,0.852,102,2012-04-18,ORL,BOS,2012,103.5
7782,7782,82,Home,L 98-104 ,240,36,73,0.493,31,55,0.564,5,18,0.278,21,26,0.808,98,38,78,0.487,24,54,0.444,14,24,0.583,14,20,0.7,104,2012-04-18,DEN,LAC,2012,111.0
7783,7783,83,Home,W 98-90 ,240,36,79,0.456,30,60,0.5,6,19,0.316,20,27,0.741,98,35,83,0.422,23,50,0.46,12,33,0.364,8,15,0.533,90,2012-04-20,CLE,NYK,2012,96.0
7784,7784,84,@,L 98-107 ,240,35,71,0.493,32,59,0.542,3,12,0.25,25,34,0.735,98,33,77,0.429,26,49,0.531,7,28,0.25,34,43,0.791,107,2012-04-22,NOP,LAC,2012,110.5
7785,7785,85,@,L 98-114 ,240,37,88,0.42,32,66,0.485,5,22,0.227,19,28,0.679,98,42,77,0.545,34,57,0.596,8,20,0.4,22,29,0.759,114,2012-04-22,CLE,SAS,2012,118.0
7786,7786,86,Home,W 98-67 ,240,37,88,0.42,27,69,0.391,10,19,0.526,14,18,0.778,98,25,83,0.301,19,65,0.292,6,18,0.333,11,16,0.688,67,2012-04-26,TOR,NJN,2012,70.0
7787,7787,87,@,L 98-106 (2OT),290,37,102,0.363,29,80,0.363,8,22,0.364,16,20,0.8,98,39,99,0.394,35,77,0.455,4,22,0.182,24,27,0.889,106,2012-11-03,SAC,IND,2013,108.0
7788,7788,88,Home,W 98-93 ,240,36,72,0.5,32,62,0.516,4,10,0.4,22,29,0.759,98,33,82,0.402,26,67,0.388,7,15,0.467,20,28,0.714,93,2012-11-14,BOS,UTA,2013,96.5
7789,7789,89,@,W 98-93 ,240,36,77,0.468,23,50,0.46,13,27,0.481,13,16,0.813,98,37,88,0.42,31,68,0.456,6,20,0.3,13,19,0.684,93,2012-11-15,MIA,DEN,2013,96.0
7790,7790,90,Home,L 98-106 ,240,34,79,0.43,27,61,0.443,7,18,0.389,23,29,0.793,98,43,85,0.506,41,70,0.586,2,15,0.133,18,26,0.692,106,2012-11-16,MIN,GSW,2013,107.0
7791,7791,91,@,L 98-102 ,240,44,93,0.473,42,77,0.545,2,16,0.125,8,11,0.727,98,36,82,0.439,33,71,0.465,3,11,0.273,27,30,0.9,102,2012-11-19,MIL,CHA,2013,103.5
7792,7792,92,@,L 98-106 ,240,37,82,0.451,33,66,0.5,4,16,0.25,20,29,0.69,98,40,85,0.471,31,61,0.508,9,24,0.375,17,19,0.895,106,2012-11-20,TOR,PHI,2013,110.5
7793,7793,93,Home,W 98-97 ,240,36,86,0.419,33,67,0.493,3,19,0.158,23,28,0.821,98,37,80,0.463,28,57,0.491,9,23,0.391,14,20,0.7,97,2012-11-21,CHA,TOR,2013,101.5
7794,7794,94,@,L 98-106 ,240,33,74,0.446,21,47,0.447,12,27,0.444,20,24,0.833,98,38,75,0.507,32,64,0.5,6,11,0.545,24,30,0.8,106,2012-11-23,LAL,MEM,2013,109.0
7795,7795,95,Home,W 98-85 ,240,39,92,0.424,34,75,0.453,5,17,0.294,15,21,0.714,98,34,78,0.436,27,61,0.443,7,17,0.412,10,13,0.769,85,2012-11-25,BRK,POR,2013,88.5
7796,7796,96,Home,L 98-105 ,240,37,79,0.468,19,42,0.452,18,37,0.486,6,11,0.545,98,36,71,0.507,21,46,0.457,15,25,0.6,18,23,0.783,105,2012-11-26,LAC,NOH,2013,112.5
7797,7797,97,@,L 98-100 ,240,37,81,0.457,32,62,0.516,5,19,0.263,19,22,0.864,98,35,75,0.467,29,61,0.475,6,14,0.429,24,32,0.75,100,2012-11-27,DAL,PHI,2013,103.0
7798,7798,98,@,L 98-120 ,240,36,87,0.414,28,66,0.424,8,21,0.381,18,30,0.6,98,47,87,0.54,38,65,0.585,9,22,0.409,17,22,0.773,120,2012-11-28,HOU,OKC,2013,124.5
7799,7799,99,Home,L 98-104 ,240,39,83,0.47,31,66,0.47,8,17,0.471,12,18,0.667,98,44,86,0.512,36,69,0.522,8,17,0.471,8,10,0.8,104,2012-11-30,CHA,PHI,2013,108.0
7800,7800,0,@,W 98-86 ,240,38,83,0.458,27,63,0.429,11,20,0.55,11,13,0.846,98,35,78,0.449,34,67,0.507,1,11,0.091,15,19,0.789,86,2012-11-30,BRK,ORL,2013,86.5
7801,7801,1,@,L 98-108 (OT),265,38,82,0.463,32,68,0.471,6,14,0.429,16,22,0.727,98,40,85,0.471,36,66,0.545,4,19,0.211,24,31,0.774,108,2012-12-04,PHO,MEM,2013,110.0
7802,7802,2,Home,L 98-100 ,240,39,83,0.47,32,67,0.478,7,16,0.438,13,15,0.867,98,39,92,0.424,26,51,0.51,13,41,0.317,9,13,0.692,100,2012-12-05,CHA,NYK,2013,106.5
7803,7803,3,@,W 98-90 ,240,40,77,0.519,35,62,0.565,5,15,0.333,13,18,0.722,98,36,78,0.462,31,58,0.534,5,20,0.25,13,18,0.722,90,2012-12-09,ORL,PHO,2013,92.5
7804,7804,4,Home,W 98-85 ,240,39,96,0.406,33,79,0.418,6,17,0.353,14,24,0.583,98,32,86,0.372,29,67,0.433,3,19,0.158,18,21,0.857,85,2012-12-12,MIL,SAC,2013,86.5
7805,7805,5,Home,W 98-90 ,240,40,88,0.455,33,61,0.541,7,27,0.259,11,12,0.917,98,33,72,0.458,27,53,0.509,6,19,0.316,18,25,0.72,90,2012-12-13,POR,SAS,2013,93.0
7806,7806,6,Home,L 98-107 ,240,36,78,0.462,32,66,0.485,4,12,0.333,22,29,0.759,98,43,79,0.544,38,62,0.613,5,17,0.294,16,19,0.842,107,2012-12-15,CHA,ORL,2013,109.5
7807,7807,7,Home,L 98-111 ,240,41,83,0.494,31,58,0.534,10,25,0.4,6,11,0.545,98,39,80,0.488,25,46,0.543,14,34,0.412,19,24,0.792,111,2012-12-16,PHI,LAL,2013,118.0
7808,7808,8,Home,W 98-93 ,240,37,86,0.43,31,72,0.431,6,14,0.429,18,26,0.692,98,32,80,0.4,30,72,0.417,2,8,0.25,27,34,0.794,93,2012-12-18,MIL,IND,2013,94.0
7809,7809,9,@,W 98-95 ,240,35,82,0.427,24,58,0.414,11,24,0.458,17,23,0.739,98,39,79,0.494,35,69,0.507,4,10,0.4,13,20,0.65,95,2012-12-29,NOP,CHA,2013,97.0
7810,7810,10,Home,W 98-91 ,240,36,82,0.439,32,66,0.485,4,16,0.25,22,31,0.71,98,37,85,0.435,32,61,0.525,5,24,0.208,12,16,0.75,91,2013-01-11,DEN,CLE,2013,93.5
7811,7811,11,@,L 98-101 (OT),265,35,76,0.461,25,51,0.49,10,25,0.4,18,22,0.818,98,40,85,0.471,37,73,0.507,3,12,0.25,18,21,0.857,101,2013-01-11,SAS,MEM,2013,102.5
7812,7812,12,@,L 98-113 ,240,35,85,0.412,29,65,0.446,6,20,0.3,22,29,0.759,98,46,77,0.597,40,64,0.625,6,13,0.462,15,16,0.938,113,2013-01-14,MIN,DAL,2013,116.0
7813,7813,13,@,W 98-94 ,240,39,92,0.424,33,76,0.434,6,16,0.375,14,20,0.7,98,34,89,0.382,30,75,0.4,4,14,0.286,22,29,0.759,94,2013-01-17,MIL,PHO,2013,96.0
7814,7814,14,@,W 98-93 ,240,41,86,0.477,33,62,0.532,8,24,0.333,8,11,0.727,98,35,85,0.412,27,64,0.422,8,21,0.381,15,22,0.682,93,2013-01-19,SAS,ATL,2013,97.0
7815,7815,15,@,L 98-109 ,240,34,83,0.41,28,62,0.452,6,21,0.286,24,30,0.8,98,45,90,0.5,39,74,0.527,6,16,0.375,13,17,0.765,109,2013-01-19,CLE,UTA,2013,112.0
7816,7816,16,@,W 98-95 ,240,39,84,0.464,31,65,0.477,8,19,0.421,12,17,0.706,98,37,81,0.457,30,57,0.526,7,24,0.292,14,18,0.778,95,2013-01-21,WAS,POR,2013,98.5
7817,7817,17,Home,L 98-99 ,240,40,82,0.488,35,65,0.538,5,17,0.294,13,18,0.722,98,37,78,0.474,31,67,0.463,6,11,0.545,19,22,0.864,99,2013-01-26,TOR,CLE,2013,102.0
7818,7818,18,@,L 98-100 (2OT),290,39,96,0.406,34,73,0.466,5,23,0.217,15,20,0.75,98,36,88,0.409,31,68,0.456,5,20,0.25,23,27,0.852,100,2013-01-27,MIA,BOS,2013,102.5
7819,7819,19,Home,W 98-79 ,240,36,81,0.444,29,67,0.433,7,14,0.5,19,21,0.905,98,32,88,0.364,29,70,0.414,3,18,0.167,12,27,0.444,79,2013-01-30,IND,DET,2013,80.5
7820,7820,20,@,L 98-113 ,240,38,72,0.528,34,59,0.576,4,13,0.308,18,21,0.857,98,44,84,0.524,37,62,0.597,7,22,0.318,18,22,0.818,113,2013-02-01,NOP,DEN,2013,116.5
7821,7821,21,Home,W 98-73 ,240,38,81,0.469,26,55,0.473,12,26,0.462,10,17,0.588,98,25,72,0.347,22,53,0.415,3,19,0.158,20,31,0.645,73,2013-02-01,TOR,LAC,2013,74.5
7822,7822,22,@,L 98-107 ,240,41,94,0.436,36,75,0.48,5,19,0.263,11,22,0.5,98,42,90,0.467,33,66,0.5,9,24,0.375,14,20,0.7,107,2013-02-02,ORL,MIL,2013,111.5
7823,7823,23,@,W 98-97 ,240,39,83,0.47,33,63,0.524,6,20,0.3,14,22,0.636,98,41,92,0.446,36,78,0.462,5,14,0.357,10,15,0.667,97,2013-02-03,LAL,DET,2013,99.5
7824,7824,24,Home,L 98-100 ,240,40,85,0.471,37,72,0.514,3,13,0.231,15,19,0.789,98,41,70,0.586,34,52,0.654,7,18,0.389,11,16,0.688,100,2013-02-04,MIN,POR,2013,103.5
7825,7825,25,Home,W 98-91 (OT),265,38,72,0.528,31,60,0.517,7,12,0.583,15,18,0.833,98,35,87,0.402,32,67,0.478,3,20,0.15,18,25,0.72,91,2013-02-04,UTA,SAC,2013,92.5
7826,7826,26,Home,W 98-90 ,240,37,84,0.44,30,72,0.417,7,12,0.583,17,27,0.63,98,37,79,0.468,33,62,0.532,4,17,0.235,12,15,0.8,90,2013-02-04,WAS,LAC,2013,92.0
7827,7827,27,@,L 98-119 ,240,38,93,0.409,28,73,0.384,10,20,0.5,12,16,0.75,98,48,95,0.505,40,72,0.556,8,23,0.348,15,20,0.75,119,2013-02-06,GSW,OKC,2013,123.0
7828,7828,28,Home,L 98-100 (OT),265,35,78,0.449,26,56,0.464,9,22,0.409,19,28,0.679,98,42,96,0.438,40,87,0.46,2,9,0.222,14,19,0.737,100,2013-02-08,IND,TOR,2013,101.0
7829,7829,29,Home,L 98-102 ,240,33,80,0.413,27,60,0.45,6,20,0.3,26,32,0.813,98,41,82,0.5,38,69,0.551,3,13,0.231,17,20,0.85,102,2013-02-19,POR,PHO,2013,103.5
7830,7830,30,@,L 98-108 ,240,40,84,0.476,31,67,0.463,9,17,0.529,9,14,0.643,98,42,87,0.483,32,67,0.478,10,20,0.5,14,17,0.824,108,2013-02-20,PHO,GSW,2013,113.0
7831,7831,31,@,L 98-100 ,240,35,75,0.467,25,47,0.532,10,28,0.357,18,23,0.783,98,35,80,0.438,28,62,0.452,7,18,0.389,23,28,0.821,100,2013-02-22,NYK,TOR,2013,103.5
7832,7832,32,Home,L 98-101 ,240,39,78,0.5,30,57,0.526,9,21,0.429,11,15,0.733,98,40,81,0.494,35,64,0.547,5,17,0.294,16,19,0.842,101,2013-02-26,CHI,CLE,2013,103.5
7833,7833,33,@,W 98-84 ,240,41,76,0.539,36,63,0.571,5,13,0.385,11,16,0.688,98,32,81,0.395,25,60,0.417,7,21,0.333,13,18,0.722,84,2013-02-26,ORL,PHI,2013,87.5
7834,7834,34,@,W 98-90 ,240,39,78,0.5,30,57,0.526,9,21,0.429,11,14,0.786,98,36,78,0.462,29,55,0.527,7,23,0.304,11,14,0.786,90,2013-03-01,DAL,BRK,2013,93.5
7835,7835,35,Home,W 98-91 ,240,34,73,0.466,24,54,0.444,10,19,0.526,20,27,0.741,98,33,77,0.429,29,64,0.453,4,13,0.308,21,27,0.778,91,2013-03-01,MIA,MEM,2013,93.0
7836,7836,36,Home,W 98-68 ,240,38,78,0.487,33,62,0.532,5,16,0.313,17,23,0.739,98,28,81,0.346,23,63,0.365,5,18,0.278,7,12,0.583,68,2013-03-01,UTA,CHA,2013,70.5
7837,7837,37,@,L 98-99 ,240,41,82,0.5,33,60,0.55,8,22,0.364,8,15,0.533,98,38,78,0.487,28,57,0.491,10,21,0.476,13,18,0.722,99,2013-03-03,ATL,LAL,2013,104.0
7838,7838,38,@,W 98-71 ,240,37,77,0.481,26,53,0.491,11,24,0.458,13,15,0.867,98,28,74,0.378,21,51,0.412,7,23,0.304,8,15,0.533,71,2013-03-06,TOR,PHO,2013,74.5
7839,7839,39,Home,W 98-96 ,240,40,86,0.465,29,66,0.439,11,20,0.55,7,9,0.778,98,37,76,0.487,26,51,0.51,11,25,0.44,11,12,0.917,96,2013-03-10,NOP,POR,2013,101.5
7840,7840,40,@,L 98-108 ,240,40,78,0.513,35,62,0.565,5,16,0.313,13,15,0.867,98,40,80,0.5,35,64,0.547,5,16,0.313,23,31,0.742,108,2013-03-12,NOP,BRK,2013,110.5
7841,7841,41,Home,W 98-81 ,240,35,82,0.427,29,62,0.468,6,20,0.3,22,30,0.733,98,33,78,0.423,28,56,0.5,5,22,0.227,10,14,0.714,81,2013-03-12,MIA,ATL,2013,83.5
7842,7842,42,@,W 98-94 ,240,35,75,0.467,30,55,0.545,5,20,0.25,23,27,0.852,98,40,85,0.471,33,67,0.493,7,18,0.389,7,12,0.583,94,2013-03-13,MIA,PHI,2013,97.5
7843,7843,43,Home,W 98-91 ,240,39,79,0.494,33,66,0.5,6,13,0.462,14,19,0.737,98,34,88,0.386,28,72,0.389,6,16,0.375,17,21,0.81,91,2013-03-16,PHI,IND,2013,94.0
7844,7844,44,Home,W 98-90 ,240,38,79,0.481,30,61,0.492,8,18,0.444,14,17,0.824,98,37,99,0.374,29,80,0.363,8,19,0.421,8,11,0.727,90,2013-03-20,ATL,MIL,2013,94.0
7845,7845,45,@,W 98-95 ,240,32,72,0.444,20,43,0.465,12,29,0.414,22,30,0.733,98,37,81,0.457,30,60,0.5,7,21,0.333,14,17,0.824,95,2013-03-20,MIA,CLE,2013,98.5
7846,7846,46,@,L 98-101 ,240,41,98,0.418,40,79,0.506,1,19,0.053,15,18,0.833,98,40,75,0.533,34,57,0.596,6,18,0.333,15,18,0.833,101,2013-03-21,MIN,SAC,2013,104.0
7847,7847,47,Home,L 98-105 ,240,41,90,0.456,36,66,0.545,5,24,0.208,11,13,0.846,98,41,90,0.456,30,62,0.484,11,28,0.393,12,21,0.571,105,2013-03-27,GSW,SAC,2013,110.5
7848,7848,48,@,L 98-100 ,240,38,80,0.475,26,59,0.441,12,21,0.571,10,18,0.556,98,40,79,0.506,34,61,0.557,6,18,0.333,14,18,0.778,100,2013-03-30,CHI,DAL,2013,103.0
7849,7849,49,@,L 98-125 ,240,33,86,0.384,25,63,0.397,8,23,0.348,24,29,0.828,98,47,87,0.54,38,67,0.567,9,20,0.45,22,27,0.815,125,2013-03-30,POR,GSW,2013,129.5
7850,7850,50,Home,W 98-81 ,240,35,80,0.438,26,56,0.464,9,24,0.375,19,27,0.704,98,31,78,0.397,24,56,0.429,7,22,0.318,12,14,0.857,81,2013-03-30,HOU,LAC,2013,84.5
7851,7851,51,Home,L 98-103 ,240,39,86,0.453,32,62,0.516,7,24,0.292,13,16,0.813,98,38,82,0.463,28,52,0.538,10,30,0.333,17,26,0.654,103,2013-03-30,SAC,LAL,2013,108.0
7852,7852,52,Home,L 98-108 ,240,41,81,0.506,33,60,0.55,8,21,0.381,8,10,0.8,98,43,77,0.558,36,62,0.581,7,15,0.467,15,21,0.714,108,2013-04-01,TOR,DET,2013,111.5
7853,7853,53,Home,W 98-93 ,240,36,71,0.507,29,51,0.569,7,20,0.35,19,22,0.864,98,34,93,0.366,30,69,0.435,4,24,0.167,21,30,0.7,93,2013-04-03,BOS,DET,2013,95.0
7854,7854,54,Home,W 98-88 ,240,36,78,0.462,29,59,0.492,7,19,0.368,19,22,0.864,98,33,83,0.398,29,68,0.426,4,15,0.267,18,23,0.783,88,2013-04-03,GSW,NOH,2013,90.0
7855,7855,55,Home,L 98-107 ,240,42,96,0.438,34,73,0.466,8,23,0.348,6,9,0.667,98,44,84,0.524,36,71,0.507,8,13,0.615,11,16,0.688,107,2013-04-03,MIL,MIN,2013,111.0
7856,7856,56,Home,W 98-84 ,240,40,90,0.444,30,61,0.492,10,29,0.345,8,13,0.615,98,35,90,0.389,29,73,0.397,6,17,0.353,8,9,0.889,84,2013-04-03,SAS,ORL,2013,87.0
7857,7857,57,Home,L 98-116 ,240,38,91,0.418,36,71,0.507,2,20,0.1,20,24,0.833,98,39,76,0.513,27,48,0.563,12,28,0.429,26,35,0.743,116,2013-04-05,POR,HOU,2013,122.0
7858,7858,58,Home,L 98-101 ,240,37,86,0.43,27,69,0.391,10,17,0.588,14,20,0.7,98,37,72,0.514,30,54,0.556,7,18,0.389,20,24,0.833,101,2013-04-09,CHI,TOR,2013,104.5
7859,7859,59,@,L 98-101 ,240,38,86,0.442,31,74,0.419,7,12,0.583,15,19,0.789,98,37,86,0.43,31,56,0.554,6,30,0.2,21,24,0.875,101,2013-04-09,PHO,HOU,2013,104.0
7860,7860,60,Home,L 98-103 ,240,36,80,0.45,25,57,0.439,11,23,0.478,15,21,0.714,98,33,75,0.44,16,34,0.471,17,41,0.415,20,23,0.87,103,2013-04-10,WAS,MIA,2013,111.5
7861,7861,61,@,L 98-105 ,240,39,80,0.488,31,57,0.544,8,23,0.348,12,18,0.667,98,37,73,0.507,29,53,0.547,8,20,0.4,23,30,0.767,105,2013-04-17,CLE,CHA,2013,109.0
7862,7862,62,@,L 98-118 ,240,40,104,0.385,33,79,0.418,7,25,0.28,11,17,0.647,98,49,93,0.527,45,77,0.584,4,16,0.25,16,20,0.8,118,2013-04-17,PHO,DEN,2013,120.0
7863,7863,63,Home,W 98-92 ,240,39,91,0.429,30,67,0.448,9,24,0.375,11,16,0.688,98,37,90,0.411,35,69,0.507,2,21,0.095,16,17,0.941,92,2013-04-17,NYK,ATL,2013,93.0
7864,7864,64,Home,W 98-94 ,240,35,84,0.417,30,69,0.435,5,15,0.333,23,34,0.676,98,33,82,0.402,24,58,0.414,9,24,0.375,19,24,0.792,94,2013-10-30,CLE,BRK,2014,98.5
7865,7865,65,Home,L 98-101 ,240,36,79,0.456,30,57,0.526,6,22,0.273,20,30,0.667,98,33,81,0.407,27,62,0.435,6,19,0.316,29,33,0.879,101,2013-10-30,UTA,OKC,2014,104.0
7866,7866,66,Home,L 98-105 ,240,34,76,0.447,30,60,0.5,4,16,0.25,26,38,0.684,98,35,84,0.417,29,69,0.42,6,15,0.4,29,34,0.853,105,2013-11-01,BOS,MIL,2014,108.0
7867,7867,67,Home,L 98-113 ,240,36,99,0.364,30,81,0.37,6,18,0.333,20,34,0.588,98,44,103,0.427,30,81,0.37,14,22,0.636,11,15,0.733,113,2013-11-01,DEN,POR,2014,120.0
7868,7868,68,Home,W 98-87 ,240,39,76,0.513,28,49,0.571,11,27,0.407,9,12,0.75,98,30,87,0.345,24,61,0.393,6,26,0.231,21,24,0.875,87,2013-11-02,GSW,SAC,2014,90.0
7869,7869,69,Home,L 98-104 ,240,37,85,0.435,27,67,0.403,10,18,0.556,14,19,0.737,98,39,78,0.5,27,53,0.509,12,25,0.48,14,22,0.636,104,2013-11-05,NOP,PHO,2014,110.0
7870,7870,70,Home,W 98-90 ,240,40,82,0.488,35,66,0.53,5,16,0.313,13,17,0.765,98,36,95,0.379,33,76,0.434,3,19,0.158,15,21,0.714,90,2013-11-06,ORL,LAC,2014,91.5
7871,7871,71,Home,L 98-99 ,240,29,77,0.377,22,50,0.44,7,27,0.259,33,52,0.635,98,36,92,0.391,20,57,0.351,16,35,0.457,11,15,0.733,99,2013-11-07,HOU,LAL,2014,107.0
7872,7872,72,Home,L 98-100 (OT),265,34,79,0.43,24,51,0.471,10,28,0.357,20,25,0.8,98,38,87,0.437,36,75,0.48,2,12,0.167,22,29,0.759,100,2013-11-15,PHO,BRK,2014,101.0
7873,7873,73,@,L 98-135 ,240,35,83,0.422,29,64,0.453,6,19,0.316,22,31,0.71,98,52,86,0.605,39,58,0.672,13,28,0.464,18,27,0.667,135,2013-11-16,PHI,NOP,2014,141.5
7874,7874,74,Home,L 98-108 ,240,31,85,0.365,28,72,0.389,3,13,0.231,33,35,0.943,98,41,76,0.539,33,58,0.569,8,18,0.444,18,21,0.857,108,2013-11-18,BRK,POR,2014,112.0
7875,7875,75,@,W 98-87 ,240,32,79,0.405,20,57,0.351,12,22,0.545,22,30,0.733,98,32,81,0.395,25,66,0.379,7,15,0.467,16,19,0.842,87,2013-11-18,GSW,UTA,2014,90.5
7876,7876,76,@,W 98-91 ,240,38,84,0.452,30,65,0.462,8,19,0.421,14,14,1.0,98,32,77,0.416,23,54,0.426,9,23,0.391,18,21,0.857,91,2013-11-20,WAS,CLE,2014,95.5
7877,7877,77,Home,L 98-102 ,240,34,90,0.378,29,68,0.426,5,22,0.227,25,31,0.806,98,40,81,0.494,28,57,0.491,12,24,0.5,10,16,0.625,102,2013-11-20,MIN,LAC,2014,108.0
7878,7878,78,@,L 98-105 ,240,37,83,0.446,29,59,0.492,8,24,0.333,16,20,0.8,98,40,79,0.506,35,64,0.547,5,15,0.333,20,33,0.606,105,2013-11-20,UTA,NOP,2014,107.5
7879,7879,79,Home,L 98-108 ,240,34,76,0.447,27,56,0.482,7,20,0.35,23,31,0.742,98,36,86,0.419,22,57,0.386,14,29,0.483,22,28,0.786,108,2013-11-20,PHI,TOR,2014,115.0
7880,7880,80,@,W 98-91 ,240,33,70,0.471,23,47,0.489,10,23,0.435,22,38,0.579,98,32,77,0.416,29,63,0.46,3,14,0.214,24,33,0.727,91,2013-11-22,PHO,CHA,2014,92.5
7881,7881,81,Home,W 98-95 ,240,36,88,0.409,24,62,0.387,12,26,0.462,14,15,0.933,98,32,83,0.386,27,69,0.391,5,14,0.357,26,29,0.897,95,2013-11-22,POR,CHI,2014,97.5
7882,7882,82,@,L 98-106 ,240,35,102,0.343,31,77,0.403,4,25,0.16,24,32,0.75,98,35,76,0.461,30,58,0.517,5,18,0.278,31,38,0.816,106,2013-11-23,PHI,IND,2014,108.5
7883,7883,83,Home,W 98-89 ,240,37,76,0.487,30,57,0.526,7,19,0.368,17,22,0.773,98,36,82,0.439,25,53,0.472,11,29,0.379,6,15,0.4,89,2013-11-23,WAS,NYK,2014,94.5
7884,7884,84,Home,W 98-84 ,240,40,80,0.5,32,65,0.492,8,15,0.533,10,17,0.588,98,29,88,0.33,26,69,0.377,3,19,0.158,23,28,0.821,84,2013-11-25,IND,MIN,2014,85.5
7885,7885,85,Home,L 98-104 (OT),265,42,91,0.462,36,68,0.529,6,23,0.261,8,10,0.8,98,37,83,0.446,31,63,0.492,6,20,0.3,24,37,0.649,104,2013-11-29,SAC,LAC,2014,107.0
7886,7886,86,@,L 98-99 ,240,35,76,0.461,31,61,0.508,4,15,0.267,24,28,0.857,98,36,69,0.522,28,51,0.549,8,18,0.444,19,25,0.76,99,2013-12-01,CHA,MIA,2014,103.0
7887,7887,87,Home,L 98-112 ,240,35,87,0.402,27,65,0.415,8,22,0.364,20,26,0.769,98,44,87,0.506,34,64,0.531,10,23,0.435,14,19,0.737,112,2013-12-01,TOR,DEN,2014,117.0
7888,7888,88,Home,W 98-80 ,240,33,73,0.452,24,60,0.4,9,13,0.692,23,29,0.793,98,30,77,0.39,27,62,0.435,3,15,0.2,17,19,0.895,80,2013-12-02,WAS,ORL,2014,81.5
7889,7889,89,Home,W 98-88 ,240,37,91,0.407,32,77,0.416,5,14,0.357,19,24,0.792,98,36,92,0.391,30,69,0.435,6,23,0.261,10,13,0.769,88,2013-12-04,CLE,DEN,2014,91.0
7890,7890,90,Home,L 98-105 ,240,36,91,0.396,27,64,0.422,9,27,0.333,17,22,0.773,98,33,86,0.384,26,65,0.4,7,21,0.333,32,42,0.762,105,2013-12-04,MIL,DET,2014,108.5
7891,7891,91,@,L 98-106 ,240,34,77,0.442,28,60,0.467,6,17,0.353,24,29,0.828,98,43,83,0.518,37,63,0.587,6,20,0.3,14,18,0.778,106,2013-12-06,DEN,BOS,2014,109.0
7892,7892,92,@,L 98-130 ,240,39,93,0.419,35,82,0.427,4,11,0.364,16,19,0.842,98,46,83,0.554,29,60,0.483,17,23,0.739,21,24,0.875,130,2013-12-06,UTA,POR,2014,138.5
7893,7893,93,Home,W 98-88 ,240,32,76,0.421,22,43,0.512,10,33,0.303,24,42,0.571,98,32,93,0.344,24,64,0.375,8,29,0.276,16,28,0.571,88,2013-12-08,HOU,ORL,2014,92.0
7894,7894,94,@,L 98-104 ,240,40,80,0.5,34,65,0.523,6,15,0.4,12,17,0.706,98,39,76,0.513,30,54,0.556,9,22,0.409,17,20,0.85,104,2013-12-13,MEM,NOP,2014,108.5
7895,7895,95,@,L 98-101 ,240,37,82,0.451,30,58,0.517,7,24,0.292,17,26,0.654,98,39,87,0.448,34,68,0.5,5,19,0.263,18,20,0.9,101,2013-12-15,ORL,OKC,2014,103.5
7896,7896,96,Home,L 98-104 ,240,28,76,0.368,21,53,0.396,7,23,0.304,35,36,0.972,98,36,91,0.396,28,71,0.394,8,20,0.4,24,29,0.828,104,2013-12-22,OKC,TOR,2014,108.0
7897,7897,97,Home,L 98-103 ,240,37,89,0.416,29,64,0.453,8,25,0.32,16,22,0.727,98,39,86,0.453,29,65,0.446,10,21,0.476,15,19,0.789,103,2013-12-23,ORL,NYK,2014,108.0
7898,7898,98,Home,L 98-111 ,240,37,91,0.407,32,71,0.451,5,20,0.25,19,23,0.826,98,45,86,0.523,33,62,0.532,12,24,0.5,9,18,0.5,111,2013-12-25,SAS,HOU,2014,117.0
7899,7899,99,@,L 98-120 ,240,38,83,0.458,30,62,0.484,8,21,0.381,14,17,0.824,98,42,85,0.494,37,70,0.529,5,15,0.333,31,38,0.816,120,2013-12-27,WAS,MIN,2014,122.5
7900,7900,0,@,L 98-107 ,240,41,93,0.441,31,71,0.437,10,22,0.455,6,8,0.75,98,38,77,0.494,32,51,0.627,6,26,0.231,25,32,0.781,107,2013-12-28,NOP,HOU,2014,110.0
7901,7901,1,Home,W 98-90 ,240,35,77,0.455,32,63,0.508,3,14,0.214,25,32,0.781,98,32,76,0.421,25,57,0.439,7,19,0.368,19,21,0.905,90,2013-12-28,LAC,UTA,2014,93.5
7902,7902,2,Home,L 98-100 ,240,36,79,0.456,30,56,0.536,6,23,0.261,20,23,0.87,98,41,86,0.477,35,62,0.565,6,24,0.25,12,14,0.857,100,2013-12-30,MIN,DAL,2014,103.0
7903,7903,3,@,W 98-94 ,240,36,91,0.396,28,58,0.483,8,33,0.242,18,21,0.857,98,36,82,0.439,33,68,0.485,3,14,0.214,19,26,0.731,94,2013-12-31,POR,OKC,2014,95.5
7904,7904,4,@,L 98-129 ,240,35,91,0.385,31,73,0.425,4,18,0.222,24,32,0.75,98,43,83,0.518,29,52,0.558,14,31,0.452,29,38,0.763,129,2014-01-07,BOS,DEN,2014,136.0
7905,7905,5,@,L 98-102 ,240,36,78,0.462,27,52,0.519,9,26,0.346,17,23,0.739,98,34,77,0.442,29,58,0.5,5,19,0.263,29,35,0.829,102,2014-01-08,GSW,BRK,2014,104.5
7906,7906,6,Home,W 98-96 (OT),265,35,81,0.432,28,61,0.459,7,20,0.35,21,27,0.778,98,33,93,0.355,26,63,0.413,7,30,0.233,23,28,0.821,96,2014-01-13,NYK,PHO,2014,99.5
7907,7907,7,@,L 98-108 ,240,39,81,0.481,33,64,0.516,6,17,0.353,14,18,0.778,98,38,75,0.507,32,61,0.525,6,14,0.429,26,33,0.788,108,2014-01-14,NYK,CHA,2014,111.0
7908,7908,8,Home,W 98-72 ,240,36,83,0.434,30,66,0.455,6,17,0.353,20,34,0.588,98,21,73,0.288,14,48,0.292,7,25,0.28,23,29,0.793,72,2014-01-18,MIN,UTA,2014,75.5
7909,7909,9,Home,L 98-104 ,240,37,76,0.487,29,55,0.527,8,21,0.381,16,29,0.552,98,40,81,0.494,34,60,0.567,6,21,0.286,18,31,0.581,104,2014-01-18,WAS,DET,2014,107.0
7910,7910,10,@,W 98-87 ,240,37,70,0.529,27,49,0.551,10,21,0.476,14,18,0.778,98,33,88,0.375,25,69,0.362,8,19,0.421,13,18,0.722,87,2014-01-22,CHI,CLE,2014,91.0
7911,7911,11,@,L 98-119 ,240,34,86,0.395,22,56,0.393,12,30,0.4,18,30,0.6,98,43,90,0.478,35,59,0.593,8,31,0.258,25,40,0.625,119,2014-01-22,SAC,HOU,2014,123.0
7912,7912,12,@,W 98-81 ,240,43,83,0.518,37,70,0.529,6,13,0.462,6,10,0.6,98,30,87,0.345,26,63,0.413,4,24,0.167,17,22,0.773,81,2014-01-28,MEM,POR,2014,83.0
7913,7913,13,Home,L 98-101 ,240,39,100,0.39,30,72,0.417,9,28,0.321,11,13,0.846,98,33,78,0.423,28,64,0.438,5,14,0.357,30,42,0.714,101,2014-01-29,DEN,CHA,2014,103.5
7914,7914,14,Home,W 98-83 ,240,37,87,0.425,23,56,0.411,14,31,0.452,10,13,0.769,98,28,84,0.333,22,65,0.338,6,19,0.316,21,26,0.808,83,2014-01-29,TOR,ORL,2014,86.0
7915,7915,15,Home,W 98-79 ,240,38,90,0.422,30,65,0.462,8,25,0.32,14,17,0.824,98,33,83,0.398,26,67,0.388,7,16,0.438,6,10,0.6,79,2014-02-03,IND,ORL,2014,82.5
7916,7916,16,@,L 98-101 ,240,34,78,0.436,19,44,0.432,15,34,0.441,15,24,0.625,98,36,81,0.444,25,63,0.397,11,18,0.611,18,21,0.857,101,2014-02-03,NYK,MIL,2014,106.5
7917,7917,17,@,L 98-112 ,240,39,85,0.459,33,65,0.508,6,20,0.3,14,23,0.609,98,44,89,0.494,38,71,0.535,6,18,0.333,18,20,0.9,112,2014-02-05,DET,ORL,2014,115.0
7918,7918,18,Home,W 98-91 ,240,39,81,0.481,31,66,0.47,8,15,0.533,12,16,0.75,98,28,75,0.373,24,57,0.421,4,18,0.222,31,37,0.838,91,2014-02-07,NOP,MIN,2014,93.0
7919,7919,19,Home,L 98-112 ,240,37,87,0.425,22,55,0.4,15,32,0.469,9,17,0.529,98,45,89,0.506,37,71,0.521,8,18,0.444,14,20,0.7,112,2014-02-07,PHI,LAL,2014,116.0
7920,7920,20,@,W 98-95 ,240,40,83,0.482,33,69,0.478,7,14,0.5,11,12,0.917,98,32,85,0.376,25,62,0.403,7,23,0.304,24,27,0.889,95,2014-02-11,OKC,POR,2014,98.5
7921,7921,21,Home,L 98-102 ,240,39,80,0.488,33,64,0.516,6,16,0.375,14,19,0.737,98,41,79,0.519,35,66,0.53,6,13,0.462,14,17,0.824,102,2014-02-12,MIL,NOP,2014,105.0
7922,7922,22,@,L 98-108 ,240,37,77,0.481,25,51,0.49,12,26,0.462,12,19,0.632,98,39,79,0.494,30,56,0.536,9,23,0.391,21,26,0.808,108,2014-02-18,ATL,IND,2014,112.5
7923,7923,23,Home,W 98-93 ,240,37,75,0.493,31,63,0.492,6,12,0.5,18,24,0.75,98,35,85,0.412,29,58,0.5,6,27,0.222,17,20,0.85,93,2014-02-18,MEM,NYK,2014,96.0
7924,7924,24,@,L 98-116 ,240,38,90,0.422,30,72,0.417,8,18,0.444,14,20,0.7,98,42,82,0.512,34,62,0.548,8,20,0.4,24,31,0.774,116,2014-02-19,DET,CHA,2014,120.0
7925,7925,25,@,W 98-91 ,240,37,83,0.446,27,62,0.435,10,21,0.476,14,20,0.7,98,35,75,0.467,28,54,0.519,7,21,0.333,14,21,0.667,91,2014-02-19,NYK,NOP,2014,94.5
7926,7926,26,Home,W 98-91 ,240,40,93,0.43,33,72,0.458,7,21,0.333,11,13,0.846,98,32,82,0.39,26,62,0.419,6,20,0.3,21,29,0.724,91,2014-02-21,TOR,CLE,2014,94.0
7927,7927,27,@,L 98-107 ,240,39,89,0.438,29,61,0.475,10,28,0.357,10,16,0.625,98,32,74,0.432,16,43,0.372,16,31,0.516,27,33,0.818,107,2014-02-22,NYK,ATL,2014,115.0
7928,7928,28,@,L 98-105 ,240,34,87,0.391,28,66,0.424,6,21,0.286,24,36,0.667,98,38,73,0.521,33,64,0.516,5,9,0.556,24,28,0.857,105,2014-02-22,BOS,SAC,2014,107.5
7929,7929,29,@,L 98-110 ,240,37,84,0.44,33,69,0.478,4,15,0.267,20,21,0.952,98,44,80,0.55,38,63,0.603,6,17,0.353,16,21,0.762,110,2014-02-24,BOS,UTA,2014,113.0
7930,7930,30,@,L 98-118 ,240,39,90,0.433,31,67,0.463,8,23,0.348,12,20,0.6,98,47,101,0.465,42,85,0.494,5,16,0.313,19,25,0.76,118,2014-02-25,LAL,IND,2014,120.5
7931,7931,31,@,L 98-112 ,240,36,83,0.434,32,65,0.492,4,18,0.222,22,29,0.759,98,43,74,0.581,37,58,0.638,6,16,0.375,20,24,0.833,112,2014-03-01,ORL,MIA,2014,115.0
7932,7932,32,Home,L 98-107 ,240,34,74,0.459,29,62,0.468,5,12,0.417,25,31,0.806,98,37,83,0.446,27,58,0.466,10,25,0.4,23,31,0.742,107,2014-03-01,MIL,BRK,2014,112.0
7933,7933,33,@,L 98-104 ,240,37,88,0.42,29,65,0.446,8,23,0.348,16,20,0.8,98,38,79,0.481,30,57,0.526,8,22,0.364,20,23,0.87,104,2014-03-02,GSW,TOR,2014,108.0
7934,7934,34,@,W 98-96 ,240,37,84,0.44,27,64,0.422,10,20,0.5,14,21,0.667,98,36,86,0.419,33,70,0.471,3,16,0.188,21,22,0.955,96,2014-03-04,GSW,IND,2014,97.5
7935,7935,35,@,L 98-103 ,240,38,83,0.458,31,57,0.544,7,26,0.269,15,21,0.714,98,37,79,0.468,33,66,0.5,4,13,0.308,25,34,0.735,103,2014-03-07,POR,DAL,2014,105.0
7936,7936,36,@,L 98-105 ,240,36,83,0.434,31,59,0.525,5,24,0.208,21,31,0.677,98,37,81,0.457,29,61,0.475,8,20,0.4,23,28,0.821,105,2014-03-10,DEN,CHA,2014,109.0
7937,7937,37,@,L 98-105 ,240,42,88,0.477,33,65,0.508,9,23,0.391,5,8,0.625,98,38,84,0.452,30,57,0.526,8,27,0.296,21,25,0.84,105,2014-03-10,ORL,MIL,2014,109.0
7938,7938,38,@,L 98-106 ,240,33,79,0.418,24,54,0.444,9,25,0.36,23,34,0.676,98,34,80,0.425,23,51,0.451,11,29,0.379,27,34,0.794,106,2014-03-11,HOU,OKC,2014,111.5
7939,7939,39,@,L 98-111 ,240,36,82,0.439,28,61,0.459,8,21,0.381,18,25,0.72,98,43,88,0.489,35,70,0.5,8,18,0.444,17,24,0.708,111,2014-03-12,GSW,LAC,2014,115.0
7940,7940,40,Home,L 98-115 ,240,33,84,0.393,25,61,0.41,8,23,0.348,24,28,0.857,98,34,74,0.459,27,56,0.482,7,18,0.389,40,50,0.8,115,2014-03-12,PHI,SAC,2014,118.5
7941,7941,41,@,W 98-85 ,240,38,78,0.487,33,60,0.55,5,18,0.278,17,22,0.773,98,35,82,0.427,26,57,0.456,9,25,0.36,6,9,0.667,85,2014-03-12,CHA,WAS,2014,89.5
7942,7942,42,@,L 98-114 ,240,35,83,0.422,26,56,0.464,9,27,0.333,19,23,0.826,98,44,78,0.564,35,61,0.574,9,17,0.529,17,24,0.708,114,2014-03-21,BOS,BRK,2014,118.5
7943,7943,43,Home,W 98-92 ,240,33,73,0.452,25,48,0.521,8,25,0.32,24,35,0.686,98,39,90,0.433,35,74,0.473,4,16,0.25,10,26,0.385,92,2014-03-21,PHO,DET,2014,94.0
7944,7944,44,@,L 98-106 ,240,41,85,0.482,36,72,0.5,5,13,0.385,11,16,0.688,98,38,78,0.487,30,60,0.5,8,18,0.444,22,27,0.815,106,2014-03-24,MIL,LAC,2014,110.0
7945,7945,45,Home,W 98-96 ,240,38,90,0.422,35,78,0.449,3,12,0.25,19,25,0.76,98,33,80,0.413,20,50,0.4,13,30,0.433,17,28,0.607,96,2014-03-26,NOP,LAC,2014,102.5
7946,7946,46,@,L 98-120 ,240,35,90,0.389,21,54,0.389,14,36,0.389,14,22,0.636,98,44,90,0.489,35,64,0.547,9,26,0.346,23,34,0.676,120,2014-03-27,PHI,HOU,2014,124.5
7947,7947,47,@,L 98-123 ,240,33,85,0.388,27,64,0.422,6,21,0.286,26,32,0.813,98,48,92,0.522,36,71,0.507,12,21,0.571,15,19,0.789,123,2014-03-29,DET,PHI,2014,129.0
7948,7948,48,@,W 98-93 ,240,33,73,0.452,27,54,0.5,6,19,0.316,26,27,0.963,98,38,69,0.551,31,50,0.62,7,19,0.368,10,14,0.714,93,2014-03-30,TOR,ORL,2014,96.5
7949,7949,49,@,L 98-105 ,240,41,89,0.461,36,72,0.5,5,17,0.294,11,18,0.611,98,39,75,0.52,34,60,0.567,5,15,0.333,22,25,0.88,105,2014-03-30,MEM,POR,2014,107.5
7950,7950,50,Home,L 98-119 ,240,35,79,0.443,24,51,0.471,11,28,0.393,17,20,0.85,98,45,78,0.577,36,60,0.6,9,18,0.5,20,24,0.833,119,2014-04-02,ORL,CLE,2014,123.5
7951,7951,51,@,L 98-117 ,240,36,91,0.396,31,70,0.443,5,21,0.238,21,25,0.84,98,48,82,0.585,35,53,0.66,13,29,0.448,8,10,0.8,117,2014-04-04,CLE,ATL,2014,123.5
7952,7952,52,Home,L 98-102 ,240,38,79,0.481,37,70,0.529,1,9,0.111,21,27,0.778,98,36,81,0.444,24,54,0.444,12,27,0.444,18,22,0.818,102,2014-04-05,MIL,TOR,2014,108.0
7953,7953,53,@,L 98-106 ,240,40,86,0.465,35,69,0.507,5,17,0.294,13,23,0.565,98,40,81,0.494,35,62,0.565,5,19,0.263,21,23,0.913,106,2014-04-11,DET,CHI,2014,108.5
7954,7954,54,Home,W 98-86 ,240,35,75,0.467,29,59,0.492,6,16,0.375,22,28,0.786,98,31,65,0.477,23,51,0.451,8,14,0.571,16,19,0.842,86,2014-04-11,MIA,IND,2014,90.0
7955,7955,55,Home,W 98-85 ,240,36,78,0.462,26,56,0.464,10,22,0.455,16,19,0.842,98,35,73,0.479,29,48,0.604,6,25,0.24,9,19,0.474,85,2014-04-12,ATL,MIA,2014,88.0
7956,7956,56,@,L 98-101 ,240,36,78,0.462,28,61,0.459,8,17,0.471,18,23,0.783,98,39,79,0.494,28,55,0.509,11,24,0.458,12,15,0.8,101,2014-04-12,PHO,DAL,2014,106.5
7957,7957,57,@,L 98-104 ,240,39,89,0.438,35,72,0.486,4,17,0.235,16,18,0.889,98,38,85,0.447,34,63,0.54,4,22,0.182,24,29,0.828,104,2014-04-14,SAS,HOU,2014,106.0
7958,7958,58,Home,L 98-109 ,240,33,75,0.44,23,50,0.46,10,25,0.4,22,31,0.71,98,32,67,0.478,21,46,0.457,11,21,0.524,34,40,0.85,109,2014-04-15,BRK,NYK,2014,114.5
7959,7959,59,Home,L 98-105 ,240,37,72,0.514,31,57,0.544,6,15,0.4,18,24,0.75,98,39,80,0.488,32,67,0.478,7,13,0.538,20,26,0.769,105,2014-10-30,ORL,WAS,2015,108.5
7960,7960,60,@,W 98-92 ,240,34,68,0.5,31,58,0.534,3,10,0.3,27,33,0.818,98,33,88,0.375,24,57,0.421,9,31,0.29,17,21,0.81,92,2014-11-02,SAC,LAC,2015,96.5
7961,7961,61,Home,W 98-90 ,240,35,75,0.467,28,60,0.467,7,15,0.467,21,27,0.778,98,38,88,0.432,32,74,0.432,6,14,0.429,8,14,0.571,90,2014-11-04,CHI,ORL,2015,93.0
7962,7962,62,@,W 98-83 ,240,39,80,0.488,31,62,0.5,8,18,0.444,12,19,0.632,98,30,81,0.37,22,66,0.333,8,15,0.533,15,19,0.789,83,2014-11-04,WAS,NYK,2015,87.0
7963,7963,63,@,W 98-91 ,240,37,90,0.411,30,73,0.411,7,17,0.412,17,22,0.773,98,36,82,0.439,28,61,0.459,8,21,0.381,11,17,0.647,91,2014-11-05,MIN,BRK,2015,95.0
7964,7964,64,Home,W 98-95 ,240,32,87,0.368,21,64,0.328,11,23,0.478,23,33,0.697,98,39,90,0.433,30,70,0.429,9,20,0.45,8,10,0.8,95,2014-11-05,DET,NYK,2015,99.5
7965,7965,65,Home,W 98-81 ,240,34,72,0.472,24,45,0.533,10,27,0.37,20,33,0.606,98,31,90,0.344,29,70,0.414,2,20,0.1,17,19,0.895,81,2014-11-06,HOU,SAS,2015,82.0
7966,7966,66,@,L 98-101 ,240,40,88,0.455,35,69,0.507,5,19,0.263,13,13,1.0,98,39,85,0.459,30,58,0.517,9,27,0.333,14,16,0.875,101,2014-11-07,IND,BOS,2015,105.5
7967,7967,67,Home,W 98-95 ,240,37,75,0.493,26,52,0.5,11,23,0.478,13,24,0.542,98,36,77,0.468,31,57,0.544,5,20,0.25,18,23,0.783,95,2014-11-07,DET,MIL,2015,97.5
7968,7968,68,@,W 98-87 ,240,39,87,0.448,30,59,0.508,9,28,0.321,11,17,0.647,98,30,86,0.349,20,44,0.455,10,42,0.238,17,21,0.81,87,2014-11-08,GSW,HOU,2015,92.0
7969,7969,69,@,L 98-106 ,240,32,72,0.444,23,53,0.434,9,19,0.474,25,32,0.781,98,38,80,0.475,28,53,0.528,10,27,0.37,20,24,0.833,106,2014-11-11,SAC,DAL,2015,111.0
7970,7970,70,Home,W 98-93 ,240,42,84,0.5,39,74,0.527,3,10,0.3,11,16,0.688,98,37,78,0.474,30,61,0.492,7,17,0.412,12,18,0.667,93,2014-11-15,WAS,ORL,2015,96.5
7971,7971,71,Home,W 98-81 ,240,35,81,0.432,25,57,0.439,10,24,0.417,18,26,0.692,98,30,84,0.357,22,61,0.361,8,23,0.348,13,19,0.684,81,2014-11-18,UTA,OKC,2015,85.0
7972,7972,72,@,W 98-92 ,240,37,91,0.407,32,71,0.451,5,20,0.25,19,23,0.826,98,30,74,0.405,15,36,0.417,15,38,0.395,17,23,0.739,92,2014-11-19,LAL,HOU,2015,99.5
7973,7973,73,Home,W 98-86 ,240,39,90,0.433,29,68,0.426,10,22,0.455,10,13,0.769,98,36,78,0.462,29,58,0.5,7,20,0.35,7,17,0.412,86,2014-11-25,MIL,DET,2015,89.5
7974,7974,74,Home,L 98-104 ,240,35,78,0.449,25,51,0.49,10,27,0.37,18,24,0.75,98,37,78,0.474,25,50,0.5,12,28,0.429,18,19,0.947,104,2014-11-26,DET,LAC,2015,110.0
7975,7975,75,Home,W 98-83 ,240,41,94,0.436,37,78,0.474,4,16,0.25,12,14,0.857,98,31,70,0.443,24,52,0.462,7,18,0.389,14,16,0.875,83,2014-11-28,IND,ORL,2015,86.5
7976,7976,76,Home,W 98-97 ,240,38,82,0.463,30,55,0.545,8,27,0.296,14,18,0.778,98,39,87,0.448,33,70,0.471,6,17,0.353,13,14,0.929,97,2014-12-02,GSW,ORL,2015,100.0
7977,7977,77,@,W 98-93 ,240,39,89,0.438,33,72,0.458,6,17,0.353,14,20,0.7,98,35,81,0.432,24,53,0.453,11,28,0.393,12,14,0.857,93,2014-12-02,BRK,NYK,2015,98.5
7978,7978,78,@,W 98-75 ,240,35,81,0.432,22,47,0.468,13,34,0.382,15,24,0.625,98,30,80,0.375,27,62,0.435,3,18,0.167,12,19,0.632,75,2014-12-05,ATL,BRK,2015,76.5
7979,7979,79,@,W 98-93 ,240,37,74,0.5,30,57,0.526,7,17,0.412,17,20,0.85,98,36,79,0.456,28,63,0.444,8,16,0.5,13,21,0.619,93,2014-12-05,ORL,UTA,2015,97.0
7980,7980,80,@,W 98-86 ,240,41,84,0.488,32,63,0.508,9,21,0.429,7,8,0.875,98,34,97,0.351,29,75,0.387,5,22,0.227,13,16,0.813,86,2014-12-09,POR,DET,2015,88.5
7981,7981,81,Home,W 98-95 ,240,38,96,0.396,33,71,0.465,5,25,0.2,17,25,0.68,98,32,70,0.457,25,55,0.455,7,15,0.467,24,37,0.649,95,2014-12-09,LAL,SAC,2015,98.5
7982,7982,82,Home,L 98-105 ,240,36,89,0.404,31,64,0.484,5,25,0.2,21,30,0.7,98,37,83,0.446,27,51,0.529,10,32,0.313,21,27,0.778,105,2014-12-13,DAL,GSW,2015,110.0
7983,7983,83,@,L 98-105 ,240,39,95,0.411,30,64,0.469,9,31,0.29,11,12,0.917,98,42,92,0.457,37,78,0.474,5,14,0.357,16,19,0.842,105,2014-12-16,GSW,MEM,2015,107.5
7984,7984,84,Home,L 98-127 ,240,37,82,0.451,29,52,0.558,8,30,0.267,16,21,0.762,98,49,76,0.645,33,48,0.688,16,28,0.571,13,16,0.813,127,2014-12-17,CLE,ATL,2015,135.0
7985,7985,85,@,L 98-114 ,240,42,93,0.452,36,81,0.444,6,12,0.5,8,16,0.5,98,48,85,0.565,40,62,0.645,8,23,0.348,10,14,0.714,114,2014-12-19,MIN,BOS,2015,118.0
7986,7986,86,@,L 98-102 ,240,36,99,0.364,25,70,0.357,11,29,0.379,15,20,0.75,98,42,83,0.506,37,65,0.569,5,18,0.278,13,24,0.542,102,2014-12-26,LAL,DAL,2015,104.5
7987,7987,87,Home,W 98-75 ,240,36,88,0.409,28,61,0.459,8,27,0.296,18,21,0.857,98,25,87,0.287,20,63,0.317,5,24,0.208,20,26,0.769,75,2014-12-26,OKC,CHO,2015,77.5
7988,7988,88,@,W 98-89 ,240,33,80,0.413,25,50,0.5,8,30,0.267,24,26,0.923,98,36,73,0.493,27,52,0.519,9,21,0.429,8,12,0.667,89,2014-12-26,CLE,ORL,2015,93.5
7989,7989,89,Home,L 98-110 ,240,37,81,0.457,25,56,0.446,12,25,0.48,12,15,0.8,98,41,86,0.477,28,52,0.538,13,34,0.382,15,19,0.789,110,2014-12-27,LAC,TOR,2015,116.5
7990,7990,90,Home,L 98-100 ,240,37,88,0.42,26,66,0.394,11,22,0.5,13,20,0.65,98,41,72,0.569,34,52,0.654,7,20,0.35,11,18,0.611,100,2015-01-02,ORL,BRK,2015,103.5
7991,7991,91,@,W 98-92 ,240,33,81,0.407,27,58,0.466,6,23,0.261,26,30,0.867,98,32,86,0.372,22,55,0.4,10,31,0.323,18,24,0.75,92,2015-01-02,ATL,UTA,2015,97.0
7992,7992,92,@,W 98-90 ,240,35,78,0.449,31,62,0.5,4,16,0.25,24,32,0.75,98,33,87,0.379,29,68,0.426,4,19,0.211,20,21,0.952,90,2015-01-03,CHA,ORL,2015,92.0
7993,7993,93,Home,L 98-107 ,240,33,74,0.446,26,49,0.531,7,25,0.28,25,33,0.758,98,36,81,0.444,23,54,0.426,13,27,0.481,22,33,0.667,107,2015-01-05,LAC,ATL,2015,113.5
7994,7994,94,Home,W 98-94 ,240,33,83,0.398,22,57,0.386,11,26,0.423,21,24,0.875,98,37,88,0.42,33,74,0.446,4,14,0.286,16,20,0.8,94,2015-01-05,POR,LAL,2015,96.0
7995,7995,95,Home,W 98-94 ,240,37,86,0.43,33,72,0.458,4,14,0.286,20,26,0.769,98,36,80,0.45,30,62,0.484,6,18,0.333,16,24,0.667,94,2015-01-07,CHA,NOP,2015,97.0
7996,7996,96,Home,W 98-84 ,240,39,75,0.52,27,56,0.482,12,19,0.632,8,10,0.8,98,32,79,0.405,26,57,0.456,6,22,0.273,14,17,0.824,84,2015-01-09,MIL,MIN,2015,87.0
7997,7997,97,Home,W 98-93 ,240,34,80,0.425,23,47,0.489,11,33,0.333,19,26,0.731,98,37,88,0.42,28,57,0.491,9,31,0.29,10,10,1.0,93,2015-01-10,DET,BRK,2015,97.5
7998,7998,98,@,W 98-93 ,240,37,85,0.435,29,64,0.453,8,21,0.381,16,20,0.8,98,33,86,0.384,29,73,0.397,4,13,0.308,23,35,0.657,93,2015-01-14,SAS,CHO,2015,95.0
7999,7999,99,@,W 98-96 ,240,32,85,0.376,19,54,0.352,13,31,0.419,21,24,0.875,98,40,89,0.449,34,71,0.479,6,18,0.333,10,12,0.833,96,2015-01-16,DET,IND,2015,99.0
8000,8000,0,@,L 98-102 ,240,36,93,0.387,23,57,0.404,13,36,0.361,13,15,0.867,98,39,77,0.506,31,62,0.5,8,15,0.533,16,24,0.667,102,2015-01-17,POR,MEM,2015,106.0
8001,8001,1,@,L 98-110 ,240,39,85,0.459,33,58,0.569,6,27,0.222,14,18,0.778,98,37,72,0.514,25,41,0.61,12,31,0.387,24,33,0.727,110,2015-01-19,IND,HOU,2015,116.0
8002,8002,2,Home,W 98-94 ,240,35,88,0.398,24,52,0.462,11,36,0.306,17,26,0.654,98,34,76,0.447,30,64,0.469,4,12,0.333,22,30,0.733,94,2015-01-19,POR,SAC,2015,96.0
8003,8003,3,@,W 98-75 ,240,39,76,0.513,28,49,0.571,11,27,0.407,9,14,0.643,98,31,89,0.348,29,74,0.392,2,15,0.133,11,15,0.733,75,2015-01-21,DAL,MIN,2015,76.0
8004,8004,4,@,W 98-91 ,240,37,91,0.407,30,71,0.423,7,20,0.35,17,20,0.85,98,29,79,0.367,21,56,0.375,8,23,0.348,25,32,0.781,91,2015-01-21,NYK,PHI,2015,95.0
8005,8005,5,Home,L 98-102 ,240,37,82,0.451,31,64,0.484,6,18,0.333,18,18,1.0,98,38,78,0.487,29,62,0.468,9,16,0.563,17,20,0.85,102,2015-01-23,DAL,CHI,2015,106.5
8006,8006,6,@,L 98-108 ,240,37,94,0.394,27,64,0.422,10,30,0.333,14,18,0.778,98,36,82,0.439,20,46,0.435,16,36,0.444,20,29,0.69,108,2015-01-25,OKC,CLE,2015,116.0
8007,8007,7,@,L 98-102 ,240,40,83,0.482,32,62,0.516,8,21,0.381,10,15,0.667,98,38,80,0.475,31,61,0.508,7,19,0.368,19,22,0.864,102,2015-01-26,DEN,LAC,2015,105.5
8008,8008,8,@,W 98-92 ,240,38,78,0.487,34,62,0.548,4,16,0.25,18,27,0.667,98,37,87,0.425,32,67,0.478,5,20,0.25,13,16,0.813,92,2015-01-27,WAS,LAL,2015,94.5
8009,8009,9,@,L 98-110 ,240,42,91,0.462,35,68,0.515,7,23,0.304,7,9,0.778,98,38,77,0.494,32,61,0.525,6,16,0.375,28,32,0.875,110,2015-01-28,BOS,MIN,2015,113.0
8010,8010,10,@,L 98-106 ,240,37,88,0.42,29,70,0.414,8,18,0.444,16,23,0.696,98,40,88,0.455,29,59,0.492,11,29,0.379,15,18,0.833,106,2015-01-28,WAS,PHO,2015,111.5
8011,8011,11,@,L 98-105 ,240,33,85,0.388,21,54,0.389,12,31,0.387,20,28,0.714,98,31,70,0.443,20,43,0.465,11,27,0.407,32,42,0.762,105,2015-02-03,DEN,PHI,2015,110.5
8012,8012,12,Home,W 98-88 ,240,37,82,0.451,33,58,0.569,4,24,0.167,20,26,0.769,98,33,85,0.388,28,63,0.444,5,22,0.227,17,22,0.773,88,2015-02-06,DET,DEN,2015,90.5
8013,8013,13,Home,W 98-85 ,240,40,83,0.482,29,54,0.537,11,29,0.379,7,9,0.778,98,36,80,0.45,31,64,0.484,5,16,0.313,8,9,0.889,85,2015-02-06,SAS,MIA,2015,87.5
8014,8014,14,Home,L 98-109 ,240,31,82,0.378,18,47,0.383,13,35,0.371,23,34,0.676,98,40,76,0.526,31,47,0.66,9,29,0.31,20,23,0.87,109,2015-02-08,HOU,POR,2015,113.5
8015,8015,15,@,W 98-97 ,240,37,77,0.481,29,55,0.527,8,22,0.364,16,18,0.889,98,39,83,0.47,30,58,0.517,9,25,0.36,10,13,0.769,97,2015-02-08,CHI,ORL,2015,101.5
8016,8016,16,Home,L 98-115 ,240,33,81,0.407,23,47,0.489,10,34,0.294,22,30,0.733,98,41,92,0.446,32,65,0.492,9,27,0.333,24,29,0.828,115,2015-02-09,DAL,LAC,2015,119.5
8017,8017,17,@,L 98-113 ,240,37,85,0.435,29,54,0.537,8,31,0.258,16,22,0.727,98,42,92,0.457,33,69,0.478,9,23,0.391,20,26,0.769,113,2015-02-12,CLE,CHI,2015,117.5
8018,8018,18,Home,W 98-76 ,240,35,84,0.417,29,55,0.527,6,29,0.207,22,31,0.71,98,25,77,0.325,21,59,0.356,4,18,0.222,22,28,0.786,76,2015-02-21,HOU,TOR,2015,78.0
8019,8019,19,@,L 98-104 ,240,34,89,0.382,25,63,0.397,9,26,0.346,21,22,0.955,98,39,81,0.481,31,62,0.5,8,19,0.421,18,23,0.783,104,2015-02-22,GSW,IND,2015,108.0
8020,8020,20,@,L 98-103 ,240,36,78,0.462,23,44,0.523,13,34,0.382,13,17,0.765,98,39,82,0.476,33,59,0.559,6,23,0.261,19,26,0.731,103,2015-02-22,PHI,ORL,2015,106.0
8021,8021,21,@,W 98-92 ,240,42,89,0.472,39,80,0.488,3,9,0.333,11,13,0.846,98,33,82,0.402,20,49,0.408,13,33,0.394,13,16,0.813,92,2015-02-22,MEM,POR,2015,98.5
8022,8022,22,@,W 98-86 ,240,39,84,0.464,35,70,0.5,4,14,0.286,16,21,0.762,98,34,77,0.442,31,60,0.517,3,17,0.176,15,23,0.652,86,2015-02-25,CHA,CHI,2015,87.5
8023,8023,23,@,L 98-106 ,240,37,82,0.451,27,61,0.443,10,21,0.476,14,17,0.824,98,40,96,0.417,26,61,0.426,14,35,0.4,12,15,0.8,106,2015-02-27,CHA,BOS,2015,113.0
8024,8024,24,@,L 98-102 ,240,38,85,0.447,34,68,0.5,4,17,0.235,18,20,0.9,98,39,84,0.464,30,52,0.577,9,32,0.281,15,17,0.882,102,2015-02-27,BRK,HOU,2015,106.5
8025,8025,25,@,L 98-103 ,240,34,81,0.42,26,52,0.5,8,29,0.276,22,28,0.786,98,33,75,0.44,26,56,0.464,7,19,0.368,30,38,0.789,103,2015-02-28,TOR,NYK,2015,106.5
8026,8026,26,@,W 98-83 ,240,40,80,0.5,32,62,0.516,8,18,0.444,10,14,0.714,98,31,85,0.365,25,70,0.357,6,15,0.4,15,20,0.75,83,2015-03-01,CHA,ORL,2015,86.0
8027,8027,27,@,L 98-115 ,240,33,78,0.423,26,47,0.553,7,31,0.226,25,38,0.658,98,43,82,0.524,36,68,0.529,7,14,0.5,22,30,0.733,115,2015-03-02,PHO,MIA,2015,118.5
8028,8028,28,@,W 98-93 (OT),265,34,87,0.391,26,55,0.473,8,32,0.25,22,29,0.759,98,37,96,0.385,26,65,0.4,11,31,0.355,8,18,0.444,93,2015-03-04,POR,LAC,2015,98.5
8029,8029,29,Home,W 98-84 ,240,34,80,0.425,28,60,0.467,6,20,0.3,24,33,0.727,98,31,86,0.36,26,63,0.413,5,23,0.217,17,19,0.895,84,2015-03-06,IND,CHI,2015,86.5
8030,8030,30,Home,L 98-104 ,240,38,80,0.475,30,59,0.508,8,21,0.381,14,15,0.933,98,36,79,0.456,26,56,0.464,10,23,0.435,22,25,0.88,104,2015-03-06,NOP,BOS,2015,109.0
8031,8031,31,@,L 98-106 ,240,40,83,0.482,32,58,0.552,8,25,0.32,10,14,0.714,98,40,80,0.5,30,58,0.517,10,22,0.455,16,23,0.696,106,2015-03-08,LAC,GSW,2015,111.0
8032,8032,32,@,L 98-103 ,240,35,89,0.393,20,55,0.364,15,34,0.441,13,16,0.813,98,38,87,0.437,31,65,0.477,7,22,0.318,20,30,0.667,103,2015-03-08,BOS,ORL,2015,106.5
8033,8033,33,@,W 98-80 ,240,35,83,0.422,22,52,0.423,13,31,0.419,15,19,0.789,98,29,77,0.377,25,66,0.379,4,11,0.364,18,23,0.783,80,2015-03-09,GSW,PHO,2015,82.0
8034,8034,34,@,L 98-105 ,240,42,98,0.429,38,86,0.442,4,12,0.333,10,12,0.833,98,44,84,0.524,37,64,0.578,7,20,0.35,10,13,0.769,105,2015-03-11,DET,GSW,2015,108.5
8035,8035,35,@,L 98-104 ,240,32,73,0.438,26,56,0.464,6,17,0.353,28,39,0.718,98,37,81,0.457,31,60,0.517,6,21,0.286,24,38,0.632,104,2015-03-11,BRK,MIA,2015,107.0
8036,8036,36,Home,L 98-100 ,240,36,82,0.439,24,56,0.429,12,26,0.462,14,24,0.583,98,32,86,0.372,25,56,0.446,7,30,0.233,29,36,0.806,100,2015-03-15,LAC,HOU,2015,103.5
8037,8037,37,Home,L 98-117 ,240,38,88,0.432,36,69,0.522,2,19,0.105,20,25,0.8,98,39,82,0.476,27,59,0.458,12,23,0.522,27,33,0.818,117,2015-03-16,IND,TOR,2015,123.0
8038,8038,38,Home,L 98-109 ,240,41,74,0.554,37,63,0.587,4,11,0.364,12,16,0.75,98,45,89,0.506,39,71,0.549,6,18,0.333,13,16,0.813,109,2015-03-22,MIN,CHO,2015,112.0
8039,8039,39,Home,W 98-92 ,240,39,76,0.513,33,55,0.6,6,21,0.286,14,23,0.609,98,37,96,0.385,32,77,0.416,5,19,0.263,13,22,0.591,92,2015-03-22,PHO,DAL,2015,94.5
8040,8040,40,Home,W 98-86 ,240,37,82,0.451,34,66,0.515,3,16,0.188,21,29,0.724,98,28,81,0.346,20,61,0.328,8,20,0.4,22,28,0.786,86,2015-03-23,CHI,CHO,2015,90.0
8041,8041,41,@,L 98-106 ,240,37,81,0.457,29,51,0.569,8,30,0.267,16,20,0.8,98,40,86,0.465,31,63,0.492,9,23,0.391,17,19,0.895,106,2015-03-27,CLE,BRK,2015,110.5
8042,8042,42,Home,L 98-119 ,240,36,86,0.419,25,55,0.455,11,31,0.355,15,27,0.556,98,44,82,0.537,32,53,0.604,12,29,0.414,19,31,0.613,119,2015-03-27,PHI,LAC,2015,125.0
8043,8043,43,Home,L 98-100 ,240,37,81,0.457,26,58,0.448,11,23,0.478,13,15,0.867,98,41,81,0.506,32,65,0.492,9,16,0.563,9,12,0.75,100,2015-04-01,NYK,BRK,2015,104.5
8044,8044,44,Home,W 98-84 ,240,37,77,0.481,28,54,0.519,9,23,0.391,15,24,0.625,98,33,95,0.347,26,62,0.419,7,33,0.212,11,12,0.917,84,2015-04-01,UTA,DEN,2015,87.5
8045,8045,45,@,L 98-99 ,240,37,77,0.481,32,57,0.561,5,20,0.25,19,26,0.731,98,36,73,0.493,24,47,0.511,12,26,0.462,15,23,0.652,99,2015-04-04,MIA,DET,2015,105.0
8046,8046,46,@,L 98-110 ,240,39,84,0.464,29,59,0.492,10,25,0.4,10,16,0.625,98,48,95,0.505,41,74,0.554,7,21,0.333,7,9,0.778,110,2015-04-08,HOU,SAS,2015,113.5
8047,8047,47,@,L 98-106 ,240,32,74,0.432,29,59,0.492,3,15,0.2,31,34,0.912,98,41,83,0.494,32,60,0.533,9,23,0.391,15,24,0.625,106,2015-04-10,MIN,LAL,2015,110.5
8048,8048,48,@,L 98-114 ,240,38,91,0.418,31,66,0.47,7,25,0.28,15,18,0.833,98,39,86,0.453,30,61,0.492,9,25,0.36,27,34,0.794,114,2015-04-15,POR,DAL,2015,118.5
8049,8049,49,Home,W 98-94 (OT),265,39,104,0.375,33,76,0.434,6,28,0.214,14,28,0.5,98,34,84,0.405,27,62,0.435,7,22,0.318,19,26,0.731,94,2015-10-30,DET,CHI,2016,97.5
8050,8050,50,@,W 98-92 ,240,37,90,0.411,30,69,0.435,7,21,0.333,17,22,0.773,98,38,86,0.442,33,58,0.569,5,28,0.179,11,16,0.688,92,2015-11-03,ATL,MIA,2016,94.5
8051,8051,51,@,L 98-100 ,240,35,83,0.422,25,56,0.446,10,27,0.37,18,22,0.818,98,35,91,0.385,27,68,0.397,8,23,0.348,22,29,0.759,100,2015-11-04,BOS,IND,2016,104.0
8052,8052,52,Home,L 98-103 ,240,39,82,0.476,31,59,0.525,8,23,0.348,12,14,0.857,98,33,79,0.418,28,65,0.431,5,14,0.357,32,39,0.821,103,2015-11-04,OKC,TOR,2016,105.5
8053,8053,53,@,L 98-104 ,240,38,84,0.452,33,71,0.465,5,13,0.385,17,20,0.85,98,40,90,0.444,33,72,0.458,7,18,0.389,17,21,0.81,104,2015-11-05,OKC,CHI,2016,107.5
8054,8054,54,@,L 98-118 ,240,36,88,0.409,28,63,0.444,8,25,0.32,18,23,0.783,98,44,97,0.454,32,67,0.478,12,30,0.4,18,23,0.783,118,2015-11-06,WAS,BOS,2016,124.0
8055,8055,55,Home,L 98-104 ,240,40,93,0.43,37,74,0.5,3,19,0.158,15,20,0.75,98,33,78,0.423,26,55,0.473,7,23,0.304,31,40,0.775,104,2015-11-06,BRK,LAL,2016,107.5
8056,8056,56,@,L 98-107 ,240,39,86,0.453,30,58,0.517,9,28,0.321,11,13,0.846,98,40,84,0.476,31,60,0.517,9,24,0.375,18,22,0.818,107,2015-11-07,NOP,DAL,2016,111.5
8057,8057,57,@,L 98-106 ,240,37,83,0.446,23,54,0.426,14,29,0.483,10,15,0.667,98,42,86,0.488,32,60,0.533,10,26,0.385,12,16,0.75,106,2015-11-11,NOP,ATL,2016,111.0
8058,8058,58,Home,L 98-106 ,240,42,98,0.429,34,64,0.531,8,34,0.235,6,12,0.5,98,42,98,0.429,34,81,0.42,8,17,0.471,14,17,0.824,106,2015-11-11,HOU,BRK,2016,110.0
8059,8059,59,@,L 98-107 ,240,33,77,0.429,24,48,0.5,9,29,0.31,23,31,0.742,98,37,81,0.457,28,61,0.459,9,20,0.45,24,32,0.75,107,2015-11-13,HOU,DEN,2016,111.5
8060,8060,60,Home,L 98-110 ,240,32,84,0.381,23,50,0.46,9,34,0.265,25,32,0.781,98,43,89,0.483,35,61,0.574,8,28,0.286,16,21,0.762,110,2015-11-14,HOU,DAL,2016,114.0
8061,8061,61,Home,L 98-115 ,240,41,83,0.494,34,60,0.567,7,23,0.304,9,11,0.818,98,45,85,0.529,30,55,0.545,15,30,0.5,10,13,0.769,115,2015-11-17,NOP,DEN,2016,122.5
8062,8062,62,@,L 98-109 ,240,38,98,0.388,33,83,0.398,5,15,0.333,17,18,0.944,98,42,86,0.488,33,68,0.485,9,18,0.5,16,20,0.8,109,2015-11-18,DEN,SAS,2016,113.5
8063,8063,63,Home,W 98-84 ,240,42,82,0.512,33,62,0.532,9,20,0.45,5,10,0.5,98,34,73,0.466,27,54,0.5,7,19,0.368,9,10,0.9,84,2015-11-23,SAS,PHO,2016,87.5
8064,8064,64,@,L 98-112 ,240,36,84,0.429,27,47,0.574,9,37,0.243,17,22,0.773,98,36,79,0.456,27,48,0.563,9,31,0.29,31,44,0.705,112,2015-11-30,DAL,SAC,2016,116.5
8065,8065,65,Home,L 98-114 ,240,39,89,0.438,34,72,0.472,5,17,0.294,15,23,0.652,98,44,86,0.512,30,53,0.566,14,33,0.424,12,23,0.522,114,2015-12-06,BRK,GSW,2016,121.0
8066,8066,66,Home,W 98-95 ,240,35,86,0.407,29,64,0.453,6,22,0.273,22,31,0.71,98,35,88,0.398,28,64,0.438,7,24,0.292,18,30,0.6,95,2015-12-06,OKC,SAC,2016,98.5
8067,8067,67,@,W 98-95 ,240,39,81,0.481,33,61,0.541,6,20,0.3,14,18,0.778,98,36,100,0.36,29,69,0.42,7,31,0.226,16,19,0.842,95,2015-12-09,ATL,DAL,2016,98.5
8068,8068,68,Home,W 98-94 ,240,33,78,0.423,25,58,0.431,8,20,0.4,24,29,0.828,98,40,89,0.449,34,73,0.466,6,16,0.375,8,11,0.727,94,2015-12-12,CHI,NOP,2016,97.0
8069,8069,69,@,W 98-93 ,240,40,96,0.417,31,71,0.437,9,25,0.36,9,10,0.9,98,36,88,0.409,25,53,0.472,11,35,0.314,10,10,1.0,93,2015-12-12,BOS,CHO,2016,98.5
8070,8070,70,@,L 98-104 (OT),265,39,94,0.415,31,72,0.431,8,22,0.364,12,20,0.6,98,35,79,0.443,28,58,0.483,7,21,0.333,27,30,0.9,104,2015-12-13,UTA,OKC,2016,107.5
8071,8071,71,Home,L 98-104 ,240,42,89,0.472,38,73,0.521,4,16,0.25,10,14,0.714,98,40,75,0.533,33,54,0.611,7,21,0.333,17,24,0.708,104,2015-12-16,BRK,MIA,2016,107.5
8072,8072,72,Home,W 98-85 ,240,38,86,0.442,29,62,0.468,9,24,0.375,13,19,0.684,98,32,76,0.421,27,57,0.474,5,19,0.263,16,28,0.571,85,2015-12-16,CHI,MEM,2016,87.5
8073,8073,73,@,L 98-113 ,240,36,79,0.456,22,45,0.489,14,34,0.412,12,15,0.8,98,43,77,0.558,29,53,0.547,14,24,0.583,13,15,0.867,113,2015-12-16,CHA,ORL,2016,120.0
8074,8074,74,@,L 98-117 ,240,39,81,0.481,32,57,0.561,7,24,0.292,13,17,0.765,98,47,88,0.534,39,63,0.619,8,25,0.32,15,18,0.833,117,2015-12-26,NYK,ATL,2016,121.0
8075,8075,75,Home,W 98-92 ,240,28,69,0.406,14,37,0.378,14,32,0.438,28,32,0.875,98,37,90,0.411,30,71,0.423,7,19,0.368,11,21,0.524,92,2015-12-26,CHA,MEM,2016,95.5
8076,8076,76,@,W 98-94 ,240,38,92,0.413,28,59,0.475,10,33,0.303,12,16,0.75,98,30,76,0.395,21,52,0.404,9,24,0.375,25,31,0.806,94,2015-12-27,POR,SAC,2016,98.5
8077,8077,77,@,L 98-108 ,240,35,85,0.412,26,56,0.464,9,29,0.31,19,23,0.826,98,43,89,0.483,37,64,0.578,6,25,0.24,16,22,0.727,108,2015-12-28,LAL,CHO,2016,111.0
8078,8078,78,Home,L 98-105 ,240,36,83,0.434,26,57,0.456,10,26,0.385,16,19,0.842,98,40,83,0.482,34,63,0.54,6,20,0.3,19,24,0.792,105,2016-01-02,DAL,NOP,2016,108.0
8079,8079,79,Home,L 98-123 ,240,37,77,0.481,34,65,0.523,3,12,0.25,21,30,0.7,98,49,90,0.544,40,70,0.571,9,20,0.45,16,20,0.8,123,2016-01-04,MIL,SAS,2016,127.5
8080,8080,80,@,W 98-90 ,240,39,70,0.557,36,62,0.581,3,8,0.375,17,18,0.944,98,37,82,0.451,35,65,0.538,2,17,0.118,14,15,0.933,90,2016-01-06,NYK,MIA,2016,91.0
8081,8081,81,Home,L 98-109 ,240,38,86,0.442,29,60,0.483,9,26,0.346,13,23,0.565,98,42,83,0.506,31,60,0.517,11,23,0.478,14,17,0.824,109,2016-01-06,POR,LAC,2016,114.5
8082,8082,82,@,L 98-123 ,240,37,79,0.468,30,61,0.492,7,18,0.389,17,18,0.944,98,52,86,0.605,43,65,0.662,9,21,0.429,10,13,0.769,123,2016-01-06,UTA,SAS,2016,127.5
8083,8083,83,Home,L 98-126 ,240,39,86,0.453,34,68,0.5,5,18,0.278,15,25,0.6,98,49,92,0.533,36,60,0.6,13,32,0.406,15,19,0.789,126,2016-01-07,PHI,ATL,2016,132.5
8084,8084,84,Home,W 98-83 ,240,39,71,0.549,30,51,0.588,9,20,0.45,11,18,0.611,98,34,82,0.415,28,63,0.444,6,19,0.316,9,17,0.529,83,2016-01-09,UTA,MIA,2016,86.0
8085,8085,85,@,L 98-101 ,240,37,88,0.42,30,66,0.455,7,22,0.318,17,23,0.739,98,31,84,0.369,27,68,0.397,4,16,0.25,35,40,0.875,101,2016-01-10,BOS,MEM,2016,103.0
8086,8086,86,@,L 98-116 ,240,40,90,0.444,36,67,0.537,4,23,0.174,14,24,0.583,98,43,86,0.5,30,53,0.566,13,33,0.394,17,20,0.85,116,2016-01-14,LAL,GSW,2016,122.5
8087,8087,87,@,W 98-95 ,240,40,81,0.494,36,69,0.522,4,12,0.333,14,19,0.737,98,32,78,0.41,26,60,0.433,6,18,0.333,25,26,0.962,95,2016-01-15,MIA,DEN,2016,98.0
8088,8088,88,Home,W 98-81 ,240,41,80,0.513,32,61,0.525,9,19,0.474,7,10,0.7,98,30,87,0.345,24,65,0.369,6,22,0.273,15,20,0.75,81,2016-01-18,ATL,ORL,2016,84.0
8089,8089,89,Home,L 98-132 ,240,37,77,0.481,30,58,0.517,7,19,0.368,17,25,0.68,98,46,85,0.541,27,45,0.6,19,40,0.475,21,27,0.778,132,2016-01-18,CLE,GSW,2016,141.5
8090,8090,90,Home,L 98-108 ,240,37,77,0.481,28,56,0.5,9,21,0.429,15,20,0.75,98,43,84,0.512,26,53,0.491,17,31,0.548,5,11,0.455,108,2016-01-18,WAS,POR,2016,116.5
8091,8091,91,Home,L 98-104 ,240,41,94,0.436,32,63,0.508,9,31,0.29,7,11,0.636,98,39,87,0.448,29,63,0.46,10,24,0.417,16,23,0.696,104,2016-01-20,POR,ATL,2016,109.0
8092,8092,92,@,L 98-102 ,240,39,85,0.459,36,71,0.507,3,14,0.214,17,22,0.773,98,38,94,0.404,23,50,0.46,15,44,0.341,11,16,0.688,102,2016-01-22,MIL,HOU,2016,109.5
8093,8093,93,Home,W 98-95 ,240,34,85,0.4,24,61,0.393,10,24,0.417,20,26,0.769,98,34,84,0.405,22,50,0.44,12,34,0.353,15,18,0.833,95,2016-01-23,PHO,ATL,2016,101.0
8094,8094,94,Home,L 98-102 ,240,36,71,0.507,27,53,0.509,9,18,0.5,17,23,0.739,98,45,83,0.542,42,74,0.568,3,9,0.333,9,10,0.9,102,2016-01-26,BRK,MIA,2016,103.5
8095,8095,95,@,L 98-114 ,240,40,86,0.465,33,60,0.55,7,26,0.269,11,15,0.733,98,43,83,0.518,36,61,0.59,7,22,0.318,21,27,0.778,114,2016-02-01,WAS,OKC,2016,117.5
8096,8096,96,@,W 98-95 ,240,43,94,0.457,43,85,0.506,0,9,0.0,12,18,0.667,98,36,81,0.444,26,55,0.473,10,26,0.385,13,15,0.867,95,2016-02-05,MIA,CHO,2016,100.0
8097,8097,97,@,L 98-103 ,240,35,76,0.461,30,61,0.492,5,15,0.333,23,26,0.885,98,38,81,0.469,28,52,0.538,10,29,0.345,17,22,0.773,103,2016-02-06,BRK,PHI,2016,108.0
8098,8098,98,@,W 98-89 ,240,34,78,0.436,29,62,0.468,5,16,0.313,25,31,0.806,98,30,80,0.375,21,56,0.375,9,24,0.375,20,26,0.769,89,2016-02-06,UTA,PHO,2016,93.5
8099,8099,99,@,W 98-92 (OT),265,35,95,0.368,30,73,0.411,5,22,0.227,23,31,0.742,98,34,90,0.378,28,65,0.431,6,25,0.24,18,21,0.857,92,2016-02-08,LAC,PHI,2016,95.0
8100,8100,0,@,W 98-96 ,240,38,89,0.427,30,69,0.435,8,20,0.4,14,15,0.933,98,37,91,0.407,29,71,0.408,8,20,0.4,14,16,0.875,96,2016-02-10,SAS,ORL,2016,100.0
8101,8101,1,@,L 98-109 ,240,36,82,0.439,26,56,0.464,10,26,0.385,16,18,0.889,98,42,86,0.488,34,69,0.493,8,17,0.471,17,20,0.85,109,2016-02-19,NYK,BRK,2016,113.0
8102,8102,2,@,W 98-95 ,240,37,86,0.43,28,55,0.509,9,31,0.29,15,18,0.833,98,36,81,0.444,29,62,0.468,7,19,0.368,16,21,0.762,95,2016-02-19,CHA,MIL,2016,98.5
8103,8103,3,Home,L 98-101 ,240,42,96,0.438,37,70,0.529,5,26,0.192,9,10,0.9,98,39,88,0.443,30,66,0.455,9,22,0.409,14,22,0.636,101,2016-02-19,OKC,IND,2016,105.5
8104,8104,4,Home,W 98-86 ,240,36,78,0.462,29,56,0.518,7,22,0.318,19,26,0.731,98,35,82,0.427,28,59,0.475,7,23,0.304,9,17,0.529,86,2016-02-19,WAS,DET,2016,89.5
8105,8105,5,Home,W 98-85 ,240,33,81,0.407,26,53,0.491,7,28,0.25,25,31,0.806,98,28,76,0.368,25,56,0.446,3,20,0.15,26,32,0.813,85,2016-02-21,TOR,MEM,2016,86.5
8106,8106,6,@,W 98-96 ,240,40,84,0.476,33,69,0.478,7,15,0.467,11,17,0.647,98,37,89,0.416,32,69,0.464,5,20,0.25,17,25,0.68,96,2016-02-27,BRK,UTA,2016,98.5
8107,8107,7,@,W 98-81 ,240,40,84,0.476,39,76,0.513,1,8,0.125,17,21,0.81,98,32,87,0.368,26,72,0.361,6,15,0.4,11,12,0.917,81,2016-02-28,MIA,NYK,2016,84.0
8108,8108,8,@,L 98-103 ,240,39,98,0.398,29,63,0.46,10,35,0.286,10,11,0.909,98,40,98,0.408,31,66,0.47,9,32,0.281,14,21,0.667,103,2016-03-02,OKC,LAC,2016,107.5
8109,8109,9,@,L 98-104 ,240,39,82,0.476,30,56,0.536,9,26,0.346,11,20,0.55,98,35,79,0.443,30,61,0.492,5,18,0.278,29,33,0.879,104,2016-03-02,SAC,MEM,2016,106.5
8110,8110,10,Home,L 98-104 ,240,32,75,0.427,27,61,0.443,5,14,0.357,29,34,0.853,98,42,84,0.5,31,55,0.564,11,29,0.379,9,13,0.692,104,2016-03-02,MIN,WAS,2016,109.5
8111,8111,11,@,L 98-103 ,240,37,85,0.435,26,54,0.481,11,31,0.355,13,22,0.591,98,36,81,0.444,28,67,0.418,8,14,0.571,23,30,0.767,103,2016-03-06,PHI,MIA,2016,107.0
8112,8112,12,@,L 98-107 ,240,37,76,0.487,32,57,0.561,5,19,0.263,19,27,0.704,98,40,81,0.494,31,54,0.574,9,27,0.333,18,23,0.783,107,2016-03-08,ORL,LAL,2016,111.5
8113,8113,13,@,L 98-116 ,240,33,89,0.371,27,61,0.443,6,28,0.214,26,33,0.788,98,44,91,0.484,31,63,0.492,13,28,0.464,15,19,0.789,116,2016-03-10,PHO,DEN,2016,122.5
8114,8114,14,Home,L 98-102 ,240,34,91,0.374,26,60,0.433,8,31,0.258,22,28,0.786,98,40,88,0.455,35,62,0.565,5,26,0.192,17,25,0.68,102,2016-03-11,BOS,HOU,2016,104.5
8115,8115,15,@,L 98-103 ,240,36,94,0.383,28,63,0.444,8,31,0.258,18,22,0.818,98,39,84,0.464,34,72,0.472,5,12,0.417,20,28,0.714,103,2016-03-15,BOS,IND,2016,105.5
8116,8116,16,Home,L 98-106 ,240,37,84,0.44,32,58,0.552,5,26,0.192,19,26,0.731,98,38,79,0.481,34,61,0.557,4,18,0.222,26,33,0.788,106,2016-03-15,LAL,SAC,2016,108.0
8117,8117,17,@,L 98-99 ,240,37,79,0.468,30,57,0.526,7,22,0.318,17,19,0.895,98,39,88,0.443,29,51,0.569,10,37,0.27,11,13,0.846,99,2016-03-16,DAL,CLE,2016,104.0
8118,8118,18,@,L 98-116 ,240,39,87,0.448,33,65,0.508,6,22,0.273,14,17,0.824,98,40,80,0.5,28,54,0.519,12,26,0.462,24,28,0.857,116,2016-03-17,DEN,ATL,2016,122.0
8119,8119,19,@,L 98-114 ,240,36,85,0.424,28,57,0.491,8,28,0.286,18,27,0.667,98,39,87,0.448,24,53,0.453,15,34,0.441,21,28,0.75,114,2016-03-23,LAC,GSW,2016,121.5
8120,8120,20,@,W 98-96 ,240,37,87,0.425,27,61,0.443,10,26,0.385,14,16,0.875,98,39,90,0.433,36,71,0.507,3,19,0.158,15,17,0.882,96,2016-03-29,CHI,IND,2016,97.5
8121,8121,21,@,W 98-89 ,240,39,85,0.459,31,61,0.508,8,24,0.333,12,14,0.857,98,31,81,0.383,18,48,0.375,13,33,0.394,14,24,0.583,89,2016-04-01,DAL,DET,2016,95.5
8122,8122,22,Home,W 98-85 ,240,38,72,0.528,30,50,0.6,8,22,0.364,14,23,0.609,98,35,79,0.443,26,56,0.464,9,23,0.391,6,10,0.6,85,2016-04-01,UTA,MIN,2016,89.5
8123,8123,23,Home,L 98-102 ,240,40,85,0.471,38,78,0.487,2,7,0.286,16,20,0.8,98,39,74,0.527,32,48,0.667,7,26,0.269,17,22,0.773,102,2016-04-03,MIL,CHI,2016,105.5
8124,8124,24,@,L 98-106 ,240,35,78,0.449,32,64,0.5,3,14,0.214,25,28,0.893,98,44,92,0.478,40,78,0.513,4,14,0.286,14,17,0.824,106,2016-04-07,CHI,MIA,2016,108.0
8125,8125,25,@,L 98-102 ,240,36,85,0.424,33,71,0.465,3,14,0.214,23,28,0.821,98,40,86,0.465,34,64,0.531,6,22,0.273,16,19,0.842,102,2016-04-08,SAS,DEN,2016,105.0
8126,8126,26,@,L 98-111 ,240,37,83,0.446,29,56,0.518,8,27,0.296,16,20,0.8,98,37,68,0.544,27,46,0.587,10,22,0.455,27,38,0.711,111,2016-04-08,IND,TOR,2016,116.0
8127,8127,27,Home,W 98-91 ,240,37,76,0.487,28,58,0.483,9,18,0.5,15,37,0.405,98,30,74,0.405,22,44,0.5,8,30,0.267,23,33,0.697,91,2016-04-10,LAC,DAL,2016,95.0
8128,8128,28,@,L 98-113 ,240,28,81,0.346,16,48,0.333,12,33,0.364,30,35,0.857,98,42,80,0.525,33,59,0.559,9,21,0.429,20,28,0.714,113,2016-04-10,CHA,WAS,2016,117.5
8129,8129,29,@,L 98-107 ,240,41,78,0.526,38,63,0.603,3,15,0.2,13,19,0.684,98,41,84,0.488,34,61,0.557,7,23,0.304,18,28,0.643,107,2016-04-11,MIL,ORL,2016,110.5
8130,8130,30,@,L 98-102 (OT),265,35,87,0.402,29,62,0.468,6,25,0.24,22,25,0.88,98,37,87,0.425,33,73,0.452,4,14,0.286,24,32,0.75,102,2016-04-12,OKC,SAS,2016,104.0
8131,8131,31,@,L 98-122 ,240,35,77,0.455,20,42,0.476,15,35,0.429,13,25,0.52,98,48,95,0.505,38,70,0.543,10,25,0.4,16,19,0.842,122,2016-04-12,PHI,TOR,2016,127.0
8132,8132,32,Home,W 98-88 ,240,37,86,0.43,32,72,0.444,5,14,0.357,19,22,0.864,98,38,88,0.432,36,69,0.522,2,19,0.105,10,12,0.833,88,2016-04-13,BOS,MIA,2016,89.0
8133,8133,33,@,L 98-109 ,240,32,81,0.395,21,52,0.404,11,29,0.379,23,31,0.742,98,42,88,0.477,33,60,0.55,9,28,0.321,16,30,0.533,109,2016-04-13,ATL,WAS,2016,113.5
8134,8134,34,@,L 98-102 ,240,36,86,0.419,30,68,0.441,6,18,0.333,20,29,0.69,98,36,80,0.45,25,56,0.446,11,24,0.458,19,27,0.704,102,2016-10-26,MIN,MEM,2017,107.5
8135,8135,35,Home,L 98-106 ,240,35,80,0.438,27,51,0.529,8,29,0.276,20,24,0.833,98,33,70,0.471,18,38,0.474,15,32,0.469,25,31,0.806,106,2016-10-28,DAL,HOU,2017,113.5
8136,8136,36,Home,L 98-104 ,240,32,79,0.405,23,47,0.489,9,32,0.281,25,33,0.758,98,39,81,0.481,24,50,0.48,15,31,0.484,11,17,0.647,104,2016-10-29,CHA,BOS,2017,111.5
8137,8137,37,Home,W 98-79 ,240,35,83,0.422,25,59,0.424,10,24,0.417,18,23,0.783,98,32,86,0.372,28,64,0.438,4,22,0.182,11,15,0.733,79,2016-10-29,SAS,NOP,2017,81.0
8138,8138,38,Home,W 98-83 ,240,39,88,0.443,34,68,0.5,5,20,0.25,15,20,0.75,98,34,87,0.391,30,70,0.429,4,17,0.235,11,14,0.786,83,2016-10-30,DET,MIL,2017,85.0
8139,8139,39,@,L 98-116 ,240,35,84,0.417,30,69,0.435,5,15,0.333,23,31,0.742,98,40,80,0.5,34,64,0.531,6,16,0.375,30,38,0.789,116,2016-10-31,PHO,LAC,2017,119.0
8140,8140,40,@,L 98-104 ,240,38,82,0.463,30,48,0.625,8,34,0.235,14,18,0.778,98,38,82,0.463,30,56,0.536,8,26,0.308,20,29,0.69,104,2016-11-09,UTA,CHO,2017,108.0
8141,8141,41,@,W 98-95 ,240,37,89,0.416,31,73,0.425,6,16,0.375,18,20,0.9,98,36,88,0.409,23,59,0.39,13,29,0.448,10,15,0.667,95,2016-11-10,CHI,MIA,2017,101.5
8142,8142,42,@,W 98-85 ,240,34,85,0.4,27,63,0.429,7,22,0.318,23,25,0.92,98,32,79,0.405,26,53,0.491,6,26,0.231,15,21,0.714,85,2016-11-25,MIN,PHO,2017,88.0
8143,8143,43,Home,L 98-106 ,240,38,91,0.418,31,69,0.449,7,22,0.318,15,24,0.625,98,41,93,0.441,32,69,0.464,9,24,0.375,15,26,0.577,106,2016-11-30,DEN,MIA,2017,110.5
8144,8144,44,@,L 98-105 ,240,37,83,0.446,24,59,0.407,13,24,0.542,11,14,0.786,98,35,78,0.449,26,53,0.491,9,25,0.36,26,28,0.929,105,2016-12-03,DEN,UTA,2017,109.5
8145,8145,45,@,W 98-92 ,240,42,79,0.532,35,56,0.625,7,23,0.304,7,14,0.5,98,38,86,0.442,28,59,0.475,10,27,0.37,6,13,0.462,92,2016-12-04,ORL,DET,2017,97.0
8146,8146,46,@,L 98-106 ,240,31,97,0.32,22,69,0.319,9,28,0.321,27,31,0.871,98,39,88,0.443,28,59,0.475,11,29,0.379,17,24,0.708,106,2016-12-04,SAC,NYK,2017,111.5
8147,8147,47,Home,L 98-106 ,240,35,86,0.407,24,55,0.436,11,31,0.355,17,23,0.739,98,35,76,0.461,25,49,0.51,10,27,0.37,26,34,0.765,106,2016-12-05,PHI,DEN,2017,111.0
8148,8148,48,Home,L 98-115 ,240,36,92,0.391,28,66,0.424,8,26,0.308,18,24,0.75,98,42,89,0.472,35,58,0.603,7,31,0.226,24,29,0.828,115,2016-12-07,LAC,GSW,2017,118.5
8149,8149,49,@,L 98-132 ,240,39,92,0.424,28,60,0.467,11,32,0.344,9,11,0.818,98,50,85,0.588,28,43,0.651,22,42,0.524,10,16,0.625,132,2016-12-14,SAC,HOU,2017,143.0
8150,8150,50,Home,L 98-102 ,240,38,93,0.409,32,66,0.485,6,27,0.222,16,25,0.64,98,36,83,0.434,29,58,0.5,7,25,0.28,23,29,0.793,102,2016-12-16,MIA,LAC,2017,105.5
8151,8151,51,@,W 98-86 ,240,35,82,0.427,23,52,0.442,12,30,0.4,16,19,0.842,98,26,72,0.361,20,49,0.408,6,23,0.261,28,37,0.757,86,2016-12-21,MEM,DET,2017,89.0
8152,8152,52,Home,L 98-104 ,240,35,79,0.443,25,52,0.481,10,27,0.37,18,21,0.857,98,43,81,0.531,35,60,0.583,8,21,0.381,10,15,0.667,104,2016-12-23,UTA,TOR,2017,108.0
8153,8153,53,@,L 98-102 (OT),265,35,93,0.376,28,66,0.424,7,27,0.259,21,26,0.808,98,37,101,0.366,30,74,0.405,7,27,0.259,21,27,0.778,102,2016-12-28,NYK,ATL,2017,105.5
8154,8154,54,@,L 98-102 ,240,37,94,0.394,26,57,0.456,11,37,0.297,13,18,0.722,98,40,87,0.46,30,58,0.517,10,29,0.345,12,21,0.571,102,2016-12-28,LAC,NOP,2017,107.0
8155,8155,55,@,L 98-119 ,240,36,74,0.486,29,58,0.5,7,16,0.438,19,24,0.792,98,47,87,0.54,42,70,0.6,5,17,0.294,20,25,0.8,119,2016-12-28,PHO,SAS,2017,121.5
8156,8156,56,@,L 98-105 ,240,35,84,0.417,26,53,0.491,9,31,0.29,19,21,0.905,98,39,88,0.443,31,62,0.5,8,26,0.308,19,25,0.76,105,2016-12-30,DET,ATL,2017,109.0
8157,8157,57,Home,L 98-112 ,240,31,72,0.431,20,44,0.455,11,28,0.393,25,28,0.893,98,44,87,0.506,27,52,0.519,17,35,0.486,7,9,0.778,112,2016-12-31,SAC,MEM,2017,120.5
8158,8158,58,Home,L 98-107 ,240,35,77,0.455,21,51,0.412,14,26,0.538,14,18,0.778,98,42,86,0.488,33,64,0.516,9,22,0.409,14,22,0.636,107,2017-01-01,MIA,DET,2017,111.5
8159,8159,59,@,L 98-109 ,240,39,102,0.382,37,87,0.425,2,15,0.133,18,22,0.818,98,37,80,0.463,30,64,0.469,7,16,0.438,28,38,0.737,109,2017-01-02,PHO,LAC,2017,112.5
8160,8160,60,Home,W 98-94 ,240,38,79,0.481,31,60,0.517,7,19,0.368,15,24,0.625,98,36,78,0.462,27,51,0.529,9,27,0.333,13,19,0.684,94,2017-01-02,MIL,OKC,2017,98.5
8161,8161,61,Home,L 98-106 ,240,36,87,0.414,27,57,0.474,9,30,0.3,17,22,0.773,98,39,84,0.464,26,53,0.491,13,31,0.419,15,21,0.714,106,2017-01-06,SAC,LAC,2017,112.5
8162,8162,62,Home,W 98-86 ,240,36,86,0.419,27,56,0.482,9,30,0.3,17,25,0.68,98,31,84,0.369,24,57,0.421,7,27,0.259,17,21,0.81,86,2017-01-08,LAC,MIA,2017,89.5
8163,8163,63,Home,W 98-97 ,240,37,95,0.389,30,67,0.448,7,28,0.25,17,21,0.81,98,42,86,0.488,38,64,0.594,4,22,0.182,9,10,0.9,97,2017-01-11,PHI,NYK,2017,99.0
8164,8164,64,@,L 98-111 ,240,39,79,0.494,33,60,0.55,6,19,0.316,14,18,0.778,98,42,80,0.525,29,54,0.537,13,26,0.5,14,18,0.778,111,2017-01-15,MIL,ATL,2017,117.5
8165,8165,65,Home,W 98-87 ,240,36,77,0.468,24,48,0.5,12,29,0.414,14,19,0.737,98,35,80,0.438,30,59,0.508,5,21,0.238,12,18,0.667,87,2017-01-15,DAL,MIN,2017,89.5
8166,8166,66,@,L 98-108 ,240,38,86,0.442,30,61,0.492,8,25,0.32,14,17,0.824,98,42,84,0.5,27,45,0.6,15,39,0.385,9,10,0.9,108,2017-01-16,CHA,BOS,2017,115.5
8167,8167,67,Home,W 98-95 ,240,41,81,0.506,36,62,0.581,5,19,0.263,11,16,0.688,98,36,83,0.434,26,58,0.448,10,25,0.4,13,18,0.722,95,2017-01-16,IND,NOP,2017,100.0
8168,8168,68,@,L 98-120 ,240,36,85,0.424,26,55,0.473,10,30,0.333,16,19,0.842,98,45,82,0.549,33,54,0.611,12,28,0.429,18,22,0.818,120,2017-01-16,OKC,LAC,2017,126.0
8169,8169,69,Home,L 98-99 ,240,37,82,0.451,31,68,0.456,6,14,0.429,18,22,0.818,98,37,78,0.474,26,50,0.52,11,28,0.393,14,18,0.778,99,2017-01-17,CHI,DAL,2017,104.5
8170,8170,70,@,L 98-118 ,240,39,88,0.443,28,56,0.5,11,32,0.344,9,11,0.818,98,46,93,0.495,31,57,0.544,15,36,0.417,11,15,0.733,118,2017-01-18,ORL,NOP,2017,125.5
8171,8171,71,@,L 98-123 ,240,40,96,0.417,30,64,0.469,10,32,0.313,8,8,1.0,98,46,87,0.529,36,63,0.571,10,24,0.417,21,26,0.808,123,2017-01-21,LAC,DEN,2017,128.0
8172,8172,72,Home,L 98-118 ,240,42,96,0.438,35,68,0.515,7,28,0.25,7,16,0.438,98,42,89,0.472,23,47,0.489,19,42,0.452,15,19,0.789,118,2017-01-22,ORL,GSW,2017,127.5
8173,8173,73,@,L 98-105 ,240,37,94,0.394,26,65,0.4,11,29,0.379,13,14,0.929,98,43,90,0.478,39,75,0.52,4,15,0.267,15,20,0.75,105,2017-01-25,LAL,POR,2017,107.0
8174,8174,74,@,L 98-109 ,240,38,84,0.452,27,58,0.466,11,26,0.423,11,13,0.846,98,37,72,0.514,28,50,0.56,9,22,0.409,26,36,0.722,109,2017-01-26,DAL,OKC,2017,113.5
8175,8175,75,@,L 98-128 ,240,38,87,0.437,29,62,0.468,9,25,0.36,13,18,0.722,98,50,89,0.562,34,55,0.618,16,34,0.471,12,15,0.8,128,2017-01-27,ORL,BOS,2017,136.0
8176,8176,76,@,L 98-144 ,240,36,82,0.439,24,54,0.444,12,28,0.429,14,22,0.636,98,57,92,0.62,40,58,0.69,17,34,0.5,13,16,0.813,144,2017-01-28,LAC,GSW,2017,152.5
8177,8177,77,@,L 98-115 ,240,33,83,0.398,22,52,0.423,11,31,0.355,21,25,0.84,98,42,93,0.452,31,62,0.5,11,31,0.355,20,23,0.87,115,2017-01-31,CHA,POR,2017,120.5
8178,8178,78,@,L 98-118 ,240,41,82,0.5,36,61,0.59,5,21,0.238,11,14,0.786,98,48,88,0.545,38,62,0.613,10,26,0.385,12,17,0.706,118,2017-02-01,NOP,DET,2017,123.0
8179,8179,79,@,W 98-88 ,240,33,69,0.478,24,49,0.49,9,20,0.45,23,26,0.885,98,31,77,0.403,25,53,0.472,6,24,0.25,20,28,0.714,88,2017-02-01,IND,ORL,2017,91.0
8180,8180,80,@,L 98-105 ,240,35,82,0.427,22,49,0.449,13,33,0.394,15,18,0.833,98,38,81,0.469,25,48,0.521,13,33,0.394,16,24,0.667,105,2017-02-04,CHA,UTA,2017,111.5
8181,8181,81,Home,L 98-111 ,240,35,77,0.455,26,50,0.52,9,27,0.333,19,25,0.76,98,40,81,0.494,24,47,0.511,16,34,0.471,15,18,0.833,111,2017-02-13,DAL,BOS,2017,119.0
8182,8182,82,@,L 98-120 ,240,34,96,0.354,27,62,0.435,7,34,0.206,23,30,0.767,98,42,73,0.575,29,53,0.547,13,20,0.65,23,28,0.821,120,2017-02-13,OKC,WAS,2017,126.5
8183,8183,83,Home,W 98-91 ,240,36,82,0.439,30,63,0.476,6,19,0.316,20,22,0.909,98,35,92,0.38,25,55,0.455,10,37,0.27,11,11,1.0,91,2017-02-15,DET,DAL,2017,96.0
8184,8184,84,Home,L 98-111 ,240,40,81,0.494,36,63,0.571,4,18,0.222,14,18,0.778,98,43,83,0.518,28,54,0.519,15,29,0.517,10,15,0.667,111,2017-02-16,IND,WAS,2017,118.5
8185,8185,85,Home,L 98-105 ,240,37,84,0.44,26,50,0.52,11,34,0.324,13,17,0.765,98,36,80,0.45,25,47,0.532,11,33,0.333,22,25,0.88,105,2017-02-26,DEN,MEM,2017,110.5
8186,8186,86,Home,L 98-104 ,240,35,81,0.432,23,48,0.479,12,33,0.364,16,35,0.457,98,34,85,0.4,22,50,0.44,12,35,0.343,24,30,0.8,104,2017-02-26,DET,BOS,2017,110.0
8187,8187,87,Home,L 98-119 ,240,40,87,0.46,33,65,0.508,7,22,0.318,11,18,0.611,98,49,94,0.521,39,73,0.534,10,21,0.476,11,13,0.846,119,2017-02-26,LAL,SAS,2017,124.0
8188,8188,88,Home,L 98-114 ,240,34,87,0.391,24,53,0.453,10,34,0.294,20,25,0.8,98,46,95,0.484,40,70,0.571,6,25,0.24,16,20,0.8,114,2017-02-27,BOS,ATL,2017,117.0
8189,8189,89,@,L 98-125 ,240,37,85,0.435,31,68,0.456,6,17,0.353,18,22,0.818,98,49,90,0.544,36,60,0.6,13,30,0.433,14,21,0.667,125,2017-03-01,PHI,MIA,2017,131.5
8190,8190,90,Home,L 98-110 ,240,38,83,0.458,29,65,0.446,9,18,0.5,13,15,0.867,98,41,84,0.488,31,51,0.608,10,33,0.303,18,20,0.9,110,2017-03-01,MIL,DEN,2017,115.0
8191,8191,91,Home,L 98-101 (OT),265,35,91,0.385,27,66,0.409,8,25,0.32,20,24,0.833,98,40,95,0.421,34,68,0.5,6,27,0.222,15,25,0.6,101,2017-03-03,NOP,SAS,2017,104.0
8192,8192,92,Home,L 98-106 ,240,35,78,0.449,26,51,0.51,9,27,0.333,19,29,0.655,98,39,91,0.429,23,56,0.411,16,35,0.457,12,14,0.857,106,2017-03-06,CLE,MIA,2017,114.0
8193,8193,93,Home,L 98-112 ,240,39,89,0.438,31,59,0.525,8,30,0.267,12,19,0.632,98,41,83,0.494,27,50,0.54,14,33,0.424,16,20,0.8,112,2017-03-06,PHI,MIL,2017,119.0
8194,8194,94,@,L 98-115 ,240,39,89,0.438,32,63,0.508,7,26,0.269,13,22,0.591,98,44,88,0.5,33,65,0.508,11,23,0.478,16,19,0.842,115,2017-03-08,DET,IND,2017,120.5
8195,8195,95,Home,W 98-91 ,240,37,89,0.416,30,64,0.469,7,25,0.28,17,21,0.81,98,36,81,0.444,24,53,0.453,12,28,0.429,7,11,0.636,91,2017-03-08,ORL,CHI,2017,97.0
8196,8196,96,Home,L 98-114 ,240,37,83,0.446,30,63,0.476,7,20,0.35,17,22,0.773,98,40,78,0.513,29,48,0.604,11,30,0.367,23,28,0.821,114,2017-03-09,MEM,LAC,2017,119.5
8197,8197,97,Home,W 97-89 ,240,34,72,0.472,24,53,0.453,10,19,0.526,19,26,0.731,97,30,81,0.37,22,53,0.415,8,28,0.286,21,26,0.808,89,2011-12-25,OKC,ORL,2012,93.0
8198,8198,98,Home,W 97-78 ,240,36,79,0.456,32,67,0.478,4,12,0.333,21,25,0.84,97,29,78,0.372,22,61,0.361,7,17,0.412,13,18,0.722,78,2011-12-28,NOP,BOS,2012,81.5
8199,8199,99,@,L 97-107 ,240,35,88,0.398,27,62,0.435,8,26,0.308,19,23,0.826,97,41,77,0.532,32,55,0.582,9,22,0.409,16,18,0.889,107,2011-12-31,PHO,OKC,2012,111.5
8200,8200,0,Home,W 97-90 ,240,37,77,0.481,34,66,0.515,3,11,0.273,20,29,0.69,97,38,77,0.494,34,63,0.54,4,14,0.286,10,19,0.526,90,2012-01-06,LAL,GSW,2012,92.0
8201,8201,1,@,W 97-83 ,240,38,86,0.442,30,72,0.417,8,14,0.571,13,17,0.765,97,30,75,0.4,23,55,0.418,7,20,0.35,16,21,0.762,83,2012-01-06,CHI,ORL,2012,86.5
8202,8202,2,@,W 97-85 ,240,31,80,0.388,16,49,0.327,15,31,0.484,20,27,0.741,97,33,73,0.452,27,56,0.482,6,17,0.353,13,19,0.684,85,2012-01-06,BRK,TOR,2012,88.0
8203,8203,3,Home,W 97-62 ,240,36,83,0.434,31,62,0.5,5,21,0.238,20,27,0.741,97,27,85,0.318,26,73,0.356,1,12,0.083,7,12,0.583,62,2012-01-07,PHI,TOR,2012,62.5
8204,8204,4,Home,L 97-104 ,240,38,73,0.521,35,53,0.66,3,20,0.15,18,24,0.75,97,37,87,0.425,27,55,0.491,10,32,0.313,20,31,0.645,104,2012-01-08,SAC,ORL,2012,109.0
8205,8205,5,Home,W 97-87 ,240,34,77,0.442,31,58,0.534,3,19,0.158,26,28,0.929,97,27,80,0.338,20,56,0.357,7,24,0.292,26,33,0.788,87,2012-01-09,TOR,MIN,2012,90.5
8206,8206,6,@,L 97-105 ,240,37,83,0.446,31,60,0.517,6,23,0.261,17,24,0.708,97,37,72,0.514,32,58,0.552,5,14,0.357,26,32,0.813,105,2012-01-10,LAC,POR,2012,107.5
8207,8207,7,Home,W 97-92 ,240,37,76,0.487,32,62,0.516,5,14,0.357,18,23,0.783,97,32,85,0.376,24,61,0.393,8,24,0.333,20,25,0.8,92,2012-01-13,LAL,CLE,2012,96.0
8208,8208,8,Home,W 97-83 ,240,35,94,0.372,30,78,0.385,5,16,0.313,22,23,0.957,97,32,83,0.386,27,68,0.397,5,15,0.333,14,18,0.778,83,2012-01-14,IND,BOS,2012,85.5
8209,8209,9,@,W 97-88 ,240,36,80,0.45,29,61,0.475,7,19,0.368,18,19,0.947,97,34,87,0.391,28,73,0.384,6,14,0.429,14,16,0.875,88,2012-01-16,OKC,BOS,2012,91.0
8210,8210,10,@,L 97-118 ,240,38,74,0.514,33,63,0.524,5,11,0.455,16,19,0.842,97,47,88,0.534,42,78,0.538,5,10,0.5,19,24,0.792,118,2012-01-17,PHO,CHI,2012,120.5
8211,8211,11,Home,W 97-80 ,240,40,81,0.494,32,62,0.516,8,19,0.421,9,12,0.75,97,34,83,0.41,30,70,0.429,4,13,0.308,8,9,0.889,80,2012-01-17,HOU,DET,2012,82.0
8212,8212,12,Home,W 97-87 ,240,38,86,0.442,31,59,0.525,7,27,0.259,14,15,0.933,97,37,79,0.468,32,65,0.492,5,14,0.357,8,15,0.533,87,2012-01-22,BRK,CHA,2012,89.5
8213,8213,13,@,W 97-92 ,240,38,83,0.458,35,72,0.486,3,11,0.273,18,21,0.857,97,37,92,0.402,32,75,0.427,5,17,0.294,13,17,0.765,92,2012-01-23,ATL,MIL,2012,94.5
8214,8214,14,Home,W 97-84 ,240,31,72,0.431,26,50,0.52,5,22,0.227,30,36,0.833,97,34,90,0.378,31,76,0.408,3,14,0.214,13,17,0.765,84,2012-01-24,POR,MEM,2012,85.5
8215,8215,15,@,W 97-90 (OT),265,37,82,0.451,25,55,0.455,12,27,0.444,11,14,0.786,97,35,79,0.443,30,65,0.462,5,14,0.357,15,19,0.789,90,2012-01-25,BRK,PHI,2012,92.5
8216,8216,16,Home,W 97-84 ,240,38,77,0.494,34,65,0.523,4,12,0.333,17,22,0.773,97,34,89,0.382,29,63,0.46,5,26,0.192,11,15,0.733,84,2012-01-28,HOU,NYK,2012,86.5
8217,8217,17,Home,W 97-93 ,240,32,78,0.41,29,70,0.414,3,8,0.375,30,40,0.75,97,35,81,0.432,32,70,0.457,3,11,0.273,20,28,0.714,93,2012-01-29,MIA,CHI,2012,94.5
8218,8218,18,@,L 97-100 (OT),265,35,80,0.438,28,57,0.491,7,23,0.304,20,27,0.741,97,33,86,0.384,27,74,0.365,6,12,0.5,28,35,0.8,100,2012-01-31,DEN,MEM,2012,103.0
8219,8219,19,@,L 97-105 ,240,34,73,0.466,25,53,0.472,9,20,0.45,20,24,0.833,97,39,88,0.443,29,65,0.446,10,23,0.435,17,25,0.68,105,2012-02-01,MIA,MIL,2012,110.0
8220,8220,20,@,L 97-117 ,240,35,79,0.443,30,57,0.526,5,22,0.227,22,24,0.917,97,46,86,0.535,31,53,0.585,15,33,0.455,10,12,0.833,117,2012-02-04,DEN,POR,2012,124.5
8221,8221,21,Home,W 97-87 ,240,35,76,0.461,26,55,0.473,9,21,0.429,18,24,0.75,97,33,75,0.44,28,61,0.459,5,14,0.357,16,23,0.696,87,2012-02-08,ATL,IND,2012,89.5
8222,8222,22,Home,L 97-104 ,240,32,79,0.405,26,56,0.464,6,23,0.261,27,31,0.871,97,39,90,0.433,30,69,0.435,9,21,0.429,17,23,0.739,104,2012-02-10,MIN,DAL,2012,108.5
8223,8223,23,Home,W 97-94 (2OT),290,39,84,0.464,33,65,0.508,6,19,0.316,13,19,0.684,97,36,97,0.371,33,77,0.429,3,20,0.15,19,21,0.905,94,2012-02-11,DAL,POR,2012,95.5
8224,8224,24,@,L 97-106 ,240,31,75,0.413,20,46,0.435,11,29,0.379,24,33,0.727,97,40,79,0.506,27,55,0.491,13,24,0.542,13,18,0.722,106,2012-02-12,HOU,GSW,2012,112.5
8225,8225,25,@,W 97-85 ,240,34,85,0.4,24,63,0.381,10,22,0.455,19,25,0.76,97,33,84,0.393,30,71,0.423,3,13,0.231,16,27,0.593,85,2012-02-18,BRK,CHI,2012,86.5
8226,8226,26,Home,W 97-77 ,240,38,81,0.469,29,59,0.492,9,22,0.409,12,16,0.75,97,30,73,0.411,23,46,0.5,7,27,0.259,10,13,0.769,77,2012-02-18,POR,ATL,2012,80.5
8227,8227,27,@,L 97-104 ,240,36,81,0.444,24,48,0.5,12,33,0.364,13,17,0.765,97,40,86,0.465,28,57,0.491,12,29,0.414,12,18,0.667,104,2012-02-19,DAL,NYK,2012,110.0
8228,8228,28,@,L 97-104 ,240,33,77,0.429,22,51,0.431,11,26,0.423,20,27,0.741,97,38,83,0.458,29,60,0.483,9,23,0.391,19,24,0.792,104,2012-02-20,LAC,GSW,2012,108.5
8229,8229,29,Home,W 97-93 ,240,35,74,0.473,28,52,0.538,7,22,0.318,20,25,0.8,97,38,79,0.481,35,66,0.53,3,13,0.231,14,18,0.778,93,2012-02-20,HOU,MEM,2012,94.5
8230,8230,30,@,L 97-137 ,240,32,84,0.381,24,64,0.375,8,20,0.4,25,32,0.781,97,51,86,0.593,36,58,0.621,15,28,0.536,20,24,0.833,137,2012-02-21,SAS,POR,2012,144.5
8231,8231,31,@,W 97-68 ,240,42,84,0.5,37,71,0.521,5,13,0.385,8,9,0.889,97,25,79,0.316,23,69,0.333,2,10,0.2,16,20,0.8,68,2012-02-28,PHI,DET,2012,69.0
8232,8232,32,Home,L 97-109 ,240,40,85,0.471,38,74,0.514,2,11,0.182,15,22,0.682,97,40,78,0.513,30,56,0.536,10,22,0.455,19,27,0.704,109,2012-02-28,LAC,MIN,2012,114.0
8233,8233,33,Home,W 97-92 ,240,40,88,0.455,37,75,0.493,3,13,0.231,14,17,0.824,97,37,83,0.446,26,54,0.481,11,29,0.379,7,10,0.7,92,2012-03-02,NOP,DAL,2012,97.5
8234,8234,34,Home,W 97-90 ,240,37,85,0.435,29,68,0.426,8,17,0.471,15,22,0.682,97,30,73,0.411,24,50,0.48,6,23,0.261,24,29,0.828,90,2012-03-03,ATL,OKC,2012,93.0
8235,8235,35,Home,W 97-93 ,240,35,88,0.398,28,68,0.412,7,20,0.35,20,23,0.87,97,35,94,0.372,28,75,0.373,7,19,0.368,16,23,0.696,93,2012-03-05,MIL,PHI,2012,96.5
8236,8236,36,Home,W 97-92 (OT),265,35,81,0.432,31,67,0.463,4,14,0.286,23,31,0.742,97,32,83,0.386,27,64,0.422,5,19,0.263,23,29,0.793,92,2012-03-06,BOS,HOU,2012,94.5
8237,8237,37,@,L 97-110 ,240,33,72,0.458,29,61,0.475,4,11,0.364,27,32,0.844,97,41,73,0.562,35,50,0.7,6,23,0.261,22,32,0.688,110,2012-03-09,NOP,DEN,2012,113.0
8238,8238,38,@,L 97-110 ,240,39,86,0.453,33,64,0.516,6,22,0.273,13,18,0.722,97,43,85,0.506,32,58,0.552,11,27,0.407,13,13,1.0,110,2012-03-09,DAL,SAC,2012,115.5
8239,8239,39,@,L 97-111 ,240,40,85,0.471,40,82,0.488,0,3,0.0,17,22,0.773,97,43,77,0.558,36,59,0.61,7,18,0.389,18,24,0.75,111,2012-03-10,UTA,CHI,2012,114.5
8240,8240,40,@,W 97-93 ,240,36,70,0.514,28,55,0.509,8,15,0.533,17,21,0.81,97,34,79,0.43,28,60,0.467,6,19,0.316,19,35,0.543,93,2012-03-11,GSW,LAC,2012,96.0
8241,8241,41,Home,W 97-94 ,240,36,71,0.507,28,55,0.509,8,16,0.5,17,26,0.654,97,39,83,0.47,33,66,0.5,6,17,0.353,10,12,0.833,94,2012-03-11,LAL,BOS,2012,97.0
8242,8242,42,@,L 97-112 ,240,39,87,0.448,31,70,0.443,8,17,0.471,11,14,0.786,97,47,87,0.54,39,65,0.6,8,22,0.364,10,19,0.526,112,2012-03-12,WAS,SAS,2012,116.0
8243,8243,43,Home,W 97-92 ,240,33,80,0.413,23,58,0.397,10,22,0.455,21,27,0.778,97,37,92,0.402,33,70,0.471,4,22,0.182,14,20,0.7,92,2012-03-16,LAL,MIN,2012,94.0
8244,8244,44,Home,W 97-92 ,240,34,85,0.4,32,78,0.41,2,7,0.286,27,37,0.73,97,37,78,0.474,31,60,0.517,6,18,0.333,12,19,0.632,92,2012-03-18,MEM,WAS,2012,95.0
8245,8245,45,@,W 97-93 ,240,35,74,0.473,26,53,0.491,9,21,0.429,18,23,0.783,97,34,80,0.425,24,54,0.444,10,26,0.385,15,20,0.75,93,2012-03-19,MIN,GSW,2012,98.0
8246,8246,46,Home,W 97-90 ,240,38,80,0.475,33,70,0.471,5,10,0.5,16,22,0.727,97,30,71,0.423,22,52,0.423,8,19,0.421,22,30,0.733,90,2012-03-20,UTA,OKC,2012,94.0
8247,8247,47,Home,W 97-90 ,240,34,59,0.576,32,54,0.593,2,5,0.4,27,34,0.794,97,35,90,0.389,30,63,0.476,5,27,0.185,15,24,0.625,90,2012-03-22,NOP,LAC,2012,92.5
8248,8248,48,Home,W 97-93 ,240,31,73,0.425,21,48,0.438,10,25,0.4,25,25,1.0,97,37,81,0.457,34,73,0.466,3,8,0.375,16,23,0.696,93,2012-03-22,POR,MEM,2012,94.5
8249,8249,49,Home,W 97-85 ,240,37,74,0.5,29,48,0.604,8,26,0.308,15,21,0.714,97,31,62,0.5,29,51,0.569,2,11,0.182,21,31,0.677,85,2012-03-26,LAC,NOH,2012,86.0
8250,8250,50,@,L 97-98 ,240,39,78,0.5,31,59,0.525,8,19,0.421,11,15,0.733,97,39,75,0.52,31,54,0.574,8,21,0.381,12,19,0.632,98,2012-03-30,POR,LAC,2012,102.0
8251,8251,51,Home,W 97-76 ,240,42,87,0.483,35,70,0.5,7,17,0.412,6,6,1.0,97,30,82,0.366,27,68,0.397,3,14,0.214,13,17,0.765,76,2012-03-30,WAS,PHI,2012,77.5
8252,8252,52,Home,L 97-102 ,240,35,81,0.432,23,59,0.39,12,22,0.545,15,18,0.833,97,41,84,0.488,37,69,0.536,4,15,0.267,16,21,0.762,102,2012-04-02,POR,UTA,2012,104.0
8253,8253,53,@,W 97-94 ,240,41,86,0.477,37,70,0.529,4,16,0.25,11,16,0.688,97,37,87,0.425,28,56,0.5,9,31,0.29,11,16,0.688,94,2012-04-04,GSW,MIN,2012,98.5
8254,8254,54,Home,L 97-99 (OT),265,42,93,0.452,35,69,0.507,7,24,0.292,6,8,0.75,97,41,94,0.436,33,73,0.452,8,21,0.381,9,11,0.818,99,2012-04-06,DAL,POR,2012,103.0
8255,8255,55,@,W 97-82 ,240,38,82,0.463,30,65,0.462,8,17,0.471,13,17,0.765,97,33,82,0.402,29,64,0.453,4,18,0.222,12,16,0.75,82,2012-04-06,MEM,MIA,2012,84.0
8256,8256,56,@,L 97-112 ,240,37,80,0.463,29,55,0.527,8,25,0.32,15,20,0.75,97,46,88,0.523,38,67,0.567,8,21,0.381,12,16,0.75,112,2012-04-07,DEN,GSW,2012,116.0
8257,8257,57,@,L 97-107 ,240,36,85,0.424,32,66,0.485,4,19,0.211,21,27,0.778,97,37,76,0.487,30,56,0.536,7,20,0.35,26,31,0.839,107,2012-04-12,MEM,SAS,2012,110.5
8258,8258,58,Home,L 97-113 ,240,37,78,0.474,34,68,0.5,3,10,0.3,20,24,0.833,97,45,87,0.517,40,72,0.556,5,15,0.333,18,22,0.818,113,2012-04-13,DET,MIL,2012,115.5
8259,8259,59,@,L 97-103 ,240,41,92,0.446,36,75,0.48,5,17,0.294,10,15,0.667,97,38,75,0.507,31,60,0.517,7,15,0.467,20,29,0.69,103,2012-04-13,DEN,LAL,2012,106.5
8260,8260,60,@,W 97-94 ,240,40,83,0.482,31,63,0.492,9,20,0.45,8,10,0.8,97,35,83,0.422,29,58,0.5,6,25,0.24,18,23,0.783,94,2012-04-13,DAL,POR,2012,97.0
8261,8261,61,Home,L 97-102 ,240,34,76,0.447,29,62,0.468,5,14,0.357,24,32,0.75,97,37,89,0.416,24,65,0.369,13,24,0.542,15,18,0.833,102,2012-04-17,PHI,IND,2012,108.5
8262,8262,62,Home,L 97-109 ,240,34,83,0.41,28,63,0.444,6,20,0.3,23,32,0.719,97,36,80,0.45,30,64,0.469,6,16,0.375,31,34,0.912,109,2012-04-18,PHO,OKC,2012,112.0
8263,8263,63,Home,W 97-92 ,240,37,72,0.514,28,55,0.509,9,17,0.529,14,17,0.824,97,39,81,0.481,34,69,0.493,5,12,0.417,9,14,0.643,92,2012-04-20,ATL,BOS,2012,94.5
8264,8264,64,@,L 97-121 ,240,33,76,0.434,27,62,0.435,6,14,0.429,25,30,0.833,97,47,77,0.61,37,62,0.597,10,15,0.667,17,18,0.944,121,2012-04-20,LAL,SAS,2012,126.0
8265,8265,65,Home,W 97-88 ,240,35,85,0.412,30,69,0.435,5,16,0.313,22,24,0.917,97,35,76,0.461,28,56,0.5,7,20,0.35,11,13,0.846,88,2012-04-22,MIA,HOU,2012,91.5
8266,8266,66,@,L 97-103 ,240,38,83,0.458,30,67,0.448,8,16,0.5,13,22,0.591,97,35,92,0.38,31,77,0.403,4,15,0.267,29,38,0.763,103,2012-04-23,DET,IND,2012,105.0
8267,8267,67,@,L 97-109 ,240,35,78,0.449,29,66,0.439,6,12,0.5,21,25,0.84,97,41,92,0.446,31,62,0.5,10,30,0.333,17,22,0.773,109,2012-11-06,DET,DEN,2013,114.0
8268,8268,68,@,W 97-91 ,240,36,73,0.493,31,60,0.517,5,13,0.385,20,21,0.952,97,35,84,0.417,30,69,0.435,5,15,0.333,16,18,0.889,91,2012-11-08,OKC,CHI,2013,93.5
8269,8269,69,@,W 97-86 ,240,35,72,0.486,30,54,0.556,5,18,0.278,22,26,0.846,97,32,91,0.352,29,75,0.387,3,16,0.188,19,26,0.731,86,2012-11-09,SAS,SAC,2013,87.5
8270,8270,70,@,L 97-101 (OT),265,32,79,0.405,23,60,0.383,9,19,0.474,24,30,0.8,97,40,95,0.421,37,75,0.493,3,20,0.15,18,28,0.643,101,2012-11-10,DAL,CHA,2013,102.5
8271,8271,71,Home,L 97-107 ,240,35,72,0.486,29,59,0.492,6,13,0.462,21,26,0.808,97,44,93,0.473,37,76,0.487,7,17,0.412,12,14,0.857,107,2012-11-14,OKC,MEM,2013,110.5
8272,8272,72,@,L 97-102 ,240,35,75,0.467,28,62,0.452,7,13,0.538,20,25,0.8,97,36,85,0.424,28,63,0.444,8,22,0.364,22,28,0.786,102,2012-11-15,BOS,BRK,2013,106.0
8273,8273,73,@,W 97-88 ,240,38,71,0.535,30,52,0.577,8,19,0.421,13,19,0.684,97,34,79,0.43,29,61,0.475,5,18,0.278,15,21,0.714,88,2012-11-17,MIA,PHO,2013,90.5
8274,8274,74,Home,W 97-86 ,240,38,80,0.475,31,62,0.5,7,18,0.389,14,23,0.609,97,32,80,0.4,28,67,0.418,4,13,0.308,18,21,0.857,86,2012-11-18,TOR,ORL,2013,88.0
8275,8275,75,@,W 97-92 ,240,36,81,0.444,31,66,0.47,5,15,0.333,20,28,0.714,97,36,78,0.462,30,61,0.492,6,17,0.353,14,17,0.824,92,2012-11-19,DEN,MEM,2013,95.0
8276,8276,76,@,L 97-98 ,240,37,80,0.463,28,57,0.491,9,23,0.391,14,20,0.7,97,36,86,0.419,33,67,0.493,3,19,0.158,23,28,0.821,98,2012-11-21,TOR,CHA,2013,99.5
8277,8277,77,@,L 97-113 ,240,29,65,0.446,17,39,0.436,12,26,0.462,27,39,0.692,97,44,81,0.543,37,66,0.561,7,15,0.467,18,22,0.818,113,2012-11-21,LAL,SAC,2013,116.5
8278,8278,78,Home,L 97-104 ,240,38,92,0.413,31,76,0.408,7,16,0.438,14,21,0.667,97,41,83,0.494,39,66,0.591,2,17,0.118,20,22,0.909,104,2012-11-23,IND,SAS,2013,105.0
8279,8279,79,@,L 97-108 ,240,32,79,0.405,21,54,0.389,11,25,0.44,22,30,0.733,97,40,74,0.541,34,58,0.586,6,16,0.375,22,32,0.688,108,2012-11-24,UTA,SAC,2013,111.0
8280,8280,80,@,W 97-89 ,240,38,83,0.458,32,61,0.525,6,22,0.273,15,18,0.833,97,37,84,0.44,31,67,0.463,6,17,0.353,9,14,0.643,89,2012-11-27,MIN,SAC,2013,92.0
8281,8281,81,@,W 97-92 ,240,37,85,0.435,28,59,0.475,9,26,0.346,14,19,0.737,97,32,75,0.427,26,58,0.448,6,17,0.353,22,25,0.88,92,2012-11-30,IND,SAC,2013,95.0
8282,8282,82,@,L 97-101 ,240,37,77,0.481,31,61,0.508,6,16,0.375,17,19,0.895,97,39,81,0.481,31,67,0.463,8,14,0.571,15,22,0.682,101,2012-11-30,PHO,TOR,2013,105.0
8283,8283,83,Home,L 97-104 ,240,35,79,0.443,29,58,0.5,6,21,0.286,21,31,0.677,97,34,75,0.453,25,51,0.49,9,24,0.375,27,34,0.794,104,2012-12-05,DET,GSW,2013,108.5
8284,8284,84,@,W 97-94 ,240,37,78,0.474,33,66,0.5,4,12,0.333,19,24,0.792,97,34,85,0.4,26,64,0.406,8,21,0.381,18,25,0.72,94,2012-12-06,DAL,PHO,2013,98.0
8285,8285,85,Home,L 97-104 ,240,39,91,0.429,33,64,0.516,6,27,0.222,13,17,0.765,97,35,75,0.467,26,60,0.433,9,15,0.6,25,33,0.758,104,2012-12-08,CLE,DET,2013,108.5
8286,8286,86,Home,L 97-101 ,240,37,87,0.425,28,62,0.452,9,25,0.36,14,23,0.609,97,35,81,0.432,26,59,0.441,9,22,0.409,22,27,0.815,101,2012-12-08,WAS,GSW,2013,105.5
8287,8287,87,@,W 97-88 ,240,33,71,0.465,26,55,0.473,7,16,0.438,24,30,0.8,97,32,79,0.405,25,54,0.463,7,25,0.28,17,23,0.739,88,2012-12-09,MIL,BRK,2013,91.5
8288,8288,88,@,L 97-104 ,240,32,81,0.395,27,63,0.429,5,18,0.278,28,33,0.848,97,44,82,0.537,40,71,0.563,4,11,0.364,12,23,0.522,104,2012-12-10,DET,PHI,2013,106.0
8289,8289,89,Home,L 97-100 ,240,36,68,0.529,32,50,0.64,4,18,0.222,21,28,0.75,97,36,78,0.462,22,50,0.44,14,28,0.5,14,18,0.778,100,2012-12-11,BRK,NYK,2013,107.0
8290,8290,90,@,W 97-95 ,240,38,82,0.463,29,58,0.5,9,24,0.375,12,14,0.857,97,38,80,0.475,31,58,0.534,7,22,0.318,12,15,0.8,95,2012-12-12,GSW,MIA,2013,98.5
8291,8291,91,Home,L 97-122 ,240,31,91,0.341,25,67,0.373,6,24,0.25,29,34,0.853,97,46,85,0.541,38,67,0.567,8,18,0.444,22,29,0.759,122,2012-12-16,SAC,DEN,2013,126.0
8292,8292,92,Home,W 97-91 ,240,35,72,0.486,25,43,0.581,10,29,0.345,17,22,0.773,97,35,84,0.417,32,72,0.444,3,12,0.25,18,30,0.6,91,2012-12-19,TOR,DET,2013,92.5
8293,8293,93,Home,W 97-85 ,240,37,87,0.425,30,64,0.469,7,23,0.304,16,24,0.667,97,33,79,0.418,25,57,0.439,8,22,0.364,11,16,0.688,85,2012-12-21,LAC,SAC,2013,89.0
8294,8294,94,@,W 97-93 ,240,36,83,0.434,29,65,0.446,7,18,0.389,18,25,0.72,97,38,76,0.5,29,56,0.518,9,20,0.45,8,15,0.533,93,2012-12-23,UTA,ORL,2013,97.5
8295,8295,95,Home,L 97-120 ,240,37,83,0.446,31,63,0.492,6,20,0.3,17,20,0.85,97,46,82,0.561,38,62,0.613,8,20,0.4,20,24,0.833,120,2012-12-25,CHI,HOU,2013,124.0
8296,8296,96,@,L 97-103 ,240,30,71,0.423,25,55,0.455,5,16,0.313,32,38,0.842,97,38,80,0.475,30,52,0.577,8,28,0.286,19,19,1.0,103,2012-12-25,OKC,MIA,2013,107.0
8297,8297,97,@,W 97-94 ,240,38,76,0.5,36,64,0.563,2,12,0.167,19,20,0.95,97,36,79,0.456,25,49,0.51,11,30,0.367,11,13,0.846,94,2012-12-26,NOP,ORL,2013,99.5
8298,8298,98,Home,L 97-99 ,240,38,83,0.458,30,62,0.484,8,21,0.381,13,16,0.813,97,40,88,0.455,31,66,0.47,9,22,0.409,10,14,0.714,99,2012-12-26,PHO,NYK,2013,103.5
8299,8299,99,Home,W 97-81 ,240,34,76,0.447,25,49,0.51,9,27,0.333,20,26,0.769,97,28,73,0.384,25,63,0.397,3,10,0.3,22,32,0.688,81,2012-12-28,BRK,CHA,2013,82.5
8300,8300,0,Home,W 97-91 ,240,34,77,0.442,26,61,0.426,8,16,0.5,21,29,0.724,97,38,82,0.463,36,68,0.529,2,14,0.143,13,16,0.813,91,2012-12-28,IND,PHO,2013,92.0
8301,8301,1,Home,L 97-104 (OT),265,37,82,0.451,32,69,0.464,5,13,0.385,18,24,0.75,97,37,85,0.435,32,61,0.525,5,24,0.208,25,32,0.781,104,2012-12-28,NOP,TOR,2013,106.5
8302,8302,2,@,L 97-105 ,240,39,86,0.453,29,58,0.5,10,28,0.357,9,11,0.818,97,42,88,0.477,36,68,0.529,6,20,0.3,15,17,0.882,105,2012-12-28,ORL,WAS,2013,108.0
8303,8303,3,@,L 97-103 ,240,36,86,0.419,27,60,0.45,9,26,0.346,16,21,0.762,97,39,75,0.52,31,55,0.564,8,20,0.4,17,22,0.773,103,2013-01-01,SAC,DET,2013,107.0
8304,8304,4,@,W 97-94 ,240,38,88,0.432,35,72,0.486,3,16,0.188,18,23,0.783,97,34,87,0.391,29,66,0.439,5,21,0.238,21,24,0.875,94,2013-01-02,SAC,CLE,2013,96.5
8305,8305,5,Home,L 97-101 ,240,40,86,0.465,34,64,0.531,6,22,0.273,11,20,0.55,97,37,83,0.446,31,67,0.463,6,16,0.375,21,30,0.7,101,2013-01-03,DEN,MIN,2013,104.0
8306,8306,6,Home,L 97-102 ,240,38,91,0.418,33,75,0.44,5,16,0.313,16,18,0.889,97,37,86,0.43,21,62,0.339,16,24,0.667,12,13,0.923,102,2013-01-05,MIN,POR,2013,110.0
8307,8307,7,@,L 97-103 ,240,35,92,0.38,20,49,0.408,15,43,0.349,12,19,0.632,97,41,86,0.477,35,71,0.493,6,15,0.4,15,18,0.833,103,2013-01-11,POR,GSW,2013,106.0
8308,8308,8,@,W 97-81 ,240,36,73,0.493,30,59,0.508,6,14,0.429,19,25,0.76,97,32,88,0.364,30,77,0.39,2,11,0.182,15,21,0.714,81,2013-01-12,PHO,CHI,2013,82.0
8309,8309,9,Home,W 97-86 ,240,33,81,0.407,27,67,0.403,6,14,0.429,25,31,0.806,97,35,83,0.422,29,59,0.492,6,24,0.25,10,12,0.833,86,2013-01-13,BRK,IND,2013,89.0
8310,8310,10,Home,W 97-58 ,240,33,79,0.418,27,65,0.415,6,14,0.429,25,33,0.758,97,24,82,0.293,22,68,0.324,2,14,0.143,8,10,0.8,58,2013-01-14,CHI,ATL,2013,59.0
8311,8311,11,@,L 97-104 ,240,39,72,0.542,30,49,0.612,9,23,0.391,10,16,0.625,97,36,76,0.474,28,58,0.483,8,18,0.444,24,28,0.857,104,2013-01-14,MIA,UTA,2013,108.0
8312,8312,12,@,L 97-117 ,240,33,73,0.452,31,58,0.534,2,15,0.133,29,37,0.784,97,44,85,0.518,35,66,0.53,9,19,0.474,20,26,0.769,117,2013-01-16,DEN,OKC,2013,121.5
8313,8313,13,Home,W 97-86 ,240,40,86,0.465,28,65,0.431,12,21,0.571,5,5,1.0,97,37,85,0.435,35,68,0.515,2,17,0.118,10,12,0.833,86,2013-01-16,ORL,IND,2013,87.0
8314,8314,14,@,W 97-93 ,240,37,81,0.457,32,63,0.508,5,18,0.278,18,21,0.857,97,31,72,0.431,26,57,0.456,5,15,0.333,26,38,0.684,93,2013-01-19,SAC,CHA,2013,95.5
8315,8315,15,Home,L 97-109 ,240,39,84,0.464,35,68,0.515,4,16,0.25,15,21,0.714,97,41,78,0.526,26,51,0.51,15,27,0.556,12,14,0.857,109,2013-01-22,LAC,OKC,2013,116.5
8316,8316,16,@,W 97-95 ,240,39,78,0.5,35,62,0.565,4,16,0.25,15,19,0.789,97,35,81,0.432,27,63,0.429,8,18,0.444,17,20,0.85,95,2013-01-24,TOR,ORL,2013,99.0
8317,8317,17,Home,W 97-80 ,240,38,75,0.507,32,56,0.571,6,19,0.316,15,22,0.682,97,28,81,0.346,24,54,0.444,4,27,0.148,20,23,0.87,80,2013-01-26,PHI,NYK,2013,82.0
8318,8318,18,Home,W 97-77 ,240,37,74,0.5,24,45,0.533,13,29,0.448,10,12,0.833,97,32,79,0.405,26,52,0.5,6,27,0.222,7,9,0.778,77,2013-01-28,BRK,ORL,2013,80.0
8319,8319,19,@,L 97-113 ,240,38,77,0.494,31,51,0.608,7,26,0.269,14,16,0.875,97,47,82,0.573,33,48,0.688,14,34,0.412,5,8,0.625,113,2013-01-30,ORL,NYK,2013,120.0
8320,8320,20,@,L 97-100 ,240,36,81,0.444,28,56,0.5,8,25,0.32,17,24,0.708,97,36,84,0.429,29,64,0.453,7,20,0.35,21,25,0.84,100,2013-01-31,DAL,GSW,2013,103.5
8321,8321,21,Home,W 97-84 ,240,42,84,0.5,38,66,0.576,4,18,0.222,9,14,0.643,97,36,95,0.379,33,76,0.434,3,19,0.158,9,9,1.0,84,2013-02-01,BOS,ORL,2013,85.5
8322,8322,22,Home,L 97-98 ,240,41,92,0.446,36,78,0.462,5,14,0.357,10,15,0.667,97,39,83,0.47,33,63,0.524,6,20,0.3,14,22,0.636,98,2013-02-03,DET,LAL,2013,101.0
8323,8323,23,@,L 97-107 ,240,35,70,0.5,28,58,0.483,7,12,0.583,20,26,0.769,97,44,80,0.55,38,64,0.594,6,16,0.375,13,14,0.929,107,2013-02-10,LAL,MIA,2013,110.0
8324,8324,24,@,W 97-69 ,240,34,76,0.447,25,59,0.424,9,17,0.529,20,27,0.741,97,30,91,0.33,26,77,0.338,4,14,0.286,5,5,1.0,69,2013-02-10,OKC,PHO,2013,71.0
8325,8325,25,@,W 97-93 ,240,38,87,0.437,36,76,0.474,2,11,0.182,19,25,0.76,97,29,85,0.341,24,63,0.381,5,22,0.227,30,38,0.789,93,2013-02-13,UTA,MIN,2013,95.5
8326,8326,26,Home,W 97-90 ,240,33,77,0.429,26,57,0.456,7,20,0.35,24,36,0.667,97,35,79,0.443,28,59,0.475,7,20,0.35,13,16,0.813,90,2013-02-19,DEN,BOS,2013,93.5
8327,8327,27,@,W 97-94 ,240,34,85,0.4,25,59,0.424,9,26,0.346,20,26,0.769,97,35,75,0.467,29,61,0.475,6,14,0.429,18,31,0.581,94,2013-02-20,BRK,MIL,2013,97.0
8328,8328,28,@,W 97-87 ,240,32,72,0.444,27,55,0.491,5,17,0.294,28,35,0.8,97,30,81,0.37,27,72,0.375,3,9,0.333,24,33,0.727,87,2013-02-24,SAS,PHO,2013,88.5
8329,8329,29,@,L 97-108 ,240,33,76,0.434,21,55,0.382,12,21,0.571,19,24,0.792,97,41,84,0.488,35,63,0.556,6,21,0.286,20,27,0.741,108,2013-02-26,GSW,IND,2013,111.0
8330,8330,30,Home,L 97-101 ,240,40,87,0.46,35,73,0.479,5,14,0.357,12,15,0.8,97,37,76,0.487,25,56,0.446,12,20,0.6,15,18,0.833,101,2013-02-26,NOP,BRK,2013,107.0
8331,8331,31,@,L 97-104 ,240,36,86,0.419,26,60,0.433,10,26,0.385,15,19,0.789,97,44,85,0.518,32,67,0.478,12,18,0.667,4,9,0.444,104,2013-03-02,GSW,PHI,2013,110.0
8332,8332,32,Home,W 97-92 ,240,33,71,0.465,27,58,0.466,6,13,0.462,25,33,0.758,97,35,81,0.432,27,62,0.435,8,19,0.421,14,18,0.778,92,2013-03-03,IND,CHI,2013,96.0
8333,8333,33,Home,L 97-102 ,240,37,73,0.507,31,53,0.585,6,20,0.3,17,24,0.708,97,36,78,0.462,24,48,0.5,12,30,0.4,18,21,0.857,102,2013-03-04,CLE,NYK,2013,108.0
8334,8334,34,@,W 97-81 ,240,38,74,0.514,33,53,0.623,5,21,0.238,16,19,0.842,97,33,88,0.375,28,68,0.412,5,20,0.25,10,15,0.667,81,2013-03-04,MIA,MIN,2013,83.5
8335,8335,35,Home,W 97-96 ,240,32,74,0.432,26,46,0.565,6,28,0.214,27,31,0.871,97,40,89,0.449,34,61,0.557,6,28,0.214,10,12,0.833,96,2013-03-06,MIA,ORL,2013,99.0
8336,8336,36,@,L 97-129 ,240,30,64,0.469,19,41,0.463,11,23,0.478,26,42,0.619,97,50,80,0.625,36,52,0.692,14,28,0.5,15,25,0.6,129,2013-03-10,DET,LAC,2013,136.0
8337,8337,37,@,L 97-106 ,240,40,81,0.494,34,62,0.548,6,19,0.316,11,16,0.688,97,40,76,0.526,32,61,0.525,8,15,0.533,18,27,0.667,106,2013-03-11,BRK,PHI,2013,110.0
8338,8338,38,Home,L 97-106 ,240,37,93,0.398,27,61,0.443,10,32,0.313,13,17,0.765,97,34,73,0.466,25,48,0.521,9,25,0.36,29,47,0.617,106,2013-03-12,ORL,LAL,2013,110.5
8339,8339,39,Home,L 97-102 ,240,32,79,0.405,27,63,0.429,5,16,0.313,28,29,0.966,97,39,76,0.513,36,65,0.554,3,11,0.273,21,31,0.677,102,2013-03-12,POR,MEM,2013,103.5
8340,8340,40,@,L 97-105 ,240,40,89,0.449,35,72,0.486,5,17,0.294,12,14,0.857,97,41,72,0.569,33,54,0.611,8,18,0.444,15,25,0.6,105,2013-03-13,DET,GSW,2013,109.0
8341,8341,41,Home,W 97-95 ,240,36,64,0.563,31,49,0.633,5,15,0.333,20,27,0.741,97,39,85,0.459,34,72,0.472,5,13,0.385,12,16,0.75,95,2013-03-17,MIN,NOH,2013,97.5
8342,8342,42,@,W 97-89 ,240,34,80,0.425,29,59,0.492,5,21,0.238,24,33,0.727,97,38,92,0.413,33,76,0.434,5,16,0.313,8,10,0.8,89,2013-03-22,OKC,ORL,2013,91.5
8343,8343,43,@,L 97-104 (OT),265,41,96,0.427,33,79,0.418,8,17,0.471,7,12,0.583,97,39,84,0.464,31,64,0.484,8,20,0.4,18,24,0.75,104,2013-03-22,UTA,SAS,2013,108.0
8344,8344,44,Home,L 97-104 ,240,39,78,0.5,33,66,0.5,6,12,0.5,13,19,0.684,97,41,89,0.461,31,63,0.492,10,26,0.385,12,17,0.706,104,2013-03-24,MIN,CHI,2013,109.0
8345,8345,45,@,L 97-101 ,240,37,77,0.481,30,57,0.526,7,20,0.35,16,23,0.696,97,40,85,0.471,32,63,0.508,8,22,0.364,13,18,0.722,101,2013-03-27,MIA,CHI,2013,105.0
8346,8346,46,@,W 97-87 ,240,42,86,0.488,35,68,0.515,7,18,0.389,6,10,0.6,97,37,86,0.43,33,68,0.485,4,18,0.222,9,15,0.6,87,2013-03-29,PHI,CLE,2013,89.0
8347,8347,47,Home,W 97-92 ,240,37,86,0.43,32,71,0.451,5,15,0.333,18,22,0.818,97,30,81,0.37,26,61,0.426,4,20,0.2,28,32,0.875,92,2013-03-29,ORL,WAS,2013,94.0
8348,8348,48,Home,W 97-88 ,240,34,78,0.436,28,57,0.491,6,21,0.286,23,31,0.742,97,34,87,0.391,30,74,0.405,4,13,0.308,16,27,0.593,88,2013-03-30,ATL,ORL,2013,90.0
8349,8349,49,@,W 97-91 ,240,36,89,0.404,33,76,0.434,3,13,0.231,22,26,0.846,97,36,89,0.404,30,67,0.448,6,22,0.273,13,22,0.591,91,2013-04-05,CLE,BOS,2013,94.0
8350,8350,50,@,W 97-75 ,240,37,78,0.474,33,66,0.5,4,12,0.333,19,23,0.826,97,27,72,0.375,25,51,0.49,2,21,0.095,19,24,0.792,75,2013-04-05,OKC,IND,2013,76.0
8351,8351,51,@,L 97-99 ,240,35,83,0.422,30,71,0.423,5,12,0.417,22,25,0.88,97,36,80,0.45,33,65,0.508,3,15,0.2,24,29,0.828,99,2013-04-06,ATL,SAS,2013,100.5
8352,8352,52,@,W 97-90 ,240,40,88,0.455,29,63,0.46,11,25,0.44,6,7,0.857,97,35,74,0.473,28,57,0.491,7,17,0.412,13,18,0.722,90,2013-04-07,UTA,GSW,2013,93.5
8353,8353,53,Home,L 97-116 ,240,37,84,0.44,30,68,0.441,7,16,0.438,16,26,0.615,97,42,83,0.506,30,56,0.536,12,27,0.444,20,23,0.87,116,2013-04-11,GSW,OKC,2013,122.0
8354,8354,54,Home,W 97-88 ,240,34,72,0.472,32,64,0.5,2,8,0.25,27,33,0.818,97,34,77,0.442,25,59,0.424,9,18,0.5,11,14,0.786,88,2013-04-12,TOR,CHI,2013,92.5
8355,8355,55,@,W 97-86 ,240,40,93,0.43,33,71,0.465,7,22,0.318,10,11,0.909,97,36,87,0.414,35,74,0.473,1,13,0.077,13,21,0.619,86,2013-04-12,PHI,WAS,2013,86.5
8356,8356,56,Home,L 97-103 ,240,34,76,0.447,25,57,0.439,9,19,0.474,20,25,0.8,97,38,80,0.475,31,59,0.525,7,21,0.333,20,25,0.8,103,2013-04-15,DAL,MEM,2013,106.5
8357,8357,57,Home,W 97-87 ,240,34,71,0.479,27,54,0.5,7,17,0.412,22,32,0.688,97,36,93,0.387,27,74,0.365,9,19,0.474,6,10,0.6,87,2013-10-29,IND,ORL,2014,91.5
8358,8358,58,@,W 97-90 ,240,31,78,0.397,24,55,0.436,7,23,0.304,28,38,0.737,97,37,84,0.44,31,67,0.463,6,17,0.353,10,18,0.556,90,2013-11-02,TOR,MIL,2014,93.0
8359,8359,59,Home,L 97-102 ,240,35,82,0.427,27,54,0.5,8,28,0.286,19,23,0.826,97,30,71,0.423,22,50,0.44,8,21,0.381,34,42,0.81,102,2013-11-05,NYK,CHA,2014,106.0
8360,8360,60,Home,W 97-87 ,240,40,89,0.449,33,69,0.478,7,20,0.35,10,14,0.714,97,37,80,0.463,36,70,0.514,1,10,0.1,12,18,0.667,87,2013-11-06,BOS,UTA,2014,87.5
8361,8361,61,Home,W 97-80 ,240,36,86,0.419,29,68,0.426,7,18,0.389,18,21,0.857,97,26,73,0.356,21,58,0.362,5,15,0.333,23,27,0.852,80,2013-11-06,IND,CHI,2014,82.5
8362,8362,62,@,L 97-102 ,240,36,73,0.493,28,49,0.571,8,24,0.333,17,21,0.81,97,38,71,0.535,33,55,0.6,5,16,0.313,21,33,0.636,102,2013-11-07,LAC,MIA,2014,104.5
8363,8363,63,Home,W 97-73 ,240,38,72,0.528,35,64,0.547,3,8,0.375,18,25,0.72,97,25,85,0.294,18,65,0.277,7,20,0.35,16,25,0.64,73,2013-11-08,CHI,UTA,2014,76.5
8364,8364,64,@,W 97-90 ,240,38,85,0.447,32,62,0.516,6,23,0.261,15,24,0.625,97,34,80,0.425,24,55,0.436,10,25,0.4,12,17,0.706,90,2013-11-15,DET,SAC,2014,95.0
8365,8365,65,@,W 97-81 ,240,35,69,0.507,29,54,0.537,6,15,0.4,21,23,0.913,97,29,83,0.349,21,56,0.375,8,27,0.296,15,20,0.75,81,2013-11-16,MIA,CHA,2014,85.0
8366,8366,66,@,W 97-86 ,240,40,72,0.556,36,59,0.61,4,13,0.308,13,18,0.722,97,33,87,0.379,26,64,0.406,7,23,0.304,13,17,0.765,86,2013-11-17,MEM,SAC,2014,89.5
8367,8367,67,Home,W 97-94 ,240,34,78,0.436,25,49,0.51,9,29,0.31,20,26,0.769,97,38,99,0.384,32,78,0.41,6,21,0.286,12,22,0.545,94,2013-11-18,DAL,PHI,2014,97.0
8368,8368,68,Home,W 97-87 ,240,38,84,0.452,29,63,0.46,9,21,0.429,12,22,0.545,97,38,98,0.388,35,88,0.398,3,10,0.3,8,14,0.571,87,2013-11-21,DEN,CHI,2014,88.5
8369,8369,69,@,W 97-82 ,240,38,81,0.469,32,64,0.5,6,17,0.353,15,18,0.833,97,35,69,0.507,30,58,0.517,5,11,0.455,7,9,0.778,82,2013-11-22,IND,BOS,2014,84.5
8370,8370,70,Home,L 97-109 ,240,35,77,0.455,21,51,0.412,14,26,0.538,13,18,0.722,97,38,80,0.475,33,63,0.524,5,17,0.294,28,40,0.7,109,2013-11-24,BRK,DET,2014,111.5
8371,8371,71,Home,W 97-95 ,240,31,71,0.437,22,47,0.468,9,24,0.375,26,34,0.765,97,34,83,0.41,28,61,0.459,6,22,0.273,21,25,0.84,95,2013-11-29,DEN,NYK,2014,98.0
8372,8372,72,Home,W 97-93 ,240,37,78,0.474,30,63,0.476,7,15,0.467,16,19,0.842,97,39,82,0.476,33,67,0.493,6,15,0.4,9,15,0.6,93,2013-11-30,CLE,CHI,2014,96.0
8373,8373,73,@,W 97-88 ,240,34,73,0.466,25,55,0.455,9,18,0.5,20,26,0.769,97,36,77,0.468,29,62,0.468,7,15,0.467,9,12,0.75,88,2013-11-30,BRK,MEM,2014,91.5
8374,8374,74,Home,L 97-107 ,240,36,82,0.439,27,54,0.5,9,28,0.321,16,23,0.696,97,41,80,0.513,34,64,0.531,7,16,0.438,18,26,0.692,107,2013-12-03,MIA,DET,2014,110.5
8375,8375,75,@,W 97-95 ,240,36,83,0.434,29,63,0.46,7,20,0.35,18,20,0.9,97,35,89,0.393,25,60,0.417,10,29,0.345,15,19,0.789,95,2013-12-03,OKC,SAC,2014,100.0
8376,8376,76,@,L 97-107 ,240,39,83,0.47,35,64,0.547,4,19,0.211,15,20,0.75,97,42,82,0.512,30,59,0.508,12,23,0.522,11,16,0.688,107,2013-12-04,LAC,ATL,2014,113.0
8377,8377,77,@,W 97-88 ,240,36,79,0.456,25,55,0.455,11,24,0.458,14,19,0.737,97,31,88,0.352,22,57,0.386,9,31,0.29,17,19,0.895,88,2013-12-04,PHO,HOU,2014,92.5
8378,8378,78,Home,L 97-100 ,240,38,94,0.404,31,72,0.431,7,22,0.318,14,15,0.933,97,37,86,0.43,26,62,0.419,11,24,0.458,15,22,0.682,100,2013-12-04,NOP,DAL,2014,105.5
8379,8379,79,@,L 97-106 ,240,35,87,0.402,30,68,0.441,5,19,0.263,22,25,0.88,97,37,82,0.451,28,59,0.475,9,23,0.391,23,32,0.719,106,2013-12-06,TOR,PHO,2014,110.5
8380,8380,80,@,L 97-112 ,240,37,95,0.389,32,68,0.471,5,27,0.185,18,20,0.9,97,38,81,0.469,29,56,0.518,9,25,0.36,27,34,0.794,112,2013-12-09,DAL,SAC,2014,116.5
8381,8381,81,@,L 97-122 ,240,36,87,0.414,29,62,0.468,7,25,0.28,18,31,0.581,97,47,99,0.475,39,74,0.527,8,25,0.32,20,23,0.87,122,2013-12-13,LAL,OKC,2014,126.0
8382,8382,82,Home,L 97-113 ,240,40,81,0.494,37,67,0.552,3,14,0.214,14,20,0.7,97,39,69,0.565,30,48,0.625,9,21,0.429,26,31,0.839,113,2013-12-14,WAS,LAC,2014,117.5
8383,8383,83,@,L 97-101 ,240,37,98,0.378,29,69,0.42,8,29,0.276,15,26,0.577,97,38,86,0.442,31,65,0.477,7,21,0.333,18,23,0.783,101,2013-12-16,MIN,BOS,2014,104.5
8384,8384,84,Home,W 97-94 ,240,37,77,0.481,32,56,0.571,5,21,0.238,18,22,0.818,97,32,73,0.438,27,59,0.458,5,14,0.357,25,28,0.893,94,2013-12-18,MIA,IND,2014,96.5
8385,8385,85,Home,L 97-114 ,240,40,89,0.449,39,77,0.506,1,12,0.083,16,26,0.615,97,44,79,0.557,35,56,0.625,9,23,0.391,17,23,0.739,114,2013-12-21,DET,HOU,2014,118.5
8386,8386,86,@,W 97-94 ,240,34,67,0.507,23,44,0.523,11,23,0.478,18,28,0.643,97,38,81,0.469,30,61,0.492,8,20,0.4,10,11,0.909,94,2013-12-30,MIA,DEN,2014,98.0
8387,8387,87,@,L 97-102 ,240,39,77,0.506,32,55,0.582,7,22,0.318,12,21,0.571,97,38,81,0.469,35,70,0.5,3,11,0.273,23,27,0.852,102,2014-01-05,TOR,MIA,2014,103.5
8388,8388,88,@,W 97-83 ,240,40,85,0.471,35,68,0.515,5,17,0.294,12,15,0.8,97,31,72,0.431,25,56,0.446,6,16,0.375,15,24,0.625,83,2014-01-07,WAS,CHA,2014,86.0
8389,8389,89,@,L 97-110 ,240,34,81,0.42,23,50,0.46,11,31,0.355,18,26,0.692,97,48,90,0.533,43,73,0.589,5,17,0.294,9,15,0.6,110,2014-01-07,LAL,DAL,2014,112.5
8390,8390,90,Home,W 97-87 ,240,34,75,0.453,24,52,0.462,10,23,0.435,19,22,0.864,97,35,87,0.402,26,60,0.433,9,27,0.333,8,9,0.889,87,2014-01-08,ATL,IND,2014,91.5
8391,8391,91,@,L 97-99 ,240,38,85,0.447,31,66,0.47,7,19,0.368,14,16,0.875,97,38,92,0.413,30,66,0.455,8,26,0.308,15,21,0.714,99,2014-01-10,BOS,GSW,2014,103.0
8392,8392,92,@,L 97-103 ,240,37,79,0.468,33,68,0.485,4,11,0.364,19,20,0.95,97,38,81,0.469,32,67,0.478,6,14,0.429,21,26,0.808,103,2014-01-11,CHA,CHI,2014,106.0
8393,8393,93,@,L 97-114 ,240,37,84,0.44,30,59,0.508,7,25,0.28,16,17,0.941,97,41,75,0.547,31,53,0.585,10,22,0.455,22,26,0.846,114,2014-01-15,MIA,WAS,2014,119.0
8394,8394,94,@,W 97-87 ,240,37,84,0.44,31,62,0.5,6,22,0.273,17,19,0.895,97,32,83,0.386,30,72,0.417,2,11,0.182,21,28,0.75,87,2014-01-18,GSW,NOP,2014,88.0
8395,8395,95,Home,L 97-102 ,240,33,81,0.407,28,58,0.483,5,23,0.217,26,33,0.788,97,38,83,0.458,34,63,0.54,4,20,0.2,22,28,0.786,102,2014-01-20,CLE,DAL,2014,104.0
8396,8396,96,Home,L 97-114 ,240,33,69,0.478,28,58,0.483,5,11,0.455,26,38,0.684,97,42,82,0.512,33,61,0.541,9,21,0.429,21,31,0.677,114,2014-01-21,NOP,SAC,2014,118.5
8397,8397,97,@,L 97-105 ,240,40,86,0.465,33,67,0.493,7,19,0.368,10,16,0.625,97,42,87,0.483,32,72,0.444,10,15,0.667,11,17,0.647,105,2014-01-21,POR,OKC,2014,110.0
8398,8398,98,Home,L 97-112 ,240,41,87,0.471,36,70,0.514,5,17,0.294,10,12,0.833,97,41,90,0.456,33,69,0.478,8,21,0.381,22,24,0.917,112,2014-01-21,UTA,MIN,2014,116.0
8399,8399,99,Home,W 97-90 ,240,33,75,0.44,28,57,0.491,5,18,0.278,26,47,0.553,97,35,82,0.427,29,59,0.492,6,23,0.261,14,21,0.667,90,2014-01-28,HOU,SAS,2014,93.0
8400,8400,0,Home,W 97-96 ,240,31,73,0.425,28,58,0.483,3,15,0.2,32,37,0.865,97,34,77,0.442,27,54,0.5,7,23,0.304,21,23,0.913,96,2014-02-01,IND,BRK,2014,99.5
8401,8401,1,@,L 97-106 ,240,37,78,0.474,31,58,0.534,6,20,0.3,17,23,0.739,97,44,91,0.484,34,64,0.531,10,27,0.37,8,11,0.727,106,2014-02-05,MIN,OKC,2014,111.0
8402,8402,2,Home,L 97-103 ,240,35,76,0.461,23,48,0.479,12,28,0.429,15,17,0.882,97,36,76,0.474,27,49,0.551,9,27,0.333,22,30,0.733,103,2014-02-11,PHO,MIA,2014,107.5
8403,8403,3,Home,L 97-114 ,240,33,73,0.452,27,57,0.474,6,16,0.375,25,30,0.833,97,46,89,0.517,33,65,0.508,13,24,0.542,9,11,0.818,114,2014-02-19,ATL,WAS,2014,120.5
8404,8404,4,@,L 97-108 ,240,37,94,0.394,28,66,0.424,9,28,0.321,14,20,0.7,97,40,83,0.482,27,55,0.491,13,28,0.464,15,16,0.938,108,2014-02-23,MIN,POR,2014,114.5
8405,8405,5,Home,L 97-102 ,240,38,89,0.427,31,68,0.456,7,21,0.333,14,17,0.824,97,39,77,0.506,34,64,0.531,5,13,0.385,19,23,0.826,102,2014-03-01,BOS,IND,2014,104.5
8406,8406,6,Home,L 97-108 ,240,37,82,0.451,30,60,0.5,7,22,0.318,16,21,0.762,97,37,81,0.457,32,60,0.533,5,21,0.238,29,38,0.763,108,2014-03-01,SAC,MIN,2014,110.5
8407,8407,7,@,L 97-111 ,240,39,86,0.453,31,52,0.596,8,34,0.235,11,13,0.846,97,43,80,0.538,37,61,0.607,6,19,0.316,19,24,0.792,111,2014-03-07,ATL,GSW,2014,114.0
8408,8408,8,Home,L 97-107 ,240,36,87,0.414,27,64,0.422,9,23,0.391,16,18,0.889,97,38,88,0.432,24,57,0.421,14,31,0.452,17,23,0.739,107,2014-03-08,CLE,NYK,2014,114.0
8409,8409,9,@,L 97-101 ,240,35,71,0.493,29,48,0.604,6,23,0.261,21,24,0.875,97,34,70,0.486,23,50,0.46,11,20,0.55,22,31,0.71,101,2014-03-10,TOR,BRK,2014,106.5
8410,8410,10,@,L 97-102 ,240,37,89,0.416,34,70,0.486,3,19,0.158,20,26,0.769,97,36,74,0.486,23,45,0.511,13,29,0.448,17,20,0.85,102,2014-03-13,MIL,ATL,2014,108.5
8411,8411,11,Home,W 97-92 ,240,33,81,0.407,19,49,0.388,14,32,0.438,17,29,0.586,97,34,83,0.41,26,58,0.448,8,25,0.32,16,25,0.64,92,2014-03-15,ATL,DEN,2014,96.0
8412,8412,12,@,W 97-83 ,240,39,85,0.459,26,51,0.51,13,34,0.382,6,7,0.857,97,30,85,0.353,21,60,0.35,9,25,0.36,14,16,0.875,83,2014-03-17,ATL,CHA,2014,87.5
8413,8413,13,@,W 97-85 ,240,31,75,0.413,18,50,0.36,13,25,0.52,22,28,0.786,97,29,84,0.345,24,62,0.387,5,22,0.227,22,31,0.71,85,2014-03-17,OKC,CHI,2014,87.5
8414,8414,14,@,W 97-96 ,240,37,85,0.435,28,59,0.475,9,26,0.346,14,24,0.583,97,39,84,0.464,28,58,0.483,11,26,0.423,7,13,0.538,96,2014-03-26,CLE,DET,2014,101.5
8415,8415,15,@,L 97-108 ,240,37,87,0.425,27,63,0.429,10,24,0.417,13,16,0.813,97,39,71,0.549,25,42,0.595,14,29,0.483,16,21,0.762,108,2014-03-28,CLE,BRK,2014,115.0
8416,8416,16,@,L 97-101 ,240,34,80,0.425,25,49,0.51,9,31,0.29,20,28,0.714,97,39,79,0.494,33,65,0.508,6,14,0.429,17,25,0.68,101,2014-03-29,ATL,WAS,2014,104.0
8417,8417,17,Home,L 97-102 ,240,36,73,0.493,31,59,0.525,5,14,0.357,20,26,0.769,97,38,80,0.475,35,69,0.507,3,11,0.273,23,31,0.742,102,2014-03-31,NOP,SAC,2014,103.5
8418,8418,18,@,L 97-120 ,240,36,86,0.419,29,55,0.527,7,31,0.226,18,23,0.783,97,47,83,0.566,37,64,0.578,10,19,0.526,16,26,0.615,120,2014-04-06,LAL,LAC,2014,125.0
8419,8419,19,@,L 97-105 ,240,37,84,0.44,25,58,0.431,12,26,0.462,11,14,0.786,97,40,76,0.526,31,53,0.585,9,23,0.391,16,22,0.727,105,2014-04-09,BOS,ATL,2014,109.5
8420,8420,20,Home,W 97-88 ,240,34,73,0.466,22,44,0.5,12,29,0.414,17,23,0.739,97,35,74,0.473,27,54,0.5,8,20,0.4,10,14,0.714,88,2014-04-13,BRK,ORL,2014,92.0
8421,8421,21,@,L 97-102 ,240,36,84,0.429,29,56,0.518,7,28,0.25,18,19,0.947,97,38,72,0.528,29,52,0.558,9,20,0.45,17,23,0.739,102,2014-04-13,OKC,IND,2014,106.5
8422,8422,22,@,W 97-91 ,240,40,77,0.519,34,62,0.548,6,15,0.4,11,15,0.733,97,38,80,0.475,33,54,0.611,5,26,0.192,10,14,0.714,91,2014-04-14,MEM,PHO,2014,93.5
8423,8423,23,Home,W 97-91 ,240,37,76,0.487,33,66,0.5,4,10,0.4,19,28,0.679,97,38,91,0.418,31,70,0.443,7,21,0.333,8,13,0.615,91,2014-10-30,MIN,DET,2015,94.5
8424,8424,24,@,W 97-89 ,240,35,79,0.443,28,60,0.467,7,19,0.368,20,27,0.741,97,34,74,0.459,26,53,0.491,8,21,0.381,13,16,0.813,89,2014-10-31,MEM,IND,2015,93.0
8425,8425,25,@,L 97-108 ,240,34,80,0.425,25,58,0.431,9,22,0.409,20,24,0.833,97,40,73,0.548,36,60,0.6,4,13,0.308,24,33,0.727,108,2014-11-01,MIL,WAS,2015,110.0
8426,8426,26,@,W 97-90 ,240,39,81,0.481,37,70,0.529,2,11,0.182,17,23,0.739,97,33,77,0.429,25,53,0.472,8,24,0.333,16,25,0.64,90,2014-11-08,WAS,IND,2015,94.0
8427,8427,27,@,W 97-96 ,240,33,72,0.458,27,57,0.474,6,15,0.4,25,35,0.714,97,36,93,0.387,30,70,0.429,6,23,0.261,18,25,0.72,96,2014-11-09,UTA,DET,2015,99.0
8428,8428,28,Home,W 97-86 ,240,39,90,0.433,33,75,0.44,6,15,0.4,13,15,0.867,97,32,74,0.432,26,53,0.491,6,21,0.286,16,21,0.762,86,2014-11-10,IND,UTA,2015,89.0
8429,8429,29,@,L 97-100 ,240,43,86,0.5,38,63,0.603,5,23,0.217,6,12,0.5,97,39,76,0.513,30,56,0.536,9,20,0.45,13,18,0.722,100,2014-11-12,UTA,ATL,2015,104.5
8430,8430,30,@,W 97-95 ,240,33,70,0.471,27,58,0.466,6,12,0.5,25,32,0.781,97,37,86,0.43,29,63,0.46,8,23,0.348,13,14,0.929,95,2014-11-12,ORL,NYK,2015,99.0
8431,8431,31,Home,W 97-87 ,240,33,78,0.423,22,52,0.423,11,26,0.423,20,27,0.741,97,35,89,0.393,34,70,0.486,1,19,0.053,16,17,0.941,87,2014-11-15,POR,BRK,2015,87.5
8432,8432,32,Home,L 97-106 ,240,34,79,0.43,24,50,0.48,10,29,0.345,19,23,0.826,97,41,85,0.482,29,54,0.537,12,31,0.387,12,15,0.8,106,2014-11-17,CLE,DEN,2015,112.0
8433,8433,33,@,L 97-117 ,240,31,78,0.397,26,62,0.419,5,16,0.313,30,34,0.882,97,43,82,0.524,32,58,0.552,11,24,0.458,20,25,0.8,117,2014-11-21,NOP,DEN,2015,122.5
8434,8434,34,@,W 97-95 ,240,36,72,0.5,27,52,0.519,9,20,0.45,16,23,0.696,97,42,86,0.488,39,77,0.506,3,9,0.333,8,10,0.8,95,2014-11-24,CHI,UTA,2015,96.5
8435,8435,35,Home,L 97-114 ,240,33,85,0.388,23,62,0.371,10,23,0.435,21,27,0.778,97,43,75,0.573,30,47,0.638,13,28,0.464,15,23,0.652,114,2014-11-25,MIA,GSW,2015,120.5
8436,8436,36,Home,L 97-105 ,240,41,94,0.436,36,79,0.456,5,15,0.333,10,15,0.667,97,39,92,0.424,27,65,0.415,12,27,0.444,15,20,0.75,105,2014-11-26,CHA,POR,2015,111.0
8437,8437,37,Home,W 97-82 ,240,40,83,0.482,28,57,0.491,12,26,0.462,5,10,0.5,97,31,70,0.443,28,54,0.519,3,16,0.188,17,28,0.607,82,2014-11-26,OKC,UTA,2015,83.5
8438,8438,38,@,L 97-122 ,240,33,85,0.388,25,62,0.403,8,23,0.348,23,29,0.793,97,41,88,0.466,33,67,0.493,8,21,0.381,32,36,0.889,122,2014-11-28,PHO,DEN,2015,126.0
8439,8439,39,@,L 97-109 ,240,35,89,0.393,28,67,0.418,7,22,0.318,20,26,0.769,97,41,78,0.526,34,62,0.548,7,16,0.438,20,32,0.625,109,2014-11-29,IND,CLE,2015,112.5
8440,8440,40,@,W 97-85 ,240,38,79,0.481,35,66,0.53,3,13,0.231,18,28,0.643,97,33,70,0.471,32,59,0.542,1,11,0.091,18,27,0.667,85,2014-11-30,MEM,SAC,2015,85.5
8441,8441,41,@,L 97-98 ,240,39,87,0.448,33,70,0.471,6,17,0.353,13,14,0.929,97,38,82,0.463,30,55,0.545,8,27,0.296,14,18,0.778,98,2014-12-02,ORL,GSW,2015,102.0
8442,8442,42,Home,L 97-103 ,240,37,77,0.481,20,42,0.476,17,35,0.486,6,9,0.667,97,43,80,0.538,34,63,0.54,9,17,0.529,8,12,0.667,103,2014-12-09,PHO,MIA,2015,107.5
8443,8443,43,Home,W 97-88 ,240,38,83,0.458,29,59,0.492,9,24,0.375,12,17,0.706,97,38,83,0.458,33,67,0.493,5,16,0.313,7,14,0.5,88,2014-12-15,CLE,CHO,2015,90.5
8444,8444,44,@,L 97-104 ,240,37,77,0.481,30,58,0.517,7,19,0.368,16,22,0.727,97,41,87,0.471,34,64,0.531,7,23,0.304,15,29,0.517,104,2014-12-17,MIL,POR,2015,107.5
8445,8445,45,@,L 97-103 ,240,38,82,0.463,32,73,0.438,6,9,0.667,15,19,0.789,97,34,75,0.453,22,52,0.423,12,23,0.522,23,30,0.767,103,2014-12-18,NYK,CHI,2015,109.0
8446,8446,46,Home,L 97-103 ,240,37,94,0.394,35,81,0.432,2,13,0.154,21,24,0.875,97,32,73,0.438,22,47,0.468,10,26,0.385,29,33,0.879,103,2014-12-19,MEM,CHI,2015,108.0
8447,8447,47,Home,L 97-104 ,240,34,86,0.395,19,43,0.442,15,43,0.349,14,18,0.778,97,38,74,0.514,28,48,0.583,10,26,0.385,18,24,0.75,104,2014-12-20,HOU,ATL,2015,109.0
8448,8448,48,@,W 97-91 ,240,34,75,0.453,25,56,0.446,9,19,0.474,20,27,0.741,97,38,86,0.442,31,63,0.492,7,23,0.304,8,9,0.889,91,2014-12-22,UTA,MEM,2015,94.5
8449,8449,49,Home,W 97-90 ,240,35,84,0.417,29,67,0.433,6,17,0.353,21,24,0.875,97,37,75,0.493,31,61,0.508,6,14,0.429,10,14,0.714,90,2014-12-26,NOP,SAS,2015,93.0
8450,8450,50,@,L 97-110 ,240,34,77,0.442,26,58,0.448,8,19,0.421,21,36,0.583,97,41,88,0.466,30,60,0.5,11,28,0.393,17,21,0.81,110,2014-12-27,MIN,GSW,2015,115.5
8451,8451,51,@,L 97-101 ,240,38,92,0.413,30,73,0.411,8,19,0.421,13,22,0.591,97,37,81,0.457,27,58,0.466,10,23,0.435,17,22,0.773,101,2014-12-29,UTA,LAC,2015,106.0
8452,8452,52,@,L 97-102 (OT),265,40,99,0.404,36,77,0.468,4,22,0.182,13,15,0.867,97,38,95,0.4,26,59,0.441,12,36,0.333,14,18,0.778,102,2014-12-30,TOR,POR,2015,108.0
8453,8453,53,@,W 97-81 ,240,38,76,0.5,25,43,0.581,13,33,0.394,8,14,0.571,97,32,91,0.352,22,67,0.328,10,24,0.417,7,14,0.5,81,2015-01-02,DET,NYK,2015,86.0
8454,8454,54,@,W 97-77 ,240,37,78,0.474,32,62,0.516,5,16,0.313,18,24,0.75,97,28,84,0.333,22,64,0.344,6,20,0.3,15,20,0.75,77,2015-01-07,UTA,CHI,2015,80.0
8455,8455,55,@,W 97-77 ,240,41,76,0.539,33,59,0.559,8,17,0.471,7,11,0.636,97,25,83,0.301,23,58,0.397,2,25,0.08,25,29,0.862,77,2015-01-07,MIL,PHI,2015,78.0
8456,8456,56,Home,W 97-82 ,240,33,77,0.429,20,43,0.465,13,34,0.382,18,21,0.857,97,29,70,0.414,24,53,0.453,5,17,0.294,19,21,0.905,82,2015-01-10,HOU,UTA,2015,84.5
8457,8457,57,Home,W 97-89 ,240,33,79,0.418,25,54,0.463,8,25,0.32,23,29,0.793,97,34,83,0.41,25,58,0.431,9,25,0.36,12,25,0.48,89,2015-01-16,DAL,DEN,2015,93.5
8458,8458,58,Home,W 97-84 ,240,35,78,0.449,23,51,0.451,12,27,0.444,15,22,0.682,97,31,78,0.397,19,45,0.422,12,33,0.364,10,14,0.714,84,2015-02-02,CLE,PHI,2015,90.0
8459,8459,59,@,L 97-104 ,240,38,90,0.422,32,67,0.478,6,23,0.261,15,18,0.833,97,37,75,0.493,29,55,0.527,8,20,0.4,22,26,0.846,104,2015-02-02,ORL,OKC,2015,108.0
8460,8460,60,Home,L 97-108 ,240,41,83,0.494,34,63,0.54,7,20,0.35,8,11,0.727,97,42,77,0.545,36,53,0.679,6,24,0.25,18,23,0.783,108,2015-02-03,NYK,BOS,2015,111.0
8461,8461,61,@,L 97-103 (OT),265,39,97,0.402,28,71,0.394,11,26,0.423,8,13,0.615,97,43,83,0.518,38,68,0.559,5,15,0.333,12,14,0.857,103,2015-02-06,LAL,ORL,2015,105.5
8462,8462,62,Home,L 97-98 ,240,39,83,0.47,30,58,0.517,9,25,0.36,10,13,0.769,97,37,77,0.481,29,55,0.527,8,22,0.364,16,18,0.889,98,2015-02-08,ORL,CHI,2015,102.0
8463,8463,63,@,L 97-103 ,240,38,76,0.5,29,51,0.569,9,25,0.36,12,19,0.632,97,37,89,0.416,30,71,0.423,7,18,0.389,22,25,0.88,103,2015-02-09,BRK,MIL,2015,106.5
8464,8464,64,@,W 97-86 ,240,35,87,0.402,26,57,0.456,9,30,0.3,18,21,0.857,97,32,72,0.444,28,56,0.5,4,16,0.25,18,18,1.0,86,2015-02-22,ATL,MIL,2015,88.0
8465,8465,65,@,L 97-100 ,240,35,84,0.417,30,61,0.492,5,23,0.217,22,31,0.71,97,40,78,0.513,30,56,0.536,10,22,0.455,10,16,0.625,100,2015-02-23,TOR,NOP,2015,105.0
8466,8466,66,Home,W 97-77 ,240,35,81,0.432,31,68,0.456,4,13,0.308,23,28,0.821,97,33,87,0.379,29,69,0.42,4,18,0.222,7,8,0.875,77,2015-02-25,MIN,WAS,2015,79.0
8467,8467,67,Home,L 97-100 ,240,34,73,0.466,27,61,0.443,7,12,0.583,22,34,0.647,97,40,89,0.449,38,78,0.487,2,11,0.182,18,21,0.857,100,2015-02-25,UTA,LAL,2015,101.0
8468,8468,68,@,W 97-79 ,240,36,78,0.462,27,52,0.519,9,26,0.346,16,28,0.571,97,33,87,0.379,30,75,0.4,3,12,0.25,10,15,0.667,79,2015-02-27,LAC,MEM,2015,80.5
8469,8469,69,Home,L 97-101 ,240,34,88,0.386,27,69,0.391,7,19,0.368,22,27,0.815,97,38,64,0.594,34,53,0.642,4,11,0.364,21,29,0.724,101,2015-02-28,MIN,MEM,2015,103.0
8470,8470,70,Home,W 97-92 ,240,33,78,0.423,24,49,0.49,9,29,0.31,22,30,0.733,97,35,84,0.417,27,62,0.435,8,22,0.364,14,19,0.737,92,2015-03-03,CHI,WAS,2015,96.0
8471,8471,71,@,L 97-106 ,240,29,69,0.42,16,31,0.516,13,38,0.342,26,33,0.788,97,43,84,0.512,37,63,0.587,6,21,0.286,14,17,0.824,106,2015-03-06,CLE,ATL,2015,109.0
8472,8472,72,Home,W 97-90 ,240,34,77,0.442,33,66,0.5,1,11,0.091,28,33,0.848,97,39,84,0.464,34,72,0.472,5,12,0.417,7,9,0.778,90,2015-03-06,MEM,LAL,2015,92.5
8473,8473,73,@,L 97-99 ,240,37,79,0.468,27,52,0.519,10,27,0.37,13,19,0.684,97,38,82,0.463,31,59,0.525,7,23,0.304,16,18,0.889,99,2015-03-06,MIA,WAS,2015,102.5
8474,8474,74,Home,W 97-91 ,240,39,79,0.494,31,61,0.508,8,18,0.444,11,16,0.688,97,34,85,0.4,24,67,0.358,10,18,0.556,13,13,1.0,91,2015-03-11,MIL,ORL,2015,96.0
8475,8475,75,@,L 97-106 ,240,36,81,0.444,35,68,0.515,1,13,0.077,24,26,0.923,97,45,90,0.5,39,66,0.591,6,24,0.25,10,13,0.769,106,2015-03-11,MIN,PHO,2015,109.0
8476,8476,76,@,L 97-113 ,240,35,77,0.455,29,58,0.5,6,19,0.316,21,28,0.75,97,43,81,0.531,30,55,0.545,13,26,0.5,14,17,0.824,113,2015-03-14,SAC,WAS,2015,119.5
8477,8477,77,@,L 97-123 ,240,38,86,0.442,31,71,0.437,7,15,0.467,14,18,0.778,97,49,84,0.583,37,62,0.597,12,22,0.545,13,15,0.867,123,2015-03-15,MIN,SAS,2015,129.0
8478,8478,78,Home,L 97-113 ,240,37,78,0.474,32,60,0.533,5,18,0.278,18,23,0.783,97,45,86,0.523,32,57,0.561,13,29,0.448,10,16,0.625,113,2015-03-15,TOR,POR,2015,119.5
8479,8479,79,@,L 97-105 ,240,36,89,0.404,28,61,0.459,8,28,0.286,17,20,0.85,97,41,82,0.5,34,70,0.486,7,12,0.583,16,26,0.615,105,2015-03-16,POR,WAS,2015,108.5
8480,8480,80,Home,W 97-81 ,240,37,88,0.42,26,58,0.448,11,30,0.367,12,15,0.8,97,25,69,0.362,17,53,0.321,8,16,0.5,23,26,0.885,81,2015-03-20,PHI,NYK,2015,85.0
8481,8481,81,Home,W 97-86 ,240,37,89,0.416,26,71,0.366,11,18,0.611,12,16,0.75,97,33,76,0.434,27,54,0.5,6,22,0.273,14,15,0.933,86,2015-03-21,MEM,POR,2015,89.0
8482,8482,82,Home,L 97-105 (OT),265,38,105,0.362,30,78,0.385,8,27,0.296,13,17,0.765,97,39,89,0.438,30,63,0.476,9,26,0.346,18,30,0.6,105,2015-03-22,BOS,DET,2015,109.5
8483,8483,83,Home,L 97-111 ,240,43,82,0.524,40,67,0.597,3,15,0.2,8,8,1.0,97,42,90,0.467,35,72,0.486,7,18,0.389,20,27,0.741,111,2015-03-27,ORL,DET,2015,114.5
8484,8484,84,Home,L 97-109 ,240,37,82,0.451,32,60,0.533,5,22,0.227,18,24,0.75,97,40,86,0.465,30,60,0.5,10,26,0.385,19,26,0.731,109,2015-03-29,PHO,OKC,2015,114.0
8485,8485,85,Home,W 97-83 ,240,38,83,0.458,30,60,0.5,8,23,0.348,13,17,0.765,97,33,81,0.407,28,65,0.431,5,16,0.313,12,20,0.6,83,2015-03-30,MEM,SAC,2015,85.5
8486,8486,86,@,W 97-84 ,240,40,92,0.435,34,71,0.479,6,21,0.286,11,17,0.647,97,29,64,0.453,28,53,0.528,1,11,0.091,25,32,0.781,84,2015-04-03,ORL,MIN,2015,84.5
8487,8487,87,@,W 97-90 ,240,40,86,0.465,32,65,0.492,8,21,0.381,9,13,0.692,97,39,89,0.438,34,73,0.466,5,16,0.313,7,13,0.538,90,2015-04-04,ORL,MIL,2015,92.5
8488,8488,88,@,L 97-109 ,240,38,83,0.458,29,58,0.5,9,25,0.36,12,20,0.6,97,43,85,0.506,26,53,0.491,17,32,0.531,6,12,0.5,109,2015-04-13,DET,CLE,2015,117.5
8489,8489,89,Home,L 97-107 ,240,32,81,0.395,26,53,0.491,6,28,0.214,27,34,0.794,97,40,81,0.494,36,72,0.5,4,9,0.444,23,36,0.639,107,2015-04-13,PHI,MIL,2015,109.0
8490,8490,90,Home,W 97-95 ,240,37,87,0.425,30,68,0.441,7,19,0.368,16,23,0.696,97,38,94,0.404,29,65,0.446,9,29,0.31,10,17,0.588,95,2015-10-27,CHI,CLE,2016,99.5
8491,8491,91,Home,L 97-122 ,240,30,86,0.349,21,68,0.309,9,18,0.5,28,31,0.903,97,42,93,0.452,33,70,0.471,9,23,0.391,29,35,0.829,122,2015-10-28,MIL,NYK,2016,126.5
8492,8492,92,Home,W 97-94 ,240,36,83,0.434,28,60,0.467,8,23,0.348,17,22,0.773,97,36,88,0.409,24,58,0.414,12,30,0.4,10,13,0.769,94,2015-10-30,ATL,CHO,2016,100.0
8493,8493,93,@,W 97-76 ,240,39,88,0.443,33,73,0.452,6,15,0.4,13,18,0.722,97,28,70,0.4,24,53,0.453,4,17,0.235,16,21,0.762,76,2015-10-31,UTA,IND,2016,78.0
8494,8494,94,@,L 97-118 ,240,40,84,0.476,29,60,0.483,11,24,0.458,6,12,0.5,97,45,83,0.542,31,60,0.517,14,23,0.609,14,22,0.636,118,2015-11-04,SAC,PHO,2016,125.0
8495,8495,95,Home,L 97-105 ,240,36,80,0.45,25,47,0.532,11,33,0.333,14,26,0.538,97,39,83,0.47,33,70,0.471,6,13,0.462,21,24,0.875,105,2015-11-07,PHI,ORL,2016,108.0
8496,8496,96,@,L 97-101 ,240,39,90,0.433,33,72,0.458,6,18,0.333,13,19,0.684,97,38,83,0.458,30,59,0.508,8,24,0.333,17,25,0.68,101,2015-11-08,IND,CLE,2016,105.0
8497,8497,97,Home,W 97-84 ,240,34,77,0.442,23,52,0.442,11,25,0.44,18,22,0.818,97,31,78,0.397,21,45,0.467,10,33,0.303,12,17,0.706,84,2015-11-09,IND,ORL,2016,89.0
8498,8498,98,@,L 97-102 ,240,36,95,0.379,21,62,0.339,15,33,0.455,10,12,0.833,97,37,84,0.44,33,68,0.485,4,16,0.25,24,31,0.774,102,2015-11-13,CHA,CHI,2016,104.0
8499,8499,99,@,W 97-96 ,240,39,76,0.513,32,55,0.582,7,21,0.333,12,17,0.706,97,37,76,0.487,29,54,0.537,8,22,0.364,14,17,0.824,96,2015-11-15,UTA,ATL,2016,100.0
8500,8500,0,Home,W 97-85 ,240,31,75,0.413,25,56,0.446,6,19,0.316,29,39,0.744,97,35,96,0.365,28,69,0.406,7,27,0.259,8,15,0.533,85,2015-11-15,LAL,DET,2016,88.5
8501,8501,1,@,L 97-103 ,240,38,86,0.442,33,70,0.471,5,16,0.313,16,18,0.889,97,38,89,0.427,29,59,0.492,9,30,0.3,18,24,0.75,103,2015-11-18,SAC,ATL,2016,107.5
8502,8502,2,Home,L 97-103 ,240,37,91,0.407,29,64,0.453,8,27,0.296,15,21,0.714,97,41,83,0.494,32,64,0.5,9,19,0.474,12,14,0.857,103,2015-11-18,PHO,CHI,2016,107.5
8503,8503,3,@,L 97-109 ,240,32,86,0.372,21,58,0.362,11,28,0.393,22,25,0.88,97,41,85,0.482,30,56,0.536,11,29,0.379,16,19,0.842,109,2015-11-21,ATL,CLE,2016,114.5
8504,8504,4,@,W 97-95 ,240,38,78,0.487,31,59,0.525,7,19,0.368,14,20,0.7,97,36,79,0.456,28,53,0.528,8,26,0.308,15,21,0.714,95,2015-11-21,WAS,DET,2016,99.0
8505,8505,5,@,W 97-91 ,240,31,81,0.383,24,61,0.393,7,20,0.35,28,31,0.903,97,38,92,0.413,29,61,0.475,9,31,0.29,6,8,0.75,91,2015-11-21,SAC,ORL,2016,95.5
8506,8506,6,@,L 97-121 ,240,34,82,0.415,25,61,0.41,9,21,0.429,20,26,0.769,97,45,80,0.563,33,56,0.589,12,24,0.5,19,22,0.864,121,2015-11-24,BOS,ATL,2016,127.0
8507,8507,7,@,W 97-78 ,240,33,76,0.434,26,59,0.441,7,17,0.412,24,28,0.857,97,32,85,0.376,29,71,0.408,3,14,0.214,11,15,0.733,78,2015-11-27,MIA,NYK,2016,79.5
8508,8508,8,@,W 97-85 ,240,39,83,0.47,32,55,0.582,7,28,0.25,12,16,0.75,97,28,83,0.337,19,53,0.358,9,30,0.3,20,23,0.87,85,2015-12-01,WAS,CLE,2016,89.5
8509,8509,9,Home,W 97-95 ,240,40,81,0.494,37,68,0.544,3,13,0.231,14,24,0.583,97,35,79,0.443,31,63,0.492,4,16,0.25,21,24,0.875,95,2015-12-03,MIA,OKC,2016,97.0
8510,8510,10,Home,L 97-114 ,240,29,77,0.377,22,56,0.393,7,21,0.333,32,41,0.78,97,40,84,0.476,26,51,0.51,14,33,0.424,20,24,0.833,114,2015-12-03,SAC,BOS,2016,121.0
8511,8511,11,Home,L 97-104 ,240,40,84,0.476,31,59,0.525,9,25,0.36,8,9,0.889,97,37,82,0.451,24,51,0.471,13,31,0.419,17,20,0.85,104,2015-12-07,NYK,DAL,2016,110.5
8512,8512,12,Home,W 97-94 ,240,37,64,0.578,34,54,0.63,3,10,0.3,20,22,0.909,97,34,76,0.447,27,51,0.529,7,25,0.28,19,24,0.792,94,2015-12-09,TOR,SAS,2016,97.5
8513,8513,13,@,L 97-99 ,240,33,83,0.398,24,54,0.444,9,29,0.31,22,28,0.786,97,42,93,0.452,39,77,0.506,3,16,0.188,12,16,0.75,99,2015-12-10,NYK,SAC,2016,100.5
8514,8514,14,@,L 97-126 ,240,35,88,0.398,25,56,0.446,10,32,0.313,17,20,0.85,97,47,90,0.522,32,57,0.561,15,33,0.455,17,28,0.607,126,2015-12-12,LAL,HOU,2016,133.5
8515,8515,15,@,L 97-100 ,240,40,77,0.519,33,58,0.569,7,19,0.368,10,14,0.714,97,37,77,0.481,30,55,0.545,7,22,0.318,19,23,0.826,100,2015-12-13,MEM,MIA,2016,103.5
8516,8516,16,@,L 97-107 ,240,34,82,0.415,22,43,0.512,12,39,0.308,17,23,0.739,97,38,75,0.507,27,51,0.529,11,24,0.458,20,29,0.69,107,2015-12-15,HOU,SAC,2016,112.5
8517,8517,17,Home,W 97-88 ,240,34,78,0.436,24,49,0.49,10,29,0.345,19,21,0.905,97,30,80,0.375,24,63,0.381,6,17,0.353,22,24,0.917,88,2015-12-18,DAL,MEM,2016,91.0
8518,8518,18,@,L 97-104 ,240,36,86,0.419,28,70,0.4,8,16,0.5,17,17,1.0,97,37,89,0.416,30,61,0.492,7,28,0.25,23,26,0.885,104,2015-12-18,BRK,IND,2016,107.5
8519,8519,19,Home,L 97-107 ,240,37,77,0.481,31,53,0.585,6,24,0.25,17,30,0.567,97,40,85,0.471,34,66,0.515,6,19,0.316,21,28,0.75,107,2015-12-18,PHI,NYK,2016,110.0
8520,8520,20,Home,W 97-88 ,240,34,73,0.466,24,48,0.5,10,25,0.4,19,25,0.76,97,31,79,0.392,25,51,0.49,6,28,0.214,20,25,0.8,88,2015-12-18,UTA,DEN,2016,91.0
8521,8521,21,@,L 97-107 ,240,34,86,0.395,23,48,0.479,11,38,0.289,18,29,0.621,97,34,76,0.447,26,51,0.51,8,25,0.32,31,49,0.633,107,2015-12-19,LAC,HOU,2016,111.0
8522,8522,22,@,L 97-106 ,240,38,81,0.469,33,57,0.579,5,24,0.208,16,22,0.727,97,37,77,0.481,28,48,0.583,9,29,0.31,23,28,0.821,106,2015-12-21,POR,ATL,2016,110.5
8523,8523,23,@,L 97-104 ,240,38,88,0.432,32,68,0.471,6,20,0.3,15,24,0.625,97,40,87,0.46,32,66,0.485,8,21,0.381,16,24,0.667,104,2015-12-28,TOR,CHI,2016,108.0
8524,8524,24,Home,L 97-101 ,240,36,79,0.456,25,54,0.463,11,25,0.44,14,20,0.7,97,33,71,0.465,16,30,0.533,17,41,0.415,18,25,0.72,101,2015-12-28,PHO,CLE,2016,109.5
8525,8525,25,Home,L 97-100 ,240,34,88,0.386,27,56,0.482,7,32,0.219,22,28,0.786,97,38,93,0.409,35,75,0.467,3,18,0.167,21,22,0.955,100,2016-01-02,BOS,BRK,2016,101.5
8526,8526,26,Home,W 97-77 ,240,38,84,0.452,30,62,0.484,8,22,0.364,13,17,0.765,97,32,89,0.36,26,62,0.419,6,27,0.222,7,9,0.778,77,2016-01-03,LAL,PHO,2016,80.0
8527,8527,27,@,L 97-111 ,240,37,84,0.44,29,58,0.5,8,26,0.308,15,20,0.75,97,44,88,0.5,33,62,0.532,11,26,0.423,12,14,0.857,111,2016-01-03,ATL,NYK,2016,116.5
8528,8528,28,@,W 97-75 ,240,39,86,0.453,30,63,0.476,9,23,0.391,10,12,0.833,97,31,91,0.341,27,61,0.443,4,30,0.133,9,13,0.692,75,2016-01-03,MIA,WAS,2016,77.0
8529,8529,29,@,W 97-88 ,240,34,75,0.453,29,61,0.475,5,14,0.357,24,26,0.923,97,33,84,0.393,25,59,0.424,8,25,0.32,14,15,0.933,88,2016-01-08,TOR,WAS,2016,92.0
8530,8530,30,Home,W 97-83 ,240,40,91,0.44,32,60,0.533,8,31,0.258,9,10,0.9,97,31,84,0.369,24,61,0.393,7,23,0.304,14,19,0.737,83,2016-01-09,LAC,CHO,2016,86.5
8531,8531,31,@,L 97-116 ,240,36,89,0.404,28,64,0.438,8,25,0.32,17,27,0.63,97,41,79,0.519,31,55,0.564,10,24,0.417,24,31,0.774,116,2016-01-12,PHO,IND,2016,121.0
8532,8532,32,Home,L 97-109 ,240,41,84,0.488,35,61,0.574,6,23,0.261,9,14,0.643,97,42,100,0.42,26,67,0.388,16,33,0.485,9,11,0.818,109,2016-01-13,SAC,NOP,2016,117.0
8533,8533,33,@,W 97-94 ,240,34,83,0.41,30,63,0.476,4,20,0.2,25,34,0.735,97,28,81,0.346,17,46,0.37,11,35,0.314,27,29,0.931,94,2016-01-19,IND,PHO,2016,99.5
8534,8534,34,Home,W 97-84 ,240,28,82,0.341,19,51,0.373,9,31,0.29,32,37,0.865,97,29,77,0.377,22,53,0.415,7,24,0.292,19,32,0.594,84,2016-01-23,CHA,NYK,2016,87.5
8535,8535,35,@,L 97-108 ,240,36,86,0.419,29,67,0.433,7,19,0.368,18,25,0.72,97,38,85,0.447,33,69,0.478,5,16,0.313,27,36,0.75,108,2016-01-23,IND,SAC,2016,110.5
8536,8536,36,@,L 97-112 ,240,36,86,0.419,29,67,0.433,7,19,0.368,18,32,0.563,97,44,90,0.489,35,60,0.583,9,30,0.3,15,19,0.789,112,2016-01-26,SAC,POR,2016,116.5
8537,8537,37,@,L 97-110 ,240,39,82,0.476,32,63,0.508,7,19,0.368,12,17,0.706,97,39,91,0.429,34,70,0.486,5,21,0.238,27,38,0.711,110,2016-01-27,PHI,DET,2016,112.5
8538,8538,38,@,L 97-112 ,240,31,85,0.365,24,59,0.407,7,26,0.269,28,38,0.737,97,42,80,0.525,28,45,0.622,14,35,0.4,14,19,0.737,112,2016-02-01,DAL,ATL,2016,119.0
8539,8539,39,@,W 97-89 ,240,40,90,0.444,37,71,0.521,3,19,0.158,14,17,0.824,97,31,82,0.378,25,62,0.403,6,20,0.3,21,28,0.75,89,2016-02-02,BOS,NYK,2016,92.0
8540,8540,40,Home,L 97-104 ,240,37,79,0.468,25,48,0.521,12,31,0.387,11,15,0.733,97,35,74,0.473,26,47,0.553,9,27,0.333,25,32,0.781,104,2016-02-02,PHO,TOR,2016,108.5
8541,8541,41,@,L 97-106 ,240,38,83,0.458,28,55,0.509,10,28,0.357,11,14,0.786,97,39,79,0.494,30,52,0.577,9,27,0.333,19,23,0.826,106,2016-02-03,CLE,CHO,2016,110.5
8542,8542,42,@,L 97-110 ,240,41,90,0.456,38,71,0.535,3,19,0.158,12,14,0.857,97,42,81,0.519,33,66,0.5,9,15,0.6,17,18,0.944,110,2016-02-03,NOP,SAS,2016,114.5
8543,8543,43,@,L 97-99 ,240,35,74,0.473,23,50,0.46,12,24,0.5,15,21,0.714,97,37,73,0.507,31,56,0.554,6,17,0.353,19,26,0.731,99,2016-02-26,CLE,TOR,2016,102.0
8544,8544,44,Home,W 97-81 ,240,43,84,0.512,40,70,0.571,3,14,0.214,8,9,0.889,97,31,78,0.397,25,59,0.424,6,19,0.316,13,23,0.565,81,2016-03-02,SAS,DET,2016,84.0
8545,8545,45,Home,L 97-107 ,240,34,79,0.43,22,47,0.468,12,32,0.375,17,28,0.607,97,40,89,0.449,30,62,0.484,10,27,0.37,17,20,0.85,107,2016-03-05,LAC,ATL,2016,112.0
8546,8546,46,Home,L 97-128 ,240,39,89,0.438,30,60,0.5,9,29,0.31,10,15,0.667,97,46,82,0.561,30,58,0.517,16,24,0.667,20,24,0.833,128,2016-03-09,PHO,NYK,2016,136.0
8547,8547,47,Home,L 97-111 ,240,35,89,0.393,25,60,0.417,10,29,0.345,17,27,0.63,97,45,89,0.506,38,67,0.567,7,22,0.318,14,18,0.778,111,2016-03-18,PHI,OKC,2016,114.5
8548,8548,48,@,L 97-109 ,240,33,84,0.393,28,61,0.459,5,23,0.217,26,31,0.839,97,44,88,0.5,30,50,0.6,14,38,0.368,7,12,0.583,109,2016-03-19,HOU,ATL,2016,116.0
8549,8549,49,Home,L 97-103 ,240,30,76,0.395,19,48,0.396,11,28,0.393,26,34,0.765,97,39,90,0.433,31,70,0.443,8,20,0.4,17,19,0.895,103,2016-03-21,PHO,MEM,2016,107.0
8550,8550,50,@,L 97-108 ,240,36,84,0.429,30,66,0.455,6,18,0.333,19,28,0.679,97,40,80,0.5,35,65,0.538,5,15,0.333,23,33,0.697,108,2016-03-25,ORL,MIA,2016,110.5
8551,8551,51,@,W 97-88 ,240,36,88,0.409,25,56,0.446,11,32,0.344,14,15,0.933,97,31,70,0.443,22,46,0.478,9,24,0.375,17,19,0.895,88,2016-03-28,DAL,DEN,2016,92.5
8552,8552,52,@,L 97-105 ,240,37,83,0.446,23,50,0.46,14,33,0.424,9,13,0.692,97,36,80,0.45,25,57,0.439,11,23,0.478,22,28,0.786,105,2016-03-30,ATL,TOR,2016,110.5
8553,8553,53,@,L 97-104 ,240,34,78,0.436,25,54,0.463,9,24,0.375,20,23,0.87,97,36,87,0.414,26,53,0.491,10,34,0.294,22,27,0.815,104,2016-04-06,NOP,BOS,2016,109.0
8554,8554,54,Home,L 97-111 ,240,37,78,0.474,27,52,0.519,10,26,0.385,13,15,0.867,97,42,90,0.467,30,64,0.469,12,26,0.462,15,17,0.882,111,2016-04-06,NYK,CHO,2016,117.0
8555,8555,55,Home,L 97-105 ,240,36,85,0.424,30,68,0.441,6,17,0.353,19,21,0.905,97,36,80,0.45,25,59,0.424,11,21,0.524,22,31,0.71,105,2016-04-07,SAC,MIN,2016,110.5
8556,8556,56,@,W 97-92 ,240,39,90,0.433,28,66,0.424,11,24,0.458,8,10,0.8,97,37,87,0.425,30,64,0.469,7,23,0.304,11,13,0.846,92,2016-04-13,IND,MIL,2016,95.5
8557,8557,57,Home,L 97-103 ,240,36,84,0.429,29,60,0.483,7,24,0.292,18,25,0.72,97,39,94,0.415,33,72,0.458,6,22,0.273,19,26,0.731,103,2016-10-26,PHI,OKC,2017,106.0
8558,8558,58,@,W 97-91 ,240,35,92,0.38,28,70,0.4,7,22,0.318,20,24,0.833,97,32,86,0.372,18,52,0.346,14,34,0.412,13,20,0.65,91,2016-10-28,CHA,MIA,2017,98.0
8559,8559,59,Home,W 97-81 ,240,35,77,0.455,23,52,0.442,12,25,0.48,15,26,0.577,97,33,77,0.429,26,51,0.51,7,26,0.269,8,10,0.8,81,2016-11-02,UTA,DAL,2017,84.5
8560,8560,60,@,L 97-117 ,240,39,86,0.453,34,54,0.63,5,32,0.156,14,20,0.7,97,45,95,0.474,37,65,0.569,8,30,0.267,19,21,0.905,117,2016-11-04,GSW,LAL,2017,121.0
8561,8561,61,@,L 97-112 ,240,37,85,0.435,25,49,0.51,12,36,0.333,11,13,0.846,97,45,85,0.529,37,65,0.569,8,20,0.4,14,24,0.583,112,2016-11-05,HOU,ATL,2017,116.0
8562,8562,62,Home,W 97-85 ,240,37,85,0.435,28,57,0.491,9,28,0.321,14,17,0.824,97,31,84,0.369,27,67,0.403,4,17,0.235,19,22,0.864,85,2016-11-07,OKC,MIA,2017,87.0
8563,8563,63,Home,L 97-109 ,240,38,78,0.487,28,52,0.538,10,26,0.385,11,14,0.786,97,43,82,0.524,33,59,0.559,10,23,0.435,13,15,0.867,109,2016-11-08,LAL,DAL,2017,114.0
8564,8564,64,@,L 97-108 ,240,35,73,0.479,28,52,0.538,7,21,0.333,20,26,0.769,97,47,90,0.522,38,71,0.535,9,19,0.474,5,7,0.714,108,2016-11-25,LAC,DET,2017,112.5
8565,8565,65,@,L 97-118 ,240,36,79,0.456,25,45,0.556,11,34,0.324,14,23,0.609,97,48,87,0.552,37,61,0.607,11,26,0.423,11,16,0.688,118,2016-11-25,BRK,IND,2017,123.5
8566,8566,66,Home,W 97-87 ,240,35,74,0.473,30,56,0.536,5,18,0.278,22,31,0.71,97,32,86,0.372,23,55,0.418,9,31,0.29,14,18,0.778,87,2016-12-01,CHA,DAL,2017,91.5
8567,8567,67,Home,W 97-92 ,240,36,88,0.409,25,60,0.417,11,28,0.393,14,15,0.933,97,33,88,0.375,27,62,0.435,6,26,0.231,20,25,0.8,92,2016-12-02,BOS,SAC,2017,95.0
8568,8568,68,@,W 97-96 ,240,40,93,0.43,32,65,0.492,8,28,0.286,9,14,0.643,97,30,73,0.411,24,49,0.49,6,24,0.25,30,34,0.882,96,2016-12-05,SAS,MIL,2017,99.0
8569,8569,69,@,W 97-79 ,240,38,68,0.559,31,51,0.608,7,17,0.412,14,17,0.824,97,32,82,0.39,27,63,0.429,5,19,0.263,10,14,0.714,79,2016-12-11,PHI,DET,2017,81.5
8570,8570,70,@,L 97-107 ,240,35,91,0.385,29,64,0.453,6,27,0.222,21,34,0.618,97,33,86,0.384,22,51,0.431,11,35,0.314,30,40,0.75,107,2016-12-14,LAL,BRK,2017,112.5
8571,8571,71,@,L 97-108 ,240,35,74,0.473,30,55,0.545,5,19,0.263,22,29,0.759,97,45,95,0.474,34,75,0.453,11,20,0.55,7,13,0.538,108,2016-12-15,CHI,MIL,2017,113.5
8572,8572,72,Home,L 97-107 ,240,38,95,0.4,32,74,0.432,6,21,0.286,15,19,0.789,97,43,82,0.524,40,64,0.625,3,18,0.167,18,25,0.72,107,2016-12-21,CHI,WAS,2017,108.5
8573,8573,73,@,W 97-82 ,240,30,74,0.405,19,52,0.365,11,22,0.5,26,32,0.813,97,32,82,0.39,23,46,0.5,9,36,0.25,9,10,0.9,82,2017-01-07,ATL,DAL,2017,86.5
8574,8574,74,Home,L 97-117 ,240,35,87,0.402,25,58,0.431,10,29,0.345,17,23,0.739,97,44,92,0.478,37,69,0.536,7,23,0.304,22,38,0.579,117,2017-01-10,BRK,ATL,2017,120.5
8575,8575,75,@,L 97-98 ,240,42,86,0.488,38,64,0.594,4,22,0.182,9,10,0.9,97,37,95,0.389,30,67,0.448,7,28,0.25,17,21,0.81,98,2017-01-11,NYK,PHI,2017,101.5
8576,8576,76,@,L 97-113 ,240,36,80,0.45,26,59,0.441,10,21,0.476,15,27,0.556,97,48,92,0.522,38,64,0.594,10,28,0.357,7,8,0.875,113,2017-01-14,LAL,LAC,2017,118.0
8577,8577,77,Home,L 97-102 ,240,36,83,0.434,30,57,0.526,6,26,0.231,19,24,0.792,97,41,95,0.432,32,70,0.457,9,25,0.36,11,16,0.688,102,2017-01-15,LAL,DET,2017,106.5
8578,8578,78,@,L 97-109 ,240,33,79,0.418,27,61,0.443,6,18,0.333,25,32,0.781,97,41,77,0.532,28,47,0.596,13,30,0.433,14,22,0.636,109,2017-01-21,MIL,MIA,2017,115.5
8579,8579,79,@,W 97-95 ,240,36,83,0.434,30,63,0.476,6,20,0.3,19,25,0.76,97,36,84,0.429,31,63,0.492,5,21,0.238,18,26,0.692,95,2017-01-23,OKC,UTA,2017,97.5
8580,8580,80,@,L 97-104 ,240,35,75,0.467,23,43,0.535,12,32,0.375,15,21,0.714,97,39,86,0.453,30,54,0.556,9,32,0.281,17,18,0.944,104,2017-01-30,CLE,DAL,2017,108.5
8581,8581,81,@,L 97-125 ,240,41,94,0.436,34,73,0.466,7,21,0.333,8,10,0.8,97,48,89,0.539,33,52,0.635,15,37,0.405,14,22,0.636,125,2017-02-01,MIN,CLE,2017,132.5
8582,8582,82,Home,L 97-106 ,240,32,86,0.372,21,58,0.362,11,28,0.393,22,23,0.957,97,37,86,0.43,29,66,0.439,8,20,0.4,24,31,0.774,106,2017-02-03,BRK,IND,2017,110.0
8583,8583,83,@,L 97-121 ,240,41,92,0.446,31,66,0.47,10,26,0.385,5,10,0.5,97,45,79,0.57,35,58,0.603,10,21,0.476,21,26,0.808,121,2017-02-04,DEN,SAS,2017,126.0
8584,8584,84,@,L 97-115 ,240,37,86,0.43,32,67,0.478,5,19,0.263,18,22,0.818,97,48,95,0.505,40,76,0.526,8,19,0.421,11,13,0.846,115,2017-02-10,CHI,PHO,2017,119.0
8585,8585,85,@,W 97-96 ,240,36,73,0.493,29,49,0.592,7,24,0.292,18,25,0.72,97,38,83,0.458,26,54,0.481,12,29,0.414,8,15,0.533,96,2017-02-14,SAC,LAL,2017,102.0
8586,8586,86,Home,L 97-105 ,240,35,79,0.443,28,56,0.5,7,23,0.304,20,24,0.833,97,35,82,0.427,26,56,0.464,9,26,0.346,26,30,0.867,105,2017-02-24,LAC,SAS,2017,109.5
8587,8587,87,Home,W 97-84 ,240,41,78,0.526,36,65,0.554,5,13,0.385,10,14,0.714,97,35,83,0.422,27,50,0.54,8,33,0.242,6,9,0.667,84,2017-02-24,MIN,DAL,2017,88.0
8588,8588,88,@,L 97-107 ,240,33,78,0.423,21,40,0.525,12,38,0.316,19,22,0.864,97,40,81,0.494,35,66,0.53,5,15,0.333,22,29,0.759,107,2017-02-24,BOS,TOR,2017,109.5
8589,8589,89,@,L 97-112 ,240,36,89,0.404,29,59,0.492,7,30,0.233,18,24,0.75,97,38,74,0.514,26,48,0.542,12,26,0.462,24,34,0.706,112,2017-03-03,BRK,UTA,2017,118.0
8590,8590,90,Home,W 97-90 (OT),265,38,94,0.404,32,70,0.457,6,24,0.25,15,24,0.625,97,35,89,0.393,31,73,0.425,4,16,0.25,16,22,0.727,90,2017-03-04,SAS,MIN,2017,92.0
8591,8591,91,@,W 97-96 ,240,35,78,0.449,20,45,0.444,15,33,0.455,12,21,0.571,97,34,77,0.442,25,50,0.5,9,27,0.333,19,31,0.613,96,2017-03-05,IND,ATL,2017,100.5
8592,8592,92,Home,L 97-105 ,240,38,83,0.458,28,55,0.509,10,28,0.357,11,15,0.733,97,36,89,0.404,27,65,0.415,9,24,0.375,24,35,0.686,105,2017-03-05,LAL,NOP,2017,109.5
8593,8593,93,Home,W 96-95 ,240,38,86,0.442,34,67,0.507,4,19,0.211,16,21,0.762,96,34,84,0.405,26,61,0.426,8,23,0.348,19,23,0.826,95,2011-12-26,CHA,MIL,2012,99.0
8594,8594,94,Home,L 96-104 ,240,35,85,0.412,29,65,0.446,6,20,0.3,20,28,0.714,96,42,79,0.532,33,58,0.569,9,21,0.429,11,13,0.846,104,2011-12-26,CLE,TOR,2012,108.5
8595,8595,95,Home,W 96-71 ,240,30,71,0.423,24,55,0.436,6,16,0.375,30,37,0.811,96,29,90,0.322,28,77,0.364,1,13,0.077,12,17,0.706,71,2011-12-27,LAL,UTA,2012,71.5
8596,8596,96,@,W 96-95 ,240,36,78,0.462,35,72,0.486,1,6,0.167,23,28,0.821,96,39,82,0.476,32,64,0.5,7,18,0.389,10,16,0.625,95,2011-12-28,MIA,CHA,2012,98.5
8597,8597,97,Home,W 96-85 ,240,35,67,0.522,28,51,0.549,7,16,0.438,19,19,1.0,96,34,79,0.43,31,63,0.492,3,16,0.188,14,15,0.933,85,2011-12-30,BOS,DET,2012,86.5
8598,8598,98,Home,W 96-88 ,240,39,82,0.476,31,67,0.463,8,15,0.533,10,13,0.769,96,30,76,0.395,25,61,0.41,5,15,0.333,23,28,0.821,88,2011-12-31,DET,IND,2012,90.5
8599,8599,99,@,L 96-102 ,240,32,70,0.457,27,57,0.474,5,13,0.385,27,29,0.931,96,37,75,0.493,25,48,0.521,12,27,0.444,16,24,0.667,102,2012-01-01,TOR,ORL,2012,108.0
8600,8600,0,Home,W 96-80 ,240,35,85,0.412,27,62,0.435,8,23,0.348,18,21,0.857,96,36,89,0.404,36,74,0.486,0,15,0.0,8,16,0.5,80,2012-01-01,SAC,NOH,2012,80.0
8601,8601,1,@,L 96-106 ,240,36,82,0.439,29,62,0.468,7,20,0.35,17,21,0.81,96,41,71,0.577,29,50,0.58,12,21,0.571,12,15,0.8,106,2012-01-02,SAS,MIN,2012,112.0
8602,8602,2,@,L 96-113 ,240,34,83,0.41,25,59,0.424,9,24,0.375,19,23,0.826,96,50,91,0.549,48,83,0.578,2,8,0.25,11,16,0.688,113,2012-01-03,SAC,MEM,2012,114.0
8603,8603,3,@,L 96-107 ,240,37,79,0.468,37,68,0.544,0,11,0.0,22,27,0.815,96,41,89,0.461,36,77,0.468,5,12,0.417,20,26,0.769,107,2012-01-05,LAL,POR,2012,109.5
8604,8604,4,Home,L 96-102 (OT),265,40,87,0.46,33,69,0.478,7,18,0.389,9,13,0.692,96,42,95,0.442,35,75,0.467,7,20,0.35,11,16,0.688,102,2012-01-06,CHA,ATL,2012,105.5
8605,8605,5,@,W 96-88 ,240,37,79,0.468,32,58,0.552,5,21,0.238,17,22,0.773,96,36,77,0.468,28,60,0.467,8,17,0.471,8,10,0.8,88,2012-01-06,DEN,NOH,2012,92.0
8606,8606,6,Home,W 96-73 ,240,39,85,0.459,34,67,0.507,5,18,0.278,13,16,0.813,96,31,86,0.36,31,76,0.408,0,10,0.0,11,14,0.786,73,2012-01-06,PHI,DET,2012,73.0
8607,8607,7,Home,L 96-99 ,240,41,85,0.482,35,71,0.493,6,14,0.429,8,13,0.615,96,39,89,0.438,33,71,0.465,6,18,0.333,15,21,0.714,99,2012-01-06,WAS,NYK,2012,102.0
8608,8608,8,Home,W 96-81 ,240,32,74,0.432,24,55,0.436,8,19,0.421,24,29,0.828,96,26,64,0.406,20,53,0.377,6,11,0.545,23,28,0.821,81,2012-01-07,DAL,NOH,2012,84.0
8609,8609,9,@,L 96-108 ,240,35,84,0.417,28,72,0.389,7,12,0.583,19,25,0.76,96,38,75,0.507,31,56,0.554,7,19,0.368,25,29,0.862,108,2012-01-08,SAS,OKC,2012,111.5
8610,8610,10,Home,W 96-86 ,240,38,76,0.5,32,59,0.542,6,17,0.353,14,19,0.737,96,30,82,0.366,26,69,0.377,4,13,0.308,22,30,0.733,86,2012-01-09,PHI,IND,2012,88.0
8611,8611,11,Home,W 96-84 ,240,39,85,0.459,33,71,0.465,6,14,0.429,12,16,0.75,96,30,80,0.375,25,67,0.373,5,13,0.385,19,27,0.704,84,2012-01-11,IND,ATL,2012,86.5
8612,8612,12,Home,L 96-106 ,240,32,75,0.427,26,59,0.441,6,16,0.375,26,39,0.667,96,44,85,0.518,40,73,0.548,4,12,0.333,14,20,0.7,106,2012-01-15,DEN,UTA,2012,108.0
8613,8613,13,Home,W 96-89 ,240,36,78,0.462,29,56,0.518,7,22,0.318,17,26,0.654,96,36,77,0.468,31,60,0.517,5,17,0.294,12,17,0.706,89,2012-01-17,ORL,CHA,2012,91.5
8614,8614,14,Home,W 96-73 ,240,34,71,0.479,28,55,0.509,6,16,0.375,22,32,0.688,96,26,69,0.377,22,54,0.407,4,15,0.267,17,20,0.85,73,2012-01-18,BOS,TOR,2012,75.0
8615,8615,15,Home,L 96-98 ,240,36,86,0.419,34,77,0.442,2,9,0.222,22,33,0.667,96,36,77,0.468,26,59,0.441,10,18,0.556,16,19,0.842,98,2012-01-22,LAL,IND,2012,103.0
8616,8616,16,Home,L 96-99 ,240,39,82,0.476,34,66,0.515,5,16,0.313,13,17,0.765,96,34,82,0.415,26,67,0.388,8,15,0.533,23,25,0.92,99,2012-01-24,PHO,TOR,2012,103.0
8617,8617,17,Home,W 96-91 ,240,32,66,0.485,24,50,0.48,8,16,0.5,24,32,0.75,96,37,87,0.425,29,64,0.453,8,23,0.348,9,14,0.643,91,2012-01-25,LAL,LAC,2012,95.0
8618,8618,18,Home,L 96-99 ,240,38,81,0.469,32,62,0.516,6,19,0.316,14,24,0.583,96,36,79,0.456,25,51,0.49,11,28,0.393,16,21,0.762,99,2012-01-27,CLE,NJN,2012,104.5
8619,8619,19,Home,W 96-81 ,240,32,70,0.457,24,43,0.558,8,27,0.296,24,32,0.75,96,32,82,0.39,25,63,0.397,7,19,0.368,10,14,0.714,81,2012-01-27,DEN,TOR,2012,84.5
8620,8620,20,Home,W 96-93 ,240,35,79,0.443,28,61,0.459,7,18,0.389,19,23,0.826,96,37,80,0.463,31,67,0.463,6,13,0.462,13,14,0.929,93,2012-01-28,UTA,SAC,2012,96.0
8621,8621,21,@,L 96-99 ,240,40,82,0.488,35,64,0.547,5,18,0.278,11,14,0.786,96,38,79,0.481,30,56,0.536,8,23,0.348,15,25,0.6,99,2012-02-01,DET,NJN,2012,103.0
8622,8622,22,@,W 96-77 ,240,41,85,0.482,39,78,0.5,2,7,0.286,12,19,0.632,96,33,75,0.44,28,60,0.467,5,15,0.333,6,9,0.667,77,2012-02-02,MEM,ATL,2012,79.5
8623,8623,23,@,L 96-107 ,240,36,77,0.468,29,56,0.518,7,21,0.333,17,28,0.607,96,37,88,0.42,25,65,0.385,12,23,0.522,21,25,0.84,107,2012-02-04,OKC,SAS,2012,113.0
8624,8624,24,Home,W 96-87 ,240,39,87,0.448,35,75,0.467,4,12,0.333,14,20,0.7,96,29,75,0.387,25,61,0.41,4,14,0.286,25,30,0.833,87,2012-02-04,UTA,LAL,2012,89.0
8625,8625,25,Home,L 96-103 ,240,35,74,0.473,28,56,0.5,7,18,0.389,19,22,0.864,96,41,78,0.526,31,55,0.564,10,23,0.435,11,19,0.579,103,2012-02-08,POR,HOU,2012,108.0
8626,8626,26,@,W 96-89 ,240,42,86,0.488,34,70,0.486,8,16,0.5,4,6,0.667,96,35,74,0.473,26,47,0.553,9,27,0.333,10,16,0.625,89,2012-02-09,HOU,PHO,2012,93.5
8627,8627,27,Home,W 96-92 ,240,35,79,0.443,29,61,0.475,6,18,0.333,20,28,0.714,96,33,74,0.446,23,47,0.489,10,27,0.37,16,25,0.64,92,2012-02-13,DAL,LAC,2012,97.0
8628,8628,28,@,L 96-102 ,240,38,82,0.463,33,57,0.579,5,25,0.2,15,19,0.789,96,39,86,0.453,32,68,0.471,7,18,0.389,17,21,0.81,102,2012-02-13,PHO,GSW,2012,105.5
8629,8629,29,Home,L 96-114 ,240,33,84,0.393,24,61,0.393,9,23,0.391,21,25,0.84,96,43,83,0.518,36,69,0.522,7,14,0.5,21,25,0.84,114,2012-02-13,MIL,MIA,2012,117.5
8630,8630,30,Home,W 96-95 ,240,37,87,0.425,29,69,0.42,8,18,0.444,14,18,0.778,96,36,83,0.434,29,60,0.483,7,23,0.304,16,18,0.889,95,2012-02-15,HOU,OKC,2012,98.5
8631,8631,31,Home,W 96-81 ,240,31,82,0.378,26,73,0.356,5,9,0.556,29,46,0.63,96,32,72,0.444,26,56,0.464,6,16,0.375,11,15,0.733,81,2012-02-19,DET,BOS,2012,84.0
8632,8632,32,@,W 96-91 ,240,35,76,0.461,27,56,0.482,8,20,0.4,18,31,0.581,96,36,90,0.4,28,58,0.483,8,32,0.25,11,16,0.688,91,2012-02-22,LAL,DAL,2012,95.0
8633,8633,33,@,L 96-103 ,240,40,85,0.471,35,72,0.486,5,13,0.385,11,22,0.5,96,37,84,0.44,32,64,0.5,5,20,0.25,24,29,0.828,103,2012-02-28,UTA,SAC,2012,105.5
8634,8634,34,@,L 96-102 ,240,39,96,0.406,35,81,0.432,4,15,0.267,14,16,0.875,96,40,87,0.46,37,71,0.521,3,16,0.188,19,28,0.679,102,2012-02-29,MIL,BOS,2012,103.5
8635,8635,35,Home,W 96-85 ,240,39,80,0.488,37,68,0.544,2,12,0.167,16,19,0.842,96,35,79,0.443,31,56,0.554,4,23,0.174,11,14,0.786,85,2012-02-29,MEM,DAL,2012,87.0
8636,8636,36,@,W 96-89 ,240,37,88,0.42,30,73,0.411,7,15,0.467,15,21,0.714,96,37,86,0.43,29,66,0.439,8,20,0.4,7,12,0.583,89,2012-02-29,CHI,SAS,2012,93.0
8637,8637,37,@,L 96-102 ,240,38,85,0.447,34,69,0.493,4,16,0.25,16,21,0.762,96,36,75,0.48,26,52,0.5,10,23,0.435,20,24,0.833,102,2012-03-03,UTA,DAL,2012,107.0
8638,8638,38,@,W 96-91 ,240,39,82,0.476,32,66,0.485,7,16,0.438,11,16,0.688,96,38,97,0.392,37,86,0.43,1,11,0.091,14,17,0.824,91,2012-03-04,CHI,PHI,2012,91.5
8639,8639,39,Home,W 96-88 ,240,40,88,0.455,35,76,0.461,5,12,0.417,11,16,0.688,96,38,99,0.384,36,86,0.419,2,13,0.154,10,14,0.714,88,2012-03-04,PHO,SAC,2012,89.0
8640,8640,40,Home,L 96-101 ,240,31,70,0.443,26,55,0.473,5,15,0.333,29,40,0.725,96,38,83,0.458,30,64,0.469,8,19,0.421,17,22,0.773,101,2012-03-06,IND,ATL,2012,105.0
8641,8641,41,Home,W 96-94 ,240,37,76,0.487,34,62,0.548,3,14,0.214,19,27,0.704,96,38,87,0.437,30,65,0.462,8,22,0.364,10,13,0.769,94,2012-03-08,PHO,DAL,2012,98.0
8642,8642,42,@,W 96-90 ,240,38,91,0.418,33,74,0.446,5,17,0.294,15,24,0.625,96,37,76,0.487,31,52,0.596,6,24,0.25,10,17,0.588,90,2012-03-09,CLE,OKC,2012,93.0
8643,8643,43,@,W 96-88 ,240,37,74,0.5,29,55,0.527,8,19,0.421,14,21,0.667,96,29,76,0.382,26,61,0.426,3,15,0.2,27,33,0.818,88,2012-03-13,TOR,CLE,2012,89.5
8644,8644,44,Home,W 96-82 ,240,38,70,0.543,28,50,0.56,10,20,0.5,10,17,0.588,96,29,68,0.426,21,43,0.488,8,25,0.32,16,20,0.8,82,2012-03-14,LAC,ATL,2012,86.0
8645,8645,45,@,L 96-101 ,240,35,84,0.417,27,63,0.429,8,21,0.381,18,20,0.9,96,38,84,0.452,29,59,0.492,9,25,0.36,16,21,0.762,101,2012-03-15,CHA,DAL,2012,105.5
8646,8646,46,@,L 96-103 ,240,36,82,0.439,28,62,0.452,8,20,0.4,16,19,0.842,96,40,85,0.471,34,66,0.515,6,19,0.316,17,26,0.654,103,2012-03-23,POR,LAL,2012,106.0
8647,8647,47,Home,W 96-79 ,240,38,83,0.458,37,70,0.529,1,13,0.077,19,26,0.731,96,32,85,0.376,27,57,0.474,5,28,0.179,10,18,0.556,79,2012-03-23,TOR,NYK,2012,81.5
8648,8648,48,Home,L 96-102 ,240,31,73,0.425,24,55,0.436,7,18,0.389,27,30,0.9,96,44,86,0.512,38,73,0.521,6,13,0.462,8,10,0.8,102,2012-03-25,LAL,MEM,2012,105.0
8649,8649,49,@,L 96-105 ,240,33,80,0.413,28,60,0.467,5,20,0.25,25,30,0.833,96,35,86,0.407,23,64,0.359,12,22,0.545,23,33,0.697,105,2012-03-28,DEN,TOR,2012,111.0
8650,8650,50,@,L 96-105 ,240,35,77,0.455,31,65,0.477,4,12,0.333,22,31,0.71,96,39,72,0.542,29,51,0.569,10,21,0.476,17,24,0.708,105,2012-03-31,UTA,LAC,2012,110.0
8651,8651,51,Home,L 96-109 ,240,39,84,0.464,33,66,0.5,6,18,0.333,12,19,0.632,96,44,76,0.579,40,65,0.615,4,11,0.364,17,19,0.895,109,2012-04-04,WAS,IND,2012,111.0
8652,8652,52,@,W 96-80 ,240,38,78,0.487,25,53,0.472,13,25,0.52,7,15,0.467,96,30,72,0.417,21,48,0.438,9,24,0.375,11,16,0.688,80,2012-04-05,NYK,ORL,2012,84.5
8653,8653,53,@,L 96-101 ,240,37,78,0.474,30,63,0.476,7,15,0.467,15,22,0.682,96,39,81,0.481,35,66,0.53,4,15,0.267,19,27,0.704,101,2012-04-06,DET,ATL,2012,103.0
8654,8654,54,Home,L 96-116 ,240,38,81,0.469,35,74,0.473,3,7,0.429,17,24,0.708,96,43,82,0.524,34,62,0.548,9,20,0.45,21,23,0.913,116,2012-04-07,CHA,ATL,2012,120.5
8655,8655,55,@,L 96-105 ,240,36,83,0.434,29,61,0.475,7,22,0.318,17,23,0.739,96,38,68,0.559,34,59,0.576,4,9,0.444,25,36,0.694,105,2012-04-11,SAC,NOH,2012,107.0
8656,8656,56,Home,W 96-86 (OT),265,37,86,0.43,26,64,0.406,11,22,0.5,11,19,0.579,96,36,82,0.439,32,71,0.451,4,11,0.364,10,16,0.625,86,2012-04-12,CHI,MIA,2012,88.0
8657,8657,57,Home,W 96-85 ,240,38,69,0.551,32,56,0.571,6,13,0.462,14,21,0.667,96,33,73,0.452,31,62,0.5,2,11,0.182,17,21,0.81,85,2012-04-13,NOP,UTA,2012,86.0
8658,8658,58,Home,W 96-72 ,240,40,76,0.526,33,59,0.559,7,17,0.412,9,15,0.6,96,30,72,0.417,29,56,0.518,1,16,0.063,11,15,0.733,72,2012-04-18,MIA,TOR,2012,72.5
8659,8659,59,@,L 96-99 ,240,36,73,0.493,31,57,0.544,5,16,0.313,19,22,0.864,96,40,84,0.476,30,58,0.517,10,26,0.385,9,15,0.6,99,2012-04-21,GSW,HOU,2012,104.0
8660,8660,60,@,W 96-85 ,240,40,91,0.44,36,75,0.48,4,16,0.25,12,16,0.75,96,34,77,0.442,30,60,0.5,4,17,0.235,13,18,0.722,85,2012-04-25,WAS,CLE,2012,87.0
8661,8661,61,@,L 96-113 ,240,41,91,0.451,34,76,0.447,7,15,0.467,7,9,0.778,96,47,92,0.511,41,77,0.532,6,15,0.4,13,18,0.722,113,2012-04-26,LAL,SAC,2012,116.0
8662,8662,62,Home,W 96-94 ,240,35,83,0.422,29,64,0.453,6,19,0.316,20,27,0.741,96,36,80,0.45,30,55,0.545,6,25,0.24,16,19,0.842,94,2012-04-26,UTA,POR,2012,97.0
8663,8663,63,Home,L 96-105 ,240,35,79,0.443,29,63,0.46,6,16,0.375,20,26,0.769,96,39,79,0.494,29,52,0.558,10,27,0.37,17,23,0.739,105,2012-10-31,DET,HOU,2013,110.0
8664,8664,64,Home,L 96-107 ,240,35,73,0.479,22,50,0.44,13,23,0.565,13,18,0.722,96,44,88,0.5,37,68,0.544,7,20,0.35,12,15,0.8,107,2012-11-05,BRK,MIN,2013,110.5
8665,8665,65,@,L 96-106 ,240,36,86,0.419,25,54,0.463,11,32,0.344,13,21,0.619,96,42,78,0.538,37,60,0.617,5,18,0.278,17,23,0.739,106,2012-11-07,CLE,GSW,2013,108.5
8666,8666,66,Home,W 96-94 ,240,35,70,0.5,33,61,0.541,2,9,0.222,24,28,0.857,96,37,84,0.44,32,66,0.485,5,18,0.278,15,17,0.882,94,2012-11-09,MIN,IND,2013,96.5
8667,8667,67,Home,W 96-82 ,240,33,82,0.402,24,56,0.429,9,26,0.346,21,26,0.808,96,32,80,0.4,25,60,0.417,7,20,0.35,11,16,0.688,82,2012-11-10,HOU,DET,2013,85.5
8668,8668,68,@,W 96-92 ,240,32,72,0.444,27,57,0.474,5,15,0.333,27,34,0.794,96,35,88,0.398,32,69,0.464,3,19,0.158,19,26,0.731,92,2012-11-10,BOS,MIL,2013,93.5
8669,8669,69,Home,L 96-105 ,240,37,85,0.435,27,61,0.443,10,24,0.417,12,16,0.75,96,41,80,0.513,34,60,0.567,7,20,0.35,16,18,0.889,105,2012-11-12,PHI,MIL,2013,108.5
8670,8670,70,@,L 96-100 ,240,34,84,0.405,26,60,0.433,8,24,0.333,20,21,0.952,96,36,80,0.45,26,51,0.51,10,29,0.345,18,22,0.818,100,2012-11-14,NOP,HOU,2013,105.0
8671,8671,71,Home,L 96-112 ,240,39,85,0.459,31,65,0.477,8,20,0.4,10,14,0.714,96,42,76,0.553,34,61,0.557,8,15,0.533,20,27,0.741,112,2012-11-16,SAC,ATL,2013,116.0
8672,8672,72,@,W 96-89 ,240,34,70,0.486,31,51,0.608,3,19,0.158,25,29,0.862,96,31,87,0.356,27,70,0.386,4,17,0.235,23,31,0.742,89,2012-11-19,IND,WAS,2013,91.0
8673,8673,73,Home,W 96-85 ,240,33,78,0.423,27,57,0.474,6,21,0.286,24,29,0.828,96,33,86,0.384,28,59,0.475,5,27,0.185,14,19,0.737,85,2012-11-24,GSW,MIN,2013,87.5
8674,8674,74,Home,W 96-89 (OT),265,37,91,0.407,28,63,0.444,9,28,0.321,13,19,0.684,96,33,85,0.388,27,64,0.422,6,21,0.286,17,24,0.708,89,2012-11-26,BRK,NYK,2013,92.0
8675,8675,75,@,W 96-84 ,240,31,63,0.492,25,52,0.481,6,11,0.545,28,38,0.737,96,31,73,0.425,26,52,0.5,5,21,0.238,17,21,0.81,84,2012-11-28,UTA,NOH,2013,86.5
8676,8676,76,Home,W 96-78 ,240,36,73,0.493,30,57,0.526,6,16,0.375,18,20,0.9,96,24,69,0.348,21,54,0.389,3,15,0.2,27,37,0.73,78,2012-11-30,BOS,POR,2013,79.5
8677,8677,77,@,W 96-89 ,240,36,72,0.5,28,55,0.509,8,17,0.471,16,22,0.727,96,36,75,0.48,28,59,0.475,8,16,0.5,9,12,0.75,89,2012-12-07,MEM,NOH,2013,93.0
8678,8678,78,Home,L 96-104 ,240,31,83,0.373,22,57,0.386,9,26,0.346,25,32,0.781,96,38,84,0.452,30,64,0.469,8,20,0.4,20,23,0.87,104,2012-12-10,CHA,GSW,2013,108.0
8679,8679,79,@,L 96-119 ,240,37,84,0.44,25,57,0.439,12,27,0.444,10,16,0.625,96,48,87,0.552,41,67,0.612,7,20,0.35,16,21,0.762,119,2012-12-10,SAC,DAL,2013,122.5
8680,8680,80,Home,W 96-81 ,240,34,83,0.41,29,65,0.446,5,18,0.278,23,28,0.821,96,27,81,0.333,18,59,0.305,9,22,0.409,18,25,0.72,81,2012-12-12,IND,CLE,2013,85.5
8681,8681,81,@,W 96-89 ,240,34,78,0.436,30,67,0.448,4,11,0.364,24,26,0.923,96,41,91,0.451,39,77,0.506,2,14,0.143,5,11,0.455,89,2012-12-12,CHI,PHI,2013,90.0
8682,8682,82,@,L 96-99 ,240,37,87,0.425,29,68,0.426,8,19,0.421,14,18,0.778,96,41,84,0.488,33,65,0.508,8,19,0.421,9,15,0.6,99,2012-12-12,SAS,UTA,2013,103.0
8683,8683,83,Home,L 96-102 ,240,36,83,0.434,28,62,0.452,8,21,0.381,16,20,0.8,96,37,82,0.451,29,53,0.547,8,29,0.276,20,28,0.714,102,2012-12-14,WAS,LAL,2013,106.0
8684,8684,84,@,L 96-103 ,240,32,78,0.41,25,55,0.455,7,23,0.304,25,32,0.781,96,39,85,0.459,31,55,0.564,8,30,0.267,17,20,0.85,103,2012-12-16,HOU,TOR,2013,107.0
8685,8685,85,Home,L 96-109 ,240,39,90,0.433,30,59,0.508,9,31,0.29,9,16,0.563,96,40,78,0.513,30,49,0.612,10,29,0.345,19,24,0.792,109,2012-12-17,NYK,HOU,2013,114.0
8686,8686,86,@,L 96-103 ,240,35,75,0.467,26,48,0.542,9,27,0.333,17,17,1.0,96,34,78,0.436,28,60,0.467,6,18,0.333,29,34,0.853,103,2012-12-18,NOP,GSW,2013,106.0
8687,8687,87,@,L 96-121 ,240,42,79,0.532,40,66,0.606,2,13,0.154,10,14,0.714,96,44,82,0.537,32,54,0.593,12,28,0.429,21,26,0.808,121,2012-12-22,MEM,HOU,2013,127.0
8688,8688,88,Home,W 96-93 ,240,33,69,0.478,26,49,0.531,7,20,0.35,23,28,0.821,96,40,89,0.449,35,70,0.5,5,19,0.263,8,11,0.727,93,2012-12-22,POR,PHO,2013,95.5
8689,8689,89,@,W 96-87 ,240,36,88,0.409,28,69,0.406,8,19,0.421,16,20,0.8,96,29,77,0.377,25,56,0.446,4,21,0.19,25,32,0.781,87,2012-12-22,DET,WAS,2013,89.0
8690,8690,90,@,L 96-108 ,240,37,85,0.435,30,61,0.492,7,24,0.292,15,17,0.882,96,45,81,0.556,36,62,0.581,9,19,0.474,9,11,0.818,108,2012-12-23,POR,SAC,2013,112.5
8691,8691,91,Home,W 96-89 ,240,34,80,0.425,27,63,0.429,7,17,0.412,21,26,0.808,96,35,87,0.402,30,67,0.448,5,20,0.25,14,23,0.609,89,2012-12-28,GSW,PHI,2013,91.5
8692,8692,92,Home,W 96-94 ,240,39,82,0.476,33,64,0.516,6,18,0.333,12,15,0.8,96,36,77,0.468,26,54,0.481,10,23,0.435,12,17,0.706,94,2012-12-30,DET,MIL,2013,99.0
8693,8693,93,@,L 96-107 ,240,33,80,0.413,28,67,0.418,5,13,0.385,25,34,0.735,96,39,78,0.5,31,60,0.517,8,18,0.444,21,29,0.724,107,2012-12-30,UTA,LAC,2013,111.0
8694,8694,94,@,L 96-118 ,240,36,86,0.419,29,64,0.453,7,22,0.318,17,19,0.895,96,44,82,0.537,34,62,0.548,10,20,0.5,20,25,0.8,118,2012-12-30,BOS,SAC,2013,123.0
8695,8695,95,@,L 96-114 ,240,37,78,0.474,29,54,0.537,8,24,0.333,14,17,0.824,96,44,87,0.506,39,72,0.542,5,15,0.333,21,24,0.875,114,2012-12-31,PHO,OKC,2013,116.5
8696,8696,96,@,W 96-94 ,240,36,77,0.468,31,65,0.477,5,12,0.417,19,25,0.76,96,37,78,0.474,28,54,0.519,9,24,0.375,11,14,0.786,94,2013-01-02,CHI,ORL,2013,98.5
8697,8697,97,@,W 96-89 ,240,36,80,0.45,31,66,0.47,5,14,0.357,19,24,0.792,96,30,65,0.462,25,45,0.556,5,20,0.25,24,31,0.774,89,2013-01-04,CHI,MIA,2013,91.5
8698,8698,98,Home,L 96-105 ,240,30,79,0.38,19,46,0.413,11,33,0.333,25,37,0.676,96,40,76,0.526,36,64,0.563,4,12,0.333,21,30,0.7,105,2013-01-04,TOR,SAC,2013,107.0
8699,8699,99,Home,L 96-99 (OT),265,39,85,0.459,32,66,0.485,7,19,0.368,11,13,0.846,96,39,86,0.453,31,65,0.477,8,21,0.381,13,16,0.813,99,2013-01-05,DAL,NOH,2013,103.0
8700,8700,0,Home,L 96-102 ,240,31,76,0.408,17,44,0.386,14,32,0.438,20,26,0.769,96,39,74,0.527,33,56,0.589,6,18,0.333,18,20,0.9,102,2013-01-07,NYK,BOS,2013,105.0
8701,8701,1,Home,L 96-104 ,240,39,95,0.411,35,85,0.412,4,10,0.4,14,20,0.7,96,39,84,0.464,29,62,0.468,10,22,0.455,16,21,0.762,104,2013-01-09,CHI,MIL,2013,109.0
8702,8702,2,Home,W 96-88 ,240,38,89,0.427,27,61,0.443,11,28,0.393,9,12,0.75,96,36,78,0.462,33,71,0.465,3,7,0.429,13,16,0.813,88,2013-01-12,IND,CHA,2013,89.5
8703,8703,3,Home,L 96-107 ,240,36,85,0.424,33,72,0.458,3,13,0.231,21,27,0.778,96,40,77,0.519,32,58,0.552,8,19,0.421,19,23,0.826,107,2013-01-13,TOR,MIL,2013,111.0
8704,8704,4,@,L 96-104 ,240,36,74,0.486,31,60,0.517,5,14,0.357,19,26,0.731,96,41,71,0.577,31,55,0.564,10,16,0.625,12,21,0.571,104,2013-01-21,MIN,ATL,2013,109.0
8705,8705,5,Home,L 96-106 ,240,38,79,0.481,33,68,0.485,5,11,0.455,15,24,0.625,96,43,90,0.478,37,71,0.521,6,19,0.316,14,16,0.875,106,2013-01-23,SAC,PHO,2013,109.0
8706,8706,6,Home,W 96-83 ,240,42,82,0.512,36,65,0.554,6,17,0.353,6,9,0.667,96,29,66,0.439,26,51,0.51,3,15,0.2,22,29,0.759,83,2013-01-27,LAC,POR,2013,84.5
8707,8707,7,@,L 96-105 ,240,36,81,0.444,32,65,0.492,4,16,0.25,20,26,0.769,96,41,74,0.554,34,57,0.596,7,17,0.412,16,29,0.552,105,2013-01-27,OKC,LAL,2013,108.5
8708,8708,8,@,W 96-94 ,240,36,82,0.439,27,59,0.458,9,23,0.391,15,25,0.6,96,37,77,0.481,34,66,0.515,3,11,0.273,17,21,0.81,94,2013-01-28,SAC,WAS,2013,95.5
8709,8709,9,@,W 96-90 ,240,35,76,0.461,32,67,0.478,3,9,0.333,23,36,0.639,96,33,76,0.434,28,57,0.491,5,19,0.263,19,27,0.704,90,2013-01-30,LAC,MIN,2013,92.5
8710,8710,10,Home,W 96-86 ,240,32,76,0.421,19,41,0.463,13,35,0.371,19,26,0.731,96,33,83,0.398,25,63,0.397,8,20,0.4,12,17,0.706,86,2013-02-01,NYK,MIL,2013,90.0
8711,8711,11,Home,W 96-86 ,240,38,78,0.487,33,58,0.569,5,20,0.25,15,16,0.938,96,36,88,0.409,30,66,0.455,6,22,0.273,8,17,0.471,86,2013-02-02,SAS,WAS,2013,89.0
8712,8712,12,@,W 96-90 ,240,37,73,0.507,33,63,0.524,4,10,0.4,18,22,0.818,96,36,82,0.439,33,73,0.452,3,9,0.333,15,17,0.882,90,2013-02-05,PHO,MEM,2013,91.5
8713,8713,13,@,L 96-106 ,240,34,84,0.405,25,56,0.446,9,28,0.321,19,23,0.826,96,42,79,0.532,31,59,0.525,11,20,0.55,11,14,0.786,106,2013-02-06,NYK,WAS,2013,111.5
8714,8714,14,@,L 96-128 ,240,38,91,0.418,28,64,0.438,10,27,0.37,10,14,0.714,96,50,86,0.581,41,67,0.612,9,19,0.474,19,23,0.826,128,2013-02-07,CHI,DEN,2013,132.5
8715,8715,15,@,L 96-127 ,240,39,83,0.47,32,65,0.492,7,18,0.389,11,15,0.733,96,50,87,0.575,36,66,0.545,14,21,0.667,13,18,0.722,127,2013-02-08,PHO,OKC,2013,134.0
8716,8716,16,@,W 96-95 ,240,38,84,0.452,33,65,0.508,5,19,0.263,15,18,0.833,96,40,97,0.412,38,86,0.442,2,11,0.182,13,15,0.867,95,2013-02-13,SAS,CLE,2013,96.0
8717,8717,17,Home,W 96-85 ,240,35,79,0.443,26,61,0.426,9,18,0.5,17,25,0.68,96,34,70,0.486,31,59,0.525,3,11,0.273,14,22,0.636,85,2013-02-13,DET,WAS,2013,86.5
8718,8718,18,@,L 96-106 ,240,36,82,0.439,31,58,0.534,5,24,0.208,19,22,0.864,96,37,75,0.493,24,43,0.558,13,32,0.406,19,26,0.731,106,2013-02-13,HOU,LAC,2013,112.5
8719,8719,19,@,W 96-87 ,240,39,84,0.464,34,71,0.479,5,13,0.385,13,17,0.765,96,35,84,0.417,31,67,0.463,4,17,0.235,13,20,0.65,87,2013-02-19,CHI,NOH,2013,89.0
8720,8720,20,@,W 96-88 ,240,35,78,0.449,27,58,0.466,8,20,0.4,18,20,0.9,96,30,78,0.385,24,63,0.381,6,15,0.4,22,27,0.815,88,2013-02-19,TOR,WAS,2013,91.0
8721,8721,21,@,L 96-111 ,240,39,85,0.459,34,69,0.493,5,16,0.313,13,22,0.591,96,42,88,0.477,31,59,0.525,11,29,0.379,16,18,0.889,111,2013-02-20,ORL,DAL,2013,116.5
8722,8722,22,Home,L 96-106 ,240,40,91,0.44,30,61,0.492,10,30,0.333,6,11,0.545,96,41,77,0.532,25,47,0.532,16,30,0.533,8,12,0.667,106,2013-02-22,BRK,HOU,2013,114.0
8723,8723,23,@,W 96-95 ,240,39,72,0.542,30,57,0.526,9,15,0.6,9,16,0.563,96,40,84,0.476,32,65,0.492,8,19,0.421,7,10,0.7,95,2013-02-27,DET,WAS,2013,99.0
8724,8724,24,@,W 96-88 ,240,35,81,0.432,27,53,0.509,8,28,0.286,18,21,0.857,96,31,74,0.419,24,58,0.414,7,16,0.438,19,29,0.655,88,2013-03-01,NYK,WAS,2013,91.5
8725,8725,25,Home,W 96-85 ,240,38,73,0.521,32,58,0.552,6,15,0.4,14,14,1.0,96,32,72,0.444,27,57,0.474,5,15,0.333,16,23,0.696,85,2013-03-02,CHI,BRK,2013,87.5
8726,8726,26,@,L 96-107 ,240,37,86,0.43,31,69,0.449,6,17,0.353,16,21,0.762,96,43,80,0.538,32,56,0.571,11,24,0.458,10,17,0.588,107,2013-03-06,PHI,ATL,2013,112.5
8727,8727,27,@,L 96-97 ,240,40,89,0.449,34,61,0.557,6,28,0.214,10,12,0.833,96,32,74,0.432,26,46,0.565,6,28,0.214,27,31,0.871,97,2013-03-06,ORL,MIA,2013,100.0
8728,8728,28,Home,W 96-85 ,240,38,81,0.469,34,68,0.5,4,13,0.308,16,20,0.8,96,34,79,0.43,32,67,0.478,2,12,0.167,15,17,0.882,85,2013-03-09,MEM,NOH,2013,86.0
8729,8729,29,@,L 96-98 ,240,37,76,0.487,26,51,0.51,11,25,0.44,11,12,0.917,96,40,86,0.465,29,66,0.439,11,20,0.55,7,9,0.778,98,2013-03-10,POR,NOH,2013,103.5
8730,8730,30,@,L 96-100 ,240,36,86,0.419,29,65,0.446,7,21,0.333,17,27,0.63,96,33,84,0.393,25,61,0.41,8,23,0.348,26,34,0.765,100,2013-03-10,CLE,TOR,2013,104.0
8731,8731,31,Home,W 96-92 ,240,37,79,0.468,29,57,0.509,8,22,0.364,14,21,0.667,96,36,92,0.391,28,63,0.444,8,29,0.276,12,16,0.75,92,2013-03-13,ATL,LAL,2013,96.0
8732,8732,32,@,W 96-85 ,240,37,68,0.544,31,56,0.554,6,12,0.5,16,21,0.762,96,31,72,0.431,25,46,0.543,6,26,0.231,17,18,0.944,85,2013-03-13,MEM,LAC,2013,88.0
8733,8733,33,Home,W 96-86 ,240,41,82,0.5,34,61,0.557,7,21,0.333,7,11,0.636,96,34,78,0.436,27,62,0.435,7,16,0.438,11,18,0.611,86,2013-03-15,DAL,CLE,2013,89.5
8734,8734,34,Home,W 96-87 ,240,36,72,0.5,27,52,0.519,9,20,0.45,15,19,0.789,96,35,80,0.438,32,61,0.525,3,19,0.158,14,19,0.737,87,2013-03-15,WAS,NOH,2013,88.5
8735,8735,35,Home,L 96-113 ,240,40,80,0.5,33,61,0.541,7,19,0.368,9,15,0.6,96,45,89,0.506,38,68,0.559,7,21,0.333,16,21,0.762,113,2013-03-20,DAL,BRK,2013,116.5
8736,8736,36,Home,W 96-95 ,240,32,80,0.4,23,54,0.426,9,26,0.346,23,27,0.852,96,33,78,0.423,23,56,0.411,10,22,0.455,19,21,0.905,95,2013-03-24,HOU,SAS,2013,100.0
8737,8737,37,Home,L 96-113 ,240,39,84,0.464,33,64,0.516,6,20,0.3,12,18,0.667,96,41,73,0.562,34,55,0.618,7,18,0.389,24,32,0.75,113,2013-04-03,UTA,DEN,2013,116.5
8738,8738,38,@,L 96-105 ,240,36,80,0.45,29,59,0.492,7,21,0.333,17,23,0.739,96,39,80,0.488,34,59,0.576,5,21,0.238,22,30,0.733,105,2013-04-06,CHA,BRK,2013,107.5
8739,8739,39,@,L 96-107 ,240,39,88,0.443,29,62,0.468,10,26,0.385,8,12,0.667,96,43,77,0.558,39,66,0.591,4,11,0.364,17,21,0.81,107,2013-04-07,WAS,BOS,2013,109.0
8740,8740,40,@,W 96-91 ,240,42,90,0.467,39,77,0.506,3,13,0.231,9,12,0.75,96,37,80,0.463,33,58,0.569,4,22,0.182,13,16,0.813,91,2013-04-07,DAL,POR,2013,93.0
8741,8741,41,@,L 96-104 ,240,37,84,0.44,32,64,0.5,5,20,0.25,17,18,0.944,96,40,79,0.506,33,54,0.611,7,25,0.28,17,22,0.773,104,2013-04-09,NOP,LAL,2013,107.5
8742,8742,42,Home,W 96-86 ,240,39,86,0.453,33,71,0.465,6,15,0.4,12,21,0.571,96,35,87,0.402,31,66,0.47,4,21,0.19,12,17,0.706,86,2013-04-10,DEN,SAS,2013,88.0
8743,8743,43,@,W 96-93 ,240,35,78,0.449,28,52,0.538,7,26,0.269,19,28,0.679,96,35,83,0.422,29,64,0.453,6,19,0.316,17,32,0.531,93,2013-04-12,LAC,NOH,2013,96.0
8744,8744,44,@,W 96-95 ,240,33,66,0.5,20,38,0.526,13,28,0.464,17,27,0.63,96,39,86,0.453,34,73,0.466,5,13,0.385,12,19,0.632,95,2013-04-15,MIA,CLE,2013,97.5
8745,8745,45,@,W 96-80 ,240,36,77,0.468,33,67,0.493,3,10,0.3,21,23,0.913,96,32,75,0.427,30,58,0.517,2,17,0.118,14,18,0.778,80,2013-04-15,UTA,MIN,2013,81.0
8746,8746,46,Home,L 96-113 ,240,35,88,0.398,26,60,0.433,9,28,0.321,17,23,0.739,96,40,78,0.513,30,51,0.588,10,27,0.37,23,27,0.852,113,2013-04-16,ATL,TOR,2013,118.0
8747,8747,47,Home,W 96-83 ,240,36,76,0.474,27,51,0.529,9,25,0.36,15,24,0.625,96,33,90,0.367,29,80,0.363,4,10,0.4,13,20,0.65,83,2013-10-30,HOU,CHA,2014,85.0
8748,8748,48,@,L 96-103 ,240,32,80,0.4,18,43,0.419,14,37,0.378,18,22,0.818,96,35,82,0.427,33,64,0.516,2,18,0.111,31,37,0.838,103,2013-11-03,PHO,OKC,2014,104.0
8749,8749,49,@,L 96-99 ,240,42,85,0.494,35,66,0.53,7,19,0.368,5,9,0.556,96,41,85,0.482,35,69,0.507,6,16,0.375,11,15,0.733,99,2013-11-06,PHO,SAS,2014,102.0
8750,8750,50,Home,W 96-85 ,240,38,87,0.437,35,78,0.449,3,9,0.333,17,22,0.773,96,31,80,0.388,25,61,0.41,6,19,0.316,17,26,0.654,85,2013-11-08,NOP,LAL,2014,88.0
8751,8751,51,@,W 96-91 ,240,37,80,0.463,30,66,0.455,7,14,0.5,15,20,0.75,96,35,76,0.461,27,57,0.474,8,19,0.421,13,16,0.813,91,2013-11-09,IND,BRK,2014,95.0
8752,8752,52,@,W 96-85 ,240,36,82,0.439,27,62,0.435,9,20,0.45,15,22,0.682,96,36,78,0.462,33,66,0.5,3,12,0.25,10,14,0.714,85,2013-11-09,POR,SAC,2014,86.5
8753,8753,53,Home,W 96-81 ,240,34,83,0.41,30,67,0.448,4,16,0.25,24,26,0.923,96,31,75,0.413,26,61,0.426,5,14,0.357,14,20,0.7,81,2013-11-11,CHI,CLE,2014,83.5
8754,8754,54,Home,L 96-109 ,240,37,81,0.457,30,63,0.476,7,18,0.389,15,19,0.789,96,40,82,0.488,31,56,0.554,9,26,0.346,20,22,0.909,109,2013-11-15,BOS,POR,2014,113.5
8755,8755,55,@,W 96-80 ,240,36,80,0.45,29,64,0.453,7,16,0.438,17,19,0.895,96,29,82,0.354,24,61,0.393,5,21,0.238,17,22,0.773,80,2013-11-15,CHI,TOR,2014,82.5
8756,8756,56,Home,L 96-103 (OT),265,37,93,0.398,31,68,0.456,6,25,0.24,16,22,0.727,96,36,81,0.444,26,60,0.433,10,21,0.476,21,22,0.955,103,2013-11-16,WAS,CLE,2014,108.0
8757,8757,57,Home,L 96-103 (OT),265,37,100,0.37,29,70,0.414,8,30,0.267,14,17,0.824,96,33,87,0.379,24,57,0.421,9,30,0.3,28,36,0.778,103,2013-11-20,NYK,IND,2014,107.5
8758,8758,58,@,W 96-89 ,240,37,85,0.435,29,62,0.468,8,23,0.348,14,21,0.667,96,36,84,0.429,33,71,0.465,3,13,0.231,14,22,0.636,89,2013-11-22,ATL,DET,2014,90.5
8759,8759,59,Home,W 96-88 ,240,37,78,0.474,32,60,0.533,5,18,0.278,17,23,0.739,96,36,86,0.419,30,69,0.435,6,17,0.353,10,13,0.769,88,2013-11-22,TOR,WAS,2014,91.0
8760,8760,60,@,W 96-72 ,240,38,77,0.494,33,63,0.524,5,14,0.357,15,27,0.556,96,30,85,0.353,25,67,0.373,5,18,0.278,7,9,0.778,72,2013-11-23,CHA,MIL,2014,74.5
8761,8761,61,@,L 96-126 ,240,39,83,0.47,35,70,0.5,4,13,0.308,14,20,0.7,96,46,80,0.575,30,56,0.536,16,24,0.667,18,23,0.783,126,2013-11-23,CLE,SAS,2014,134.0
8762,8762,62,Home,L 96-104 ,240,39,84,0.464,33,63,0.524,6,21,0.286,12,14,0.857,96,46,95,0.484,35,66,0.53,11,29,0.379,1,3,0.333,104,2013-11-24,ORL,PHO,2014,109.5
8763,8763,63,@,W 96-86 ,240,35,80,0.438,26,60,0.433,9,20,0.45,17,21,0.81,96,33,74,0.446,30,65,0.462,3,9,0.333,17,20,0.85,86,2013-11-25,BOS,CHA,2014,87.5
8764,8764,64,Home,L 96-110 ,240,38,82,0.463,33,63,0.524,5,19,0.263,15,19,0.789,96,41,75,0.547,33,55,0.6,8,20,0.4,20,28,0.714,110,2013-11-25,DAL,DEN,2014,114.0
8765,8765,65,@,L 96-104 ,240,35,80,0.438,24,58,0.414,11,22,0.5,15,21,0.714,96,39,70,0.557,36,58,0.621,3,12,0.25,23,28,0.821,104,2013-12-10,BOS,BRK,2014,105.5
8766,8766,66,@,W 96-88 ,240,34,76,0.447,28,59,0.475,6,17,0.353,22,34,0.647,96,33,80,0.413,27,63,0.429,6,17,0.353,16,19,0.842,88,2013-12-11,LAC,BOS,2014,91.0
8767,8767,67,Home,L 96-101 ,240,35,81,0.432,29,64,0.453,6,17,0.353,20,27,0.741,96,38,88,0.432,31,68,0.456,7,20,0.35,18,28,0.643,101,2013-12-16,IND,DET,2014,104.5
8768,8768,68,@,W 96-92 ,240,37,75,0.493,30,53,0.566,7,22,0.318,15,19,0.789,96,37,91,0.407,32,75,0.427,5,16,0.313,13,17,0.765,92,2013-12-17,LAL,MEM,2014,94.5
8769,8769,69,Home,W 96-87 ,240,36,81,0.444,29,65,0.446,7,16,0.438,17,17,1.0,96,36,76,0.474,32,54,0.593,4,22,0.182,11,14,0.786,87,2014-01-02,UTA,MIL,2014,89.0
8770,8770,70,@,L 96-119 ,240,35,80,0.438,24,57,0.421,11,23,0.478,15,24,0.625,96,43,83,0.518,34,64,0.531,9,19,0.474,24,31,0.774,119,2014-01-05,BOS,OKC,2014,123.5
8771,8771,71,Home,L 96-112 ,240,37,86,0.43,31,66,0.47,6,20,0.3,16,16,1.0,96,43,85,0.506,34,63,0.54,9,22,0.409,17,20,0.85,112,2014-01-05,WAS,GSW,2014,116.5
8772,8772,72,Home,L 96-102 ,240,35,78,0.449,31,65,0.477,4,13,0.308,22,27,0.815,96,38,80,0.475,28,59,0.475,10,21,0.476,16,26,0.615,102,2014-01-08,NOP,WAS,2014,107.0
8773,8773,73,Home,W 96-80 ,240,32,79,0.405,21,54,0.389,11,25,0.44,21,28,0.75,96,30,75,0.4,22,50,0.44,8,25,0.32,12,18,0.667,80,2014-01-11,TOR,BRK,2014,84.0
8774,8774,74,@,L 96-98 (OT),265,33,93,0.355,26,63,0.413,7,30,0.233,23,28,0.821,96,35,81,0.432,28,61,0.459,7,20,0.35,21,27,0.778,98,2014-01-13,PHO,NYK,2014,101.5
8775,8775,75,@,L 96-108 ,240,39,89,0.438,33,66,0.5,6,23,0.261,12,18,0.667,96,42,88,0.477,31,61,0.508,11,27,0.407,13,17,0.765,108,2014-01-15,CLE,POR,2014,113.5
8776,8776,76,Home,W 96-93 ,240,40,79,0.506,34,68,0.5,6,11,0.545,10,13,0.769,96,35,76,0.461,26,52,0.5,9,24,0.375,14,16,0.875,93,2014-01-17,WAS,CHI,2014,97.5
8777,8777,77,Home,L 96-104 (OT),265,36,75,0.48,29,58,0.5,7,17,0.412,17,23,0.739,96,39,79,0.494,32,58,0.552,7,21,0.333,19,29,0.655,104,2014-01-18,CHA,MIA,2014,107.5
8778,8778,78,@,L 96-125 ,240,37,76,0.487,27,52,0.519,10,24,0.417,12,14,0.857,96,50,90,0.556,36,63,0.571,14,27,0.519,11,11,1.0,125,2014-01-24,CHA,NYK,2014,132.0
8779,8779,79,@,L 96-109 ,240,37,88,0.42,32,76,0.421,5,12,0.417,17,27,0.63,96,40,83,0.482,32,63,0.508,8,20,0.4,21,37,0.568,109,2014-01-25,IND,DEN,2014,113.0
8780,8780,80,@,W 96-86 ,240,37,83,0.446,33,71,0.465,4,12,0.333,18,23,0.783,96,33,71,0.465,28,58,0.483,5,13,0.385,15,16,0.938,86,2014-01-29,CHI,SAS,2014,88.5
8781,8781,81,@,L 96-113 ,240,38,89,0.427,33,68,0.485,5,21,0.238,15,23,0.652,96,41,92,0.446,34,67,0.507,7,25,0.28,24,40,0.6,113,2014-02-01,PHI,DET,2014,116.5
8782,8782,82,@,L 96-97 ,240,34,77,0.442,27,54,0.5,7,23,0.304,21,23,0.913,96,31,73,0.425,28,58,0.483,3,15,0.2,32,37,0.865,97,2014-02-01,BRK,IND,2014,98.5
8783,8783,83,Home,W 96-81 ,240,41,89,0.461,33,65,0.508,8,24,0.333,6,9,0.667,96,31,78,0.397,27,54,0.5,4,24,0.167,15,17,0.882,81,2014-02-01,WAS,OKC,2014,83.0
8784,8784,84,Home,W 96-89 ,240,41,82,0.5,37,68,0.544,4,14,0.286,10,12,0.833,96,33,80,0.413,28,66,0.424,5,14,0.357,18,22,0.818,89,2014-02-02,BOS,ORL,2014,91.5
8785,8785,85,@,L 96-102 ,240,34,83,0.41,28,65,0.431,6,18,0.333,22,29,0.759,96,39,85,0.459,32,65,0.492,7,20,0.35,17,21,0.81,102,2014-02-03,DET,MIA,2014,105.5
8786,8786,86,Home,L 96-110 ,240,37,69,0.536,31,53,0.585,6,16,0.375,16,22,0.727,96,42,78,0.538,34,60,0.567,8,18,0.444,18,25,0.72,110,2014-02-05,MEM,DAL,2014,114.0
8787,8787,87,@,W 96-79 ,240,37,85,0.435,31,68,0.456,6,17,0.353,16,25,0.64,96,33,85,0.388,29,69,0.42,4,16,0.25,9,13,0.692,79,2014-02-11,UTA,LAL,2014,81.0
8788,8788,88,Home,L 96-108 ,240,39,98,0.398,34,82,0.415,5,16,0.313,13,23,0.565,96,39,75,0.52,32,58,0.552,7,17,0.412,23,37,0.622,108,2014-02-18,DET,CHA,2014,111.5
8789,8789,89,@,L 96-102 ,240,31,80,0.388,24,56,0.429,7,24,0.292,27,43,0.628,96,42,87,0.483,37,72,0.514,5,15,0.333,13,15,0.867,102,2014-02-21,LAC,MEM,2014,104.5
8790,8790,90,@,W 96-83 ,240,41,96,0.427,33,76,0.434,8,20,0.4,6,10,0.6,96,30,78,0.385,28,60,0.467,2,18,0.111,21,26,0.808,83,2014-02-23,WAS,CLE,2014,84.0
8791,8791,91,Home,L 96-104 ,240,40,99,0.404,36,86,0.419,4,13,0.308,12,18,0.667,96,38,82,0.463,25,51,0.49,13,31,0.419,15,22,0.682,104,2014-02-24,DET,GSW,2014,110.5
8792,8792,92,@,L 96-101 ,240,38,87,0.437,26,63,0.413,12,24,0.5,8,11,0.727,96,38,74,0.514,32,59,0.542,6,15,0.4,19,22,0.864,101,2014-02-27,MIL,IND,2014,104.0
8793,8793,93,@,L 96-110 ,240,39,79,0.494,32,61,0.525,7,18,0.389,11,15,0.733,96,44,81,0.543,35,62,0.565,9,19,0.474,13,18,0.722,110,2014-03-01,CLE,MEM,2014,114.5
8794,8794,94,@,L 96-102 ,240,33,83,0.398,26,60,0.433,7,23,0.304,23,35,0.657,96,37,81,0.457,32,54,0.593,5,27,0.185,23,24,0.958,102,2014-03-01,DEN,POR,2014,104.5
8795,8795,95,Home,W 96-80 ,240,34,73,0.466,27,48,0.563,7,25,0.28,21,28,0.75,96,30,65,0.462,26,52,0.5,4,13,0.308,16,23,0.696,80,2014-03-03,BRK,CHI,2014,82.0
8796,8796,96,Home,W 96-85 ,240,35,83,0.422,31,71,0.437,4,12,0.333,22,30,0.733,96,32,83,0.386,22,55,0.4,10,28,0.357,11,14,0.786,85,2014-03-03,DET,NYK,2014,90.0
8797,8797,97,Home,W 96-89 ,240,32,68,0.471,31,61,0.508,1,7,0.143,31,41,0.756,96,32,75,0.427,26,55,0.473,6,20,0.3,19,28,0.679,89,2014-03-03,SAC,NOP,2014,92.0
8798,8798,98,Home,L 96-98 ,240,36,86,0.419,33,70,0.471,3,16,0.188,21,22,0.955,96,37,84,0.44,27,64,0.422,10,20,0.5,14,21,0.667,98,2014-03-04,IND,GSW,2014,103.0
8799,8799,99,Home,L 96-104 ,240,39,86,0.453,32,67,0.478,7,19,0.368,11,19,0.579,96,40,78,0.513,32,58,0.552,8,20,0.4,16,22,0.727,104,2014-03-04,PHO,LAC,2014,108.0
8800,8800,0,Home,L 96-104 ,240,32,75,0.427,24,57,0.421,8,18,0.444,24,28,0.857,96,40,79,0.506,28,58,0.483,12,21,0.571,12,15,0.8,104,2014-03-11,CHI,SAS,2014,110.0
8801,8801,1,@,W 96-95 ,240,34,78,0.436,22,49,0.449,12,29,0.414,16,19,0.842,96,33,68,0.485,24,41,0.585,9,27,0.333,20,26,0.769,95,2014-03-12,BRK,MIA,2014,99.5
8802,8802,2,@,W 96-87 ,240,37,76,0.487,28,53,0.528,9,23,0.391,13,20,0.65,96,35,77,0.455,28,63,0.444,7,14,0.5,10,13,0.769,87,2014-03-14,LAC,UTA,2014,90.5
8803,8803,3,Home,L 96-100 ,240,37,72,0.514,30,50,0.6,7,22,0.318,15,22,0.682,96,34,75,0.453,22,45,0.489,12,30,0.4,20,31,0.645,100,2014-03-18,CLE,MIA,2014,106.0
8804,8804,4,@,L 96-101 ,240,40,81,0.494,36,64,0.563,4,17,0.235,12,15,0.8,96,39,77,0.506,26,49,0.531,13,28,0.464,10,12,0.833,101,2014-03-19,MIA,BOS,2014,107.5
8805,8805,5,Home,W 96-86 ,240,36,81,0.444,34,70,0.486,2,11,0.182,22,25,0.88,96,37,84,0.44,30,66,0.455,7,18,0.389,5,10,0.5,86,2014-03-19,MEM,UTA,2014,89.5
8806,8806,6,Home,W 96-86 ,240,34,80,0.425,26,56,0.464,8,24,0.333,20,28,0.714,96,33,76,0.434,28,56,0.5,5,20,0.25,15,20,0.75,86,2014-03-23,TOR,ATL,2014,88.5
8807,8807,7,@,L 96-117 ,240,30,77,0.39,21,49,0.429,9,28,0.321,27,40,0.675,96,45,89,0.506,34,67,0.507,11,22,0.5,16,21,0.762,117,2014-03-24,DEN,OKC,2014,122.5
8808,8808,8,@,L 96-127 ,240,36,74,0.486,32,59,0.542,4,15,0.267,20,27,0.741,96,48,83,0.578,30,55,0.545,18,28,0.643,13,15,0.867,127,2014-03-25,NYK,LAL,2014,136.0
8809,8809,9,Home,L 96-97 ,240,39,84,0.464,28,58,0.483,11,26,0.423,7,13,0.538,96,37,85,0.435,28,59,0.475,9,26,0.346,14,24,0.583,97,2014-03-26,DET,CLE,2014,101.5
8810,8810,10,@,L 96-98 ,240,33,80,0.413,20,50,0.4,13,30,0.433,17,28,0.607,96,38,90,0.422,35,78,0.449,3,12,0.25,19,25,0.76,98,2014-03-26,LAC,NOP,2014,99.5
8811,8811,11,Home,W 96-80 ,240,37,78,0.474,28,57,0.491,9,21,0.429,13,20,0.65,96,32,81,0.395,29,69,0.42,3,12,0.25,13,16,0.813,80,2014-03-29,SAS,NOP,2014,81.5
8812,8812,12,@,L 96-116 ,240,36,86,0.419,30,65,0.462,6,21,0.286,18,24,0.75,96,41,74,0.554,30,56,0.536,11,18,0.611,23,26,0.885,116,2014-03-30,UTA,OKC,2014,121.5
8813,8813,13,@,L 96-105 ,240,32,84,0.381,22,49,0.449,10,35,0.286,22,28,0.786,96,44,83,0.53,38,58,0.655,6,25,0.24,11,17,0.647,105,2014-04-01,HOU,BRK,2014,108.0
8814,8814,14,Home,W 96-77 ,240,39,77,0.506,30,51,0.588,9,26,0.346,9,14,0.643,96,32,73,0.438,28,55,0.509,4,18,0.222,9,9,1.0,77,2014-04-02,MIA,MIL,2014,79.0
8815,8815,15,@,L 96-100 ,240,34,73,0.466,26,54,0.481,8,19,0.421,20,29,0.69,96,33,64,0.516,29,53,0.547,4,11,0.364,30,35,0.857,100,2014-04-04,NOP,UTA,2014,102.0
8816,8816,16,@,W 96-94 (OT),265,34,91,0.374,25,65,0.385,9,26,0.346,19,27,0.704,96,35,96,0.365,28,74,0.378,7,22,0.318,17,21,0.81,94,2014-04-05,CHA,CLE,2014,97.5
8817,8817,17,@,W 96-78 ,240,35,79,0.443,26,56,0.464,9,23,0.391,17,21,0.81,96,34,86,0.395,31,70,0.443,3,16,0.188,7,12,0.583,78,2014-04-05,CHI,WAS,2014,79.5
8818,8818,18,@,W 96-86 ,240,35,82,0.427,33,63,0.524,2,19,0.105,24,33,0.727,96,32,77,0.416,28,58,0.483,4,19,0.211,18,24,0.75,86,2014-04-11,WAS,ORL,2014,88.0
8819,8819,19,Home,L 96-114 ,240,35,67,0.522,28,44,0.636,7,23,0.304,19,26,0.731,96,41,83,0.494,29,59,0.492,12,24,0.5,20,29,0.69,114,2014-11-01,PHI,MIA,2015,120.0
8820,8820,20,Home,W 96-93 ,240,39,78,0.5,31,62,0.5,8,16,0.5,10,17,0.588,96,33,70,0.471,27,55,0.491,6,15,0.4,21,29,0.724,93,2014-11-02,NYK,CHO,2015,96.0
8821,8821,21,Home,W 96-89 ,240,35,82,0.427,30,64,0.469,5,18,0.278,21,29,0.724,96,30,77,0.39,26,55,0.473,4,22,0.182,25,31,0.806,89,2014-11-05,CHA,MIA,2015,91.0
8822,8822,22,Home,W 96-94 (OT),265,34,91,0.374,27,74,0.365,7,17,0.412,21,23,0.913,96,35,90,0.389,27,63,0.429,8,27,0.296,16,20,0.8,94,2014-11-05,WAS,IND,2015,98.0
8823,8823,23,@,L 96-103 ,240,40,84,0.476,32,63,0.508,8,21,0.381,8,11,0.727,96,33,81,0.407,24,59,0.407,9,22,0.409,28,36,0.778,103,2014-11-08,NYK,ATL,2015,107.5
8824,8824,24,@,L 96-104 ,240,39,75,0.52,31,60,0.517,8,15,0.533,10,16,0.625,96,40,83,0.482,36,69,0.522,4,14,0.286,20,23,0.87,104,2014-11-09,ORL,BRK,2015,106.0
8825,8825,25,Home,L 96-105 ,240,35,83,0.422,26,54,0.481,9,29,0.31,17,24,0.708,96,42,76,0.553,33,53,0.623,9,23,0.391,12,20,0.6,105,2014-11-09,DAL,MIA,2015,109.5
8826,8826,26,Home,L 96-97 ,240,36,93,0.387,30,70,0.429,6,23,0.261,18,25,0.72,96,33,72,0.458,27,57,0.474,6,15,0.4,25,35,0.714,97,2014-11-09,DET,UTA,2015,100.0
8827,8827,27,@,W 96-89 (OT),265,38,89,0.427,27,58,0.466,11,31,0.355,9,15,0.6,96,38,96,0.396,26,60,0.433,12,36,0.333,1,6,0.167,89,2014-11-14,DET,OKC,2015,95.0
8828,8828,28,Home,W 96-92 ,240,38,83,0.458,29,57,0.509,9,26,0.346,11,13,0.846,96,35,80,0.438,32,70,0.457,3,10,0.3,19,26,0.731,92,2014-11-19,TOR,MEM,2015,93.5
8829,8829,29,Home,L 96-122 ,240,36,78,0.462,32,55,0.582,4,23,0.174,20,33,0.606,96,44,86,0.512,31,55,0.564,13,31,0.419,21,23,0.913,122,2014-11-21,PHI,PHO,2015,128.5
8830,8830,30,Home,L 96-111 ,240,36,87,0.414,30,67,0.448,6,20,0.3,18,24,0.75,96,44,85,0.518,32,59,0.542,12,26,0.462,11,19,0.579,111,2014-11-26,ORL,GSW,2015,117.0
8831,8831,31,Home,L 96-112 ,240,34,75,0.453,27,54,0.5,7,21,0.333,21,33,0.636,96,45,80,0.563,34,52,0.654,11,28,0.393,11,15,0.733,112,2014-11-29,UTA,LAC,2015,117.5
8832,8832,32,Home,L 96-106 ,240,33,90,0.367,27,69,0.391,6,21,0.286,24,31,0.774,96,39,81,0.481,29,64,0.453,10,17,0.588,18,24,0.75,106,2014-12-02,DET,LAL,2015,111.0
8833,8833,33,@,L 96-105 ,240,39,76,0.513,37,63,0.587,2,13,0.154,16,27,0.593,96,41,93,0.441,31,65,0.477,10,28,0.357,13,20,0.65,105,2014-12-03,MEM,HOU,2015,110.0
8834,8834,34,@,L 96-113 ,240,38,92,0.413,32,76,0.421,6,16,0.375,14,19,0.737,96,46,90,0.511,38,70,0.543,8,20,0.4,13,22,0.591,113,2014-12-05,LAL,BOS,2015,117.0
8835,8835,35,Home,L 96-105 ,240,35,79,0.443,31,64,0.484,4,15,0.267,22,28,0.786,96,42,83,0.506,33,57,0.579,9,26,0.346,12,14,0.857,105,2014-12-06,SAC,ORL,2015,109.5
8836,8836,36,Home,W 96-84 ,240,36,87,0.414,26,60,0.433,10,27,0.37,14,19,0.737,96,34,93,0.366,28,58,0.483,6,35,0.171,10,13,0.769,84,2014-12-07,ATL,DEN,2015,87.0
8837,8837,37,@,W 96-94 ,240,39,87,0.448,33,66,0.5,6,21,0.286,12,17,0.706,96,34,76,0.447,27,53,0.509,7,23,0.304,19,28,0.679,94,2014-12-07,OKC,DET,2015,97.5
8838,8838,38,@,L 96-100 ,240,39,84,0.464,35,64,0.547,4,20,0.2,14,23,0.609,96,40,80,0.5,36,66,0.545,4,14,0.286,16,22,0.727,100,2014-12-09,SAS,UTA,2015,102.0
8839,8839,39,Home,W 96-87 ,240,35,84,0.417,32,70,0.457,3,14,0.214,23,29,0.793,96,38,87,0.437,33,64,0.516,5,23,0.217,6,10,0.6,87,2014-12-10,CHA,BOS,2015,89.5
8840,8840,40,Home,L 96-103 ,240,35,89,0.393,26,62,0.419,9,27,0.333,17,22,0.773,96,42,88,0.477,35,64,0.547,7,24,0.292,12,14,0.857,103,2014-12-10,IND,LAC,2015,106.5
8841,8841,41,@,L 96-104 ,240,32,75,0.427,26,55,0.473,6,20,0.3,26,31,0.839,96,39,80,0.488,30,64,0.469,9,16,0.563,17,21,0.81,104,2014-12-12,LAC,WAS,2015,108.5
8842,8842,42,@,L 96-108 ,240,36,96,0.375,29,68,0.426,7,28,0.25,17,26,0.654,96,39,88,0.443,29,54,0.537,10,34,0.294,20,34,0.588,108,2014-12-13,DEN,HOU,2015,113.0
8843,8843,43,@,W 96-94 ,240,35,73,0.479,27,57,0.474,8,16,0.5,18,22,0.818,96,30,75,0.4,18,37,0.486,12,38,0.316,22,27,0.815,94,2014-12-15,MIL,PHO,2015,100.0
8844,8844,44,Home,L 96-100 ,240,36,77,0.468,31,66,0.47,5,11,0.455,19,24,0.792,96,42,84,0.5,36,65,0.554,6,19,0.316,10,14,0.714,100,2014-12-21,MIN,IND,2015,103.0
8845,8845,45,@,W 96-88 ,240,35,82,0.427,29,59,0.492,6,23,0.261,20,25,0.8,96,35,84,0.417,28,61,0.459,7,23,0.304,11,20,0.55,88,2014-12-21,PHI,ORL,2015,91.5
8846,8846,46,@,L 96-102 ,240,36,82,0.439,29,57,0.509,7,25,0.28,17,22,0.773,96,43,91,0.473,37,68,0.544,6,23,0.261,10,14,0.714,102,2014-12-23,DEN,BRK,2015,105.0
8847,8847,47,Home,W 96-84 ,240,39,78,0.5,34,63,0.54,5,15,0.333,13,18,0.722,96,33,83,0.398,29,63,0.46,4,20,0.2,14,19,0.737,84,2014-12-23,IND,NOP,2015,86.0
8848,8848,48,@,W 96-82 ,240,36,83,0.434,30,69,0.435,6,14,0.429,18,21,0.857,96,33,86,0.384,25,61,0.41,8,25,0.32,8,15,0.533,82,2014-12-30,BRK,CHI,2015,86.0
8849,8849,49,@,W 96-80 ,240,40,90,0.444,29,65,0.446,11,25,0.44,5,10,0.5,96,29,85,0.341,21,54,0.389,8,31,0.258,14,16,0.875,80,2014-12-31,MIL,CLE,2015,84.0
8850,8850,50,@,L 96-112 ,240,37,87,0.425,30,61,0.492,7,26,0.269,15,25,0.6,96,42,84,0.5,28,52,0.538,14,32,0.438,14,16,0.875,112,2015-01-02,PHI,PHO,2015,119.0
8851,8851,51,@,W 96-88 (OT),265,37,94,0.394,27,67,0.403,10,27,0.37,12,19,0.632,96,33,84,0.393,30,59,0.508,3,25,0.12,19,23,0.826,88,2015-01-05,DAL,BRK,2015,89.5
8852,8852,52,Home,L 96-102 ,240,37,88,0.42,34,68,0.5,3,20,0.15,19,22,0.864,96,37,81,0.457,30,56,0.536,7,25,0.28,21,27,0.778,102,2015-01-06,MIL,PHO,2015,105.5
8853,8853,53,Home,W 96-86 ,240,32,72,0.444,19,47,0.404,13,25,0.52,19,23,0.826,96,35,79,0.443,30,62,0.484,5,17,0.294,11,11,1.0,86,2015-01-07,ATL,MEM,2015,88.5
8854,8854,54,Home,L 96-120 ,240,37,80,0.463,26,54,0.481,11,26,0.423,11,21,0.524,96,41,77,0.532,25,41,0.61,16,36,0.444,22,32,0.688,120,2015-01-08,NYK,HOU,2015,128.0
8855,8855,55,@,L 96-109 ,240,39,83,0.47,33,65,0.508,6,18,0.333,12,20,0.6,96,41,91,0.451,28,61,0.459,13,30,0.433,14,19,0.737,109,2015-01-10,BOS,TOR,2015,115.5
8856,8856,56,Home,L 96-98 ,240,40,89,0.449,34,71,0.479,6,18,0.333,10,12,0.833,96,32,85,0.376,19,54,0.352,13,31,0.419,21,24,0.875,98,2015-01-16,IND,DET,2015,104.5
8857,8857,57,Home,L 96-106 ,240,36,79,0.456,27,55,0.491,9,24,0.375,15,20,0.75,96,40,87,0.46,37,73,0.507,3,14,0.214,23,29,0.793,106,2015-01-16,ORL,MEM,2015,107.5
8858,8858,58,Home,W 96-81 ,240,36,80,0.45,29,58,0.5,7,22,0.318,17,27,0.63,96,29,75,0.387,25,58,0.431,4,17,0.235,19,29,0.655,81,2015-01-16,PHI,NOP,2015,83.0
8859,8859,59,@,L 96-110 ,240,37,74,0.5,31,55,0.564,6,19,0.316,16,20,0.8,96,42,94,0.447,31,65,0.477,11,29,0.379,15,17,0.882,110,2015-01-16,POR,SAS,2015,115.5
8860,8860,60,Home,W 96-80 ,240,38,83,0.458,35,67,0.522,3,16,0.188,17,21,0.81,96,28,77,0.364,22,57,0.386,6,20,0.3,18,21,0.857,80,2015-01-21,NOP,LAL,2015,83.0
8861,8861,61,@,L 96-103 ,240,40,82,0.488,35,67,0.522,5,15,0.333,11,14,0.786,96,35,87,0.402,22,56,0.393,13,31,0.419,20,20,1.0,103,2015-01-24,WAS,POR,2015,109.5
8862,8862,62,@,W 96-84 ,240,38,84,0.452,37,71,0.521,1,13,0.077,19,23,0.826,96,31,87,0.356,24,63,0.381,7,24,0.292,15,19,0.789,84,2015-01-25,MIA,CHI,2015,87.5
8863,8863,63,Home,L 96-121 ,240,35,79,0.443,28,63,0.444,7,16,0.438,19,24,0.792,96,46,91,0.505,36,68,0.529,10,23,0.435,19,26,0.731,121,2015-02-03,SAC,GSW,2015,126.0
8864,8864,64,@,L 96-105 ,240,34,77,0.442,30,61,0.492,4,16,0.25,24,30,0.8,96,38,80,0.475,27,55,0.491,11,25,0.44,18,27,0.667,105,2015-02-04,WAS,ATL,2015,110.5
8865,8865,65,@,L 96-107 ,240,35,79,0.443,24,54,0.444,11,25,0.44,15,31,0.484,96,39,86,0.453,29,59,0.492,10,27,0.37,19,25,0.76,107,2015-02-06,PHI,BOS,2015,112.0
8866,8866,66,Home,W 96-93 ,240,37,75,0.493,29,55,0.527,8,20,0.4,14,19,0.737,96,36,86,0.419,29,57,0.509,7,29,0.241,14,20,0.7,93,2015-02-07,MIL,BOS,2015,96.5
8867,8867,67,Home,L 96-100 ,240,33,79,0.418,20,57,0.351,13,22,0.591,17,20,0.85,96,39,93,0.419,30,72,0.417,9,21,0.429,13,19,0.684,100,2015-02-09,NOP,UTA,2015,104.5
8868,8868,68,Home,W 96-80 ,240,33,77,0.429,26,52,0.5,7,25,0.28,23,27,0.852,96,33,83,0.398,29,61,0.475,4,22,0.182,10,15,0.667,80,2015-02-09,WAS,ORL,2015,82.0
8869,8869,69,Home,L 96-106 ,240,37,85,0.435,31,67,0.463,6,18,0.333,16,27,0.593,96,43,79,0.544,39,63,0.619,4,16,0.25,16,23,0.696,106,2015-02-10,LAL,DEN,2015,108.0
8870,8870,70,Home,L 96-110 ,240,31,81,0.383,19,47,0.404,12,34,0.353,22,33,0.667,96,39,91,0.429,31,67,0.463,8,24,0.333,24,32,0.75,110,2015-02-25,DEN,PHO,2015,114.0
8871,8871,71,@,L 96-102 ,240,39,92,0.424,32,71,0.451,7,21,0.333,11,15,0.733,96,38,74,0.514,27,49,0.551,11,25,0.44,15,19,0.789,102,2015-02-25,BRK,NOP,2015,107.5
8872,8872,72,Home,W 96-89 ,240,37,96,0.385,28,65,0.431,9,31,0.29,13,16,0.813,96,33,77,0.429,31,63,0.492,2,14,0.143,21,31,0.677,89,2015-02-27,CHI,MIN,2015,90.0
8873,8873,73,Home,L 96-107 ,240,38,79,0.481,37,75,0.493,1,4,0.25,19,23,0.826,96,35,88,0.398,27,65,0.415,8,23,0.348,29,32,0.906,107,2015-02-27,SAC,SAS,2015,111.0
8874,8874,74,@,W 96-86 ,240,38,87,0.437,31,60,0.517,7,27,0.259,13,24,0.542,96,27,87,0.31,17,61,0.279,10,26,0.385,22,30,0.733,86,2015-03-01,LAC,CHI,2015,91.0
8875,8875,75,@,L 96-104 ,240,39,90,0.433,25,49,0.51,14,41,0.341,4,9,0.444,96,39,86,0.453,31,57,0.544,8,29,0.276,18,21,0.857,104,2015-03-03,HOU,ATL,2015,108.0
8876,8876,76,@,W 96-87 ,240,39,83,0.47,31,65,0.477,8,18,0.444,10,12,0.833,96,32,78,0.41,22,52,0.423,10,26,0.385,13,21,0.619,87,2015-03-13,ATL,PHO,2015,92.0
8877,8877,77,Home,W 96-83 ,240,37,78,0.474,29,64,0.453,8,14,0.571,14,16,0.875,96,30,72,0.417,25,53,0.472,5,19,0.263,18,27,0.667,83,2015-03-14,MEM,MIL,2015,85.5
8878,8878,78,@,L 96-112 ,240,33,77,0.429,22,55,0.4,11,22,0.5,19,22,0.864,96,44,88,0.5,39,69,0.565,5,19,0.263,19,23,0.826,112,2015-03-20,NOP,GSW,2015,114.5
8879,8879,79,@,W 96-92 ,240,29,69,0.42,25,49,0.51,4,20,0.2,34,43,0.791,96,38,87,0.437,31,63,0.492,7,24,0.292,9,14,0.643,92,2015-03-27,BOS,NYK,2015,95.5
8880,8880,80,@,L 96-99 ,240,35,84,0.417,27,57,0.474,8,27,0.296,18,31,0.581,96,35,78,0.449,27,56,0.482,8,22,0.364,21,27,0.778,99,2015-03-30,HOU,TOR,2015,103.0
8881,8881,81,@,L 96-106 ,240,39,87,0.448,28,61,0.459,11,26,0.423,7,9,0.778,96,41,91,0.451,35,77,0.455,6,14,0.429,18,23,0.783,106,2015-04-06,POR,BRK,2015,109.0
8882,8882,82,Home,W 96-69 ,240,41,83,0.494,37,58,0.638,4,25,0.16,10,14,0.714,96,26,83,0.313,22,63,0.349,4,20,0.2,13,18,0.722,69,2015-04-07,ATL,PHO,2015,71.0
8883,8883,83,Home,W 96-73 ,240,41,83,0.494,35,63,0.556,6,20,0.3,8,12,0.667,96,27,83,0.325,24,65,0.369,3,18,0.167,16,22,0.727,73,2015-04-12,MIL,BRK,2015,74.5
8884,8884,84,Home,L 96-103 ,240,36,79,0.456,30,60,0.5,6,19,0.316,18,22,0.818,96,38,73,0.521,29,50,0.58,9,23,0.391,18,26,0.692,103,2015-11-02,BRK,MIL,2016,107.5
8885,8885,85,@,L 96-102 ,240,36,98,0.367,27,68,0.397,9,30,0.3,15,21,0.714,96,37,81,0.457,29,55,0.527,8,26,0.308,20,23,0.87,102,2015-11-02,PHO,LAC,2016,106.0
8886,8886,86,Home,W 96-86 ,240,33,83,0.398,26,56,0.464,7,27,0.259,23,32,0.719,96,33,84,0.393,25,60,0.417,8,24,0.333,12,15,0.8,86,2015-11-04,CLE,NYK,2016,90.0
8887,8887,87,@,W 96-84 ,240,37,85,0.435,26,61,0.426,11,24,0.458,11,17,0.647,96,28,72,0.389,23,52,0.442,5,20,0.25,23,34,0.676,84,2015-11-05,UTA,DEN,2016,86.5
8888,8888,88,@,W 96-84 ,240,37,76,0.487,33,62,0.532,4,14,0.286,18,25,0.72,96,30,85,0.353,26,73,0.356,4,12,0.333,20,22,0.909,84,2015-11-05,MIA,MIN,2016,86.0
8889,8889,89,@,L 96-115 ,240,37,77,0.481,30,57,0.526,7,20,0.35,15,21,0.714,96,44,87,0.506,29,57,0.509,15,30,0.5,12,20,0.6,115,2015-11-05,MEM,POR,2016,122.5
8890,8890,90,Home,W 96-76 ,240,35,83,0.422,27,63,0.429,8,20,0.4,18,25,0.72,96,28,71,0.394,25,52,0.481,3,19,0.158,17,22,0.773,76,2015-11-08,MIA,TOR,2016,77.5
8891,8891,91,@,L 96-101 ,240,33,74,0.446,26,47,0.553,7,27,0.259,23,35,0.657,96,37,79,0.468,30,60,0.5,7,19,0.368,20,26,0.769,101,2015-11-14,DET,LAC,2016,104.5
8892,8892,92,Home,L 96-97 ,240,37,76,0.487,29,54,0.537,8,22,0.364,14,17,0.824,96,39,76,0.513,32,55,0.582,7,21,0.333,12,17,0.706,97,2015-11-15,ATL,UTA,2016,100.5
8893,8893,93,Home,W 96-95 ,240,35,86,0.407,29,71,0.408,6,15,0.4,20,32,0.625,96,35,87,0.402,26,66,0.394,9,21,0.429,16,24,0.667,95,2015-11-16,CHI,IND,2016,99.5
8894,8894,94,Home,W 96-84 ,240,36,85,0.424,28,61,0.459,8,24,0.333,16,19,0.842,96,28,74,0.378,22,45,0.489,6,29,0.207,22,37,0.595,84,2015-11-20,MEM,HOU,2016,87.0
8895,8895,95,@,W 96-86 ,240,40,87,0.46,34,59,0.576,6,28,0.214,10,13,0.769,96,33,77,0.429,30,64,0.469,3,13,0.231,17,25,0.68,86,2015-11-20,DET,MIN,2016,87.5
8896,8896,96,Home,W 96-91 ,240,30,69,0.435,25,51,0.49,5,18,0.278,31,45,0.689,96,31,82,0.378,21,51,0.412,10,31,0.323,19,24,0.792,91,2015-11-21,MIA,PHI,2016,96.0
8897,8897,97,@,L 96-110 ,240,30,77,0.39,19,43,0.442,11,34,0.324,25,28,0.893,96,37,86,0.43,30,65,0.462,7,21,0.333,29,37,0.784,110,2015-11-24,DAL,MEM,2016,113.5
8898,8898,98,@,L 96-108 ,240,36,82,0.439,29,59,0.492,7,23,0.304,17,23,0.739,96,38,78,0.487,26,48,0.542,12,30,0.4,20,26,0.769,108,2015-11-28,LAL,POR,2016,114.0
8899,8899,99,@,W 96-93 ,240,38,86,0.442,33,69,0.478,5,17,0.294,15,20,0.75,96,29,77,0.377,25,58,0.431,4,19,0.211,31,38,0.816,93,2015-12-01,ORL,MIN,2016,95.0
8900,8900,0,@,W 96-86 ,240,36,79,0.456,30,54,0.556,6,25,0.24,18,24,0.75,96,33,90,0.367,25,63,0.397,8,27,0.296,12,16,0.75,86,2015-12-02,TOR,ATL,2016,90.0
8901,8901,1,Home,L 96-100 ,240,37,81,0.457,29,52,0.558,8,29,0.276,14,20,0.7,96,39,84,0.464,27,58,0.466,12,26,0.462,10,18,0.556,100,2015-12-04,DAL,HOU,2016,106.0
8902,8902,2,Home,L 96-102 ,240,37,89,0.416,28,64,0.438,9,25,0.36,13,19,0.684,96,37,89,0.416,27,55,0.491,10,34,0.294,18,25,0.72,102,2015-12-05,CHI,CHO,2016,107.0
8903,8903,3,Home,W 96-83 ,240,36,86,0.419,30,58,0.517,6,28,0.214,18,20,0.9,96,35,81,0.432,30,61,0.492,5,20,0.25,8,13,0.615,83,2015-12-11,IND,MIA,2016,85.5
8904,8904,4,Home,L 96-106 ,240,36,83,0.434,23,48,0.479,13,35,0.371,11,18,0.611,96,45,96,0.469,33,62,0.532,12,34,0.353,4,7,0.571,106,2015-12-11,PHO,POR,2016,112.0
8905,8905,5,@,L 96-118 ,240,41,82,0.5,38,66,0.576,3,16,0.188,11,18,0.611,96,45,90,0.5,32,61,0.525,13,29,0.448,15,19,0.789,118,2015-12-12,IND,DET,2016,124.5
8906,8906,6,Home,W 96-76 ,240,32,78,0.41,25,56,0.446,7,22,0.318,25,34,0.735,96,28,84,0.333,18,56,0.321,10,28,0.357,10,14,0.714,76,2015-12-13,TOR,PHI,2016,81.0
8907,8907,7,@,L 96-115 ,240,38,92,0.413,27,61,0.443,11,31,0.355,9,13,0.692,96,43,85,0.506,35,63,0.556,8,22,0.364,21,26,0.808,115,2015-12-14,PHI,CHI,2016,119.0
8908,8908,8,Home,W 96-84 ,240,37,83,0.446,32,64,0.5,5,19,0.263,17,21,0.81,96,30,77,0.39,25,49,0.51,5,28,0.179,19,25,0.76,84,2015-12-19,MEM,IND,2016,86.5
8909,8909,9,Home,L 96-104 ,240,36,87,0.414,23,62,0.371,13,25,0.52,11,17,0.647,96,42,91,0.462,28,56,0.5,14,35,0.4,6,13,0.462,104,2015-12-23,PHO,DEN,2016,111.0
8910,8910,10,Home,L 96-105 ,240,37,96,0.385,31,72,0.431,6,24,0.25,16,23,0.696,96,40,92,0.435,33,74,0.446,7,18,0.389,18,20,0.9,105,2015-12-25,OKC,CHI,2016,108.5
8911,8911,11,Home,L 96-111 ,240,43,89,0.483,38,72,0.528,5,17,0.294,5,16,0.313,96,42,84,0.5,30,57,0.526,12,27,0.444,15,22,0.682,111,2015-12-26,BRK,WAS,2016,117.0
8912,8912,12,@,L 96-112 ,240,32,84,0.381,24,55,0.436,8,29,0.276,24,32,0.75,96,45,80,0.563,39,64,0.609,6,16,0.375,16,22,0.727,112,2015-12-27,LAL,MEM,2016,115.0
8913,8913,13,@,L 96-108 ,240,37,89,0.416,27,62,0.435,10,27,0.37,12,17,0.706,96,43,79,0.544,35,63,0.556,8,16,0.5,14,17,0.824,108,2015-12-29,DET,NYK,2016,112.0
8914,8914,14,@,L 96-109 ,240,35,78,0.449,19,42,0.452,16,36,0.444,10,14,0.714,96,43,86,0.5,28,53,0.528,15,33,0.455,8,11,0.727,109,2015-12-31,POR,UTA,2016,116.5
8915,8915,15,Home,W 96-95 ,240,37,80,0.463,33,71,0.465,4,9,0.444,18,29,0.621,96,35,84,0.417,21,40,0.525,14,44,0.318,11,16,0.688,95,2016-01-08,MIL,DAL,2016,102.0
8916,8916,16,Home,L 96-101 ,240,36,81,0.444,29,63,0.46,7,18,0.389,17,23,0.739,96,39,84,0.464,30,62,0.484,9,22,0.409,14,18,0.778,101,2016-01-12,MIN,OKC,2016,105.5
8917,8917,17,@,W 96-87 ,240,36,74,0.486,27,55,0.491,9,19,0.474,15,21,0.714,96,33,84,0.393,29,67,0.433,4,17,0.235,17,26,0.654,87,2016-01-20,PHI,ORL,2016,89.0
8918,8918,18,@,W 96-83 ,240,38,87,0.437,31,70,0.443,7,17,0.412,13,15,0.867,96,35,94,0.372,31,70,0.443,4,24,0.167,9,22,0.409,83,2016-01-23,CHI,CLE,2016,85.0
8919,8919,19,Home,W 96-93 ,240,32,76,0.421,26,49,0.531,6,27,0.222,26,30,0.867,96,35,80,0.438,31,64,0.484,4,16,0.25,19,28,0.679,93,2016-01-31,POR,MIN,2016,95.0
8920,8920,20,@,L 96-105 (OT),265,39,90,0.433,34,69,0.493,5,21,0.238,13,20,0.65,96,38,85,0.447,31,67,0.463,7,18,0.389,22,33,0.667,105,2016-02-01,CHI,UTA,2016,108.5
8921,8921,21,Home,L 96-99 ,240,39,85,0.459,35,65,0.538,4,20,0.2,14,26,0.538,96,39,81,0.481,32,61,0.525,7,20,0.35,14,20,0.7,99,2016-02-04,NOP,LAL,2016,102.5
8922,8922,22,@,L 96-102 ,240,38,91,0.418,25,60,0.417,13,31,0.419,7,9,0.778,96,39,76,0.513,29,49,0.592,10,27,0.37,14,20,0.7,102,2016-02-05,IND,ATL,2016,107.0
8923,8923,23,@,W 96-79 ,240,35,87,0.402,24,52,0.462,11,35,0.314,15,23,0.652,96,25,77,0.325,18,41,0.439,7,36,0.194,22,30,0.733,79,2016-02-06,POR,HOU,2016,82.5
8924,8924,24,Home,L 96-101 ,240,37,84,0.44,29,62,0.468,8,22,0.364,14,20,0.7,96,37,86,0.43,32,65,0.492,5,21,0.238,22,28,0.786,101,2016-02-07,NYK,DEN,2016,103.5
8925,8925,25,Home,W 96-94 ,240,39,85,0.459,32,60,0.533,7,25,0.28,11,12,0.917,96,35,91,0.385,22,63,0.349,13,28,0.464,11,15,0.733,94,2016-02-07,ORL,ATL,2016,100.5
8926,8926,26,@,L 96-100 ,240,33,70,0.471,26,49,0.531,7,21,0.333,23,30,0.767,96,39,82,0.476,31,63,0.492,8,19,0.421,14,21,0.667,100,2016-02-10,UTA,NOP,2016,104.0
8927,8927,27,Home,L 96-98 ,240,37,91,0.407,29,71,0.408,8,20,0.4,14,16,0.875,96,38,89,0.427,30,69,0.435,8,20,0.4,14,15,0.933,98,2016-02-10,ORL,SAS,2016,102.0
8928,8928,28,Home,L 96-104 ,240,35,81,0.432,30,59,0.508,5,22,0.227,21,24,0.875,96,40,79,0.506,30,52,0.577,10,27,0.37,14,15,0.933,104,2016-02-21,BRK,CHO,2016,109.0
8929,8929,29,@,W 96-88 ,240,37,80,0.463,29,55,0.527,8,25,0.32,14,21,0.667,96,34,79,0.43,26,53,0.491,8,26,0.308,12,13,0.923,88,2016-02-22,DET,CLE,2016,92.0
8930,8930,30,@,W 96-78 ,240,38,79,0.481,29,61,0.475,9,18,0.5,11,12,0.917,96,33,77,0.429,30,60,0.5,3,17,0.176,9,12,0.75,78,2016-02-25,SAS,UTA,2016,79.5
8931,8931,31,@,W 96-95 ,240,36,83,0.434,25,55,0.455,11,28,0.393,13,19,0.684,96,35,85,0.412,31,66,0.47,4,19,0.211,21,24,0.875,95,2016-02-26,CHA,IND,2016,97.0
8932,8932,32,Home,L 96-98 ,240,37,89,0.416,32,69,0.464,5,20,0.25,17,25,0.68,96,40,84,0.476,33,69,0.478,7,15,0.467,11,17,0.647,98,2016-02-27,UTA,BRK,2016,101.5
8933,8933,33,@,L 96-100 ,240,37,80,0.463,29,62,0.468,8,18,0.444,14,15,0.933,96,35,83,0.422,26,54,0.481,9,29,0.31,21,25,0.84,100,2016-02-29,IND,CLE,2016,104.5
8934,8934,34,Home,L 96-103 ,240,40,75,0.533,32,50,0.64,8,25,0.32,8,10,0.8,96,36,75,0.48,33,55,0.6,3,20,0.15,28,36,0.778,103,2016-02-29,DEN,MEM,2016,104.5
8935,8935,35,Home,L 96-104 ,240,34,90,0.378,31,71,0.437,3,19,0.158,25,30,0.833,96,32,76,0.421,25,51,0.49,7,25,0.28,33,43,0.767,104,2016-03-06,MIL,OKC,2016,107.5
8936,8936,36,@,L 96-116 ,240,32,84,0.381,25,58,0.431,7,26,0.269,25,31,0.806,96,41,87,0.471,26,55,0.473,15,32,0.469,19,24,0.792,116,2016-03-09,MEM,BOS,2016,123.5
8937,8937,37,Home,L 96-102 ,240,39,86,0.453,30,56,0.536,9,30,0.3,9,11,0.818,96,38,85,0.447,29,58,0.5,9,27,0.333,17,30,0.567,102,2016-03-09,DAL,DET,2016,106.5
8938,8938,38,@,L 96-104 ,240,35,82,0.427,28,59,0.475,7,23,0.304,19,27,0.704,96,38,82,0.463,31,58,0.534,7,24,0.292,21,29,0.724,104,2016-03-10,ATL,TOR,2016,107.5
8939,8939,39,Home,L 96-118 ,240,38,81,0.469,30,60,0.5,8,21,0.381,12,15,0.8,96,47,91,0.516,37,73,0.507,10,18,0.556,14,20,0.7,118,2016-03-11,CHI,MIA,2016,123.0
8940,8940,40,Home,L 96-99 ,240,36,84,0.429,30,57,0.526,6,27,0.222,18,25,0.72,96,37,86,0.43,30,65,0.462,7,21,0.333,18,21,0.857,99,2016-03-11,OKC,MIN,2016,102.5
8941,8941,41,Home,L 96-107 ,240,32,76,0.421,22,46,0.478,10,30,0.333,22,34,0.647,96,42,87,0.483,33,57,0.579,9,30,0.3,14,18,0.778,107,2016-03-14,CHA,DAL,2016,111.5
8942,8942,42,@,L 96-117 ,240,35,87,0.402,29,67,0.433,6,20,0.3,20,23,0.87,96,43,88,0.489,30,67,0.448,13,21,0.619,18,24,0.75,117,2016-03-16,CHI,WAS,2016,123.5
8943,8943,43,Home,W 96-86 ,240,37,75,0.493,32,56,0.571,5,19,0.263,17,25,0.68,96,34,92,0.37,31,79,0.392,3,13,0.231,15,17,0.882,86,2016-03-17,MIL,MEM,2016,87.5
8944,8944,44,@,L 96-107 ,240,39,93,0.419,34,74,0.459,5,19,0.263,13,19,0.684,96,40,85,0.471,33,63,0.524,7,22,0.318,20,24,0.833,107,2016-03-21,ORL,BOS,2016,110.5
8945,8945,45,Home,W 96-94 ,240,37,82,0.451,33,63,0.524,4,19,0.211,18,28,0.643,96,32,80,0.4,26,56,0.464,6,24,0.25,24,32,0.75,94,2016-03-24,LAC,POR,2016,97.0
8946,8946,46,Home,L 96-98 ,240,39,90,0.433,36,71,0.507,3,19,0.158,15,17,0.882,96,37,87,0.425,27,61,0.443,10,26,0.385,14,16,0.875,98,2016-03-29,IND,CHI,2016,103.0
8947,8947,47,Home,L 96-103 (OT),265,37,92,0.402,28,60,0.467,9,32,0.281,13,29,0.448,96,39,89,0.438,27,54,0.5,12,35,0.343,13,18,0.722,103,2016-03-30,UTA,GSW,2016,109.0
8948,8948,48,Home,W 96-90 ,240,34,78,0.436,28,55,0.509,6,23,0.261,22,31,0.71,96,32,88,0.364,21,53,0.396,11,35,0.314,15,21,0.714,90,2016-04-05,TOR,CHO,2016,95.5
8949,8949,49,@,L 96-118 ,240,37,83,0.446,30,65,0.462,7,18,0.389,15,19,0.789,96,43,77,0.558,37,57,0.649,6,20,0.3,26,30,0.867,118,2016-04-10,ORL,MIA,2016,121.0
8950,8950,50,Home,L 96-103 ,240,39,89,0.438,29,63,0.46,10,26,0.385,8,12,0.667,96,41,93,0.441,28,56,0.5,13,37,0.351,8,15,0.533,103,2016-04-13,BRK,TOR,2016,109.5
8951,8951,51,@,W 96-91 ,240,35,74,0.473,29,51,0.569,6,23,0.261,20,26,0.769,96,31,77,0.403,19,38,0.5,12,39,0.308,17,21,0.81,91,2016-04-13,SAS,DAL,2016,97.0
8952,8952,52,@,L 96-101 ,240,39,83,0.47,30,53,0.566,9,30,0.3,9,15,0.6,96,41,85,0.482,35,60,0.583,6,25,0.24,13,15,0.867,101,2016-04-13,UTA,LAL,2016,104.0
8953,8953,53,Home,L 96-107 ,240,39,92,0.424,36,76,0.474,3,16,0.188,15,20,0.75,96,40,89,0.449,33,66,0.5,7,23,0.304,20,24,0.833,107,2016-10-26,MIL,CHO,2017,110.5
8954,8954,54,Home,L 96-108 ,240,34,89,0.382,28,71,0.394,6,18,0.333,22,28,0.786,96,47,97,0.485,43,81,0.531,4,16,0.25,10,16,0.625,108,2016-10-26,ORL,MIA,2017,110.0
8955,8955,55,Home,W 96-89 ,240,31,75,0.413,25,50,0.5,6,25,0.24,28,40,0.7,96,32,84,0.381,23,61,0.377,9,23,0.391,16,21,0.762,89,2016-10-28,UTA,LAL,2017,93.5
8956,8956,56,@,L 96-113 ,240,35,87,0.402,28,55,0.509,7,32,0.219,19,24,0.792,96,45,95,0.474,36,69,0.522,9,26,0.346,14,17,0.824,113,2016-10-30,LAL,OKC,2017,117.5
8957,8957,57,@,L 96-108 (OT),265,34,89,0.382,29,66,0.439,5,23,0.217,23,27,0.852,96,37,86,0.43,24,57,0.421,13,29,0.448,21,29,0.724,108,2016-11-01,SAC,MIA,2017,114.5
8958,8958,58,@,L 96-122 ,240,35,87,0.402,25,60,0.417,10,27,0.37,16,28,0.571,96,46,89,0.517,32,59,0.542,14,30,0.467,16,20,0.8,122,2016-11-03,OKC,GSW,2017,129.0
8959,8959,59,Home,W 96-87 ,240,37,84,0.44,31,59,0.525,6,25,0.24,16,18,0.889,96,34,88,0.386,25,60,0.417,9,28,0.321,10,15,0.667,87,2016-11-04,TOR,MIA,2017,91.5
8960,8960,60,@,W 96-91 ,240,34,78,0.436,29,62,0.468,5,16,0.313,23,31,0.742,96,30,84,0.357,23,54,0.426,7,30,0.233,24,31,0.774,91,2016-11-06,SAC,TOR,2017,94.5
8961,8961,61,@,L 96-110 ,240,33,79,0.418,22,46,0.478,11,33,0.333,19,27,0.704,96,44,92,0.478,34,62,0.548,10,30,0.333,12,17,0.706,110,2016-11-09,BRK,NYK,2017,115.0
8962,8962,62,Home,W 96-86 ,240,36,81,0.444,27,61,0.443,9,20,0.45,15,19,0.789,96,32,76,0.421,27,51,0.529,5,25,0.2,17,21,0.81,86,2016-11-11,SAS,DET,2017,88.5
8963,8963,63,@,L 96-117 ,240,36,83,0.434,25,54,0.463,11,29,0.379,13,20,0.65,96,48,95,0.505,35,63,0.556,13,32,0.406,8,14,0.571,117,2016-11-12,PHI,ATL,2017,123.5
8964,8964,64,@,L 96-106 ,240,35,78,0.449,29,48,0.604,6,30,0.2,20,21,0.952,96,36,68,0.529,29,50,0.58,7,18,0.389,27,36,0.75,106,2016-11-12,MEM,MIL,2017,109.5
8965,8965,65,Home,L 96-102 ,240,35,73,0.479,27,45,0.6,8,28,0.286,18,22,0.818,96,36,76,0.474,28,55,0.509,8,21,0.381,22,26,0.846,102,2016-11-14,UTA,MEM,2017,106.0
8966,8966,66,Home,W 96-73 ,240,39,97,0.402,32,67,0.478,7,30,0.233,11,21,0.524,96,28,85,0.329,21,62,0.339,7,23,0.304,10,13,0.769,73,2016-11-17,MIA,MIL,2017,76.5
8967,8967,67,@,L 96-100 ,240,39,84,0.464,32,56,0.571,7,28,0.25,11,17,0.647,96,37,90,0.411,27,61,0.443,10,29,0.345,16,24,0.667,100,2016-11-18,ATL,CHO,2017,105.0
8968,8968,68,Home,L 96-116 ,240,36,76,0.474,35,69,0.507,1,7,0.143,23,29,0.793,96,46,97,0.474,37,71,0.521,9,26,0.346,15,18,0.833,116,2016-11-18,IND,PHO,2017,120.5
8969,8969,69,Home,L 96-99 ,240,36,87,0.414,29,70,0.414,7,17,0.412,17,24,0.708,96,35,78,0.449,25,47,0.532,10,31,0.323,19,27,0.704,99,2016-11-21,DET,HOU,2017,104.0
8970,8970,70,Home,W 96-91 ,240,35,75,0.467,27,55,0.491,8,20,0.4,18,25,0.72,96,35,74,0.473,27,47,0.574,8,27,0.296,13,20,0.65,91,2016-11-21,SAS,DAL,2017,95.0
8971,8971,71,@,W 96-85 ,240,36,85,0.424,31,65,0.477,5,20,0.25,19,22,0.864,96,34,84,0.405,27,57,0.474,7,27,0.259,10,14,0.714,85,2016-11-23,ATL,IND,2017,88.5
8972,8972,72,@,L 96-117 ,240,33,86,0.384,30,69,0.435,3,17,0.176,27,33,0.818,96,45,83,0.542,36,59,0.61,9,24,0.375,18,23,0.783,117,2016-11-23,MIN,NOP,2017,121.5
8973,8973,73,Home,L 96-104 ,240,38,92,0.413,31,64,0.484,7,28,0.25,13,17,0.765,96,41,86,0.477,33,62,0.532,8,24,0.333,14,20,0.7,104,2016-11-27,ORL,MIL,2017,108.0
8974,8974,74,@,W 96-90 ,240,33,81,0.407,31,73,0.425,2,8,0.25,28,41,0.683,96,32,91,0.352,28,70,0.4,4,21,0.19,22,29,0.759,90,2016-11-30,LAL,CHI,2017,92.0
8975,8975,75,Home,L 96-114 ,240,39,85,0.459,34,65,0.523,5,20,0.25,13,21,0.619,96,45,88,0.511,35,64,0.547,10,24,0.417,14,16,0.875,114,2016-12-02,NOP,LAC,2017,119.0
8976,8976,76,Home,L 96-97 ,240,30,73,0.411,24,49,0.49,6,24,0.25,30,34,0.882,96,40,93,0.43,32,65,0.492,8,28,0.286,9,14,0.643,97,2016-12-05,MIL,SAS,2017,101.0
8977,8977,77,Home,W 96-91 ,240,33,86,0.384,31,69,0.449,2,17,0.118,28,35,0.8,96,32,82,0.39,18,41,0.439,14,41,0.341,13,26,0.5,91,2016-12-06,MEM,PHI,2017,98.0
8978,8978,78,@,L 96-99 ,240,40,90,0.444,29,58,0.5,11,32,0.344,5,8,0.625,96,41,83,0.494,38,62,0.613,3,21,0.143,14,27,0.519,99,2016-12-11,BOS,OKC,2017,100.5
8979,8979,79,Home,W 96-88 ,240,34,78,0.436,25,50,0.5,9,28,0.321,19,26,0.731,96,32,98,0.327,24,68,0.353,8,30,0.267,16,19,0.842,88,2016-12-16,BOS,CHO,2017,92.0
8980,8980,80,@,W 96-92 ,240,31,80,0.388,24,56,0.429,7,24,0.292,27,37,0.73,96,29,77,0.377,24,52,0.462,5,25,0.2,29,36,0.806,92,2016-12-16,SAC,MEM,2017,94.5
8981,8981,81,@,W 96-95 ,240,35,83,0.422,28,52,0.538,7,31,0.226,19,23,0.826,96,32,72,0.444,22,45,0.489,10,27,0.37,21,28,0.75,95,2016-12-21,DAL,POR,2017,100.0
8982,8982,82,@,L 96-123 ,240,37,79,0.468,30,55,0.545,7,24,0.292,15,18,0.833,96,45,80,0.563,36,55,0.655,9,25,0.36,24,27,0.889,123,2016-12-23,WAS,MIL,2017,127.5
8983,8983,83,Home,L 96-116 ,240,33,83,0.398,23,56,0.411,10,27,0.37,20,28,0.714,96,43,76,0.566,34,61,0.557,9,15,0.6,21,27,0.778,116,2016-12-31,CHI,MIL,2017,120.5
8984,8984,84,Home,L 96-110 ,240,36,85,0.424,25,56,0.446,11,29,0.379,13,16,0.813,96,41,84,0.488,29,57,0.509,12,27,0.444,16,19,0.842,110,2017-01-09,NYK,NOP,2017,116.0
8985,8985,85,@,L 96-105 ,240,39,92,0.424,33,65,0.508,6,27,0.222,12,18,0.667,96,39,76,0.513,30,50,0.6,9,26,0.346,18,26,0.692,105,2017-01-11,ORL,LAC,2017,109.5
8986,8986,86,Home,W 96-86 ,240,39,86,0.453,34,68,0.5,5,18,0.278,13,14,0.929,96,33,85,0.388,30,65,0.462,3,20,0.15,17,21,0.81,86,2017-01-13,MIN,OKC,2017,87.5
8987,8987,87,@,L 96-112 ,240,34,84,0.405,24,59,0.407,10,25,0.4,18,26,0.692,96,40,87,0.46,32,59,0.542,8,28,0.286,24,31,0.774,112,2017-01-20,MIL,ORL,2017,116.0
8988,8988,88,Home,W 96-88 ,240,33,81,0.407,27,55,0.491,6,26,0.231,24,28,0.857,96,36,84,0.429,32,70,0.457,4,14,0.286,12,13,0.923,88,2017-01-26,UTA,LAL,2017,90.0
8989,8989,89,@,L 96-104 ,240,37,87,0.425,33,61,0.541,4,26,0.154,18,22,0.818,96,39,82,0.476,28,56,0.5,11,26,0.423,15,23,0.652,104,2017-01-30,BRK,MIA,2017,109.5
8990,8990,90,Home,L 96-115 ,240,31,74,0.419,26,55,0.473,5,19,0.263,29,39,0.744,96,39,80,0.488,23,52,0.442,16,28,0.571,21,24,0.875,115,2017-01-30,PHO,MEM,2017,123.0
8991,8991,91,@,L 96-113 ,240,36,85,0.424,31,57,0.544,5,28,0.179,19,28,0.679,96,46,99,0.465,41,77,0.532,5,22,0.227,16,17,0.941,113,2017-02-06,PHI,DET,2017,115.5
8992,8992,92,Home,L 96-97 ,240,38,83,0.458,26,54,0.481,12,29,0.414,8,15,0.533,96,36,73,0.493,29,49,0.592,7,24,0.292,18,25,0.72,97,2017-02-14,LAL,SAC,2017,100.5
8993,8993,93,Home,W 96-83 ,240,36,78,0.462,24,52,0.462,12,26,0.462,12,16,0.75,96,31,77,0.403,26,54,0.481,5,23,0.217,16,25,0.64,83,2017-02-25,DAL,NOP,2017,85.5
8994,8994,94,@,L 96-100 ,240,40,83,0.482,35,69,0.507,5,14,0.357,11,16,0.688,96,39,76,0.513,33,56,0.589,6,20,0.3,16,18,0.889,100,2017-02-26,PHO,MIL,2017,103.0
8995,8995,95,Home,W 96-89 ,240,33,76,0.434,24,58,0.414,9,18,0.5,21,23,0.913,96,37,83,0.446,28,57,0.491,9,26,0.346,6,13,0.462,89,2017-02-27,DAL,MIA,2017,93.5
8996,8996,96,Home,L 96-105 ,240,33,90,0.367,26,70,0.371,7,20,0.35,23,26,0.885,96,40,84,0.476,31,59,0.525,9,25,0.36,16,19,0.842,105,2017-03-01,TOR,WAS,2017,109.5
8997,8997,97,Home,L 96-97 ,240,34,77,0.442,25,50,0.5,9,27,0.333,19,31,0.613,96,35,78,0.449,20,45,0.444,15,33,0.455,12,21,0.571,97,2017-03-05,ATL,IND,2017,104.5
8998,8998,98,@,L 96-108 ,240,36,83,0.434,30,67,0.448,6,16,0.375,18,21,0.857,96,37,75,0.493,24,45,0.533,13,30,0.433,21,28,0.75,108,2017-03-06,SAC,DEN,2017,114.5
8999,8999,99,@,L 95-96 ,240,34,84,0.405,26,61,0.426,8,23,0.348,19,23,0.826,95,38,86,0.442,34,67,0.507,4,19,0.211,16,21,0.762,96,2011-12-26,MIL,CHA,2012,98.0
9000,9000,0,@,L 95-104 ,240,36,82,0.439,30,55,0.545,6,27,0.222,17,20,0.85,95,44,83,0.53,35,61,0.574,9,22,0.409,7,10,0.7,104,2011-12-26,HOU,ORL,2012,108.5
9001,9001,1,Home,W 95-82 ,240,35,88,0.398,25,55,0.455,10,33,0.303,15,22,0.682,95,34,73,0.466,31,66,0.47,3,7,0.429,11,19,0.579,82,2011-12-26,SAS,MEM,2012,83.5
9002,9002,2,@,L 95-98 ,240,28,70,0.4,22,56,0.393,6,14,0.429,33,45,0.733,95,40,94,0.426,38,78,0.487,2,16,0.125,16,20,0.8,98,2011-12-27,MIN,MIL,2012,99.0
9003,9003,3,Home,L 95-96 ,240,39,82,0.476,32,64,0.5,7,18,0.389,10,16,0.625,95,36,78,0.462,35,72,0.486,1,6,0.167,23,28,0.821,96,2011-12-28,CHA,MIA,2012,96.5
9004,9004,4,Home,L 95-98 ,240,34,87,0.391,32,71,0.451,2,16,0.125,25,33,0.758,95,29,77,0.377,19,52,0.365,10,25,0.4,30,38,0.789,98,2011-12-28,MEM,OKC,2012,103.0
9005,9005,5,Home,W 95-84 ,240,38,82,0.463,29,63,0.46,9,19,0.474,10,13,0.769,95,35,80,0.438,31,64,0.484,4,16,0.25,10,16,0.625,84,2011-12-31,HOU,ATL,2012,86.0
9006,9006,6,@,L 95-101 ,240,37,80,0.463,28,60,0.467,9,20,0.45,12,19,0.632,95,37,78,0.474,27,61,0.443,10,17,0.588,17,24,0.708,101,2012-01-04,GSW,SAS,2012,106.0
9007,9007,7,Home,L 95-98 ,240,38,87,0.437,33,73,0.452,5,14,0.357,14,15,0.933,95,36,85,0.424,29,64,0.453,7,21,0.333,19,22,0.864,98,2012-01-07,HOU,OKC,2012,101.5
9008,9008,8,Home,L 95-100 ,240,39,85,0.459,34,73,0.466,5,12,0.417,12,20,0.6,95,34,74,0.459,28,59,0.475,6,15,0.4,26,32,0.813,100,2012-01-10,MEM,OKC,2012,103.0
9009,9009,9,Home,W 95-89 (OT),265,36,86,0.419,30,69,0.435,6,17,0.353,17,23,0.739,95,32,81,0.395,27,65,0.415,5,16,0.313,20,34,0.588,89,2012-01-11,LAC,MIA,2012,91.5
9010,9010,10,@,W 95-85 ,240,35,73,0.479,28,53,0.528,7,20,0.35,18,26,0.692,95,36,80,0.45,35,64,0.547,1,16,0.063,12,17,0.706,85,2012-01-11,OKC,NOH,2012,85.5
9011,9011,11,@,L 95-101 (OT),265,41,96,0.427,38,75,0.507,3,21,0.143,10,12,0.833,95,42,92,0.457,37,76,0.487,5,16,0.313,12,17,0.706,101,2012-01-11,HOU,SAS,2012,103.5
9012,9012,12,@,W 95-90 ,240,30,66,0.455,27,58,0.466,3,8,0.375,32,38,0.842,95,33,74,0.446,29,57,0.509,4,17,0.235,20,32,0.625,90,2012-01-13,IND,TOR,2012,92.0
9013,9013,13,Home,L 95-105 ,240,35,82,0.427,30,67,0.448,5,15,0.333,20,28,0.714,95,41,94,0.436,32,75,0.427,9,19,0.474,14,19,0.737,105,2012-01-17,CLE,GSW,2012,109.5
9014,9014,14,Home,L 95-105 ,240,38,91,0.418,31,68,0.456,7,23,0.304,12,14,0.857,95,32,75,0.427,20,50,0.4,12,25,0.48,29,37,0.784,105,2012-01-17,MIL,DEN,2012,111.0
9015,9015,15,Home,W 95-89 ,240,40,85,0.471,34,70,0.486,6,15,0.4,9,15,0.6,95,35,74,0.473,33,63,0.524,2,11,0.182,17,23,0.739,89,2012-01-21,CHI,CHA,2012,90.0
9016,9016,16,@,L 95-128 ,240,36,87,0.414,30,68,0.441,6,19,0.316,17,22,0.773,95,50,92,0.543,42,76,0.553,8,16,0.5,20,27,0.741,128,2012-01-21,SAC,MEM,2012,132.0
9017,9017,17,@,L 95-110 ,240,37,77,0.481,30,58,0.517,7,19,0.368,14,21,0.667,95,43,75,0.573,36,56,0.643,7,19,0.368,17,23,0.739,110,2012-01-23,BRK,CHI,2012,113.5
9018,9018,18,@,W 95-90 ,240,38,80,0.475,33,70,0.471,5,10,0.5,14,21,0.667,95,36,90,0.4,33,77,0.429,3,13,0.231,15,21,0.714,90,2012-01-25,IND,CHI,2012,91.5
9019,9019,19,Home,W 95-74 ,240,38,78,0.487,29,63,0.46,9,15,0.6,10,15,0.667,95,29,83,0.349,26,72,0.361,3,11,0.273,13,17,0.765,74,2012-01-28,PHI,DET,2012,75.5
9020,9020,20,@,L 95-109 ,240,40,75,0.533,36,62,0.581,4,13,0.308,11,19,0.579,95,43,78,0.551,37,63,0.587,6,15,0.4,17,21,0.81,109,2012-01-30,NOP,MIA,2012,112.0
9021,9021,21,@,W 95-86 ,240,33,81,0.407,28,61,0.459,5,20,0.25,24,33,0.727,95,30,84,0.357,26,65,0.4,4,19,0.211,22,25,0.88,86,2012-02-01,OKC,DAL,2012,88.0
9022,9022,22,Home,W 95-92 ,240,34,76,0.447,29,59,0.492,5,17,0.294,22,29,0.759,95,40,88,0.455,36,70,0.514,4,18,0.222,8,16,0.5,92,2012-02-02,SAC,POR,2012,94.0
9023,9023,23,Home,W 95-89 ,240,34,85,0.4,24,63,0.381,10,22,0.455,17,24,0.708,95,33,75,0.44,24,56,0.429,9,19,0.474,14,19,0.737,89,2012-02-04,PHO,CHA,2012,93.5
9024,9024,24,Home,W 95-89 ,240,31,69,0.449,27,57,0.474,4,12,0.333,29,34,0.853,95,34,79,0.43,28,57,0.491,6,22,0.273,15,21,0.714,89,2012-02-05,MIA,TOR,2012,92.0
9025,9025,25,Home,W 95-90 ,240,38,81,0.469,30,64,0.469,8,17,0.471,11,17,0.647,95,34,81,0.42,27,57,0.474,7,24,0.292,15,20,0.75,90,2012-02-06,PHI,LAL,2012,93.5
9026,9026,26,Home,L 95-105 ,240,33,72,0.458,24,46,0.522,9,26,0.346,20,27,0.741,95,44,90,0.489,35,62,0.565,9,28,0.321,8,9,0.889,105,2012-02-08,DEN,DAL,2012,109.5
9027,9027,27,@,W 95-64 ,240,39,90,0.433,33,75,0.44,6,15,0.4,11,20,0.55,95,25,76,0.329,24,68,0.353,1,8,0.125,13,19,0.684,64,2012-02-10,CHI,CHA,2012,64.5
9028,9028,28,Home,W 95-91 ,240,37,75,0.493,34,62,0.548,3,13,0.231,18,26,0.692,95,34,88,0.386,28,68,0.412,6,20,0.3,17,24,0.708,91,2012-02-12,BOS,CHI,2012,94.0
9029,9029,29,Home,L 95-99 ,240,39,84,0.464,36,71,0.507,3,13,0.231,14,25,0.56,95,36,83,0.434,30,69,0.435,6,14,0.429,21,32,0.656,99,2012-02-14,DET,SAS,2012,102.0
9030,9030,30,@,L 95-96 ,240,36,83,0.434,29,60,0.483,7,23,0.304,16,18,0.889,95,37,87,0.425,29,69,0.42,8,18,0.444,14,18,0.778,96,2012-02-15,OKC,HOU,2012,100.0
9031,9031,31,@,L 95-103 ,240,33,82,0.402,27,59,0.458,6,23,0.261,23,31,0.742,95,38,86,0.442,31,59,0.525,7,27,0.259,20,28,0.714,103,2012-02-22,DEN,LAC,2012,106.5
9032,9032,32,@,L 95-99 ,240,36,89,0.404,32,80,0.4,4,9,0.444,19,22,0.864,95,41,90,0.456,38,72,0.528,3,18,0.167,14,20,0.7,99,2012-02-28,NOP,CHI,2012,100.5
9033,9033,33,@,L 95-104 ,240,38,87,0.437,29,63,0.46,9,24,0.375,10,11,0.909,95,44,91,0.484,38,70,0.543,6,21,0.286,10,16,0.625,104,2012-02-29,POR,DEN,2012,107.0
9034,9034,34,@,W 95-84 ,240,34,77,0.442,25,62,0.403,9,15,0.6,18,23,0.783,95,30,80,0.375,27,64,0.422,3,16,0.188,21,27,0.778,84,2012-02-29,TOR,NOH,2012,85.5
9035,9035,35,Home,L 95-102 ,240,37,90,0.411,31,74,0.419,6,16,0.375,15,19,0.789,95,34,75,0.453,19,39,0.487,15,36,0.417,19,27,0.704,102,2012-02-29,WAS,ORL,2012,109.5
9036,9036,36,@,L 95-104 ,240,34,86,0.395,33,73,0.452,1,13,0.077,26,32,0.813,95,42,79,0.532,39,71,0.549,3,8,0.375,17,21,0.81,104,2012-03-01,MIN,PHO,2012,105.5
9037,9037,37,Home,W 95-94 ,240,32,80,0.4,21,52,0.404,11,28,0.393,20,27,0.741,95,34,84,0.405,29,61,0.475,5,23,0.217,21,32,0.656,94,2012-03-05,MIN,LAC,2012,96.5
9038,9038,38,Home,W 95-91 ,240,29,76,0.382,21,49,0.429,8,27,0.296,29,33,0.879,95,36,84,0.429,27,63,0.429,9,21,0.429,10,10,1.0,91,2012-03-05,OKC,DAL,2012,95.5
9039,9039,39,Home,W 95-85 ,240,31,80,0.388,24,54,0.444,7,26,0.269,26,30,0.867,95,32,84,0.381,26,61,0.426,6,23,0.261,15,23,0.652,85,2012-03-06,DAL,NYK,2012,88.0
9040,9040,40,@,W 95-89 ,240,39,85,0.459,36,78,0.462,3,7,0.429,14,16,0.875,95,33,80,0.413,28,57,0.491,5,23,0.217,18,25,0.72,89,2012-03-10,NOP,MIN,2012,91.5
9041,9041,41,@,L 95-122 ,240,36,88,0.409,29,74,0.392,7,14,0.5,16,19,0.842,95,46,73,0.63,36,50,0.72,10,23,0.435,20,26,0.769,122,2012-03-10,CHA,OKC,2012,127.0
9042,9042,42,@,L 95-120 ,240,36,80,0.45,30,61,0.492,6,19,0.316,17,21,0.81,95,46,86,0.535,37,65,0.569,9,21,0.429,19,21,0.905,120,2012-03-16,BOS,SAC,2012,124.5
9043,9043,43,Home,W 95-91 ,240,35,86,0.407,29,63,0.46,6,23,0.261,19,27,0.704,95,35,72,0.486,29,52,0.558,6,20,0.3,15,18,0.833,91,2012-03-17,LAC,HOU,2012,94.0
9044,9044,44,@,L 95-111 ,240,39,84,0.464,31,63,0.492,8,21,0.381,9,14,0.643,95,41,74,0.554,30,56,0.536,11,18,0.611,18,28,0.643,111,2012-03-18,POR,OKC,2012,116.5
9045,9045,45,Home,L 95-112 ,240,36,83,0.434,30,62,0.484,6,21,0.286,17,20,0.85,95,45,84,0.536,35,59,0.593,10,25,0.4,12,15,0.8,112,2012-03-19,DEN,DAL,2012,117.0
9046,9046,46,@,L 95-99 ,240,36,80,0.45,30,65,0.462,6,15,0.4,17,24,0.708,95,36,76,0.474,35,67,0.522,1,9,0.111,26,35,0.743,99,2012-03-20,PHO,MIA,2012,99.5
9047,9047,47,@,W 95-92 ,240,37,76,0.487,30,53,0.566,7,23,0.304,14,21,0.667,95,38,85,0.447,34,67,0.507,4,18,0.222,12,14,0.857,92,2012-03-24,ATL,WAS,2012,94.0
9048,9048,48,Home,L 95-102 ,240,33,79,0.418,29,67,0.433,4,12,0.333,25,35,0.714,95,33,73,0.452,31,61,0.508,2,12,0.167,34,45,0.756,102,2012-03-26,CHA,BOS,2012,103.0
9049,9049,49,Home,L 95-109 ,240,34,79,0.43,27,63,0.429,7,16,0.438,20,25,0.8,95,45,79,0.57,39,62,0.629,6,17,0.353,13,16,0.813,109,2012-03-27,POR,OKC,2012,112.0
9050,9050,50,Home,L 95-99 ,240,34,82,0.415,29,65,0.446,5,17,0.294,22,28,0.786,95,37,88,0.42,33,73,0.452,4,15,0.267,21,28,0.75,99,2012-03-31,MIL,MEM,2012,101.0
9051,9051,51,Home,W 95-90 ,240,37,77,0.481,31,65,0.477,6,12,0.5,15,19,0.789,95,35,74,0.473,31,60,0.517,4,14,0.286,16,22,0.727,90,2012-03-31,PHI,ATL,2012,92.0
9052,9052,52,@,L 95-102 ,240,33,72,0.458,23,48,0.479,10,24,0.417,19,24,0.792,95,43,76,0.566,40,65,0.615,3,11,0.273,13,19,0.684,102,2012-04-03,ORL,DET,2012,103.5
9053,9053,53,Home,W 95-85 ,240,40,80,0.5,36,65,0.554,4,15,0.267,11,16,0.688,95,35,83,0.422,28,67,0.418,7,16,0.438,8,14,0.571,85,2012-04-04,DAL,MEM,2012,88.5
9054,9054,54,Home,W 95-90 ,240,37,91,0.407,32,76,0.421,5,15,0.333,16,24,0.667,95,36,85,0.424,34,73,0.466,2,12,0.167,16,24,0.667,90,2012-04-06,MIL,CHA,2012,91.0
9055,9055,55,@,W 95-82 ,240,39,91,0.429,27,60,0.45,12,31,0.387,5,10,0.5,95,31,77,0.403,26,56,0.464,5,21,0.238,15,22,0.682,82,2012-04-12,LAC,MIN,2012,84.5
9056,9056,56,@,W 95-89 ,240,34,81,0.42,28,65,0.431,6,16,0.375,21,27,0.778,95,34,81,0.42,33,71,0.465,1,10,0.1,20,27,0.741,89,2012-04-13,BRK,PHI,2012,89.5
9057,9057,57,Home,L 95-104 ,240,35,78,0.449,25,53,0.472,10,25,0.4,15,17,0.882,95,36,83,0.434,23,48,0.479,13,35,0.371,19,24,0.792,104,2012-04-18,BRK,NYK,2012,110.5
9058,9058,58,@,L 95-106 ,240,40,86,0.465,36,74,0.486,4,12,0.333,11,15,0.733,95,38,84,0.452,34,71,0.479,4,13,0.308,26,37,0.703,106,2012-04-21,BRK,MIL,2012,108.0
9059,9059,59,@,L 95-102 ,240,31,70,0.443,26,53,0.491,5,17,0.294,28,32,0.875,95,33,82,0.402,19,44,0.432,14,38,0.368,22,28,0.786,102,2012-04-25,CHA,ORL,2012,109.0
9060,9060,60,Home,L 95-99 ,240,35,80,0.438,31,63,0.492,4,17,0.235,21,23,0.913,95,38,80,0.475,32,60,0.533,6,20,0.3,17,26,0.654,99,2012-10-31,NOP,SAS,2013,102.0
9061,9061,61,Home,L 95-105 ,240,34,68,0.5,27,52,0.519,7,16,0.438,20,28,0.714,95,38,84,0.452,30,62,0.484,8,22,0.364,21,27,0.778,105,2012-11-02,LAL,LAC,2013,109.0
9062,9062,62,@,W 95-85 (OT),265,39,93,0.419,29,69,0.42,10,24,0.417,7,12,0.583,95,34,96,0.354,29,70,0.414,5,26,0.192,12,18,0.667,85,2012-11-03,POR,HOU,2013,87.5
9063,9063,63,Home,L 95-104 ,240,33,71,0.465,24,49,0.49,9,22,0.409,20,22,0.909,95,41,83,0.494,33,58,0.569,8,25,0.32,14,20,0.7,104,2012-11-04,OKC,ATL,2013,108.0
9064,9064,64,Home,W 95-86 ,240,37,83,0.446,32,66,0.485,5,17,0.294,16,18,0.889,95,25,74,0.338,21,51,0.412,4,23,0.174,32,46,0.696,86,2012-11-07,UTA,LAL,2013,88.0
9065,9065,65,@,W 95-89 ,240,37,76,0.487,30,54,0.556,7,22,0.318,14,16,0.875,95,34,81,0.42,25,56,0.446,9,25,0.36,12,16,0.75,89,2012-11-09,MIA,ATL,2013,93.5
9066,9066,66,Home,L 95-101 ,240,34,74,0.459,31,65,0.477,3,9,0.333,24,31,0.774,95,41,81,0.506,38,65,0.585,3,16,0.188,16,16,1.0,101,2012-11-12,CHI,BOS,2013,102.5
9067,9067,67,@,W 95-87 ,240,35,79,0.443,28,61,0.459,7,18,0.389,18,22,0.818,95,30,83,0.361,24,60,0.4,6,23,0.261,21,26,0.808,87,2012-11-12,ATL,POR,2013,90.0
9068,9068,68,@,L 95-105 ,240,37,72,0.514,32,53,0.604,5,19,0.263,16,21,0.762,95,37,76,0.487,32,61,0.525,5,15,0.333,26,32,0.813,105,2012-11-16,NYK,MEM,2013,107.5
9069,9069,69,Home,L 95-110 ,240,33,78,0.423,26,66,0.394,7,12,0.583,22,28,0.786,95,40,74,0.541,26,45,0.578,14,29,0.483,16,20,0.8,110,2012-11-16,NOP,OKC,2013,117.0
9070,9070,70,Home,L 95-103 ,240,36,96,0.375,28,71,0.394,8,25,0.32,15,20,0.75,95,38,74,0.514,28,51,0.549,10,23,0.435,17,20,0.85,103,2012-11-17,CLE,DAL,2013,108.0
9071,9071,71,Home,W 95-90 ,240,35,73,0.479,29,52,0.558,6,21,0.286,19,37,0.514,95,34,82,0.415,27,59,0.458,7,23,0.304,15,21,0.714,90,2012-11-20,LAL,BRK,2013,93.5
9072,9072,72,@,L 95-103 ,240,32,78,0.41,29,60,0.483,3,18,0.167,28,37,0.757,95,42,78,0.538,31,53,0.585,11,25,0.44,8,18,0.444,103,2012-11-23,MIN,POR,2013,108.5
9073,9073,73,@,W 95-83 ,240,33,82,0.402,23,58,0.397,10,24,0.417,19,29,0.655,95,32,75,0.427,31,68,0.456,1,7,0.143,18,24,0.75,83,2012-11-28,BRK,BOS,2013,83.5
9074,9074,74,@,L 95-101 ,240,31,82,0.378,25,60,0.417,6,22,0.273,27,35,0.771,95,37,81,0.457,33,62,0.532,4,19,0.211,23,26,0.885,101,2012-11-28,MIN,LAC,2013,103.0
9075,9075,75,Home,W 95-85 ,240,34,87,0.391,26,68,0.382,8,19,0.421,19,27,0.704,95,34,93,0.366,29,75,0.387,5,18,0.278,12,16,0.75,85,2012-11-30,MIN,MIL,2013,87.5
9076,9076,76,@,L 95-99 (OT),265,36,99,0.364,32,84,0.381,4,15,0.267,19,22,0.864,95,37,89,0.416,30,60,0.5,7,29,0.241,18,24,0.75,99,2012-12-01,MEM,SAS,2013,102.5
9077,9077,77,@,W 95-85 ,240,34,72,0.472,30,57,0.526,4,15,0.267,23,27,0.852,95,31,85,0.365,26,69,0.377,5,16,0.313,18,25,0.72,85,2012-12-05,CHI,CLE,2013,87.5
9078,9078,78,@,L 95-104 ,240,36,79,0.456,29,63,0.46,7,16,0.438,16,20,0.8,95,41,85,0.482,31,59,0.525,10,26,0.385,12,19,0.632,104,2012-12-07,WAS,ATL,2013,109.0
9079,9079,79,Home,W 95-94 (OT),265,37,99,0.374,35,88,0.398,2,11,0.182,19,26,0.731,95,35,81,0.432,29,59,0.492,6,22,0.273,18,25,0.72,94,2012-12-07,PHI,BOS,2013,97.0
9080,9080,80,Home,L 95-97 ,240,38,80,0.475,31,58,0.534,7,22,0.318,12,15,0.8,95,38,82,0.463,29,58,0.5,9,24,0.375,12,14,0.857,97,2012-12-12,MIA,GSW,2013,101.5
9081,9081,81,Home,W 95-85 ,240,35,77,0.455,27,63,0.429,8,14,0.571,17,27,0.63,95,35,81,0.432,32,69,0.464,3,12,0.25,12,16,0.75,85,2012-12-14,IND,PHI,2013,86.5
9082,9082,82,Home,W 95-74 ,240,34,84,0.405,22,48,0.458,12,36,0.333,15,22,0.682,95,27,69,0.391,27,56,0.482,0,13,0.0,20,23,0.87,74,2012-12-14,TOR,DAL,2013,74.0
9083,9083,83,Home,W 95-94 ,240,37,80,0.463,26,51,0.51,11,29,0.379,10,12,0.833,95,36,80,0.45,25,60,0.417,11,20,0.55,11,15,0.733,94,2012-12-16,POR,NOH,2013,99.5
9084,9084,84,Home,L 95-100 (OT),265,36,95,0.379,30,77,0.39,6,18,0.333,17,22,0.773,95,34,78,0.436,25,54,0.463,9,24,0.375,23,34,0.676,100,2012-12-18,WAS,ATL,2013,104.5
9085,9085,85,Home,L 95-110 ,240,37,96,0.385,34,74,0.459,3,22,0.136,18,21,0.857,95,42,78,0.538,32,50,0.64,10,28,0.357,16,18,0.889,110,2012-12-20,DAL,MIA,2013,115.0
9086,9086,86,Home,W 95-92 ,240,33,74,0.446,25,52,0.481,8,22,0.364,21,30,0.7,95,38,88,0.432,30,70,0.429,8,18,0.444,8,10,0.8,92,2012-12-23,BRK,PHI,2013,96.0
9087,9087,87,Home,L 95-98 ,240,39,79,0.494,35,69,0.507,4,10,0.4,13,20,0.65,95,35,82,0.427,24,58,0.414,11,24,0.458,17,23,0.739,98,2012-12-29,CHA,NOH,2013,103.5
9088,9088,88,@,W 95-86 ,240,41,83,0.494,32,61,0.525,9,22,0.409,4,8,0.5,95,36,82,0.439,26,62,0.419,10,20,0.5,4,12,0.333,86,2013-01-01,ATL,NOH,2013,91.0
9089,9089,89,Home,W 95-89 ,240,39,85,0.459,36,72,0.5,3,13,0.231,14,20,0.7,95,37,84,0.44,32,70,0.457,5,14,0.357,10,12,0.833,89,2013-01-02,PHO,PHI,2013,91.5
9090,9090,90,Home,W 95-80 ,240,40,92,0.435,37,72,0.514,3,20,0.15,12,20,0.6,95,31,82,0.378,26,64,0.406,5,18,0.278,13,18,0.722,80,2013-01-05,IND,MIL,2013,82.5
9091,9091,91,Home,W 95-88 ,240,40,83,0.482,35,70,0.5,5,13,0.385,10,12,0.833,95,33,73,0.452,27,52,0.519,6,21,0.286,16,20,0.8,88,2013-01-07,NOP,SAS,2013,91.0
9092,9092,92,@,L 95-103 ,240,36,76,0.474,28,56,0.5,8,20,0.4,15,19,0.789,95,40,72,0.556,31,53,0.585,9,19,0.474,14,23,0.609,103,2013-01-11,UTA,ATL,2013,107.5
9093,9093,93,@,L 95-109 ,240,37,87,0.425,33,61,0.541,4,26,0.154,17,17,1.0,95,45,78,0.577,37,57,0.649,8,21,0.381,11,17,0.647,109,2013-01-16,BRK,ATL,2013,113.0
9094,9094,94,Home,W 95-94 ,240,41,85,0.482,36,74,0.486,5,11,0.455,8,13,0.615,95,39,86,0.453,31,69,0.449,8,17,0.471,8,11,0.727,94,2013-01-16,SAC,WAS,2013,98.0
9095,9095,95,@,L 95-105 ,240,34,83,0.41,21,53,0.396,13,30,0.433,14,16,0.875,95,40,87,0.46,29,68,0.426,11,19,0.579,14,17,0.824,105,2013-01-18,HOU,IND,2013,110.5
9096,9096,96,Home,W 95-88 ,240,36,80,0.45,31,58,0.534,5,22,0.227,18,20,0.9,95,36,84,0.429,32,68,0.471,4,16,0.25,12,14,0.857,88,2013-01-18,SAS,GSW,2013,90.0
9097,9097,97,Home,W 95-83 ,240,39,93,0.419,30,76,0.395,9,17,0.529,8,12,0.667,95,32,81,0.395,29,64,0.453,3,17,0.176,16,23,0.696,83,2013-01-21,CHI,LAL,2013,84.5
9098,9098,98,Home,L 95-98 ,240,37,81,0.457,30,57,0.526,7,24,0.292,14,18,0.778,95,39,84,0.464,31,65,0.477,8,19,0.421,12,17,0.706,98,2013-01-21,POR,WAS,2013,102.0
9099,9099,99,Home,W 95-90 ,240,37,82,0.451,35,70,0.5,2,12,0.167,19,22,0.864,95,32,84,0.381,25,67,0.373,7,17,0.412,19,22,0.864,90,2013-01-22,CLE,BOS,2013,93.5
9100,9100,0,Home,L 95-105 ,240,37,83,0.446,26,49,0.531,11,34,0.324,10,13,0.769,95,40,86,0.465,32,65,0.492,8,21,0.381,17,25,0.68,105,2013-01-23,HOU,DEN,2013,109.0
9101,9101,1,Home,L 95-97 ,240,35,81,0.432,27,63,0.429,8,18,0.444,17,20,0.85,95,39,78,0.5,35,62,0.565,4,16,0.25,15,19,0.789,97,2013-01-24,ORL,TOR,2013,99.0
9102,9102,2,Home,L 95-105 ,240,36,86,0.419,28,71,0.394,8,15,0.533,15,21,0.714,95,37,76,0.487,31,53,0.585,6,23,0.261,25,30,0.833,105,2013-01-25,SAC,OKC,2013,108.0
9103,9103,3,@,L 95-110 ,240,34,77,0.442,30,60,0.5,4,17,0.235,23,28,0.821,95,45,88,0.511,40,77,0.519,5,11,0.455,15,18,0.833,110,2013-01-27,PHO,DAL,2013,112.5
9104,9104,4,Home,L 95-108 ,240,36,84,0.429,32,66,0.485,4,18,0.222,19,25,0.76,95,45,84,0.536,34,68,0.5,11,16,0.688,7,10,0.7,108,2013-01-29,CLE,GSW,2013,113.5
9105,9105,5,@,L 95-109 ,240,33,79,0.418,25,60,0.417,8,19,0.421,21,24,0.875,95,42,82,0.512,35,62,0.565,7,20,0.35,18,23,0.783,109,2013-02-02,CHA,HOU,2013,112.5
9106,9106,6,@,L 95-122 ,240,37,79,0.468,31,64,0.484,6,15,0.4,15,25,0.6,95,52,92,0.565,43,68,0.632,9,24,0.375,9,13,0.692,122,2013-02-06,CHA,CLE,2013,126.5
9107,9107,7,Home,L 95-99 ,240,34,82,0.415,30,64,0.469,4,18,0.222,23,26,0.885,95,35,73,0.479,31,54,0.574,4,19,0.211,25,30,0.833,99,2013-02-06,TOR,BOS,2013,101.0
9108,9108,8,@,L 95-116 ,240,36,87,0.414,31,64,0.484,5,23,0.217,18,30,0.6,95,46,87,0.529,41,76,0.539,5,11,0.455,19,25,0.76,116,2013-02-07,LAL,BOS,2013,118.5
9109,9109,9,Home,L 95-96 ,240,40,97,0.412,38,86,0.442,2,11,0.182,13,15,0.867,95,38,84,0.452,33,65,0.508,5,19,0.263,15,18,0.833,96,2013-02-13,CLE,SAS,2013,98.5
9110,9110,10,@,L 95-110 ,240,35,83,0.422,23,64,0.359,12,19,0.632,13,13,1.0,95,45,89,0.506,39,73,0.534,6,16,0.375,14,15,0.933,110,2013-02-24,SAC,NOH,2013,113.0
9111,9111,11,@,W 95-90 ,240,34,82,0.415,27,64,0.422,7,18,0.389,20,26,0.769,95,36,85,0.424,35,68,0.515,1,17,0.059,17,21,0.81,90,2013-02-26,MIL,DAL,2013,90.5
9112,9112,12,Home,L 95-96 ,240,40,84,0.476,32,65,0.492,8,19,0.421,7,10,0.7,95,39,72,0.542,30,57,0.526,9,15,0.6,9,16,0.563,96,2013-02-27,WAS,DET,2013,100.5
9113,9113,13,@,L 95-100 ,240,39,78,0.5,32,59,0.542,7,19,0.368,10,16,0.625,95,35,81,0.432,28,61,0.459,7,20,0.35,23,31,0.742,100,2013-03-01,DET,NOH,2013,103.5
9114,9114,14,@,W 95-94 ,240,31,70,0.443,23,49,0.469,8,21,0.381,25,29,0.862,95,35,86,0.407,25,55,0.455,10,31,0.323,14,14,1.0,94,2013-03-07,OKC,NYK,2013,99.0
9115,9115,15,Home,W 95-78 ,240,32,81,0.395,20,54,0.37,12,27,0.444,19,33,0.576,95,32,90,0.356,29,73,0.397,3,17,0.176,11,17,0.647,78,2013-03-08,BRK,WAS,2013,79.5
9116,9116,16,Home,W 95-90 ,240,34,83,0.41,26,57,0.456,8,26,0.308,19,25,0.76,95,31,76,0.408,26,59,0.441,5,17,0.294,23,28,0.821,90,2013-03-12,CLE,WAS,2013,92.5
9117,9117,17,Home,L 95-113 ,240,34,76,0.447,31,62,0.5,3,14,0.214,24,30,0.8,95,43,83,0.518,35,67,0.522,8,16,0.5,19,22,0.864,113,2013-03-15,GSW,CHI,2013,117.0
9118,9118,18,@,L 95-97 ,240,39,85,0.459,34,72,0.472,5,13,0.385,12,16,0.75,95,36,64,0.563,31,49,0.633,5,15,0.333,20,27,0.741,97,2013-03-17,NOP,MIN,2013,99.5
9119,9119,19,Home,W 95-73 ,240,34,87,0.391,28,64,0.438,6,23,0.261,21,24,0.875,95,28,88,0.318,25,73,0.342,3,15,0.2,14,21,0.667,73,2013-03-19,IND,ORL,2013,74.5
9120,9120,20,@,L 95-102 ,240,36,83,0.434,23,57,0.404,13,26,0.5,10,13,0.769,95,42,87,0.483,33,68,0.485,9,19,0.474,9,13,0.692,102,2013-03-19,POR,MIL,2013,106.5
9121,9121,21,Home,L 95-98 ,240,37,81,0.457,30,60,0.5,7,21,0.333,14,17,0.824,95,32,72,0.444,20,43,0.465,12,29,0.414,22,30,0.733,98,2013-03-20,CLE,MIA,2013,104.0
9122,9122,22,@,L 95-101 ,240,39,86,0.453,31,58,0.534,8,28,0.286,9,17,0.529,95,37,85,0.435,33,71,0.465,4,14,0.286,23,32,0.719,101,2013-03-23,SAC,DEN,2013,103.0
9123,9123,23,@,L 95-101 ,240,34,74,0.459,25,49,0.51,9,25,0.36,18,24,0.75,95,37,79,0.468,28,53,0.528,9,26,0.346,18,24,0.75,101,2013-03-23,BRK,LAC,2013,105.5
9124,9124,24,@,L 95-96 ,240,33,78,0.423,23,56,0.411,10,22,0.455,19,21,0.905,95,32,80,0.4,23,54,0.426,9,26,0.346,23,27,0.852,96,2013-03-24,SAS,HOU,2013,100.5
9125,9125,25,Home,L 95-105 ,240,33,67,0.493,27,54,0.5,6,13,0.462,23,32,0.719,95,43,86,0.5,39,67,0.582,4,19,0.211,15,18,0.833,105,2013-03-29,POR,UTA,2013,107.0
9126,9126,26,Home,W 95-94 ,240,30,76,0.395,22,53,0.415,8,23,0.348,27,40,0.675,95,36,72,0.5,29,56,0.518,7,16,0.438,15,22,0.682,94,2013-03-31,CHI,DET,2013,97.5
9127,9127,27,@,W 95-82 ,240,40,77,0.519,33,55,0.6,7,22,0.318,8,12,0.667,95,32,66,0.485,23,40,0.575,9,26,0.346,9,19,0.474,82,2013-04-03,NYK,ATL,2013,86.5
9128,9128,28,Home,L 95-113 ,240,34,89,0.382,30,75,0.4,4,14,0.286,23,26,0.885,95,43,76,0.566,33,55,0.6,10,21,0.476,17,22,0.773,113,2013-04-03,CLE,BRK,2013,118.0
9129,9129,29,Home,W 95-94 ,240,35,89,0.393,29,72,0.403,6,17,0.353,19,30,0.633,95,41,88,0.466,37,70,0.529,4,18,0.222,8,10,0.8,94,2013-04-04,DEN,DAL,2013,96.0
9130,9130,30,@,W 95-93 ,240,40,85,0.471,36,70,0.514,4,15,0.267,11,16,0.688,95,30,67,0.448,27,52,0.519,3,15,0.2,30,40,0.75,93,2013-04-05,TOR,MIN,2013,94.5
9131,9131,31,Home,W 95-83 ,240,39,77,0.506,28,51,0.549,11,26,0.423,6,11,0.545,95,32,77,0.416,30,65,0.462,2,12,0.167,17,20,0.85,83,2013-04-05,UTA,NOH,2013,84.0
9132,9132,32,@,L 95-109 ,240,33,76,0.434,26,52,0.5,7,24,0.292,22,30,0.733,95,42,84,0.5,34,63,0.54,8,21,0.381,17,21,0.81,109,2013-04-07,LAL,LAC,2013,113.0
9133,9133,33,@,W 95-92 ,240,32,80,0.4,28,65,0.431,4,15,0.267,27,29,0.931,95,34,80,0.425,27,59,0.458,7,21,0.333,17,19,0.895,92,2013-04-07,NOP,PHO,2013,95.5
9134,9134,34,@,L 95-111 ,240,35,90,0.389,29,67,0.433,6,23,0.261,19,22,0.864,95,44,77,0.571,33,56,0.589,11,21,0.524,12,16,0.75,111,2013-04-10,MIN,LAC,2013,116.5
9135,9135,35,Home,W 95-85 ,240,37,80,0.463,33,71,0.465,4,9,0.444,17,24,0.708,95,34,87,0.391,25,58,0.431,9,29,0.31,8,12,0.667,85,2013-04-13,CHA,MIL,2013,89.5
9136,9136,36,@,L 95-106 ,240,34,79,0.43,20,42,0.476,14,37,0.378,13,13,1.0,95,43,74,0.581,36,56,0.643,7,18,0.389,13,14,0.929,106,2013-04-15,NYK,CHA,2013,109.5
9137,9137,37,Home,L 95-96 ,240,39,86,0.453,34,73,0.466,5,13,0.385,12,19,0.632,95,33,66,0.5,20,38,0.526,13,28,0.464,17,27,0.63,96,2013-04-15,CLE,MIA,2013,102.5
9138,9138,38,@,L 95-104 ,240,38,87,0.437,31,60,0.517,7,27,0.259,12,21,0.571,95,42,92,0.457,37,69,0.536,5,23,0.217,15,20,0.75,104,2013-04-15,SAC,OKC,2013,106.5
9139,9139,39,Home,W 95-92 ,240,37,78,0.474,30,60,0.5,7,18,0.389,14,19,0.737,95,36,85,0.424,29,69,0.42,7,16,0.438,13,17,0.765,92,2013-04-17,CHI,WAS,2013,95.5
9140,9140,40,Home,L 95-105 ,240,36,80,0.45,30,54,0.556,6,26,0.231,17,27,0.63,95,43,85,0.506,35,66,0.53,8,19,0.421,11,14,0.786,105,2013-04-17,IND,PHI,2013,109.0
9141,9141,41,@,L 95-99 (OT),265,35,84,0.417,27,51,0.529,8,33,0.242,17,24,0.708,95,33,90,0.367,23,58,0.397,10,32,0.313,23,34,0.676,99,2013-04-17,HOU,LAL,2013,104.0
9142,9142,42,@,W 95-89 ,240,36,85,0.424,26,58,0.448,10,27,0.37,13,18,0.722,95,37,89,0.416,34,68,0.5,3,21,0.143,12,14,0.857,89,2013-04-17,MIL,OKC,2013,90.5
9143,9143,43,Home,L 95-108 ,240,33,79,0.418,26,61,0.426,7,18,0.389,22,22,1.0,95,42,91,0.462,30,62,0.484,12,29,0.414,12,16,0.75,108,2013-04-17,SAS,MIN,2013,114.0
9144,9144,44,@,L 95-107 ,240,35,83,0.422,28,57,0.491,7,26,0.269,18,23,0.783,95,37,72,0.514,26,52,0.5,11,20,0.55,22,29,0.759,107,2013-10-29,CHI,MIA,2014,112.5
9145,9145,45,@,W 95-90 ,240,30,70,0.429,20,47,0.426,10,23,0.435,25,30,0.833,95,34,85,0.4,29,74,0.392,5,11,0.455,17,21,0.81,90,2013-10-30,IND,NOP,2014,92.5
9146,9146,46,@,L 95-102 ,240,40,88,0.455,33,65,0.508,7,23,0.304,8,14,0.571,95,36,77,0.468,26,54,0.481,10,23,0.435,20,31,0.645,102,2013-11-01,TOR,ATL,2014,107.0
9147,9147,47,Home,W 95-88 ,240,36,74,0.486,31,59,0.525,5,15,0.333,18,22,0.818,95,33,70,0.471,26,50,0.52,7,20,0.35,15,18,0.833,88,2013-11-04,MEM,BOS,2014,91.5
9148,9148,48,Home,L 95-104 ,240,31,72,0.431,25,51,0.49,6,21,0.286,27,33,0.818,95,41,83,0.494,31,60,0.517,10,23,0.435,12,14,0.857,104,2013-11-05,TOR,MIA,2014,109.0
9149,9149,49,Home,W 95-79 ,240,37,76,0.487,31,57,0.544,6,19,0.316,15,18,0.833,95,31,75,0.413,27,67,0.403,4,8,0.5,13,19,0.684,79,2013-11-11,IND,MEM,2014,81.0
9150,9150,50,@,L 95-105 ,240,33,75,0.44,24,49,0.49,9,26,0.346,20,29,0.69,95,41,84,0.488,31,58,0.534,10,26,0.385,13,19,0.684,105,2013-11-12,WAS,DAL,2014,110.0
9151,9151,51,@,L 95-113 ,240,37,87,0.425,34,69,0.493,3,18,0.167,18,27,0.667,95,42,70,0.6,34,54,0.63,8,16,0.5,21,26,0.808,113,2013-11-12,DET,GSW,2014,117.0
9152,9152,52,@,L 95-116 ,240,34,84,0.405,31,74,0.419,3,10,0.3,24,33,0.727,95,44,79,0.557,33,59,0.559,11,20,0.55,17,21,0.81,116,2013-11-12,NOP,LAL,2014,121.5
9153,9153,53,@,L 95-118 ,240,33,79,0.418,22,49,0.449,11,30,0.367,18,21,0.857,95,46,79,0.582,34,56,0.607,12,23,0.522,14,24,0.583,118,2013-11-12,MIL,MIA,2014,124.0
9154,9154,54,@,W 95-91 ,240,37,88,0.42,25,54,0.463,12,34,0.353,9,13,0.692,95,35,77,0.455,30,53,0.566,5,24,0.208,16,21,0.762,91,2013-11-13,NYK,ATL,2014,93.5
9155,9155,55,@,L 95-124 ,240,36,87,0.414,31,71,0.437,5,16,0.313,18,21,0.857,95,45,82,0.549,34,60,0.567,11,22,0.5,23,26,0.885,124,2013-11-13,CLE,MIN,2014,129.5
9156,9156,56,Home,W 95-91 ,240,36,81,0.444,31,68,0.456,5,13,0.385,18,30,0.6,95,32,67,0.478,23,48,0.479,9,19,0.474,18,25,0.72,91,2013-11-20,CHA,BRK,2014,95.5
9157,9157,57,@,L 95-102 ,240,34,82,0.415,25,60,0.417,9,22,0.409,18,28,0.643,95,39,82,0.476,28,58,0.483,11,24,0.458,13,17,0.765,102,2013-11-22,GSW,LAL,2014,107.5
9158,9158,58,@,L 95-98 ,240,32,83,0.386,27,69,0.391,5,14,0.357,26,29,0.897,95,36,88,0.409,24,62,0.387,12,26,0.462,14,15,0.933,98,2013-11-22,CHI,POR,2014,104.0
9159,9159,59,Home,W 95-73 ,240,36,71,0.507,31,59,0.525,5,12,0.417,18,22,0.818,95,28,71,0.394,24,53,0.453,4,18,0.222,13,29,0.448,73,2013-11-24,OKC,UTA,2014,75.0
9160,9160,60,@,W 95-84 ,240,35,72,0.486,31,53,0.585,4,19,0.211,21,25,0.84,95,29,83,0.349,19,55,0.345,10,28,0.357,16,24,0.667,84,2013-11-27,MIA,CLE,2014,89.0
9161,9161,61,@,L 95-97 ,240,34,83,0.41,28,61,0.459,6,22,0.273,21,25,0.84,95,31,71,0.437,22,47,0.468,9,24,0.375,26,34,0.765,97,2013-11-29,NYK,DEN,2014,101.5
9162,9162,62,@,L 95-114 ,240,37,89,0.416,31,67,0.463,6,22,0.273,15,23,0.652,95,39,74,0.527,20,42,0.476,19,32,0.594,17,20,0.85,114,2013-11-29,BRK,HOU,2014,123.5
9163,9163,63,Home,L 95-97 ,240,35,89,0.393,25,60,0.417,10,29,0.345,15,19,0.789,95,36,83,0.434,29,63,0.46,7,20,0.35,18,20,0.9,97,2013-12-03,SAC,OKC,2014,100.5
9164,9164,64,@,W 95-86 ,240,40,84,0.476,37,68,0.544,3,16,0.188,12,15,0.8,95,33,80,0.413,29,69,0.42,4,11,0.364,16,18,0.889,86,2013-12-04,IND,UTA,2014,88.0
9165,9165,65,Home,L 95-109 ,240,33,88,0.375,30,72,0.417,3,16,0.188,26,34,0.765,95,39,77,0.506,32,56,0.571,7,21,0.333,24,30,0.8,109,2013-12-06,NOP,OKC,2014,112.5
9166,9166,66,Home,L 95-110 ,240,36,85,0.424,29,65,0.446,7,20,0.35,16,22,0.727,95,40,72,0.556,29,44,0.659,11,28,0.393,19,21,0.905,110,2013-12-08,DET,MIA,2014,115.5
9167,9167,67,Home,W 95-93 ,240,37,86,0.43,25,58,0.431,12,28,0.429,9,15,0.6,95,37,88,0.42,29,65,0.446,8,23,0.348,11,14,0.786,93,2013-12-11,GSW,DAL,2014,97.0
9168,9168,68,Home,W 95-87 ,240,35,78,0.449,27,61,0.443,8,17,0.471,17,24,0.708,95,30,80,0.375,26,65,0.4,4,15,0.267,23,28,0.821,87,2013-12-17,CHA,SAC,2014,89.0
9169,9169,69,@,L 95-108 ,240,37,93,0.398,30,73,0.411,7,20,0.35,14,20,0.7,95,33,78,0.423,22,49,0.449,11,29,0.379,31,36,0.861,108,2013-12-18,NOP,LAC,2014,113.5
9170,9170,70,@,L 95-107 ,240,29,77,0.377,21,48,0.438,8,29,0.276,29,39,0.744,95,43,84,0.512,34,69,0.493,9,15,0.6,12,14,0.857,107,2013-12-19,CHI,OKC,2014,111.5
9171,9171,71,@,W 95-87 ,240,39,82,0.476,38,73,0.521,1,9,0.111,16,19,0.842,95,33,79,0.418,27,57,0.474,6,22,0.273,15,23,0.652,87,2013-12-21,MEM,NYK,2014,90.0
9172,9172,72,@,W 95-78 ,240,36,74,0.486,31,57,0.544,5,17,0.294,18,20,0.9,95,25,71,0.352,20,54,0.37,5,17,0.294,23,31,0.742,78,2013-12-25,CHI,BRK,2014,80.5
9173,9173,73,Home,L 95-101 ,240,33,79,0.418,19,43,0.442,14,36,0.389,15,26,0.577,95,41,80,0.513,32,53,0.604,9,27,0.333,10,17,0.588,101,2013-12-25,LAL,MIA,2014,105.5
9174,9174,74,@,W 95-83 ,240,31,73,0.425,21,45,0.467,10,28,0.357,23,33,0.697,95,30,79,0.38,20,60,0.333,10,19,0.526,13,21,0.619,83,2013-12-27,TOR,NYK,2014,88.0
9175,9175,75,Home,L 95-117 ,240,40,89,0.449,35,67,0.522,5,22,0.227,10,17,0.588,95,43,90,0.478,32,66,0.485,11,24,0.458,20,29,0.69,117,2013-12-28,MIL,MIN,2014,122.5
9176,9176,76,@,W 95-91 ,240,28,65,0.431,22,50,0.44,6,15,0.4,33,42,0.786,95,35,78,0.449,35,73,0.479,0,5,0.0,21,28,0.75,91,2013-12-30,CHI,MEM,2014,91.0
9177,9177,77,Home,W 95-82 ,240,34,78,0.436,27,59,0.458,7,19,0.368,20,23,0.87,95,32,74,0.432,27,60,0.45,5,14,0.357,13,20,0.65,82,2014-01-01,TOR,IND,2014,84.5
9178,9178,78,@,W 95-93 ,240,31,70,0.443,22,46,0.478,9,24,0.375,24,31,0.774,95,34,68,0.5,25,46,0.543,9,22,0.409,16,19,0.842,93,2014-01-02,BRK,OKC,2014,97.5
9179,9179,79,@,W 95-92 ,240,38,77,0.494,36,71,0.507,2,6,0.333,17,22,0.773,95,31,89,0.348,24,60,0.4,7,29,0.241,23,28,0.821,92,2014-01-03,NOP,BOS,2014,95.5
9180,9180,80,Home,L 95-126 ,240,38,80,0.475,30,62,0.484,8,18,0.444,11,16,0.688,95,46,100,0.46,30,74,0.405,16,26,0.615,18,23,0.783,126,2014-01-06,PHI,MIN,2014,134.0
9181,9181,81,@,L 95-104 (2OT),290,34,80,0.425,28,57,0.491,6,23,0.261,21,27,0.778,95,40,86,0.465,33,66,0.5,7,20,0.35,17,21,0.81,104,2014-01-10,MIA,BRK,2014,107.5
9182,9182,82,Home,L 95-101 ,240,38,87,0.437,31,76,0.408,7,11,0.636,12,17,0.706,95,35,67,0.522,30,55,0.545,5,12,0.417,26,31,0.839,101,2014-01-13,NOP,SAS,2014,103.5
9183,9183,83,Home,W 95-92 ,240,39,77,0.506,33,62,0.532,6,15,0.4,11,20,0.55,95,35,88,0.398,30,68,0.441,5,20,0.25,17,26,0.654,92,2014-01-15,PHI,CHA,2014,94.5
9184,9184,84,Home,L 95-109 ,240,29,83,0.349,22,60,0.367,7,23,0.304,30,36,0.833,95,33,78,0.423,25,48,0.521,8,30,0.267,35,42,0.833,109,2014-01-17,NYK,LAC,2014,113.0
9185,9185,85,@,L 95-100 ,240,39,95,0.411,29,66,0.439,10,29,0.345,7,10,0.7,95,32,65,0.492,23,49,0.469,9,16,0.563,27,33,0.818,100,2014-01-20,TOR,CHA,2014,104.5
9186,9186,86,@,W 95-92 ,240,35,77,0.455,30,68,0.441,5,9,0.556,20,23,0.87,95,31,74,0.419,24,55,0.436,7,19,0.368,23,28,0.821,92,2014-01-20,NOP,MEM,2014,95.5
9187,9187,87,Home,W 95-91 ,240,39,84,0.464,34,69,0.493,5,15,0.333,12,20,0.6,95,39,90,0.433,33,64,0.516,6,26,0.231,7,9,0.778,91,2014-01-22,CHA,LAC,2014,94.0
9188,9188,88,Home,L 95-112 ,240,40,93,0.43,34,74,0.459,6,19,0.316,9,11,0.818,95,41,76,0.539,28,55,0.509,13,21,0.619,17,26,0.654,112,2014-01-24,CHI,LAC,2014,118.5
9189,9189,89,Home,L 95-104 ,240,38,89,0.427,32,69,0.464,6,20,0.3,13,16,0.813,95,40,84,0.476,32,64,0.5,8,20,0.4,16,22,0.727,104,2014-01-24,PHI,TOR,2014,108.0
9190,9190,90,Home,L 95-101 ,240,34,71,0.479,27,49,0.551,7,22,0.318,20,25,0.8,95,39,86,0.453,33,70,0.471,6,16,0.375,17,23,0.739,101,2014-01-24,PHO,WAS,2014,104.0
9191,9191,91,@,W 95-86 ,240,34,73,0.466,29,56,0.518,5,17,0.294,22,26,0.846,95,32,85,0.376,24,61,0.393,8,24,0.333,14,16,0.875,86,2014-01-27,MIN,CHI,2014,90.0
9192,9192,92,@,W 95-94 ,240,37,86,0.43,30,65,0.462,7,21,0.333,14,25,0.56,95,32,87,0.368,25,68,0.368,7,19,0.368,23,30,0.767,94,2014-01-29,PHI,BOS,2014,97.5
9193,9193,93,Home,L 95-112 ,240,37,72,0.514,34,53,0.642,3,19,0.158,18,22,0.818,95,41,80,0.513,25,53,0.472,16,27,0.593,14,19,0.737,112,2014-01-29,MIA,OKC,2014,120.0
9194,9194,94,Home,L 95-120 ,240,35,74,0.473,24,50,0.48,11,24,0.458,14,17,0.824,95,49,77,0.636,44,62,0.71,5,15,0.333,17,20,0.85,120,2014-01-31,BRK,OKC,2014,122.5
9195,9195,95,@,W 95-90 ,240,33,88,0.375,23,62,0.371,10,26,0.385,19,24,0.792,95,35,73,0.479,32,64,0.5,3,9,0.333,17,21,0.81,90,2014-01-31,GSW,UTA,2014,91.5
9196,9196,96,@,L 95-105 ,240,33,79,0.418,25,56,0.446,8,23,0.348,21,29,0.724,95,39,80,0.488,32,59,0.542,7,21,0.333,20,23,0.87,105,2014-02-01,CHA,PHO,2014,108.5
9197,9197,97,Home,W 95-93 ,240,36,75,0.48,30,53,0.566,6,22,0.273,17,26,0.654,95,34,83,0.41,29,69,0.42,5,14,0.357,20,25,0.8,93,2014-02-01,SAS,SAC,2014,95.5
9198,9198,98,Home,L 95-102 ,240,36,79,0.456,30,65,0.462,6,14,0.429,17,20,0.85,95,38,81,0.469,33,63,0.524,5,18,0.278,21,25,0.84,102,2014-02-03,NOP,SAS,2014,104.5
9199,9199,99,@,L 95-111 ,240,32,89,0.36,20,58,0.345,12,31,0.387,19,29,0.655,95,43,84,0.512,34,67,0.507,9,17,0.529,16,24,0.667,111,2014-02-07,BRK,DET,2014,115.5
9200,9200,0,Home,L 95-101 ,240,40,90,0.444,34,75,0.453,6,15,0.4,9,11,0.818,95,42,85,0.494,34,61,0.557,8,24,0.333,9,13,0.692,101,2014-02-08,MIL,HOU,2014,105.0
9201,9201,1,Home,L 95-98 ,240,32,85,0.376,25,62,0.403,7,23,0.304,24,27,0.889,95,40,83,0.482,33,69,0.478,7,14,0.5,11,12,0.917,98,2014-02-11,POR,OKC,2014,101.5
9202,9202,2,Home,L 95-109 ,240,33,88,0.375,18,56,0.321,15,32,0.469,14,21,0.667,95,37,78,0.474,32,65,0.492,5,13,0.385,30,36,0.833,109,2014-02-23,DEN,SAC,2014,111.5
9203,9203,3,Home,L 95-100 ,240,37,103,0.359,33,83,0.398,4,20,0.2,17,26,0.654,95,28,76,0.368,16,45,0.356,12,31,0.387,32,38,0.842,100,2014-02-25,DEN,POR,2014,106.0
9204,9204,4,Home,W 95-88 (OT),265,38,90,0.422,31,71,0.437,7,19,0.368,12,17,0.706,95,30,74,0.405,23,54,0.426,7,20,0.35,21,22,0.955,88,2014-03-09,CHI,MIA,2014,91.5
9205,9205,5,Home,L 95-96 ,240,33,68,0.485,24,41,0.585,9,27,0.333,20,26,0.769,95,34,78,0.436,22,49,0.449,12,29,0.414,16,19,0.842,96,2014-03-12,MIA,BRK,2014,102.0
9206,9206,6,@,L 95-108 ,240,37,80,0.463,31,58,0.534,6,22,0.273,15,28,0.536,95,41,70,0.586,32,49,0.653,9,21,0.429,17,27,0.63,108,2014-03-17,PHO,BRK,2014,112.5
9207,9207,7,Home,L 95-102 ,240,36,81,0.444,28,59,0.475,8,22,0.364,15,24,0.625,95,38,89,0.427,28,58,0.483,10,31,0.323,16,20,0.8,102,2014-03-20,CLE,OKC,2014,107.0
9208,9208,8,@,L 95-105 ,240,37,73,0.507,29,47,0.617,8,26,0.308,13,17,0.765,95,43,84,0.512,36,67,0.537,7,17,0.412,12,17,0.706,105,2014-03-22,MIA,NOP,2014,108.5
9209,9209,9,Home,L 95-102 ,240,30,72,0.417,22,49,0.449,8,23,0.348,27,33,0.818,95,38,74,0.514,26,50,0.52,12,24,0.5,14,16,0.875,102,2014-03-24,ATL,PHO,2014,108.0
9210,9210,10,Home,W 95-85 ,240,37,85,0.435,31,68,0.456,6,17,0.353,15,22,0.682,95,32,86,0.372,25,60,0.417,7,26,0.269,14,17,0.824,85,2014-03-25,ORL,POR,2014,88.5
9211,9211,11,@,L 95-102 ,240,33,68,0.485,26,47,0.553,7,21,0.333,22,27,0.815,95,36,71,0.507,30,57,0.526,6,14,0.429,24,32,0.75,102,2014-03-28,UTA,NOP,2014,105.0
9212,9212,12,@,L 95-103 ,240,36,77,0.468,25,47,0.532,11,30,0.367,12,20,0.6,95,36,84,0.429,29,53,0.547,7,31,0.226,24,30,0.8,103,2014-03-31,PHI,ATL,2014,106.5
9213,9213,13,Home,L 95-107 ,240,35,83,0.422,28,55,0.509,7,28,0.25,18,24,0.75,95,44,92,0.478,39,71,0.549,5,21,0.238,14,15,0.933,107,2014-04-04,LAL,DAL,2014,109.5
9214,9214,14,Home,L 95-102 ,240,34,89,0.382,25,54,0.463,9,35,0.257,18,24,0.75,95,37,86,0.43,31,69,0.449,6,17,0.353,22,32,0.688,102,2014-04-08,ATL,DET,2014,105.0
9215,9215,15,@,W 95-83 ,240,40,72,0.556,31,49,0.633,9,23,0.391,6,11,0.545,95,36,87,0.414,32,63,0.508,4,24,0.167,7,13,0.538,83,2014-04-08,DAL,UTA,2014,85.0
9216,9216,16,Home,L 95-112 ,240,35,89,0.393,26,61,0.426,9,28,0.321,16,20,0.8,95,45,92,0.489,32,67,0.478,13,25,0.52,9,13,0.692,112,2014-04-11,LAL,GSW,2014,118.5
9217,9217,17,@,L 95-117 ,240,39,88,0.443,33,70,0.471,6,18,0.333,11,17,0.647,95,44,81,0.543,39,68,0.574,5,13,0.385,24,32,0.75,117,2014-04-11,PHI,MEM,2014,119.5
9218,9218,18,@,W 95-93 ,240,35,80,0.438,29,55,0.527,6,25,0.24,19,31,0.613,95,34,79,0.43,26,49,0.531,8,30,0.267,17,23,0.739,93,2014-04-14,CHA,ATL,2014,97.0
9219,9219,19,@,L 95-108 ,240,36,72,0.5,29,57,0.509,7,15,0.467,16,19,0.842,95,39,77,0.506,34,64,0.531,5,13,0.385,25,32,0.781,108,2014-04-14,ORL,CHI,2014,110.5
9220,9220,20,Home,W 95-92 ,240,37,81,0.457,29,64,0.453,8,17,0.471,13,19,0.684,95,36,80,0.45,27,51,0.529,9,29,0.31,11,18,0.611,92,2014-04-16,NYK,TOR,2014,96.5
9221,9221,21,@,L 95-107 ,240,36,75,0.48,30,56,0.536,6,19,0.316,17,24,0.708,95,39,81,0.481,30,53,0.566,9,28,0.321,20,23,0.87,107,2014-10-29,WAS,MIA,2015,111.5
9222,9222,22,@,W 95-77 ,240,33,75,0.44,27,48,0.563,6,27,0.222,23,32,0.719,95,24,78,0.308,21,60,0.35,3,18,0.167,26,35,0.743,77,2014-10-29,GSW,SAC,2015,78.5
9223,9223,23,@,W 95-90 ,240,37,69,0.536,31,57,0.544,6,12,0.5,15,18,0.833,95,32,70,0.457,23,46,0.5,9,24,0.375,17,20,0.85,90,2014-10-30,NYK,CLE,2015,94.5
9224,9224,24,Home,L 95-108 ,240,38,81,0.469,31,61,0.508,7,20,0.35,12,24,0.5,95,33,83,0.398,29,62,0.468,4,21,0.19,38,48,0.792,108,2014-11-01,ORL,TOR,2015,110.0
9225,9225,25,@,W 95-90 ,240,36,81,0.444,30,62,0.484,6,19,0.316,17,21,0.81,95,37,92,0.402,30,65,0.462,7,27,0.259,9,14,0.643,90,2014-11-02,GSW,POR,2015,93.5
9226,9226,26,@,L 95-98 ,240,39,90,0.433,30,70,0.429,9,20,0.45,8,10,0.8,95,32,87,0.368,21,64,0.328,11,23,0.478,23,33,0.697,98,2014-11-05,NYK,DET,2015,103.5
9227,9227,27,@,W 95-86 ,240,34,73,0.466,29,57,0.509,5,16,0.313,22,30,0.733,95,33,89,0.371,30,74,0.405,3,15,0.2,17,20,0.85,86,2014-11-05,CHI,MIL,2015,87.5
9228,9228,28,@,L 95-98 ,240,36,77,0.468,31,57,0.544,5,20,0.25,18,23,0.783,95,37,75,0.493,26,52,0.5,11,23,0.478,13,24,0.542,98,2014-11-07,MIL,DET,2015,103.5
9229,9229,29,@,L 95-107 ,240,33,69,0.478,22,45,0.489,11,24,0.458,18,21,0.857,95,34,79,0.43,22,49,0.449,12,30,0.4,27,33,0.818,107,2014-11-09,GSW,PHO,2015,113.0
9230,9230,30,Home,L 95-97 ,240,37,86,0.43,29,63,0.46,8,23,0.348,13,14,0.929,95,33,70,0.471,27,58,0.466,6,12,0.5,25,32,0.781,97,2014-11-12,NYK,ORL,2015,100.0
9231,9231,31,Home,L 95-103 ,240,37,86,0.43,29,57,0.509,8,29,0.276,13,14,0.929,95,39,91,0.429,32,75,0.427,7,16,0.438,18,19,0.947,103,2014-11-14,PHO,CHO,2015,106.5
9232,9232,32,Home,W 95-88 ,240,32,86,0.372,28,71,0.394,4,15,0.267,27,33,0.818,95,34,82,0.415,24,56,0.429,10,26,0.385,10,17,0.588,88,2014-11-15,MEM,DET,2015,93.0
9233,9233,33,@,W 95-83 ,240,31,72,0.431,22,45,0.489,9,27,0.333,24,27,0.889,95,29,70,0.414,20,47,0.426,9,23,0.391,16,26,0.615,83,2014-11-17,MIA,BRK,2015,87.5
9234,9234,34,Home,W 95-92 ,240,30,82,0.366,15,36,0.417,15,46,0.326,20,23,0.87,95,35,88,0.398,29,53,0.547,6,35,0.171,16,22,0.727,92,2014-11-22,HOU,DAL,2015,95.0
9235,9235,35,Home,L 95-97 ,240,42,86,0.488,39,77,0.506,3,9,0.333,8,10,0.8,95,36,72,0.5,27,52,0.519,9,20,0.45,16,23,0.696,97,2014-11-24,UTA,CHI,2015,101.5
9236,9236,36,Home,W 95-93 (OT),265,37,90,0.411,28,71,0.394,9,19,0.474,12,18,0.667,95,36,101,0.356,24,69,0.348,12,32,0.375,9,12,0.75,93,2014-12-03,BRK,SAS,2015,99.0
9237,9237,37,Home,L 95-102 ,240,36,90,0.4,34,75,0.453,2,15,0.133,21,23,0.913,95,37,80,0.463,25,52,0.481,12,28,0.429,16,21,0.762,102,2014-12-03,CHA,CHI,2015,108.0
9238,9238,38,@,L 95-111 ,240,33,85,0.388,21,56,0.375,12,29,0.414,17,21,0.81,95,45,93,0.484,39,74,0.527,6,19,0.316,15,19,0.789,111,2014-12-03,LAL,WAS,2015,114.0
9239,9239,39,@,L 95-100 ,240,34,93,0.366,27,65,0.415,7,28,0.25,20,26,0.769,95,33,81,0.407,22,54,0.407,11,27,0.407,23,31,0.742,100,2014-12-06,PHO,HOU,2015,105.5
9240,9240,40,@,L 95-98 ,240,32,70,0.457,25,55,0.455,7,15,0.467,24,37,0.649,95,38,96,0.396,33,71,0.465,5,25,0.2,17,25,0.68,98,2014-12-09,SAC,LAL,2015,100.5
9241,9241,41,Home,W 95-79 ,240,38,91,0.418,28,61,0.459,10,30,0.333,9,13,0.692,95,30,72,0.417,24,47,0.511,6,25,0.24,13,22,0.591,79,2014-12-10,ATL,PHI,2015,82.0
9242,9242,42,@,L 95-109 ,240,37,76,0.487,31,61,0.508,6,15,0.4,15,17,0.882,95,37,73,0.507,27,54,0.5,10,19,0.526,25,30,0.833,109,2014-12-10,NYK,SAS,2015,114.0
9243,9243,43,Home,L 95-101 ,240,37,85,0.435,30,63,0.476,7,22,0.318,14,18,0.778,95,40,81,0.494,34,65,0.523,6,16,0.375,15,18,0.833,101,2014-12-12,BOS,NYK,2015,104.0
9244,9244,44,Home,L 95-100 ,240,34,77,0.442,26,49,0.531,8,28,0.286,19,22,0.864,95,36,72,0.5,29,52,0.558,7,20,0.35,21,31,0.677,100,2014-12-12,UTA,MIA,2015,103.5
9245,9245,45,@,W 95-85 ,240,40,90,0.444,35,73,0.479,5,17,0.294,10,12,0.833,95,34,88,0.386,30,73,0.411,4,15,0.267,13,16,0.813,85,2014-12-13,POR,IND,2015,87.0
9246,9246,46,@,W 95-90 ,240,35,79,0.443,29,59,0.492,6,20,0.3,19,23,0.826,95,33,93,0.355,22,64,0.344,11,29,0.379,13,19,0.684,90,2014-12-13,DET,SAC,2015,95.5
9247,9247,47,@,W 95-90 (OT),265,36,78,0.462,27,54,0.5,9,24,0.375,14,18,0.778,95,29,78,0.372,20,49,0.408,9,29,0.31,23,28,0.821,90,2014-12-14,TOR,NYK,2015,94.5
9248,9248,48,@,L 95-108 ,240,38,78,0.487,34,67,0.507,4,11,0.364,15,22,0.682,95,41,89,0.461,34,71,0.479,7,18,0.389,19,22,0.864,108,2014-12-15,SAS,POR,2015,111.5
9249,9249,49,Home,W 95-82 ,240,37,83,0.446,26,53,0.491,11,30,0.367,10,15,0.667,95,36,74,0.486,32,59,0.542,4,15,0.267,6,8,0.75,82,2014-12-15,TOR,ORL,2015,84.0
9250,9250,50,@,W 95-91 ,240,33,72,0.458,24,48,0.5,9,24,0.375,20,26,0.769,95,30,77,0.39,22,49,0.449,8,28,0.286,23,32,0.719,91,2014-12-16,MIA,BRK,2015,95.0
9251,9251,51,@,L 95-109 ,240,36,81,0.444,33,73,0.452,3,8,0.375,20,35,0.571,95,43,86,0.5,33,69,0.478,10,17,0.588,13,18,0.722,109,2014-12-16,MIN,WAS,2015,114.0
9252,9252,52,Home,W 95-91 ,240,31,77,0.403,22,53,0.415,9,24,0.375,24,29,0.828,95,37,78,0.474,28,54,0.519,9,24,0.375,8,12,0.667,91,2014-12-19,CLE,BRK,2015,95.5
9253,9253,53,@,L 95-110 ,240,34,76,0.447,24,49,0.49,10,27,0.37,17,18,0.944,95,41,87,0.471,28,51,0.549,13,36,0.361,15,20,0.75,110,2014-12-22,POR,HOU,2015,116.5
9254,9254,54,@,L 95-100 ,240,33,85,0.388,26,62,0.419,7,23,0.304,22,29,0.759,95,39,83,0.47,32,65,0.492,7,18,0.389,15,23,0.652,100,2014-12-23,BOS,ORL,2015,103.5
9255,9255,55,Home,L 95-103 ,240,37,72,0.514,31,52,0.596,6,20,0.3,15,21,0.714,95,34,73,0.466,27,57,0.474,7,16,0.438,28,37,0.757,103,2014-12-27,MIA,MEM,2015,106.5
9256,9256,56,Home,W 95-87 ,240,35,72,0.486,28,57,0.491,7,15,0.467,18,22,0.818,95,35,78,0.449,30,56,0.536,5,22,0.227,12,17,0.706,87,2014-12-30,MEM,SAS,2015,89.5
9257,9257,57,@,L 95-106 ,240,38,77,0.494,33,61,0.541,5,16,0.313,14,18,0.778,95,35,79,0.443,25,61,0.41,10,18,0.556,26,30,0.867,106,2014-12-31,MIA,IND,2015,111.0
9258,9258,58,Home,W 95-93 (OT),265,39,89,0.438,33,65,0.508,6,24,0.25,11,18,0.611,95,34,89,0.382,26,61,0.426,8,28,0.286,17,20,0.85,93,2014-12-31,SAS,NOP,2015,97.0
9259,9259,59,@,L 95-114 ,240,32,75,0.427,29,60,0.483,3,15,0.2,28,36,0.778,95,45,91,0.495,33,60,0.55,12,31,0.387,12,16,0.75,114,2015-01-04,SAC,DET,2015,120.0
9260,9260,60,@,W 95-82 ,240,35,77,0.455,31,61,0.508,4,16,0.25,21,27,0.778,95,31,76,0.408,22,51,0.431,9,25,0.36,11,14,0.786,82,2015-01-04,MIL,NYK,2015,86.5
9261,9261,61,Home,L 95-104 ,240,36,91,0.396,29,73,0.397,7,18,0.389,16,23,0.696,95,38,78,0.487,32,59,0.542,6,19,0.316,22,23,0.957,104,2015-01-05,BOS,CHO,2015,107.0
9262,9262,62,Home,W 95-92 ,240,38,79,0.481,31,56,0.554,7,23,0.304,12,15,0.8,95,33,85,0.388,22,55,0.4,11,30,0.367,15,22,0.682,92,2015-01-05,PHI,CLE,2015,97.5
9263,9263,63,Home,L 95-108 ,240,38,87,0.437,32,65,0.492,6,22,0.273,13,18,0.722,95,43,97,0.443,33,76,0.434,10,21,0.476,12,14,0.857,108,2015-01-07,DAL,DET,2015,113.0
9264,9264,64,Home,L 95-103 ,240,33,83,0.398,23,52,0.442,10,31,0.323,19,25,0.76,95,42,88,0.477,38,72,0.528,4,16,0.25,15,22,0.682,103,2015-01-08,TOR,CHO,2015,105.0
9265,9265,65,@,L 95-106 ,240,36,82,0.439,30,65,0.462,6,17,0.353,17,22,0.773,95,37,81,0.457,27,61,0.443,10,20,0.5,22,26,0.846,106,2015-01-09,MEM,NOP,2015,111.0
9266,9266,66,@,L 95-100 ,240,37,83,0.446,30,57,0.526,7,26,0.269,14,21,0.667,95,38,89,0.427,27,66,0.409,11,23,0.478,13,18,0.722,100,2015-01-09,PHO,SAS,2015,105.5
9267,9267,67,Home,W 95-87 ,240,35,88,0.398,31,71,0.437,4,17,0.235,21,24,0.875,95,36,81,0.444,33,70,0.471,3,11,0.273,12,16,0.75,87,2015-01-10,CHI,MIL,2015,88.5
9268,9268,68,Home,W 95-79 ,240,28,72,0.389,20,54,0.37,8,18,0.444,31,42,0.738,95,28,68,0.412,20,46,0.435,8,22,0.364,15,20,0.75,79,2015-01-15,MIL,NYK,2015,83.0
9269,9269,69,@,W 95-83 ,240,35,74,0.473,27,57,0.474,8,17,0.471,17,21,0.81,95,32,75,0.427,25,59,0.424,7,16,0.438,12,14,0.857,83,2015-01-16,MIA,SAC,2015,86.5
9270,9270,70,@,W 95-93 ,240,39,82,0.476,34,65,0.523,5,17,0.294,12,20,0.6,95,31,72,0.431,24,47,0.511,7,25,0.28,24,29,0.828,93,2015-01-18,NOP,TOR,2015,96.5
9271,9271,71,Home,L 95-103 ,240,36,85,0.424,33,63,0.524,3,22,0.136,20,22,0.909,95,34,76,0.447,24,51,0.471,10,25,0.4,25,33,0.758,103,2015-01-19,MEM,DAL,2015,108.0
9272,9272,72,@,L 95-101 ,240,39,82,0.476,31,65,0.477,8,17,0.471,9,13,0.692,95,35,83,0.422,30,61,0.492,5,22,0.227,26,30,0.867,101,2015-01-25,MIL,SAS,2015,103.5
9273,9273,73,Home,L 95-103 ,240,35,83,0.422,27,59,0.458,8,24,0.333,17,23,0.739,95,39,93,0.419,30,59,0.508,9,34,0.265,16,17,0.941,103,2015-01-27,DET,CLE,2015,107.5
9274,9274,74,Home,W 95-86 ,240,35,83,0.422,25,54,0.463,10,29,0.345,15,18,0.833,95,34,83,0.41,28,65,0.431,6,18,0.333,12,14,0.857,86,2015-01-28,SAS,CHO,2015,89.0
9275,9275,75,Home,W 95-88 ,240,37,82,0.451,29,61,0.475,8,21,0.381,13,14,0.929,95,33,89,0.371,24,58,0.414,9,31,0.29,13,18,0.722,88,2015-01-31,MIL,POR,2015,92.5
9276,9276,76,@,W 95-93 ,240,37,89,0.416,31,64,0.484,6,25,0.24,15,17,0.882,95,36,88,0.409,28,67,0.418,8,21,0.381,13,13,1.0,93,2015-02-09,SAS,IND,2015,97.0
9277,9277,77,@,L 95-109 ,240,36,84,0.429,29,64,0.453,7,20,0.35,16,19,0.842,95,36,74,0.486,24,52,0.462,12,22,0.545,25,29,0.862,109,2015-02-09,NYK,MIA,2015,115.0
9278,9278,78,Home,W 95-86 ,240,36,81,0.444,30,62,0.484,6,19,0.316,17,25,0.68,95,35,81,0.432,32,69,0.464,3,12,0.25,13,17,0.765,86,2015-02-10,MEM,BRK,2015,87.5
9279,9279,79,@,L 95-110 ,240,34,87,0.391,25,42,0.595,9,45,0.2,18,22,0.818,95,39,81,0.481,35,59,0.593,4,22,0.182,28,45,0.622,110,2015-02-11,HOU,LAC,2015,112.0
9280,9280,80,Home,W 95-93 ,240,31,76,0.408,20,50,0.4,11,26,0.423,22,26,0.846,95,39,85,0.459,34,64,0.531,5,21,0.238,10,16,0.625,93,2015-02-11,TOR,WAS,2015,95.5
9281,9281,81,Home,W 95-84 ,240,44,88,0.5,40,70,0.571,4,18,0.222,3,6,0.5,95,29,69,0.42,24,50,0.48,5,19,0.263,21,28,0.75,84,2015-02-20,ORL,NOP,2015,86.5
9282,9282,82,Home,L 95-106 ,240,34,84,0.405,26,59,0.441,8,25,0.32,19,29,0.655,95,40,83,0.482,32,61,0.525,8,22,0.364,18,22,0.818,106,2015-02-20,PHI,IND,2015,110.0
9283,9283,83,@,L 95-111 ,240,37,85,0.435,29,64,0.453,8,21,0.381,13,14,0.929,95,43,85,0.506,30,59,0.508,13,26,0.5,12,15,0.8,111,2015-02-25,SAS,POR,2015,117.5
9284,9284,84,Home,W 95-88 ,240,36,81,0.444,22,50,0.44,14,31,0.452,9,12,0.75,95,36,80,0.45,27,54,0.5,9,26,0.346,7,13,0.538,88,2015-02-27,ATL,ORL,2015,92.5
9285,9285,85,@,L 95-99 ,240,38,79,0.481,30,53,0.566,8,26,0.308,11,21,0.524,95,37,78,0.474,30,58,0.517,7,20,0.35,18,25,0.72,99,2015-02-28,DET,WAS,2015,102.5
9286,9286,86,@,L 95-106 ,240,35,86,0.407,25,62,0.403,10,24,0.417,15,22,0.682,95,39,86,0.453,27,52,0.519,12,34,0.353,16,20,0.8,106,2015-03-03,MIL,DEN,2015,112.0
9287,9287,87,Home,W 95-89 ,240,38,80,0.475,30,57,0.526,8,23,0.348,11,13,0.846,95,32,74,0.432,26,58,0.448,6,16,0.375,19,29,0.655,89,2015-03-07,NOP,MEM,2015,92.0
9288,9288,88,@,W 95-88 ,240,34,72,0.472,24,50,0.48,10,22,0.455,17,21,0.81,95,38,76,0.5,30,61,0.492,8,15,0.533,4,11,0.364,88,2015-03-08,UTA,BRK,2015,92.0
9289,9289,89,@,W 95-69 ,240,44,85,0.518,42,71,0.592,2,14,0.143,5,5,1.0,95,25,77,0.325,21,55,0.382,4,22,0.182,15,20,0.75,69,2015-03-09,WAS,CHO,2015,71.0
9290,9290,90,Home,W 95-92 ,240,37,85,0.435,29,58,0.5,8,27,0.296,13,17,0.765,95,37,78,0.474,32,66,0.485,5,12,0.417,13,13,1.0,92,2015-03-11,BOS,MEM,2015,94.5
9291,9291,91,Home,L 95-104 (OT),265,36,104,0.346,25,63,0.397,11,41,0.268,12,25,0.48,95,40,87,0.46,30,63,0.476,10,24,0.417,14,20,0.7,104,2015-03-11,PHI,CHI,2015,109.0
9292,9292,92,Home,W 95-88 ,240,37,86,0.43,27,60,0.45,10,26,0.385,11,20,0.55,95,34,80,0.425,28,60,0.467,6,20,0.3,14,28,0.5,88,2015-03-13,BOS,ORL,2015,91.0
9293,9293,93,@,L 95-105 ,240,35,80,0.438,25,62,0.403,10,18,0.556,15,17,0.882,95,39,83,0.47,27,50,0.54,12,33,0.364,15,22,0.682,105,2015-03-17,MEM,DET,2015,111.0
9294,9294,94,@,L 95-114 ,240,31,87,0.356,23,65,0.354,8,22,0.364,25,30,0.833,95,44,84,0.524,30,54,0.556,14,30,0.467,12,20,0.6,114,2015-03-18,ATL,GSW,2015,121.0
9295,9295,95,@,W 95-92 (OT),265,34,83,0.41,32,71,0.451,2,12,0.167,25,30,0.833,95,40,97,0.412,36,77,0.468,4,20,0.2,8,10,0.8,92,2015-03-19,MIN,NYK,2015,94.0
9296,9296,96,Home,W 95-92 ,240,35,82,0.427,26,56,0.464,9,26,0.346,16,21,0.762,95,36,84,0.429,28,64,0.438,8,20,0.4,12,13,0.923,92,2015-03-20,CLE,IND,2015,96.0
9297,9297,97,Home,L 95-114 ,240,38,80,0.475,26,56,0.464,12,24,0.5,7,7,1.0,95,46,82,0.561,39,65,0.6,7,17,0.412,15,17,0.882,114,2015-03-22,ATL,SAS,2015,117.5
9298,9298,98,@,W 95-93 ,240,40,81,0.494,34,59,0.576,6,22,0.273,9,12,0.75,95,34,75,0.453,29,60,0.483,5,15,0.333,20,32,0.625,93,2015-03-25,HOU,NOP,2015,95.5
9299,9299,99,@,W 95-83 ,240,39,90,0.433,29,59,0.492,10,31,0.323,7,10,0.7,95,32,78,0.41,29,62,0.468,3,16,0.188,16,20,0.8,83,2015-03-25,ATL,ORL,2015,84.5
9300,9300,0,Home,L 95-108 ,240,33,87,0.379,31,72,0.431,2,15,0.133,27,32,0.844,95,42,82,0.512,30,57,0.526,12,25,0.48,12,14,0.857,108,2015-03-28,MIL,GSW,2015,114.0
9301,9301,1,@,L 95-105 ,240,40,84,0.476,32,59,0.542,8,25,0.32,7,10,0.7,95,41,83,0.494,30,54,0.556,11,29,0.379,12,17,0.706,105,2015-03-31,ATL,DET,2015,110.5
9302,9302,2,@,W 95-81 ,240,37,74,0.5,29,56,0.518,8,18,0.444,13,17,0.765,95,32,79,0.405,27,64,0.422,5,15,0.333,12,12,1.0,81,2015-03-31,SAS,MIA,2015,83.5
9303,9303,3,Home,W 95-91 ,240,37,89,0.416,29,68,0.426,8,21,0.381,13,18,0.722,95,31,74,0.419,26,48,0.542,5,26,0.192,24,37,0.649,91,2015-04-01,MIL,CHI,2015,93.5
9304,9304,4,Home,L 95-101 ,240,37,78,0.474,31,61,0.508,6,17,0.353,15,25,0.6,95,34,87,0.391,20,58,0.345,14,29,0.483,19,28,0.679,101,2015-04-03,SAC,NOP,2015,108.0
9305,9305,5,Home,L 95-101 ,240,38,79,0.481,33,64,0.516,5,15,0.333,14,24,0.583,95,40,87,0.46,32,63,0.508,8,24,0.333,13,18,0.722,101,2015-04-05,SAC,UTA,2015,105.0
9306,9306,6,Home,W 95-93 ,240,38,99,0.384,32,72,0.444,6,27,0.222,13,15,0.867,95,35,80,0.438,26,56,0.464,9,24,0.375,14,20,0.7,93,2015-04-14,BOS,TOR,2015,97.5
9307,9307,7,@,L 95-99 (2OT),290,37,104,0.356,30,80,0.375,7,24,0.292,14,17,0.824,95,40,105,0.381,31,75,0.413,9,30,0.3,10,17,0.588,99,2015-04-14,WAS,IND,2015,103.5
9308,9308,8,Home,W 95-83 ,240,36,76,0.474,34,67,0.507,2,9,0.222,21,26,0.808,95,32,78,0.41,24,54,0.444,8,24,0.333,11,15,0.733,83,2015-04-15,MEM,IND,2015,87.0
9309,9309,9,@,L 95-97 ,240,38,94,0.404,29,65,0.446,9,29,0.31,10,17,0.588,95,37,87,0.425,30,68,0.441,7,19,0.368,16,23,0.696,97,2015-10-27,CLE,CHI,2016,100.5
9310,9310,10,@,L 95-111 ,240,35,83,0.422,29,65,0.446,6,18,0.333,19,27,0.704,95,41,96,0.427,32,66,0.485,9,30,0.3,20,22,0.909,111,2015-10-27,NOP,GSW,2016,115.5
9311,9311,11,@,L 95-112 ,240,34,83,0.41,27,61,0.443,7,22,0.318,20,23,0.87,95,39,85,0.459,31,61,0.508,8,24,0.333,26,27,0.963,112,2015-10-28,PHI,BOS,2016,116.0
9312,9312,12,Home,L 95-111 ,240,34,87,0.391,28,63,0.444,6,24,0.25,21,33,0.636,95,40,85,0.471,30,64,0.469,10,21,0.476,21,31,0.677,111,2015-10-28,PHO,DAL,2016,116.0
9313,9313,13,@,W 95-78 ,240,30,71,0.423,28,60,0.467,2,11,0.182,33,41,0.805,95,29,95,0.305,24,70,0.343,5,25,0.2,15,20,0.75,78,2015-10-30,MIN,DEN,2016,80.5
9314,9314,14,@,W 95-87 ,240,36,83,0.434,31,64,0.484,5,19,0.263,18,25,0.72,95,35,98,0.357,29,69,0.42,6,29,0.207,11,14,0.786,87,2015-11-01,SAS,BOS,2016,90.0
9315,9315,15,@,L 95-99 ,240,36,94,0.383,27,67,0.403,9,27,0.333,14,23,0.609,95,33,84,0.393,24,57,0.421,9,27,0.333,24,29,0.828,99,2015-11-08,LAL,NYK,2016,103.5
9316,9316,16,@,L 95-109 ,240,40,85,0.471,34,66,0.515,6,19,0.316,9,15,0.6,95,43,91,0.473,31,70,0.443,12,21,0.571,11,13,0.846,109,2015-11-09,DET,GSW,2016,115.0
9317,9317,17,Home,L 95-104 ,240,36,80,0.45,27,61,0.443,9,19,0.474,14,19,0.737,95,38,78,0.487,30,52,0.577,8,26,0.308,20,27,0.741,104,2015-11-10,MIN,CHO,2016,108.0
9318,9318,18,Home,W 95-93 ,240,35,84,0.417,27,61,0.443,8,23,0.348,17,28,0.607,95,42,86,0.488,38,65,0.585,4,21,0.19,5,7,0.714,93,2015-11-11,CHA,NYK,2016,95.0
9319,9319,19,Home,W 95-87 ,240,38,88,0.432,34,70,0.486,4,18,0.222,15,19,0.789,95,32,71,0.451,26,50,0.52,6,21,0.286,17,19,0.895,87,2015-11-15,NYK,NOP,2016,90.0
9320,9320,20,@,L 95-96 ,240,35,87,0.402,26,66,0.394,9,21,0.429,16,24,0.667,95,35,86,0.407,29,71,0.408,6,15,0.4,20,32,0.625,96,2015-11-16,IND,CHI,2016,99.0
9321,9321,21,Home,L 95-111 ,240,36,85,0.424,25,53,0.472,11,32,0.344,12,23,0.522,95,44,93,0.473,33,57,0.579,11,36,0.306,12,17,0.706,111,2015-11-16,HOU,BOS,2016,116.5
9322,9322,22,@,L 95-120 ,240,35,89,0.393,27,70,0.386,8,19,0.421,17,24,0.708,95,51,87,0.586,41,58,0.707,10,29,0.345,8,10,0.8,120,2015-11-20,BRK,BOS,2016,125.0
9323,9323,23,Home,L 95-97 ,240,36,79,0.456,28,53,0.528,8,26,0.308,15,21,0.714,95,38,78,0.487,31,59,0.525,7,19,0.368,14,20,0.7,97,2015-11-21,DET,WAS,2016,100.5
9324,9324,24,Home,W 95-78 ,240,31,81,0.383,26,62,0.419,5,19,0.263,28,36,0.778,95,28,87,0.322,24,63,0.381,4,24,0.167,18,21,0.857,78,2015-11-23,MIA,NYK,2016,80.0
9325,9325,25,@,L 95-100 ,240,32,78,0.41,22,47,0.468,10,31,0.323,21,27,0.778,95,36,78,0.462,33,66,0.5,3,12,0.25,25,27,0.926,100,2015-11-23,PHI,MIN,2016,101.5
9326,9326,26,@,L 95-99 ,240,31,82,0.378,23,51,0.451,8,31,0.258,25,35,0.714,95,34,82,0.415,25,61,0.41,9,21,0.429,22,29,0.759,99,2015-11-25,ATL,MIN,2016,103.5
9327,9327,27,@,W 95-90 ,240,34,81,0.42,26,56,0.464,8,25,0.32,19,25,0.76,95,33,80,0.413,28,55,0.509,5,25,0.2,19,25,0.76,90,2015-11-27,CLE,CHO,2016,92.5
9328,9328,28,Home,L 95-105 ,240,36,75,0.48,31,58,0.534,5,17,0.294,18,24,0.75,95,38,80,0.475,30,60,0.5,8,20,0.4,21,25,0.84,105,2015-11-30,MIA,BOS,2016,109.0
9329,9329,29,Home,W 95-70 ,240,37,90,0.411,30,69,0.435,7,21,0.333,14,20,0.7,95,26,78,0.333,23,64,0.359,3,14,0.214,15,18,0.833,70,2015-12-02,SAS,MIL,2016,71.5
9330,9330,30,@,L 95-97 ,240,35,79,0.443,31,63,0.492,4,16,0.25,21,24,0.875,95,40,81,0.494,37,68,0.544,3,13,0.231,14,24,0.583,97,2015-12-03,OKC,MIA,2016,98.5
9331,9331,31,@,L 95-102 ,240,39,87,0.448,35,69,0.507,4,18,0.222,13,14,0.929,95,34,82,0.415,27,59,0.458,7,23,0.304,27,39,0.692,102,2015-12-04,MIL,DET,2016,105.5
9332,9332,32,Home,W 95-93 ,240,36,90,0.4,31,75,0.413,5,15,0.333,18,24,0.75,95,36,82,0.439,27,51,0.529,9,31,0.29,12,17,0.706,93,2015-12-06,MEM,PHO,2016,97.5
9333,9333,33,@,L 95-98 ,240,35,88,0.398,28,64,0.438,7,24,0.292,18,30,0.6,95,35,86,0.407,29,64,0.453,6,22,0.273,22,31,0.71,98,2015-12-06,SAC,OKC,2016,101.0
9334,9334,34,Home,L 95-98 ,240,36,100,0.36,29,69,0.42,7,31,0.226,16,19,0.842,95,39,81,0.481,33,61,0.541,6,20,0.3,14,18,0.778,98,2015-12-09,DAL,ATL,2016,101.0
9335,9335,35,Home,L 95-109 ,240,42,90,0.467,40,80,0.5,2,10,0.2,9,12,0.75,95,38,81,0.469,26,53,0.491,12,28,0.429,21,36,0.583,109,2015-12-09,MIL,LAC,2016,115.0
9336,9336,36,Home,L 95-107 ,240,36,80,0.45,30,62,0.484,6,18,0.333,17,24,0.708,95,43,93,0.462,33,66,0.5,10,27,0.37,11,16,0.688,107,2015-12-11,PHI,DET,2016,112.0
9337,9337,37,@,L 95-108 ,240,36,89,0.404,30,62,0.484,6,27,0.222,17,25,0.68,95,44,90,0.489,38,76,0.5,6,14,0.429,14,18,0.778,108,2015-12-12,GSW,MIL,2016,111.0
9338,9338,38,@,L 95-112 ,240,37,86,0.43,28,62,0.452,9,24,0.375,12,20,0.6,95,44,78,0.564,34,63,0.54,10,15,0.667,14,15,0.933,112,2015-12-14,WAS,MEM,2016,117.0
9339,9339,39,@,L 95-113 ,240,40,85,0.471,36,72,0.5,4,13,0.308,11,20,0.55,95,41,89,0.461,31,62,0.5,10,27,0.37,21,25,0.84,113,2015-12-15,MIL,LAL,2016,118.0
9340,9340,40,@,L 95-114 ,240,35,84,0.417,32,69,0.464,3,15,0.2,22,25,0.88,95,44,83,0.53,36,61,0.59,8,22,0.364,18,23,0.783,114,2015-12-16,WAS,SAS,2016,118.0
9341,9341,41,@,L 95-99 ,240,38,81,0.469,31,58,0.534,7,23,0.304,12,17,0.706,95,39,82,0.476,33,64,0.516,6,18,0.333,15,16,0.938,99,2015-12-18,SAC,MIN,2016,102.0
9342,9342,42,Home,L 95-101 ,240,33,74,0.446,25,56,0.446,8,18,0.444,21,24,0.875,95,41,79,0.519,36,63,0.571,5,16,0.313,14,24,0.583,101,2015-12-20,PHO,MIL,2016,103.5
9343,9343,43,@,L 95-102 ,240,29,83,0.349,17,42,0.405,12,41,0.293,25,31,0.806,95,33,71,0.465,26,43,0.605,7,28,0.25,29,41,0.707,102,2015-12-21,CHA,HOU,2016,105.5
9344,9344,44,@,L 95-101 ,240,39,82,0.476,36,71,0.507,3,11,0.273,14,24,0.583,95,37,72,0.514,32,55,0.582,5,17,0.294,22,28,0.786,101,2015-12-28,MIN,SAS,2016,103.5
9345,9345,45,Home,W 95-91 ,240,28,84,0.333,21,58,0.362,7,26,0.269,32,36,0.889,95,36,86,0.419,31,65,0.477,5,21,0.238,14,19,0.737,91,2015-12-28,UTA,PHI,2016,93.5
9346,9346,46,@,W 95-89 ,240,35,90,0.389,25,56,0.446,10,34,0.294,15,19,0.789,95,36,82,0.439,29,57,0.509,7,25,0.28,10,15,0.667,89,2015-12-31,LAC,NOP,2016,92.5
9347,9347,47,@,W 95-85 ,240,32,75,0.427,24,59,0.407,8,16,0.5,23,28,0.821,95,33,84,0.393,30,70,0.429,3,14,0.214,16,24,0.667,85,2016-01-02,MIL,MIN,2016,86.5
9348,9348,48,@,W 95-86 ,240,32,76,0.421,26,54,0.481,6,22,0.273,25,29,0.862,95,32,79,0.405,26,48,0.542,6,31,0.194,16,17,0.941,86,2016-01-06,IND,ORL,2016,89.0
9349,9349,49,@,L 95-96 ,240,35,84,0.417,21,40,0.525,14,44,0.318,11,16,0.688,95,37,80,0.463,33,71,0.465,4,9,0.444,18,29,0.621,96,2016-01-08,DAL,MIL,2016,98.0
9350,9350,50,Home,L 95-103 ,240,40,92,0.435,34,68,0.5,6,24,0.25,9,13,0.692,95,36,73,0.493,29,55,0.527,7,18,0.389,24,30,0.8,103,2016-01-08,PHO,MIA,2016,106.5
9351,9351,51,Home,L 95-108 ,240,39,80,0.488,28,63,0.444,11,17,0.647,6,14,0.429,95,41,75,0.547,36,58,0.621,5,17,0.294,21,27,0.778,108,2016-01-09,PHI,TOR,2016,110.5
9352,9352,52,Home,W 95-92 ,240,32,77,0.416,20,50,0.4,12,27,0.444,19,23,0.826,95,30,83,0.361,18,47,0.383,12,36,0.333,20,24,0.833,92,2016-01-10,DEN,CHO,2016,98.0
9353,9353,53,@,W 95-85 ,240,35,90,0.389,26,58,0.448,9,32,0.281,16,23,0.696,95,35,77,0.455,29,59,0.492,6,18,0.333,9,19,0.474,85,2016-01-10,CLE,PHI,2016,88.0
9354,9354,54,Home,W 95-91 ,240,32,87,0.368,26,58,0.448,6,29,0.207,25,32,0.781,95,38,91,0.418,32,68,0.471,6,23,0.261,9,14,0.643,91,2016-01-12,LAL,NOP,2016,94.0
9355,9355,55,@,L 95-99 ,240,38,82,0.463,28,56,0.5,10,26,0.385,9,11,0.818,95,38,83,0.458,33,66,0.5,5,17,0.294,18,22,0.818,99,2016-01-14,CLE,SAS,2016,101.5
9356,9356,56,Home,L 95-98 ,240,32,78,0.41,26,60,0.433,6,18,0.333,25,26,0.962,95,40,81,0.494,36,69,0.522,4,12,0.333,14,19,0.737,98,2016-01-15,DEN,MIA,2016,100.0
9357,9357,57,@,L 95-113 ,240,34,94,0.362,24,69,0.348,10,25,0.4,17,23,0.739,95,47,101,0.465,39,78,0.5,8,23,0.348,11,20,0.55,113,2016-01-16,GSW,DET,2016,117.0
9358,9358,58,@,L 95-103 ,240,35,77,0.455,30,57,0.526,5,20,0.25,20,24,0.833,95,39,82,0.476,34,72,0.472,5,10,0.5,20,26,0.769,103,2016-01-16,NYK,MEM,2016,105.5
9359,9359,59,Home,L 95-112 ,240,37,82,0.451,31,63,0.492,6,19,0.316,15,19,0.789,95,44,91,0.484,38,70,0.543,6,21,0.286,18,24,0.75,112,2016-01-17,LAL,HOU,2016,115.0
9360,9360,60,@,L 95-109 ,240,34,81,0.42,25,54,0.463,9,27,0.333,18,21,0.857,95,39,83,0.47,30,59,0.508,9,24,0.375,22,30,0.733,109,2016-01-20,CHA,OKC,2016,113.5
9361,9361,61,Home,L 95-108 ,240,38,84,0.452,32,68,0.471,6,16,0.375,13,18,0.722,95,43,85,0.506,32,64,0.5,11,21,0.524,11,13,0.846,108,2016-01-22,LAL,SAS,2016,113.5
9362,9362,62,@,L 95-98 ,240,34,84,0.405,22,50,0.44,12,34,0.353,15,18,0.833,95,34,85,0.4,24,61,0.393,10,24,0.417,20,26,0.769,98,2016-01-23,ATL,PHO,2016,103.0
9363,9363,63,@,W 95-92 ,240,34,75,0.453,23,53,0.434,11,22,0.5,16,33,0.485,95,34,85,0.4,25,56,0.446,9,29,0.31,15,18,0.833,92,2016-01-25,DET,UTA,2016,96.5
9364,9364,64,Home,L 95-116 ,240,33,90,0.367,27,72,0.375,6,18,0.333,23,26,0.885,95,42,73,0.575,26,44,0.591,16,29,0.552,16,23,0.696,116,2016-01-31,NYK,GSW,2016,124.0
9365,9365,65,Home,L 95-110 ,240,36,88,0.409,26,62,0.419,10,26,0.385,13,21,0.619,95,43,71,0.606,34,55,0.618,9,16,0.563,15,18,0.833,110,2016-02-01,NOP,MEM,2016,114.5
9366,9366,66,@,L 95-107 ,240,38,86,0.442,33,72,0.458,5,14,0.357,14,24,0.583,95,39,85,0.459,28,54,0.519,11,31,0.355,18,25,0.72,107,2016-02-02,MIL,POR,2016,112.5
9367,9367,67,@,L 95-102 ,240,32,85,0.376,21,51,0.412,11,34,0.324,20,28,0.714,95,42,96,0.438,35,75,0.467,7,21,0.333,11,13,0.846,102,2016-02-03,DET,BOS,2016,105.5
9368,9368,68,Home,L 95-98 ,240,36,81,0.444,26,55,0.473,10,26,0.385,13,15,0.867,95,43,94,0.457,43,85,0.506,0,9,0.0,12,18,0.667,98,2016-02-05,CHA,MIA,2016,98.0
9369,9369,69,Home,L 95-117 ,240,40,92,0.435,36,74,0.486,4,18,0.222,11,15,0.733,95,45,87,0.517,33,59,0.559,12,28,0.429,15,19,0.789,117,2016-02-10,IND,CHO,2016,123.0
9370,9370,70,@,L 95-121 ,240,38,88,0.432,35,72,0.486,3,16,0.188,16,24,0.667,95,45,86,0.523,33,54,0.611,12,32,0.375,19,23,0.826,121,2016-02-11,NOP,OKC,2016,127.0
9371,9371,71,@,L 95-106 ,240,37,93,0.398,29,72,0.403,8,21,0.381,13,22,0.591,95,42,91,0.462,35,67,0.522,7,24,0.292,15,17,0.882,106,2016-02-18,CHI,CLE,2016,109.5
9372,9372,72,Home,L 95-98 ,240,36,81,0.444,29,62,0.468,7,19,0.368,16,21,0.762,95,37,86,0.43,28,55,0.509,9,31,0.29,15,18,0.833,98,2016-02-19,MIL,CHO,2016,102.5
9373,9373,73,Home,L 95-103 ,240,36,84,0.429,31,72,0.431,5,12,0.417,18,25,0.72,95,42,83,0.506,37,66,0.561,5,17,0.294,14,16,0.875,103,2016-02-20,MIN,NYK,2016,105.5
9374,9374,74,Home,L 95-122 ,240,37,84,0.44,31,64,0.484,6,20,0.3,15,23,0.652,95,46,87,0.529,35,62,0.565,11,25,0.44,19,25,0.76,122,2016-02-22,NYK,TOR,2016,127.5
9375,9375,75,Home,L 95-96 ,240,35,85,0.412,31,66,0.47,4,19,0.211,21,24,0.875,95,36,83,0.434,25,55,0.455,11,28,0.393,13,19,0.684,96,2016-02-26,IND,CHO,2016,101.5
9376,9376,76,Home,L 95-112 ,240,32,78,0.41,27,55,0.491,5,23,0.217,26,39,0.667,95,43,85,0.506,30,53,0.566,13,32,0.406,13,15,0.867,112,2016-02-26,LAL,MEM,2016,118.5
9377,9377,77,@,L 95-108 ,240,39,93,0.419,33,66,0.5,6,27,0.222,11,16,0.688,95,37,80,0.463,33,64,0.516,4,16,0.25,30,36,0.833,108,2016-02-26,ORL,NYK,2016,110.0
9378,9378,78,Home,L 95-103 ,240,39,94,0.415,32,72,0.444,7,22,0.318,10,12,0.833,95,38,87,0.437,33,66,0.5,5,21,0.238,22,27,0.815,103,2016-02-27,CHI,POR,2016,105.5
9379,9379,79,@,L 95-100 ,240,38,101,0.376,31,77,0.403,7,24,0.292,12,17,0.706,95,37,84,0.44,31,66,0.47,6,18,0.333,20,29,0.69,100,2016-02-29,UTA,BOS,2016,103.0
9380,9380,80,@,L 95-105 ,240,32,77,0.416,24,58,0.414,8,19,0.421,23,33,0.697,95,41,83,0.494,32,60,0.533,9,23,0.391,14,16,0.875,105,2016-02-29,BRK,LAC,2016,109.5
9381,9381,81,@,L 95-100 ,240,36,90,0.4,22,53,0.415,14,37,0.378,9,13,0.692,95,36,81,0.444,33,46,0.717,3,35,0.086,25,38,0.658,100,2016-03-02,NOP,HOU,2016,101.5
9382,9382,82,@,L 95-112 ,240,37,92,0.402,33,62,0.532,4,30,0.133,17,21,0.81,95,41,87,0.471,32,62,0.516,9,25,0.36,21,22,0.955,112,2016-03-06,GSW,LAL,2016,116.5
9383,9383,83,Home,W 95-89 ,240,38,84,0.452,29,56,0.518,9,28,0.321,10,15,0.667,95,33,87,0.379,28,70,0.4,5,17,0.294,18,22,0.818,89,2016-03-11,PHI,BRK,2016,91.5
9384,9384,84,Home,W 95-83 ,240,36,84,0.429,25,50,0.5,11,34,0.324,12,17,0.706,95,33,95,0.347,27,72,0.375,6,23,0.261,11,14,0.786,83,2016-03-12,ATL,MEM,2016,86.0
9385,9385,85,@,W 95-90 ,240,32,89,0.36,24,59,0.407,8,30,0.267,23,26,0.885,95,31,86,0.36,25,63,0.397,6,23,0.261,22,26,0.846,90,2016-03-18,PHO,LAL,2016,93.0
9386,9386,86,@,L 95-104 ,240,39,89,0.438,29,51,0.569,10,38,0.263,7,9,0.778,95,41,89,0.461,33,67,0.493,8,22,0.364,14,19,0.737,104,2016-03-24,CLE,BRK,2016,108.0
9387,9387,87,Home,L 95-112 ,240,34,88,0.386,27,59,0.458,7,29,0.241,20,28,0.714,95,43,95,0.453,30,61,0.492,13,34,0.382,13,14,0.929,112,2016-03-26,DET,ATL,2016,118.5
9388,9388,88,@,L 95-101 ,240,36,83,0.434,26,56,0.464,10,27,0.37,13,17,0.765,95,40,90,0.444,27,61,0.443,13,29,0.448,8,9,0.889,101,2016-03-31,DEN,NOP,2016,107.5
9389,9389,89,Home,L 95-99 ,240,37,91,0.407,30,72,0.417,7,19,0.368,14,17,0.824,95,30,71,0.423,18,43,0.419,12,28,0.429,27,29,0.931,99,2016-04-01,MEM,TOR,2016,105.0
9390,9390,90,@,L 95-102 ,240,40,80,0.5,34,62,0.548,6,18,0.333,9,10,0.9,95,35,77,0.455,30,57,0.526,5,20,0.25,27,30,0.9,102,2016-04-02,TOR,SAS,2016,104.5
9391,9391,91,Home,W 95-87 ,240,33,76,0.434,21,44,0.477,12,32,0.375,17,21,0.81,95,32,84,0.381,24,63,0.381,8,21,0.381,15,20,0.75,87,2016-04-07,ATL,TOR,2016,91.0
9392,9392,92,@,L 95-106 ,240,36,75,0.48,26,52,0.5,10,23,0.435,13,19,0.684,95,33,79,0.418,22,49,0.449,11,30,0.367,29,47,0.617,106,2016-10-31,SAC,ATL,2017,111.5
9393,9393,93,Home,L 95-99 ,240,35,87,0.402,26,51,0.51,9,36,0.25,16,21,0.762,95,36,86,0.419,26,56,0.464,10,30,0.333,17,24,0.708,99,2016-11-04,BRK,CHO,2017,104.0
9394,9394,94,Home,L 95-105 ,240,34,83,0.41,24,55,0.436,10,28,0.357,17,20,0.85,95,36,80,0.45,24,49,0.49,12,31,0.387,21,26,0.808,105,2016-11-04,DAL,POR,2017,111.0
9395,9395,95,Home,W 95-92 ,240,31,80,0.388,26,60,0.433,5,20,0.25,28,35,0.8,95,32,83,0.386,27,58,0.466,5,25,0.2,23,36,0.639,92,2016-11-04,WAS,ATL,2017,94.5
9396,9396,96,@,L 95-116 ,240,34,86,0.395,28,58,0.483,6,28,0.214,21,28,0.75,95,43,74,0.581,26,41,0.634,17,33,0.515,13,22,0.591,116,2016-11-09,DAL,GSW,2017,124.5
9397,9397,97,Home,L 95-98 ,240,36,88,0.409,23,59,0.39,13,29,0.448,10,15,0.667,95,37,89,0.416,31,73,0.425,6,16,0.375,18,20,0.9,98,2016-11-10,MIA,CHI,2017,101.0
9398,9398,98,@,L 95-106 ,240,38,91,0.418,34,78,0.436,4,13,0.308,15,18,0.833,95,39,97,0.402,34,82,0.415,5,15,0.333,23,25,0.92,106,2016-11-12,WAS,CHI,2017,108.5
9399,9399,99,Home,L 95-106 ,240,36,84,0.429,27,59,0.458,9,25,0.36,14,19,0.737,95,46,90,0.511,42,72,0.583,4,18,0.222,10,14,0.714,106,2016-11-12,DEN,DET,2017,108.0
9400,9400,0,@,L 95-127 ,240,34,77,0.442,24,44,0.545,10,33,0.303,17,22,0.773,95,48,90,0.533,34,65,0.523,14,25,0.56,17,21,0.81,127,2016-11-14,BRK,LAC,2017,134.0
9401,9401,1,@,L 95-102 ,240,33,77,0.429,24,47,0.511,9,30,0.3,20,24,0.833,95,36,77,0.468,25,50,0.5,11,27,0.407,19,23,0.826,102,2016-11-19,CHI,LAC,2017,107.5
9402,9402,2,Home,W 95-87 ,240,34,78,0.436,26,57,0.456,8,21,0.381,19,22,0.864,95,26,77,0.338,13,49,0.265,13,28,0.464,22,27,0.815,87,2016-11-19,ORL,DAL,2017,93.5
9403,9403,3,Home,W 95-68 ,240,35,80,0.438,25,46,0.543,10,34,0.294,15,18,0.833,95,26,83,0.313,18,58,0.31,8,25,0.32,8,12,0.667,68,2016-11-25,UTA,ATL,2017,72.0
9404,9404,4,@,L 95-122 ,240,36,86,0.419,22,52,0.423,14,34,0.412,9,13,0.692,95,42,77,0.545,29,58,0.5,13,19,0.684,25,31,0.806,122,2016-11-28,PHI,TOR,2017,128.5
9405,9405,5,@,L 95-101 (OT),265,38,93,0.409,35,72,0.486,3,21,0.143,16,26,0.615,95,35,85,0.412,25,60,0.417,10,25,0.4,21,26,0.808,101,2016-11-28,SAC,WAS,2017,106.0
9406,9406,6,@,W 95-83 ,240,39,86,0.453,33,71,0.465,6,15,0.4,11,12,0.917,95,28,76,0.368,23,56,0.411,5,20,0.25,22,26,0.846,83,2016-11-29,ORL,SAS,2017,85.5
9407,9407,7,Home,W 95-94 ,240,33,79,0.418,26,61,0.426,7,18,0.389,22,28,0.786,95,33,74,0.446,27,50,0.54,6,24,0.25,22,31,0.71,94,2016-12-01,MEM,ORL,2017,97.0
9408,9408,8,@,L 95-103 ,240,34,80,0.425,23,53,0.434,11,27,0.407,16,20,0.8,95,43,88,0.489,39,69,0.565,4,19,0.211,13,15,0.867,103,2016-12-07,MIA,ATL,2017,105.0
9409,9409,9,@,L 95-134 ,240,34,87,0.391,29,67,0.433,5,20,0.25,22,27,0.815,95,51,94,0.543,36,58,0.621,15,36,0.417,17,21,0.81,134,2016-12-07,LAL,HOU,2017,141.5
9410,9410,10,Home,W 95-91 ,240,35,80,0.438,31,63,0.492,4,17,0.235,21,27,0.778,95,39,97,0.402,30,69,0.435,9,28,0.321,4,5,0.8,91,2016-12-08,CHI,SAS,2017,95.5
9411,9411,11,@,L 95-114 ,240,33,87,0.379,25,60,0.417,8,27,0.296,21,28,0.75,95,43,80,0.538,35,57,0.614,8,23,0.348,20,27,0.741,114,2016-12-13,OKC,POR,2017,118.0
9412,9412,12,@,W 95-85 ,240,36,71,0.507,31,54,0.574,5,17,0.294,18,22,0.818,95,32,78,0.41,24,53,0.453,8,25,0.32,13,16,0.813,85,2016-12-14,DET,DAL,2017,89.0
9413,9413,13,Home,W 95-89 ,240,37,82,0.451,30,57,0.526,7,25,0.28,14,25,0.56,95,33,89,0.371,24,62,0.387,9,27,0.333,14,17,0.824,89,2016-12-14,MIA,IND,2017,93.5
9414,9414,14,@,L 95-102 ,240,36,87,0.414,33,66,0.5,3,21,0.143,20,24,0.833,95,36,86,0.419,26,59,0.441,10,27,0.37,20,28,0.714,102,2016-12-15,IND,NOP,2017,107.0
9415,9415,15,@,W 95-69 ,240,38,82,0.463,28,57,0.491,10,25,0.4,9,13,0.692,95,28,92,0.304,23,71,0.324,5,21,0.238,8,15,0.533,69,2016-12-16,MIL,CHI,2017,71.5
9416,9416,16,Home,L 95-105 ,240,36,69,0.522,27,45,0.6,9,24,0.375,14,25,0.56,95,41,90,0.456,32,62,0.516,9,28,0.321,14,19,0.737,105,2016-12-18,MIA,BOS,2017,109.5
9417,9417,17,Home,L 95-96 ,240,32,72,0.444,22,45,0.489,10,27,0.37,21,28,0.75,95,35,83,0.422,28,52,0.538,7,31,0.226,19,23,0.826,96,2016-12-21,POR,DAL,2017,99.5
9418,9418,18,@,L 95-106 ,240,39,90,0.433,34,63,0.54,5,27,0.185,12,16,0.75,95,41,96,0.427,32,76,0.421,9,20,0.45,15,17,0.882,106,2016-12-22,ORL,NYK,2017,110.5
9419,9419,19,@,W 95-91 ,240,32,95,0.337,20,61,0.328,12,34,0.353,19,24,0.792,95,35,83,0.422,27,60,0.45,8,23,0.348,13,18,0.722,91,2016-12-26,TOR,POR,2017,95.0
9420,9420,20,@,L 95-118 ,240,32,74,0.432,22,49,0.449,10,25,0.4,21,25,0.84,95,47,83,0.566,36,61,0.59,11,22,0.5,13,14,0.929,118,2016-12-30,BRK,WAS,2017,123.5
9421,9421,21,@,W 95-89 ,240,36,73,0.493,30,51,0.588,6,22,0.273,17,28,0.607,95,35,87,0.402,28,64,0.438,7,23,0.304,12,18,0.667,89,2017-01-01,POR,MIN,2017,92.5
9422,9422,22,Home,L 95-102 ,240,36,79,0.456,27,50,0.54,9,29,0.31,14,17,0.824,95,38,85,0.447,31,68,0.456,7,17,0.412,19,22,0.864,102,2017-01-05,DAL,PHO,2017,105.5
9423,9423,23,Home,L 95-105 ,240,36,78,0.462,26,51,0.51,10,27,0.37,13,17,0.765,95,37,94,0.394,29,67,0.433,8,27,0.296,23,27,0.852,105,2017-01-08,BRK,PHI,2017,109.0
9424,9424,24,@,L 95-111 ,240,34,90,0.378,27,64,0.422,7,26,0.269,20,29,0.69,95,42,87,0.483,34,55,0.618,8,32,0.25,19,24,0.792,111,2017-01-08,ORL,LAL,2017,115.0
9425,9425,25,@,L 95-107 ,240,38,90,0.422,32,60,0.533,6,30,0.2,13,17,0.765,95,39,86,0.453,28,59,0.475,11,27,0.407,18,22,0.818,107,2017-01-10,MIA,GSW,2017,112.5
9426,9426,26,@,L 95-103 ,240,38,92,0.413,31,68,0.456,7,24,0.292,12,21,0.571,95,36,81,0.444,28,55,0.509,8,26,0.308,23,29,0.793,103,2017-01-11,MEM,OKC,2017,107.0
9427,9427,27,Home,L 95-104 ,240,40,97,0.412,31,55,0.564,9,42,0.214,6,11,0.545,95,38,90,0.422,27,58,0.466,11,32,0.344,17,25,0.68,104,2017-01-12,BRK,NOP,2017,109.5
9428,9428,28,@,L 95-98 ,240,36,83,0.434,26,58,0.448,10,25,0.4,13,18,0.722,95,41,81,0.506,36,62,0.581,5,19,0.263,11,16,0.688,98,2017-01-16,NOP,IND,2017,100.5
9429,9429,29,@,L 95-118 ,240,30,78,0.385,24,53,0.453,6,25,0.24,29,37,0.784,95,45,91,0.495,35,66,0.53,10,25,0.4,18,28,0.643,118,2017-01-18,ATL,DET,2017,123.0
9430,9430,30,@,L 95-99 ,240,37,82,0.451,23,46,0.5,14,36,0.389,7,11,0.636,95,35,73,0.479,26,53,0.491,9,20,0.45,20,29,0.69,99,2017-01-19,DAL,MIA,2017,103.5
9431,9431,31,@,L 95-108 ,240,34,80,0.425,25,57,0.439,9,23,0.391,18,25,0.72,95,41,87,0.471,27,54,0.5,14,33,0.424,12,15,0.8,108,2017-01-20,IND,LAL,2017,115.0
9432,9432,32,Home,L 95-119 ,240,33,89,0.371,24,55,0.436,9,34,0.265,20,28,0.714,95,41,80,0.513,25,38,0.658,16,42,0.381,21,25,0.84,119,2017-01-21,MEM,HOU,2017,127.0
9433,9433,33,Home,L 95-97 ,240,36,84,0.429,31,63,0.492,5,21,0.238,18,26,0.692,95,36,83,0.434,30,63,0.476,6,20,0.3,19,25,0.76,97,2017-01-23,UTA,OKC,2017,100.0
9434,9434,34,@,L 95-103 ,240,39,92,0.424,32,69,0.464,7,23,0.304,10,12,0.833,95,39,83,0.47,33,57,0.579,6,26,0.231,19,24,0.792,103,2017-01-25,NYK,DAL,2017,106.0
9435,9435,35,Home,L 95-102 ,240,29,62,0.468,19,37,0.514,10,25,0.4,27,29,0.931,95,41,80,0.513,30,54,0.556,11,26,0.423,9,10,0.9,102,2017-01-28,UTA,MEM,2017,107.5
9436,9436,36,@,W 95-90 ,240,35,99,0.354,29,72,0.403,6,27,0.222,19,31,0.613,95,37,88,0.42,32,63,0.508,5,25,0.2,11,16,0.688,90,2017-02-01,NYK,BRK,2017,92.5
9437,9437,37,@,L 95-113 ,240,35,77,0.455,29,55,0.527,6,22,0.273,19,26,0.731,95,40,86,0.465,30,60,0.5,10,26,0.385,23,28,0.821,113,2017-02-01,PHI,DAL,2017,118.0
9438,9438,38,Home,L 95-103 ,240,32,76,0.421,19,42,0.452,13,34,0.382,18,21,0.857,95,40,87,0.46,35,68,0.515,5,19,0.263,18,20,0.9,103,2017-02-05,BRK,TOR,2017,105.5
9439,9439,39,Home,L 95-120 ,240,33,74,0.446,27,57,0.474,6,17,0.353,23,32,0.719,95,49,80,0.613,39,54,0.722,10,26,0.385,12,18,0.667,120,2017-02-06,ATL,UTA,2017,125.0
9440,9440,40,Home,L 95-107 ,240,37,85,0.435,29,59,0.492,8,26,0.308,13,14,0.929,95,39,87,0.448,26,47,0.553,13,40,0.325,16,20,0.8,107,2017-02-09,CHA,HOU,2017,113.5
9441,9441,41,@,W 95-91 ,240,37,75,0.493,29,57,0.509,8,18,0.444,13,22,0.591,95,33,89,0.371,27,56,0.482,6,33,0.182,19,25,0.76,91,2017-02-15,NOP,MEM,2017,94.0
9442,9442,42,Home,L 95-109 ,240,32,74,0.432,25,56,0.446,7,18,0.389,24,29,0.828,95,37,74,0.5,29,51,0.569,8,23,0.348,27,30,0.9,109,2017-02-24,MIL,UTA,2017,113.0
9443,9443,43,@,L 95-112 ,240,38,94,0.404,30,66,0.455,8,28,0.286,11,17,0.647,95,42,100,0.42,31,69,0.449,11,31,0.355,17,22,0.773,112,2017-02-25,BRK,GSW,2017,117.5
9444,9444,44,@,L 95-113 ,240,34,85,0.4,30,73,0.411,4,12,0.333,23,26,0.885,95,38,78,0.487,25,47,0.532,13,31,0.419,24,31,0.774,113,2017-02-25,IND,MIA,2017,119.5
9445,9445,45,@,L 95-102 ,240,37,83,0.446,26,53,0.491,11,30,0.367,10,16,0.625,95,35,70,0.5,25,42,0.595,10,28,0.357,22,26,0.846,102,2017-02-27,MIL,CLE,2017,107.0
9446,9446,46,@,L 95-100 ,240,35,77,0.455,21,44,0.477,14,33,0.424,11,13,0.846,95,36,64,0.563,26,43,0.605,10,21,0.476,18,24,0.75,100,2017-03-01,DAL,ATL,2017,105.0
9447,9447,47,Home,L 95-115 ,240,37,87,0.425,31,63,0.492,6,24,0.25,15,20,0.75,95,43,84,0.512,33,51,0.647,10,33,0.303,19,25,0.76,115,2017-03-03,LAL,BOS,2017,120.0
9448,9448,48,@,L 95-109 ,240,34,83,0.41,26,55,0.473,8,28,0.286,19,21,0.905,95,45,92,0.489,39,71,0.549,6,21,0.286,13,20,0.65,109,2017-03-06,CHI,DET,2017,112.0
9449,9449,49,Home,L 94-105 ,240,31,82,0.378,22,54,0.407,9,28,0.321,23,30,0.767,94,38,78,0.487,34,71,0.479,4,7,0.571,25,36,0.694,105,2011-12-25,DAL,MIA,2012,107.0
9450,9450,50,Home,W 94-78 ,240,36,81,0.444,27,60,0.45,9,21,0.429,13,25,0.52,94,29,77,0.377,23,60,0.383,6,17,0.353,14,21,0.667,78,2011-12-29,ORL,NJN,2012,81.0
9451,9451,51,@,W 94-86 ,240,37,74,0.5,32,62,0.516,5,12,0.417,15,23,0.652,94,32,78,0.41,30,62,0.484,2,16,0.125,20,23,0.87,86,2012-01-01,BOS,WAS,2012,87.0
9452,9452,52,Home,L 94-108 ,240,33,89,0.371,26,61,0.426,7,28,0.25,21,26,0.808,94,41,78,0.526,28,57,0.491,13,21,0.619,13,18,0.722,108,2012-01-02,BRK,IND,2012,114.5
9453,9453,53,Home,W 94-90 ,240,37,76,0.487,32,61,0.525,5,15,0.333,15,23,0.652,94,37,74,0.5,34,64,0.531,3,10,0.3,13,16,0.813,90,2012-01-02,UTA,NOH,2012,91.5
9454,9454,54,@,L 94-109 ,240,36,78,0.462,33,65,0.508,3,13,0.231,19,27,0.704,94,42,80,0.525,36,66,0.545,6,14,0.429,19,25,0.76,109,2012-01-06,HOU,OKC,2012,112.0
9455,9455,55,Home,W 94-85 ,240,36,71,0.507,34,63,0.54,2,8,0.25,20,30,0.667,94,33,80,0.413,29,63,0.46,4,17,0.235,15,21,0.714,85,2012-01-06,UTA,MEM,2012,87.0
9456,9456,56,@,L 94-109 ,240,36,82,0.439,30,68,0.441,6,14,0.429,16,20,0.8,94,47,83,0.566,38,71,0.535,9,12,0.75,6,6,1.0,109,2012-01-07,CHI,ATL,2012,113.5
9457,9457,57,@,W 94-81 ,240,39,75,0.52,33,65,0.508,6,10,0.6,10,14,0.714,94,29,71,0.408,21,48,0.438,8,23,0.348,15,21,0.714,81,2012-01-09,NOP,DEN,2012,85.0
9458,9458,58,Home,W 94-83 ,240,34,75,0.453,28,63,0.444,6,12,0.5,20,30,0.667,94,31,83,0.373,20,57,0.351,11,26,0.423,10,11,0.909,83,2012-01-12,MEM,NYK,2012,88.5
9459,9459,59,@,L 94-102 ,240,35,77,0.455,30,65,0.462,5,12,0.417,19,25,0.76,94,35,85,0.412,26,64,0.406,9,21,0.429,23,30,0.767,102,2012-01-14,LAL,LAC,2012,106.5
9460,9460,60,@,L 94-107 ,240,32,74,0.432,23,47,0.489,9,27,0.333,21,27,0.778,94,42,81,0.519,39,73,0.534,3,8,0.375,20,26,0.769,107,2012-01-14,BRK,UTA,2012,108.5
9461,9461,61,Home,L 94-102 ,240,38,86,0.442,34,69,0.493,4,17,0.235,14,26,0.538,94,39,80,0.488,35,65,0.538,4,15,0.267,20,29,0.69,102,2012-01-16,CHA,CLE,2012,104.0
9462,9462,62,Home,W 94-82 ,240,37,84,0.44,26,61,0.426,11,23,0.478,9,13,0.692,94,35,75,0.467,32,61,0.525,3,14,0.214,9,14,0.643,82,2012-01-16,PHI,MIL,2012,83.5
9463,9463,63,@,W 94-91 ,240,37,71,0.521,32,51,0.627,5,20,0.25,15,19,0.789,94,31,80,0.388,28,68,0.412,3,12,0.25,26,29,0.897,91,2012-01-19,DAL,UTA,2012,92.5
9464,9464,64,@,W 94-91 ,240,35,83,0.422,27,67,0.403,8,16,0.5,16,21,0.762,94,37,80,0.463,27,57,0.474,10,23,0.435,7,8,0.875,91,2012-01-20,IND,GSW,2012,96.0
9465,9465,65,@,W 94-84 ,240,33,82,0.402,28,67,0.418,5,15,0.333,23,31,0.742,94,30,82,0.366,25,67,0.373,5,15,0.333,19,25,0.76,84,2012-01-20,POR,TOR,2012,86.5
9466,9466,66,@,L 94-121 ,240,34,70,0.486,27,50,0.54,7,20,0.35,19,27,0.704,94,46,83,0.554,35,59,0.593,11,24,0.458,18,24,0.75,121,2012-01-21,CLE,ATL,2012,126.5
9467,9467,67,Home,W 94-91 ,240,30,67,0.448,23,52,0.442,7,15,0.467,27,32,0.844,94,34,81,0.42,31,61,0.508,3,20,0.15,20,24,0.833,91,2012-01-21,DET,POR,2012,92.5
9468,9468,68,Home,L 94-100 ,240,37,77,0.481,35,62,0.565,2,15,0.133,18,21,0.857,94,37,72,0.514,32,60,0.533,5,12,0.417,21,30,0.7,100,2012-01-22,WAS,BOS,2012,102.5
9469,9469,69,Home,W 94-87 ,240,38,83,0.458,32,69,0.464,6,14,0.429,12,14,0.857,94,28,80,0.35,27,61,0.443,1,19,0.053,30,31,0.968,87,2012-01-27,BOS,IND,2012,87.5
9470,9470,70,@,W 94-73 ,240,35,68,0.515,32,54,0.593,3,14,0.214,21,29,0.724,94,27,74,0.365,20,52,0.385,7,22,0.318,12,18,0.667,73,2012-01-29,TOR,NJN,2012,76.5
9471,9471,71,@,W 94-72 ,240,36,81,0.444,24,58,0.414,12,23,0.522,10,17,0.588,94,27,73,0.37,24,63,0.381,3,10,0.3,15,19,0.789,72,2012-01-29,ATL,NOH,2012,73.5
9472,9472,72,@,L 94-101 ,240,37,87,0.425,33,74,0.446,4,13,0.308,16,20,0.8,94,34,71,0.479,27,54,0.5,7,17,0.412,26,33,0.788,101,2012-02-03,MEM,OKC,2012,104.5
9473,9473,73,@,L 94-102 ,240,33,90,0.367,26,72,0.361,7,18,0.389,21,27,0.778,94,34,80,0.425,25,54,0.463,9,26,0.346,25,36,0.694,102,2012-02-03,CLE,ORL,2012,106.5
9474,9474,74,Home,W 94-84 ,240,41,81,0.506,37,58,0.638,4,23,0.174,8,8,1.0,94,32,71,0.451,28,55,0.509,4,16,0.25,16,20,0.8,84,2012-02-07,BOS,CHA,2012,86.0
9475,9475,75,@,W 94-86 ,240,35,68,0.515,31,51,0.608,4,17,0.235,20,25,0.8,94,33,75,0.44,30,59,0.508,3,16,0.188,17,25,0.68,86,2012-02-10,POR,NOH,2012,87.5
9476,9476,76,@,L 94-97 (2OT),290,36,97,0.371,33,77,0.429,3,20,0.15,19,21,0.905,94,39,84,0.464,33,65,0.508,6,19,0.316,13,19,0.684,97,2012-02-11,POR,DAL,2012,100.0
9477,9477,77,Home,L 94-99 ,240,39,93,0.419,30,71,0.423,9,22,0.409,7,7,1.0,94,35,81,0.432,20,44,0.455,15,37,0.405,14,21,0.667,99,2012-02-11,MIL,ORL,2012,106.5
9478,9478,78,@,W 94-92 ,240,35,81,0.432,25,58,0.431,10,23,0.435,14,20,0.7,94,37,78,0.474,31,67,0.463,6,11,0.545,12,17,0.706,92,2012-02-12,LAL,TOR,2012,95.0
9479,9479,79,Home,W 94-85 ,240,33,76,0.434,24,47,0.511,9,29,0.31,19,26,0.731,94,33,90,0.367,27,69,0.391,6,21,0.286,13,17,0.765,85,2012-02-17,ORL,MIL,2012,88.0
9480,9480,80,@,L 94-109 ,240,36,82,0.439,33,73,0.452,3,9,0.333,19,29,0.655,94,42,84,0.5,41,74,0.554,1,10,0.1,24,32,0.75,109,2012-02-29,CHA,DET,2012,109.5
9481,9481,81,@,L 94-99 ,240,32,85,0.376,26,67,0.388,6,18,0.333,24,28,0.857,94,39,86,0.453,31,63,0.492,8,23,0.348,13,15,0.867,99,2012-03-02,MIL,ATL,2012,103.0
9482,9482,82,@,L 94-107 ,240,34,76,0.447,29,57,0.509,5,19,0.263,21,28,0.75,94,45,87,0.517,41,71,0.577,4,16,0.25,13,17,0.765,107,2012-03-02,BRK,BOS,2012,109.0
9483,9483,83,Home,L 94-99 ,240,32,72,0.444,22,45,0.489,10,27,0.37,20,27,0.741,94,36,86,0.419,30,69,0.435,6,17,0.353,21,28,0.75,99,2012-03-04,SAS,DEN,2012,102.0
9484,9484,84,@,L 94-95 ,240,34,84,0.405,29,61,0.475,5,23,0.217,21,32,0.656,94,32,80,0.4,21,52,0.404,11,28,0.393,20,27,0.741,95,2012-03-05,LAC,MIN,2012,100.5
9485,9485,85,@,L 94-106 ,240,44,93,0.473,41,70,0.586,3,23,0.13,3,4,0.75,94,37,78,0.474,24,55,0.436,13,23,0.565,19,26,0.731,106,2012-03-07,POR,MIN,2012,112.5
9486,9486,86,Home,L 94-99 ,240,35,86,0.407,30,64,0.469,5,22,0.227,19,26,0.731,94,32,76,0.421,21,50,0.42,11,26,0.423,24,31,0.774,99,2012-03-08,CHI,ORL,2012,104.5
9487,9487,87,@,L 94-96 ,240,38,87,0.437,30,65,0.462,8,22,0.364,10,13,0.769,94,37,76,0.487,34,62,0.548,3,14,0.214,19,27,0.704,96,2012-03-08,DAL,PHO,2012,97.5
9488,9488,88,@,W 94-91 ,240,37,73,0.507,32,58,0.552,5,15,0.333,15,23,0.652,94,32,79,0.405,28,70,0.4,4,9,0.444,23,30,0.767,91,2012-03-11,MEM,DEN,2012,93.0
9489,9489,89,@,L 94-97 ,240,39,83,0.47,33,66,0.5,6,17,0.353,10,12,0.833,94,36,71,0.507,28,55,0.509,8,16,0.5,17,26,0.654,97,2012-03-11,BOS,LAL,2012,101.0
9490,9490,90,Home,L 94-106 ,240,33,80,0.413,26,63,0.413,7,17,0.412,21,26,0.808,94,40,79,0.506,35,70,0.5,5,9,0.556,21,26,0.808,106,2012-03-11,NYK,PHI,2012,108.5
9491,9491,91,@,L 94-107 ,240,39,82,0.476,38,70,0.543,1,12,0.083,15,18,0.833,94,37,79,0.468,27,52,0.519,10,27,0.37,23,30,0.767,107,2012-03-11,IND,ORL,2012,112.0
9492,9492,92,@,W 94-85 ,240,33,67,0.493,28,54,0.519,5,13,0.385,23,27,0.852,94,31,83,0.373,26,60,0.433,5,23,0.217,18,21,0.857,85,2012-03-12,BOS,LAC,2012,87.5
9493,9493,93,@,L 94-111 ,240,40,76,0.526,34,63,0.54,6,13,0.462,8,10,0.8,94,43,76,0.566,36,59,0.61,7,17,0.412,18,22,0.818,111,2012-03-14,PHI,IND,2012,114.5
9494,9494,94,Home,L 94-102 ,240,36,86,0.419,26,63,0.413,10,23,0.435,12,14,0.857,94,41,81,0.506,33,65,0.508,8,16,0.5,12,13,0.923,102,2012-03-17,BRK,NOH,2012,106.0
9495,9495,95,@,W 94-82 ,240,36,82,0.439,29,66,0.439,7,16,0.438,15,23,0.652,94,35,85,0.412,34,77,0.442,1,8,0.125,11,11,1.0,82,2012-03-21,CHI,TOR,2012,82.5
9496,9496,96,Home,W 94-82 ,240,36,77,0.468,32,62,0.516,4,15,0.267,18,21,0.857,94,32,82,0.39,29,72,0.403,3,10,0.3,15,24,0.625,82,2012-03-28,BOS,UTA,2012,83.5
9497,9497,97,@,W 94-75 ,240,39,83,0.47,28,51,0.549,11,32,0.344,5,12,0.417,94,30,77,0.39,25,54,0.463,5,23,0.217,10,17,0.588,75,2012-04-02,LAC,DAL,2012,77.5
9498,9498,98,@,W 94-88 ,240,34,87,0.391,30,71,0.423,4,16,0.25,22,24,0.917,94,33,73,0.452,28,52,0.538,5,21,0.238,17,24,0.708,88,2012-04-02,MEM,OKC,2012,90.5
9499,9499,99,@,L 94-98 ,240,38,82,0.463,31,64,0.484,7,18,0.389,11,16,0.688,94,37,80,0.463,28,63,0.444,9,17,0.529,15,24,0.625,98,2012-04-03,GSW,MEM,2012,102.5
9500,9500,0,Home,L 94-97 ,240,37,87,0.425,28,56,0.5,9,31,0.29,11,16,0.688,94,41,86,0.477,37,70,0.529,4,16,0.25,11,16,0.688,97,2012-04-04,MIN,GSW,2012,99.0
9501,9501,1,Home,W 94-92 ,240,35,67,0.522,30,57,0.526,5,10,0.5,19,27,0.704,94,35,83,0.422,29,63,0.46,6,20,0.3,16,22,0.727,92,2012-04-04,NOP,DEN,2012,95.0
9502,9502,2,@,L 94-99 ,240,33,78,0.423,26,57,0.456,7,21,0.333,21,29,0.724,94,36,68,0.529,32,58,0.552,4,10,0.4,23,39,0.59,99,2012-04-05,WAS,DET,2012,101.0
9503,9503,3,@,L 94-109 ,240,34,82,0.415,27,60,0.45,7,22,0.318,19,28,0.679,94,44,89,0.494,33,62,0.532,11,27,0.407,10,19,0.526,109,2012-04-07,SAC,LAC,2012,114.5
9504,9504,4,Home,W 94-89 ,240,31,80,0.388,22,60,0.367,9,20,0.45,23,27,0.852,94,34,73,0.466,25,52,0.481,9,21,0.429,12,17,0.706,89,2012-04-07,MEM,DAL,2012,93.5
9505,9505,5,@,L 94-116 ,240,34,78,0.436,28,56,0.5,6,22,0.273,20,23,0.87,94,47,94,0.5,35,69,0.507,12,25,0.48,10,11,0.909,116,2012-04-07,POR,MIL,2012,122.0
9506,9506,6,Home,W 94-85 ,240,37,74,0.5,33,61,0.541,4,13,0.308,16,20,0.8,94,34,84,0.405,30,66,0.455,4,18,0.222,13,18,0.722,85,2012-04-09,MEM,LAC,2012,87.0
9507,9507,7,@,W 94-89 ,240,37,80,0.463,27,61,0.443,10,19,0.526,10,13,0.769,94,33,83,0.398,27,62,0.435,6,21,0.286,17,19,0.895,89,2012-04-09,HOU,POR,2012,92.0
9508,9508,8,Home,L 94-97 ,240,35,83,0.422,29,58,0.5,6,25,0.24,18,23,0.783,94,40,83,0.482,31,63,0.492,9,20,0.45,8,10,0.8,97,2012-04-13,POR,DAL,2012,101.5
9509,9509,9,@,W 94-82 ,240,37,81,0.457,32,67,0.478,5,14,0.357,15,22,0.682,94,32,87,0.368,26,65,0.4,6,22,0.273,12,14,0.857,82,2012-04-14,BOS,NJN,2012,85.0
9510,9510,10,@,W 94-82 ,240,39,80,0.488,34,65,0.523,5,15,0.333,11,17,0.647,94,32,79,0.405,29,66,0.439,3,13,0.231,15,20,0.75,82,2012-04-15,BOS,CHA,2012,83.5
9511,9511,11,Home,L 94-100 (OT),265,33,84,0.393,27,69,0.391,6,15,0.4,22,28,0.786,94,39,91,0.429,34,74,0.459,5,17,0.294,17,23,0.739,100,2012-04-15,DET,CHI,2012,102.5
9512,9512,12,@,L 94-104 ,240,37,83,0.446,28,64,0.438,9,19,0.474,11,21,0.524,94,38,81,0.469,35,62,0.565,3,19,0.158,25,26,0.962,104,2012-04-20,GSW,DAL,2012,105.5
9513,9513,13,@,L 94-96 ,240,36,80,0.45,30,55,0.545,6,25,0.24,16,19,0.842,94,35,83,0.422,29,64,0.453,6,19,0.316,20,27,0.741,96,2012-04-26,POR,UTA,2012,99.0
9514,9514,14,Home,W 94-84 ,240,36,79,0.456,29,59,0.492,7,20,0.35,15,22,0.682,94,32,90,0.356,24,58,0.414,8,32,0.25,12,20,0.6,84,2012-10-30,CLE,WAS,2013,88.0
9515,9515,15,@,L 94-113 ,240,32,85,0.376,21,63,0.333,11,22,0.5,19,26,0.731,94,38,89,0.427,32,75,0.427,6,14,0.429,31,42,0.738,113,2012-10-31,DAL,UTA,2013,116.0
9516,9516,16,Home,L 94-104 ,240,36,80,0.45,26,60,0.433,10,20,0.5,12,17,0.706,94,35,77,0.455,29,64,0.453,6,13,0.462,28,34,0.824,104,2012-11-02,GSW,MEM,2013,107.0
9517,9517,17,@,L 94-115 ,240,39,91,0.429,34,72,0.472,5,19,0.263,11,18,0.611,94,45,92,0.489,36,81,0.444,9,11,0.818,16,19,0.842,115,2012-11-04,PHO,ORL,2013,119.5
9518,9518,18,@,L 94-103 ,240,40,90,0.444,35,75,0.467,5,15,0.333,9,13,0.692,94,38,91,0.418,33,77,0.429,5,14,0.357,22,25,0.88,103,2012-11-05,UTA,MEM,2013,105.5
9519,9519,19,Home,W 94-92 ,240,37,81,0.457,33,62,0.532,4,19,0.211,16,23,0.696,94,31,78,0.397,25,57,0.439,6,21,0.286,24,28,0.857,92,2012-11-05,SAC,GSW,2013,95.0
9520,9520,20,@,L 94-100 (OT),265,39,95,0.411,29,66,0.439,10,29,0.345,6,7,0.857,94,34,81,0.42,30,68,0.441,4,13,0.308,28,34,0.824,100,2012-11-07,WAS,BOS,2013,102.0
9521,9521,21,@,L 94-96 ,240,37,84,0.44,32,66,0.485,5,18,0.278,15,17,0.882,94,35,70,0.5,33,61,0.541,2,9,0.222,24,28,0.857,96,2012-11-09,IND,MIN,2013,97.0
9522,9522,22,@,L 94-104 ,240,33,81,0.407,25,53,0.472,8,28,0.286,20,23,0.87,94,35,84,0.417,27,62,0.435,8,22,0.364,26,38,0.684,104,2012-11-09,DAL,NYK,2013,108.0
9523,9523,23,@,L 94-105 ,240,36,87,0.414,30,68,0.441,6,19,0.316,16,22,0.727,94,38,71,0.535,30,51,0.588,8,20,0.4,21,26,0.808,105,2012-11-09,DET,OKC,2013,109.0
9524,9524,24,Home,W 94-81 ,240,38,78,0.487,36,64,0.563,2,14,0.143,16,24,0.667,94,32,87,0.368,28,71,0.394,4,16,0.25,13,17,0.765,81,2012-11-10,UTA,PHO,2013,83.0
9525,9525,25,@,W 94-76 ,240,35,73,0.479,32,66,0.485,3,7,0.429,21,31,0.677,94,25,84,0.298,20,68,0.294,5,16,0.313,21,32,0.656,76,2012-11-14,DET,PHI,2013,78.5
9526,9526,26,@,W 94-87 ,240,31,80,0.388,29,66,0.439,2,14,0.143,30,34,0.882,94,32,85,0.376,28,72,0.389,4,13,0.308,19,28,0.679,87,2012-11-17,MEM,CHA,2013,89.0
9527,9527,27,@,L 94-102 ,240,37,75,0.493,33,59,0.559,4,16,0.25,16,18,0.889,94,39,79,0.494,30,57,0.526,9,22,0.409,15,20,0.75,102,2012-11-18,CHI,POR,2013,106.5
9528,9528,28,Home,L 94-101 ,240,34,89,0.382,24,61,0.393,10,28,0.357,16,25,0.64,94,35,79,0.443,26,58,0.448,9,21,0.429,22,26,0.846,101,2012-11-21,MIN,DEN,2013,105.5
9529,9529,29,Home,W 94-91 ,240,36,90,0.4,24,58,0.414,12,32,0.375,10,15,0.667,94,30,76,0.395,18,52,0.346,12,24,0.5,19,23,0.826,91,2012-11-28,ATL,CHA,2013,97.0
9530,9530,30,@,L 94-106 ,240,38,92,0.413,31,69,0.449,7,23,0.304,11,12,0.917,94,39,75,0.52,35,66,0.53,4,9,0.444,24,33,0.727,106,2012-11-30,UTA,OKC,2013,108.0
9531,9531,31,Home,L 94-102 ,240,37,81,0.457,30,64,0.469,7,17,0.412,13,18,0.722,94,40,92,0.435,32,69,0.464,8,23,0.348,14,16,0.875,102,2012-12-03,GSW,ORL,2013,106.0
9532,9532,32,@,L 94-104 ,240,37,84,0.44,31,65,0.477,6,19,0.316,14,30,0.467,94,41,78,0.526,37,61,0.607,4,17,0.235,18,26,0.692,104,2012-12-05,MIN,BOS,2013,106.0
9533,9533,33,Home,L 94-97 ,240,34,85,0.4,26,64,0.406,8,21,0.381,18,25,0.72,94,37,78,0.474,33,66,0.5,4,12,0.333,19,24,0.792,97,2012-12-06,PHO,DAL,2013,99.0
9534,9534,34,@,L 94-95 (OT),265,35,81,0.432,29,59,0.492,6,22,0.273,18,25,0.72,94,37,99,0.374,35,88,0.398,2,11,0.182,19,26,0.731,95,2012-12-07,BOS,PHI,2013,96.0
9535,9535,35,@,W 94-89 ,240,37,80,0.463,33,69,0.478,4,11,0.364,16,23,0.696,94,35,87,0.402,25,67,0.373,10,20,0.5,9,12,0.75,89,2012-12-11,LAC,CHI,2013,94.0
9536,9536,36,@,L 94-100 ,240,31,75,0.413,24,48,0.5,7,27,0.259,25,40,0.625,94,37,84,0.44,26,57,0.456,11,27,0.407,15,26,0.577,100,2012-12-11,LAL,CLE,2013,105.5
9537,9537,37,Home,L 94-101 ,240,34,81,0.42,29,68,0.426,5,13,0.385,21,31,0.677,94,37,80,0.463,31,63,0.492,6,17,0.353,21,34,0.618,101,2012-12-11,DET,DEN,2013,104.0
9538,9538,38,Home,L 94-100 ,240,35,82,0.427,30,66,0.455,5,16,0.313,19,24,0.792,94,37,85,0.435,28,62,0.452,9,23,0.391,17,25,0.68,100,2012-12-12,CHA,LAC,2013,104.5
9539,9539,39,@,W 94-88 ,240,29,64,0.453,19,45,0.422,10,19,0.526,26,35,0.743,94,37,75,0.493,33,57,0.579,4,18,0.222,10,17,0.588,88,2012-12-12,BRK,TOR,2013,90.0
9540,9540,40,@,L 94-99 ,240,39,94,0.415,32,75,0.427,7,19,0.368,9,10,0.9,94,36,69,0.522,32,59,0.542,4,10,0.4,23,26,0.885,99,2012-12-14,MEM,DEN,2013,101.0
9541,9541,41,@,L 94-95 ,240,36,80,0.45,25,60,0.417,11,20,0.55,11,15,0.733,94,37,80,0.463,26,51,0.51,11,29,0.379,10,12,0.833,95,2012-12-16,NOP,POR,2013,100.5
9542,9542,42,Home,L 94-99 (OT),265,36,94,0.383,31,70,0.443,5,24,0.208,17,20,0.85,94,36,83,0.434,31,67,0.463,5,16,0.313,22,36,0.611,99,2012-12-21,BOS,MIL,2013,101.5
9543,9543,43,@,L 94-99 ,240,39,86,0.453,37,70,0.529,2,16,0.125,14,16,0.875,94,39,76,0.513,35,58,0.603,4,18,0.222,17,23,0.739,99,2012-12-21,NOP,SAS,2013,101.0
9544,9544,44,@,W 94-82 ,240,38,88,0.432,33,71,0.465,5,17,0.294,13,16,0.813,94,31,79,0.392,27,59,0.458,4,20,0.2,16,23,0.696,82,2012-12-22,CLE,MIL,2013,84.0
9545,9545,45,Home,W 94-91 ,240,32,72,0.444,26,46,0.565,6,26,0.231,24,28,0.857,94,34,84,0.405,27,62,0.435,7,22,0.318,16,18,0.889,91,2012-12-23,NYK,MIN,2013,94.5
9546,9546,46,@,L 94-100 ,240,38,89,0.427,29,63,0.46,9,26,0.346,9,16,0.563,94,37,77,0.481,32,56,0.571,5,21,0.238,21,31,0.677,100,2012-12-25,NYK,LAL,2013,102.5
9547,9547,47,Home,L 94-97 ,240,36,79,0.456,25,49,0.51,11,30,0.367,11,13,0.846,94,38,76,0.5,36,64,0.563,2,12,0.167,19,20,0.95,97,2012-12-26,ORL,NOH,2013,98.0
9548,9548,48,@,W 94-83 ,240,33,82,0.402,24,64,0.375,9,18,0.5,19,20,0.95,94,32,83,0.386,28,66,0.424,4,17,0.235,15,22,0.682,83,2012-12-26,GSW,UTA,2013,85.0
9549,9549,49,Home,L 94-102 ,240,36,86,0.419,28,65,0.431,8,21,0.381,14,14,1.0,94,38,78,0.487,25,54,0.463,13,24,0.542,13,16,0.813,102,2012-12-28,CLE,ATL,2013,108.5
9550,9550,50,Home,L 94-124 ,240,33,83,0.398,25,53,0.472,8,30,0.267,20,27,0.741,94,45,94,0.479,32,65,0.492,13,29,0.448,21,23,0.913,124,2012-12-29,HOU,OKC,2013,130.5
9551,9551,51,@,L 94-96 ,240,36,77,0.468,26,54,0.481,10,23,0.435,12,17,0.706,94,39,82,0.476,33,64,0.516,6,18,0.333,12,15,0.8,96,2012-12-30,MIL,DET,2013,99.0
9552,9552,52,Home,L 94-103 ,240,32,79,0.405,22,53,0.415,10,26,0.385,20,26,0.769,94,41,82,0.5,31,60,0.517,10,22,0.455,11,17,0.647,103,2013-01-01,WAS,DAL,2013,108.0
9553,9553,53,Home,L 94-97 ,240,34,87,0.391,29,66,0.439,5,21,0.238,21,24,0.875,94,38,88,0.432,35,72,0.486,3,16,0.188,18,23,0.783,97,2013-01-02,CLE,SAC,2013,98.5
9554,9554,54,@,L 94-115 ,240,29,80,0.363,21,51,0.412,8,29,0.276,28,39,0.718,94,42,84,0.5,30,61,0.492,12,23,0.522,19,22,0.864,115,2013-01-02,LAC,GSW,2013,121.0
9555,9555,55,Home,L 94-96 ,240,37,78,0.474,28,54,0.519,9,24,0.375,11,14,0.786,94,36,77,0.468,31,65,0.477,5,12,0.417,19,25,0.76,96,2013-01-02,ORL,CHI,2013,98.5
9556,9556,56,Home,W 94-75 ,240,40,89,0.449,36,80,0.45,4,9,0.444,10,18,0.556,94,27,85,0.318,23,68,0.338,4,17,0.235,17,28,0.607,75,2013-01-04,BOS,IND,2013,77.0
9557,9557,57,@,L 94-100 ,240,35,81,0.432,29,62,0.468,6,19,0.316,18,20,0.9,94,31,78,0.397,21,59,0.356,10,19,0.526,28,36,0.778,100,2013-01-07,DAL,UTA,2013,105.0
9558,9558,58,@,W 94-87 ,240,40,88,0.455,38,71,0.535,2,17,0.118,12,16,0.75,94,33,71,0.465,26,54,0.481,7,17,0.412,14,20,0.7,87,2013-01-09,MEM,GSW,2013,90.5
9559,9559,59,@,L 94-95 ,240,39,86,0.453,31,69,0.449,8,17,0.471,8,11,0.727,94,41,85,0.482,36,74,0.486,5,11,0.455,8,13,0.615,95,2013-01-16,WAS,SAC,2013,97.5
9560,9560,60,Home,L 94-98 ,240,34,89,0.382,30,75,0.4,4,14,0.286,22,29,0.759,94,39,92,0.424,33,76,0.434,6,16,0.375,14,20,0.7,98,2013-01-17,PHO,MIL,2013,101.0
9561,9561,61,Home,W 94-89 ,240,30,74,0.405,21,48,0.438,9,26,0.346,25,38,0.658,94,35,80,0.438,26,59,0.441,9,21,0.429,10,14,0.714,89,2013-01-18,BRK,ATL,2013,93.5
9562,9562,62,Home,W 94-87 ,240,34,93,0.366,29,72,0.403,5,21,0.238,21,31,0.677,94,32,77,0.416,24,57,0.421,8,20,0.4,15,27,0.556,87,2013-01-19,LAC,WAS,2013,91.0
9563,9563,63,Home,L 94-100 ,240,34,81,0.42,28,66,0.424,6,15,0.4,20,24,0.833,94,29,74,0.392,19,45,0.422,10,29,0.345,32,41,0.78,100,2013-01-21,CHA,HOU,2013,105.0
9564,9564,64,Home,L 94-96 ,240,37,77,0.481,34,66,0.515,3,11,0.273,17,21,0.81,94,36,82,0.439,27,59,0.458,9,23,0.391,15,25,0.6,96,2013-01-28,WAS,SAC,2013,100.5
9565,9565,65,@,L 94-99 ,240,34,80,0.425,26,55,0.473,8,25,0.32,18,20,0.9,94,41,81,0.506,40,69,0.58,1,12,0.083,16,24,0.667,99,2013-02-04,CHA,MIA,2013,99.5
9566,9566,66,Home,L 94-104 ,240,33,81,0.407,25,63,0.397,8,18,0.444,20,23,0.87,94,37,81,0.457,27,56,0.482,10,25,0.4,20,21,0.952,104,2013-02-06,MIN,SAS,2013,109.0
9567,9567,67,Home,L 94-100 ,240,37,80,0.463,36,67,0.537,1,13,0.077,19,27,0.704,94,38,81,0.469,30,55,0.545,8,26,0.308,16,20,0.8,100,2013-02-08,MIN,NYK,2013,104.0
9568,9568,68,Home,W 94-91 ,240,33,77,0.429,25,59,0.424,8,18,0.444,20,30,0.667,94,32,77,0.416,26,63,0.413,6,14,0.429,21,26,0.808,91,2013-02-11,CHA,BOS,2013,94.0
9569,9569,69,@,L 94-109 ,240,38,68,0.559,33,53,0.623,5,15,0.333,13,23,0.565,94,42,87,0.483,35,68,0.515,7,19,0.368,18,22,0.818,109,2013-02-12,OKC,UTA,2013,112.5
9570,9570,70,Home,W 94-92 ,240,37,88,0.42,33,70,0.471,4,18,0.222,16,21,0.762,94,34,76,0.447,30,63,0.476,4,13,0.308,20,24,0.833,92,2013-02-13,MIL,PHI,2013,94.0
9571,9571,71,Home,L 94-97 ,240,35,75,0.467,29,61,0.475,6,14,0.429,18,31,0.581,94,34,85,0.4,25,59,0.424,9,26,0.346,20,26,0.769,97,2013-02-20,MIL,BRK,2013,101.5
9572,9572,72,Home,W 94-87 ,240,28,70,0.4,23,57,0.404,5,13,0.385,33,44,0.75,94,31,81,0.383,27,68,0.397,4,13,0.308,21,32,0.656,87,2013-02-20,MIN,PHI,2013,89.0
9573,9573,73,@,L 94-107 ,240,35,84,0.417,34,69,0.493,1,15,0.067,23,28,0.821,94,40,78,0.513,32,58,0.552,8,20,0.4,19,24,0.792,107,2013-02-23,UTA,LAC,2013,111.0
9574,9574,74,Home,L 94-118 ,240,38,79,0.481,34,65,0.523,4,14,0.286,14,22,0.636,94,43,87,0.494,34,66,0.515,9,21,0.429,23,28,0.821,118,2013-02-23,ORL,CLE,2013,122.5
9575,9575,75,@,L 94-116 ,240,37,81,0.457,30,60,0.5,7,21,0.333,13,15,0.867,94,44,83,0.53,28,51,0.549,16,32,0.5,12,21,0.571,116,2013-02-28,MIN,LAL,2013,124.0
9576,9576,76,Home,W 94-86 ,240,36,75,0.48,33,60,0.55,3,15,0.2,19,28,0.679,94,32,94,0.34,27,71,0.38,5,23,0.217,17,22,0.773,86,2013-03-01,BOS,GSW,2013,88.5
9577,9577,77,@,L 94-109 ,240,34,87,0.391,33,75,0.44,1,12,0.083,25,36,0.694,94,44,90,0.489,37,70,0.529,7,20,0.35,14,22,0.636,109,2013-03-02,MIN,POR,2013,112.5
9578,9578,78,Home,L 94-95 ,240,35,86,0.407,25,55,0.455,10,31,0.323,14,14,1.0,94,31,70,0.443,23,49,0.469,8,21,0.381,25,29,0.862,95,2013-03-07,NYK,OKC,2013,99.0
9579,9579,79,Home,L 94-116 ,240,35,85,0.412,28,62,0.452,7,23,0.304,17,25,0.68,94,46,81,0.568,34,57,0.596,12,24,0.5,12,16,0.75,116,2013-03-08,CHA,OKC,2013,122.0
9580,9580,80,@,W 94-88 ,240,27,74,0.365,12,39,0.308,15,35,0.429,25,34,0.735,94,33,87,0.379,24,66,0.364,9,21,0.429,13,20,0.65,88,2013-03-08,HOU,GSW,2013,92.5
9581,9581,81,@,L 94-117 ,240,34,79,0.43,23,51,0.451,11,28,0.393,15,22,0.682,94,41,84,0.488,32,63,0.508,9,21,0.429,26,37,0.703,117,2013-03-13,NYK,DEN,2013,121.5
9582,9582,82,Home,L 94-98 ,240,40,85,0.471,33,67,0.493,7,18,0.389,7,12,0.583,94,35,75,0.467,30,55,0.545,5,20,0.25,23,27,0.852,98,2013-03-13,PHI,MIA,2013,100.5
9583,9583,83,@,L 94-107 ,240,35,79,0.443,32,60,0.533,3,19,0.158,21,31,0.677,94,41,84,0.488,29,61,0.475,12,23,0.522,13,16,0.813,107,2013-03-15,PHO,ATL,2013,113.0
9584,9584,84,Home,L 94-107 ,240,33,89,0.371,24,64,0.375,9,25,0.36,19,21,0.905,94,41,79,0.519,34,64,0.531,7,15,0.467,18,22,0.818,107,2013-03-15,MIL,MIA,2013,110.5
9585,9585,85,@,L 94-106 ,240,38,79,0.481,33,62,0.532,5,17,0.294,13,18,0.722,94,40,76,0.526,25,42,0.595,15,34,0.441,11,16,0.688,106,2013-03-20,ORL,NYK,2013,113.5
9586,9586,86,@,L 94-104 ,240,32,77,0.416,27,60,0.45,5,17,0.294,25,27,0.926,94,38,82,0.463,32,63,0.508,6,19,0.316,22,28,0.786,104,2013-03-22,BOS,DAL,2013,107.0
9587,9587,87,Home,L 94-99 ,240,36,79,0.456,25,47,0.532,11,32,0.344,11,14,0.786,94,38,71,0.535,28,49,0.571,10,22,0.455,13,24,0.542,99,2013-03-22,TOR,NYK,2013,104.0
9588,9588,88,@,L 94-100 ,240,36,80,0.45,29,59,0.492,7,21,0.333,15,25,0.6,94,40,84,0.476,32,61,0.525,8,23,0.348,12,15,0.8,100,2013-03-25,ATL,IND,2013,104.0
9589,9589,89,Home,L 94-108 ,240,37,86,0.43,28,62,0.452,9,24,0.375,11,18,0.611,94,37,78,0.474,22,50,0.44,15,28,0.536,19,29,0.655,108,2013-03-25,ORL,MIA,2013,115.5
9590,9590,90,@,L 94-107 ,240,34,77,0.442,28,61,0.459,6,16,0.375,20,22,0.909,94,36,72,0.5,31,59,0.525,5,13,0.385,30,44,0.682,107,2013-03-25,MEM,WAS,2013,109.5
9591,9591,91,@,L 94-103 ,240,34,81,0.42,25,54,0.463,9,27,0.333,17,21,0.81,94,40,79,0.506,36,68,0.529,4,11,0.364,19,21,0.905,103,2013-03-29,HOU,MEM,2013,105.0
9592,9592,92,@,L 94-95 ,240,36,72,0.5,29,56,0.518,7,16,0.438,15,22,0.682,94,30,76,0.395,22,53,0.415,8,23,0.348,27,40,0.675,95,2013-03-31,DET,CHI,2013,99.0
9593,9593,93,@,L 94-102 ,240,41,81,0.506,38,69,0.551,3,12,0.25,9,15,0.6,94,37,81,0.457,28,51,0.549,9,30,0.3,19,26,0.731,102,2013-04-01,CLE,ATL,2013,106.5
9594,9594,94,@,W 94-76 ,240,34,67,0.507,30,55,0.545,4,12,0.333,22,28,0.786,94,33,80,0.413,29,51,0.569,4,29,0.138,6,10,0.6,76,2013-04-03,MEM,POR,2013,78.0
9595,9595,95,@,L 94-95 ,240,41,88,0.466,37,70,0.529,4,18,0.222,8,10,0.8,94,35,89,0.393,29,72,0.403,6,17,0.353,19,30,0.633,95,2013-04-04,DAL,DEN,2013,98.0
9596,9596,96,@,L 94-99 ,240,39,85,0.459,36,75,0.48,3,10,0.3,13,15,0.867,94,32,79,0.405,28,63,0.444,4,16,0.25,31,46,0.674,99,2013-04-09,CLE,IND,2013,101.0
9597,9597,97,Home,W 94-75 ,240,39,82,0.476,36,69,0.522,3,13,0.231,13,20,0.65,94,30,80,0.375,28,66,0.424,2,14,0.143,13,18,0.722,75,2013-04-09,MEM,CHA,2013,76.0
9598,9598,98,Home,W 94-83 ,240,38,88,0.432,30,53,0.566,8,35,0.229,10,10,1.0,94,33,75,0.44,24,50,0.48,9,25,0.36,8,14,0.571,83,2013-04-09,MIA,MIL,2013,87.5
9599,9599,99,@,L 94-98 ,240,33,82,0.402,24,58,0.414,9,24,0.375,19,24,0.792,94,35,84,0.417,30,69,0.435,5,15,0.333,23,34,0.676,98,2013-10-30,BRK,CLE,2014,100.5
9600,9600,0,@,L 94-125 ,240,35,89,0.393,27,71,0.38,8,18,0.444,16,21,0.762,94,46,86,0.535,31,59,0.525,15,27,0.556,18,23,0.783,125,2013-10-30,LAL,GSW,2014,132.5
9601,9601,1,@,L 94-101 ,240,39,93,0.419,31,78,0.397,8,15,0.533,8,15,0.533,94,40,76,0.526,29,56,0.518,11,20,0.55,10,16,0.625,101,2013-10-30,MEM,SAS,2014,106.5
9602,9602,2,Home,L 94-102 ,240,35,83,0.422,26,64,0.406,9,19,0.474,15,20,0.75,94,40,86,0.465,36,70,0.514,4,16,0.25,18,20,0.9,102,2013-11-05,DEN,SAS,2014,104.0
9603,9603,3,Home,W 94-79 ,240,40,84,0.476,33,63,0.524,7,21,0.333,7,9,0.778,94,30,90,0.333,21,64,0.328,9,26,0.346,10,14,0.714,79,2013-11-08,PHI,CLE,2014,83.5
9604,9604,4,@,L 94-104 ,240,38,82,0.463,30,65,0.462,8,17,0.471,10,18,0.556,94,43,90,0.478,37,71,0.521,6,19,0.316,12,17,0.706,104,2013-11-09,ORL,ATL,2014,107.0
9605,9605,5,Home,L 94-107 ,240,35,78,0.449,28,52,0.538,7,26,0.269,17,27,0.63,94,42,88,0.477,33,64,0.516,9,24,0.375,14,23,0.609,107,2013-11-09,HOU,LAC,2014,111.5
9606,9606,6,@,L 94-101 ,240,39,88,0.443,35,75,0.467,4,13,0.308,12,13,0.923,94,38,78,0.487,31,56,0.554,7,22,0.318,18,23,0.783,101,2013-11-10,NOP,PHO,2014,104.5
9607,9607,7,Home,L 94-103 ,240,33,81,0.407,28,68,0.412,5,13,0.385,23,29,0.793,94,35,76,0.461,25,49,0.51,10,27,0.37,23,28,0.821,103,2013-11-11,CHA,ATL,2014,108.0
9608,9608,8,Home,W 94-91 ,240,35,82,0.427,26,56,0.464,9,26,0.346,15,21,0.714,94,33,74,0.446,28,61,0.459,5,13,0.385,20,22,0.909,91,2013-11-13,ORL,MIL,2014,93.5
9609,9609,9,@,L 94-110 ,240,34,85,0.4,30,69,0.435,4,16,0.25,22,28,0.786,94,40,79,0.506,29,60,0.483,11,19,0.579,19,24,0.792,110,2013-11-16,IND,CHI,2014,115.5
9610,9610,10,@,L 94-97 ,240,38,99,0.384,32,78,0.41,6,21,0.286,12,22,0.545,94,34,78,0.436,25,49,0.51,9,29,0.31,20,26,0.769,97,2013-11-18,PHI,DAL,2014,101.5
9611,9611,11,@,W 94-87 ,240,33,72,0.458,29,56,0.518,4,16,0.25,24,31,0.774,94,36,93,0.387,31,73,0.425,5,20,0.25,10,12,0.833,87,2013-11-23,BOS,ATL,2014,89.5
9612,9612,12,@,L 94-113 ,240,33,73,0.452,27,54,0.5,6,19,0.316,22,26,0.846,94,43,80,0.538,31,51,0.608,12,29,0.414,15,23,0.652,113,2013-11-25,MIL,DET,2014,119.0
9613,9613,13,Home,L 94-99 ,240,31,83,0.373,20,53,0.377,11,30,0.367,21,26,0.808,94,34,85,0.4,21,55,0.382,13,30,0.433,18,22,0.818,99,2013-11-27,BRK,LAL,2014,105.5
9614,9614,14,Home,W 94-88 ,240,39,84,0.464,35,69,0.507,4,15,0.267,12,15,0.8,94,36,92,0.391,29,65,0.446,7,27,0.259,9,14,0.643,88,2013-11-27,OKC,SAS,2014,91.5
9615,9615,15,@,L 94-105 ,240,38,85,0.447,31,63,0.492,7,22,0.318,11,17,0.647,94,43,82,0.524,39,63,0.619,4,19,0.211,15,21,0.714,105,2013-11-27,PHI,ORL,2014,107.0
9616,9616,16,Home,L 94-106 ,240,34,79,0.43,25,51,0.49,9,28,0.321,17,20,0.85,94,40,82,0.488,36,56,0.643,4,26,0.154,22,25,0.88,106,2013-12-08,LAL,TOR,2014,108.0
9617,9617,17,@,L 94-118 ,240,34,85,0.4,27,64,0.422,7,21,0.333,19,21,0.905,94,47,77,0.61,42,64,0.656,5,13,0.385,19,20,0.95,118,2013-12-08,IND,OKC,2014,120.5
9618,9618,18,Home,W 94-85 ,240,36,86,0.419,26,69,0.377,10,17,0.588,12,17,0.706,94,30,75,0.4,24,53,0.453,6,22,0.273,19,20,0.95,85,2013-12-09,MEM,ORL,2014,88.0
9619,9619,19,@,W 94-83 ,240,35,82,0.427,30,55,0.545,5,27,0.185,19,29,0.655,94,33,92,0.359,30,71,0.423,3,21,0.143,14,19,0.737,83,2013-12-09,LAC,PHI,2014,84.5
9620,9620,20,Home,L 94-105 ,240,36,82,0.439,35,75,0.467,1,7,0.143,21,23,0.913,94,40,85,0.471,34,66,0.515,6,19,0.316,19,20,0.95,105,2013-12-09,UTA,POR,2014,108.0
9621,9621,21,@,L 94-109 ,240,40,87,0.46,30,56,0.536,10,31,0.323,4,5,0.8,94,42,74,0.568,33,55,0.6,9,19,0.474,16,22,0.727,109,2013-12-10,NYK,CLE,2014,113.5
9622,9622,22,Home,L 94-121 ,240,39,83,0.47,31,55,0.564,8,28,0.286,8,16,0.5,94,41,85,0.482,30,61,0.492,11,24,0.458,28,33,0.848,121,2013-12-10,DET,MIN,2014,126.5
9623,9623,23,@,L 94-99 ,240,39,83,0.47,35,71,0.493,4,12,0.333,12,17,0.706,94,36,76,0.474,28,55,0.509,8,21,0.381,19,25,0.76,99,2013-12-13,CHA,IND,2014,103.0
9624,9624,24,@,L 94-130 ,240,37,90,0.411,29,60,0.483,8,30,0.267,12,20,0.6,94,47,78,0.603,26,43,0.605,21,35,0.6,15,26,0.577,130,2013-12-16,PHI,BRK,2014,140.5
9625,9625,25,@,L 94-117 ,240,39,84,0.464,34,66,0.515,5,18,0.278,11,17,0.647,94,45,71,0.634,39,56,0.696,6,15,0.4,21,26,0.808,117,2013-12-16,UTA,MIA,2014,120.0
9626,9626,26,@,L 94-109 ,240,38,79,0.481,33,67,0.493,5,12,0.417,13,23,0.565,94,44,82,0.537,36,60,0.6,8,22,0.364,13,16,0.813,109,2013-12-18,CHI,HOU,2014,113.0
9627,9627,27,@,L 94-97 ,240,32,73,0.438,27,59,0.458,5,14,0.357,25,28,0.893,94,37,77,0.481,32,56,0.571,5,21,0.238,18,22,0.818,97,2013-12-18,IND,MIA,2014,99.5
9628,9628,28,@,L 94-104 ,240,35,75,0.467,24,51,0.471,11,24,0.458,13,15,0.867,94,39,83,0.47,28,63,0.444,11,20,0.55,15,20,0.75,104,2013-12-23,UTA,MEM,2014,109.5
9629,9629,29,Home,L 94-123 ,240,38,90,0.422,32,67,0.478,6,23,0.261,12,19,0.632,94,45,84,0.536,32,60,0.533,13,24,0.542,20,26,0.769,123,2013-12-25,NYK,OKC,2014,129.5
9630,9630,30,Home,L 94-97 ,240,38,81,0.469,30,61,0.492,8,20,0.4,10,11,0.909,94,34,67,0.507,23,44,0.523,11,23,0.478,18,28,0.643,97,2013-12-30,DEN,MIA,2014,102.5
9631,9631,31,@,W 94-79 ,240,40,91,0.44,34,68,0.5,6,23,0.261,8,14,0.571,94,29,81,0.358,22,57,0.386,7,24,0.292,14,18,0.778,79,2013-12-31,MIL,LAL,2014,82.5
9632,9632,32,Home,L 94-98 ,240,36,82,0.439,33,68,0.485,3,14,0.214,19,26,0.731,94,36,91,0.396,28,58,0.483,8,33,0.242,18,21,0.857,98,2013-12-31,OKC,POR,2014,102.0
9633,9633,33,@,W 94-81 ,240,41,85,0.482,35,58,0.603,6,27,0.222,6,10,0.6,94,34,89,0.382,29,70,0.414,5,19,0.263,8,13,0.615,81,2013-12-31,GSW,ORL,2014,83.5
9634,9634,34,Home,W 94-82 ,240,35,84,0.417,33,69,0.478,2,15,0.133,22,28,0.786,94,32,81,0.395,30,69,0.435,2,12,0.167,16,23,0.696,82,2014-01-02,CHI,BOS,2014,83.0
9635,9635,35,Home,L 94-110 ,240,33,80,0.413,25,54,0.463,8,26,0.308,20,24,0.833,94,40,74,0.541,34,58,0.586,6,16,0.375,24,31,0.774,110,2014-01-04,ORL,MIA,2014,113.0
9636,9636,36,@,L 94-110 ,240,33,83,0.398,26,63,0.413,7,20,0.35,21,27,0.778,94,45,95,0.474,36,65,0.554,9,30,0.3,11,13,0.846,110,2014-01-08,ORL,POR,2014,114.5
9637,9637,37,@,L 94-120 ,240,37,84,0.44,33,64,0.516,4,20,0.2,16,23,0.696,94,44,87,0.506,32,59,0.542,12,28,0.429,20,26,0.769,120,2014-01-11,ORL,DEN,2014,126.0
9638,9638,38,@,L 94-116 ,240,35,83,0.422,26,64,0.406,9,19,0.474,15,22,0.682,94,40,79,0.506,28,56,0.5,12,23,0.522,24,30,0.8,116,2014-01-13,MIL,TOR,2014,122.0
9639,9639,39,Home,W 94-89 ,240,34,78,0.436,23,54,0.426,11,24,0.458,15,20,0.75,94,36,82,0.439,33,64,0.516,3,18,0.167,14,20,0.7,89,2014-01-17,TOR,MIN,2014,90.5
9640,9640,40,Home,L 94-102 ,240,35,86,0.407,25,56,0.446,10,30,0.333,14,20,0.7,94,41,91,0.451,33,72,0.458,8,19,0.421,12,15,0.8,102,2014-01-20,GSW,IND,2014,106.0
9641,9641,41,Home,L 94-95 ,240,32,87,0.368,25,68,0.368,7,19,0.368,23,30,0.767,94,37,86,0.43,30,65,0.462,7,21,0.333,14,25,0.56,95,2014-01-29,BOS,PHI,2014,98.5
9642,9642,42,Home,L 94-102 ,240,38,87,0.437,37,72,0.514,1,15,0.067,17,24,0.708,94,39,91,0.429,31,74,0.419,8,17,0.471,16,20,0.8,102,2014-01-30,IND,PHO,2014,106.0
9643,9643,43,@,W 94-90 ,240,38,80,0.475,34,68,0.5,4,12,0.333,14,22,0.636,94,39,84,0.464,33,62,0.532,6,22,0.273,6,7,0.857,90,2014-01-31,MEM,MIN,2014,93.0
9644,9644,44,@,W 94-79 ,240,37,84,0.44,31,63,0.492,6,21,0.286,14,16,0.875,94,32,78,0.41,29,61,0.475,3,17,0.176,12,13,0.923,79,2014-02-03,TOR,UTA,2014,80.5
9645,9645,45,@,W 94-90 ,240,30,79,0.38,22,58,0.379,8,21,0.381,26,33,0.788,94,36,90,0.4,32,69,0.464,4,21,0.19,14,20,0.7,90,2014-02-05,POR,NYK,2014,92.0
9646,9646,46,Home,W 94-89 ,240,36,74,0.486,26,49,0.531,10,25,0.4,12,19,0.632,94,29,67,0.433,22,44,0.5,7,23,0.304,24,30,0.8,89,2014-02-08,UTA,MIA,2014,92.5
9647,9647,47,@,L 94-100 ,240,34,87,0.391,29,70,0.414,5,17,0.294,21,28,0.75,94,36,82,0.439,25,54,0.463,11,28,0.393,17,26,0.654,100,2014-02-19,BOS,PHO,2014,105.5
9648,9648,48,@,W 94-92 ,240,36,72,0.5,29,60,0.483,7,12,0.583,15,20,0.75,94,35,83,0.422,32,66,0.485,3,17,0.176,19,23,0.826,92,2014-02-19,CHI,TOR,2014,93.5
9649,9649,49,@,L 94-102 ,240,37,82,0.451,31,69,0.449,6,13,0.462,14,18,0.778,94,39,91,0.429,32,71,0.451,7,20,0.35,17,17,1.0,102,2014-02-21,UTA,POR,2014,105.5
9650,9650,50,Home,W 94-93 ,240,36,74,0.486,33,60,0.55,3,14,0.214,19,26,0.731,94,35,81,0.432,29,68,0.426,6,13,0.462,17,21,0.81,93,2014-02-22,WAS,NOP,2014,96.0
9651,9651,51,Home,W 94-91 ,240,34,82,0.415,29,67,0.433,5,15,0.333,21,28,0.75,94,36,78,0.462,30,64,0.469,6,14,0.429,13,18,0.722,91,2014-03-02,IND,UTA,2014,94.0
9652,9652,52,@,L 94-103 ,240,34,79,0.43,28,64,0.438,6,15,0.4,20,25,0.8,94,38,74,0.514,23,48,0.479,15,26,0.577,12,13,0.923,103,2014-03-05,MEM,BRK,2014,110.5
9653,9653,53,Home,L 94-105 ,240,39,87,0.448,37,76,0.487,2,11,0.182,14,17,0.824,94,43,80,0.538,38,61,0.623,5,19,0.263,14,17,0.824,105,2014-03-05,DET,CHI,2014,107.5
9654,9654,54,Home,L 94-142 ,240,34,86,0.395,26,56,0.464,8,30,0.267,18,26,0.692,94,57,103,0.553,45,77,0.584,12,26,0.462,16,22,0.727,142,2014-03-06,LAL,LAC,2014,148.0
9655,9655,55,@,L 94-105 ,240,32,67,0.478,25,51,0.49,7,16,0.438,23,29,0.793,94,36,81,0.444,28,61,0.459,8,20,0.4,25,31,0.806,105,2014-03-09,IND,DAL,2014,109.0
9656,9656,56,Home,W 94-83 ,240,40,73,0.548,36,57,0.632,4,16,0.25,10,13,0.769,94,32,91,0.352,29,72,0.403,3,19,0.158,16,19,0.842,83,2014-03-11,IND,BOS,2014,84.5
9657,9657,57,Home,L 94-103 ,240,35,77,0.455,24,48,0.5,11,29,0.379,13,19,0.684,94,40,82,0.488,30,60,0.5,10,22,0.455,13,18,0.722,103,2014-03-14,GSW,CLE,2014,108.0
9658,9658,58,Home,L 94-101 ,240,35,90,0.389,27,64,0.422,8,26,0.308,16,18,0.889,94,39,67,0.582,30,46,0.652,9,21,0.429,14,22,0.636,101,2014-03-14,PHI,IND,2014,105.5
9659,9659,59,Home,W 94-87 ,240,31,78,0.397,25,58,0.431,6,20,0.3,26,33,0.788,94,31,85,0.365,29,71,0.408,2,14,0.143,23,37,0.622,87,2014-03-15,CHI,SAC,2014,88.0
9660,9660,60,@,L 94-115 ,240,35,81,0.432,31,71,0.437,4,10,0.4,20,27,0.741,94,42,76,0.553,34,56,0.607,8,20,0.4,23,28,0.821,115,2014-03-15,MIL,NYK,2014,119.0
9661,9661,61,@,L 94-101 ,240,34,71,0.479,23,50,0.46,11,21,0.524,15,22,0.682,94,36,77,0.468,28,51,0.549,8,26,0.308,21,25,0.84,101,2014-03-15,BRK,WAS,2014,105.0
9662,9662,62,Home,W 94-89 ,240,33,78,0.423,24,51,0.471,9,27,0.333,19,21,0.905,94,34,93,0.366,25,71,0.352,9,22,0.409,12,14,0.857,89,2014-03-17,DAL,BOS,2014,93.5
9663,9663,63,Home,L 94-102 ,240,37,81,0.457,26,57,0.456,11,24,0.458,9,19,0.474,94,36,83,0.434,28,68,0.412,8,15,0.533,22,27,0.815,102,2014-03-19,PHI,CHI,2014,106.0
9664,9664,64,@,L 94-124 ,240,34,84,0.405,25,57,0.439,9,27,0.333,17,22,0.773,94,49,94,0.521,41,75,0.547,8,19,0.421,18,19,0.947,124,2014-03-22,POR,CHA,2014,128.0
9665,9665,65,@,L 94-103 ,240,37,82,0.451,31,63,0.492,6,19,0.316,14,17,0.824,94,37,80,0.463,31,64,0.484,6,16,0.375,23,29,0.793,103,2014-03-23,ORL,LAL,2014,106.0
9666,9666,66,Home,L 94-114 ,240,34,83,0.41,27,56,0.482,7,27,0.259,19,28,0.679,94,46,83,0.554,37,66,0.561,9,17,0.529,13,18,0.722,114,2014-03-24,UTA,DET,2014,118.5
9667,9667,67,Home,W 94-81 ,240,33,69,0.478,24,46,0.522,9,23,0.391,19,25,0.76,94,31,85,0.365,22,67,0.328,9,18,0.5,10,16,0.625,81,2014-03-28,OKC,SAC,2014,85.5
9668,9668,68,@,L 94-100 ,240,38,79,0.481,29,62,0.468,9,17,0.529,9,13,0.692,94,34,78,0.436,31,57,0.544,3,21,0.143,29,34,0.853,100,2014-03-31,WAS,CHA,2014,101.5
9669,9669,69,Home,W 94-80 ,240,38,80,0.475,35,64,0.547,3,16,0.188,15,16,0.938,94,31,77,0.403,24,52,0.462,7,25,0.28,11,15,0.733,80,2014-03-31,CHI,BOS,2014,83.5
9670,9670,70,@,W 94-92 ,240,38,85,0.447,33,76,0.434,5,9,0.556,13,23,0.565,94,36,73,0.493,30,53,0.566,6,20,0.3,14,24,0.583,92,2014-03-31,MEM,DEN,2014,95.0
9671,9671,71,@,L 94-101 ,240,34,93,0.366,27,77,0.351,7,16,0.438,19,28,0.679,94,39,79,0.494,34,61,0.557,5,18,0.278,18,24,0.75,101,2014-04-02,DET,IND,2014,103.5
9672,9672,72,@,L 94-106 ,240,38,88,0.432,29,66,0.439,9,22,0.409,9,12,0.75,94,40,81,0.494,34,63,0.54,6,18,0.333,20,23,0.87,106,2014-04-03,SAS,OKC,2014,109.0
9673,9673,73,@,L 94-102 ,240,33,78,0.423,27,67,0.403,6,11,0.545,22,28,0.786,94,40,84,0.476,30,62,0.484,10,22,0.455,12,16,0.75,102,2014-04-04,IND,TOR,2014,107.0
9674,9674,74,Home,L 94-96 (OT),265,35,96,0.365,28,74,0.378,7,22,0.318,17,21,0.81,94,34,91,0.374,25,65,0.385,9,26,0.346,19,27,0.704,96,2014-04-05,CLE,CHA,2014,100.5
9675,9675,75,@,L 94-100 ,240,38,90,0.422,34,78,0.436,4,12,0.333,14,18,0.778,94,41,87,0.471,36,65,0.554,5,22,0.227,13,15,0.867,100,2014-04-06,NOP,POR,2014,102.5
9676,9676,76,@,W 94-88 ,240,39,80,0.488,30,61,0.492,9,19,0.474,7,10,0.7,94,34,80,0.425,28,66,0.424,6,14,0.429,14,17,0.824,88,2014-04-09,PHO,NOP,2014,91.0
9677,9677,77,@,W 94-88 (OT),265,35,92,0.38,24,67,0.358,11,25,0.44,13,15,0.867,94,37,82,0.451,36,67,0.537,1,15,0.067,13,20,0.65,88,2014-04-09,CHA,WAS,2014,88.5
9678,9678,78,@,L 94-116 ,240,35,86,0.407,26,68,0.382,9,18,0.5,15,19,0.789,94,44,82,0.537,39,69,0.565,5,13,0.385,23,27,0.852,116,2014-04-11,NOP,OKC,2014,118.5
9679,9679,79,@,L 94-101 ,240,34,79,0.43,32,66,0.485,2,13,0.154,24,32,0.75,94,35,84,0.417,28,62,0.452,7,22,0.318,24,29,0.828,101,2014-04-12,UTA,DEN,2014,104.5
9680,9680,80,Home,W 94-89 ,240,35,87,0.402,33,69,0.478,2,18,0.111,22,26,0.846,94,32,78,0.41,24,53,0.453,8,25,0.32,17,23,0.739,89,2014-10-31,PHO,SAS,2015,93.0
9681,9681,81,@,L 94-103 ,240,34,83,0.41,25,57,0.439,9,26,0.346,17,19,0.895,94,34,81,0.42,30,71,0.423,4,10,0.4,31,35,0.886,103,2014-10-31,POR,SAC,2015,105.0
9682,9682,82,Home,W 94-92 ,240,31,69,0.449,26,52,0.5,5,17,0.294,27,38,0.711,94,38,92,0.413,30,67,0.448,8,25,0.32,8,11,0.727,92,2014-11-05,SAS,ATL,2015,96.0
9683,9683,83,@,L 94-96 (OT),265,35,90,0.389,27,63,0.429,8,27,0.296,16,20,0.8,94,34,91,0.374,27,74,0.365,7,17,0.412,21,23,0.913,96,2014-11-05,IND,WAS,2015,99.5
9684,9684,84,Home,L 94-109 ,240,37,83,0.446,28,50,0.56,9,33,0.273,11,13,0.846,94,40,82,0.488,30,58,0.517,10,24,0.417,19,22,0.864,109,2014-11-12,BOS,OKC,2015,114.0
9685,9685,85,@,L 94-127 ,240,40,90,0.444,37,68,0.544,3,22,0.136,11,13,0.846,94,49,90,0.544,30,59,0.508,19,31,0.613,10,13,0.769,127,2014-11-15,ATL,CLE,2015,136.5
9686,9686,86,Home,W 94-91 ,240,37,86,0.43,37,74,0.5,0,12,0.0,20,24,0.833,94,34,80,0.425,27,56,0.482,7,24,0.292,16,18,0.889,91,2014-11-15,SAC,SAS,2015,94.5
9687,9687,87,@,W 94-92 ,240,31,67,0.463,26,52,0.5,5,15,0.333,27,30,0.9,94,38,85,0.447,34,65,0.523,4,20,0.2,12,19,0.632,92,2014-11-21,BRK,OKC,2015,94.0
9688,9688,88,Home,L 94-106 ,240,33,71,0.465,28,57,0.491,5,14,0.357,23,29,0.793,94,42,93,0.452,38,76,0.5,4,17,0.235,18,22,0.818,106,2014-11-22,UTA,NOP,2015,108.0
9689,9689,89,@,W 94-88 ,240,37,86,0.43,30,67,0.448,7,19,0.368,13,15,0.867,94,37,95,0.389,32,72,0.444,5,23,0.217,9,12,0.75,88,2014-11-23,POR,BOS,2015,90.5
9690,9690,90,Home,L 94-101 (OT),265,33,89,0.371,30,65,0.462,3,24,0.125,25,34,0.735,94,34,90,0.378,24,53,0.453,10,37,0.27,23,38,0.605,101,2014-11-23,LAL,DEN,2015,106.0
9691,9691,91,Home,W 94-93 ,240,33,66,0.5,22,43,0.512,11,23,0.478,17,19,0.895,94,37,79,0.468,30,58,0.517,7,21,0.333,12,16,0.75,93,2014-11-23,MIA,CHO,2015,96.5
9692,9692,92,Home,L 94-96 ,240,34,76,0.447,27,53,0.509,7,23,0.304,19,28,0.679,94,39,87,0.448,33,66,0.5,6,21,0.286,12,17,0.706,96,2014-12-07,DET,OKC,2015,99.0
9693,9693,93,@,L 94-103 ,240,31,85,0.365,22,57,0.386,9,28,0.321,23,30,0.767,94,38,87,0.437,31,61,0.508,7,26,0.269,20,22,0.909,103,2014-12-11,CLE,OKC,2015,106.5
9694,9694,94,@,L 94-106 ,240,33,80,0.413,25,58,0.431,8,22,0.364,20,23,0.87,94,38,91,0.418,28,65,0.431,10,26,0.385,20,22,0.909,106,2014-12-12,IND,TOR,2015,111.0
9695,9695,95,Home,L 94-100 ,240,38,90,0.422,35,80,0.438,3,10,0.3,15,20,0.75,94,34,81,0.42,29,64,0.453,5,17,0.294,27,34,0.794,100,2014-12-14,MIN,LAL,2015,102.5
9696,9696,96,Home,L 94-96 ,240,30,75,0.4,18,37,0.486,12,38,0.316,22,27,0.815,94,35,73,0.479,27,57,0.474,8,16,0.5,18,22,0.818,96,2014-12-15,PHO,MIL,2015,100.0
9697,9697,97,Home,L 94-101 ,240,37,83,0.446,25,61,0.41,12,22,0.545,8,12,0.667,94,39,73,0.534,35,62,0.565,4,11,0.364,19,24,0.792,101,2014-12-19,ORL,UTA,2015,103.0
9698,9698,98,Home,L 94-102 ,240,36,86,0.419,28,62,0.452,8,24,0.333,14,18,0.778,94,38,83,0.458,30,63,0.476,8,20,0.4,18,24,0.75,102,2014-12-27,CHA,ORL,2015,106.0
9699,9699,99,Home,L 94-104 (OT),265,33,90,0.367,26,65,0.4,7,25,0.28,21,26,0.808,94,40,85,0.471,34,64,0.531,6,21,0.286,18,21,0.857,104,2014-12-29,CHA,MIL,2015,107.0
9700,9700,0,@,L 94-100 ,240,38,82,0.463,30,65,0.462,8,17,0.471,10,14,0.714,94,38,79,0.481,31,60,0.517,7,19,0.368,17,22,0.773,100,2014-12-30,MIN,UTA,2015,103.5
9701,9701,1,@,W 94-91 ,240,35,81,0.432,27,61,0.443,8,20,0.4,16,20,0.8,94,38,89,0.427,31,65,0.477,7,24,0.292,8,10,0.8,91,2015-01-02,IND,MIL,2015,94.5
9702,9702,2,@,L 94-98 ,240,37,88,0.42,33,74,0.446,4,14,0.286,16,20,0.8,94,33,83,0.398,22,57,0.386,11,26,0.423,21,24,0.875,98,2015-01-05,LAL,POR,2015,103.5
9703,9703,3,@,L 94-98 ,240,36,80,0.45,30,62,0.484,6,18,0.333,16,24,0.667,94,37,86,0.43,33,72,0.458,4,14,0.286,20,26,0.769,98,2015-01-07,NOP,CHO,2015,100.0
9704,9704,4,@,L 94-112 ,240,35,86,0.407,28,63,0.444,7,23,0.304,17,23,0.739,94,43,86,0.5,33,56,0.589,10,30,0.333,16,17,0.941,112,2015-01-09,CLE,GSW,2015,117.0
9705,9705,5,@,L 94-99 ,240,36,74,0.486,29,53,0.547,7,21,0.333,15,22,0.682,94,42,91,0.462,35,70,0.5,7,21,0.333,8,9,0.889,99,2015-01-09,UTA,OKC,2015,102.5
9706,9706,6,Home,L 94-106 ,240,36,81,0.444,29,59,0.492,7,22,0.318,15,19,0.789,94,41,86,0.477,28,55,0.509,13,31,0.419,11,17,0.647,106,2015-01-11,LAL,POR,2015,112.5
9707,9707,7,Home,L 94-105 ,240,34,73,0.466,26,51,0.51,8,22,0.364,18,23,0.783,94,39,80,0.488,31,59,0.525,8,21,0.381,19,23,0.826,105,2015-01-14,DET,NOP,2015,109.0
9708,9708,8,Home,L 94-100 ,240,35,87,0.402,29,61,0.475,6,26,0.231,18,20,0.9,94,37,88,0.42,29,65,0.446,8,23,0.348,18,19,0.947,100,2015-01-14,POR,LAC,2015,104.0
9709,9709,9,Home,W 94-85 ,240,36,85,0.424,24,54,0.444,12,31,0.387,10,10,1.0,94,31,65,0.477,28,58,0.483,3,7,0.429,20,27,0.741,85,2015-01-16,UTA,LAL,2015,86.5
9710,9710,10,@,L 94-108 ,240,30,80,0.375,22,64,0.344,8,16,0.5,26,32,0.813,94,41,90,0.456,33,72,0.458,8,18,0.444,18,25,0.72,108,2015-01-19,CHI,CLE,2015,112.0
9711,9711,11,@,L 94-98 ,240,34,76,0.447,30,64,0.469,4,12,0.333,22,30,0.733,94,35,88,0.398,24,52,0.462,11,36,0.306,17,26,0.654,98,2015-01-19,SAC,POR,2015,103.5
9712,9712,12,@,W 94-86 ,240,41,92,0.446,35,66,0.53,6,26,0.231,6,10,0.6,94,32,68,0.471,24,46,0.522,8,22,0.364,14,19,0.737,86,2015-01-20,OKC,MIA,2015,90.0
9713,9713,13,@,L 94-103 ,240,37,78,0.474,33,66,0.5,4,12,0.333,16,25,0.64,94,36,76,0.474,29,58,0.5,7,18,0.389,24,26,0.923,103,2015-01-26,ORL,MEM,2015,106.5
9714,9714,14,@,L 94-99 ,240,35,80,0.438,25,49,0.51,10,31,0.323,14,17,0.824,94,34,85,0.4,19,48,0.396,15,37,0.405,16,18,0.889,99,2015-01-28,POR,CLE,2015,106.5
9715,9715,15,@,L 94-99 ,240,35,82,0.427,25,57,0.439,10,25,0.4,14,16,0.875,94,36,88,0.409,22,53,0.415,14,35,0.4,13,15,0.867,99,2015-01-28,DAL,HOU,2015,106.0
9716,9716,16,@,W 94-89 ,240,34,76,0.447,25,50,0.5,9,26,0.346,17,25,0.68,94,35,81,0.432,30,57,0.526,5,24,0.208,14,20,0.7,89,2015-01-28,LAC,UTA,2015,91.5
9717,9717,17,@,L 94-103 ,240,34,76,0.447,29,62,0.468,5,14,0.357,21,25,0.84,94,37,74,0.5,29,51,0.569,8,23,0.348,21,25,0.84,103,2015-01-30,MIN,PHI,2015,107.0
9718,9718,18,Home,L 94-99 ,240,33,80,0.413,28,55,0.509,5,25,0.2,23,25,0.92,94,34,80,0.425,29,65,0.446,5,15,0.333,26,29,0.897,99,2015-01-31,IND,SAC,2015,101.5
9719,9719,19,@,L 94-100 ,240,34,82,0.415,31,69,0.449,3,13,0.231,23,26,0.885,94,39,84,0.464,29,53,0.547,10,31,0.323,12,18,0.667,100,2015-02-02,MIN,DAL,2015,105.0
9720,9720,20,Home,W 94-87 ,240,33,76,0.434,27,51,0.529,6,25,0.24,22,27,0.815,94,35,84,0.417,30,74,0.405,5,10,0.5,12,17,0.706,87,2015-02-05,CHA,WAS,2015,89.5
9721,9721,21,@,L 94-105 ,240,38,91,0.418,33,69,0.478,5,22,0.227,13,20,0.65,94,31,72,0.431,23,42,0.548,8,30,0.267,35,44,0.795,105,2015-02-05,LAC,CLE,2015,109.0
9722,9722,22,Home,W 94-88 ,240,36,92,0.391,33,79,0.418,3,13,0.231,19,21,0.905,94,33,80,0.413,21,50,0.42,12,30,0.4,10,11,0.909,88,2015-02-08,MEM,ATL,2015,94.0
9723,9723,23,@,W 94-91 ,240,40,90,0.444,33,63,0.524,7,27,0.259,7,9,0.778,94,33,86,0.384,28,72,0.389,5,14,0.357,20,27,0.741,91,2015-02-11,GSW,MIN,2015,93.5
9724,9724,24,@,L 94-119 ,240,35,97,0.361,28,70,0.4,7,27,0.259,17,20,0.85,94,48,92,0.522,40,72,0.556,8,20,0.4,15,23,0.652,119,2015-02-22,DEN,OKC,2015,123.0
9725,9725,25,@,L 94-115 ,240,34,82,0.415,32,61,0.525,2,21,0.095,24,31,0.774,94,42,83,0.506,28,52,0.538,14,31,0.452,17,20,0.85,115,2015-02-25,NYK,BOS,2015,122.0
9726,9726,26,Home,L 94-104 ,240,35,82,0.427,26,54,0.481,9,28,0.321,15,18,0.833,94,40,77,0.519,30,54,0.556,10,23,0.435,14,23,0.609,104,2015-02-28,DAL,BRK,2015,109.0
9727,9727,27,Home,W 94-74 ,240,36,88,0.409,33,70,0.471,3,18,0.167,19,25,0.76,94,29,84,0.345,24,60,0.4,5,24,0.208,11,17,0.647,74,2015-03-01,IND,PHI,2015,76.5
9728,9728,28,@,L 94-100 ,240,38,88,0.432,31,70,0.443,7,18,0.389,11,17,0.647,94,32,79,0.405,29,63,0.46,3,16,0.188,33,43,0.767,100,2015-03-04,LAL,MIA,2015,101.5
9729,9729,29,Home,W 94-75 ,240,34,82,0.415,27,60,0.45,7,22,0.318,19,21,0.905,94,33,88,0.375,31,72,0.431,2,16,0.125,7,8,0.875,75,2015-03-05,POR,DAL,2015,76.0
9730,9730,30,@,L 94-103 ,240,37,91,0.407,30,69,0.435,7,22,0.318,13,15,0.867,94,40,85,0.471,35,65,0.538,5,20,0.25,18,20,0.9,103,2015-03-06,TOR,CHO,2015,105.5
9731,9731,31,Home,L 94-127 ,240,33,81,0.407,28,61,0.459,5,20,0.25,23,33,0.697,94,44,87,0.506,29,55,0.527,15,32,0.469,24,29,0.828,127,2015-03-10,DAL,CLE,2015,134.5
9732,9732,32,Home,L 94-101 ,240,38,90,0.422,33,72,0.458,5,18,0.278,13,21,0.619,94,36,77,0.468,27,59,0.458,9,18,0.5,20,26,0.769,101,2015-03-12,LAL,NYK,2015,105.5
9733,9733,33,@,L 94-125 ,240,38,96,0.396,29,71,0.408,9,25,0.36,9,16,0.563,94,45,90,0.5,26,56,0.464,19,34,0.559,16,17,0.941,125,2015-03-14,NYK,GSW,2015,134.5
9734,9734,34,@,W 94-87 ,240,37,84,0.44,35,67,0.522,2,17,0.118,18,26,0.692,94,35,94,0.372,27,57,0.474,8,37,0.216,9,14,0.643,87,2015-03-14,BRK,PHI,2015,91.0
9735,9735,35,Home,W 94-66 ,240,33,78,0.423,18,54,0.333,15,24,0.625,13,19,0.684,94,23,78,0.295,18,59,0.305,5,19,0.263,15,18,0.833,66,2015-03-16,UTA,CHO,2015,68.5
9736,9736,36,@,L 94-107 ,240,38,89,0.427,32,67,0.478,6,22,0.273,12,17,0.706,94,39,78,0.5,28,51,0.549,11,27,0.407,18,27,0.667,107,2015-03-17,ORL,HOU,2015,112.5
9737,9737,37,Home,W 94-83 ,240,36,84,0.429,25,57,0.439,11,27,0.407,11,18,0.611,94,29,88,0.33,21,62,0.339,8,26,0.308,17,19,0.895,83,2015-03-18,PHI,DET,2015,87.0
9738,9738,38,@,L 94-101 ,240,36,85,0.424,28,57,0.491,8,28,0.286,14,18,0.778,94,42,87,0.483,35,65,0.538,7,22,0.318,10,13,0.769,101,2015-03-24,SAS,DAL,2015,104.5
9739,9739,39,Home,W 94-76 ,240,37,84,0.44,28,58,0.483,9,26,0.346,11,14,0.786,94,31,82,0.378,27,64,0.422,4,18,0.222,10,15,0.667,76,2015-03-27,SAS,DAL,2015,78.0
9740,9740,40,Home,W 94-83 ,240,36,75,0.48,29,57,0.509,7,18,0.389,15,21,0.714,94,29,84,0.345,25,67,0.373,4,17,0.235,21,29,0.724,83,2015-03-27,TOR,LAL,2015,85.0
9741,9741,41,Home,W 94-89 ,240,32,84,0.381,26,55,0.473,6,29,0.207,24,35,0.686,94,31,73,0.425,25,57,0.439,6,16,0.375,21,32,0.656,89,2015-03-28,UTA,OKC,2015,92.0
9742,9742,42,@,L 94-99 ,240,34,76,0.447,23,49,0.469,11,27,0.407,15,21,0.714,94,35,83,0.422,19,46,0.413,16,37,0.432,13,22,0.591,99,2015-04-05,CHI,CLE,2015,107.0
9743,9743,43,Home,W 94-86 ,240,35,88,0.398,29,61,0.475,6,27,0.222,18,22,0.818,94,34,77,0.442,32,68,0.471,2,9,0.222,16,24,0.667,86,2015-04-11,LAC,MEM,2015,87.0
9744,9744,44,Home,L 94-106 ,240,37,82,0.451,29,55,0.527,8,27,0.296,12,15,0.8,94,37,96,0.385,25,67,0.373,12,29,0.414,20,26,0.769,106,2015-10-27,ATL,DET,2016,112.0
9745,9745,45,@,L 94-104 ,240,33,84,0.393,27,60,0.45,6,24,0.25,22,29,0.759,94,36,73,0.493,24,53,0.453,12,20,0.6,20,21,0.952,104,2015-10-28,CHA,MIA,2016,110.0
9746,9746,46,@,L 94-112 ,240,36,91,0.396,25,58,0.431,11,33,0.333,11,18,0.611,94,44,88,0.5,32,56,0.571,12,32,0.375,12,14,0.857,112,2015-10-28,NOP,POR,2016,118.0
9747,9747,47,@,L 94-97 ,240,36,88,0.409,24,58,0.414,12,30,0.4,10,13,0.769,94,36,83,0.434,28,60,0.467,8,23,0.348,17,22,0.773,97,2015-10-30,CHA,ATL,2016,101.0
9748,9748,48,@,L 94-98 (OT),265,34,84,0.405,27,62,0.435,7,22,0.318,19,26,0.731,94,39,104,0.375,33,76,0.434,6,28,0.214,14,28,0.5,98,2015-10-30,CHI,DET,2016,101.0
9749,9749,49,@,W 94-92 ,240,37,88,0.42,30,59,0.508,7,29,0.241,13,14,0.929,94,32,86,0.372,18,49,0.367,14,37,0.378,14,15,0.933,92,2015-11-01,ATL,CHO,2016,99.0
9750,9750,50,@,W 94-84 ,240,39,79,0.494,35,66,0.53,4,13,0.308,12,17,0.706,94,32,89,0.36,28,76,0.368,4,13,0.308,16,21,0.762,84,2015-11-02,SAS,NYK,2016,86.0
9751,9751,51,@,W 94-82 ,240,38,88,0.432,31,65,0.477,7,23,0.304,11,12,0.917,94,33,86,0.384,28,64,0.438,5,22,0.227,11,17,0.647,82,2015-11-03,IND,DET,2016,84.5
9752,9752,52,Home,L 94-103 ,240,32,90,0.356,20,54,0.37,12,36,0.333,18,25,0.72,94,42,90,0.467,35,72,0.486,7,18,0.389,12,12,1.0,103,2015-11-03,NOP,ORL,2016,106.5
9753,9753,53,Home,L 94-108 ,240,32,82,0.39,26,53,0.491,6,29,0.207,24,27,0.889,94,44,89,0.494,38,62,0.613,6,27,0.222,14,17,0.824,108,2015-11-05,DAL,CHO,2016,111.0
9754,9754,54,Home,W 94-86 ,240,37,82,0.451,29,62,0.468,8,20,0.4,12,16,0.75,94,34,82,0.415,31,73,0.425,3,9,0.333,15,19,0.789,86,2015-11-07,MIL,BRK,2016,87.5
9755,9755,55,Home,L 94-103 ,240,38,87,0.437,32,68,0.471,6,19,0.316,12,16,0.75,94,38,92,0.413,30,53,0.566,8,39,0.205,19,22,0.864,103,2015-11-07,SAC,GSW,2016,107.0
9756,9756,56,@,L 94-114 ,240,34,73,0.466,28,54,0.519,6,19,0.316,20,31,0.645,94,45,81,0.556,36,60,0.6,9,21,0.429,15,23,0.652,114,2015-11-07,CHA,SAS,2016,118.5
9757,9757,57,Home,W 94-92 ,240,28,68,0.412,23,49,0.469,5,19,0.263,33,37,0.892,94,35,80,0.438,33,69,0.478,2,11,0.182,20,29,0.69,92,2015-11-09,LAC,MEM,2016,93.0
9758,9758,58,@,L 94-106 ,240,35,89,0.393,30,68,0.441,5,21,0.238,19,21,0.905,94,41,83,0.494,32,52,0.615,9,31,0.29,15,19,0.789,106,2015-11-15,POR,CHO,2016,110.5
9759,9759,59,@,L 94-102 ,240,36,82,0.439,31,62,0.5,5,20,0.25,17,25,0.68,94,36,89,0.404,26,69,0.377,10,20,0.5,20,21,0.952,102,2015-11-17,CHA,NYK,2016,107.0
9760,9760,60,@,L 94-106 ,240,35,88,0.398,28,66,0.424,7,22,0.318,17,23,0.739,94,39,79,0.494,29,50,0.58,10,29,0.345,18,24,0.75,106,2015-11-20,CHI,GSW,2016,111.0
9761,9761,61,Home,L 94-111 ,240,31,78,0.397,23,53,0.434,8,25,0.32,24,29,0.828,94,37,79,0.468,29,59,0.492,8,20,0.4,29,47,0.617,111,2015-11-24,DEN,LAC,2016,115.0
9762,9762,62,Home,W 94-91 ,240,41,84,0.488,37,71,0.521,4,13,0.308,8,12,0.667,94,33,75,0.44,23,47,0.489,10,28,0.357,15,22,0.682,91,2015-12-01,BRK,PHO,2016,96.0
9763,9763,63,Home,L 94-103 ,240,31,72,0.431,17,39,0.436,14,33,0.424,18,24,0.75,94,40,89,0.449,32,66,0.485,8,23,0.348,15,15,1.0,103,2015-12-03,UTA,ORL,2016,107.0
9764,9764,64,@,L 94-97 ,240,34,76,0.447,27,51,0.529,7,25,0.28,19,24,0.792,94,37,64,0.578,34,54,0.63,3,10,0.3,20,22,0.909,97,2015-12-09,SAS,TOR,2016,98.5
9765,9765,65,@,L 94-107 ,240,35,78,0.449,25,50,0.5,10,28,0.357,14,23,0.609,94,39,80,0.488,30,63,0.476,9,17,0.529,20,26,0.769,107,2015-12-10,ATL,OKC,2016,111.5
9766,9766,66,@,W 94-90 ,240,37,79,0.468,31,62,0.5,6,17,0.353,14,16,0.875,94,33,78,0.423,25,50,0.5,8,28,0.286,16,24,0.667,90,2015-12-11,OKC,UTA,2016,94.0
9767,9767,67,@,L 94-98 ,240,40,89,0.449,34,73,0.466,6,16,0.375,8,11,0.727,94,33,78,0.423,25,58,0.431,8,20,0.4,24,29,0.828,98,2015-12-12,NOP,CHI,2016,102.0
9768,9768,68,@,L 94-104 ,240,33,80,0.413,24,55,0.436,9,25,0.36,19,27,0.704,94,38,77,0.494,26,45,0.578,12,32,0.375,16,21,0.762,104,2015-12-14,PHO,DAL,2016,110.0
9769,9769,69,Home,L 94-104 ,240,32,67,0.478,25,47,0.532,7,20,0.35,23,29,0.793,94,34,73,0.466,24,52,0.462,10,21,0.476,26,28,0.929,104,2015-12-16,UTA,NOP,2016,109.0
9770,9770,70,Home,L 94-108 ,240,35,74,0.473,26,49,0.531,9,25,0.36,15,17,0.882,94,41,80,0.513,33,59,0.559,8,21,0.381,18,22,0.818,108,2015-12-18,MIA,TOR,2016,112.0
9771,9771,71,@,L 94-102 ,240,32,73,0.438,21,41,0.512,11,32,0.344,19,26,0.731,94,39,84,0.464,37,69,0.536,2,15,0.133,22,31,0.71,102,2015-12-18,POR,ORL,2016,103.0
9772,9772,72,Home,L 94-104 ,240,35,94,0.372,27,65,0.415,8,29,0.276,16,17,0.941,94,40,76,0.526,31,55,0.564,9,21,0.429,15,24,0.625,104,2015-12-20,TOR,SAC,2016,108.5
9773,9773,73,@,W 94-84 ,240,38,85,0.447,28,59,0.475,10,26,0.385,8,11,0.727,94,32,77,0.416,25,54,0.463,7,23,0.304,13,25,0.52,84,2015-12-25,LAC,LAL,2016,87.5
9774,9774,74,Home,W 94-88 (OT),265,35,88,0.398,29,62,0.468,6,26,0.231,18,27,0.667,94,36,90,0.4,30,70,0.429,6,20,0.3,10,11,0.909,88,2015-12-25,MIA,NOP,2016,91.0
9775,9775,75,Home,L 94-98 ,240,30,76,0.395,21,52,0.404,9,24,0.375,25,31,0.806,94,38,92,0.413,28,59,0.475,10,33,0.303,12,16,0.75,98,2015-12-27,SAC,POR,2016,103.0
9776,9776,76,Home,W 94-80 ,240,36,77,0.468,31,67,0.463,5,10,0.5,17,27,0.63,94,28,80,0.35,18,41,0.439,10,39,0.256,14,20,0.7,80,2015-12-30,MIN,UTA,2016,85.0
9777,9777,77,Home,W 94-91 ,240,28,82,0.341,22,58,0.379,6,24,0.25,32,39,0.821,94,35,87,0.402,27,65,0.415,8,22,0.364,13,17,0.765,91,2015-12-30,TOR,WAS,2016,95.0
9778,9778,78,@,L 94-104 ,240,34,85,0.4,24,53,0.453,10,32,0.313,16,18,0.889,94,36,91,0.396,21,58,0.362,15,33,0.455,17,18,0.944,104,2016-01-01,CHA,TOR,2016,111.5
9779,9779,79,Home,W 94-82 ,240,33,73,0.452,26,55,0.473,7,18,0.389,21,29,0.724,94,33,93,0.355,30,73,0.411,3,20,0.15,13,23,0.565,82,2016-01-02,IND,DET,2016,83.5
9780,9780,80,Home,L 94-103 ,240,32,85,0.376,26,57,0.456,6,28,0.214,24,27,0.889,94,41,92,0.446,35,71,0.493,6,21,0.286,15,19,0.789,103,2016-01-04,BRK,BOS,2016,106.0
9781,9781,81,Home,L 94-99 ,240,34,91,0.374,28,63,0.444,6,28,0.214,20,27,0.741,94,33,74,0.446,23,47,0.489,10,27,0.37,23,36,0.639,99,2016-01-06,BOS,DET,2016,104.0
9782,9782,82,@,L 94-112 ,240,35,90,0.389,28,69,0.406,7,21,0.333,17,24,0.708,94,38,83,0.458,30,66,0.455,8,17,0.471,28,33,0.848,112,2016-01-06,MEM,OKC,2016,116.0
9783,9783,83,@,L 94-103 ,240,38,78,0.487,31,50,0.62,7,28,0.25,11,17,0.647,94,39,75,0.52,32,52,0.615,7,23,0.304,18,26,0.692,103,2016-01-07,UTA,HOU,2016,106.5
9784,9784,84,@,L 94-103 ,240,37,91,0.407,32,61,0.525,5,30,0.167,15,20,0.75,94,40,90,0.444,31,64,0.484,9,26,0.346,14,20,0.7,103,2016-01-13,IND,BOS,2016,107.5
9785,9785,85,Home,L 94-97 ,240,28,81,0.346,17,46,0.37,11,35,0.314,27,29,0.931,94,34,83,0.41,30,63,0.476,4,20,0.2,25,34,0.735,97,2016-01-19,PHO,IND,2016,99.0
9786,9786,86,Home,L 94-125 ,240,37,100,0.37,36,80,0.45,1,20,0.05,19,24,0.792,94,50,95,0.526,38,63,0.603,12,32,0.375,13,20,0.65,125,2016-01-20,CHI,GSW,2016,131.0
9787,9787,87,@,L 94-106 (OT),265,40,91,0.44,35,68,0.515,5,23,0.217,9,11,0.818,94,42,97,0.433,37,72,0.514,5,25,0.2,17,22,0.773,106,2016-01-20,MIN,DAL,2016,108.5
9788,9788,88,@,L 94-112 ,240,34,76,0.447,26,50,0.52,8,26,0.308,18,30,0.6,94,41,83,0.494,29,61,0.475,12,22,0.545,18,26,0.692,112,2016-01-24,LAC,TOR,2016,118.0
9789,9789,89,@,L 94-113 ,240,32,79,0.405,25,59,0.424,7,20,0.35,23,29,0.793,94,43,86,0.5,33,62,0.532,10,24,0.417,17,21,0.81,113,2016-01-29,ORL,BOS,2016,118.0
9790,9790,90,@,L 94-106 ,240,37,87,0.425,28,61,0.459,9,26,0.346,11,14,0.786,94,44,84,0.524,38,62,0.613,6,22,0.273,12,20,0.6,106,2016-02-05,PHI,WAS,2016,109.0
9791,9791,91,@,L 94-96 ,240,35,91,0.385,22,63,0.349,13,28,0.464,11,15,0.733,94,39,85,0.459,32,60,0.533,7,25,0.28,11,12,0.917,96,2016-02-07,ATL,ORL,2016,99.5
9792,9792,92,@,L 94-114 ,240,40,99,0.404,37,77,0.481,3,22,0.136,11,21,0.524,94,47,96,0.49,45,83,0.542,2,13,0.154,18,28,0.643,114,2016-02-20,WAS,MIA,2016,115.0
9793,9793,93,Home,L 94-103 ,240,35,82,0.427,27,57,0.474,8,25,0.32,16,21,0.762,94,40,94,0.426,33,71,0.465,7,23,0.304,16,17,0.941,103,2016-02-26,PHI,WAS,2016,106.5
9794,9794,94,Home,L 94-104 ,240,35,84,0.417,27,59,0.458,8,25,0.32,16,22,0.727,94,37,76,0.487,29,57,0.509,8,19,0.421,22,28,0.786,104,2016-02-27,HOU,SAS,2016,108.0
9795,9795,95,@,L 94-104 ,240,37,83,0.446,27,57,0.474,10,26,0.385,10,16,0.625,94,40,80,0.5,34,58,0.586,6,22,0.273,18,21,0.857,104,2016-03-02,UTA,TOR,2016,107.0
9796,9796,96,@,W 94-86 ,240,36,81,0.444,28,60,0.467,8,21,0.381,14,15,0.933,94,35,89,0.393,27,65,0.415,8,24,0.333,8,8,1.0,86,2016-03-03,SAS,NOP,2016,90.0
9797,9797,97,Home,W 94-88 ,240,37,81,0.457,33,63,0.524,4,18,0.222,16,19,0.842,94,32,75,0.427,27,56,0.482,5,19,0.263,19,29,0.655,88,2016-03-04,MEM,UTA,2016,90.5
9798,9798,98,Home,L 94-106 ,240,38,92,0.413,29,73,0.397,9,19,0.474,9,11,0.818,94,37,78,0.474,31,58,0.534,6,20,0.3,26,27,0.963,106,2016-03-05,NOP,UTA,2016,109.0
9799,9799,99,@,L 94-104 ,240,37,81,0.457,31,65,0.477,6,16,0.375,14,21,0.667,94,40,81,0.494,32,58,0.552,8,23,0.348,16,19,0.842,104,2016-03-05,SAC,SAS,2016,108.0
9800,9800,0,@,L 94-110 ,240,33,75,0.44,27,57,0.474,6,18,0.333,22,26,0.846,94,45,99,0.455,39,78,0.5,6,21,0.286,14,19,0.737,110,2016-03-08,NYK,DEN,2016,113.0
9801,9801,1,@,L 94-115 ,240,32,79,0.405,24,59,0.407,8,20,0.4,22,31,0.71,94,48,84,0.571,35,54,0.648,13,30,0.433,6,10,0.6,115,2016-03-09,UTA,GSW,2016,121.5
9802,9802,2,@,L 94-101 ,240,34,83,0.41,30,63,0.476,4,20,0.2,22,25,0.88,94,38,85,0.447,25,56,0.446,13,29,0.448,12,16,0.75,101,2016-03-11,NYK,LAC,2016,107.5
9803,9803,3,@,L 94-128 ,240,31,91,0.341,24,64,0.375,7,27,0.259,25,27,0.926,94,49,83,0.59,40,66,0.606,9,17,0.529,21,26,0.808,128,2016-03-14,POR,OKC,2016,132.5
9804,9804,4,Home,W 94-85 ,240,35,71,0.493,23,44,0.523,12,27,0.444,12,14,0.857,94,35,88,0.398,25,45,0.556,10,43,0.233,5,8,0.625,85,2016-03-14,UTA,CLE,2016,90.0
9805,9805,5,Home,L 94-101 (OT),265,35,91,0.385,27,63,0.429,8,28,0.286,16,23,0.696,94,32,88,0.364,25,66,0.379,7,22,0.318,30,38,0.789,101,2016-03-17,IND,TOR,2016,104.5
9806,9806,6,Home,L 94-99 ,240,35,91,0.385,29,58,0.5,6,33,0.182,18,26,0.692,94,40,90,0.444,34,63,0.54,6,27,0.222,13,19,0.684,99,2016-03-17,PHI,WAS,2016,102.0
9807,9807,7,@,W 94-85 ,240,34,83,0.41,21,45,0.467,13,38,0.342,13,14,0.929,94,34,65,0.523,31,57,0.544,3,8,0.375,14,17,0.824,85,2016-03-20,UTA,MIL,2016,86.5
9808,9808,8,@,L 94-96 ,240,32,80,0.4,26,56,0.464,6,24,0.25,24,32,0.75,94,37,82,0.451,33,63,0.524,4,19,0.211,18,28,0.643,96,2016-03-24,POR,LAC,2016,98.0
9809,9809,9,@,L 94-106 ,240,37,89,0.416,31,64,0.484,6,25,0.24,14,18,0.778,94,39,76,0.513,26,46,0.565,13,30,0.433,15,16,0.938,106,2016-03-24,CHI,NYK,2016,112.5
9810,9810,10,@,L 94-116 ,240,35,94,0.372,26,62,0.419,9,32,0.281,15,23,0.652,94,40,90,0.444,33,68,0.485,7,22,0.318,29,39,0.744,116,2016-03-25,PHO,SAC,2016,119.5
9811,9811,11,@,L 94-102 ,240,36,86,0.419,31,63,0.492,5,23,0.217,17,27,0.63,94,38,87,0.437,27,62,0.435,11,25,0.44,15,23,0.652,102,2016-03-29,WAS,GSW,2016,107.5
9812,9812,12,@,L 94-105 ,240,38,84,0.452,33,60,0.55,5,24,0.208,13,17,0.765,94,37,77,0.481,31,62,0.5,6,15,0.4,25,34,0.735,105,2016-03-30,PHO,MIL,2016,108.0
9813,9813,13,Home,L 94-114 ,240,36,86,0.419,29,67,0.433,7,19,0.368,15,21,0.714,94,48,90,0.533,43,74,0.581,5,16,0.313,13,18,0.722,114,2016-03-31,IND,ORL,2016,116.5
9814,9814,14,@,W 94-90 ,240,32,76,0.421,22,56,0.393,10,20,0.5,20,34,0.588,94,34,88,0.386,25,63,0.397,9,25,0.36,13,15,0.867,90,2016-04-02,DET,CHI,2016,94.5
9815,9815,15,@,L 94-109 ,240,39,87,0.448,31,57,0.544,8,30,0.267,8,15,0.533,94,40,83,0.482,29,54,0.537,11,29,0.379,18,20,0.9,109,2016-04-11,ATL,CLE,2016,114.5
9816,9816,16,Home,L 94-113 ,240,36,77,0.468,32,61,0.525,4,16,0.25,18,27,0.667,94,44,86,0.512,38,65,0.585,6,21,0.286,19,26,0.731,113,2016-10-26,PHO,SAC,2017,116.0
9817,9817,17,Home,L 94-102 ,240,28,70,0.4,22,50,0.44,6,20,0.3,32,38,0.842,94,36,79,0.456,30,61,0.492,6,18,0.333,24,27,0.889,102,2016-10-27,SAC,SAS,2017,105.0
9818,9818,18,@,L 94-103 ,240,37,98,0.378,30,74,0.405,7,24,0.292,13,20,0.65,94,38,87,0.437,28,54,0.519,10,33,0.303,17,20,0.85,103,2016-10-28,IND,BRK,2017,108.0
9819,9819,19,@,W 94-91 ,240,33,79,0.418,21,47,0.447,12,32,0.375,16,22,0.727,94,35,90,0.389,31,74,0.419,4,16,0.25,17,18,0.944,91,2016-10-28,CLE,TOR,2017,93.0
9820,9820,20,@,L 94-102 ,240,38,80,0.475,31,62,0.5,7,18,0.389,11,17,0.647,94,38,84,0.452,28,54,0.519,10,30,0.333,16,23,0.696,102,2016-11-03,SAC,ORL,2017,107.0
9821,9821,21,@,L 94-111 ,240,34,79,0.43,28,61,0.459,6,18,0.333,20,25,0.8,94,46,86,0.535,34,60,0.567,12,26,0.462,7,12,0.583,111,2016-11-05,CHI,IND,2017,117.0
9822,9822,22,Home,L 94-100 ,240,31,81,0.383,25,55,0.455,6,26,0.231,26,32,0.813,94,32,71,0.451,18,38,0.474,14,33,0.424,22,27,0.815,100,2016-11-06,MEM,POR,2017,107.0
9823,9823,23,@,L 94-102 ,240,38,84,0.452,33,63,0.524,5,21,0.238,13,18,0.722,94,39,81,0.481,31,56,0.554,8,25,0.32,16,20,0.8,102,2016-11-08,NOP,SAC,2017,106.0
9824,9824,24,Home,L 94-105 ,240,38,87,0.437,35,72,0.486,3,15,0.2,15,19,0.789,94,36,86,0.419,22,53,0.415,14,33,0.424,19,26,0.731,105,2016-11-11,WAS,CLE,2017,112.0
9825,9825,25,Home,W 94-90 ,240,33,82,0.402,25,67,0.373,8,15,0.533,20,27,0.741,94,37,84,0.44,33,69,0.478,4,15,0.267,12,21,0.571,90,2016-11-14,SAS,MIA,2017,92.0
9826,9826,26,@,W 94-92 ,240,33,82,0.402,21,51,0.412,12,31,0.387,16,17,0.941,94,37,86,0.43,30,66,0.455,7,20,0.35,11,16,0.688,92,2016-11-19,BOS,DET,2017,95.5
9827,9827,27,@,L 94-104 ,240,34,85,0.4,28,64,0.438,6,21,0.286,20,29,0.69,94,42,88,0.477,32,61,0.525,10,27,0.37,10,14,0.714,104,2016-11-20,ATL,NYK,2017,109.0
9828,9828,28,@,L 94-101 ,240,34,88,0.386,27,57,0.474,7,31,0.226,19,28,0.679,94,37,78,0.474,26,52,0.5,11,26,0.423,16,20,0.8,101,2016-11-21,MIA,PHI,2017,106.5
9829,9829,29,Home,L 94-112 ,240,39,85,0.459,29,56,0.518,10,29,0.345,6,10,0.6,94,45,86,0.523,34,61,0.557,11,25,0.44,11,12,0.917,112,2016-11-22,ATL,NOP,2017,117.5
9830,9830,30,@,W 94-91 ,240,40,88,0.455,34,59,0.576,6,29,0.207,8,10,0.8,94,35,80,0.438,28,57,0.491,7,23,0.304,14,20,0.7,91,2016-11-25,WAS,ORL,2017,94.5
9831,9831,31,@,L 94-109 ,240,39,88,0.443,27,53,0.509,12,35,0.343,4,10,0.4,94,42,95,0.442,34,75,0.453,8,20,0.4,17,20,0.85,109,2016-11-27,ATL,LAL,2017,113.0
9832,9832,32,@,W 94-87 ,240,33,71,0.465,22,52,0.423,11,19,0.579,17,24,0.708,94,33,77,0.429,23,47,0.489,10,30,0.333,11,14,0.786,87,2016-11-30,SAS,DAL,2017,92.0
9833,9833,33,Home,L 94-113 ,240,28,69,0.406,19,45,0.422,9,24,0.375,29,39,0.744,94,42,89,0.472,29,58,0.5,13,31,0.419,16,24,0.667,113,2016-12-01,CLE,LAC,2017,119.5
9834,9834,34,@,L 94-95 ,240,33,74,0.446,27,50,0.54,6,24,0.25,22,31,0.71,94,33,79,0.418,26,61,0.426,7,18,0.389,22,28,0.786,95,2016-12-01,ORL,MEM,2017,98.5
9835,9835,35,Home,L 94-126 ,240,35,87,0.402,24,56,0.429,11,31,0.355,13,15,0.867,94,39,80,0.488,17,40,0.425,22,40,0.55,26,31,0.839,126,2016-12-07,NYK,CLE,2017,137.0
9836,9836,36,Home,L 94-109 ,240,34,85,0.4,25,52,0.481,9,33,0.273,17,18,0.944,94,35,78,0.449,28,55,0.509,7,23,0.304,32,41,0.78,109,2016-12-07,PHO,IND,2017,112.5
9837,9837,37,Home,L 94-101 ,240,31,83,0.373,14,41,0.341,17,42,0.405,15,22,0.682,94,34,82,0.415,25,62,0.403,9,20,0.45,24,27,0.889,101,2016-12-09,BOS,TOR,2017,105.5
9838,9838,38,@,L 94-110 ,240,28,84,0.333,18,58,0.31,10,26,0.385,28,32,0.875,94,43,88,0.489,26,52,0.5,17,36,0.472,7,10,0.7,110,2016-12-12,CHA,IND,2017,118.5
9839,9839,39,Home,L 94-99 ,240,38,87,0.437,34,72,0.472,4,15,0.267,14,19,0.737,94,38,86,0.442,32,65,0.492,6,21,0.286,17,22,0.773,99,2016-12-13,CHI,MIN,2017,102.0
9840,9840,40,@,W 94-93 ,240,34,74,0.459,24,53,0.453,10,21,0.476,16,24,0.667,94,33,74,0.446,24,47,0.511,9,27,0.333,18,22,0.818,93,2016-12-21,SAC,UTA,2017,97.5
9841,9841,41,Home,L 94-106 ,240,36,82,0.439,29,59,0.492,7,23,0.304,15,21,0.714,94,42,82,0.512,37,63,0.587,5,19,0.263,17,25,0.68,106,2016-12-27,MIA,OKC,2017,108.5
9842,9842,42,Home,L 94-119 ,240,39,88,0.443,33,64,0.516,6,24,0.25,10,16,0.625,94,48,84,0.571,37,62,0.597,11,22,0.5,12,16,0.75,119,2016-12-28,DET,MIL,2017,124.5
9843,9843,43,@,L 94-110 ,240,35,77,0.455,29,57,0.509,6,20,0.3,18,21,0.857,94,39,78,0.5,28,56,0.5,11,22,0.5,21,25,0.84,110,2016-12-30,POR,SAS,2017,115.5
9844,9844,44,@,L 94-98 ,240,36,78,0.462,27,51,0.529,9,27,0.333,13,19,0.684,94,38,79,0.481,31,60,0.517,7,19,0.368,15,24,0.625,98,2017-01-02,OKC,MIL,2017,101.5
9845,9845,45,Home,L 94-106 ,240,34,83,0.41,26,58,0.448,8,25,0.32,18,24,0.75,94,41,85,0.482,28,55,0.509,13,30,0.433,11,15,0.733,106,2017-01-04,CLE,CHI,2017,112.5
9846,9846,46,Home,L 94-99 ,240,34,93,0.366,19,58,0.328,15,35,0.429,11,14,0.786,94,38,90,0.422,29,67,0.433,9,23,0.391,14,17,0.824,99,2017-01-05,NOP,ATL,2017,103.5
9847,9847,47,@,W 94-92 ,240,32,77,0.416,24,54,0.444,8,23,0.348,22,28,0.786,94,35,80,0.438,28,60,0.467,7,20,0.35,15,21,0.714,92,2017-01-07,UTA,MIN,2017,95.5
9848,9848,48,Home,L 94-109 ,240,34,83,0.41,27,64,0.422,7,19,0.368,19,22,0.864,94,47,83,0.566,40,59,0.678,7,24,0.292,8,11,0.727,109,2017-01-09,CHI,OKC,2017,112.5
9849,9849,49,@,L 94-100 ,240,36,82,0.439,24,55,0.436,12,27,0.444,10,16,0.625,94,32,73,0.438,19,50,0.38,13,23,0.565,23,29,0.793,100,2017-01-10,DET,SAC,2017,106.5
9850,9850,50,@,L 94-134 ,240,35,85,0.412,29,65,0.446,6,20,0.3,18,25,0.72,94,49,81,0.605,39,60,0.65,10,21,0.476,26,29,0.897,134,2017-01-12,LAL,SAS,2017,139.0
9851,9851,51,Home,W 94-89 ,240,31,69,0.449,23,45,0.511,8,24,0.333,24,32,0.75,94,34,86,0.395,28,62,0.452,6,24,0.25,15,23,0.652,89,2017-01-18,PHI,TOR,2017,92.0
9852,9852,52,Home,L 94-107 ,240,38,84,0.452,28,52,0.538,10,32,0.313,8,15,0.533,94,45,89,0.506,35,68,0.515,10,21,0.476,7,10,0.7,107,2017-01-29,NOP,WAS,2017,112.0
9853,9853,53,@,L 94-108 ,240,30,85,0.353,23,57,0.404,7,28,0.25,27,32,0.844,94,37,86,0.43,30,65,0.462,7,21,0.333,27,38,0.711,108,2017-01-31,OKC,SAS,2017,111.5
9854,9854,54,@,L 94-102 ,240,34,87,0.391,24,59,0.407,10,28,0.357,16,21,0.762,94,37,80,0.463,32,66,0.485,5,14,0.357,23,32,0.719,102,2017-02-03,TOR,ORL,2017,104.5
9855,9855,55,Home,L 94-127 ,240,35,77,0.455,30,53,0.566,5,24,0.208,19,25,0.76,94,48,88,0.545,34,56,0.607,14,32,0.438,17,21,0.81,127,2017-02-08,NOP,UTA,2017,134.0
9856,9856,56,Home,W 94-90 ,240,34,68,0.5,25,54,0.463,9,14,0.643,17,21,0.81,94,33,91,0.363,27,62,0.435,6,29,0.207,18,22,0.818,90,2017-02-12,NYK,SAS,2017,93.0
9857,9857,57,@,L 94-105 ,240,35,77,0.455,30,57,0.526,5,20,0.25,19,24,0.792,94,35,73,0.479,28,56,0.5,7,17,0.412,28,35,0.8,105,2017-02-14,TOR,CHI,2017,108.5
9858,9858,58,Home,W 94-87 ,240,36,82,0.439,31,63,0.492,5,19,0.263,17,21,0.81,94,34,88,0.386,28,58,0.483,6,30,0.2,13,14,0.929,87,2017-03-02,CHI,GSW,2017,90.0
9859,9859,59,@,L 94-101 ,240,35,75,0.467,28,54,0.519,7,21,0.333,17,20,0.85,94,38,87,0.437,32,60,0.533,6,27,0.222,19,23,0.826,101,2017-03-04,TOR,MIL,2017,104.0
9860,9860,60,@,W 94-87 ,240,36,76,0.474,28,55,0.509,8,21,0.381,14,23,0.609,94,34,80,0.425,25,51,0.49,9,29,0.31,10,13,0.769,87,2017-03-08,TOR,NOP,2017,91.5
9861,9861,61,Home,L 93-115 ,240,32,76,0.421,24,49,0.49,8,27,0.296,21,27,0.778,93,39,79,0.494,29,52,0.558,10,27,0.37,27,34,0.794,115,2011-12-26,DAL,DEN,2012,120.0
9862,9862,62,@,L 93-113 ,240,34,79,0.43,23,50,0.46,11,29,0.379,14,18,0.778,93,45,80,0.563,45,75,0.6,0,5,0.0,23,33,0.697,113,2011-12-30,HOU,MEM,2012,113.0
9863,9863,63,@,W 93-78 ,240,33,78,0.423,26,55,0.473,7,23,0.304,20,22,0.909,93,26,90,0.289,23,76,0.303,3,14,0.214,23,28,0.821,78,2011-12-30,PHO,NOH,2012,79.5
9864,9864,64,Home,W 93-88 ,240,36,75,0.48,30,51,0.588,6,24,0.25,15,24,0.625,93,33,78,0.423,29,63,0.46,4,15,0.267,18,22,0.818,88,2012-01-01,LAC,POR,2012,90.0
9865,9865,65,Home,L 93-103 ,240,36,83,0.434,31,63,0.492,5,20,0.25,16,21,0.762,93,34,76,0.447,28,61,0.459,6,15,0.4,29,36,0.806,103,2012-01-03,OKC,POR,2012,106.0
9866,9866,66,Home,L 93-101 ,240,35,79,0.443,32,69,0.464,3,10,0.3,20,25,0.8,93,41,86,0.477,37,70,0.529,4,16,0.25,15,18,0.833,101,2012-01-04,NOP,PHI,2012,103.0
9867,9867,67,Home,W 93-71 ,240,34,86,0.395,18,53,0.34,16,33,0.485,9,16,0.563,93,27,77,0.351,26,58,0.448,1,19,0.053,16,21,0.762,71,2012-01-05,SAS,DAL,2012,71.5
9868,9868,68,@,L 93-109 ,240,37,86,0.43,34,71,0.479,3,15,0.2,16,24,0.667,93,43,77,0.558,33,55,0.6,10,22,0.455,13,17,0.765,109,2012-01-08,MIL,PHO,2012,114.0
9869,9869,69,@,W 93-72 ,240,36,80,0.45,26,54,0.481,10,26,0.385,11,15,0.733,93,30,87,0.345,27,77,0.351,3,10,0.3,9,16,0.563,72,2012-01-08,MIN,WAS,2012,73.5
9870,9870,70,Home,W 93-78 ,240,40,82,0.488,36,69,0.522,4,13,0.308,9,17,0.529,93,30,76,0.395,26,56,0.464,4,20,0.2,14,17,0.824,78,2012-01-10,WAS,TOR,2012,80.0
9871,9871,71,@,L 93-102 ,240,33,74,0.446,30,69,0.435,3,5,0.6,24,24,1.0,93,37,78,0.474,26,56,0.464,11,22,0.5,17,17,1.0,102,2012-01-12,DET,MIL,2012,107.5
9872,9872,72,Home,W 93-91 ,240,32,78,0.41,25,57,0.439,7,21,0.333,22,27,0.815,93,38,85,0.447,34,64,0.531,4,21,0.19,11,12,0.917,91,2012-01-14,ATL,MIN,2012,93.0
9873,9873,73,Home,W 93-84 ,240,32,71,0.451,27,58,0.466,5,13,0.385,24,31,0.774,93,33,78,0.423,30,66,0.455,3,12,0.25,15,22,0.682,84,2012-01-16,ATL,TOR,2012,85.5
9874,9874,74,Home,L 93-102 ,240,30,73,0.411,25,53,0.472,5,20,0.25,28,33,0.848,93,36,71,0.507,19,36,0.528,17,35,0.486,13,22,0.591,102,2012-01-16,NYK,ORL,2012,110.5
9875,9875,75,Home,W 93-85 ,240,30,75,0.4,22,52,0.423,8,23,0.348,25,34,0.735,93,35,79,0.443,30,68,0.441,5,11,0.455,10,21,0.476,85,2012-01-18,MIN,DET,2012,87.5
9876,9876,76,@,W 93-87 ,240,36,73,0.493,30,59,0.508,6,14,0.429,15,17,0.882,93,34,70,0.486,29,58,0.5,5,12,0.417,14,16,0.875,87,2012-01-18,MEM,NOH,2012,89.5
9877,9877,77,Home,W 93-87 ,240,33,81,0.407,25,56,0.446,8,25,0.32,19,29,0.655,93,31,83,0.373,25,63,0.397,6,20,0.3,19,22,0.864,87,2012-01-23,DAL,PHO,2012,90.0
9878,9878,78,@,L 93-101 ,240,34,83,0.41,26,62,0.419,8,21,0.381,17,20,0.85,93,41,79,0.519,30,59,0.508,11,20,0.55,8,14,0.571,101,2012-01-25,POR,GSW,2012,106.5
9879,9879,79,Home,L 93-122 ,240,34,78,0.436,25,58,0.431,9,20,0.45,16,22,0.727,93,50,91,0.549,48,78,0.615,2,13,0.154,20,25,0.8,122,2012-01-25,SAC,DEN,2012,123.0
9880,9880,80,Home,W 93-67 ,240,41,81,0.506,36,67,0.537,5,14,0.357,6,16,0.375,93,24,61,0.393,18,40,0.45,6,21,0.286,13,21,0.619,67,2012-01-27,NOP,ORL,2012,70.0
9881,9881,81,@,L 93-96 ,240,37,80,0.463,31,67,0.463,6,13,0.462,13,14,0.929,93,35,79,0.443,28,61,0.459,7,18,0.389,19,23,0.826,96,2012-01-28,SAC,UTA,2012,99.5
9882,9882,82,@,L 93-97 ,240,35,81,0.432,32,70,0.457,3,11,0.273,20,28,0.714,93,32,78,0.41,29,70,0.414,3,8,0.375,30,40,0.75,97,2012-01-29,CHI,MIA,2012,98.5
9883,9883,83,Home,W 93-89 ,240,32,84,0.381,29,72,0.403,3,12,0.25,26,38,0.684,93,37,80,0.463,32,60,0.533,5,20,0.25,10,13,0.769,89,2012-01-30,UTA,POR,2012,91.5
9884,9884,84,@,W 93-90 ,240,37,73,0.507,32,59,0.542,5,14,0.357,14,19,0.737,93,34,75,0.453,27,58,0.466,7,17,0.412,15,21,0.714,90,2012-01-31,BOS,CLE,2012,93.5
9885,9885,85,Home,W 93-90 ,240,37,91,0.407,29,67,0.433,8,24,0.333,11,13,0.846,93,35,82,0.427,29,66,0.439,6,16,0.375,14,19,0.737,90,2012-01-31,GSW,SAC,2012,93.0
9886,9886,86,Home,W 93-81 ,240,34,74,0.459,30,55,0.545,4,19,0.211,21,27,0.778,93,33,74,0.446,30,66,0.455,3,8,0.375,12,16,0.75,81,2012-02-02,SAS,NOH,2012,82.5
9887,9887,87,@,W 93-89 ,240,37,78,0.474,33,65,0.508,4,13,0.308,15,25,0.6,93,33,75,0.44,28,52,0.538,5,23,0.217,18,23,0.783,89,2012-02-03,LAL,DEN,2012,91.5
9888,9888,88,Home,L 93-107 ,240,38,83,0.458,36,66,0.545,2,17,0.118,15,19,0.789,93,37,81,0.457,30,53,0.566,7,28,0.25,26,33,0.788,107,2012-02-08,WAS,NYK,2012,110.5
9889,9889,89,Home,W 93-83 ,240,35,73,0.479,30,64,0.469,5,9,0.556,18,21,0.857,93,30,78,0.385,27,68,0.397,3,10,0.3,20,24,0.833,83,2012-02-14,MEM,HOU,2012,84.5
9890,9890,90,@,W 93-91 ,240,34,84,0.405,24,62,0.387,10,22,0.455,15,17,0.882,93,36,76,0.474,29,57,0.509,7,19,0.368,12,16,0.75,91,2012-02-15,POR,GSW,2012,94.5
9891,9891,91,Home,W 93-88 ,240,32,81,0.395,25,62,0.403,7,19,0.368,22,26,0.846,93,35,75,0.467,31,58,0.534,4,17,0.235,14,16,0.875,88,2012-02-16,IND,NJN,2012,90.0
9892,9892,92,Home,W 93-92 ,240,32,89,0.36,25,67,0.373,7,22,0.318,22,30,0.733,93,35,93,0.376,31,74,0.419,4,19,0.211,18,25,0.72,92,2012-02-19,CLE,SAC,2012,94.0
9893,9893,93,@,L 93-97 ,240,38,79,0.481,35,66,0.53,3,13,0.231,14,18,0.778,93,35,74,0.473,28,52,0.538,7,22,0.318,20,25,0.8,97,2012-02-20,MEM,HOU,2012,100.5
9894,9894,94,@,W 93-90 ,240,33,76,0.434,25,54,0.463,8,22,0.364,19,25,0.76,93,37,91,0.407,32,69,0.464,5,22,0.227,11,13,0.846,90,2012-02-20,ORL,MIL,2012,92.5
9895,9895,95,@,L 93-101 ,240,33,91,0.363,26,77,0.338,7,14,0.5,20,23,0.87,93,36,80,0.45,28,54,0.519,8,26,0.308,21,24,0.875,101,2012-02-20,NOP,OKC,2012,105.0
9896,9896,96,Home,W 93-87 ,240,36,78,0.462,31,60,0.517,5,18,0.278,16,20,0.8,93,33,82,0.402,33,73,0.452,0,9,0.0,21,27,0.778,87,2012-02-22,HOU,PHI,2012,87.0
9897,9897,97,@,L 93-103 ,240,35,84,0.417,33,72,0.458,2,12,0.167,21,27,0.778,93,40,76,0.526,37,69,0.536,3,7,0.429,20,28,0.714,103,2012-02-22,DET,TOR,2012,104.5
9898,9898,98,@,W 93-92 ,240,37,84,0.44,30,59,0.508,7,25,0.28,12,14,0.857,93,32,89,0.36,24,64,0.375,8,25,0.32,20,28,0.714,92,2012-02-28,BRK,DAL,2012,96.0
9899,9899,99,Home,L 93-107 ,240,36,76,0.474,31,60,0.517,5,16,0.313,16,19,0.842,93,39,82,0.476,33,71,0.465,6,11,0.545,23,29,0.793,107,2012-03-01,POR,MIA,2012,110.0
9900,9900,0,Home,W 93-83 ,240,35,71,0.493,30,54,0.556,5,17,0.294,18,25,0.72,93,33,88,0.375,26,64,0.406,7,24,0.292,10,15,0.667,83,2012-03-04,LAL,MIA,2012,86.5
9901,9901,1,@,L 93-97 ,240,35,94,0.372,28,75,0.373,7,19,0.368,16,23,0.696,93,35,88,0.398,28,68,0.412,7,20,0.35,20,23,0.87,97,2012-03-05,PHI,MIL,2012,100.5
9902,9902,2,Home,L 93-99 ,240,32,68,0.471,29,61,0.475,3,7,0.429,26,37,0.703,93,39,87,0.448,38,80,0.475,1,7,0.143,20,24,0.833,99,2012-03-07,CHA,UTA,2012,99.5
9903,9903,3,Home,W 93-91 (OT),265,35,75,0.467,32,62,0.516,3,13,0.231,20,31,0.645,93,33,88,0.375,26,71,0.366,7,17,0.412,18,25,0.72,91,2012-03-10,MIA,IND,2012,94.5
9904,9904,4,Home,L 93-97 ,240,34,79,0.43,28,60,0.467,6,19,0.316,19,35,0.543,93,36,70,0.514,28,55,0.509,8,15,0.533,17,21,0.81,97,2012-03-11,LAC,GSW,2012,101.0
9905,9905,5,Home,L 93-97 ,240,34,80,0.425,24,54,0.444,10,26,0.385,15,20,0.75,93,35,74,0.473,26,53,0.491,9,21,0.429,18,23,0.783,97,2012-03-19,GSW,MIN,2012,101.5
9906,9906,6,Home,L 93-109 ,240,35,82,0.427,27,56,0.482,8,26,0.308,15,22,0.682,93,45,77,0.584,36,59,0.61,9,18,0.5,10,13,0.769,109,2012-03-21,DAL,LAL,2012,113.5
9907,9907,7,@,L 93-103 ,240,38,79,0.481,34,67,0.507,4,12,0.333,13,19,0.684,93,39,83,0.47,28,60,0.467,11,23,0.478,14,21,0.667,103,2012-03-21,PHO,ORL,2012,108.5
9908,9908,8,@,L 93-97 ,240,37,81,0.457,34,73,0.466,3,8,0.375,16,23,0.696,93,31,73,0.425,21,48,0.438,10,25,0.4,25,25,1.0,97,2012-03-22,MEM,POR,2012,102.0
9909,9909,9,Home,W 93-84 ,240,36,77,0.468,29,56,0.518,7,21,0.333,14,20,0.7,93,32,80,0.4,26,55,0.473,6,25,0.24,14,21,0.667,84,2012-03-23,ATL,NJN,2012,87.0
9910,9910,10,Home,W 93-80 ,240,37,79,0.468,25,44,0.568,12,35,0.343,7,12,0.583,93,31,82,0.378,27,64,0.422,4,18,0.222,14,21,0.667,80,2012-03-23,ORL,CLE,2012,82.0
9911,9911,11,Home,W 93-76 ,240,37,81,0.457,30,53,0.566,7,28,0.25,12,18,0.667,93,35,85,0.412,34,76,0.447,1,9,0.111,5,11,0.455,76,2012-03-25,SAS,PHI,2012,76.5
9912,9912,12,Home,W 93-86 ,240,34,80,0.425,34,69,0.493,0,11,0.0,25,28,0.893,93,33,85,0.388,24,56,0.429,9,29,0.31,11,13,0.846,86,2012-03-27,MEM,MIN,2012,90.5
9913,9913,13,Home,W 93-89 ,240,31,79,0.392,25,63,0.397,6,16,0.375,25,32,0.781,93,33,78,0.423,26,56,0.464,7,22,0.318,16,25,0.64,89,2012-03-29,IND,WAS,2012,92.5
9914,9914,14,Home,L 93-102 ,240,35,84,0.417,31,73,0.425,4,11,0.364,19,23,0.826,93,42,91,0.462,37,79,0.468,5,12,0.417,13,17,0.765,102,2012-03-29,LAL,OKC,2012,104.5
9915,9915,15,@,L 93-99 ,240,33,71,0.465,26,58,0.448,7,13,0.538,20,21,0.952,93,39,80,0.488,27,52,0.519,12,28,0.429,9,13,0.692,99,2012-03-29,NOP,POR,2012,105.0
9916,9916,16,Home,L 93-99 ,240,40,83,0.482,35,66,0.53,5,17,0.294,8,17,0.471,93,42,89,0.472,38,76,0.5,4,13,0.308,11,14,0.786,99,2012-04-02,CHI,HOU,2012,101.0
9917,9917,17,@,L 93-99 ,240,38,83,0.458,35,73,0.479,3,10,0.3,14,17,0.824,93,35,75,0.467,32,62,0.516,3,13,0.231,26,32,0.813,99,2012-04-03,PHI,MIA,2012,100.5
9918,9918,18,@,L 93-120 ,240,36,79,0.456,31,65,0.477,5,14,0.357,16,20,0.8,93,47,83,0.566,38,64,0.594,9,19,0.474,17,19,0.895,120,2012-04-04,CHA,ATL,2012,124.5
9919,9919,19,@,L 93-98 ,240,35,81,0.432,30,64,0.469,5,17,0.294,18,20,0.9,93,31,83,0.373,21,59,0.356,10,24,0.417,26,29,0.897,98,2012-04-04,OKC,MIA,2012,103.0
9920,9920,20,Home,W 93-86 ,240,33,80,0.413,28,64,0.438,5,16,0.313,22,26,0.846,93,33,77,0.429,28,64,0.438,5,13,0.385,15,18,0.833,86,2012-04-05,CHI,BOS,2012,88.5
9921,9921,21,@,W 93-85 ,240,36,80,0.45,31,61,0.508,5,19,0.263,16,24,0.667,93,35,84,0.417,31,67,0.463,4,17,0.235,11,15,0.733,85,2012-04-05,LAC,SAC,2012,87.0
9922,9922,22,@,W 93-91 ,240,34,73,0.466,29,63,0.46,5,10,0.5,20,26,0.769,93,36,80,0.45,27,65,0.415,9,15,0.6,10,10,1.0,91,2012-04-09,LAL,NOH,2012,95.5
9923,9923,23,Home,W 93-85 ,240,39,78,0.5,36,63,0.571,3,15,0.2,12,15,0.8,93,34,93,0.366,23,58,0.397,11,35,0.314,6,10,0.6,85,2012-04-10,WAS,ORL,2012,90.5
9924,9924,24,@,L 93-104 ,240,38,79,0.481,31,55,0.564,7,24,0.292,10,14,0.714,93,42,84,0.5,38,70,0.543,4,14,0.286,16,19,0.842,104,2012-04-11,PHO,MEM,2012,106.0
9925,9925,25,@,W 93-75 ,240,41,77,0.532,40,67,0.597,1,10,0.1,10,16,0.625,93,29,80,0.363,22,62,0.355,7,18,0.389,10,12,0.833,75,2012-04-11,PHI,TOR,2012,78.5
9926,9926,26,@,W 93-85 ,240,36,78,0.462,32,61,0.525,4,17,0.235,17,21,0.81,93,31,73,0.425,22,43,0.512,9,30,0.3,14,23,0.609,85,2012-04-15,MIA,NYK,2012,89.5
9927,9927,27,Home,W 93-90 ,240,33,74,0.446,24,50,0.48,9,24,0.375,18,24,0.75,93,37,83,0.446,32,67,0.478,5,16,0.313,11,17,0.647,90,2012-04-19,PHO,LAC,2012,92.5
9928,9928,28,Home,W 93-83 ,240,38,84,0.452,29,64,0.453,9,20,0.45,8,12,0.667,93,31,79,0.392,27,64,0.422,4,15,0.267,17,19,0.895,83,2012-04-21,CHI,DAL,2012,85.0
9929,9929,29,Home,W 93-89 ,240,40,90,0.444,36,73,0.493,4,17,0.235,9,10,0.9,93,29,78,0.372,23,54,0.426,6,24,0.25,25,31,0.806,89,2012-04-21,MEM,POR,2012,92.0
9930,9930,30,@,W 93-88 ,240,41,92,0.446,36,76,0.474,5,16,0.313,6,10,0.6,93,30,82,0.366,23,56,0.411,7,26,0.269,21,21,1.0,88,2012-04-22,GSW,MIN,2012,91.5
9931,9931,31,@,L 93-99 ,240,34,70,0.486,23,45,0.511,11,25,0.44,14,25,0.56,93,36,77,0.468,27,53,0.509,9,24,0.375,18,24,0.75,99,2012-04-25,LAC,NYK,2012,103.5
9932,9932,32,Home,W 93-87 ,240,33,79,0.418,31,70,0.443,2,9,0.222,25,33,0.758,93,34,84,0.405,28,67,0.418,6,17,0.353,13,16,0.813,87,2012-10-31,CHI,SAC,2013,90.0
9933,9933,33,@,L 93-99 ,240,36,86,0.419,28,67,0.418,8,19,0.421,13,17,0.765,93,40,84,0.476,38,78,0.487,2,6,0.333,17,24,0.708,99,2012-11-06,ORL,CHI,2013,100.0
9934,9934,34,@,W 93-87 ,240,37,82,0.451,30,64,0.469,7,18,0.389,12,21,0.571,93,31,84,0.369,23,51,0.451,8,33,0.242,17,23,0.739,87,2012-11-07,DEN,HOU,2013,91.0
9935,9935,35,Home,W 93-85 ,240,35,94,0.372,29,75,0.387,6,19,0.316,17,23,0.739,93,31,76,0.408,22,49,0.449,9,27,0.333,14,15,0.933,85,2012-11-09,MEM,HOU,2013,89.5
9936,9936,36,@,W 93-83 ,240,34,73,0.466,28,59,0.475,6,14,0.429,19,25,0.76,93,30,79,0.38,18,53,0.34,12,26,0.462,11,16,0.688,83,2012-11-10,PHI,TOR,2013,89.0
9937,9937,37,@,L 93-98 ,240,33,82,0.402,26,67,0.388,7,15,0.467,20,28,0.714,93,36,72,0.5,32,62,0.516,4,10,0.4,22,29,0.759,98,2012-11-14,UTA,BOS,2013,100.0
9938,9938,38,Home,L 93-98 ,240,37,88,0.42,31,68,0.456,6,20,0.3,13,19,0.684,93,36,77,0.468,23,50,0.46,13,27,0.481,13,16,0.813,98,2012-11-15,DEN,MIA,2013,104.5
9939,9939,39,@,L 93-99 ,240,36,81,0.444,29,59,0.492,7,22,0.318,14,18,0.778,93,40,87,0.46,30,69,0.435,10,18,0.556,9,10,0.9,99,2012-11-16,UTA,PHI,2013,104.0
9940,9940,40,@,L 93-102 ,240,38,83,0.458,32,60,0.533,6,23,0.261,11,15,0.733,93,40,75,0.533,33,60,0.55,7,15,0.467,15,19,0.789,102,2012-11-21,BRK,GSW,2013,105.5
9941,9941,41,Home,W 93-89 ,240,32,74,0.432,25,55,0.455,7,19,0.368,22,31,0.71,93,38,95,0.4,36,79,0.456,2,16,0.125,11,19,0.579,89,2012-11-21,HOU,CHI,2013,90.0
9942,9942,42,@,L 93-104 ,240,32,75,0.427,24,56,0.429,8,19,0.421,21,25,0.84,93,38,75,0.507,31,58,0.534,7,17,0.412,21,26,0.808,104,2012-11-24,LAC,ATL,2013,107.5
9943,9943,43,@,W 93-86 ,240,32,82,0.39,28,66,0.424,4,16,0.25,25,26,0.962,93,38,88,0.432,35,71,0.493,3,17,0.176,7,10,0.7,86,2012-11-24,CHI,MIL,2013,87.5
9944,9944,44,@,W 93-92 ,240,39,85,0.459,36,70,0.514,3,15,0.2,12,19,0.632,93,35,80,0.438,30,69,0.435,5,11,0.455,17,19,0.895,92,2012-11-26,MIL,CHI,2013,94.5
9945,9945,45,Home,W 93-88 ,240,38,81,0.469,34,74,0.459,4,7,0.571,13,21,0.619,93,36,82,0.439,33,70,0.471,3,12,0.25,13,18,0.722,88,2012-12-01,CHI,PHI,2013,89.5
9946,9946,46,@,L 93-108 ,240,36,81,0.444,33,68,0.485,3,13,0.231,18,32,0.563,93,38,94,0.404,32,80,0.4,6,14,0.429,26,32,0.813,108,2012-12-07,CHA,MIL,2013,111.0
9947,9947,47,Home,W 93-85 ,240,34,78,0.436,27,65,0.415,7,13,0.538,18,18,1.0,93,27,84,0.321,19,61,0.311,8,23,0.348,23,28,0.821,85,2012-12-08,CHI,NYK,2013,89.0
9948,9948,48,@,W 93-83 ,240,34,77,0.442,27,60,0.45,7,17,0.412,18,25,0.72,93,33,77,0.429,27,61,0.443,6,16,0.375,11,18,0.611,83,2012-12-08,ATL,MEM,2013,86.0
9949,9949,49,@,L 93-104 ,240,38,82,0.463,32,65,0.492,6,17,0.353,11,13,0.846,93,37,76,0.487,32,57,0.561,5,19,0.263,25,30,0.833,104,2012-12-09,IND,OKC,2013,106.5
9950,9950,50,@,L 93-99 ,240,35,89,0.393,28,64,0.438,7,25,0.28,16,20,0.8,93,34,76,0.447,25,52,0.481,9,24,0.375,22,30,0.733,99,2012-12-12,WAS,HOU,2013,103.5
9951,9951,51,Home,L 93-115 ,240,31,84,0.369,26,58,0.448,5,26,0.192,26,36,0.722,93,49,99,0.495,39,75,0.52,10,24,0.417,7,8,0.875,115,2012-12-15,ATL,GSW,2013,120.0
9952,9952,52,@,L 93-107 ,240,36,79,0.456,30,59,0.508,6,20,0.3,15,21,0.714,93,38,85,0.447,34,71,0.479,4,14,0.286,27,30,0.9,107,2012-12-17,SAS,OKC,2013,109.0
9953,9953,53,@,L 93-102 ,240,39,96,0.406,32,71,0.451,7,25,0.28,8,12,0.667,93,44,82,0.537,38,68,0.559,6,14,0.429,8,8,1.0,102,2012-12-17,MIN,ORL,2013,105.0
9954,9954,54,@,L 93-98 ,240,32,80,0.4,30,72,0.417,2,8,0.25,27,34,0.794,93,37,86,0.43,31,72,0.431,6,14,0.429,18,26,0.692,98,2012-12-18,IND,MIL,2013,101.0
9955,9955,55,Home,W 93-77 ,240,37,74,0.5,33,54,0.611,4,20,0.2,15,19,0.789,93,29,75,0.387,27,56,0.482,2,19,0.105,17,22,0.773,77,2012-12-19,LAC,NOH,2013,78.0
9956,9956,56,@,L 93-99 ,240,33,82,0.402,28,62,0.452,5,20,0.25,22,26,0.846,93,37,84,0.44,28,64,0.438,9,20,0.45,16,23,0.696,99,2012-12-20,OKC,MIN,2013,103.5
9957,9957,57,@,L 93-101 ,240,38,98,0.388,38,76,0.5,0,22,0.0,17,24,0.708,93,33,92,0.359,19,56,0.339,14,36,0.389,21,26,0.808,101,2012-12-20,DEN,POR,2013,108.0
9958,9958,58,Home,W 93-90 ,240,33,81,0.407,25,62,0.403,8,19,0.421,19,21,0.905,93,35,70,0.5,31,56,0.554,4,14,0.286,16,19,0.842,90,2012-12-21,TOR,ORL,2013,92.0
9959,9959,59,@,L 93-96 ,240,40,89,0.449,35,70,0.5,5,19,0.263,8,11,0.727,93,33,69,0.478,26,49,0.531,7,20,0.35,23,28,0.821,96,2012-12-22,PHO,POR,2013,99.5
9960,9960,60,Home,L 93-97 ,240,38,76,0.5,29,56,0.518,9,20,0.45,8,15,0.533,93,36,83,0.434,29,65,0.446,7,18,0.389,18,25,0.72,97,2012-12-23,ORL,UTA,2013,100.5
9961,9961,61,@,W 93-76 ,240,38,77,0.494,32,67,0.478,6,10,0.6,11,13,0.846,93,26,64,0.406,19,44,0.432,7,20,0.35,17,29,0.586,76,2012-12-25,BOS,BRK,2013,79.5
9962,9962,62,@,L 93-108 ,240,34,88,0.386,30,67,0.448,4,21,0.19,21,24,0.875,93,40,84,0.476,30,67,0.448,10,17,0.588,18,19,0.947,108,2012-12-26,BRK,MIL,2013,113.0
9963,9963,63,@,W 93-83 ,240,34,71,0.479,26,53,0.491,8,18,0.444,17,22,0.773,93,32,71,0.451,24,49,0.49,8,22,0.364,11,16,0.688,83,2013-01-02,MEM,BOS,2013,87.0
9964,9964,64,Home,L 93-110 ,240,36,73,0.493,28,54,0.519,8,19,0.421,13,17,0.765,93,38,76,0.5,29,59,0.492,9,17,0.529,25,29,0.862,110,2013-01-02,OKC,BRK,2013,114.5
9965,9965,65,@,L 93-113 ,240,36,90,0.4,30,71,0.423,6,19,0.316,15,23,0.652,93,44,85,0.518,37,61,0.607,7,24,0.292,18,21,0.857,113,2013-01-05,SAC,BRK,2013,116.5
9966,9966,66,@,L 93-99 ,240,36,84,0.429,30,66,0.455,6,18,0.333,15,18,0.833,93,38,79,0.481,28,55,0.509,10,24,0.417,13,21,0.619,99,2013-01-09,DAL,LAC,2013,104.0
9967,9967,67,Home,W 93-83 ,240,36,79,0.456,34,68,0.5,2,11,0.182,19,27,0.704,93,30,78,0.385,23,54,0.426,7,24,0.292,16,25,0.64,83,2013-01-12,WAS,ATL,2013,86.5
9968,9968,68,@,L 93-113 ,240,39,95,0.411,35,74,0.473,4,21,0.19,11,12,0.917,93,40,69,0.58,27,44,0.614,13,25,0.52,20,27,0.741,113,2013-01-13,CLE,LAL,2013,119.5
9969,9969,69,@,W 93-88 ,240,32,83,0.386,28,66,0.424,4,17,0.235,25,32,0.781,93,31,79,0.392,22,50,0.44,9,29,0.31,17,26,0.654,88,2013-01-16,CLE,POR,2013,92.5
9970,9970,70,Home,L 93-98 ,240,35,85,0.412,27,64,0.422,8,21,0.381,15,22,0.682,93,41,86,0.477,33,62,0.532,8,24,0.333,8,11,0.727,98,2013-01-19,ATL,SAS,2013,102.0
9971,9971,71,Home,L 93-97 ,240,31,72,0.431,26,57,0.456,5,15,0.333,26,38,0.684,93,37,81,0.457,32,63,0.508,5,18,0.278,18,21,0.857,97,2013-01-19,CHA,SAC,2013,99.5
9972,9972,72,@,L 93-106 ,240,31,73,0.425,24,56,0.429,7,17,0.412,24,32,0.75,93,47,96,0.49,43,83,0.518,4,13,0.308,8,10,0.8,106,2013-01-23,LAL,MEM,2013,108.0
9973,9973,73,Home,W 93-88 ,240,30,71,0.423,25,55,0.455,5,16,0.313,28,37,0.757,93,33,83,0.398,27,65,0.415,6,18,0.333,16,26,0.615,88,2013-01-24,PHO,LAC,2013,91.0
9974,9974,74,@,L 93-121 ,240,37,88,0.42,29,66,0.439,8,22,0.364,11,22,0.5,93,47,89,0.528,34,58,0.586,13,31,0.419,14,17,0.824,121,2013-01-26,SAC,DEN,2013,127.5
9975,9975,75,Home,W 93-85 ,240,35,78,0.449,28,60,0.467,7,18,0.389,16,25,0.64,93,32,81,0.395,26,69,0.377,6,12,0.5,15,21,0.714,85,2013-01-28,CHI,CHA,2013,88.0
9976,9976,76,Home,W 93-92 ,240,36,75,0.48,26,49,0.531,10,26,0.385,11,18,0.611,93,33,85,0.388,24,63,0.381,9,22,0.409,17,23,0.739,92,2013-01-30,ATL,TOR,2013,96.5
9977,9977,77,Home,W 93-89 ,240,39,75,0.52,34,64,0.531,5,11,0.455,10,20,0.5,93,34,78,0.436,33,64,0.516,1,14,0.071,20,22,0.909,89,2013-02-01,BRK,CHI,2013,89.5
9978,9978,78,@,W 93-76 ,240,38,93,0.409,30,73,0.411,8,20,0.4,9,13,0.692,93,31,79,0.392,25,60,0.417,6,19,0.316,8,15,0.533,76,2013-02-02,CHI,ATL,2013,79.0
9979,9979,79,@,L 93-113 ,240,35,86,0.407,30,71,0.423,5,15,0.333,18,24,0.75,93,45,89,0.506,36,70,0.514,9,19,0.474,14,20,0.7,113,2013-02-02,PHO,GSW,2013,117.5
9980,9980,80,@,W 93-90 ,240,34,82,0.415,28,66,0.424,6,16,0.375,19,25,0.76,93,36,83,0.434,33,66,0.5,3,17,0.176,15,21,0.714,90,2013-02-06,BRK,DET,2013,91.5
9981,9981,81,Home,W 93-84 ,240,39,75,0.52,35,61,0.574,4,14,0.286,11,17,0.647,93,35,78,0.449,34,63,0.54,1,15,0.067,13,15,0.867,84,2013-02-06,NOP,PHO,2013,84.5
9982,9982,82,Home,L 93-100 ,240,38,89,0.427,34,75,0.453,4,14,0.286,13,19,0.684,93,36,80,0.45,28,54,0.519,8,26,0.308,20,25,0.8,100,2013-02-08,CHA,LAL,2013,104.0
9983,9983,83,@,L 93-99 ,240,36,74,0.486,30,57,0.526,6,17,0.353,15,20,0.75,93,36,79,0.456,28,59,0.475,8,20,0.4,19,23,0.826,99,2013-02-08,GSW,MEM,2013,103.0
9984,9984,84,@,W 93-89 ,240,36,79,0.456,31,67,0.463,5,12,0.417,16,18,0.889,93,37,78,0.474,33,62,0.532,4,16,0.25,11,17,0.647,89,2013-02-08,CHI,UTA,2013,91.0
9985,9985,85,Home,L 93-97 ,240,29,85,0.341,24,63,0.381,5,22,0.227,30,38,0.789,93,38,87,0.437,36,76,0.474,2,11,0.182,19,25,0.76,97,2013-02-13,MIN,UTA,2013,98.0
9986,9986,86,@,L 93-99 ,240,36,85,0.424,32,72,0.444,4,13,0.308,17,20,0.85,93,32,75,0.427,24,42,0.571,8,33,0.242,27,35,0.771,99,2013-02-24,PHI,NYK,2013,103.0
9987,9987,87,Home,W 93-82 ,240,32,83,0.386,29,69,0.42,3,14,0.214,26,33,0.788,93,33,85,0.388,29,74,0.392,4,11,0.364,12,21,0.571,82,2013-02-28,CHI,PHI,2013,84.0
9988,9988,88,@,W 93-81 ,240,34,70,0.486,27,50,0.54,7,20,0.35,18,22,0.818,93,29,72,0.403,26,61,0.426,3,11,0.273,20,25,0.8,81,2013-03-01,IND,TOR,2013,82.5
9989,9989,89,Home,L 93-99 ,240,32,74,0.432,24,45,0.533,8,29,0.276,21,26,0.808,93,39,84,0.464,31,64,0.484,8,20,0.4,13,19,0.684,99,2013-03-03,NYK,MIA,2013,103.0
9990,9990,90,@,L 93-102 ,240,37,77,0.481,27,56,0.482,10,21,0.476,9,11,0.818,93,42,79,0.532,34,58,0.586,8,21,0.381,10,13,0.769,102,2013-03-08,PHI,MIA,2013,106.0
9991,9991,91,@,W 93-80 ,240,36,83,0.434,30,60,0.5,6,23,0.261,15,22,0.682,93,32,77,0.416,27,59,0.458,5,18,0.278,11,16,0.688,80,2013-03-09,BRK,ATL,2013,82.5
9992,9992,92,Home,L 93-103 ,240,37,82,0.451,31,67,0.463,6,15,0.4,13,20,0.65,93,38,78,0.487,25,50,0.5,13,28,0.464,14,19,0.737,103,2013-03-09,GSW,MIL,2013,109.5
9993,9993,93,Home,L 93-108 ,240,35,84,0.417,29,64,0.453,6,20,0.3,17,22,0.773,93,44,86,0.512,41,74,0.554,3,12,0.25,17,25,0.68,108,2013-03-11,PHO,DEN,2013,109.5
9994,9994,94,@,L 93-105 ,240,33,77,0.429,27,60,0.45,6,17,0.353,21,24,0.875,93,43,82,0.524,35,61,0.574,8,21,0.381,11,14,0.786,105,2013-03-11,OKC,SAS,2013,109.0
9995,9995,95,@,L 93-106 ,240,39,85,0.459,33,67,0.493,6,18,0.333,9,12,0.75,93,43,86,0.5,35,70,0.5,8,16,0.5,12,24,0.5,106,2013-03-13,MIL,WAS,2013,110.0
9996,9996,96,Home,L 93-99 ,240,37,99,0.374,25,72,0.347,12,27,0.444,7,9,0.778,93,33,78,0.423,20,52,0.385,13,26,0.5,20,30,0.667,99,2013-03-15,IND,LAL,2013,105.5
9997,9997,97,Home,L 93-105 ,240,36,86,0.419,28,63,0.444,8,23,0.348,13,16,0.813,93,44,84,0.524,36,63,0.571,8,21,0.381,9,13,0.692,105,2013-03-17,BRK,ATL,2013,109.0
9998,9998,98,Home,W 93-80 ,240,34,75,0.453,26,47,0.553,8,28,0.286,17,31,0.548,93,29,81,0.358,17,55,0.309,12,26,0.462,10,14,0.714,80,2013-03-17,LAC,NYK,2013,86.0
9999,9999,99,@,W 93-72 ,240,35,70,0.5,25,51,0.49,10,19,0.526,13,15,0.867,93,28,83,0.337,25,66,0.379,3,17,0.176,13,13,1.0,72,2013-03-18,GSW,NOH,2013,73.5
10000,10000,0,@,L 93-100 ,240,36,79,0.456,31,62,0.5,5,17,0.294,16,20,0.8,93,34,76,0.447,28,53,0.528,6,23,0.261,26,32,0.813,100,2013-03-20,UTA,HOU,2013,103.0
10001,10001,1,@,L 93-104 ,240,37,84,0.44,31,72,0.431,6,12,0.5,13,15,0.867,93,41,85,0.482,33,59,0.559,8,26,0.308,14,15,0.933,104,2013-03-20,GSW,SAS,2013,108.0
10002,10002,2,Home,L 93-104 ,240,37,83,0.446,30,59,0.508,7,24,0.292,12,16,0.75,93,41,87,0.471,31,69,0.449,10,18,0.556,12,16,0.75,104,2013-03-22,ATL,POR,2013,109.0
10003,10003,3,@,W 93-92 ,240,34,76,0.447,29,62,0.468,5,14,0.357,20,28,0.714,93,38,86,0.442,31,69,0.449,7,17,0.412,9,14,0.643,92,2013-03-27,BOS,CLE,2013,95.5
10004,10004,4,Home,L 93-111 ,240,36,82,0.439,28,64,0.438,8,18,0.444,13,21,0.619,93,46,95,0.484,41,75,0.547,5,20,0.25,14,25,0.56,111,2013-03-27,POR,BRK,2013,113.5
10005,10005,5,@,L 93-101 ,240,36,79,0.456,31,63,0.492,5,16,0.313,16,20,0.8,93,37,83,0.446,32,68,0.471,5,15,0.333,22,27,0.815,101,2013-03-29,OKC,MIN,2013,103.5
10006,10006,6,@,L 93-98 ,240,34,93,0.366,30,69,0.435,4,24,0.167,21,30,0.7,93,36,71,0.507,29,51,0.569,7,20,0.35,19,22,0.864,98,2013-04-03,DET,BOS,2013,101.5
10007,10007,7,Home,L 93-95 ,240,30,67,0.448,27,52,0.519,3,15,0.2,30,40,0.75,93,40,85,0.471,36,70,0.514,4,15,0.267,11,16,0.688,95,2013-04-05,MIN,TOR,2013,97.0
10008,10008,8,Home,L 93-101 ,240,37,81,0.457,31,65,0.477,6,16,0.375,13,17,0.765,93,34,74,0.459,26,55,0.473,8,19,0.421,25,28,0.893,101,2013-04-10,BOS,BRK,2013,105.0
10009,10009,9,@,L 93-113 ,240,35,78,0.449,26,54,0.481,9,24,0.375,14,17,0.824,93,43,83,0.518,31,65,0.477,12,18,0.667,15,20,0.75,113,2013-04-12,CHA,DET,2013,119.0
10010,10010,10,Home,L 93-96 ,240,35,83,0.422,29,64,0.453,6,19,0.316,17,32,0.531,93,35,78,0.449,28,52,0.538,7,26,0.269,19,28,0.679,96,2013-04-12,NOP,LAC,2013,99.5
10011,10011,11,@,L 93-105 ,240,37,73,0.507,28,53,0.528,9,20,0.45,10,14,0.714,93,41,83,0.494,35,68,0.515,6,15,0.4,17,19,0.895,105,2013-04-13,PHO,MIN,2013,108.0
10012,10012,12,@,L 93-105 ,240,29,82,0.354,18,56,0.321,11,26,0.423,24,31,0.774,93,36,70,0.514,30,53,0.566,6,17,0.353,27,41,0.659,105,2013-04-14,CHI,MIA,2013,108.0
10013,10013,13,Home,W 93-87 ,240,36,82,0.439,30,67,0.448,6,15,0.4,15,21,0.714,93,34,84,0.405,26,54,0.481,8,30,0.267,11,19,0.579,87,2013-04-14,TOR,BRK,2013,91.0
10014,10014,14,Home,W 93-77 ,240,37,79,0.468,30,52,0.577,7,27,0.259,12,15,0.8,93,30,73,0.411,23,52,0.442,7,21,0.333,10,15,0.667,77,2013-04-16,LAC,POR,2013,80.5
10015,10015,15,@,L 93-105 ,240,40,77,0.519,38,63,0.603,2,14,0.143,11,25,0.44,93,42,78,0.538,30,49,0.612,12,29,0.414,9,19,0.474,105,2013-04-17,ORL,MIA,2013,111.0
10016,10016,16,Home,W 93-87 ,240,38,86,0.442,33,69,0.478,5,17,0.294,12,23,0.522,93,32,66,0.485,29,53,0.547,3,13,0.231,20,29,0.69,87,2013-10-30,TOR,BOS,2014,88.5
10017,10017,17,Home,L 93-104 ,240,34,81,0.42,30,59,0.508,4,22,0.182,21,27,0.778,93,34,67,0.507,25,45,0.556,9,22,0.409,27,35,0.771,104,2013-11-02,UTA,HOU,2014,108.5
10018,10018,18,@,L 93-103 ,240,35,82,0.427,23,52,0.442,12,30,0.4,11,16,0.688,93,37,70,0.529,26,43,0.605,11,27,0.407,18,27,0.667,103,2013-11-03,WAS,MIA,2014,108.5
10019,10019,19,Home,W 93-92 ,240,39,85,0.459,34,69,0.493,5,16,0.313,10,11,0.909,93,34,94,0.362,29,66,0.439,5,28,0.179,19,24,0.792,92,2013-11-04,CLE,MIN,2014,94.5
10020,10020,20,Home,L 93-106 ,240,34,90,0.378,30,74,0.405,4,16,0.25,21,27,0.778,93,42,84,0.5,34,64,0.531,8,20,0.4,14,20,0.7,106,2013-11-06,MIN,GSW,2014,110.0
10021,10021,21,@,L 93-107 ,240,36,85,0.424,27,62,0.435,9,23,0.391,12,14,0.857,93,43,79,0.544,38,66,0.576,5,13,0.385,16,23,0.696,107,2013-11-06,DAL,OKC,2014,109.5
10022,10022,22,Home,W 93-85 ,240,36,71,0.507,32,56,0.571,4,15,0.267,17,24,0.708,93,35,87,0.402,29,65,0.446,6,22,0.273,9,12,0.75,85,2013-11-20,ATL,DET,2014,88.0
10023,10023,23,@,L 93-104 ,240,39,86,0.453,35,71,0.493,4,15,0.267,11,12,0.917,93,39,81,0.481,31,60,0.517,8,21,0.381,18,24,0.75,104,2013-11-20,BOS,SAS,2014,108.0
10024,10024,24,@,L 93-103 ,240,39,78,0.5,32,58,0.552,7,20,0.35,8,12,0.667,93,38,75,0.507,31,58,0.534,7,17,0.412,20,27,0.741,103,2013-11-22,UTA,DAL,2014,106.5
10025,10025,25,@,W 93-86 ,240,34,69,0.493,28,45,0.622,6,24,0.25,19,27,0.704,93,34,82,0.415,30,69,0.435,4,13,0.308,14,18,0.778,86,2013-11-25,HOU,MEM,2014,88.0
10026,10026,26,@,L 93-112 ,240,37,97,0.381,35,82,0.427,2,15,0.133,17,20,0.85,93,44,81,0.543,34,56,0.607,10,25,0.4,14,19,0.737,112,2013-11-25,NOP,SAS,2014,117.0
10027,10027,27,Home,L 93-100 ,240,38,89,0.427,31,69,0.449,7,20,0.35,10,13,0.769,93,36,80,0.45,33,71,0.465,3,9,0.333,25,31,0.806,100,2013-11-27,BOS,MEM,2014,101.5
10028,10028,28,Home,W 93-80 ,240,32,74,0.432,26,49,0.531,6,25,0.24,23,31,0.742,93,32,83,0.386,29,63,0.46,3,20,0.15,13,15,0.867,80,2013-11-27,LAC,NYK,2014,81.5
10029,10029,29,Home,W 93-73 ,240,38,85,0.447,29,63,0.46,9,22,0.409,8,10,0.8,93,29,73,0.397,23,55,0.418,6,18,0.333,9,13,0.692,73,2013-11-29,IND,WAS,2014,76.0
10030,10030,30,@,L 93-97 ,240,39,82,0.476,33,67,0.493,6,15,0.4,9,15,0.6,93,37,78,0.474,30,63,0.476,7,15,0.467,16,19,0.842,97,2013-11-30,CHI,CLE,2014,100.5
10031,10031,31,@,L 93-95 ,240,37,88,0.42,29,65,0.446,8,23,0.348,11,14,0.786,93,37,86,0.43,25,58,0.431,12,28,0.429,9,15,0.6,95,2013-12-11,DAL,GSW,2014,101.0
10032,10032,32,@,L 93-102 ,240,26,70,0.371,20,46,0.435,6,24,0.25,35,52,0.673,93,33,74,0.446,25,54,0.463,8,20,0.4,28,30,0.933,102,2013-12-12,LAC,BRK,2014,106.0
10033,10033,33,Home,L 93-103 ,240,36,85,0.424,29,64,0.453,7,21,0.333,14,24,0.583,93,38,84,0.452,30,63,0.476,8,21,0.381,19,20,0.95,103,2013-12-13,DEN,UTA,2014,107.0
10034,10034,34,@,L 93-106 ,240,36,81,0.444,31,64,0.484,5,17,0.294,16,19,0.842,93,42,88,0.477,32,64,0.5,10,24,0.417,12,18,0.667,106,2013-12-14,MIL,DAL,2014,111.0
10035,10035,35,@,L 93-102 ,240,37,85,0.435,30,61,0.492,7,24,0.292,12,19,0.632,93,37,85,0.435,30,61,0.492,7,24,0.292,21,28,0.75,102,2013-12-15,NOP,DEN,2014,105.5
10036,10036,36,Home,L 93-101 ,240,37,83,0.446,32,68,0.471,5,15,0.333,14,20,0.7,93,35,79,0.443,23,53,0.434,12,26,0.462,19,25,0.76,101,2013-12-15,MEM,MIN,2014,107.0
10037,10037,37,Home,L 93-105 ,240,36,87,0.414,31,68,0.456,5,19,0.263,16,22,0.727,93,43,88,0.489,38,66,0.576,5,22,0.227,14,20,0.7,105,2013-12-17,DEN,OKC,2014,107.5
10038,10038,38,@,L 93-104 ,240,33,88,0.375,28,70,0.4,5,18,0.278,22,30,0.733,93,41,91,0.451,36,71,0.507,5,20,0.25,17,24,0.708,104,2013-12-17,NOP,GSW,2014,106.5
10039,10039,39,@,L 93-104 ,240,33,88,0.375,24,56,0.429,9,32,0.281,18,25,0.72,93,34,79,0.43,22,53,0.415,12,26,0.462,24,32,0.75,104,2013-12-27,MIL,BRK,2014,110.0
10040,10040,40,Home,L 93-95 ,240,34,68,0.5,25,46,0.543,9,22,0.409,16,19,0.842,93,31,70,0.443,22,46,0.478,9,24,0.375,24,31,0.774,95,2014-01-02,OKC,BRK,2014,99.5
10041,10041,41,@,L 93-111 ,240,34,86,0.395,30,67,0.448,4,19,0.211,21,27,0.778,93,44,89,0.494,31,61,0.508,13,28,0.464,10,18,0.556,111,2014-01-07,PHI,CLE,2014,117.5
10042,10042,42,Home,W 93-66 ,240,37,83,0.446,31,70,0.443,6,13,0.462,13,22,0.591,93,26,81,0.321,21,67,0.313,5,14,0.357,9,23,0.391,66,2014-01-10,IND,WAS,2014,68.5
10043,10043,43,@,L 93-96 ,240,35,76,0.461,26,52,0.5,9,24,0.375,14,16,0.875,93,40,79,0.506,34,68,0.5,6,11,0.545,10,13,0.769,96,2014-01-17,CHI,WAS,2014,99.0
10044,10044,44,@,L 93-108 ,240,33,77,0.429,28,60,0.467,5,17,0.294,22,28,0.786,93,39,86,0.453,30,65,0.462,9,21,0.429,21,30,0.7,108,2014-01-19,SAC,OKC,2014,112.5
10045,10045,45,Home,W 93-91 ,240,30,71,0.423,26,56,0.464,4,15,0.267,29,36,0.806,93,33,90,0.367,30,77,0.39,3,13,0.231,22,24,0.917,91,2014-01-19,ORL,BOS,2014,92.5
10046,10046,46,Home,W 93-86 ,240,38,74,0.514,33,54,0.611,5,20,0.25,12,16,0.75,93,33,84,0.393,28,57,0.491,5,27,0.185,15,18,0.833,86,2014-01-21,MIA,BOS,2014,88.5
10047,10047,47,Home,W 93-85 ,240,32,76,0.421,25,53,0.472,7,23,0.304,22,32,0.688,93,34,73,0.466,27,53,0.509,7,20,0.35,10,14,0.714,85,2014-01-22,TOR,DAL,2014,88.5
10048,10048,48,Home,W 93-78 ,240,37,88,0.42,33,74,0.446,4,14,0.286,15,23,0.652,93,30,74,0.405,23,50,0.46,7,24,0.292,11,14,0.786,78,2014-01-24,CLE,MIL,2014,81.5
10049,10049,49,@,L 93-95 ,240,34,83,0.41,29,69,0.42,5,14,0.357,20,25,0.8,93,36,75,0.48,30,53,0.566,6,22,0.273,17,26,0.654,95,2014-02-01,SAC,SAS,2014,98.0
10050,10050,50,Home,W 93-81 ,240,35,66,0.53,29,38,0.763,6,28,0.214,17,29,0.586,93,30,83,0.361,24,65,0.369,6,18,0.333,15,27,0.556,81,2014-02-09,BRK,NOP,2014,84.0
10051,10051,51,Home,W 93-92 ,240,34,83,0.41,29,71,0.408,5,12,0.417,20,26,0.769,93,35,79,0.443,24,55,0.436,11,24,0.458,11,19,0.579,92,2014-02-09,ORL,IND,2014,97.5
10052,10052,52,Home,W 93-84 ,240,34,79,0.43,26,58,0.448,8,21,0.381,17,22,0.773,93,29,82,0.354,27,71,0.38,2,11,0.182,24,28,0.857,84,2014-02-09,WAS,SAC,2014,85.0
10053,10053,53,@,W 93-89 ,240,34,84,0.405,29,69,0.42,5,15,0.333,20,30,0.667,93,33,83,0.398,29,60,0.483,4,23,0.174,19,27,0.704,89,2014-02-12,CLE,DET,2014,91.0
10054,10054,54,@,L 93-98 ,240,35,85,0.412,29,58,0.5,6,27,0.222,17,20,0.85,93,37,75,0.493,31,63,0.492,6,12,0.5,18,24,0.75,98,2014-02-18,NYK,MEM,2014,101.0
10055,10055,55,Home,L 93-103 ,240,38,81,0.469,34,66,0.515,4,15,0.267,13,21,0.619,93,42,74,0.568,35,58,0.603,7,16,0.438,12,15,0.8,103,2014-02-18,WAS,TOR,2014,106.5
10056,10056,56,@,L 93-101 ,240,35,89,0.393,29,67,0.433,6,22,0.273,17,24,0.708,93,33,80,0.413,28,60,0.467,5,20,0.25,30,37,0.811,101,2014-02-19,ORL,CLE,2014,103.5
10057,10057,57,Home,W 93-86 ,240,37,85,0.435,31,65,0.477,6,20,0.3,13,17,0.765,93,32,78,0.41,30,57,0.526,2,21,0.095,20,24,0.833,86,2014-02-22,GSW,BRK,2014,87.0
10058,10058,58,@,L 93-94 ,240,35,81,0.432,29,68,0.426,6,13,0.462,17,21,0.81,93,36,74,0.486,33,60,0.55,3,14,0.214,19,26,0.731,94,2014-02-22,NOP,WAS,2014,95.5
10059,10059,59,Home,W 93-79 ,240,37,88,0.42,28,65,0.431,9,23,0.391,10,14,0.714,93,29,81,0.358,23,60,0.383,6,21,0.286,15,17,0.882,79,2014-02-23,MIA,CHI,2014,82.0
10060,10060,60,Home,L 93-99 ,240,34,84,0.405,29,67,0.433,5,17,0.294,20,24,0.833,93,35,79,0.443,25,47,0.532,10,32,0.313,19,24,0.792,99,2014-02-25,CLE,TOR,2014,104.0
10061,10061,61,@,L 93-101 ,240,34,77,0.442,26,52,0.5,8,25,0.32,17,24,0.708,93,41,93,0.441,33,69,0.478,8,24,0.333,11,13,0.846,101,2014-02-26,HOU,LAC,2014,105.0
10062,10062,62,@,L 93-105 ,240,35,82,0.427,29,67,0.433,6,15,0.4,17,21,0.81,93,44,91,0.484,36,72,0.5,8,19,0.421,9,14,0.643,105,2014-03-14,MIN,CHA,2014,109.0
10063,10063,63,@,L 93-109 ,240,32,80,0.4,26,67,0.388,6,13,0.462,23,30,0.767,93,45,89,0.506,34,64,0.531,11,25,0.44,8,12,0.667,109,2014-03-19,ORL,PHO,2014,114.5
10064,10064,64,@,W 93-92 ,240,34,82,0.415,27,53,0.509,7,29,0.241,18,25,0.72,93,34,91,0.374,24,50,0.48,10,41,0.244,14,21,0.667,92,2014-03-21,NYK,PHI,2014,97.0
10065,10065,65,Home,W 93-91 ,240,37,84,0.44,32,69,0.464,5,15,0.333,14,23,0.609,93,28,74,0.378,17,35,0.486,11,39,0.282,24,27,0.889,91,2014-03-24,MIA,POR,2014,96.5
10066,10066,66,Home,L 93-99 ,240,37,81,0.457,31,62,0.5,6,19,0.316,13,21,0.619,93,37,75,0.493,23,47,0.489,14,28,0.5,11,12,0.917,99,2014-03-26,WAS,PHO,2014,106.0
10067,10067,67,@,L 93-100 ,240,41,81,0.506,39,69,0.565,2,12,0.167,9,16,0.563,93,40,81,0.494,31,61,0.508,9,20,0.45,11,14,0.786,100,2014-03-28,MEM,GSW,2014,104.5
10068,10068,68,Home,L 93-98 ,240,38,69,0.551,31,50,0.62,7,19,0.368,10,14,0.714,93,33,73,0.452,27,54,0.5,6,19,0.316,26,27,0.963,98,2014-03-30,ORL,TOR,2014,101.0
10069,10069,69,Home,W 93-83 ,240,34,66,0.515,27,41,0.659,7,25,0.28,18,22,0.818,93,35,70,0.5,27,44,0.614,8,26,0.308,5,10,0.5,83,2014-03-31,MIA,TOR,2014,87.0
10070,10070,70,Home,L 93-123 ,240,35,83,0.422,31,65,0.477,4,18,0.222,19,26,0.731,93,42,79,0.532,30,57,0.526,12,22,0.545,27,35,0.771,123,2014-04-02,PHI,CHA,2014,129.0
10071,10071,71,Home,L 93-109 ,240,35,81,0.432,29,60,0.483,6,21,0.286,17,27,0.63,93,39,97,0.402,33,76,0.434,6,21,0.286,25,31,0.806,109,2014-04-04,POR,PHO,2014,112.0
10072,10072,72,@,W 93-91 ,240,36,89,0.404,23,58,0.397,13,31,0.419,8,14,0.571,93,36,76,0.474,31,58,0.534,5,18,0.278,14,20,0.7,91,2014-04-06,DAL,SAC,2014,93.5
10073,10073,73,@,W 93-88 ,240,36,79,0.456,35,60,0.583,1,19,0.053,20,21,0.952,93,34,80,0.425,28,58,0.483,6,22,0.273,14,25,0.56,88,2014-04-11,ATL,BRK,2014,91.0
10074,10074,74,Home,L 93-95 ,240,34,79,0.43,26,49,0.531,8,30,0.267,17,23,0.739,93,35,80,0.438,29,55,0.527,6,25,0.24,19,31,0.613,95,2014-04-14,ATL,CHA,2014,98.0
10075,10075,75,@,L 93-114 ,240,36,80,0.45,29,53,0.547,7,27,0.259,14,16,0.875,93,46,78,0.59,32,49,0.653,14,29,0.483,8,15,0.533,114,2014-04-14,MIA,WAS,2014,121.0
10076,10076,76,Home,L 93-104 ,240,38,81,0.469,35,63,0.556,3,18,0.167,14,17,0.824,93,40,77,0.519,26,50,0.52,14,27,0.519,10,14,0.714,104,2014-10-29,UTA,HOU,2015,111.0
10077,10077,77,Home,W 93-90 ,240,34,87,0.391,27,57,0.474,7,30,0.233,18,25,0.72,93,28,65,0.431,22,44,0.5,6,21,0.286,28,34,0.824,90,2014-10-30,LAC,OKC,2015,93.0
10078,10078,78,Home,W 93-81 ,240,36,88,0.409,27,64,0.422,9,24,0.375,12,21,0.571,93,32,86,0.372,27,63,0.429,5,23,0.217,12,22,0.545,81,2014-10-31,MIL,PHI,2015,83.5
10079,10079,79,@,L 93-96 ,240,33,70,0.471,27,55,0.491,6,15,0.4,21,29,0.724,93,39,78,0.5,31,62,0.5,8,16,0.5,10,17,0.588,96,2014-11-02,CHA,NYK,2015,100.0
10080,10080,80,Home,W 93-81 ,240,31,76,0.408,27,62,0.435,4,14,0.286,27,37,0.73,93,29,86,0.337,25,62,0.403,4,24,0.167,19,29,0.655,81,2014-11-03,MEM,NOP,2015,83.0
10081,10081,81,Home,L 93-104 ,240,33,74,0.446,22,52,0.423,11,22,0.5,16,23,0.696,93,32,75,0.427,16,41,0.39,16,34,0.471,24,30,0.8,104,2014-11-03,PHI,HOU,2015,112.0
10082,10082,82,Home,W 93-92 ,240,40,88,0.455,35,70,0.5,5,18,0.278,8,11,0.727,93,29,82,0.354,26,68,0.382,3,14,0.214,31,34,0.912,92,2014-11-08,MIL,MEM,2015,93.5
10083,10083,83,@,L 93-101 ,240,36,80,0.45,30,56,0.536,6,24,0.25,15,22,0.682,93,36,78,0.462,30,60,0.5,6,18,0.333,23,27,0.852,101,2014-11-09,SAC,OKC,2015,104.0
10084,10084,84,Home,L 93-100 ,240,35,89,0.393,27,64,0.422,8,25,0.32,15,21,0.714,93,37,77,0.481,33,62,0.532,4,15,0.267,22,32,0.688,100,2014-11-13,TOR,CHI,2015,102.0
10085,10085,85,@,W 93-80 ,240,33,80,0.413,23,57,0.404,10,23,0.435,17,20,0.85,93,28,75,0.373,26,63,0.413,2,12,0.167,22,31,0.71,80,2014-11-14,SAS,LAL,2015,81.0
10086,10086,86,@,L 93-111 ,240,33,75,0.44,28,59,0.475,5,16,0.313,22,30,0.733,93,43,84,0.512,35,63,0.556,8,21,0.381,17,23,0.739,111,2014-11-15,UTA,TOR,2015,115.0
10087,10087,87,@,L 93-98 ,240,37,78,0.474,30,61,0.492,7,17,0.412,12,18,0.667,93,42,84,0.5,39,74,0.527,3,10,0.3,11,16,0.688,98,2014-11-15,ORL,WAS,2015,99.5
10088,10088,88,@,L 93-109 ,240,32,82,0.39,19,48,0.396,13,34,0.382,16,26,0.615,93,41,76,0.539,35,62,0.565,6,14,0.429,21,27,0.778,109,2014-11-16,DEN,NYK,2015,112.0
10089,10089,89,Home,L 93-107 ,240,32,80,0.4,21,56,0.375,11,24,0.458,18,24,0.75,93,41,79,0.519,28,53,0.528,13,26,0.5,12,15,0.8,107,2014-11-17,DET,ORL,2015,113.5
10090,10090,90,@,L 93-119 ,240,34,78,0.436,26,44,0.591,8,34,0.235,17,21,0.81,93,46,86,0.535,39,69,0.565,7,17,0.412,20,22,0.909,119,2014-11-17,HOU,MEM,2015,122.5
10091,10091,91,@,L 93-102 ,240,38,85,0.447,33,66,0.5,5,19,0.263,12,19,0.632,93,38,76,0.5,31,57,0.544,7,19,0.368,19,23,0.826,102,2014-11-17,NOP,POR,2015,105.5
10092,10092,92,Home,L 93-110 ,240,30,67,0.448,24,41,0.585,6,26,0.231,27,31,0.871,93,43,77,0.558,30,46,0.652,13,31,0.419,11,17,0.647,110,2014-11-20,MIA,LAC,2015,116.5
10093,10093,93,Home,L 93-110 ,240,35,81,0.432,32,65,0.492,3,16,0.188,20,29,0.69,93,32,80,0.4,24,56,0.429,8,24,0.333,38,42,0.905,110,2014-11-22,CLE,TOR,2015,114.0
10094,10094,94,@,L 93-94 ,240,37,79,0.468,30,58,0.517,7,21,0.333,12,16,0.75,93,33,66,0.5,22,43,0.512,11,23,0.478,17,19,0.895,94,2014-11-23,CHA,MIA,2015,99.5
10095,10095,95,Home,L 93-99 ,240,33,81,0.407,25,62,0.403,8,19,0.421,19,24,0.792,93,36,80,0.45,31,58,0.534,5,22,0.227,22,25,0.88,99,2014-11-26,LAL,MEM,2015,101.5
10096,10096,96,Home,L 93-104 ,240,33,91,0.363,22,68,0.324,11,23,0.478,16,24,0.667,93,37,79,0.468,28,58,0.483,9,21,0.429,21,27,0.778,104,2014-11-30,DET,GSW,2015,108.5
10097,10097,97,@,W 93-90 ,240,35,76,0.461,30,61,0.492,5,15,0.333,18,25,0.72,93,34,85,0.4,27,59,0.458,7,26,0.269,15,18,0.833,90,2014-11-30,ORL,PHO,2015,93.5
10098,10098,98,@,L 93-107 ,240,39,90,0.433,37,81,0.457,2,9,0.222,13,20,0.65,93,39,86,0.453,27,53,0.509,12,33,0.364,17,25,0.68,107,2014-11-30,MIN,POR,2015,113.0
10099,10099,99,Home,L 93-98 ,240,35,81,0.432,24,53,0.453,11,28,0.393,12,14,0.857,93,39,89,0.438,33,72,0.458,6,17,0.353,14,20,0.7,98,2014-12-02,NYK,BRK,2015,101.0
10100,10100,0,@,L 93-95 (OT),265,36,101,0.356,24,69,0.348,12,32,0.375,9,12,0.75,93,37,90,0.411,28,71,0.394,9,19,0.474,12,18,0.667,95,2014-12-03,SAS,BRK,2015,99.5
10101,10101,1,Home,L 93-98 ,240,36,79,0.456,28,63,0.444,8,16,0.5,13,21,0.619,93,37,74,0.5,30,57,0.526,7,17,0.412,17,20,0.85,98,2014-12-05,UTA,ORL,2015,101.5
10102,10102,2,@,L 93-101 ,240,34,93,0.366,23,66,0.348,11,27,0.407,14,21,0.667,93,36,88,0.409,28,71,0.394,8,17,0.471,21,26,0.808,101,2014-12-07,WAS,BOS,2015,105.0
10103,10103,3,@,L 93-104 ,240,37,78,0.474,28,59,0.475,9,19,0.474,10,13,0.769,93,40,80,0.5,36,65,0.554,4,15,0.267,20,26,0.769,104,2014-12-09,NYK,NOP,2015,106.0
10104,10104,4,@,L 93-105 ,240,37,90,0.411,28,55,0.509,9,35,0.257,10,15,0.667,93,40,81,0.494,32,58,0.552,8,23,0.348,17,20,0.85,105,2014-12-10,HOU,GSW,2015,109.0
10105,10105,5,@,W 93-75 ,240,33,71,0.465,24,53,0.453,9,18,0.5,18,21,0.857,93,28,80,0.35,24,58,0.414,4,22,0.182,15,18,0.833,75,2014-12-14,CHI,MIA,2015,77.0
10106,10106,6,Home,W 93-84 ,240,41,84,0.488,37,71,0.521,4,13,0.308,7,12,0.583,93,30,78,0.385,25,61,0.41,5,17,0.294,19,28,0.679,84,2014-12-14,WAS,UTA,2015,86.5
10107,10107,7,Home,W 93-86 ,240,36,83,0.434,29,62,0.468,7,21,0.333,14,17,0.824,93,35,93,0.376,29,64,0.453,6,29,0.207,10,14,0.714,86,2014-12-15,ATL,CHI,2015,89.0
10108,10108,8,@,L 93-99 ,240,32,77,0.416,29,64,0.453,3,13,0.231,26,26,1.0,93,37,86,0.43,28,60,0.467,9,26,0.346,16,20,0.8,99,2014-12-20,SAS,DAL,2015,103.5
10109,10109,9,@,L 93-113 ,240,36,92,0.391,31,76,0.408,5,16,0.313,16,21,0.762,93,42,86,0.488,32,62,0.516,10,24,0.417,19,25,0.76,113,2014-12-25,LAL,CHI,2015,118.0
10110,10110,10,@,L 93-114 ,240,36,81,0.444,33,67,0.493,3,14,0.214,18,33,0.545,93,42,88,0.477,24,45,0.533,18,43,0.419,12,14,0.857,114,2014-12-26,PHI,POR,2015,123.0
10111,10111,11,@,L 93-95 (OT),265,34,89,0.382,26,61,0.426,8,28,0.286,17,20,0.85,93,39,89,0.438,33,65,0.508,6,24,0.25,11,18,0.611,95,2014-12-31,NOP,SAS,2015,98.0
10112,10112,12,Home,L 93-105 ,240,34,82,0.415,24,53,0.453,10,29,0.345,15,19,0.789,93,39,86,0.453,27,52,0.519,12,34,0.353,15,24,0.625,105,2015-01-07,CLE,HOU,2015,111.0
10113,10113,13,Home,W 93-90 ,240,33,74,0.446,26,57,0.456,7,17,0.412,20,26,0.769,93,35,88,0.398,27,66,0.409,8,22,0.364,12,16,0.75,90,2015-01-07,DEN,ORL,2015,94.0
10114,10114,14,@,L 93-98 ,240,37,88,0.42,28,57,0.491,9,31,0.29,10,10,1.0,93,34,80,0.425,23,47,0.489,11,33,0.333,19,26,0.731,98,2015-01-10,BRK,DET,2015,103.5
10115,10115,15,Home,L 93-108 ,240,32,81,0.395,29,66,0.439,3,15,0.2,26,26,1.0,93,41,84,0.488,32,60,0.533,9,24,0.375,17,20,0.85,108,2015-01-10,MIN,SAS,2015,112.5
10116,10116,16,Home,W 93-92 ,240,32,80,0.4,21,56,0.375,11,24,0.458,18,25,0.72,93,29,87,0.333,25,69,0.362,4,18,0.222,30,42,0.714,92,2015-01-10,PHI,IND,2015,94.0
10117,10117,17,@,L 93-101 ,240,38,96,0.396,29,67,0.433,9,29,0.31,8,12,0.667,93,37,75,0.493,31,63,0.492,6,12,0.5,21,24,0.875,101,2015-01-13,SAS,WAS,2015,104.0
10118,10118,18,Home,L 93-98 ,240,33,86,0.384,29,73,0.397,4,13,0.308,23,35,0.657,93,37,85,0.435,29,64,0.453,8,21,0.381,16,20,0.8,98,2015-01-14,CHA,SAS,2015,102.0
10119,10119,19,Home,L 93-95 ,240,31,72,0.431,24,47,0.511,7,25,0.28,24,29,0.828,93,39,82,0.476,34,65,0.523,5,17,0.294,12,20,0.6,95,2015-01-18,TOR,NOP,2015,97.5
10120,10120,20,Home,W 93-82 ,240,37,84,0.44,28,54,0.519,9,30,0.3,10,14,0.714,93,29,82,0.354,20,47,0.426,9,35,0.257,15,26,0.577,82,2015-01-19,ATL,DET,2015,86.5
10121,10121,21,@,L 93-102 ,240,33,84,0.393,21,55,0.382,12,29,0.414,15,21,0.714,93,39,82,0.476,30,61,0.492,9,21,0.429,15,19,0.789,102,2015-01-19,BOS,LAC,2015,106.5
10122,10122,22,@,L 93-103 ,240,36,87,0.414,26,61,0.426,10,26,0.385,11,18,0.611,93,40,83,0.482,30,58,0.517,10,25,0.4,13,13,1.0,103,2015-01-23,OKC,ATL,2015,108.0
10123,10123,23,@,W 93-85 ,240,39,85,0.459,29,68,0.426,10,17,0.588,5,7,0.714,93,32,82,0.39,29,67,0.433,3,15,0.2,18,24,0.75,85,2015-01-28,DEN,NOP,2015,86.5
10124,10124,24,@,W 93-87 ,240,35,84,0.417,27,54,0.5,8,30,0.267,15,20,0.75,93,32,90,0.356,25,66,0.379,7,24,0.292,16,23,0.696,87,2015-01-30,HOU,BOS,2015,90.5
10125,10125,25,@,W 93-72 ,240,34,82,0.415,21,53,0.396,13,29,0.448,12,20,0.6,93,29,88,0.33,20,59,0.339,9,29,0.31,5,10,0.5,72,2015-01-30,DAL,MIA,2015,76.5
10126,10126,26,@,L 93-99 ,240,36,87,0.414,32,69,0.464,4,18,0.222,17,27,0.63,93,39,90,0.433,33,68,0.485,6,22,0.273,15,17,0.882,99,2015-01-30,CHI,PHO,2015,102.0
10127,10127,27,Home,L 93-108 ,240,33,78,0.423,25,54,0.463,8,24,0.333,19,24,0.792,93,42,74,0.568,31,53,0.585,11,21,0.524,13,22,0.591,108,2015-01-31,ORL,DAL,2015,113.5
10128,10128,28,Home,L 93-109 ,240,35,79,0.443,25,46,0.543,10,33,0.303,13,18,0.722,93,40,81,0.494,31,62,0.5,9,19,0.474,20,23,0.87,109,2015-02-04,TOR,BRK,2015,113.5
10129,10129,29,@,L 93-100 ,240,37,80,0.463,30,60,0.5,7,20,0.35,12,18,0.667,93,38,84,0.452,24,57,0.421,14,27,0.519,10,14,0.714,100,2015-02-06,UTA,PHO,2015,107.0
10130,10130,30,@,L 93-96 ,240,36,86,0.419,29,57,0.509,7,29,0.241,14,20,0.7,93,37,75,0.493,29,55,0.527,8,20,0.4,14,19,0.737,96,2015-02-07,BOS,MIL,2015,100.0
10131,10131,31,Home,L 93-95 ,240,36,88,0.409,28,67,0.418,8,21,0.381,13,13,1.0,93,37,89,0.416,31,64,0.484,6,25,0.24,15,17,0.882,95,2015-02-09,IND,SAS,2015,98.0
10132,10132,32,@,L 93-113 ,240,34,84,0.405,25,60,0.417,9,24,0.375,16,20,0.8,93,44,78,0.564,34,53,0.642,10,25,0.4,15,19,0.789,113,2015-02-11,MIA,CLE,2015,118.0
10133,10133,33,Home,L 93-106 ,240,34,74,0.459,27,59,0.458,7,15,0.467,18,25,0.72,93,40,75,0.533,31,55,0.564,9,20,0.45,17,18,0.944,106,2015-02-11,NOP,IND,2015,110.5
10134,10134,34,@,L 93-95 ,240,39,85,0.459,34,64,0.531,5,21,0.238,10,16,0.625,93,31,76,0.408,20,50,0.4,11,26,0.423,22,26,0.846,95,2015-02-11,WAS,TOR,2015,100.5
10135,10135,35,Home,L 93-102 ,240,33,82,0.402,24,58,0.414,9,24,0.375,18,30,0.6,93,34,77,0.442,20,40,0.5,14,37,0.378,20,24,0.833,102,2015-02-24,DET,CLE,2015,109.0
10136,10136,36,@,W 93-90 (OT),265,32,84,0.381,26,53,0.491,6,31,0.194,23,32,0.719,93,33,78,0.423,27,56,0.482,6,22,0.273,18,31,0.581,90,2015-02-25,MIA,ORL,2015,93.0
10137,10137,37,Home,W 93-86 ,240,34,80,0.425,28,63,0.444,6,17,0.353,19,29,0.655,93,33,92,0.359,24,63,0.381,9,29,0.31,11,14,0.786,86,2015-02-27,IND,CLE,2015,90.5
10138,10138,38,@,L 93-101 ,240,34,87,0.391,30,70,0.429,4,17,0.235,21,29,0.724,93,40,85,0.471,34,67,0.507,6,18,0.333,15,22,0.682,101,2015-02-27,MIL,LAL,2015,104.0
10139,10139,39,@,W 93-91 ,240,34,79,0.43,24,54,0.444,10,25,0.4,15,20,0.75,93,32,81,0.395,25,55,0.455,7,26,0.269,20,21,0.952,91,2015-02-28,ATL,MIA,2015,94.5
10140,10140,40,@,L 93-102 ,240,35,74,0.473,25,53,0.472,10,21,0.476,13,16,0.813,93,38,79,0.481,32,63,0.508,6,16,0.375,20,22,0.909,102,2015-03-02,NOP,DAL,2015,105.0
10141,10141,41,@,W 93-82 ,240,36,80,0.45,31,55,0.564,5,25,0.2,16,19,0.842,93,33,82,0.402,30,71,0.423,3,11,0.273,13,19,0.684,82,2015-03-03,UTA,MEM,2015,83.5
10142,10142,42,@,L 93-102 ,240,34,80,0.425,29,66,0.439,5,14,0.357,20,25,0.8,93,37,73,0.507,23,39,0.59,14,34,0.412,14,25,0.56,102,2015-03-04,MIL,GSW,2015,109.0
10143,10143,43,Home,L 93-98 (OT),265,37,96,0.385,26,65,0.4,11,31,0.355,8,18,0.444,93,34,87,0.391,26,55,0.473,8,32,0.25,22,29,0.759,98,2015-03-04,LAC,POR,2015,102.0
10144,10144,44,@,L 93-103 ,240,37,102,0.363,31,73,0.425,6,29,0.207,13,17,0.765,93,38,91,0.418,32,63,0.508,6,28,0.214,21,25,0.84,103,2015-03-06,DET,HOU,2015,106.0
10145,10145,45,Home,L 93-100 ,240,38,82,0.463,36,68,0.529,2,14,0.143,15,21,0.714,93,38,78,0.487,29,52,0.558,9,26,0.346,15,22,0.682,100,2015-03-08,LAL,DAL,2015,104.5
10146,10146,46,Home,W 93-85 ,240,32,75,0.427,29,62,0.468,3,13,0.231,26,30,0.867,93,32,84,0.381,24,49,0.49,8,35,0.229,13,19,0.684,85,2015-03-10,LAL,DET,2015,89.0
10147,10147,47,@,W 93-89 ,240,35,83,0.422,27,55,0.491,8,28,0.286,15,21,0.714,93,34,85,0.4,25,61,0.41,9,24,0.375,12,15,0.8,89,2015-03-14,BOS,IND,2015,93.5
10148,10148,48,Home,W 93-75 ,240,40,90,0.444,34,72,0.472,6,18,0.333,7,13,0.538,93,32,81,0.395,29,63,0.46,3,18,0.167,8,15,0.533,75,2015-03-22,OKC,MIA,2015,76.5
10149,10149,49,@,W 93-86 ,240,34,77,0.442,25,53,0.472,9,24,0.375,16,23,0.696,93,28,69,0.406,23,50,0.46,5,19,0.263,25,37,0.676,86,2015-03-25,MIA,BOS,2015,88.5
10150,10150,50,Home,L 93-95 ,240,34,75,0.453,29,60,0.483,5,15,0.333,20,32,0.625,93,40,81,0.494,34,59,0.576,6,22,0.273,9,12,0.75,95,2015-03-25,NOP,HOU,2015,98.0
10151,10151,51,@,L 93-106 ,240,36,91,0.396,26,57,0.456,10,34,0.294,11,17,0.647,93,44,76,0.579,40,64,0.625,4,12,0.333,14,22,0.636,106,2015-04-01,PHI,WAS,2015,108.0
10152,10152,52,Home,W 93-74 ,240,36,83,0.434,28,67,0.418,8,16,0.5,13,18,0.722,93,28,80,0.35,24,62,0.387,4,18,0.222,14,20,0.7,74,2015-04-03,IND,CHO,2015,76.0
10153,10153,53,@,L 93-123 ,240,40,87,0.46,34,70,0.486,6,17,0.353,7,11,0.636,93,47,85,0.553,33,51,0.647,14,34,0.412,15,17,0.882,123,2015-04-03,DEN,SAS,2015,130.0
10154,10154,54,@,L 93-100 ,240,35,85,0.412,29,64,0.453,6,21,0.286,17,28,0.607,93,39,83,0.47,36,73,0.493,3,10,0.3,19,23,0.826,100,2015-04-13,ORL,MIA,2015,101.5
10155,10155,55,@,L 93-95 ,240,35,80,0.438,26,56,0.464,9,24,0.375,14,20,0.7,93,38,99,0.384,32,72,0.444,6,27,0.222,13,15,0.867,95,2015-04-14,TOR,BOS,2015,98.0
10156,10156,56,Home,L 93-103 ,240,31,85,0.365,21,51,0.412,10,34,0.294,21,28,0.75,93,40,87,0.46,29,57,0.509,11,30,0.367,12,16,0.75,103,2015-11-01,LAL,DAL,2016,108.5
10157,10157,57,@,L 93-117 ,240,35,92,0.38,26,66,0.394,9,26,0.346,14,19,0.737,93,45,86,0.523,32,61,0.525,13,25,0.52,14,18,0.778,117,2015-11-01,DEN,OKC,2016,123.5
10158,10158,58,Home,L 93-102 (OT),265,33,93,0.355,22,61,0.361,11,32,0.344,16,23,0.696,93,39,96,0.406,32,80,0.4,7,16,0.438,17,27,0.63,102,2015-11-07,CHI,MIN,2016,105.5
10159,10159,59,@,L 93-95 ,240,42,86,0.488,38,65,0.585,4,21,0.19,5,7,0.714,93,35,84,0.417,27,61,0.443,8,23,0.348,17,28,0.607,95,2015-11-11,NYK,CHO,2016,99.0
10160,10160,60,@,L 93-106 ,240,36,76,0.474,30,56,0.536,6,20,0.3,15,20,0.75,93,42,103,0.408,31,70,0.443,11,33,0.333,11,12,0.917,106,2015-11-13,ATL,BOS,2016,111.5
10161,10161,61,@,L 93-102 ,240,34,87,0.391,26,62,0.419,8,25,0.32,17,23,0.739,93,32,76,0.421,22,49,0.449,10,27,0.37,28,31,0.903,102,2015-11-13,UTA,ORL,2016,107.0
10162,10162,62,Home,W 93-80 ,240,38,89,0.427,31,66,0.47,7,23,0.304,10,13,0.769,93,31,75,0.413,24,56,0.429,7,19,0.368,11,13,0.846,80,2015-11-16,SAS,POR,2016,83.5
10163,10163,63,Home,W 93-89 ,240,35,72,0.486,28,50,0.56,7,22,0.318,16,22,0.727,93,34,80,0.425,29,60,0.483,5,20,0.25,16,18,0.889,89,2015-11-18,UTA,TOR,2016,91.5
10164,10164,64,@,L 93-102 ,240,35,80,0.438,29,60,0.483,6,20,0.3,17,21,0.81,93,39,83,0.47,31,55,0.564,8,28,0.286,16,17,0.941,102,2015-11-20,UTA,DAL,2016,106.0
10165,10165,65,@,W 93-90 ,240,33,72,0.458,21,52,0.404,12,20,0.6,15,23,0.652,93,35,92,0.38,32,63,0.508,3,29,0.103,17,23,0.739,90,2015-11-20,NYK,OKC,2016,91.5
10166,10166,66,Home,L 93-107 ,240,32,88,0.364,26,70,0.371,6,18,0.333,23,27,0.852,93,43,87,0.494,35,62,0.565,8,25,0.32,13,17,0.765,107,2015-11-22,LAL,POR,2016,111.0
10167,10167,67,@,W 93-88 ,240,33,86,0.384,26,68,0.382,7,18,0.389,20,23,0.87,93,31,88,0.352,25,66,0.379,6,22,0.273,20,27,0.741,88,2015-11-24,CHI,POR,2016,91.0
10168,10168,68,Home,L 93-102 ,240,30,71,0.423,20,37,0.541,10,34,0.294,23,27,0.852,93,39,80,0.488,36,64,0.563,3,16,0.188,21,23,0.913,102,2015-11-25,HOU,MEM,2016,103.5
10169,10169,69,Home,L 93-96 ,240,29,77,0.377,25,58,0.431,4,19,0.211,31,38,0.816,93,38,86,0.442,33,69,0.478,5,17,0.294,15,20,0.75,96,2015-12-01,MIN,ORL,2016,98.5
10170,10170,70,@,L 93-95 ,240,36,82,0.439,27,51,0.529,9,31,0.29,12,17,0.706,93,36,90,0.4,31,75,0.413,5,15,0.333,18,24,0.75,95,2015-12-06,PHO,MEM,2016,97.5
10171,10171,71,Home,L 93-111 ,240,37,90,0.411,33,77,0.429,4,13,0.308,15,18,0.833,93,40,81,0.494,28,53,0.528,12,28,0.429,19,24,0.792,111,2015-12-07,NOP,BOS,2016,117.0
10172,10172,72,@,L 93-102 ,240,34,83,0.41,27,64,0.422,7,19,0.368,18,20,0.9,93,34,74,0.459,25,49,0.51,9,25,0.36,25,32,0.781,102,2015-12-07,LAL,TOR,2016,106.5
10173,10173,73,@,W 93-92 ,240,41,88,0.466,37,73,0.507,4,15,0.267,7,13,0.538,93,37,87,0.425,29,58,0.5,8,29,0.276,10,15,0.667,92,2015-12-09,MEM,DET,2016,96.0
10174,10174,74,Home,L 93-98 ,240,36,88,0.409,25,53,0.472,11,35,0.314,10,10,1.0,93,40,96,0.417,31,71,0.437,9,25,0.36,9,10,0.9,98,2015-12-12,CHA,BOS,2016,102.5
10175,10175,75,@,W 93-92 ,240,35,78,0.449,20,48,0.417,15,30,0.5,8,14,0.571,93,39,88,0.443,35,70,0.5,4,18,0.222,10,12,0.833,92,2015-12-22,DET,MIA,2016,94.0
10176,10176,76,Home,L 93-99 ,240,35,91,0.385,29,66,0.439,6,25,0.24,17,25,0.68,93,39,84,0.464,35,61,0.574,4,23,0.174,17,23,0.739,99,2015-12-26,DET,BOS,2016,101.0
10177,10177,77,@,L 93-103 ,240,38,79,0.481,34,65,0.523,4,14,0.286,13,15,0.867,93,38,84,0.452,28,62,0.452,10,22,0.455,17,26,0.654,103,2015-12-28,MIL,DAL,2016,108.0
10178,10178,78,Home,W 93-87 ,240,38,87,0.437,31,61,0.508,7,26,0.269,10,18,0.556,93,31,74,0.419,25,49,0.51,6,25,0.24,19,25,0.76,87,2015-12-28,IND,ATL,2016,90.0
10179,10179,79,@,W 93-87 ,240,38,86,0.442,34,64,0.531,4,22,0.182,13,22,0.591,93,37,89,0.416,32,65,0.492,5,24,0.208,8,11,0.727,87,2015-12-29,CLE,DEN,2016,89.5
10180,10180,80,@,L 93-100 ,240,35,83,0.422,32,63,0.508,3,20,0.15,20,22,0.909,93,36,82,0.439,27,56,0.482,9,26,0.346,19,21,0.905,100,2015-12-30,BRK,ORL,2016,104.5
10181,10181,81,Home,W 93-84 ,240,33,87,0.379,28,71,0.394,5,16,0.313,22,29,0.759,93,31,84,0.369,27,60,0.45,4,24,0.167,18,25,0.72,84,2016-01-01,LAL,PHI,2016,86.0
10182,10182,82,@,W 93-91 ,240,33,68,0.485,22,42,0.524,11,26,0.423,16,21,0.762,93,30,75,0.4,18,46,0.391,12,29,0.414,19,25,0.76,91,2016-01-04,HOU,UTA,2016,97.0
10183,10183,83,@,W 93-87 ,240,36,77,0.468,30,57,0.526,6,20,0.3,15,21,0.714,93,33,79,0.418,29,63,0.46,4,16,0.25,17,22,0.773,87,2016-01-10,DAL,MIN,2016,89.0
10184,10184,84,@,L 93-113 ,240,34,85,0.4,29,73,0.397,5,12,0.417,20,23,0.87,93,47,89,0.528,42,66,0.636,5,23,0.217,14,22,0.636,113,2016-01-15,MIN,OKC,2016,115.5
10185,10185,85,Home,L 93-112 ,240,32,90,0.356,28,65,0.431,4,25,0.16,25,31,0.806,93,43,89,0.483,37,69,0.536,6,20,0.3,20,28,0.714,112,2016-01-20,LAL,SAC,2016,115.0
10186,10186,86,@,L 93-115 ,240,33,70,0.471,25,50,0.5,8,20,0.4,19,25,0.76,93,45,81,0.556,34,53,0.642,11,28,0.393,14,16,0.875,115,2016-01-27,PHO,CLE,2016,120.5
10187,10187,87,@,L 93-103 ,240,38,87,0.437,31,69,0.449,7,18,0.389,10,20,0.5,93,37,85,0.435,29,65,0.446,8,20,0.4,21,29,0.724,103,2016-01-28,NYK,TOR,2016,107.0
10188,10188,88,@,L 93-105 ,240,34,78,0.436,29,65,0.446,5,13,0.385,20,25,0.8,93,40,81,0.494,32,55,0.582,8,26,0.308,17,24,0.708,105,2016-01-29,LAL,LAC,2016,109.0
10189,10189,89,@,L 93-120 ,240,40,93,0.43,35,78,0.449,5,15,0.333,8,11,0.727,93,45,84,0.536,28,52,0.538,17,32,0.531,13,19,0.684,120,2016-01-31,CHI,LAC,2016,128.5
10190,10190,90,@,L 93-96 ,240,35,80,0.438,31,64,0.484,4,16,0.25,19,28,0.679,93,32,76,0.421,26,49,0.531,6,27,0.222,26,30,0.867,96,2016-01-31,MIN,POR,2016,99.0
10191,10191,91,@,L 93-112 ,240,29,78,0.372,21,53,0.396,8,25,0.32,27,39,0.692,93,45,83,0.542,35,61,0.574,10,22,0.455,12,15,0.8,112,2016-02-01,TOR,DEN,2016,117.0
10192,10192,92,@,W 93-90 ,240,37,88,0.42,35,73,0.479,2,15,0.133,17,23,0.739,93,34,87,0.391,26,67,0.388,8,20,0.4,14,19,0.737,90,2016-02-03,MIA,DAL,2016,94.0
10193,10193,93,Home,L 93-107 ,240,34,81,0.42,30,61,0.492,4,20,0.2,21,28,0.75,93,40,74,0.541,32,47,0.681,8,27,0.296,19,23,0.826,107,2016-02-05,ORL,LAC,2016,111.0
10194,10194,94,Home,L 93-100 ,240,33,83,0.398,26,66,0.394,7,17,0.412,20,29,0.69,93,37,81,0.457,28,56,0.5,9,25,0.36,17,33,0.515,100,2016-02-07,MIA,LAC,2016,104.5
10195,10195,95,@,L 93-111 ,240,30,81,0.37,23,56,0.411,7,25,0.28,26,36,0.722,93,37,68,0.544,27,45,0.6,10,23,0.435,27,44,0.614,111,2016-02-19,BOS,UTA,2016,116.0
10196,10196,96,@,L 93-101 (OT),265,36,92,0.391,31,77,0.403,5,15,0.333,16,25,0.64,93,38,100,0.38,36,87,0.414,2,13,0.154,23,34,0.676,101,2016-02-22,IND,MIA,2016,102.0
10197,10197,97,@,L 93-116 ,240,34,84,0.405,23,55,0.418,11,29,0.379,14,20,0.7,93,43,107,0.402,36,81,0.444,7,26,0.269,23,24,0.958,116,2016-03-02,POR,BOS,2016,119.5
10198,10198,98,@,L 93-114 ,240,35,80,0.438,28,56,0.5,7,24,0.292,16,22,0.727,93,38,67,0.567,29,51,0.569,9,16,0.563,29,38,0.763,114,2016-03-11,WAS,UTA,2016,118.5
10199,10199,99,Home,W 93-85 ,240,34,85,0.4,30,61,0.492,4,24,0.167,21,25,0.84,93,31,81,0.383,29,63,0.46,2,18,0.111,21,25,0.84,85,2016-03-12,SAS,OKC,2016,86.0
10200,10200,0,Home,L 93-101 ,240,35,83,0.422,26,51,0.51,9,32,0.281,14,20,0.7,93,38,87,0.437,29,69,0.42,9,18,0.5,16,23,0.696,101,2016-03-19,CHA,DEN,2016,105.5
10201,10201,1,@,W 93-84 ,240,39,83,0.47,30,62,0.484,9,21,0.429,6,7,0.857,93,32,84,0.381,28,73,0.384,4,11,0.364,16,19,0.842,84,2016-03-26,UTA,MIN,2016,86.0
10202,10202,2,Home,L 93-107 ,240,33,79,0.418,25,56,0.446,8,23,0.348,19,28,0.679,93,37,83,0.446,23,49,0.469,14,34,0.412,19,25,0.76,107,2016-03-26,NYK,CLE,2016,114.0
10203,10203,3,@,L 93-105 ,240,37,89,0.416,30,74,0.405,7,15,0.467,12,19,0.632,93,38,80,0.475,24,51,0.471,14,29,0.483,15,18,0.833,105,2016-03-28,SAC,POR,2016,112.0
10204,10204,4,@,L 93-110 ,240,34,88,0.386,28,69,0.406,6,19,0.316,19,27,0.704,93,41,79,0.519,31,64,0.484,10,15,0.667,18,23,0.783,110,2016-04-02,MIA,POR,2016,115.0
10205,10205,5,@,L 93-107 ,240,37,82,0.451,30,64,0.469,7,18,0.389,12,16,0.75,93,40,88,0.455,27,54,0.5,13,34,0.382,14,17,0.824,107,2016-04-05,NOP,PHI,2016,113.5
10206,10206,6,@,L 93-103 ,240,35,87,0.402,28,65,0.431,7,22,0.318,16,22,0.727,93,30,60,0.5,18,29,0.621,12,31,0.387,31,39,0.795,103,2016-04-08,MEM,DAL,2016,109.0
10207,10207,7,@,W 93-89 ,240,37,78,0.474,30,58,0.517,7,20,0.35,12,19,0.632,93,32,89,0.36,25,69,0.362,7,20,0.35,18,21,0.857,89,2016-04-10,TOR,NYK,2016,92.5
10208,10208,8,Home,L 93-99 ,240,34,84,0.405,29,66,0.439,5,18,0.278,20,30,0.667,93,38,78,0.487,31,58,0.534,7,20,0.35,16,22,0.727,99,2016-04-12,DET,MIA,2016,102.5
10209,10209,9,Home,W 93-92 ,240,34,80,0.425,23,49,0.469,11,31,0.355,14,21,0.667,93,32,84,0.381,21,54,0.389,11,30,0.367,17,20,0.85,92,2016-10-30,HOU,DAL,2017,97.5
10210,10210,10,@,L 93-109 ,240,34,86,0.395,22,48,0.458,12,38,0.316,13,15,0.867,93,39,79,0.494,26,45,0.578,13,34,0.382,18,26,0.692,109,2016-11-02,PHI,CHO,2017,115.5
10211,10211,11,@,L 93-118 ,240,35,81,0.432,25,50,0.5,10,31,0.323,13,22,0.591,93,46,92,0.5,36,71,0.507,10,21,0.476,16,20,0.8,118,2016-11-09,BOS,WAS,2017,123.0
10212,10212,12,@,L 93-100 ,240,36,95,0.379,25,66,0.379,11,29,0.379,10,12,0.833,93,39,92,0.424,25,54,0.463,14,38,0.368,8,15,0.533,100,2016-11-13,CHA,CLE,2017,107.0
10213,10213,13,Home,W 93-77 ,240,34,78,0.436,25,53,0.472,9,25,0.36,16,18,0.889,93,32,84,0.381,27,57,0.474,5,27,0.185,8,11,0.727,77,2016-11-14,NYK,DAL,2017,79.5
10214,10214,14,@,W 93-90 ,240,37,80,0.463,31,63,0.492,6,17,0.353,13,19,0.684,93,36,89,0.404,29,66,0.439,7,23,0.304,11,14,0.786,90,2016-11-15,ATL,MIA,2017,93.5
10215,10215,15,@,L 93-103 ,240,35,86,0.407,24,56,0.429,11,30,0.367,12,20,0.6,93,43,86,0.5,33,58,0.569,10,28,0.357,7,11,0.636,103,2016-11-16,CLE,IND,2017,108.0
10216,10216,16,Home,W 93-71 ,240,29,76,0.382,27,58,0.466,2,18,0.111,33,38,0.868,93,25,64,0.391,18,42,0.429,7,22,0.318,14,22,0.636,71,2016-11-19,MEM,MIN,2017,74.5
10217,10217,17,Home,W 93-89 ,240,35,86,0.407,27,57,0.474,8,29,0.276,15,21,0.714,93,32,77,0.416,25,52,0.481,7,25,0.28,18,24,0.75,89,2016-11-21,MIL,ORL,2017,92.5
10218,10218,18,Home,L 93-99 ,240,36,86,0.419,32,62,0.516,4,24,0.167,17,25,0.68,93,38,84,0.452,26,46,0.565,12,38,0.316,11,14,0.786,99,2016-11-21,MIN,BOS,2017,105.0
10219,10219,19,Home,L 93-111 ,240,34,89,0.382,22,49,0.449,12,40,0.3,13,16,0.813,93,36,80,0.45,21,46,0.457,15,34,0.441,24,29,0.828,111,2016-12-01,BRK,MIL,2017,118.5
10220,10220,20,Home,W 93-85 ,240,35,81,0.432,23,58,0.397,12,23,0.522,11,16,0.688,93,28,75,0.373,19,50,0.38,9,25,0.36,20,31,0.645,85,2016-12-14,MEM,CLE,2017,89.5
10221,10221,21,Home,L 93-108 ,240,33,82,0.402,22,49,0.449,11,33,0.333,16,21,0.762,93,40,93,0.43,30,76,0.395,10,17,0.588,18,26,0.692,108,2016-12-20,PHI,NOP,2017,113.0
10222,10222,22,Home,L 93-94 ,240,33,74,0.446,24,47,0.511,9,27,0.333,18,22,0.818,93,34,74,0.459,24,53,0.453,10,21,0.476,16,24,0.667,94,2016-12-21,UTA,SAC,2017,99.0
10223,10223,23,Home,W 93-91 ,240,33,85,0.388,26,53,0.491,7,32,0.219,20,25,0.8,93,33,82,0.402,26,58,0.448,7,24,0.292,18,20,0.9,91,2017-01-03,PHI,MIN,2017,94.5
10224,10224,24,@,L 93-101 ,240,34,73,0.466,27,53,0.509,7,20,0.35,18,21,0.857,93,36,91,0.396,28,70,0.4,8,21,0.381,21,28,0.75,101,2017-01-05,UTA,TOR,2017,105.0
10225,10225,25,Home,L 93-100 ,240,38,91,0.418,30,68,0.441,8,23,0.348,9,13,0.692,93,39,86,0.453,24,37,0.649,15,49,0.306,7,12,0.583,100,2017-01-06,ORL,HOU,2017,107.5
10226,10226,26,@,L 93-102 ,240,28,85,0.329,22,62,0.355,6,23,0.261,31,32,0.969,93,36,76,0.474,22,38,0.579,14,38,0.368,16,20,0.8,102,2017-01-13,CHA,PHI,2017,109.0
10227,10227,27,@,L 93-109 ,240,36,87,0.414,26,56,0.464,10,31,0.323,11,21,0.524,93,44,91,0.484,36,74,0.486,8,17,0.471,13,18,0.722,109,2017-01-14,PHI,WAS,2017,113.0
10228,10228,28,@,L 93-102 ,240,34,81,0.42,27,53,0.509,7,28,0.25,18,19,0.947,93,39,82,0.476,30,60,0.5,9,22,0.409,15,19,0.789,102,2017-01-20,CHI,ATL,2017,106.5
10229,10229,29,Home,W 93-92 ,240,36,92,0.391,24,63,0.381,12,29,0.414,9,16,0.563,93,33,89,0.371,27,70,0.386,6,19,0.316,20,28,0.714,92,2017-01-20,PHI,POR,2017,95.0
10230,10230,30,@,L 93-110 ,240,33,78,0.423,21,49,0.429,12,29,0.414,15,18,0.833,93,45,91,0.495,38,71,0.535,7,20,0.35,13,23,0.565,110,2017-01-21,PHI,ATL,2017,113.5
10231,10231,31,@,L 93-103 ,240,35,85,0.412,28,63,0.444,7,22,0.318,16,21,0.762,93,35,76,0.461,25,50,0.5,10,26,0.385,23,31,0.742,103,2017-01-24,UTA,DEN,2017,108.0
10232,10232,32,@,L 93-116 ,240,34,86,0.395,27,60,0.45,7,26,0.269,18,21,0.857,93,45,93,0.484,33,61,0.541,12,32,0.375,14,19,0.737,116,2017-02-01,ATL,MIA,2017,122.0
10233,10233,33,Home,W 93-90 ,240,33,87,0.379,25,61,0.41,8,26,0.308,19,29,0.655,93,34,88,0.386,27,60,0.45,7,28,0.25,15,21,0.714,90,2017-02-06,IND,OKC,2017,93.5
10234,10234,34,@,L 93-110 ,240,40,101,0.396,33,66,0.5,7,35,0.2,6,14,0.429,93,44,97,0.454,34,73,0.466,10,24,0.417,12,17,0.706,110,2017-02-24,LAL,OKC,2017,115.0
10235,10235,35,@,L 93-104 ,240,39,84,0.464,32,64,0.5,7,20,0.35,8,12,0.667,93,37,86,0.43,29,60,0.483,8,26,0.308,22,28,0.786,104,2017-03-08,NYK,MIL,2017,108.0
10236,10236,36,Home,W 92-78 ,240,35,77,0.455,29,61,0.475,6,16,0.375,16,24,0.667,92,28,70,0.4,24,49,0.49,4,21,0.19,18,25,0.72,78,2011-12-28,GSW,NYK,2012,80.0
10237,10237,37,Home,W 92-89 ,240,39,86,0.453,37,62,0.597,2,24,0.083,12,15,0.8,92,34,80,0.425,27,54,0.5,7,26,0.269,14,22,0.636,89,2011-12-31,LAL,DEN,2012,92.5
10238,10238,38,Home,L 92-114 ,240,30,86,0.349,24,64,0.375,6,22,0.273,26,41,0.634,92,40,89,0.449,30,61,0.492,10,28,0.357,24,27,0.889,114,2011-12-31,SAC,NYK,2012,119.0
10239,10239,39,@,L 92-100 ,240,35,83,0.422,32,72,0.444,3,11,0.273,19,23,0.826,92,38,83,0.458,28,63,0.444,10,20,0.5,14,21,0.667,100,2012-01-02,WAS,BOS,2012,105.0
10240,10240,40,Home,L 92-100 ,240,34,73,0.466,29,60,0.483,5,13,0.385,19,28,0.679,92,39,82,0.476,30,66,0.455,9,16,0.563,13,20,0.65,100,2012-01-02,MIA,ATL,2012,104.5
10241,10241,41,Home,W 92-77 ,240,36,77,0.468,26,50,0.52,10,27,0.37,10,13,0.769,92,24,81,0.296,17,58,0.293,7,23,0.304,22,26,0.846,77,2012-01-04,TOR,CLE,2012,80.5
10242,10242,42,Home,W 92-86 ,240,31,69,0.449,27,50,0.54,4,19,0.211,26,40,0.65,92,29,80,0.363,23,60,0.383,6,20,0.3,22,27,0.815,86,2012-01-07,LAC,MIL,2012,89.0
10243,10243,43,Home,W 92-68 ,240,34,74,0.459,31,58,0.534,3,16,0.188,21,25,0.84,92,28,71,0.394,27,67,0.403,1,4,0.25,11,14,0.786,68,2012-01-09,CHI,DET,2012,68.5
10244,10244,44,@,L 92-97 ,240,32,85,0.376,24,61,0.393,8,24,0.333,20,25,0.8,92,37,76,0.487,32,62,0.516,5,14,0.357,18,23,0.783,97,2012-01-13,CLE,LAL,2012,99.5
10245,10245,45,@,L 92-104 ,240,34,83,0.41,29,64,0.453,5,19,0.263,19,23,0.826,92,34,71,0.479,27,53,0.509,7,18,0.389,29,34,0.853,104,2012-01-14,NYK,OKC,2012,107.5
10246,10246,46,Home,W 92-89 ,240,33,71,0.465,28,60,0.467,5,11,0.455,21,27,0.778,92,35,92,0.38,30,73,0.411,5,19,0.263,14,20,0.7,89,2012-01-18,ATL,POR,2012,91.5
10247,10247,47,Home,W 92-88 ,240,28,93,0.301,20,62,0.323,8,31,0.258,28,41,0.683,92,34,78,0.436,33,65,0.508,1,13,0.077,19,27,0.704,88,2012-01-18,SAC,IND,2012,88.5
10248,10248,48,Home,W 92-80 ,240,32,77,0.416,20,50,0.4,12,27,0.444,16,26,0.615,92,29,76,0.382,23,56,0.411,6,20,0.3,16,22,0.727,80,2012-01-20,ORL,LAL,2012,83.0
10249,10249,49,@,L 92-113 ,240,37,83,0.446,29,68,0.426,8,15,0.533,10,15,0.667,92,44,81,0.543,37,65,0.569,7,16,0.438,18,21,0.857,113,2012-01-21,PHI,MIA,2012,116.5
10250,10250,50,Home,L 92-97 ,240,37,92,0.402,32,75,0.427,5,17,0.294,13,17,0.765,92,38,83,0.458,35,72,0.486,3,11,0.273,18,21,0.857,97,2012-01-23,MIL,ATL,2012,98.5
10251,10251,51,Home,L 92-107 ,240,33,80,0.413,28,68,0.412,5,12,0.417,21,27,0.778,92,39,86,0.453,32,65,0.492,7,21,0.333,22,28,0.786,107,2012-01-23,MIN,HOU,2012,110.5
10252,10252,52,Home,W 92-85 ,240,32,70,0.457,27,52,0.519,5,18,0.278,23,26,0.885,92,34,68,0.5,28,52,0.538,6,16,0.375,11,17,0.647,85,2012-01-24,MIA,CLE,2012,88.0
10253,10253,53,Home,W 92-75 ,240,39,83,0.47,36,73,0.493,3,10,0.3,11,16,0.688,92,28,78,0.359,27,69,0.391,1,9,0.111,18,25,0.72,75,2012-01-25,WAS,CHA,2012,75.5
10254,10254,54,@,L 92-95 ,240,40,88,0.455,36,70,0.514,4,18,0.222,8,16,0.5,92,34,76,0.447,29,59,0.492,5,17,0.294,22,29,0.759,95,2012-02-02,POR,SAC,2012,97.5
10255,10255,55,@,L 92-99 ,240,30,72,0.417,20,46,0.435,10,26,0.385,22,26,0.846,92,37,83,0.446,35,69,0.507,2,14,0.143,23,26,0.885,99,2012-02-04,BRK,NYK,2012,100.0
10256,10256,56,Home,L 92-100 ,240,34,81,0.42,31,72,0.431,3,9,0.333,21,26,0.808,92,37,78,0.474,29,54,0.537,8,24,0.333,18,25,0.72,100,2012-02-06,NOP,SAC,2012,104.0
10257,10257,57,@,L 92-99 ,240,32,78,0.41,29,63,0.46,3,15,0.2,25,29,0.862,92,36,71,0.507,29,53,0.547,7,18,0.389,20,26,0.769,99,2012-02-08,LAC,CLE,2012,102.5
10258,10258,58,Home,L 92-99 ,240,33,78,0.423,23,51,0.451,10,27,0.37,16,20,0.8,92,39,73,0.534,37,64,0.578,2,9,0.222,19,29,0.655,99,2012-02-08,BRK,DET,2012,100.0
10259,10259,59,@,L 92-109 ,240,31,74,0.419,26,55,0.473,5,19,0.263,25,31,0.806,92,43,79,0.544,39,69,0.565,4,10,0.4,19,25,0.76,109,2012-02-10,BRK,DET,2012,111.0
10260,10260,60,@,L 92-98 ,240,30,78,0.385,24,62,0.387,6,16,0.375,26,37,0.703,92,34,73,0.466,33,64,0.516,1,9,0.111,29,37,0.784,98,2012-02-10,IND,MEM,2012,98.5
10261,10261,61,Home,W 92-85 ,240,33,77,0.429,28,56,0.5,5,21,0.238,21,34,0.618,92,30,80,0.375,24,56,0.429,6,24,0.25,19,23,0.826,85,2012-02-10,NYK,LAL,2012,88.0
10262,10262,62,Home,L 92-94 ,240,37,78,0.474,31,67,0.463,6,11,0.545,12,17,0.706,92,35,81,0.432,25,58,0.431,10,23,0.435,14,20,0.7,94,2012-02-12,TOR,LAL,2012,99.0
10263,10263,63,@,L 92-96 ,240,33,74,0.446,23,47,0.489,10,27,0.37,16,25,0.64,92,35,79,0.443,29,61,0.475,6,18,0.333,20,28,0.714,96,2012-02-13,LAC,DAL,2012,99.0
10264,10264,64,@,L 92-109 ,240,33,99,0.333,24,75,0.32,9,24,0.375,17,19,0.895,92,40,78,0.513,36,64,0.563,4,14,0.286,25,34,0.735,109,2012-02-14,PHO,DEN,2012,111.0
10265,10265,65,@,W 92-89 ,240,36,80,0.45,29,65,0.446,7,15,0.467,13,17,0.765,92,33,86,0.384,26,68,0.382,7,18,0.389,16,18,0.889,89,2012-02-15,NOP,MIL,2012,92.5
10266,10266,66,@,L 92-93 ,240,35,93,0.376,31,74,0.419,4,19,0.211,18,25,0.72,92,32,89,0.36,25,67,0.373,7,22,0.318,22,30,0.733,93,2012-02-19,SAC,CLE,2012,96.5
10267,10267,67,Home,W 92-91 ,240,33,85,0.388,30,69,0.435,3,16,0.188,23,26,0.885,92,40,90,0.444,37,79,0.468,3,11,0.273,8,10,0.8,91,2012-02-19,MIN,PHI,2012,92.5
10268,10268,68,@,W 92-85 ,240,33,86,0.384,26,67,0.388,7,19,0.368,19,24,0.792,92,29,85,0.341,24,62,0.387,5,23,0.217,22,33,0.667,85,2012-02-19,MIL,NJN,2012,87.5
10269,10269,69,@,L 92-103 ,240,32,78,0.41,20,55,0.364,12,23,0.522,16,22,0.727,92,38,83,0.458,30,64,0.469,8,19,0.421,19,22,0.864,103,2012-02-20,POR,LAL,2012,107.0
10270,10270,70,Home,L 92-100 ,240,34,85,0.4,29,64,0.453,5,21,0.238,19,26,0.731,92,32,82,0.39,17,51,0.333,15,31,0.484,21,29,0.724,100,2012-02-20,NYK,NJN,2012,107.5
10271,10271,71,Home,L 92-93 ,240,32,89,0.36,24,64,0.375,8,25,0.32,20,28,0.714,92,37,84,0.44,30,59,0.508,7,25,0.28,12,14,0.857,93,2012-02-28,DAL,NJN,2012,96.5
10272,10272,72,@,W 92-88 ,240,30,78,0.385,24,59,0.407,6,19,0.316,26,34,0.765,92,37,90,0.411,33,73,0.452,4,17,0.235,10,12,0.833,88,2012-02-29,OKC,PHI,2012,90.0
10273,10273,73,@,L 92-97 ,240,37,83,0.446,26,54,0.481,11,29,0.379,7,10,0.7,92,40,88,0.455,37,75,0.493,3,13,0.231,14,17,0.824,97,2012-03-02,DAL,NOH,2012,98.5
10274,10274,74,Home,W 92-72 ,240,33,78,0.423,24,63,0.381,9,15,0.6,17,27,0.63,92,27,79,0.342,24,63,0.381,3,16,0.188,15,22,0.682,72,2012-03-05,CHI,IND,2012,73.5
10275,10275,75,@,W 92-88 ,240,35,79,0.443,26,51,0.51,9,28,0.321,13,28,0.464,92,32,79,0.405,24,59,0.407,8,20,0.4,16,20,0.8,88,2012-03-05,ORL,TOR,2012,92.0
10276,10276,76,@,L 92-97 (OT),265,32,83,0.386,27,64,0.422,5,19,0.263,23,29,0.793,92,35,81,0.432,31,67,0.463,4,14,0.286,23,31,0.742,97,2012-03-06,HOU,BOS,2012,99.0
10277,10277,77,Home,L 92-110 ,240,35,79,0.443,27,61,0.443,8,18,0.444,14,23,0.609,92,42,80,0.525,35,61,0.574,7,19,0.368,19,21,0.905,110,2012-03-07,GSW,MEM,2012,113.5
10278,10278,78,Home,W 92-75 ,240,40,82,0.488,36,71,0.507,4,11,0.364,8,15,0.533,92,20,64,0.313,15,42,0.357,5,22,0.227,30,38,0.789,75,2012-03-13,IND,POR,2012,77.5
10279,10279,79,@,L 92-97 ,240,37,92,0.402,33,70,0.471,4,22,0.182,14,20,0.7,92,33,80,0.413,23,58,0.397,10,22,0.455,21,27,0.778,97,2012-03-16,MIN,LAL,2012,102.0
10280,10280,80,@,L 92-99 (OT),265,33,80,0.413,27,55,0.491,6,25,0.24,20,25,0.8,92,42,101,0.416,40,88,0.455,2,13,0.154,13,16,0.813,99,2012-03-17,GSW,UTA,2012,100.0
10281,10281,81,@,L 92-97 ,240,37,78,0.474,31,60,0.517,6,18,0.333,12,19,0.632,92,34,85,0.4,32,78,0.41,2,7,0.286,27,37,0.73,97,2012-03-18,WAS,MEM,2012,98.0
10282,10282,82,Home,L 92-101 ,240,39,79,0.494,36,70,0.514,3,9,0.333,11,14,0.786,92,39,89,0.438,25,60,0.417,14,29,0.483,9,10,0.9,101,2012-03-21,NOP,GSW,2012,108.0
10283,10283,83,Home,L 92-112 ,240,34,84,0.405,33,76,0.434,1,8,0.125,23,26,0.885,92,48,90,0.533,44,77,0.571,4,13,0.308,12,21,0.571,112,2012-03-23,CHA,MIL,2012,114.0
10284,10284,84,Home,L 92-95 ,240,38,85,0.447,34,67,0.507,4,18,0.222,12,14,0.857,92,37,76,0.487,30,53,0.566,7,23,0.304,14,21,0.667,95,2012-03-24,WAS,ATL,2012,98.5
10285,10285,85,Home,W 92-78 ,240,36,74,0.486,32,65,0.492,4,9,0.444,16,17,0.941,92,30,91,0.33,22,67,0.328,8,24,0.333,10,15,0.667,78,2012-04-01,OKC,CHI,2012,82.0
10286,10286,86,Home,W 92-75 ,240,35,71,0.493,32,56,0.571,3,15,0.2,19,21,0.905,92,32,77,0.416,28,68,0.412,4,9,0.444,7,9,0.778,75,2012-04-01,PHO,NOH,2012,77.0
10287,10287,87,@,L 92-99 ,240,34,71,0.479,26,51,0.51,8,20,0.4,16,20,0.8,92,37,77,0.481,33,60,0.55,4,17,0.235,21,23,0.913,99,2012-04-01,WAS,TOR,2012,101.0
10288,10288,88,Home,W 92-87 ,240,35,76,0.461,28,58,0.483,7,18,0.389,15,22,0.682,92,31,77,0.403,27,65,0.415,4,12,0.333,21,30,0.7,87,2012-04-03,TOR,CHA,2012,89.0
10289,10289,89,@,L 92-94 ,240,35,83,0.422,29,63,0.46,6,20,0.3,16,22,0.727,92,35,67,0.522,30,57,0.526,5,10,0.5,19,27,0.704,94,2012-04-04,DEN,NOH,2012,96.5
10290,10290,90,Home,W 92-77 ,240,36,81,0.444,27,61,0.443,9,20,0.45,11,16,0.688,92,27,72,0.375,22,50,0.44,5,22,0.227,18,29,0.621,77,2012-04-16,LAC,OKC,2012,79.5
10291,10291,91,@,L 92-97 ,240,39,81,0.481,34,69,0.493,5,12,0.417,9,14,0.643,92,37,72,0.514,28,55,0.509,9,17,0.529,14,17,0.824,97,2012-04-20,BOS,ATL,2012,101.5
10292,10292,92,Home,L 92-103 ,240,38,93,0.409,33,77,0.429,5,16,0.313,11,18,0.611,92,40,75,0.533,36,63,0.571,4,12,0.333,19,22,0.864,103,2012-04-20,SAC,OKC,2012,105.0
10293,10293,93,Home,W 92-86 ,240,29,78,0.372,23,61,0.377,6,17,0.353,28,36,0.778,92,34,76,0.447,30,62,0.484,4,14,0.286,14,18,0.778,86,2012-04-23,MIL,TOR,2012,88.0
10294,10294,94,@,W 92-87 ,240,38,81,0.469,32,64,0.5,6,17,0.353,10,10,1.0,92,35,80,0.438,29,66,0.439,6,14,0.429,11,16,0.688,87,2012-04-25,CHI,IND,2012,90.0
10295,10295,95,@,L 92-101 ,240,33,86,0.384,31,72,0.431,2,14,0.143,24,30,0.8,92,38,74,0.514,33,59,0.559,5,15,0.333,20,29,0.69,101,2012-10-31,MEM,LAC,2013,103.5
10296,10296,96,Home,W 92-80 ,240,32,87,0.368,30,70,0.429,2,17,0.118,26,36,0.722,92,32,89,0.36,29,73,0.397,3,16,0.188,13,16,0.813,80,2012-11-02,MIN,SAC,2013,81.5
10297,10297,97,@,L 92-106 ,240,32,89,0.36,23,63,0.365,9,26,0.346,19,24,0.792,92,39,76,0.513,34,67,0.507,5,9,0.556,23,32,0.719,106,2012-11-02,POR,OKC,2013,108.5
10298,10298,98,Home,W 92-89 ,240,40,92,0.435,38,81,0.469,2,11,0.182,10,14,0.714,92,37,90,0.411,33,77,0.429,4,13,0.308,11,19,0.579,89,2012-11-02,PHO,DET,2013,91.0
10299,10299,99,@,L 92-94 ,240,31,78,0.397,25,57,0.439,6,21,0.286,24,28,0.857,92,37,81,0.457,33,62,0.532,4,19,0.211,16,23,0.696,94,2012-11-05,GSW,SAC,2013,96.0
10300,10300,0,Home,L 92-96 ,240,35,88,0.398,32,69,0.464,3,19,0.158,19,26,0.731,92,32,72,0.444,27,57,0.474,5,15,0.333,27,34,0.794,96,2012-11-10,MIL,BOS,2013,98.5
10301,10301,1,@,W 92-90 ,240,27,73,0.37,26,63,0.413,1,10,0.1,37,42,0.881,92,33,83,0.398,27,66,0.409,6,17,0.353,18,27,0.667,90,2012-11-12,OKC,DET,2013,93.0
10302,10302,2,Home,W 92-76 ,240,31,78,0.397,28,65,0.431,3,13,0.231,27,32,0.844,92,25,84,0.298,20,53,0.377,5,31,0.161,21,32,0.656,76,2012-11-13,CHA,WAS,2013,78.5
10303,10303,3,Home,W 92-88 ,240,33,71,0.465,28,53,0.528,5,18,0.278,21,25,0.84,92,34,78,0.436,27,55,0.491,7,23,0.304,13,18,0.722,88,2012-11-14,GSW,ATL,2013,91.5
10304,10304,4,Home,L 92-97 ,240,36,78,0.462,30,61,0.492,6,17,0.353,14,17,0.824,92,36,81,0.444,31,66,0.47,5,15,0.333,20,28,0.714,97,2012-11-19,MEM,DEN,2013,99.5
10305,10305,5,@,W 92-87 ,240,40,85,0.471,39,73,0.534,1,12,0.083,11,19,0.579,92,29,82,0.354,23,62,0.371,6,20,0.3,23,28,0.821,87,2012-11-19,LAC,SAS,2013,90.0
10306,10306,6,Home,W 92-83 ,240,35,86,0.407,22,63,0.349,13,23,0.565,9,14,0.643,92,31,86,0.36,27,69,0.391,4,17,0.235,17,22,0.773,83,2012-11-21,CLE,PHI,2013,85.0
10307,10307,7,Home,L 92-93 ,240,35,80,0.438,30,69,0.435,5,11,0.455,17,19,0.895,92,39,85,0.459,36,70,0.514,3,15,0.2,12,19,0.632,93,2012-11-26,CHI,MIL,2013,94.5
10308,10308,8,Home,L 92-118 ,240,37,90,0.411,33,76,0.434,4,14,0.286,14,17,0.824,92,45,80,0.563,32,57,0.561,13,23,0.565,15,20,0.75,118,2012-11-26,WAS,SAS,2013,124.5
10309,10309,9,Home,L 92-97 ,240,32,75,0.427,26,58,0.448,6,17,0.353,22,25,0.88,92,37,85,0.435,28,59,0.475,9,26,0.346,14,19,0.737,97,2012-11-30,SAC,IND,2013,101.5
10310,10310,10,Home,W 92-77 ,240,38,93,0.409,27,68,0.397,11,25,0.44,5,8,0.625,92,29,85,0.341,24,64,0.375,5,21,0.238,14,18,0.778,77,2012-12-01,DAL,DET,2013,79.5
10311,10311,11,@,L 92-103 ,240,34,74,0.459,26,52,0.5,8,22,0.364,16,20,0.8,92,38,80,0.475,29,60,0.483,9,20,0.45,18,19,0.947,103,2012-12-01,IND,GSW,2013,107.5
10312,10312,12,@,L 92-99 ,240,34,79,0.43,28,57,0.491,6,22,0.273,18,22,0.818,92,36,80,0.45,27,54,0.5,9,26,0.346,18,19,0.947,99,2012-12-05,POR,IND,2013,103.5
10313,10313,13,Home,L 92-112 ,240,32,76,0.421,26,60,0.433,6,16,0.375,22,28,0.786,92,41,91,0.451,23,47,0.489,18,44,0.409,12,19,0.632,112,2012-12-06,MIA,NYK,2013,121.0
10314,10314,14,@,W 92-89 ,240,38,86,0.442,35,69,0.507,3,17,0.176,13,20,0.65,92,34,76,0.447,24,53,0.453,10,23,0.435,11,18,0.611,89,2012-12-07,DEN,IND,2013,94.0
10315,10315,15,@,L 92-114 ,240,37,95,0.389,26,62,0.419,11,33,0.333,7,8,0.875,92,48,87,0.552,42,67,0.627,6,20,0.3,12,13,0.923,114,2012-12-07,HOU,SAS,2013,117.0
10316,10316,16,Home,W 92-79 ,240,40,75,0.533,36,61,0.59,4,14,0.286,8,12,0.667,92,31,79,0.392,27,62,0.435,4,17,0.235,13,16,0.813,79,2012-12-08,BOS,PHI,2013,81.0
10317,10317,17,@,L 92-101 ,240,32,75,0.427,23,47,0.489,9,28,0.321,19,20,0.95,92,39,67,0.582,30,46,0.652,9,21,0.429,14,22,0.636,101,2012-12-10,ATL,MIA,2013,105.5
10318,10318,18,Home,W 92-74 ,240,36,89,0.404,36,69,0.522,0,20,0.0,20,22,0.909,92,26,74,0.351,23,53,0.434,3,21,0.143,19,21,0.905,74,2012-12-10,POR,TOR,2013,75.5
10319,10319,19,Home,W 92-88 ,240,31,71,0.437,26,56,0.464,5,15,0.333,25,32,0.781,92,33,83,0.398,24,61,0.393,9,22,0.409,13,16,0.813,88,2012-12-12,OKC,NOH,2013,92.5
10320,10320,20,@,W 92-90 ,240,37,83,0.446,32,63,0.508,5,20,0.25,13,16,0.813,92,33,77,0.429,26,60,0.433,7,17,0.412,17,22,0.773,90,2012-12-18,UTA,BRK,2013,93.5
10321,10321,21,@,L 92-103 ,240,37,86,0.43,33,69,0.478,4,17,0.235,14,19,0.737,92,36,77,0.468,23,52,0.442,13,25,0.52,18,23,0.783,103,2012-12-18,MIN,MIA,2013,109.5
10322,10322,22,Home,L 92-100 ,240,36,94,0.383,27,70,0.386,9,24,0.375,11,17,0.647,92,36,84,0.429,27,59,0.458,9,25,0.36,19,20,0.95,100,2012-12-19,ATL,OKC,2013,104.5
10323,10323,23,Home,W 92-82 ,240,36,89,0.404,33,76,0.434,3,13,0.231,17,20,0.85,92,31,76,0.408,25,55,0.455,6,21,0.286,14,17,0.824,82,2012-12-21,MEM,DAL,2013,85.0
10324,10324,24,Home,W 92-75 ,240,38,77,0.494,31,58,0.534,7,19,0.368,9,10,0.9,92,32,76,0.421,27,62,0.435,5,14,0.357,6,8,0.75,75,2012-12-22,ATL,CHI,2013,77.5
10325,10325,25,@,L 92-95 ,240,38,88,0.432,30,70,0.429,8,18,0.444,8,10,0.8,92,33,74,0.446,25,52,0.481,8,22,0.364,21,30,0.7,95,2012-12-23,PHI,BRK,2013,99.0
10326,10326,26,Home,L 92-105 ,240,34,78,0.436,29,64,0.453,5,14,0.357,19,28,0.679,92,37,81,0.457,25,58,0.431,12,23,0.522,19,25,0.76,105,2012-12-26,CHA,MIA,2013,111.0
10327,10327,27,Home,W 92-78 ,240,37,82,0.451,30,59,0.508,7,23,0.304,11,21,0.524,92,30,78,0.385,25,49,0.51,5,29,0.172,13,29,0.448,78,2013-01-01,DEN,LAC,2013,80.5
10328,10328,28,@,L 92-104 ,240,38,90,0.422,33,74,0.446,5,16,0.313,11,20,0.55,92,41,83,0.494,36,59,0.61,5,24,0.208,17,23,0.739,104,2013-01-02,NOP,HOU,2013,106.5
10329,10329,29,@,W 92-81 ,240,37,69,0.536,35,61,0.574,2,8,0.25,16,20,0.8,92,31,79,0.392,26,65,0.4,5,14,0.357,14,18,0.778,81,2013-01-06,MEM,PHO,2013,83.5
10330,10330,30,Home,L 92-104 ,240,34,76,0.447,26,53,0.491,8,23,0.348,16,21,0.762,92,38,77,0.494,32,55,0.582,6,22,0.273,22,24,0.917,104,2013-01-06,TOR,OKC,2013,107.0
10331,10331,31,@,L 92-118 ,240,33,78,0.423,26,64,0.406,7,14,0.5,19,23,0.826,92,44,82,0.537,34,68,0.5,10,14,0.714,20,24,0.833,118,2013-01-07,CLE,CHI,2013,123.0
10332,10332,32,Home,W 92-90 ,240,30,80,0.375,21,53,0.396,9,27,0.333,23,30,0.767,92,35,77,0.455,29,58,0.5,6,19,0.316,14,20,0.7,90,2013-01-10,POR,MIA,2013,93.0
10333,10333,33,@,L 92-104 ,240,31,69,0.449,27,51,0.529,4,18,0.222,26,33,0.788,92,44,84,0.524,36,62,0.581,8,22,0.364,8,9,0.889,104,2013-01-11,MIN,NOH,2013,108.0
10334,10334,34,@,W 92-75 ,240,36,90,0.4,28,61,0.459,8,29,0.276,12,18,0.667,92,29,80,0.363,26,68,0.382,3,12,0.25,14,18,0.778,75,2013-01-16,MIA,GSW,2013,76.5
10335,10335,35,Home,W 92-79 ,240,30,64,0.469,27,50,0.54,3,14,0.214,29,36,0.806,92,25,78,0.321,17,47,0.362,8,31,0.258,21,28,0.75,79,2013-01-19,MIN,HOU,2013,83.0
10336,10336,36,Home,L 92-104 ,240,31,76,0.408,25,61,0.41,6,15,0.4,24,29,0.828,92,43,87,0.494,31,62,0.5,12,25,0.48,6,12,0.5,104,2013-01-23,CHA,ATL,2013,110.0
10337,10337,37,Home,W 92-88 ,240,38,85,0.447,35,73,0.479,3,12,0.25,13,19,0.684,92,31,86,0.36,24,68,0.353,7,18,0.389,19,26,0.731,88,2013-01-23,UTA,WAS,2013,91.5
10338,10338,38,@,L 92-93 ,240,33,85,0.388,24,63,0.381,9,22,0.409,17,23,0.739,92,36,75,0.48,26,49,0.531,10,26,0.385,11,18,0.611,93,2013-01-30,TOR,ATL,2013,98.0
10339,10339,39,Home,W 92-84 ,240,40,95,0.421,34,82,0.415,6,13,0.462,6,10,0.6,92,30,75,0.4,23,53,0.434,7,22,0.318,17,21,0.81,84,2013-01-30,PHI,WAS,2013,87.5
10340,10340,40,Home,W 92-86 ,240,38,83,0.458,35,71,0.493,3,12,0.25,13,15,0.867,92,33,78,0.423,25,51,0.49,8,27,0.296,12,19,0.632,86,2013-01-30,PHO,LAL,2013,90.0
10341,10341,41,@,W 92-83 ,240,37,82,0.451,34,69,0.493,3,13,0.231,15,18,0.833,92,31,89,0.348,25,66,0.379,6,23,0.261,15,19,0.789,83,2013-02-05,LAL,BRK,2013,86.0
10342,10342,42,@,L 92-103 ,240,38,84,0.452,33,72,0.458,5,12,0.417,11,16,0.688,92,38,74,0.514,28,50,0.56,10,24,0.417,17,23,0.739,103,2013-02-06,MEM,ATL,2013,108.0
10343,10343,43,Home,L 92-100 ,240,40,79,0.506,35,61,0.574,5,18,0.278,7,11,0.636,92,39,75,0.52,31,61,0.508,8,14,0.571,14,17,0.824,100,2013-02-11,CLE,MIN,2013,104.0
10344,10344,44,@,L 92-94 ,240,34,76,0.447,30,63,0.476,4,13,0.308,20,24,0.833,92,37,88,0.42,33,70,0.471,4,18,0.222,16,21,0.762,94,2013-02-13,PHI,MIL,2013,96.0
10345,10345,45,@,W 92-88 ,240,31,73,0.425,22,52,0.423,9,21,0.429,21,24,0.875,92,28,79,0.354,19,54,0.352,9,25,0.36,23,32,0.719,88,2013-02-13,TOR,NYK,2013,92.5
10346,10346,46,Home,L 92-105 ,240,37,89,0.416,33,64,0.516,4,25,0.16,14,17,0.824,92,38,81,0.469,29,57,0.509,9,24,0.375,20,27,0.741,105,2013-02-19,ORL,CHA,2013,109.5
10347,10347,47,Home,W 92-86 ,240,35,79,0.443,28,58,0.483,7,21,0.333,15,19,0.789,92,36,85,0.424,34,72,0.472,2,13,0.154,12,15,0.8,86,2013-02-24,POR,BOS,2013,87.0
10348,10348,48,@,L 92-103 ,240,35,78,0.449,33,58,0.569,2,20,0.1,20,25,0.8,92,34,82,0.415,29,69,0.42,5,13,0.385,30,32,0.938,103,2013-02-27,TOR,CLE,2013,105.5
10349,10349,49,Home,W 92-87 ,240,36,81,0.444,26,59,0.441,10,22,0.455,10,12,0.833,92,31,73,0.425,23,50,0.46,8,23,0.348,17,22,0.773,87,2013-03-01,PHO,ATL,2013,91.0
10350,10350,50,@,L 92-97 ,240,35,81,0.432,27,62,0.435,8,19,0.421,14,18,0.778,92,33,71,0.465,27,58,0.466,6,13,0.462,25,33,0.758,97,2013-03-03,CHI,IND,2013,100.0
10351,10351,51,@,L 92-107 ,240,36,85,0.424,29,63,0.46,7,22,0.318,13,16,0.813,92,43,77,0.558,32,54,0.593,11,23,0.478,10,12,0.833,107,2013-03-07,LAC,DEN,2013,112.5
10352,10352,52,Home,L 92-103 ,240,33,72,0.458,27,58,0.466,6,14,0.429,20,26,0.769,92,45,86,0.523,41,75,0.547,4,11,0.364,9,11,0.818,103,2013-03-08,CLE,MEM,2013,105.0
10353,10353,53,Home,W 92-63 ,240,32,78,0.41,21,58,0.362,11,20,0.55,17,24,0.708,92,20,73,0.274,15,46,0.326,5,27,0.185,18,28,0.643,63,2013-03-11,GSW,NYK,2013,65.5
10354,10354,54,@,L 92-96 ,240,36,92,0.391,28,63,0.444,8,29,0.276,12,16,0.75,92,37,79,0.468,29,57,0.509,8,22,0.364,14,21,0.667,96,2013-03-13,LAL,ATL,2013,100.0
10355,10355,55,Home,W 92-91 ,240,37,84,0.44,32,71,0.451,5,13,0.385,13,17,0.765,92,37,83,0.446,29,64,0.453,8,19,0.421,9,10,0.9,91,2013-03-14,SAS,DAL,2013,95.0
10356,10356,56,Home,W 92-78 ,240,33,68,0.485,30,58,0.517,3,10,0.3,23,27,0.852,92,26,80,0.325,20,58,0.345,6,22,0.273,20,29,0.69,78,2013-03-15,TOR,CHA,2013,81.0
10357,10357,57,Home,W 92-77 ,240,40,82,0.488,35,66,0.53,5,16,0.313,7,11,0.636,92,29,86,0.337,23,62,0.371,6,24,0.25,13,18,0.722,77,2013-03-18,MEM,MIN,2013,80.0
10358,10358,58,@,W 92-91 ,240,36,79,0.456,26,53,0.491,10,26,0.385,10,14,0.714,92,32,75,0.427,28,58,0.483,4,17,0.235,23,25,0.92,91,2013-03-23,DET,CHA,2013,93.0
10359,10359,59,@,L 92-101 ,240,36,88,0.409,29,71,0.408,7,17,0.412,13,16,0.813,92,37,75,0.493,27,55,0.491,10,20,0.5,17,22,0.773,101,2013-03-23,WAS,GSW,2013,106.0
10360,10360,60,Home,L 92-93 ,240,38,86,0.442,31,69,0.449,7,17,0.412,9,14,0.643,92,34,76,0.447,29,62,0.468,5,14,0.357,20,28,0.714,93,2013-03-27,CLE,BOS,2013,95.5
10361,10361,61,@,L 92-100 ,240,37,89,0.416,31,65,0.477,6,24,0.25,12,13,0.923,92,42,89,0.472,34,73,0.466,8,16,0.5,8,9,0.889,100,2013-03-27,MIL,PHI,2013,104.0
10362,10362,62,@,L 92-97 ,240,30,81,0.37,26,61,0.426,4,20,0.2,28,32,0.875,92,37,86,0.43,32,71,0.451,5,15,0.333,18,22,0.818,97,2013-03-29,WAS,ORL,2013,99.5
10363,10363,63,@,L 92-100 ,240,38,76,0.5,36,68,0.529,2,8,0.25,14,23,0.609,92,38,73,0.521,33,57,0.579,5,16,0.313,19,27,0.704,100,2013-03-30,CHA,PHI,2013,102.5
10364,10364,64,@,L 92-112 ,240,38,82,0.463,31,64,0.484,7,18,0.389,9,12,0.75,92,40,74,0.541,28,53,0.528,12,21,0.571,20,29,0.69,112,2013-03-31,CLE,NOH,2013,118.0
10365,10365,65,@,L 92-109 ,240,32,81,0.395,25,62,0.403,7,19,0.368,21,26,0.808,92,41,85,0.482,32,68,0.471,9,17,0.529,18,28,0.643,109,2013-03-31,TOR,WAS,2013,113.5
10366,10366,66,Home,W 92-90 ,240,36,79,0.456,34,72,0.472,2,7,0.286,18,24,0.75,92,36,75,0.48,28,52,0.538,8,23,0.348,10,11,0.909,90,2013-04-01,MEM,SAS,2013,94.0
10367,10367,67,@,W 92-90 ,240,38,82,0.463,34,71,0.479,4,11,0.364,12,19,0.632,92,31,70,0.443,26,57,0.456,5,13,0.385,23,30,0.767,90,2013-04-04,CHI,BRK,2013,92.5
10368,10368,68,Home,L 92-95 ,240,34,80,0.425,27,59,0.458,7,21,0.333,17,19,0.895,92,32,80,0.4,28,65,0.431,4,15,0.267,27,29,0.931,95,2013-04-07,PHO,NOH,2013,97.0
10369,10369,69,@,L 92-95 ,240,36,85,0.424,29,69,0.42,7,16,0.438,13,17,0.765,92,37,78,0.474,30,60,0.5,7,18,0.389,14,19,0.737,95,2013-04-17,WAS,CHI,2013,98.5
10370,10370,70,@,L 92-98 ,240,37,90,0.411,35,69,0.507,2,21,0.095,16,17,0.941,92,39,91,0.429,30,67,0.448,9,24,0.375,11,16,0.688,98,2013-04-17,ATL,NYK,2013,102.5
10371,10371,71,@,L 92-93 ,240,34,94,0.362,29,66,0.439,5,28,0.179,19,24,0.792,92,39,85,0.459,34,69,0.493,5,16,0.313,10,11,0.909,93,2013-11-04,MIN,CLE,2014,95.5
10372,10372,72,Home,W 92-90 ,240,36,73,0.493,33,58,0.569,3,15,0.2,17,30,0.567,92,35,79,0.443,28,63,0.444,7,16,0.438,13,15,0.867,90,2013-11-06,CHA,TOR,2014,93.5
10373,10373,73,Home,W 92-79 ,240,39,77,0.506,31,55,0.564,8,22,0.364,6,8,0.75,92,33,91,0.363,28,76,0.368,5,15,0.333,8,11,0.727,79,2013-11-13,SAS,WAS,2014,81.5
10374,10374,74,@,W 92-79 ,240,34,82,0.415,29,65,0.446,5,17,0.294,19,27,0.704,92,30,86,0.349,22,64,0.344,8,22,0.364,11,15,0.733,79,2013-11-16,OKC,MIL,2014,83.0
10375,10375,75,Home,W 92-86 ,240,35,70,0.5,28,51,0.549,7,19,0.368,15,21,0.714,92,33,76,0.434,27,52,0.519,6,24,0.25,14,18,0.778,86,2013-11-19,DET,NYK,2014,89.0
10376,10376,76,Home,L 92-120 ,240,29,71,0.408,14,42,0.333,15,29,0.517,19,21,0.905,92,38,74,0.514,23,50,0.46,15,24,0.625,29,32,0.906,120,2013-11-20,ORL,MIA,2014,127.5
10377,10377,77,@,L 92-107 ,240,33,83,0.398,25,51,0.49,8,32,0.25,18,24,0.75,92,39,79,0.494,32,57,0.561,7,22,0.318,22,24,0.917,107,2013-11-25,PHO,MIA,2014,110.5
10378,10378,78,Home,L 92-109 ,240,30,73,0.411,21,51,0.412,9,22,0.409,23,27,0.852,92,42,83,0.506,34,61,0.557,8,22,0.364,17,20,0.85,109,2013-11-26,ATL,ORL,2014,113.0
10379,10379,79,Home,L 92-100 (OT),265,37,85,0.435,27,60,0.45,10,25,0.4,8,10,0.8,92,37,74,0.5,27,48,0.563,10,26,0.385,16,22,0.727,100,2013-11-27,MIL,WAS,2014,105.0
10380,10380,80,Home,W 92-76 ,240,35,79,0.443,32,64,0.5,3,15,0.2,19,31,0.613,92,28,84,0.333,23,67,0.343,5,17,0.294,15,20,0.75,76,2013-11-29,CHA,MIL,2014,78.5
10381,10381,81,Home,W 92-85 ,240,36,78,0.462,28,61,0.459,8,17,0.471,12,20,0.6,92,35,84,0.417,31,65,0.477,4,19,0.211,11,15,0.733,85,2013-11-30,MIL,BOS,2014,87.0
10382,10382,82,@,W 92-75 ,240,34,80,0.425,22,61,0.361,12,19,0.632,12,15,0.8,92,30,90,0.333,27,72,0.375,3,18,0.167,12,15,0.8,75,2013-12-07,DET,CHI,2014,76.5
10383,10383,83,Home,L 92-103 ,240,40,88,0.455,37,72,0.514,3,16,0.188,9,14,0.643,92,35,83,0.422,28,61,0.459,7,22,0.318,26,34,0.765,103,2013-12-07,PHI,DEN,2014,106.5
10384,10384,84,Home,L 92-101 ,240,31,87,0.356,22,61,0.361,9,26,0.346,21,27,0.778,92,38,86,0.442,34,68,0.5,4,18,0.222,21,28,0.75,101,2013-12-10,ATL,OKC,2014,103.0
10385,10385,85,@,W 92-83 ,240,38,90,0.422,31,71,0.437,7,19,0.368,9,9,1.0,92,31,84,0.369,27,67,0.403,4,17,0.235,17,18,0.944,83,2013-12-11,ORL,CHA,2014,85.0
10386,10386,86,@,L 92-115 ,240,37,76,0.487,31,58,0.534,6,18,0.333,12,21,0.571,92,39,76,0.513,28,53,0.528,11,23,0.478,26,35,0.743,115,2013-12-16,SAS,LAC,2014,120.5
10387,10387,87,Home,L 92-96 ,240,37,91,0.407,32,75,0.427,5,16,0.313,13,17,0.765,92,37,75,0.493,30,53,0.566,7,22,0.318,15,19,0.789,96,2013-12-17,MEM,LAL,2014,99.5
10388,10388,88,Home,L 92-115 ,240,34,88,0.386,26,60,0.433,8,28,0.286,16,24,0.667,92,46,96,0.479,36,72,0.5,10,24,0.417,13,18,0.722,115,2013-12-23,CLE,DET,2014,120.0
10389,10389,89,@,L 92-100 ,240,38,93,0.409,33,75,0.44,5,18,0.278,11,20,0.55,92,31,71,0.437,26,47,0.553,5,24,0.208,33,40,0.825,100,2013-12-26,MEM,HOU,2014,102.5
10390,10390,90,@,L 92-109 ,240,39,95,0.411,34,77,0.442,5,18,0.278,9,18,0.5,92,45,85,0.529,41,71,0.577,4,14,0.286,15,23,0.652,109,2013-12-27,DET,ORL,2014,111.0
10391,10391,91,@,W 92-91 ,240,33,91,0.363,28,62,0.452,5,29,0.172,21,25,0.84,92,35,84,0.417,30,64,0.469,5,20,0.25,16,17,0.941,91,2013-12-31,ATL,BOS,2014,93.5
10392,10392,92,@,L 92-113 ,240,37,84,0.44,32,69,0.464,5,15,0.333,13,15,0.867,92,40,78,0.513,31,58,0.534,9,20,0.45,24,28,0.857,113,2013-12-31,BRK,SAS,2014,117.5
10393,10393,93,Home,L 92-95 ,240,31,89,0.348,24,60,0.4,7,29,0.241,23,28,0.821,92,38,77,0.494,36,71,0.507,2,6,0.333,17,22,0.773,95,2014-01-03,BOS,NOP,2014,96.0
10394,10394,94,@,L 92-116 ,240,37,79,0.468,34,64,0.531,3,15,0.2,15,21,0.714,92,50,90,0.556,46,72,0.639,4,18,0.222,12,16,0.75,116,2014-01-04,LAC,SAS,2014,118.0
10395,10395,95,@,W 92-80 ,240,37,76,0.487,32,63,0.508,5,13,0.385,13,16,0.813,92,32,78,0.41,26,52,0.5,6,26,0.231,10,18,0.556,80,2014-01-05,NYK,DAL,2014,83.0
10396,10396,96,Home,W 92-87 ,240,36,82,0.439,30,68,0.441,6,14,0.429,14,23,0.609,92,33,82,0.402,27,59,0.458,6,23,0.261,15,19,0.789,87,2014-01-07,CHI,PHO,2014,90.0
10397,10397,97,@,L 92-102 ,240,37,68,0.544,30,47,0.638,7,21,0.333,11,21,0.524,92,44,82,0.537,35,58,0.603,9,24,0.375,5,10,0.5,102,2014-01-09,MIA,NYK,2014,106.5
10398,10398,98,@,L 92-119 ,240,37,84,0.44,29,65,0.446,8,19,0.421,10,14,0.714,92,48,88,0.545,39,69,0.565,9,19,0.474,14,19,0.737,119,2014-01-10,CHA,MIN,2014,123.5
10399,10399,99,Home,L 92-102 ,240,36,78,0.462,31,59,0.525,5,19,0.263,15,21,0.714,92,39,82,0.476,33,64,0.516,6,18,0.333,18,23,0.783,102,2014-01-11,PHI,NYK,2014,105.0
10400,10400,0,Home,L 92-104 ,240,38,101,0.376,35,84,0.417,3,17,0.176,13,14,0.929,92,37,79,0.468,29,60,0.483,8,19,0.421,22,34,0.647,104,2014-01-13,BOS,HOU,2014,108.0
10401,10401,1,@,L 92-116 ,240,39,92,0.424,35,79,0.443,4,13,0.308,10,17,0.588,92,45,82,0.549,39,66,0.591,6,16,0.375,20,25,0.8,116,2014-01-14,SAC,IND,2014,119.0
10402,10402,2,@,L 92-95 ,240,35,88,0.398,30,68,0.441,5,20,0.25,17,26,0.654,92,39,77,0.506,33,62,0.532,6,15,0.4,11,20,0.55,95,2014-01-15,CHA,PHI,2014,98.0
10403,10403,3,Home,L 92-104 ,240,33,82,0.402,21,48,0.438,12,34,0.353,14,21,0.667,92,38,82,0.463,32,57,0.561,6,25,0.24,22,25,0.88,104,2014-01-16,HOU,OKC,2014,107.0
10404,10404,4,@,L 92-106 ,240,33,83,0.398,28,63,0.444,5,20,0.25,21,24,0.875,92,38,83,0.458,29,64,0.453,9,19,0.474,21,22,0.955,106,2014-01-18,LAC,IND,2014,110.5
10405,10405,5,Home,L 92-95 ,240,31,74,0.419,24,55,0.436,7,19,0.368,23,28,0.821,92,35,77,0.455,30,68,0.441,5,9,0.556,20,23,0.87,95,2014-01-20,MEM,NOP,2014,97.5
10406,10406,6,@,L 92-100 ,240,36,77,0.468,33,62,0.532,3,15,0.2,17,19,0.895,92,37,81,0.457,32,69,0.464,5,12,0.417,21,27,0.778,100,2014-01-26,ORL,NOP,2014,102.5
10407,10407,7,Home,L 92-104 ,240,37,94,0.394,32,70,0.457,5,24,0.208,13,16,0.813,92,42,99,0.424,37,78,0.474,5,21,0.238,15,27,0.556,104,2014-01-28,LAL,IND,2014,106.5
10408,10408,8,@,L 92-111 ,240,31,76,0.408,23,52,0.442,8,24,0.333,22,34,0.647,92,45,91,0.495,39,70,0.557,6,21,0.286,15,20,0.75,111,2014-01-30,LAC,GSW,2014,114.0
10409,10409,9,@,L 92-106 ,240,38,87,0.437,30,57,0.526,8,30,0.267,8,10,0.8,92,41,80,0.513,34,54,0.63,7,26,0.269,17,24,0.708,106,2014-02-01,CLE,HOU,2014,109.5
10410,10410,10,Home,L 92-101 ,240,31,80,0.388,23,52,0.442,8,28,0.286,22,29,0.759,92,35,78,0.449,29,60,0.483,6,18,0.333,25,31,0.806,101,2014-02-04,PHO,CHI,2014,104.0
10411,10411,11,@,W 92-86 ,240,34,80,0.425,27,58,0.466,7,22,0.318,17,17,1.0,92,36,82,0.439,30,63,0.476,6,19,0.316,8,11,0.727,86,2014-02-09,CHI,LAL,2014,89.0
10412,10412,12,@,L 92-93 ,240,35,79,0.443,24,55,0.436,11,24,0.458,11,19,0.579,92,34,83,0.41,29,71,0.408,5,12,0.417,20,26,0.769,93,2014-02-09,IND,ORL,2014,95.5
10413,10413,13,Home,W 92-89 ,240,33,70,0.471,30,57,0.526,3,13,0.231,23,27,0.852,92,34,74,0.459,27,50,0.54,7,24,0.292,14,20,0.7,89,2014-02-11,MEM,WAS,2014,92.5
10414,10414,14,Home,L 92-104 ,240,37,80,0.463,31,63,0.492,6,17,0.353,12,17,0.706,92,41,82,0.5,32,63,0.508,9,19,0.474,13,14,0.929,104,2014-02-12,BOS,SAS,2014,108.5
10415,10415,15,Home,W 92-76 ,240,35,70,0.5,31,56,0.554,4,14,0.286,18,21,0.857,92,26,67,0.388,21,50,0.42,5,17,0.294,19,28,0.679,76,2014-02-13,CHI,BRK,2014,78.5
10416,10416,16,Home,L 92-101 ,240,33,79,0.418,27,62,0.435,6,17,0.353,20,28,0.714,92,39,86,0.453,36,67,0.537,3,19,0.158,20,24,0.833,101,2014-02-19,SAC,GSW,2014,102.5
10417,10417,17,Home,L 92-94 ,240,35,83,0.422,32,66,0.485,3,17,0.176,19,23,0.826,92,36,72,0.5,29,60,0.483,7,12,0.583,15,20,0.75,94,2014-02-19,TOR,CHI,2014,97.5
10418,10418,18,@,L 92-101 ,240,38,97,0.392,34,75,0.453,4,22,0.182,12,17,0.706,92,40,83,0.482,33,61,0.541,7,22,0.318,14,19,0.737,101,2014-02-21,BOS,LAL,2014,104.5
10419,10419,19,Home,W 92-89 ,240,30,82,0.366,22,62,0.355,8,20,0.4,24,27,0.889,92,34,79,0.43,30,64,0.469,4,15,0.267,17,22,0.773,89,2014-02-22,CHA,MEM,2014,91.0
10420,10420,20,Home,W 92-82 ,240,34,73,0.466,25,53,0.472,9,20,0.45,15,15,1.0,92,33,90,0.367,30,73,0.411,3,17,0.176,13,15,0.867,82,2014-02-28,SAS,CHA,2014,83.5
10421,10421,21,Home,W 92-81 ,240,35,83,0.422,34,70,0.486,1,13,0.077,21,27,0.778,92,32,86,0.372,27,62,0.435,5,24,0.208,12,18,0.667,81,2014-03-02,ORL,PHI,2014,83.5
10422,10422,22,@,L 92-125 ,240,32,94,0.34,22,64,0.344,10,30,0.333,18,26,0.692,92,43,76,0.566,36,56,0.643,7,20,0.35,32,43,0.744,125,2014-03-04,PHI,OKC,2014,128.5
10423,10423,23,@,L 92-101 ,240,37,86,0.43,34,69,0.493,3,17,0.176,15,20,0.75,92,36,77,0.468,27,48,0.563,9,29,0.31,20,22,0.909,101,2014-03-07,CLE,CHA,2014,105.5
10424,10424,24,Home,L 92-104 ,240,36,76,0.474,31,54,0.574,5,22,0.227,15,20,0.75,92,37,80,0.463,27,57,0.474,10,23,0.435,20,28,0.714,104,2014-03-08,PHI,UTA,2014,109.0
10425,10425,25,Home,L 92-116 ,240,34,81,0.42,26,62,0.419,8,19,0.421,16,23,0.696,92,42,80,0.525,31,61,0.508,11,19,0.579,21,24,0.875,116,2014-03-12,BOS,NYK,2014,121.5
10426,10426,26,@,L 92-97 ,240,34,83,0.41,26,58,0.448,8,25,0.32,16,25,0.64,92,33,81,0.407,19,49,0.388,14,32,0.438,17,29,0.586,97,2014-03-15,DEN,ATL,2014,104.0
10427,10427,27,Home,L 92-101 ,240,37,89,0.416,30,71,0.423,7,18,0.389,11,16,0.688,92,39,68,0.574,30,48,0.625,9,20,0.45,14,18,0.778,101,2014-03-16,MIL,CHA,2014,105.5
10428,10428,28,Home,W 92-86 ,240,32,82,0.39,28,65,0.431,4,17,0.235,24,29,0.828,92,31,73,0.425,26,50,0.52,5,23,0.217,19,27,0.704,86,2014-03-19,NYK,IND,2014,88.5
10429,10429,29,Home,L 92-93 ,240,34,91,0.374,24,50,0.48,10,41,0.244,14,21,0.667,92,34,82,0.415,27,53,0.509,7,29,0.241,18,25,0.72,93,2014-03-21,PHI,NYK,2014,96.5
10430,10430,30,@,L 92-98 ,240,39,90,0.433,35,74,0.473,4,16,0.25,10,26,0.385,92,33,73,0.452,25,48,0.521,8,25,0.32,24,35,0.686,98,2014-03-21,DET,PHO,2014,102.0
10431,10431,31,@,L 92-109 ,240,34,90,0.378,27,66,0.409,7,24,0.292,17,20,0.85,92,48,91,0.527,42,79,0.532,6,12,0.5,7,13,0.538,109,2014-03-24,MIN,MEM,2014,112.0
10432,10432,32,Home,L 92-94 ,240,36,73,0.493,30,53,0.566,6,20,0.3,14,24,0.583,92,38,85,0.447,33,76,0.434,5,9,0.556,13,23,0.565,94,2014-03-31,DEN,MEM,2014,96.5
10433,10433,33,@,W 92-83 ,240,33,70,0.471,24,41,0.585,9,29,0.31,17,24,0.708,92,33,85,0.388,25,61,0.41,8,24,0.333,9,15,0.6,83,2014-03-31,NYK,UTA,2014,87.0
10434,10434,34,Home,L 92-105 ,240,32,72,0.444,24,48,0.5,8,24,0.333,20,26,0.769,92,40,78,0.513,28,53,0.528,12,25,0.48,13,15,0.867,105,2014-04-02,ATL,CHI,2014,111.0
10435,10435,35,@,L 92-118 ,240,32,81,0.395,29,57,0.509,3,24,0.125,25,30,0.833,92,45,72,0.625,35,53,0.66,10,19,0.526,18,21,0.857,118,2014-04-02,BOS,WAS,2014,123.0
10436,10436,36,@,L 92-100 ,240,29,80,0.363,22,57,0.386,7,23,0.304,27,32,0.844,92,32,83,0.386,30,72,0.417,2,11,0.182,34,38,0.895,100,2014-04-04,DEN,MEM,2014,101.0
10437,10437,37,@,L 92-100 ,240,36,77,0.468,35,63,0.556,1,14,0.071,19,28,0.679,92,43,79,0.544,34,62,0.548,9,17,0.529,5,9,0.556,100,2014-04-05,MIN,ORL,2014,104.5
10438,10438,38,@,L 92-112 ,240,38,86,0.442,33,72,0.458,5,14,0.357,11,17,0.647,92,43,77,0.558,34,55,0.618,9,22,0.409,17,18,0.944,112,2014-04-06,MEM,SAS,2014,116.5
10439,10439,39,Home,L 92-107 ,240,34,82,0.415,31,68,0.456,3,14,0.214,21,28,0.75,92,38,80,0.475,26,58,0.448,12,22,0.545,19,27,0.704,107,2014-04-08,SAC,OKC,2014,113.0
10440,10440,40,@,L 92-95 ,240,36,80,0.45,27,51,0.529,9,29,0.31,11,18,0.611,92,37,81,0.457,29,64,0.453,8,17,0.471,13,19,0.684,95,2014-04-16,TOR,NYK,2014,99.0
10441,10441,41,@,L 92-102 ,240,31,81,0.383,19,49,0.388,12,32,0.375,18,21,0.857,92,35,69,0.507,28,49,0.571,7,20,0.35,25,33,0.758,102,2014-11-01,IND,ATL,2015,105.5
10442,10442,42,Home,L 92-98 ,240,33,88,0.375,24,57,0.421,9,31,0.29,17,21,0.81,92,34,68,0.5,31,58,0.534,3,10,0.3,27,33,0.818,98,2014-11-02,LAC,SAC,2015,99.5
10443,10443,43,@,L 92-94 ,240,38,92,0.413,30,67,0.448,8,25,0.32,8,11,0.727,92,31,69,0.449,26,52,0.5,5,17,0.294,27,38,0.711,94,2014-11-05,ATL,SAS,2015,96.5
10444,10444,44,@,L 92-102 ,240,35,87,0.402,31,71,0.437,4,16,0.25,18,23,0.783,92,41,78,0.526,36,65,0.554,5,13,0.385,15,17,0.882,102,2014-11-08,MIN,MIA,2015,104.5
10445,10445,45,@,L 92-93 ,240,29,82,0.354,26,68,0.382,3,14,0.214,31,34,0.912,92,40,88,0.455,35,70,0.5,5,18,0.278,8,11,0.727,93,2014-11-08,MEM,MIL,2015,95.5
10446,10446,46,@,L 92-107 ,240,35,79,0.443,32,65,0.492,3,14,0.214,19,27,0.704,92,42,82,0.512,36,65,0.554,6,17,0.353,17,22,0.773,107,2014-11-09,CHA,LAL,2015,110.0
10447,10447,47,@,W 92-90 ,240,35,74,0.473,30,58,0.517,5,16,0.313,17,25,0.68,92,37,83,0.446,30,65,0.462,7,18,0.389,9,13,0.692,90,2014-11-19,SAS,CLE,2015,93.5
10448,10448,48,Home,L 92-98 ,240,30,74,0.405,15,36,0.417,15,38,0.395,17,23,0.739,92,37,91,0.407,32,71,0.451,5,20,0.25,19,23,0.826,98,2014-11-19,HOU,LAL,2015,100.5
10449,10449,49,@,L 92-96 ,240,35,80,0.438,32,70,0.457,3,10,0.3,19,26,0.731,92,38,83,0.458,29,57,0.509,9,26,0.346,11,13,0.846,96,2014-11-19,MEM,TOR,2015,100.5
10450,10450,50,Home,L 92-121 ,240,37,90,0.411,33,77,0.429,4,13,0.308,14,22,0.636,92,46,84,0.548,33,63,0.524,13,21,0.619,16,18,0.889,121,2014-11-21,MIN,SAS,2015,127.5
10451,10451,51,Home,L 92-94 ,240,38,85,0.447,34,65,0.523,4,20,0.2,12,19,0.632,92,31,67,0.463,26,52,0.5,5,15,0.333,27,30,0.9,94,2014-11-21,OKC,BRK,2015,96.5
10452,10452,52,@,L 92-95 ,240,35,88,0.398,29,53,0.547,6,35,0.171,16,22,0.727,92,30,82,0.366,15,36,0.417,15,46,0.326,20,23,0.87,95,2014-11-22,DAL,HOU,2015,102.5
10453,10453,53,Home,L 92-99 ,240,35,78,0.449,32,62,0.516,3,16,0.188,19,27,0.704,92,37,71,0.521,25,45,0.556,12,26,0.462,13,18,0.722,99,2014-11-22,ORL,MIA,2015,105.0
10454,10454,54,Home,L 92-113 ,240,31,75,0.413,29,55,0.527,2,20,0.1,28,35,0.8,92,45,88,0.511,30,56,0.536,15,32,0.469,8,10,0.8,113,2014-11-24,CHA,LAC,2015,120.5
10455,10455,55,Home,L 92-108 ,240,37,84,0.44,28,57,0.491,9,27,0.333,9,17,0.529,92,40,77,0.519,31,56,0.554,9,21,0.429,19,27,0.704,108,2014-12-08,IND,ATL,2015,112.5
10456,10456,56,@,L 92-101 ,240,32,79,0.405,29,62,0.468,3,17,0.176,25,37,0.676,92,35,74,0.473,32,66,0.485,3,8,0.375,28,36,0.778,101,2014-12-08,UTA,SAC,2015,102.5
10457,10457,57,Home,L 92-111 ,240,36,78,0.462,35,71,0.493,1,7,0.143,19,29,0.655,92,45,88,0.511,39,64,0.609,6,24,0.25,15,20,0.75,111,2014-12-12,MIN,OKC,2015,114.0
10458,10458,58,Home,L 92-104 ,240,36,84,0.429,31,66,0.47,5,18,0.278,15,17,0.882,92,41,87,0.471,35,67,0.522,6,20,0.3,16,24,0.667,104,2014-12-16,SAC,OKC,2015,107.0
10459,10459,59,@,L 92-109 ,240,37,85,0.435,32,66,0.485,5,19,0.263,13,15,0.867,92,44,80,0.55,37,61,0.607,7,19,0.368,14,18,0.778,109,2014-12-17,ORL,BOS,2015,112.5
10460,10460,60,Home,L 92-104 ,240,34,83,0.41,31,69,0.449,3,14,0.214,21,29,0.724,92,40,78,0.513,34,61,0.557,6,17,0.353,18,25,0.72,104,2014-12-21,WAS,PHO,2015,107.0
10461,10461,61,@,W 92-90 ,240,29,84,0.345,24,71,0.338,5,13,0.385,29,33,0.879,92,36,83,0.434,31,70,0.443,5,13,0.385,13,21,0.619,90,2014-12-29,CHI,IND,2015,92.5
10462,10462,62,Home,L 92-98 ,240,32,86,0.372,22,55,0.4,10,31,0.323,18,24,0.75,92,33,81,0.407,27,58,0.466,6,23,0.261,26,30,0.867,98,2015-01-02,UTA,ATL,2015,101.0
10463,10463,63,@,L 92-101 ,240,40,82,0.488,36,68,0.529,4,14,0.286,8,13,0.615,92,43,78,0.551,39,62,0.629,4,16,0.25,11,18,0.611,101,2015-01-03,WAS,SAS,2015,103.0
10464,10464,64,@,W 92-85 ,240,38,79,0.481,36,69,0.522,2,10,0.2,14,17,0.824,92,33,74,0.446,27,55,0.491,6,19,0.316,13,17,0.765,85,2015-01-05,WAS,NOP,2015,88.0
10465,10465,65,@,L 92-95 ,240,33,85,0.388,22,55,0.4,11,30,0.367,15,22,0.682,92,38,79,0.481,31,56,0.554,7,23,0.304,12,15,0.8,95,2015-01-05,CLE,PHI,2015,98.5
10466,10466,66,@,L 92-93 ,240,29,87,0.333,25,69,0.362,4,18,0.222,30,42,0.714,92,32,80,0.4,21,56,0.375,11,24,0.458,18,25,0.72,93,2015-01-10,IND,PHI,2015,98.5
10467,10467,67,@,L 92-103 ,240,37,92,0.402,34,71,0.479,3,21,0.143,15,20,0.75,92,36,76,0.474,26,50,0.52,10,26,0.385,21,26,0.808,103,2015-01-10,ORL,POR,2015,108.0
10468,10468,68,Home,L 92-103 ,240,36,75,0.48,26,49,0.531,10,26,0.385,10,12,0.833,92,39,83,0.47,36,66,0.545,3,17,0.176,22,29,0.759,103,2015-01-14,BRK,MEM,2015,104.5
10469,10469,69,@,W 92-89 ,240,36,90,0.4,30,66,0.455,6,24,0.25,14,24,0.583,92,34,76,0.447,29,58,0.5,5,18,0.278,16,25,0.64,89,2015-01-19,TOR,MIL,2015,91.5
10470,10470,70,@,L 92-99 ,240,35,84,0.417,27,57,0.474,8,27,0.296,14,20,0.7,92,38,78,0.487,28,55,0.509,10,23,0.435,13,17,0.765,99,2015-01-19,NOP,NYK,2015,104.0
10471,10471,71,@,L 92-106 ,240,35,84,0.417,27,62,0.435,8,22,0.364,14,18,0.778,92,42,81,0.519,37,57,0.649,5,24,0.208,17,25,0.68,106,2015-01-21,UTA,CLE,2015,108.5
10472,10472,72,Home,W 92-86 ,240,34,74,0.459,33,67,0.493,1,7,0.143,23,29,0.793,92,27,85,0.318,22,57,0.386,5,28,0.179,27,32,0.844,86,2015-01-21,MEM,TOR,2015,88.5
10473,10473,73,@,W 92-84 ,240,40,80,0.5,37,76,0.487,3,4,0.75,9,14,0.643,92,35,84,0.417,33,75,0.44,2,9,0.222,12,17,0.706,84,2015-01-23,NOP,MIN,2015,85.0
10474,10474,74,Home,W 92-84 ,240,36,86,0.419,32,66,0.485,4,20,0.2,16,24,0.667,92,29,85,0.341,27,72,0.375,2,13,0.154,24,32,0.75,84,2015-01-26,OKC,MIN,2015,85.0
10475,10475,75,Home,L 92-98 ,240,37,87,0.425,32,67,0.478,5,20,0.25,13,16,0.813,92,38,78,0.487,34,62,0.548,4,16,0.25,18,27,0.667,98,2015-01-27,LAL,WAS,2015,100.0
10476,10476,76,@,L 92-100 ,240,34,85,0.4,29,63,0.46,5,22,0.227,19,22,0.864,92,40,91,0.44,32,74,0.432,8,17,0.471,12,17,0.706,100,2015-01-28,OKC,NYK,2015,104.0
10477,10477,77,Home,W 92-80 ,240,37,84,0.44,27,62,0.435,10,22,0.455,8,13,0.615,92,27,76,0.355,20,60,0.333,7,16,0.438,19,23,0.826,80,2015-02-01,NYK,LAL,2015,83.5
10478,10478,78,@,W 92-88 ,240,37,79,0.468,33,64,0.516,4,15,0.267,14,19,0.737,92,33,81,0.407,27,66,0.409,6,15,0.4,16,19,0.842,88,2015-02-02,CHA,WAS,2015,91.0
10479,10479,79,Home,W 92-88 ,240,37,74,0.5,34,63,0.54,3,11,0.273,15,22,0.682,92,34,89,0.382,28,65,0.431,6,24,0.25,14,17,0.824,88,2015-02-06,BRK,NYK,2015,91.0
10480,10480,80,Home,L 92-106 ,240,35,87,0.402,27,69,0.391,8,18,0.444,14,17,0.824,92,37,81,0.457,25,56,0.446,12,25,0.48,20,24,0.833,106,2015-02-07,NYK,GSW,2015,112.0
10481,10481,81,Home,W 92-76 ,240,37,83,0.446,27,58,0.466,10,25,0.4,8,17,0.471,92,26,72,0.361,22,50,0.44,4,22,0.182,20,22,0.909,76,2015-02-20,UTA,POR,2015,78.0
10482,10482,82,Home,W 92-81 ,240,36,78,0.462,31,60,0.517,5,18,0.278,15,19,0.789,92,33,90,0.367,27,71,0.38,6,19,0.316,9,13,0.692,81,2015-02-22,DAL,CHO,2015,84.0
10483,10483,83,Home,L 92-98 ,240,33,82,0.402,20,49,0.408,13,33,0.394,13,16,0.813,92,42,89,0.472,39,80,0.488,3,9,0.333,11,13,0.846,98,2015-02-22,POR,MEM,2015,99.5
10484,10484,84,@,L 92-99 ,240,38,84,0.452,29,58,0.5,9,26,0.346,7,11,0.636,92,38,79,0.481,30,60,0.5,8,19,0.421,15,18,0.833,99,2015-02-24,TOR,DAL,2015,103.0
10485,10485,85,@,L 92-105 ,240,38,88,0.432,29,62,0.468,9,26,0.346,7,11,0.636,92,40,96,0.417,31,72,0.431,9,24,0.375,16,18,0.889,105,2015-02-24,IND,OKC,2015,109.5
10486,10486,86,Home,L 92-99 ,240,37,92,0.402,28,59,0.475,9,33,0.273,9,17,0.529,92,36,74,0.486,31,52,0.596,5,22,0.227,22,30,0.733,99,2015-03-01,DEN,NOP,2015,101.5
10487,10487,87,@,L 92-97 ,240,35,84,0.417,27,62,0.435,8,22,0.364,14,19,0.737,92,33,78,0.423,24,49,0.49,9,29,0.31,22,30,0.733,97,2015-03-03,WAS,CHI,2015,101.5
10488,10488,88,@,W 92-86 ,240,30,79,0.38,23,61,0.377,7,18,0.389,25,30,0.833,92,30,78,0.385,27,63,0.429,3,15,0.2,23,30,0.767,86,2015-03-07,IND,NYK,2015,87.5
10489,10489,89,Home,W 92-84 ,240,35,95,0.368,22,58,0.379,13,37,0.351,9,17,0.529,92,30,77,0.39,19,52,0.365,11,25,0.44,13,16,0.813,84,2015-03-07,PHI,ATL,2015,89.5
10490,10490,90,@,L 92-95 ,240,37,78,0.474,32,66,0.485,5,12,0.417,13,13,1.0,92,37,85,0.435,29,58,0.5,8,27,0.296,13,17,0.765,95,2015-03-11,MEM,BOS,2015,99.0
10491,10491,91,@,L 92-102 ,240,35,79,0.443,30,56,0.536,5,23,0.217,17,24,0.708,92,34,79,0.43,22,46,0.478,12,33,0.364,22,31,0.71,102,2015-03-13,MIA,TOR,2015,108.0
10492,10492,92,Home,W 92-81 ,240,33,80,0.413,31,71,0.437,2,9,0.222,24,28,0.857,92,30,81,0.37,22,63,0.349,8,18,0.444,13,21,0.619,81,2015-03-16,MEM,DEN,2015,85.0
10493,10493,93,@,L 92-106 ,240,30,79,0.38,19,46,0.413,11,33,0.333,21,27,0.778,92,42,76,0.553,38,61,0.623,4,15,0.267,18,22,0.818,106,2015-03-16,CLE,MIA,2015,108.0
10494,10494,94,@,L 92-99 ,240,32,79,0.405,27,65,0.415,5,14,0.357,23,29,0.793,92,35,77,0.455,26,53,0.491,9,24,0.375,20,28,0.714,99,2015-03-17,CHA,LAC,2015,103.5
10495,10495,95,@,L 92-117 ,240,36,80,0.45,31,60,0.517,5,20,0.25,15,21,0.714,92,45,82,0.549,30,53,0.566,15,29,0.517,12,20,0.6,117,2015-03-18,BRK,CLE,2015,124.5
10496,10496,96,Home,L 92-95 (OT),265,40,97,0.412,36,77,0.468,4,20,0.2,8,10,0.8,92,34,83,0.41,32,71,0.451,2,12,0.167,25,30,0.833,95,2015-03-19,NYK,MIN,2015,96.0
10497,10497,97,@,L 92-108 ,240,30,79,0.38,20,54,0.37,10,25,0.4,22,26,0.846,92,42,79,0.532,33,51,0.647,9,28,0.321,15,17,0.882,108,2015-03-20,TOR,CHI,2015,112.5
10498,10498,98,@,L 92-95 ,240,36,84,0.429,28,64,0.438,8,20,0.4,12,13,0.923,92,35,82,0.427,26,56,0.464,9,26,0.346,16,21,0.762,95,2015-03-20,IND,CLE,2015,99.5
10499,10499,99,@,L 92-98 ,240,37,96,0.385,32,77,0.416,5,19,0.263,13,22,0.591,92,39,76,0.513,33,55,0.6,6,21,0.286,14,23,0.609,98,2015-03-22,DAL,PHO,2015,101.0
10500,10500,0,@,W 92-89 ,240,34,81,0.42,27,54,0.5,7,27,0.259,17,20,0.85,92,35,80,0.438,31,64,0.484,4,16,0.25,15,23,0.652,89,2015-03-25,POR,UTA,2015,91.0
10501,10501,1,Home,L 92-96 ,240,38,87,0.437,31,63,0.492,7,24,0.292,9,14,0.643,92,29,69,0.42,25,49,0.51,4,20,0.2,34,43,0.791,96,2015-03-27,NYK,BOS,2015,98.0
10502,10502,2,Home,L 92-113 ,240,37,83,0.446,32,67,0.478,5,16,0.313,13,21,0.619,92,44,78,0.564,35,62,0.565,9,16,0.563,16,21,0.762,113,2015-04-01,LAL,NOP,2015,117.5
10503,10503,3,@,L 92-100 ,240,36,88,0.409,32,71,0.451,4,17,0.235,16,26,0.615,92,38,80,0.475,34,59,0.576,4,21,0.19,20,28,0.714,100,2015-04-03,OKC,MEM,2015,102.0
10504,10504,4,Home,W 92-91 ,240,35,86,0.407,34,73,0.466,1,13,0.077,21,23,0.913,92,28,76,0.368,17,50,0.34,11,26,0.423,24,33,0.727,91,2015-04-04,CHA,PHI,2015,96.5
10505,10505,5,Home,L 92-107 ,240,32,85,0.376,26,63,0.413,6,22,0.273,22,31,0.71,92,34,79,0.43,21,45,0.467,13,34,0.382,26,42,0.619,107,2015-04-04,DEN,LAC,2015,113.5
10506,10506,6,@,W 92-83 ,240,38,79,0.481,30,57,0.526,8,22,0.364,8,10,0.8,92,34,81,0.42,33,66,0.5,1,15,0.067,14,18,0.778,83,2015-04-04,WAS,MEM,2015,83.5
10507,10507,7,@,L 92-107 ,240,39,91,0.429,30,63,0.476,9,28,0.321,5,10,0.5,92,44,83,0.53,37,62,0.597,7,21,0.333,12,15,0.8,107,2015-04-05,GSW,SAS,2015,110.5
10508,10508,8,@,W 92-74 ,240,33,77,0.429,21,50,0.42,12,27,0.444,14,19,0.737,92,28,81,0.346,18,59,0.305,10,22,0.455,8,11,0.727,74,2015-04-08,TOR,CHO,2015,79.0
10509,10509,9,@,L 92-102 ,240,40,96,0.417,36,81,0.444,4,15,0.267,8,13,0.615,92,35,72,0.486,31,56,0.554,4,16,0.25,28,36,0.778,102,2015-04-13,LAL,SAC,2015,104.0
10510,10510,10,@,L 92-109 ,240,34,82,0.415,25,62,0.403,9,20,0.45,15,23,0.652,92,41,82,0.5,30,54,0.556,11,28,0.393,16,26,0.615,109,2015-04-13,DAL,UTA,2015,114.5
10511,10511,11,Home,W 92-87 ,240,38,77,0.494,26,44,0.591,12,33,0.364,4,4,1.0,92,30,71,0.423,18,38,0.474,12,33,0.364,15,16,0.938,87,2015-04-15,TOR,CHO,2015,93.0
10512,10512,12,Home,W 92-87 ,240,30,74,0.405,23,55,0.418,7,19,0.368,25,34,0.735,92,35,75,0.467,33,63,0.524,2,12,0.167,15,21,0.714,87,2015-10-28,DET,UTA,2016,88.0
10513,10513,13,@,L 92-102 ,240,33,77,0.429,27,56,0.482,6,21,0.286,20,22,0.909,92,39,86,0.453,33,61,0.541,6,25,0.24,18,21,0.857,102,2015-10-30,MIA,CLE,2016,105.0
10514,10514,14,Home,L 92-112 ,240,30,82,0.366,25,59,0.424,5,23,0.217,27,36,0.75,92,43,93,0.462,34,67,0.507,9,26,0.346,17,25,0.68,112,2015-10-30,HOU,GSW,2016,116.5
10515,10515,15,@,L 92-110 ,240,34,86,0.395,25,62,0.403,9,24,0.375,15,19,0.789,92,37,83,0.446,33,65,0.508,4,18,0.222,32,42,0.762,110,2015-10-30,POR,PHO,2016,112.0
10516,10516,16,Home,W 92-87 ,240,33,87,0.379,26,59,0.441,7,28,0.25,19,22,0.864,92,35,90,0.389,28,67,0.418,7,23,0.304,10,17,0.588,87,2015-11-01,CHI,ORL,2016,90.5
10517,10517,17,Home,L 92-94 ,240,32,86,0.372,18,49,0.367,14,37,0.378,14,15,0.933,92,37,88,0.42,30,59,0.508,7,29,0.241,13,14,0.929,94,2015-11-01,CHA,ATL,2016,97.5
10518,10518,18,Home,L 92-98 ,240,38,86,0.442,33,58,0.569,5,28,0.179,11,16,0.688,92,37,90,0.411,30,69,0.435,7,21,0.333,17,22,0.773,98,2015-11-03,MIA,ATL,2016,101.5
10519,10519,19,Home,L 92-108 ,240,33,88,0.375,28,64,0.438,5,24,0.208,21,33,0.636,92,41,77,0.532,30,52,0.577,11,25,0.44,15,32,0.469,108,2015-11-04,UTA,POR,2016,113.5
10520,10520,20,Home,L 92-99 ,240,33,81,0.407,29,57,0.509,4,24,0.167,22,28,0.786,92,35,81,0.432,32,67,0.478,3,14,0.214,26,29,0.897,99,2015-11-06,NYK,MIL,2016,100.5
10521,10521,21,Home,W 92-87 ,240,33,77,0.429,24,52,0.462,9,25,0.36,17,22,0.773,92,30,86,0.349,25,63,0.397,5,23,0.217,22,29,0.759,87,2015-11-06,ORL,TOR,2016,89.5
10522,10522,22,Home,L 92-100 ,240,37,92,0.402,27,62,0.435,10,30,0.333,8,13,0.615,92,37,74,0.5,29,52,0.558,8,22,0.364,18,36,0.5,100,2015-11-06,PHO,DET,2016,104.0
10523,10523,23,@,L 92-94 ,240,35,80,0.438,33,69,0.478,2,11,0.182,20,29,0.69,92,28,68,0.412,23,49,0.469,5,19,0.263,33,37,0.892,94,2015-11-09,MEM,LAC,2016,96.5
10524,10524,24,@,L 92-101 ,240,34,89,0.382,25,57,0.439,9,32,0.281,15,20,0.75,92,37,74,0.5,28,58,0.483,9,16,0.563,18,24,0.75,101,2015-11-11,DET,SAC,2016,105.5
10525,10525,25,Home,W 92-91 ,240,36,77,0.468,32,64,0.5,4,13,0.308,16,25,0.64,92,34,89,0.382,30,72,0.417,4,17,0.235,19,25,0.76,91,2015-11-12,MIA,UTA,2016,93.0
10526,10526,26,Home,W 92-83 ,240,33,85,0.388,28,69,0.406,5,16,0.313,21,25,0.84,92,33,82,0.402,25,60,0.417,8,22,0.364,9,11,0.818,83,2015-11-14,SAS,PHI,2016,87.0
10527,10527,27,@,W 92-86 ,240,30,76,0.395,23,52,0.442,7,24,0.292,25,30,0.833,92,34,76,0.447,29,54,0.537,5,22,0.227,13,20,0.65,86,2015-11-16,DAL,PHI,2016,88.5
10528,10528,28,Home,W 92-82 ,240,34,72,0.472,27,51,0.529,7,21,0.333,17,22,0.773,92,32,74,0.432,31,65,0.477,1,9,0.111,17,17,1.0,82,2015-11-21,SAS,MEM,2016,82.5
10529,10529,29,@,L 92-104 ,240,32,92,0.348,21,66,0.318,11,26,0.423,17,20,0.85,92,37,87,0.425,29,59,0.492,8,28,0.286,22,29,0.759,104,2015-11-27,CHI,IND,2016,108.0
10530,10530,30,Home,W 92-81 ,240,33,77,0.429,26,51,0.51,7,26,0.269,19,27,0.704,92,30,75,0.4,22,50,0.44,8,25,0.32,13,17,0.765,81,2015-11-28,DAL,DEN,2016,85.0
10531,10531,31,Home,W 92-84 ,240,34,81,0.42,30,68,0.441,4,13,0.308,20,27,0.741,92,30,77,0.39,18,41,0.439,12,36,0.333,12,16,0.75,84,2015-11-29,MEM,PHI,2016,90.0
10532,10532,32,Home,W 92-89 ,240,37,86,0.43,31,70,0.443,6,16,0.375,12,20,0.6,92,37,90,0.411,35,76,0.461,2,14,0.143,13,18,0.722,89,2015-11-30,CHI,SAS,2016,90.0
10533,10533,33,Home,W 92-74 ,240,35,77,0.455,29,59,0.492,6,18,0.333,16,22,0.727,92,28,75,0.373,22,56,0.393,6,19,0.316,12,16,0.75,74,2015-11-30,MIL,DEN,2016,77.0
10534,10534,34,Home,L 92-93 ,240,37,87,0.425,29,58,0.5,8,29,0.276,10,15,0.667,92,41,88,0.466,37,73,0.507,4,15,0.267,7,13,0.538,93,2015-12-09,DET,MEM,2016,95.0
10535,10535,35,@,L 92-106 ,240,38,90,0.422,31,71,0.437,7,19,0.368,9,15,0.6,92,46,89,0.517,40,69,0.58,6,20,0.3,8,9,0.889,106,2015-12-21,IND,SAS,2016,109.0
10536,10536,36,Home,L 92-93 ,240,39,88,0.443,35,70,0.5,4,18,0.222,10,12,0.833,92,35,78,0.449,20,48,0.417,15,30,0.5,8,14,0.571,93,2015-12-22,MIA,DET,2016,100.5
10537,10537,37,@,L 92-98 ,240,37,90,0.411,30,71,0.423,7,19,0.368,11,21,0.524,92,28,69,0.406,14,37,0.378,14,32,0.438,28,32,0.875,98,2015-12-26,MEM,CHO,2016,105.0
10538,10538,38,Home,W 92-87 (OT),265,31,75,0.413,22,48,0.458,9,27,0.333,21,28,0.75,92,33,81,0.407,26,63,0.413,7,18,0.389,14,26,0.538,87,2016-01-02,UTA,MEM,2016,90.5
10539,10539,39,@,L 92-101 ,240,35,98,0.357,30,73,0.411,5,25,0.2,17,22,0.773,92,39,94,0.415,30,72,0.417,9,22,0.409,14,17,0.824,101,2016-01-07,BOS,CHI,2016,105.5
10540,10540,40,@,L 92-95 ,240,30,83,0.361,18,47,0.383,12,36,0.333,20,24,0.833,92,32,77,0.416,20,50,0.4,12,27,0.444,19,23,0.826,95,2016-01-10,CHA,DEN,2016,101.0
10541,10541,41,Home,L 92-105 ,240,33,87,0.379,24,51,0.471,9,36,0.25,17,22,0.773,92,39,72,0.542,34,60,0.567,5,12,0.417,22,26,0.846,105,2016-01-16,CHA,MIL,2016,107.5
10542,10542,42,Home,L 92-112 ,240,35,89,0.393,27,63,0.429,8,26,0.308,14,20,0.7,92,43,97,0.443,32,72,0.444,11,25,0.44,15,19,0.789,112,2016-01-24,PHI,BOS,2016,117.5
10543,10543,43,Home,L 92-95 ,240,34,85,0.4,25,56,0.446,9,29,0.31,15,18,0.833,92,34,75,0.453,23,53,0.434,11,22,0.5,16,33,0.485,95,2016-01-25,UTA,DET,2016,100.5
10544,10544,44,@,W 92-90 ,240,33,76,0.434,27,51,0.529,6,25,0.24,20,26,0.769,92,30,74,0.405,23,49,0.469,7,25,0.28,23,28,0.821,90,2016-01-26,DAL,LAL,2016,93.5
10545,10545,45,@,L 92-111 ,240,33,83,0.398,26,55,0.473,7,28,0.25,19,21,0.905,92,38,78,0.487,29,63,0.46,9,15,0.6,26,30,0.867,111,2016-01-28,ATL,IND,2016,115.5
10546,10546,46,@,L 92-107 ,240,39,96,0.406,34,79,0.43,5,17,0.294,9,11,0.818,92,40,78,0.513,31,54,0.574,9,24,0.375,18,21,0.857,107,2016-02-01,ORL,SAS,2016,111.5
10547,10547,47,Home,L 92-98 (OT),265,34,90,0.378,28,65,0.431,6,25,0.24,18,21,0.857,92,35,95,0.368,30,73,0.411,5,22,0.227,23,31,0.742,98,2016-02-08,PHI,LAC,2016,100.5
10548,10548,48,Home,L 92-103 ,240,38,88,0.432,28,61,0.459,10,27,0.37,6,7,0.857,92,39,83,0.47,33,64,0.516,6,19,0.316,19,24,0.792,103,2016-02-10,DET,DEN,2016,106.0
10549,10549,49,@,L 92-99 ,240,34,88,0.386,28,56,0.5,6,32,0.188,18,24,0.75,92,36,82,0.439,32,68,0.471,4,14,0.286,23,32,0.719,99,2016-02-11,WAS,MIL,2016,101.0
10550,10550,50,Home,L 92-115 ,240,37,90,0.411,32,69,0.464,5,21,0.238,13,19,0.684,92,41,80,0.513,31,57,0.544,10,23,0.435,23,27,0.852,115,2016-02-21,OKC,CLE,2016,120.0
10551,10551,51,Home,L 92-102 ,240,36,86,0.419,26,52,0.5,10,34,0.294,10,16,0.625,92,39,89,0.438,25,44,0.568,14,45,0.311,10,12,0.833,102,2016-02-22,ATL,GSW,2016,109.0
10552,10552,52,Home,L 92-108 ,240,39,96,0.406,33,78,0.423,6,18,0.333,8,15,0.533,92,44,85,0.518,36,66,0.545,8,19,0.421,12,15,0.8,108,2016-02-24,SAC,SAS,2016,112.0
10553,10553,53,@,L 92-126 ,240,33,91,0.363,27,64,0.422,6,27,0.222,20,27,0.741,92,45,93,0.484,32,66,0.485,13,27,0.481,23,27,0.852,126,2016-03-01,PHO,CHO,2016,132.5
10554,10554,54,@,L 92-108 ,240,33,82,0.402,28,60,0.467,5,22,0.227,21,27,0.778,92,40,83,0.482,31,66,0.47,9,17,0.529,19,25,0.76,108,2016-03-03,PHO,MIA,2016,112.5
10555,10555,55,@,L 92-103 ,240,35,89,0.393,29,60,0.483,6,29,0.207,16,21,0.762,92,40,81,0.494,36,68,0.529,4,13,0.308,19,24,0.792,103,2016-03-12,NOP,MIL,2016,105.0
10556,10556,56,Home,W 92-85 ,240,39,80,0.488,33,61,0.541,6,19,0.316,8,11,0.727,92,35,86,0.407,27,59,0.458,8,27,0.296,7,12,0.583,85,2016-03-19,CHI,UTA,2016,89.0
10557,10557,57,Home,W 92-91 ,240,35,85,0.412,26,52,0.5,9,33,0.273,13,17,0.765,92,41,76,0.539,36,67,0.537,5,9,0.556,4,7,0.571,91,2016-03-21,DET,MIL,2016,93.5
10558,10558,58,Home,W 92-84 ,240,36,79,0.456,29,59,0.492,7,20,0.35,13,15,0.867,92,35,85,0.412,31,69,0.449,4,16,0.25,10,14,0.714,84,2016-03-24,IND,NOP,2016,86.0
10559,10559,59,@,L 92-111 ,240,37,86,0.43,33,71,0.465,4,15,0.267,14,17,0.824,92,44,85,0.518,37,65,0.569,7,20,0.35,16,18,0.889,111,2016-03-26,SAS,OKC,2016,114.5
10560,10560,60,@,L 92-100 ,240,36,80,0.45,28,63,0.444,8,17,0.471,12,18,0.667,92,36,75,0.48,24,51,0.471,12,24,0.5,16,22,0.727,100,2016-03-30,NOP,SAS,2016,106.0
10561,10561,61,@,W 92-87 ,240,34,81,0.42,27,59,0.458,7,22,0.318,17,20,0.85,92,33,96,0.344,26,71,0.366,7,25,0.28,14,20,0.7,87,2016-04-03,IND,NYK,2016,90.5
10562,10562,62,@,L 92-108 ,240,34,77,0.442,23,48,0.479,11,29,0.379,13,19,0.684,92,39,87,0.448,32,68,0.471,7,19,0.368,23,26,0.885,108,2016-04-05,CHI,MEM,2016,111.5
10563,10563,63,@,W 92-86 ,240,34,77,0.442,24,50,0.48,10,27,0.37,14,18,0.778,92,34,90,0.378,31,73,0.425,3,17,0.176,15,19,0.789,86,2016-04-10,GSW,SAS,2016,87.5
10564,10564,64,Home,L 92-101 ,240,35,77,0.455,26,44,0.591,9,33,0.273,13,18,0.722,92,36,81,0.444,25,49,0.51,11,32,0.344,18,22,0.818,101,2016-04-11,UTA,DAL,2016,106.5
10565,10565,65,Home,L 92-97 ,240,37,87,0.425,30,64,0.469,7,23,0.304,11,13,0.846,92,39,90,0.433,28,66,0.424,11,24,0.458,8,10,0.8,97,2016-04-13,MIL,IND,2016,102.5
10566,10566,66,@,L 92-93 ,240,32,84,0.381,21,54,0.389,11,30,0.367,17,20,0.85,92,34,80,0.425,23,49,0.469,11,31,0.355,14,21,0.667,93,2016-10-30,DAL,HOU,2017,98.5
10567,10567,67,@,L 92-95 ,240,32,83,0.386,27,58,0.466,5,25,0.2,23,36,0.639,92,31,80,0.388,26,60,0.433,5,20,0.25,28,35,0.8,95,2016-11-04,ATL,WAS,2017,97.5
10568,10568,68,@,L 92-112 ,240,33,84,0.393,29,65,0.446,4,19,0.211,22,29,0.759,92,45,86,0.523,38,70,0.543,7,16,0.438,15,24,0.625,112,2016-11-05,MIN,OKC,2017,115.5
10569,10569,69,Home,L 92-116 ,240,30,74,0.405,20,49,0.408,10,25,0.4,22,25,0.88,92,47,91,0.516,38,68,0.559,9,23,0.391,13,14,0.929,116,2016-11-05,SAS,LAC,2017,120.5
10570,10570,70,Home,L 92-94 ,240,37,86,0.43,30,66,0.455,7,20,0.35,11,16,0.688,92,33,82,0.402,21,51,0.412,12,31,0.387,16,17,0.941,94,2016-11-19,DET,BOS,2017,100.0
10571,10571,71,Home,L 92-111 ,240,34,86,0.395,24,55,0.436,10,31,0.323,14,22,0.636,92,45,98,0.459,30,60,0.5,15,38,0.395,6,8,0.75,111,2016-11-23,BRK,BOS,2017,118.5
10572,10572,72,@,W 92-87 ,240,33,73,0.452,24,51,0.471,9,22,0.409,17,22,0.773,92,33,91,0.363,26,66,0.394,7,25,0.28,14,23,0.609,87,2016-11-23,PHO,ORL,2017,90.5
10573,10573,73,@,L 92-97 ,240,33,88,0.375,27,62,0.435,6,26,0.231,20,25,0.8,92,36,88,0.409,25,60,0.417,11,28,0.393,14,15,0.933,97,2016-12-02,SAC,BOS,2017,102.5
10574,10574,74,@,L 92-99 ,240,38,86,0.442,32,64,0.5,6,22,0.273,10,15,0.667,92,36,89,0.404,27,65,0.415,9,24,0.375,18,24,0.75,99,2016-12-03,MIA,POR,2017,103.5
10575,10575,75,Home,L 92-98 ,240,38,86,0.442,28,59,0.475,10,27,0.37,6,13,0.462,92,42,79,0.532,35,56,0.625,7,23,0.304,7,14,0.5,98,2016-12-04,DET,ORL,2017,101.5
10576,10576,76,@,L 92-101 ,240,36,98,0.367,30,70,0.429,6,28,0.214,14,19,0.737,92,41,89,0.461,35,61,0.574,6,28,0.214,13,26,0.5,101,2016-12-04,NOP,OKC,2017,104.0
10577,10577,77,Home,W 92-85 ,240,35,78,0.449,29,59,0.492,6,19,0.316,16,17,0.941,92,31,76,0.408,24,44,0.545,7,32,0.219,16,24,0.667,85,2016-12-08,WAS,DEN,2017,88.5
10578,10578,78,@,L 92-112 ,240,35,83,0.422,28,58,0.483,7,25,0.28,15,18,0.833,92,45,77,0.584,33,51,0.647,12,26,0.462,10,12,0.833,112,2016-12-12,DEN,DAL,2017,118.0
10579,10579,79,@,L 92-116 ,240,33,84,0.393,23,61,0.377,10,23,0.435,16,21,0.762,92,47,84,0.56,37,61,0.607,10,23,0.435,12,21,0.571,116,2016-12-12,LAL,SAC,2017,121.0
10580,10580,80,Home,L 92-107 ,240,34,85,0.4,24,58,0.414,10,27,0.37,14,18,0.778,92,39,74,0.527,34,58,0.586,5,16,0.313,24,26,0.923,107,2016-12-15,PHO,SAS,2017,109.5
10581,10581,81,Home,L 92-96 ,240,29,77,0.377,24,52,0.462,5,25,0.2,29,36,0.806,92,31,80,0.388,24,56,0.429,7,24,0.292,27,37,0.73,96,2016-12-16,MEM,SAC,2017,99.5
10582,10582,82,@,W 92-84 ,240,35,83,0.422,26,54,0.481,9,29,0.31,13,14,0.929,92,34,82,0.415,27,56,0.482,7,26,0.269,9,13,0.692,84,2016-12-21,MIN,ATL,2017,87.5
10583,10583,83,@,L 92-104 ,240,35,93,0.376,28,70,0.4,7,23,0.304,15,16,0.938,92,38,85,0.447,26,56,0.464,12,29,0.414,16,17,0.941,104,2016-12-30,NYK,NOP,2017,110.0
10584,10584,84,Home,L 92-111 ,240,37,86,0.43,28,58,0.483,9,28,0.321,9,10,0.9,92,44,81,0.543,34,62,0.548,10,19,0.526,13,18,0.722,111,2017-01-04,ORL,ATL,2017,116.0
10585,10585,85,Home,L 92-94 ,240,35,80,0.438,28,60,0.467,7,20,0.35,15,21,0.714,92,32,77,0.416,24,54,0.444,8,23,0.348,22,28,0.786,94,2017-01-07,MIN,UTA,2017,98.0
10586,10586,86,@,L 92-101 ,240,36,78,0.462,23,50,0.46,13,28,0.464,7,9,0.778,92,40,71,0.563,34,55,0.618,6,16,0.375,15,21,0.714,101,2017-01-09,DAL,MIN,2017,104.0
10587,10587,87,@,L 92-100 ,240,31,85,0.365,22,54,0.407,9,31,0.29,21,25,0.84,92,38,79,0.481,25,45,0.556,13,34,0.382,11,19,0.579,100,2017-01-10,CLE,UTA,2017,106.5
10588,10588,88,@,L 92-111 ,240,37,93,0.398,30,65,0.462,7,28,0.25,11,14,0.786,92,43,95,0.453,29,51,0.569,14,44,0.318,11,15,0.733,111,2017-01-18,MIL,HOU,2017,118.0
10589,10589,89,@,L 92-93 ,240,33,89,0.371,27,70,0.386,6,19,0.316,20,28,0.714,92,36,92,0.391,24,63,0.381,12,29,0.414,9,16,0.563,93,2017-01-20,POR,PHI,2017,99.0
10590,10590,90,Home,L 92-100 ,240,35,85,0.412,28,63,0.444,7,22,0.318,15,20,0.75,92,35,77,0.455,28,55,0.509,7,22,0.318,23,30,0.767,100,2017-01-24,ORL,CHI,2017,103.5
10591,10591,91,@,L 92-123 ,240,37,92,0.402,33,68,0.485,4,24,0.167,14,19,0.737,92,48,85,0.565,33,57,0.579,15,28,0.536,12,13,0.923,123,2017-02-08,CHI,GSW,2017,130.5
10592,10592,92,@,L 92-108 ,240,29,73,0.397,19,41,0.463,10,32,0.313,24,27,0.889,92,42,84,0.5,32,59,0.542,10,25,0.4,14,15,0.933,108,2017-02-08,BOS,SAC,2017,113.0
10593,10593,93,Home,L 92-103 ,240,39,92,0.424,34,75,0.453,5,17,0.294,9,13,0.692,92,41,82,0.5,32,63,0.508,9,19,0.474,12,15,0.8,103,2017-02-10,DET,SAS,2017,107.5
10594,10594,94,@,L 92-102 ,240,35,84,0.417,26,57,0.456,9,27,0.333,13,23,0.565,92,40,78,0.513,29,52,0.558,11,26,0.423,11,11,1.0,102,2017-02-24,MEM,IND,2017,107.5
10595,10595,95,Home,L 92-102 ,240,37,87,0.425,29,65,0.446,8,22,0.364,10,13,0.769,92,34,72,0.472,23,48,0.479,11,24,0.458,23,32,0.719,102,2017-02-26,WAS,UTA,2017,107.5
10596,10596,96,@,W 92-91 ,240,33,78,0.423,26,52,0.5,7,26,0.269,19,23,0.826,92,33,73,0.452,24,49,0.49,9,24,0.375,16,19,0.842,91,2017-02-27,TOR,NYK,2017,95.5
10597,10597,97,@,L 92-120 ,240,35,73,0.479,24,46,0.522,11,27,0.407,11,18,0.611,92,46,88,0.523,28,54,0.519,18,34,0.529,10,12,0.833,120,2017-03-04,CLE,MIA,2017,129.0
10598,10598,98,@,L 92-102 ,240,35,84,0.417,29,65,0.446,6,19,0.316,16,20,0.8,92,41,88,0.466,35,68,0.515,6,20,0.3,14,21,0.667,102,2017-03-09,SAS,OKC,2017,105.0
10599,10599,99,@,L 91-99 ,240,34,82,0.415,26,58,0.448,8,24,0.333,15,22,0.682,91,36,77,0.468,32,62,0.516,4,15,0.267,23,31,0.742,99,2011-12-26,CHI,GSW,2012,101.0
10600,10600,0,Home,W 91-79 ,240,32,87,0.368,25,72,0.347,7,15,0.467,20,25,0.8,91,27,75,0.36,20,56,0.357,7,19,0.368,18,21,0.857,79,2011-12-26,IND,DET,2012,82.5
10601,10601,1,@,L 91-100 ,240,37,88,0.42,36,72,0.5,1,16,0.063,16,19,0.842,91,35,75,0.467,26,57,0.456,9,18,0.5,21,35,0.6,100,2011-12-26,LAL,SAC,2012,104.5
10602,10602,2,@,L 91-98 (OT),265,34,88,0.386,29,63,0.46,5,25,0.2,18,31,0.581,91,36,94,0.383,34,84,0.405,2,10,0.2,24,32,0.75,98,2011-12-30,CLE,IND,2012,99.0
10603,10603,3,Home,W 91-86 ,240,33,83,0.398,29,64,0.453,4,19,0.211,21,27,0.778,91,37,88,0.42,32,69,0.464,5,19,0.263,7,11,0.636,86,2012-01-02,DEN,MIL,2012,88.5
10604,10604,4,@,L 91-102 ,240,36,72,0.5,29,55,0.527,7,17,0.412,12,20,0.6,91,39,87,0.448,31,64,0.484,8,23,0.348,16,21,0.762,102,2012-01-02,GSW,PHO,2012,106.0
10605,10605,5,Home,W 91-87 ,240,30,79,0.38,29,69,0.42,1,10,0.1,30,40,0.75,91,34,82,0.415,27,63,0.429,7,19,0.368,12,15,0.8,87,2012-01-09,NYK,CHA,2012,90.5
10606,10606,6,Home,L 91-98 ,240,34,80,0.425,28,60,0.467,6,20,0.3,17,21,0.81,91,30,81,0.37,23,57,0.404,7,24,0.292,31,34,0.912,98,2012-01-11,TOR,SAC,2012,101.5
10607,10607,7,@,L 91-93 ,240,38,85,0.447,34,64,0.531,4,21,0.19,11,12,0.917,91,32,78,0.41,25,57,0.439,7,21,0.333,22,27,0.815,93,2012-01-14,MIN,ATL,2012,96.5
10608,10608,8,Home,L 91-99 ,240,31,74,0.419,24,55,0.436,7,19,0.368,22,26,0.846,91,38,73,0.521,35,58,0.603,3,15,0.2,20,27,0.741,99,2012-01-15,DET,GSW,2012,100.5
10609,10609,9,@,L 91-102 ,240,38,91,0.418,33,76,0.434,5,15,0.333,10,14,0.714,91,40,81,0.494,35,62,0.565,5,19,0.263,17,23,0.739,102,2012-01-15,PHO,SAS,2012,104.5
10610,10610,10,@,L 91-101 ,240,33,78,0.423,25,54,0.463,8,24,0.333,17,26,0.654,91,37,80,0.463,29,59,0.492,8,21,0.381,19,35,0.543,101,2012-01-16,BRK,LAC,2012,105.0
10611,10611,11,Home,W 91-89 ,240,37,87,0.425,29,65,0.446,8,22,0.364,9,17,0.529,91,34,81,0.42,25,61,0.41,9,20,0.45,12,18,0.667,89,2012-01-18,LAC,DAL,2012,93.5
10612,10612,12,@,W 91-88 ,240,36,79,0.456,29,67,0.433,7,12,0.583,12,16,0.75,91,32,86,0.372,28,71,0.394,4,15,0.267,20,30,0.667,88,2012-01-18,PHO,NYK,2012,90.0
10613,10613,13,Home,L 91-94 ,240,31,80,0.388,28,68,0.412,3,12,0.25,26,29,0.897,91,37,71,0.521,32,51,0.627,5,20,0.25,15,19,0.789,94,2012-01-19,UTA,DAL,2012,96.5
10614,10614,14,Home,L 91-94 ,240,37,80,0.463,27,57,0.474,10,23,0.435,7,8,0.875,91,35,83,0.422,27,67,0.403,8,16,0.5,16,21,0.762,94,2012-01-20,GSW,IND,2012,98.0
10615,10615,15,@,L 91-94 ,240,34,81,0.42,31,61,0.508,3,20,0.15,20,24,0.833,91,30,67,0.448,23,52,0.442,7,15,0.467,27,32,0.844,94,2012-01-21,POR,DET,2012,97.5
10616,10616,16,@,L 91-103 ,240,29,81,0.358,21,62,0.339,8,19,0.421,25,31,0.806,91,35,72,0.486,27,51,0.529,8,21,0.381,25,40,0.625,103,2012-01-22,TOR,LAC,2012,107.0
10617,10617,17,@,W 91-82 ,240,28,80,0.35,23,50,0.46,5,30,0.167,30,34,0.882,91,25,67,0.373,22,55,0.4,3,12,0.25,29,35,0.829,82,2012-01-22,MIL,MIA,2012,83.5
10618,10618,18,@,W 91-90 ,240,36,85,0.424,34,72,0.472,2,13,0.154,17,23,0.739,91,38,76,0.5,29,51,0.569,9,25,0.36,5,8,0.625,90,2012-01-23,MEM,GSW,2012,94.5
10619,10619,19,Home,W 91-81 ,240,34,78,0.436,25,58,0.431,9,20,0.45,14,26,0.538,91,32,76,0.421,29,56,0.518,3,20,0.15,14,20,0.7,81,2012-01-25,CLE,NYK,2012,82.5
10620,10620,20,@,L 91-96 ,240,37,87,0.425,29,64,0.453,8,23,0.348,9,14,0.643,91,32,66,0.485,24,50,0.48,8,16,0.5,24,32,0.75,96,2012-01-25,LAC,LAL,2012,100.0
10621,10621,21,@,L 91-101 ,240,35,75,0.467,34,68,0.5,1,7,0.143,20,21,0.952,91,34,64,0.531,29,51,0.569,5,13,0.385,28,33,0.848,101,2012-01-25,NOP,OKC,2012,103.5
10622,10622,22,@,L 91-98 ,240,30,84,0.357,24,66,0.364,6,18,0.333,25,31,0.806,91,35,72,0.486,26,50,0.52,9,22,0.409,19,27,0.704,98,2012-01-26,MEM,LAC,2012,102.5
10623,10623,23,@,W 91-83 ,240,34,73,0.466,24,52,0.462,10,21,0.476,13,19,0.684,91,30,79,0.38,25,62,0.403,5,17,0.294,18,31,0.581,83,2012-01-26,BOS,ORL,2012,85.5
10624,10624,24,@,L 91-99 ,240,36,79,0.456,27,57,0.474,9,22,0.409,10,13,0.769,91,35,76,0.461,28,58,0.483,7,18,0.389,22,31,0.71,99,2012-02-01,HOU,SAS,2012,102.5
10625,10625,25,Home,L 91-112 ,240,39,85,0.459,31,58,0.534,8,27,0.296,5,12,0.417,91,39,73,0.534,27,52,0.519,12,21,0.571,22,25,0.88,112,2012-02-02,LAC,DEN,2012,118.0
10626,10626,26,Home,W 91-89 ,240,31,76,0.408,21,56,0.375,10,20,0.5,19,25,0.76,91,34,80,0.425,31,65,0.477,3,15,0.2,18,21,0.857,89,2012-02-03,BOS,NYK,2012,90.5
10627,10627,27,Home,W 91-88 ,240,37,93,0.398,31,70,0.443,6,23,0.261,11,15,0.733,91,32,67,0.478,26,54,0.481,6,13,0.462,18,27,0.667,88,2012-02-04,CLE,DAL,2012,91.0
10628,10628,28,@,L 91-100 ,240,39,91,0.429,37,81,0.457,2,10,0.2,11,14,0.786,91,37,82,0.451,31,62,0.5,6,20,0.3,20,23,0.87,100,2012-02-04,HOU,MIN,2012,103.0
10629,10629,29,@,L 91-107 ,240,32,82,0.39,25,63,0.397,7,19,0.368,20,30,0.667,91,39,84,0.464,33,67,0.493,6,17,0.353,23,26,0.885,107,2012-02-07,CLE,MIA,2012,110.0
10630,10630,30,@,L 91-95 ,240,34,88,0.386,28,68,0.412,6,20,0.3,17,24,0.708,91,37,75,0.493,34,62,0.548,3,13,0.231,18,26,0.692,95,2012-02-12,CHI,BOS,2012,96.5
10631,10631,31,Home,L 91-93 ,240,36,76,0.474,29,57,0.509,7,19,0.368,12,16,0.75,91,34,84,0.405,24,62,0.387,10,22,0.455,15,17,0.882,93,2012-02-15,GSW,POR,2012,98.0
10632,10632,32,Home,L 91-98 ,240,35,84,0.417,33,68,0.485,2,16,0.125,19,28,0.679,91,37,74,0.5,31,59,0.525,6,15,0.4,18,23,0.783,98,2012-02-17,TOR,CHA,2012,101.0
10633,10633,33,@,L 91-92 ,240,40,90,0.444,37,79,0.468,3,11,0.273,8,10,0.8,91,33,85,0.388,30,69,0.435,3,16,0.188,23,26,0.885,92,2012-02-19,PHI,MIN,2012,93.5
10634,10634,34,@,L 91-110 ,240,37,88,0.42,35,75,0.467,2,13,0.154,15,19,0.789,91,43,79,0.544,37,66,0.561,6,13,0.462,18,24,0.75,110,2012-02-22,MIL,CHI,2012,113.0
10635,10635,35,Home,L 91-96 ,240,36,90,0.4,28,58,0.483,8,32,0.25,11,16,0.688,91,35,76,0.461,27,56,0.482,8,20,0.4,18,31,0.581,96,2012-02-22,DAL,LAL,2012,100.0
10636,10636,36,Home,L 91-108 ,240,38,81,0.469,29,57,0.509,9,24,0.375,6,9,0.667,91,45,84,0.536,32,55,0.582,13,29,0.448,5,15,0.333,108,2012-02-22,BRK,ORL,2012,114.5
10637,10637,37,Home,L 91-112 ,240,35,80,0.438,26,58,0.448,9,22,0.409,12,16,0.75,91,47,89,0.528,37,69,0.536,10,20,0.5,8,12,0.667,112,2012-03-02,CLE,CHI,2012,117.0
10638,10638,38,Home,L 91-96 ,240,38,97,0.392,37,86,0.43,1,11,0.091,14,17,0.824,91,39,82,0.476,32,66,0.485,7,16,0.438,11,16,0.688,96,2012-03-04,PHI,CHI,2012,99.5
10639,10639,39,@,L 91-95 ,240,36,84,0.429,27,63,0.429,9,21,0.429,10,10,1.0,91,29,76,0.382,21,49,0.429,8,27,0.296,29,33,0.879,95,2012-03-05,DAL,OKC,2012,99.0
10640,10640,40,@,L 91-104 ,240,34,84,0.405,31,73,0.425,3,11,0.273,20,24,0.833,91,41,78,0.526,38,71,0.535,3,7,0.429,19,27,0.704,104,2012-03-09,UTA,PHI,2012,105.5
10641,10641,41,@,L 91-93 (OT),265,33,88,0.375,26,71,0.366,7,17,0.412,18,25,0.72,91,35,75,0.467,32,62,0.516,3,13,0.231,20,31,0.645,93,2012-03-10,IND,MIA,2012,94.5
10642,10642,42,@,L 91-98 ,240,36,86,0.419,31,72,0.431,5,14,0.357,14,19,0.737,91,41,86,0.477,37,75,0.493,4,11,0.364,12,15,0.8,98,2012-03-10,MEM,PHO,2012,100.0
10643,10643,43,Home,L 91-94 ,240,32,79,0.405,28,70,0.4,4,9,0.444,23,30,0.767,91,37,73,0.507,32,58,0.552,5,15,0.333,15,23,0.652,94,2012-03-11,DEN,MEM,2012,96.5
10644,10644,44,@,W 91-87 ,240,32,78,0.41,23,54,0.426,9,24,0.375,18,23,0.783,91,39,85,0.459,35,69,0.507,4,16,0.25,5,12,0.417,87,2012-03-15,PHO,LAC,2012,89.0
10645,10645,45,@,L 91-98 ,240,36,76,0.474,33,61,0.541,3,15,0.2,16,17,0.941,91,34,74,0.459,27,54,0.5,7,20,0.35,23,31,0.742,98,2012-03-17,BOS,DEN,2012,101.5
10646,10646,46,@,L 91-95 ,240,35,72,0.486,29,52,0.558,6,20,0.3,15,18,0.833,91,35,86,0.407,29,63,0.46,6,23,0.261,19,27,0.704,95,2012-03-17,HOU,LAC,2012,98.0
10647,10647,47,Home,W 91-81 ,240,34,74,0.459,32,66,0.485,2,8,0.25,21,27,0.778,91,30,76,0.395,21,51,0.412,9,25,0.36,12,21,0.571,81,2012-03-18,MIA,ORL,2012,85.5
10648,10648,48,@,L 91-114 ,240,29,79,0.367,17,53,0.321,12,26,0.462,21,27,0.778,91,42,78,0.538,33,56,0.589,9,22,0.409,21,22,0.955,114,2012-03-21,LAC,OKC,2012,118.5
10649,10649,49,Home,L 91-100 ,240,36,90,0.4,33,75,0.44,3,15,0.2,16,20,0.8,91,43,89,0.483,36,72,0.5,7,17,0.412,7,10,0.7,100,2012-03-22,MIL,BOS,2012,103.5
10650,10650,50,Home,L 91-108 ,240,35,74,0.473,22,54,0.407,13,20,0.65,8,11,0.727,91,44,88,0.5,36,72,0.5,8,16,0.5,12,16,0.75,108,2012-03-26,CHI,DEN,2012,112.0
10651,10651,51,Home,W 91-75 ,240,30,76,0.395,21,48,0.438,9,28,0.321,22,32,0.688,91,28,72,0.389,26,59,0.441,2,13,0.154,17,27,0.63,75,2012-03-31,NYK,CLE,2012,76.0
10652,10652,52,Home,W 91-72 ,240,33,70,0.471,28,57,0.491,5,13,0.385,20,22,0.909,91,31,89,0.348,28,73,0.384,3,16,0.188,7,17,0.412,72,2012-04-01,BOS,MIA,2012,73.5
10653,10653,53,Home,W 91-87 ,240,39,81,0.481,32,59,0.542,7,22,0.318,6,6,1.0,91,34,85,0.4,28,67,0.418,6,18,0.333,13,15,0.867,87,2012-04-03,LAL,NJN,2012,90.0
10654,10654,54,Home,W 91-75 ,240,30,72,0.417,20,49,0.408,10,23,0.435,21,26,0.808,91,29,78,0.372,23,62,0.371,6,16,0.375,11,16,0.688,75,2012-04-08,OKC,TOR,2012,78.0
10655,10655,55,Home,L 91-93 ,240,36,80,0.45,27,65,0.415,9,15,0.6,10,10,1.0,91,34,73,0.466,29,63,0.46,5,10,0.5,20,26,0.769,93,2012-04-09,NOP,LAL,2012,95.5
10656,10656,56,Home,W 91-84 ,240,31,73,0.425,27,59,0.458,4,14,0.286,25,33,0.758,91,35,87,0.402,28,63,0.444,7,24,0.292,7,10,0.7,84,2012-04-09,UTA,SAS,2012,87.5
10657,10657,57,Home,L 91-103 ,240,31,87,0.356,27,67,0.403,4,20,0.2,25,29,0.862,91,40,78,0.513,34,64,0.531,6,14,0.429,17,22,0.773,103,2012-04-11,HOU,UTA,2012,106.0
10658,10658,58,@,L 91-105 ,240,38,96,0.396,36,80,0.45,2,16,0.125,13,18,0.722,91,40,76,0.526,31,58,0.534,9,18,0.5,16,19,0.842,105,2012-04-14,PHO,SAS,2012,109.5
10659,10659,59,Home,L 91-112 ,240,39,80,0.488,37,70,0.529,2,10,0.2,11,11,1.0,91,50,84,0.595,43,66,0.652,7,18,0.389,5,11,0.455,112,2012-04-17,LAL,SAS,2012,115.5
10660,10660,60,@,W 91-84 ,240,40,91,0.44,35,78,0.449,5,13,0.385,6,11,0.545,91,26,73,0.356,19,51,0.373,7,22,0.318,25,30,0.833,84,2012-04-17,MEM,MIN,2012,87.5
10661,10661,61,@,L 91-103 ,240,29,60,0.483,27,53,0.509,2,7,0.286,31,38,0.816,91,42,83,0.506,34,61,0.557,8,22,0.364,11,13,0.846,103,2012-04-18,NOP,MEM,2012,107.0
10662,10662,62,Home,L 91-112 ,240,31,79,0.392,25,59,0.424,6,20,0.3,23,29,0.793,91,38,80,0.475,28,63,0.444,10,17,0.588,26,32,0.813,112,2012-04-18,POR,UTA,2012,117.0
10663,10663,63,@,W 91-80 ,240,34,73,0.466,31,58,0.534,3,15,0.2,20,28,0.714,91,33,91,0.363,26,72,0.361,7,19,0.368,7,9,0.778,80,2012-04-19,MIN,DET,2012,83.5
10664,10664,64,Home,L 91-99 ,240,38,77,0.494,35,64,0.547,3,13,0.231,12,31,0.387,91,40,85,0.471,35,70,0.5,5,15,0.333,14,18,0.778,99,2012-10-30,LAL,DAL,2013,101.5
10665,10665,65,@,L 91-114 ,240,36,93,0.387,31,71,0.437,5,22,0.227,14,18,0.778,91,48,78,0.615,38,58,0.655,10,20,0.5,8,13,0.615,114,2012-11-05,POR,DAL,2013,119.0
10666,10666,66,Home,L 91-97 ,240,35,84,0.417,30,69,0.435,5,15,0.333,16,18,0.889,91,36,73,0.493,31,60,0.517,5,13,0.385,20,21,0.952,97,2012-11-08,CHI,OKC,2013,99.5
10667,10667,67,Home,L 91-101 ,240,34,78,0.436,30,60,0.5,4,18,0.222,19,22,0.864,91,40,78,0.513,34,63,0.54,6,15,0.4,15,19,0.789,101,2012-11-09,WAS,MIL,2013,104.0
10668,10668,68,@,L 91-106 ,240,34,83,0.41,27,60,0.45,7,23,0.304,16,23,0.696,91,40,73,0.548,33,58,0.569,7,15,0.467,19,22,0.864,106,2012-11-11,CLE,OKC,2013,109.5
10669,10669,69,@,L 91-102 ,240,30,86,0.349,23,65,0.354,7,21,0.333,24,31,0.774,91,37,92,0.402,28,71,0.394,9,21,0.429,19,23,0.826,102,2012-11-19,HOU,UTA,2013,106.5
10670,10670,70,Home,L 91-101 ,240,31,83,0.373,23,61,0.377,8,22,0.364,21,26,0.808,91,42,78,0.538,31,56,0.554,11,22,0.5,6,14,0.429,101,2012-11-23,CHA,ATL,2013,106.5
10671,10671,71,@,L 91-102 ,240,35,80,0.438,28,63,0.444,7,17,0.412,14,18,0.778,91,40,84,0.476,35,65,0.538,5,19,0.263,17,30,0.567,102,2012-11-23,GSW,DEN,2013,104.5
10672,10672,72,Home,W 91-90 ,240,36,78,0.462,32,65,0.492,4,13,0.308,15,26,0.577,91,32,78,0.41,26,60,0.433,6,18,0.333,20,25,0.8,90,2012-11-23,DET,TOR,2013,93.0
10673,10673,73,@,W 91-78 ,240,37,79,0.468,31,62,0.5,6,17,0.353,11,18,0.611,91,30,84,0.357,28,69,0.406,2,15,0.133,16,22,0.727,78,2012-11-27,PHO,CLE,2013,79.0
10674,10674,74,@,L 91-94 ,240,30,76,0.395,18,52,0.346,12,24,0.5,19,23,0.826,91,36,90,0.4,24,58,0.414,12,32,0.375,10,15,0.667,94,2012-11-28,CHA,ATL,2013,100.0
10675,10675,75,Home,W 91-88 ,240,36,79,0.456,32,66,0.485,4,13,0.308,15,20,0.75,91,34,82,0.415,28,63,0.444,6,19,0.316,14,17,0.824,88,2012-12-01,MIL,BOS,2013,91.0
10676,10676,76,Home,W 91-73 ,240,30,70,0.429,26,51,0.51,4,19,0.211,27,35,0.771,91,30,87,0.345,23,63,0.365,7,24,0.292,6,9,0.667,73,2012-12-07,MIN,CLE,2013,76.5
10677,10677,77,Home,W 91-82 ,240,32,79,0.405,28,58,0.483,4,21,0.19,23,28,0.821,91,30,80,0.375,26,65,0.4,4,15,0.267,18,21,0.857,82,2012-12-07,SAC,ORL,2013,84.0
10678,10678,78,@,L 91-103 ,240,36,88,0.409,31,70,0.443,5,18,0.278,14,21,0.667,91,37,62,0.597,28,45,0.622,9,17,0.529,20,27,0.741,103,2012-12-19,CLE,BOS,2013,107.5
10679,10679,79,@,L 91-97 ,240,35,84,0.417,32,72,0.444,3,12,0.25,18,30,0.6,91,35,72,0.486,25,43,0.581,10,29,0.345,17,22,0.773,97,2012-12-19,DET,TOR,2013,102.0
10680,10680,80,@,L 91-94 ,240,34,84,0.405,27,62,0.435,7,22,0.318,16,18,0.889,91,32,72,0.444,26,46,0.565,6,26,0.231,24,28,0.857,94,2012-12-23,MIN,NYK,2013,97.0
10681,10681,81,@,L 91-129 ,240,34,74,0.459,29,60,0.483,5,14,0.357,18,29,0.621,91,47,84,0.56,27,54,0.5,20,30,0.667,15,19,0.789,129,2012-12-23,DAL,SAS,2013,139.0
10682,10682,82,@,L 91-109 ,240,35,86,0.407,26,62,0.419,9,24,0.375,12,16,0.75,91,44,87,0.506,38,66,0.576,6,21,0.286,15,20,0.75,109,2012-12-26,SAC,POR,2013,112.0
10683,10683,83,@,L 91-97 ,240,38,82,0.463,36,68,0.529,2,14,0.143,13,16,0.813,91,34,77,0.442,26,61,0.426,8,16,0.5,21,29,0.724,97,2012-12-28,PHO,IND,2013,101.0
10684,10684,84,@,W 91-81 ,240,33,70,0.471,29,60,0.483,4,10,0.4,21,38,0.553,91,33,94,0.351,29,78,0.372,4,16,0.25,11,18,0.611,81,2012-12-31,CHA,CHI,2013,83.0
10685,10685,85,@,L 91-110 ,240,28,78,0.359,19,53,0.358,9,25,0.36,26,35,0.743,91,39,76,0.513,35,65,0.538,4,11,0.364,28,39,0.718,110,2013-01-05,UTA,DEN,2013,112.0
10686,10686,86,@,L 91-103 ,240,35,80,0.438,26,47,0.553,9,33,0.273,12,29,0.414,91,41,79,0.519,32,56,0.571,9,23,0.391,12,16,0.75,103,2013-01-11,HOU,BOS,2013,107.5
10687,10687,87,@,L 91-98 ,240,37,85,0.435,32,61,0.525,5,24,0.208,12,16,0.75,91,36,82,0.439,32,66,0.485,4,16,0.25,22,31,0.71,98,2013-01-11,CLE,DEN,2013,100.0
10688,10688,88,@,L 91-120 ,240,37,87,0.425,32,69,0.464,5,18,0.278,12,15,0.8,91,46,82,0.561,39,71,0.549,7,11,0.636,21,25,0.84,120,2013-01-14,ORL,WAS,2013,123.5
10689,10689,89,@,W 91-83 ,240,37,84,0.44,31,64,0.484,6,20,0.3,11,16,0.688,91,38,83,0.458,35,68,0.515,3,15,0.2,4,6,0.667,83,2013-01-23,BRK,MIN,2013,84.5
10690,10690,90,@,W 91-83 ,240,33,77,0.429,24,57,0.421,9,20,0.45,16,23,0.696,91,32,88,0.364,29,72,0.403,3,16,0.188,16,18,0.889,83,2013-01-27,NOP,MEM,2013,84.5
10691,10691,91,@,L 91-112 ,240,36,87,0.414,33,71,0.465,3,16,0.188,16,20,0.8,91,41,87,0.471,31,62,0.5,10,25,0.4,20,27,0.741,112,2013-02-04,DAL,OKC,2013,117.0
10692,10692,92,@,L 91-98 (OT),265,35,87,0.402,32,67,0.478,3,20,0.15,18,25,0.72,91,38,72,0.528,31,60,0.517,7,12,0.583,15,18,0.833,98,2013-02-04,SAC,UTA,2013,101.5
10693,10693,93,@,L 91-116 ,240,34,89,0.382,28,73,0.384,6,16,0.375,17,24,0.708,91,38,77,0.494,27,57,0.474,11,20,0.55,29,38,0.763,116,2013-02-09,GSW,DAL,2013,121.5
10694,10694,94,@,L 91-94 ,240,32,77,0.416,26,63,0.413,6,14,0.429,21,26,0.808,91,33,77,0.429,25,59,0.424,8,18,0.444,20,30,0.667,94,2013-02-11,BOS,CHA,2013,98.0
10695,10695,95,Home,W 91-85 ,240,36,83,0.434,29,62,0.468,7,21,0.333,12,18,0.667,91,35,85,0.412,32,72,0.444,3,13,0.231,12,17,0.706,85,2013-02-12,LAL,PHO,2013,86.5
10696,10696,96,Home,L 91-105 ,240,38,82,0.463,29,62,0.468,9,20,0.45,6,10,0.6,91,45,80,0.563,42,71,0.592,3,9,0.333,12,20,0.6,105,2013-02-19,DET,MEM,2013,106.5
10697,10697,97,@,L 91-125 ,240,29,86,0.337,24,58,0.414,5,28,0.179,28,36,0.778,91,42,79,0.532,31,55,0.564,11,24,0.458,30,39,0.769,125,2013-02-20,NYK,IND,2013,130.5
10698,10698,98,Home,L 91-102 ,240,37,83,0.446,33,68,0.485,4,15,0.267,13,23,0.565,91,38,78,0.487,33,61,0.541,5,17,0.294,21,26,0.808,102,2013-02-27,UTA,ATL,2013,104.5
10699,10699,99,Home,L 91-99 ,240,32,75,0.427,23,50,0.46,9,25,0.36,18,25,0.72,91,39,80,0.488,35,57,0.614,4,23,0.174,17,21,0.81,99,2013-02-28,IND,LAC,2013,101.0
10700,10700,0,@,L 91-98 ,240,33,77,0.429,29,64,0.453,4,13,0.308,21,27,0.778,91,34,73,0.466,24,54,0.444,10,19,0.526,20,27,0.741,98,2013-03-01,MEM,MIA,2013,103.0
10701,10701,1,Home,W 91-85 ,240,38,87,0.437,34,75,0.453,4,12,0.333,11,18,0.611,91,31,76,0.408,25,56,0.446,6,20,0.3,17,28,0.607,85,2013-03-06,MEM,POR,2013,88.0
10702,10702,2,@,L 91-105 ,240,26,63,0.413,16,36,0.444,10,27,0.37,29,34,0.853,91,38,68,0.559,31,54,0.574,7,14,0.5,22,31,0.71,105,2013-03-10,IND,MIA,2013,108.5
10703,10703,3,Home,W 91-79 ,240,30,68,0.441,26,52,0.5,4,16,0.25,27,33,0.818,91,29,77,0.377,22,57,0.386,7,20,0.35,14,20,0.7,79,2013-03-10,OKC,BOS,2013,82.5
10704,10704,4,@,L 91-99 ,240,40,86,0.465,35,74,0.473,5,12,0.417,6,10,0.6,91,41,83,0.494,29,56,0.518,12,27,0.444,5,7,0.714,99,2013-03-10,PHI,ORL,2013,105.0
10705,10705,5,@,L 91-107 ,240,35,80,0.438,29,61,0.475,6,19,0.316,15,18,0.833,91,41,82,0.5,32,57,0.561,9,25,0.36,16,26,0.615,107,2013-03-13,MIN,IND,2013,111.5
10706,10706,6,@,L 91-92 ,240,37,83,0.446,29,64,0.453,8,19,0.421,9,10,0.9,91,37,84,0.44,32,71,0.451,5,13,0.385,13,17,0.765,92,2013-03-14,DAL,SAS,2013,94.5
10707,10707,7,@,L 91-98 ,240,34,88,0.386,28,72,0.389,6,16,0.375,17,21,0.81,91,39,79,0.494,33,66,0.5,6,13,0.462,14,19,0.737,98,2013-03-16,IND,PHI,2013,101.0
10708,10708,8,Home,L 91-108 ,240,39,94,0.415,37,74,0.5,2,20,0.1,11,12,0.917,91,39,67,0.582,29,45,0.644,10,22,0.455,20,29,0.69,108,2013-03-17,TOR,MIA,2013,113.0
10709,10709,9,Home,L 91-92 ,240,32,75,0.427,28,58,0.483,4,17,0.235,23,25,0.92,91,36,79,0.456,26,53,0.491,10,26,0.385,10,14,0.714,92,2013-03-23,CHA,DET,2013,97.0
10710,10710,10,@,L 91-107 ,240,32,83,0.386,28,69,0.406,4,14,0.286,23,28,0.821,91,41,84,0.488,34,70,0.486,7,14,0.5,18,21,0.857,107,2013-03-25,PHI,UTA,2013,110.5
10711,10711,11,Home,L 91-100 ,240,32,83,0.386,26,62,0.419,6,21,0.286,21,26,0.808,91,35,78,0.449,29,60,0.483,6,18,0.333,24,28,0.857,100,2013-03-27,HOU,IND,2013,103.0
10712,10712,12,Home,L 91-105 ,240,35,71,0.493,31,57,0.544,4,14,0.286,17,24,0.708,91,34,73,0.466,21,44,0.477,13,29,0.448,24,28,0.857,105,2013-03-27,NOP,LAC,2013,111.5
10713,10713,13,Home,L 91-97 ,240,36,89,0.404,30,67,0.448,6,22,0.273,13,22,0.591,91,36,89,0.404,33,76,0.434,3,13,0.231,22,26,0.846,97,2013-04-05,BOS,CLE,2013,98.5
10714,10714,14,Home,W 91-85 ,240,32,89,0.36,25,72,0.347,7,17,0.412,20,24,0.833,91,34,90,0.378,33,77,0.429,1,13,0.077,16,22,0.727,85,2013-04-07,CLE,ORL,2013,85.5
10715,10715,15,Home,L 91-96 ,240,37,80,0.463,33,58,0.569,4,22,0.182,13,16,0.813,91,42,90,0.467,39,77,0.506,3,13,0.231,9,12,0.75,96,2013-04-07,POR,DAL,2013,97.5
10716,10716,16,Home,L 91-102 ,240,34,85,0.4,28,68,0.412,6,17,0.353,17,21,0.81,91,37,89,0.416,25,62,0.403,12,27,0.444,16,17,0.941,102,2013-04-10,DAL,PHO,2013,108.0
10717,10717,17,Home,L 91-101 ,240,34,79,0.43,28,57,0.491,6,22,0.273,17,24,0.708,91,40,79,0.506,30,51,0.588,10,28,0.357,11,17,0.647,101,2013-04-12,CLE,NYK,2013,106.0
10718,10718,18,@,W 91-87 ,240,37,80,0.463,31,64,0.484,6,16,0.375,11,18,0.611,91,34,83,0.41,28,70,0.4,6,13,0.462,13,20,0.65,87,2013-04-13,LAC,MEM,2013,90.0
10719,10719,19,Home,W 91-86 ,240,31,85,0.365,22,58,0.379,9,27,0.333,20,31,0.645,91,33,89,0.371,27,71,0.38,6,18,0.333,14,19,0.737,86,2013-04-14,LAL,SAS,2013,89.0
10720,10720,20,Home,W 91-77 ,240,38,86,0.442,30,65,0.462,8,21,0.381,7,11,0.636,91,31,85,0.365,26,69,0.377,5,16,0.313,10,15,0.667,77,2013-04-14,PHI,CLE,2013,79.5
10721,10721,21,@,L 91-104 ,240,33,81,0.407,25,55,0.455,8,26,0.308,17,24,0.708,91,43,83,0.518,39,64,0.609,4,19,0.211,14,18,0.778,104,2013-10-30,POR,PHO,2014,106.0
10722,10722,22,@,W 91-85 ,240,38,94,0.404,33,73,0.452,5,21,0.238,10,14,0.714,91,30,82,0.366,22,55,0.4,8,27,0.296,17,24,0.708,85,2013-11-01,SAS,LAL,2014,89.0
10723,10723,23,Home,L 91-99 ,240,33,87,0.379,28,62,0.452,5,25,0.2,20,25,0.8,91,38,73,0.521,29,52,0.558,9,21,0.429,14,23,0.609,99,2013-11-05,DET,IND,2014,103.5
10724,10724,24,Home,L 91-101 ,240,31,76,0.408,27,60,0.45,4,16,0.25,25,30,0.833,91,42,90,0.467,30,64,0.469,12,26,0.462,5,9,0.556,101,2013-11-08,CHA,NYK,2014,107.0
10725,10725,25,Home,W 91-84 ,240,36,78,0.462,30,57,0.526,6,21,0.286,13,16,0.813,91,32,81,0.395,26,63,0.413,6,18,0.333,14,16,0.875,84,2013-11-08,IND,TOR,2014,87.0
10726,10726,26,@,W 91-89 ,240,34,95,0.358,32,81,0.395,2,14,0.143,21,26,0.808,91,33,83,0.398,29,63,0.46,4,20,0.2,19,29,0.655,89,2013-11-08,BOS,ORL,2014,91.0
10727,10727,27,@,L 91-104 ,240,36,86,0.419,30,64,0.469,6,22,0.273,13,15,0.867,91,39,80,0.488,29,57,0.509,10,23,0.435,16,18,0.889,104,2013-11-08,SAC,POR,2014,109.0
10728,10728,28,Home,L 91-96 ,240,35,76,0.461,27,57,0.474,8,19,0.421,13,16,0.813,91,37,80,0.463,30,66,0.455,7,14,0.5,15,20,0.75,96,2013-11-09,BRK,IND,2014,99.5
10729,10729,29,@,W 91-83 ,240,33,78,0.423,27,59,0.458,6,19,0.316,19,21,0.905,91,31,81,0.383,20,58,0.345,11,23,0.478,10,16,0.625,83,2013-11-09,DAL,MIL,2014,88.5
10730,10730,30,@,L 91-115 ,240,34,77,0.442,31,59,0.525,3,18,0.167,20,24,0.833,91,40,83,0.482,30,58,0.517,10,25,0.4,25,29,0.862,115,2013-11-09,UTA,TOR,2014,120.0
10731,10731,31,Home,L 91-95 ,240,35,77,0.455,30,53,0.566,5,24,0.208,16,21,0.762,91,37,88,0.42,25,54,0.463,12,34,0.353,9,13,0.692,95,2013-11-13,ATL,NYK,2014,101.0
10732,10732,32,@,L 91-94 ,240,33,74,0.446,28,61,0.459,5,13,0.385,20,22,0.909,91,35,82,0.427,26,56,0.464,9,26,0.346,15,21,0.714,94,2013-11-13,MIL,ORL,2014,98.5
10733,10733,33,@,W 91-82 ,240,35,76,0.461,31,61,0.508,4,15,0.267,17,22,0.773,91,35,91,0.385,30,75,0.4,5,16,0.313,7,11,0.636,82,2013-11-15,SAS,UTA,2014,84.5
10734,10734,34,@,L 91-95 ,240,32,67,0.478,23,48,0.479,9,19,0.474,18,25,0.72,91,36,81,0.444,31,68,0.456,5,13,0.385,18,30,0.6,95,2013-11-20,BRK,CHA,2014,97.5
10735,10735,35,Home,L 91-98 ,240,32,77,0.416,23,54,0.426,9,23,0.391,18,21,0.857,91,38,84,0.452,30,65,0.462,8,19,0.421,14,14,1.0,98,2013-11-20,CLE,WAS,2014,102.0
10736,10736,36,@,W 91-82 ,240,35,86,0.407,24,55,0.436,11,31,0.355,10,15,0.667,91,35,80,0.438,30,66,0.455,5,14,0.357,7,12,0.583,82,2013-11-20,POR,MIL,2014,84.5
10737,10737,37,@,L 91-105 ,240,38,92,0.413,30,64,0.469,8,28,0.286,7,15,0.467,91,41,79,0.519,37,60,0.617,4,19,0.211,19,29,0.655,105,2013-11-21,LAC,OKC,2014,107.0
10738,10738,38,Home,L 91-98 ,240,32,77,0.416,29,63,0.46,3,14,0.214,24,33,0.727,91,33,70,0.471,23,47,0.489,10,23,0.435,22,38,0.579,98,2013-11-22,CHA,PHO,2014,103.0
10739,10739,39,@,L 91-102 ,240,38,85,0.447,32,70,0.457,6,15,0.4,9,14,0.643,91,37,84,0.44,28,59,0.475,9,25,0.36,19,22,0.864,102,2013-11-25,NYK,POR,2014,106.5
10740,10740,40,Home,L 91-109 ,240,34,78,0.436,25,59,0.424,9,19,0.474,14,15,0.933,91,42,76,0.553,34,59,0.576,8,17,0.471,17,17,1.0,109,2013-11-29,ORL,SAS,2014,113.0
10741,10741,41,@,L 91-110 ,240,37,87,0.425,30,58,0.517,7,29,0.241,10,15,0.667,91,46,84,0.548,41,70,0.586,5,14,0.357,13,21,0.619,110,2013-12-03,PHO,MEM,2014,112.5
10742,10742,42,@,W 91-90 ,240,34,81,0.42,27,57,0.474,7,24,0.292,16,19,0.842,91,33,74,0.446,29,64,0.453,4,10,0.4,20,25,0.8,90,2013-12-13,CHI,MIL,2014,92.0
10743,10743,43,@,L 91-106 ,240,31,75,0.413,24,48,0.5,7,27,0.259,22,38,0.579,91,39,81,0.481,36,68,0.529,3,13,0.231,25,30,0.833,106,2013-12-15,HOU,SAC,2014,107.5
10744,10744,44,@,L 91-105 ,240,37,93,0.398,29,75,0.387,8,18,0.444,9,14,0.643,91,40,73,0.548,35,58,0.603,5,15,0.333,20,23,0.87,105,2013-12-18,MEM,DAL,2014,107.5
10745,10745,45,@,L 91-104 ,240,33,95,0.347,28,73,0.384,5,22,0.227,20,25,0.8,91,42,78,0.538,35,59,0.593,7,19,0.368,13,15,0.867,104,2013-12-20,MIN,LAL,2014,107.5
10746,10746,46,@,L 91-112 ,240,31,88,0.352,25,58,0.431,6,30,0.2,23,29,0.793,91,39,86,0.453,26,53,0.491,13,33,0.394,21,31,0.677,112,2013-12-21,DEN,LAC,2014,118.5
10747,10747,47,@,L 91-105 ,240,36,77,0.468,28,56,0.5,8,21,0.381,11,16,0.688,91,38,71,0.535,30,52,0.577,8,19,0.421,21,25,0.84,105,2013-12-28,BRK,IND,2014,109.0
10748,10748,48,Home,L 91-95 ,240,35,78,0.449,35,73,0.479,0,5,0.0,21,28,0.75,91,28,65,0.431,22,50,0.44,6,15,0.4,33,42,0.786,95,2013-12-30,MEM,CHI,2014,98.0
10749,10749,49,Home,L 91-92 ,240,35,84,0.417,30,64,0.469,5,20,0.25,16,17,0.941,91,33,91,0.363,28,62,0.452,5,29,0.172,21,25,0.84,92,2013-12-31,BOS,ATL,2014,94.5
10750,10750,50,Home,W 91-76 ,240,34,77,0.442,29,52,0.558,5,25,0.2,18,22,0.818,91,29,80,0.363,28,68,0.412,1,12,0.083,17,23,0.739,76,2013-12-31,IND,CLE,2014,76.5
10751,10751,51,Home,L 91-99 ,240,37,90,0.411,29,60,0.483,8,30,0.267,9,16,0.563,91,44,92,0.478,41,78,0.526,3,14,0.214,8,14,0.571,99,2014-01-02,PHO,MEM,2014,100.5
10752,10752,52,Home,W 91-84 ,240,33,81,0.407,27,64,0.422,6,17,0.353,19,24,0.792,91,32,86,0.372,24,58,0.414,8,28,0.286,12,14,0.857,84,2014-01-04,CHI,ATL,2014,88.0
10753,10753,53,Home,W 91-86 ,240,33,80,0.413,25,53,0.472,8,27,0.296,17,26,0.654,91,27,70,0.386,19,46,0.413,8,24,0.333,24,26,0.923,86,2014-01-06,BRK,ATL,2014,90.0
10754,10754,54,@,L 91-112 ,240,34,86,0.395,30,70,0.429,4,16,0.25,19,35,0.543,91,35,86,0.407,24,55,0.436,11,31,0.355,31,34,0.912,112,2014-01-08,DET,TOR,2014,117.5
10755,10755,55,Home,W 91-90 ,240,36,78,0.462,30,61,0.492,6,17,0.353,13,18,0.722,91,33,81,0.407,28,70,0.4,5,11,0.455,19,23,0.826,90,2014-01-17,MEM,SAC,2014,92.5
10756,10756,56,@,L 91-93 ,240,33,90,0.367,30,77,0.39,3,13,0.231,22,24,0.917,91,30,71,0.423,26,56,0.464,4,15,0.267,29,36,0.806,93,2014-01-19,BOS,ORL,2014,95.0
10757,10757,57,@,L 91-95 ,240,39,90,0.433,33,64,0.516,6,26,0.231,7,9,0.778,91,39,84,0.464,34,69,0.493,5,15,0.333,12,20,0.6,95,2014-01-22,LAC,CHA,2014,97.5
10758,10758,58,Home,L 91-103 ,240,34,90,0.378,30,63,0.476,4,27,0.148,19,27,0.704,91,40,76,0.526,36,55,0.655,4,21,0.19,19,25,0.76,103,2014-01-25,PHI,OKC,2014,105.0
10759,10759,59,Home,L 91-106 ,240,33,67,0.493,22,41,0.537,11,26,0.423,14,23,0.609,91,41,76,0.539,33,53,0.623,8,23,0.348,16,24,0.667,106,2014-02-01,NYK,MIA,2014,110.0
10760,10760,60,@,W 91-75 ,240,37,78,0.474,32,65,0.492,5,13,0.385,12,19,0.632,91,29,93,0.312,25,73,0.342,4,20,0.2,13,16,0.813,75,2014-02-04,CHA,GSW,2014,77.0
10761,10761,61,@,L 91-98 ,240,28,75,0.373,24,57,0.421,4,18,0.222,31,37,0.838,91,39,81,0.481,31,66,0.47,8,15,0.533,12,16,0.75,98,2014-02-07,MIN,NOP,2014,102.0
10762,10762,62,Home,L 91-102 ,240,33,92,0.359,22,65,0.338,11,27,0.407,14,15,0.933,91,37,82,0.451,27,59,0.458,10,23,0.435,18,20,0.9,102,2014-02-09,BOS,DAL,2014,107.0
10763,10763,63,Home,W 91-83 (OT),265,35,88,0.398,25,68,0.368,10,20,0.5,11,18,0.611,91,33,86,0.384,30,72,0.417,3,14,0.214,14,16,0.875,83,2014-02-09,CLE,MEM,2014,84.5
10764,10764,64,@,L 91-104 ,240,35,87,0.402,29,65,0.446,6,22,0.273,15,20,0.75,91,40,83,0.482,34,63,0.54,6,20,0.3,18,31,0.581,104,2014-02-19,IND,MIN,2014,107.0
10765,10765,65,Home,L 91-98 ,240,35,75,0.467,28,54,0.519,7,21,0.333,14,21,0.667,91,37,83,0.446,27,62,0.435,10,21,0.476,14,20,0.7,98,2014-02-19,NOP,NYK,2014,103.0
10766,10766,66,@,L 91-98 ,240,32,82,0.39,26,62,0.419,6,20,0.3,21,29,0.724,91,40,93,0.43,33,72,0.458,7,21,0.333,11,13,0.846,98,2014-02-21,CLE,TOR,2014,101.5
10767,10767,67,Home,L 91-100 ,240,34,85,0.4,23,54,0.426,11,31,0.355,12,17,0.706,91,36,71,0.507,27,52,0.519,9,19,0.474,19,28,0.679,100,2014-02-28,DAL,CHI,2014,104.5
10768,10768,68,@,L 91-94 ,240,36,78,0.462,30,64,0.469,6,14,0.429,13,18,0.722,91,34,82,0.415,29,67,0.433,5,15,0.333,21,28,0.75,94,2014-03-02,UTA,IND,2014,96.5
10769,10769,69,@,L 91-104 ,240,35,78,0.449,27,55,0.491,8,23,0.348,13,22,0.591,91,44,81,0.543,38,66,0.576,6,15,0.4,10,10,1.0,104,2014-03-05,UTA,WAS,2014,107.0
10770,10770,70,Home,W 91-84 ,240,31,70,0.443,23,49,0.469,8,21,0.381,21,26,0.808,91,29,80,0.363,25,50,0.5,4,30,0.133,22,26,0.846,84,2014-03-07,BOS,BRK,2014,86.0
10771,10771,71,Home,W 91-79 ,240,34,79,0.43,32,68,0.471,2,11,0.182,21,25,0.84,91,28,77,0.364,23,66,0.348,5,11,0.455,18,24,0.75,79,2014-03-21,IND,CHI,2014,81.5
10772,10772,72,Home,W 91-86 ,240,35,75,0.467,28,55,0.509,7,20,0.35,14,16,0.875,91,36,79,0.456,33,65,0.508,3,14,0.214,11,17,0.647,86,2014-03-21,MIA,MEM,2014,87.5
10773,10773,73,Home,W 91-81 ,240,31,70,0.443,26,56,0.464,5,14,0.357,24,31,0.774,91,30,87,0.345,29,67,0.433,1,20,0.05,20,22,0.909,81,2014-03-22,CHI,PHI,2014,81.5
10774,10774,74,@,L 91-93 ,240,28,74,0.378,17,35,0.486,11,39,0.282,24,27,0.889,91,37,84,0.44,32,69,0.464,5,15,0.333,14,23,0.609,93,2014-03-24,POR,MIA,2014,95.5
10775,10775,75,@,L 91-113 ,240,36,88,0.409,25,55,0.455,11,33,0.333,8,18,0.444,91,44,79,0.557,31,52,0.596,13,27,0.481,12,16,0.75,113,2014-03-24,PHI,SAS,2014,119.5
10776,10776,76,@,W 91-87 ,240,36,79,0.456,32,70,0.457,4,9,0.444,15,16,0.938,91,32,69,0.464,27,53,0.509,5,16,0.313,18,26,0.692,87,2014-03-26,MEM,UTA,2014,89.5
10777,10777,77,@,W 91-74 ,240,35,80,0.438,25,58,0.431,10,22,0.455,11,16,0.688,91,33,84,0.393,30,67,0.448,3,17,0.176,5,7,0.714,74,2014-03-28,POR,CHI,2014,75.5
10778,10778,78,Home,W 91-78 ,240,34,87,0.391,27,64,0.422,7,23,0.304,16,17,0.941,91,28,79,0.354,26,66,0.394,2,13,0.154,20,25,0.8,78,2014-03-28,WAS,IND,2014,79.0
10779,10779,79,Home,W 91-80 ,240,33,78,0.423,27,62,0.435,6,16,0.375,19,23,0.826,91,31,87,0.356,28,76,0.368,3,11,0.273,15,18,0.833,80,2014-04-04,CHA,ORL,2014,81.5
10780,10780,80,@,L 91-102 ,240,33,88,0.375,18,46,0.391,15,42,0.357,10,13,0.769,91,34,61,0.557,22,34,0.647,12,27,0.444,22,30,0.733,102,2014-04-06,NYK,MIA,2014,108.0
10781,10781,81,Home,L 91-93 ,240,36,76,0.474,31,58,0.534,5,18,0.278,14,20,0.7,91,36,89,0.404,23,58,0.397,13,31,0.419,8,14,0.571,93,2014-04-06,SAC,DAL,2014,99.5
10782,10782,82,@,L 91-110 ,240,36,81,0.444,32,64,0.5,4,17,0.235,15,25,0.6,91,42,91,0.462,37,76,0.487,5,15,0.333,21,26,0.808,110,2014-04-08,SAS,MIN,2014,112.5
10783,10783,83,@,L 91-104 ,240,32,68,0.471,27,60,0.45,5,8,0.625,22,34,0.647,91,40,84,0.476,32,62,0.516,8,22,0.364,16,19,0.842,104,2014-04-12,MIL,WAS,2014,108.0
10784,10784,84,Home,L 91-97 ,240,38,80,0.475,33,54,0.611,5,26,0.192,10,14,0.714,91,40,77,0.519,34,62,0.548,6,15,0.4,11,15,0.733,97,2014-04-14,PHO,MEM,2014,100.0
10785,10785,85,Home,W 91-86 (OT),265,34,85,0.4,29,64,0.453,5,21,0.238,18,26,0.692,91,34,86,0.395,26,64,0.406,8,22,0.364,10,15,0.667,86,2014-04-16,CHA,CHI,2014,90.0
10786,10786,86,@,L 91-103 ,240,34,89,0.382,28,68,0.412,6,21,0.286,17,30,0.567,91,38,81,0.469,30,56,0.536,8,25,0.32,19,28,0.679,103,2014-10-29,PHI,IND,2015,107.0
10787,10787,87,@,L 91-97 ,240,38,91,0.418,31,70,0.443,7,21,0.333,8,13,0.615,91,37,76,0.487,33,66,0.5,4,10,0.4,19,28,0.679,97,2014-10-30,DET,MIN,2015,99.0
10788,10788,88,@,L 91-102 ,240,35,80,0.438,28,54,0.519,7,26,0.269,14,20,0.7,91,37,80,0.463,31,60,0.517,6,20,0.3,22,31,0.71,102,2014-11-01,DEN,OKC,2015,105.0
10789,10789,89,@,L 91-118 ,240,36,87,0.414,29,56,0.518,7,31,0.226,12,15,0.8,91,42,88,0.477,35,62,0.565,7,26,0.269,27,33,0.818,118,2014-11-01,PHO,UTA,2015,121.5
10790,10790,90,Home,L 91-108 ,240,31,74,0.419,19,46,0.413,12,28,0.429,17,27,0.63,91,35,68,0.515,18,31,0.581,17,37,0.459,21,27,0.778,108,2014-11-04,MIA,HOU,2015,116.5
10791,10791,91,@,L 91-100 ,240,37,80,0.463,31,59,0.525,6,21,0.286,11,13,0.846,91,38,81,0.469,33,63,0.524,5,18,0.278,19,19,1.0,100,2014-11-04,CHA,NOP,2015,102.5
10792,10792,92,Home,L 91-98 ,240,36,82,0.439,28,61,0.459,8,21,0.381,11,17,0.647,91,37,90,0.411,30,73,0.411,7,17,0.412,17,22,0.773,98,2014-11-05,BRK,MIN,2015,101.5
10793,10793,93,@,W 91-89 ,240,39,88,0.443,36,68,0.529,3,20,0.15,10,12,0.833,91,33,77,0.429,25,52,0.481,8,25,0.32,15,23,0.652,89,2014-11-05,ORL,PHI,2015,93.0
10794,10794,94,Home,L 91-102 ,240,32,69,0.464,24,48,0.5,8,21,0.381,19,21,0.905,91,40,80,0.5,31,63,0.492,9,17,0.529,13,17,0.765,102,2014-11-05,PHO,MEM,2015,106.5
10795,10795,95,@,W 91-89 ,240,34,81,0.42,25,63,0.397,9,18,0.5,14,17,0.824,91,37,79,0.468,25,54,0.463,12,25,0.48,3,11,0.273,89,2014-11-07,MEM,OKC,2015,95.0
10796,10796,96,@,L 91-102 ,240,34,80,0.425,27,66,0.409,7,14,0.5,16,25,0.64,91,39,88,0.443,32,68,0.471,7,20,0.35,17,20,0.85,102,2014-11-10,DET,CHI,2015,105.5
10797,10797,97,@,W 91-85 ,240,27,71,0.38,17,44,0.386,10,27,0.37,27,28,0.964,91,36,83,0.434,30,57,0.526,6,26,0.231,7,12,0.583,85,2014-11-10,ATL,NYK,2015,88.0
10798,10798,98,@,L 91-139 ,240,29,72,0.403,26,58,0.448,3,14,0.214,30,41,0.732,91,56,84,0.667,41,64,0.641,15,20,0.75,12,16,0.75,139,2014-11-14,MIN,NOP,2015,146.5
10799,10799,99,@,L 91-94 ,240,34,80,0.425,27,56,0.482,7,24,0.292,16,18,0.889,91,37,86,0.43,37,74,0.5,0,12,0.0,20,24,0.833,94,2014-11-15,SAS,SAC,2015,94.0
10800,10800,0,@,W 91-84 ,240,35,74,0.473,30,56,0.536,5,18,0.278,16,26,0.615,91,30,73,0.411,19,48,0.396,11,25,0.44,13,22,0.591,84,2014-11-16,MIL,MIA,2015,89.5
10801,10801,1,Home,W 91-78 ,240,41,84,0.488,37,74,0.5,4,10,0.4,5,9,0.556,91,27,75,0.36,21,48,0.438,6,27,0.222,18,23,0.783,78,2014-11-21,WAS,CLE,2015,81.0
10802,10802,2,Home,W 91-83 ,240,33,66,0.5,27,49,0.551,6,17,0.353,19,21,0.905,91,30,75,0.4,22,49,0.449,8,26,0.308,15,25,0.6,83,2014-11-22,NYK,PHI,2015,87.0
10803,10803,3,@,L 91-107 ,240,32,77,0.416,25,52,0.481,7,25,0.28,20,28,0.714,91,42,85,0.494,35,64,0.547,7,21,0.333,16,23,0.696,107,2014-11-23,LAC,MEM,2015,110.5
10804,10804,4,@,W 91-86 ,240,33,93,0.355,26,68,0.382,7,25,0.28,18,24,0.75,91,32,90,0.356,29,73,0.397,3,17,0.176,19,27,0.704,86,2014-11-23,GSW,OKC,2015,87.5
10805,10805,5,Home,W 91-86 ,240,32,76,0.421,18,40,0.45,14,36,0.389,13,19,0.684,91,35,76,0.461,29,54,0.537,6,22,0.273,10,15,0.667,86,2014-11-24,HOU,NYK,2015,89.0
10806,10806,6,Home,L 91-99 ,240,34,85,0.4,25,61,0.41,9,24,0.375,14,17,0.824,91,35,71,0.493,27,47,0.574,8,24,0.333,21,28,0.75,99,2014-11-26,PHI,BRK,2015,103.0
10807,10807,7,@,L 91-100 ,240,36,89,0.404,29,65,0.446,7,24,0.292,12,16,0.75,91,38,76,0.5,33,59,0.559,5,17,0.294,19,22,0.864,100,2014-11-28,NOP,ATL,2015,102.5
10808,10808,8,Home,L 91-103 ,240,32,84,0.381,24,56,0.429,8,28,0.286,19,30,0.633,91,35,71,0.493,26,48,0.542,9,23,0.391,24,31,0.774,103,2014-12-05,PHI,OKC,2015,107.5
10809,10809,9,Home,L 91-105 ,240,35,86,0.407,27,62,0.435,8,24,0.333,13,20,0.65,91,41,84,0.488,32,64,0.5,9,20,0.45,14,21,0.667,105,2014-12-05,TOR,CLE,2015,109.5
10810,10810,10,@,W 91-89 ,240,41,81,0.506,36,69,0.522,5,12,0.417,4,9,0.444,91,38,84,0.452,31,69,0.449,7,15,0.467,6,9,0.667,89,2014-12-10,WAS,ORL,2015,92.5
10811,10811,11,Home,L 91-99 ,240,34,83,0.41,26,67,0.388,8,16,0.5,15,21,0.714,91,34,74,0.459,29,58,0.5,5,16,0.313,26,35,0.743,99,2014-12-14,DEN,SAS,2015,101.5
10812,10812,12,@,L 91-110 ,240,29,88,0.33,19,62,0.306,10,26,0.385,23,29,0.793,91,40,83,0.482,33,66,0.5,7,17,0.412,23,27,0.852,110,2014-12-15,LAL,IND,2015,113.5
10813,10813,13,@,L 91-113 ,240,35,83,0.422,27,56,0.482,8,27,0.296,13,22,0.591,91,43,80,0.538,31,56,0.554,12,24,0.5,15,20,0.75,113,2014-12-15,DET,LAC,2015,119.0
10814,10814,14,Home,L 91-95 ,240,30,77,0.39,22,49,0.449,8,28,0.286,23,32,0.719,91,33,72,0.458,24,48,0.5,9,24,0.375,20,26,0.769,95,2014-12-16,BRK,MIA,2015,99.5
10815,10815,15,@,L 91-95 ,240,37,78,0.474,28,54,0.519,9,24,0.375,8,12,0.667,91,31,77,0.403,22,53,0.415,9,24,0.375,24,29,0.828,95,2014-12-19,BRK,CLE,2015,99.5
10816,10816,16,Home,L 91-109 ,240,32,71,0.451,20,45,0.444,12,26,0.462,15,17,0.882,91,43,98,0.439,33,74,0.446,10,24,0.417,13,17,0.765,109,2014-12-19,PHI,CHO,2015,114.0
10817,10817,17,@,L 91-105 ,240,39,86,0.453,38,70,0.543,1,16,0.063,12,15,0.8,91,46,76,0.605,39,62,0.629,7,14,0.5,6,10,0.6,105,2014-12-21,MEM,CLE,2015,108.5
10818,10818,18,Home,L 91-97 ,240,38,86,0.442,31,63,0.492,7,23,0.304,8,9,0.889,91,34,75,0.453,25,56,0.446,9,19,0.474,20,27,0.741,97,2014-12-22,MEM,UTA,2015,101.5
10819,10819,19,@,W 91-87 ,240,33,77,0.429,28,58,0.483,5,19,0.263,20,27,0.741,91,33,80,0.413,25,54,0.463,8,26,0.308,13,18,0.722,87,2014-12-23,PHI,MIA,2015,91.0
10820,10820,20,Home,L 91-99 ,240,38,89,0.427,33,80,0.413,5,9,0.556,10,16,0.625,91,39,85,0.459,34,68,0.5,5,17,0.294,16,24,0.667,99,2014-12-23,WAS,CHI,2015,101.5
10821,10821,21,@,L 91-101 ,240,32,72,0.444,26,46,0.565,6,26,0.231,21,33,0.636,91,40,84,0.476,33,63,0.524,7,21,0.333,14,17,0.824,101,2014-12-25,CLE,MIA,2015,104.5
10822,10822,22,Home,L 91-102 ,240,36,80,0.45,32,58,0.552,4,22,0.182,15,19,0.789,91,44,86,0.512,37,70,0.529,7,16,0.438,7,10,0.7,102,2014-12-25,NYK,WAS,2015,105.5
10823,10823,23,@,W 91-87 ,240,33,87,0.379,29,72,0.403,4,15,0.267,21,30,0.7,91,32,87,0.368,26,59,0.441,6,28,0.214,17,26,0.654,87,2015-01-02,CLE,CHO,2015,90.0
10824,10824,24,Home,L 91-94 ,240,38,89,0.427,31,65,0.477,7,24,0.292,8,10,0.8,91,35,81,0.432,27,61,0.443,8,20,0.4,16,20,0.8,94,2015-01-02,MIL,IND,2015,98.0
10825,10825,25,@,L 91-127 ,240,32,79,0.405,23,54,0.426,9,25,0.36,18,26,0.692,91,46,85,0.541,31,48,0.646,15,37,0.405,20,26,0.769,127,2015-01-03,PHI,LAC,2015,134.5
10826,10826,26,@,L 91-117 ,240,30,98,0.306,25,70,0.357,5,28,0.179,26,34,0.765,91,41,88,0.466,26,60,0.433,15,28,0.536,20,32,0.625,117,2015-01-05,OKC,GSW,2015,124.5
10827,10827,27,@,L 91-101 ,240,34,82,0.415,23,56,0.411,11,26,0.423,12,16,0.75,91,39,76,0.513,31,60,0.517,8,16,0.5,15,21,0.714,101,2015-01-07,NYK,WAS,2015,105.0
10828,10828,28,Home,L 91-105 ,240,34,83,0.41,23,50,0.46,11,33,0.333,12,14,0.857,91,36,73,0.493,26,44,0.591,10,29,0.345,23,27,0.852,105,2015-01-14,BOS,ATL,2015,110.0
10829,10829,29,@,L 91-110 ,240,31,78,0.397,26,53,0.491,5,25,0.2,24,26,0.923,91,39,78,0.5,26,49,0.531,13,29,0.448,19,26,0.731,110,2015-01-21,IND,ATL,2015,116.5
10830,10830,30,Home,L 91-98 ,240,29,79,0.367,21,56,0.375,8,23,0.348,25,32,0.781,91,37,91,0.407,30,71,0.423,7,20,0.35,17,20,0.85,98,2015-01-21,PHI,NYK,2015,101.5
10831,10831,31,@,W 91-86 ,240,33,80,0.413,27,56,0.482,6,24,0.25,19,24,0.792,91,31,81,0.383,22,52,0.423,9,29,0.31,15,18,0.833,86,2015-01-23,TOR,PHI,2015,90.5
10832,10832,32,Home,L 91-104 ,240,34,82,0.415,27,64,0.422,7,18,0.389,16,23,0.696,91,34,73,0.466,25,47,0.532,9,26,0.346,27,34,0.794,104,2015-01-27,IND,TOR,2015,108.5
10833,10833,33,Home,W 91-85 ,240,34,78,0.436,24,50,0.48,10,28,0.357,13,18,0.722,91,31,81,0.383,17,46,0.37,14,35,0.4,9,15,0.6,85,2015-01-31,ATL,PHI,2015,92.0
10834,10834,34,@,L 91-108 ,240,35,74,0.473,29,60,0.483,6,14,0.429,15,23,0.652,91,42,88,0.477,33,68,0.485,9,20,0.45,15,18,0.833,108,2015-02-03,MIA,DET,2015,112.5
10835,10835,35,Home,L 91-102 ,240,37,97,0.381,30,72,0.417,7,25,0.28,10,13,0.769,91,45,85,0.529,40,70,0.571,5,15,0.333,7,11,0.636,102,2015-02-04,NOP,OKC,2015,104.5
10836,10836,36,Home,L 91-94 ,240,33,86,0.384,28,72,0.389,5,14,0.357,20,27,0.741,91,40,90,0.444,33,63,0.524,7,27,0.259,7,9,0.778,94,2015-02-11,MIN,GSW,2015,97.5
10837,10837,37,@,L 91-100 ,240,33,78,0.423,28,62,0.452,5,16,0.313,20,22,0.909,91,38,84,0.452,32,62,0.516,6,22,0.273,18,33,0.545,100,2015-02-20,CHI,DET,2015,103.0
10838,10838,38,Home,L 91-105 ,240,33,79,0.418,28,62,0.452,5,17,0.294,20,27,0.741,91,35,83,0.422,27,62,0.435,8,21,0.381,27,31,0.871,105,2015-02-21,MIA,NOP,2015,109.0
10839,10839,39,Home,L 91-93 ,240,32,81,0.395,25,55,0.455,7,26,0.269,20,21,0.952,91,34,79,0.43,24,54,0.444,10,25,0.4,15,20,0.75,93,2015-02-28,MIA,ATL,2015,98.0
10840,10840,40,Home,L 91-115 ,240,35,88,0.398,32,72,0.444,3,16,0.188,18,24,0.75,91,42,85,0.494,34,66,0.515,8,19,0.421,23,28,0.821,115,2015-03-04,BRK,CHO,2015,119.0
10841,10841,41,Home,W 91-85 ,240,36,78,0.462,26,58,0.448,10,20,0.5,9,15,0.6,91,31,81,0.383,22,53,0.415,9,28,0.321,14,22,0.636,85,2015-03-07,MIL,WAS,2015,89.5
10842,10842,42,Home,L 91-101 ,240,35,80,0.438,25,58,0.431,10,22,0.455,11,14,0.786,91,42,84,0.5,37,70,0.529,5,14,0.357,12,17,0.706,101,2015-03-09,CHI,MEM,2015,103.5
10843,10843,43,Home,L 91-111 ,240,35,84,0.417,29,68,0.426,6,16,0.375,15,23,0.652,91,45,87,0.517,33,66,0.5,12,21,0.571,9,11,0.818,111,2015-03-10,BRK,NOP,2015,117.0
10844,10844,44,@,L 91-97 ,240,34,85,0.4,24,67,0.358,10,18,0.556,13,13,1.0,91,39,79,0.494,31,61,0.508,8,18,0.444,11,16,0.688,97,2015-03-11,ORL,MIL,2015,101.0
10845,10845,45,@,L 91-109 ,240,34,79,0.43,27,47,0.574,7,32,0.219,16,24,0.667,91,44,92,0.478,33,59,0.559,11,33,0.333,10,17,0.588,109,2015-03-12,HOU,UTA,2015,114.5
10846,10846,46,@,L 91-101 ,240,31,82,0.378,16,50,0.32,15,32,0.469,14,19,0.737,91,33,89,0.371,26,70,0.371,7,19,0.368,28,33,0.848,101,2015-03-13,CHI,CHO,2015,104.5
10847,10847,47,@,W 91-86 ,240,34,76,0.447,29,53,0.547,5,23,0.217,18,27,0.667,91,34,85,0.4,27,67,0.403,7,18,0.389,11,15,0.733,86,2015-03-15,ATL,LAL,2015,89.5
10848,10848,48,@,L 91-108 ,240,37,79,0.468,30,52,0.577,7,27,0.259,10,19,0.526,91,43,81,0.531,36,65,0.554,7,16,0.438,15,19,0.789,108,2015-03-20,DEN,MIA,2015,111.5
10849,10849,49,@,L 91-101 ,240,36,91,0.396,30,73,0.411,6,18,0.333,13,16,0.813,91,37,78,0.474,28,57,0.491,9,21,0.429,18,25,0.72,101,2015-03-20,CHA,SAC,2015,105.5
10850,10850,50,@,L 91-107 ,240,33,77,0.429,27,56,0.482,6,21,0.286,19,24,0.792,91,44,90,0.489,33,64,0.516,11,26,0.423,8,10,0.8,107,2015-03-21,CHI,DET,2015,112.5
10851,10851,51,@,L 91-106 ,240,32,73,0.438,22,51,0.431,10,22,0.455,17,21,0.81,91,38,78,0.487,30,60,0.5,8,18,0.444,22,26,0.846,106,2015-03-21,UTA,GSW,2015,110.0
10852,10852,52,Home,L 91-110 ,240,32,89,0.36,31,72,0.431,1,17,0.059,26,30,0.867,91,47,92,0.511,41,70,0.586,6,22,0.273,10,14,0.714,110,2015-03-23,BRK,BOS,2015,113.0
10853,10853,53,@,W 91-88 ,240,39,91,0.429,36,77,0.468,3,14,0.214,10,11,0.909,91,36,91,0.396,33,79,0.418,3,12,0.25,13,20,0.65,88,2015-03-25,BRK,CHO,2015,89.5
10854,10854,54,@,L 91-130 ,240,36,90,0.4,30,72,0.417,6,18,0.333,13,14,0.929,91,51,88,0.58,38,67,0.567,13,21,0.619,15,19,0.789,130,2015-03-25,OKC,SAS,2015,136.5
10855,10855,55,@,L 91-107 ,240,32,81,0.395,27,54,0.5,5,27,0.185,22,31,0.71,91,39,76,0.513,26,52,0.5,13,24,0.542,16,23,0.696,107,2015-03-27,UTA,DEN,2015,113.5
10856,10856,56,Home,L 91-99 ,240,29,75,0.387,25,60,0.417,4,15,0.267,29,37,0.784,91,34,80,0.425,25,51,0.49,9,29,0.31,22,33,0.667,99,2015-03-29,WAS,HOU,2015,103.5
10857,10857,57,@,L 91-95 ,240,31,74,0.419,26,48,0.542,5,26,0.192,24,37,0.649,91,37,89,0.416,29,68,0.426,8,21,0.381,13,18,0.722,95,2015-04-01,CHI,MIL,2015,99.0
10858,10858,58,Home,L 91-103 ,240,39,93,0.419,34,76,0.447,5,17,0.294,8,9,0.889,91,35,86,0.407,22,57,0.386,13,29,0.448,20,23,0.87,103,2015-04-01,ORL,SAS,2015,109.5
10859,10859,59,@,L 91-92 ,240,28,76,0.368,17,50,0.34,11,26,0.423,24,33,0.727,91,35,86,0.407,34,73,0.466,1,13,0.077,21,23,0.913,92,2015-04-04,PHI,CHO,2015,92.5
10860,10860,60,@,L 91-101 ,240,38,99,0.384,28,67,0.418,10,32,0.313,5,8,0.625,91,37,72,0.514,34,59,0.576,3,13,0.231,24,29,0.828,101,2015-04-05,PHI,NYK,2015,102.5
10861,10861,61,@,L 91-116 ,240,32,85,0.376,29,74,0.392,3,11,0.273,24,29,0.828,91,42,85,0.494,30,52,0.577,12,33,0.364,20,23,0.87,116,2015-04-08,MIN,POR,2015,122.0
10862,10862,62,@,L 91-103 ,240,33,75,0.44,26,59,0.441,7,16,0.438,18,28,0.643,91,36,74,0.486,23,43,0.535,13,31,0.419,18,25,0.72,103,2015-04-08,SAC,UTA,2015,109.5
10863,10863,63,Home,L 91-99 ,240,34,72,0.472,29,59,0.492,5,13,0.385,18,24,0.75,91,37,76,0.487,31,59,0.525,6,17,0.353,19,29,0.655,99,2015-04-10,NYK,MIL,2015,102.0
10864,10864,64,@,L 91-107 ,240,35,85,0.412,31,69,0.449,4,16,0.25,17,23,0.739,91,35,69,0.507,27,50,0.54,8,19,0.421,29,34,0.853,107,2015-04-12,PHO,SAS,2015,111.0
10865,10865,65,Home,W 91-85 ,240,31,77,0.403,24,53,0.453,7,24,0.292,22,26,0.846,91,36,92,0.391,28,63,0.444,8,29,0.276,5,7,0.714,85,2015-04-15,CHI,ATL,2015,89.0
10866,10866,66,@,L 91-117 ,240,38,101,0.376,33,74,0.446,5,27,0.185,10,18,0.556,91,41,76,0.539,29,48,0.604,12,28,0.429,23,34,0.676,117,2015-04-15,UTA,HOU,2015,123.0
10867,10867,67,@,L 91-101 ,240,38,79,0.481,35,66,0.53,3,13,0.231,12,18,0.667,91,34,80,0.425,25,57,0.439,9,23,0.391,24,28,0.857,101,2015-10-31,BRK,MEM,2016,105.5
10868,10868,68,Home,L 91-102 ,240,33,86,0.384,26,63,0.413,7,23,0.304,18,25,0.72,91,37,82,0.451,32,65,0.492,5,17,0.294,23,26,0.885,102,2015-11-03,DAL,TOR,2016,104.5
10869,10869,69,Home,W 91-87 ,240,35,86,0.407,27,63,0.429,8,23,0.348,13,17,0.765,91,34,81,0.42,28,53,0.528,6,28,0.214,13,15,0.867,87,2015-11-04,MIL,PHI,2016,90.0
10870,10870,70,Home,L 91-102 ,240,32,77,0.416,28,53,0.528,4,24,0.167,23,32,0.719,91,38,79,0.481,32,62,0.516,6,17,0.353,20,31,0.645,102,2015-11-11,BOS,IND,2016,105.0
10871,10871,71,@,L 91-92 ,240,34,89,0.382,30,72,0.417,4,17,0.235,19,25,0.76,91,36,77,0.468,32,64,0.5,4,13,0.308,16,25,0.64,92,2015-11-12,UTA,MIA,2016,94.0
10872,10872,72,Home,L 91-103 ,240,36,79,0.456,31,55,0.564,5,24,0.208,14,30,0.467,91,36,97,0.371,32,76,0.421,4,21,0.19,27,35,0.771,103,2015-11-17,MIA,MIN,2016,105.0
10873,10873,73,Home,L 91-102 ,240,35,77,0.455,27,52,0.519,8,25,0.32,13,17,0.765,91,34,78,0.436,19,45,0.422,15,33,0.455,19,24,0.792,102,2015-11-20,LAL,TOR,2016,109.5
10874,10874,74,@,L 91-102 ,240,38,86,0.442,31,62,0.5,7,24,0.292,8,16,0.5,91,38,90,0.422,30,65,0.462,8,25,0.32,18,24,0.75,102,2015-11-20,LAC,POR,2016,106.0
10875,10875,75,@,L 91-96 ,240,31,82,0.378,21,51,0.412,10,31,0.323,19,24,0.792,91,30,69,0.435,25,51,0.49,5,18,0.278,31,45,0.689,96,2015-11-21,PHI,MIA,2016,98.5
10876,10876,76,Home,L 91-97 ,240,38,92,0.413,29,61,0.475,9,31,0.29,6,8,0.75,91,31,81,0.383,24,61,0.393,7,20,0.35,28,31,0.903,97,2015-11-21,ORL,SAC,2016,100.5
10877,10877,77,@,W 91-80 ,240,29,78,0.372,25,61,0.41,4,17,0.235,29,31,0.935,91,29,74,0.392,22,42,0.524,7,32,0.219,15,20,0.75,80,2015-11-22,TOR,LAC,2016,83.5
10878,10878,78,Home,L 91-102 ,240,38,75,0.507,34,63,0.54,4,12,0.333,11,17,0.647,91,39,77,0.506,33,64,0.516,6,13,0.462,18,25,0.72,102,2015-11-25,LAC,UTA,2016,105.0
10879,10879,79,@,L 91-100 ,240,31,83,0.373,22,56,0.393,9,27,0.333,20,25,0.8,91,34,86,0.395,29,70,0.414,5,16,0.313,27,32,0.844,100,2015-11-25,NYK,ORL,2016,102.5
10880,10880,80,@,W 91-80 ,240,36,75,0.48,28,53,0.528,8,22,0.364,11,14,0.786,91,31,77,0.403,24,57,0.421,7,20,0.35,11,13,0.846,80,2015-11-27,SAS,DEN,2016,83.5
10881,10881,81,Home,L 91-101 ,240,37,86,0.43,29,64,0.453,8,22,0.364,9,15,0.6,91,37,77,0.481,28,52,0.538,9,25,0.36,18,19,0.947,101,2015-11-27,SAC,MIN,2016,105.5
10882,10882,82,@,L 91-110 ,240,36,88,0.409,31,61,0.508,5,27,0.185,14,20,0.7,91,45,93,0.484,36,68,0.529,9,25,0.36,11,16,0.688,110,2015-11-29,BOS,ORL,2016,114.5
10883,10883,83,@,L 91-94 ,240,33,75,0.44,23,47,0.489,10,28,0.357,15,22,0.682,91,41,84,0.488,37,71,0.521,4,13,0.308,8,12,0.667,94,2015-12-01,PHO,BRK,2016,96.0
10884,10884,84,@,L 91-103 ,240,33,89,0.371,25,55,0.455,8,34,0.235,17,24,0.708,91,37,79,0.468,23,47,0.489,14,32,0.438,15,23,0.652,103,2015-12-01,LAL,PHI,2016,110.0
10885,10885,85,Home,L 91-103 ,240,30,79,0.38,24,52,0.462,6,27,0.222,25,39,0.641,91,32,76,0.421,25,56,0.446,7,20,0.35,32,39,0.821,103,2015-12-02,LAC,IND,2016,106.5
10886,10886,86,@,L 91-108 ,240,39,91,0.429,36,80,0.45,3,11,0.273,10,15,0.667,91,39,87,0.448,27,60,0.45,12,27,0.444,18,21,0.857,108,2015-12-04,BRK,NYK,2016,114.0
10887,10887,87,@,L 91-106 ,240,32,76,0.421,26,51,0.51,6,25,0.24,21,28,0.75,91,44,89,0.494,42,85,0.494,2,4,0.5,16,24,0.667,106,2015-12-05,NYK,MIL,2016,107.0
10888,10888,88,@,L 91-111 ,240,32,80,0.4,27,62,0.435,5,18,0.278,22,29,0.759,91,41,93,0.441,32,69,0.464,9,24,0.375,20,26,0.769,111,2015-12-06,LAL,DET,2016,115.5
10889,10889,89,@,L 91-100 ,240,34,87,0.391,30,56,0.536,4,31,0.129,19,22,0.864,91,37,74,0.5,31,60,0.517,6,14,0.429,20,27,0.741,100,2015-12-10,PHI,BRK,2016,103.0
10890,10890,90,@,L 91-107 ,240,37,94,0.394,32,73,0.438,5,21,0.238,12,17,0.706,91,41,82,0.5,36,62,0.581,5,20,0.25,20,24,0.833,107,2015-12-19,CHI,NYK,2016,109.5
10891,10891,91,Home,W 91-84 ,240,32,83,0.386,27,61,0.443,5,22,0.227,22,25,0.88,91,32,82,0.39,27,66,0.409,5,16,0.313,15,16,0.938,84,2015-12-23,CLE,NYK,2016,86.5
10892,10892,92,@,L 91-100 ,240,33,72,0.458,30,55,0.545,3,17,0.176,22,32,0.688,91,37,82,0.451,26,57,0.456,11,25,0.44,15,19,0.789,100,2015-12-23,MEM,WAS,2016,105.5
10893,10893,93,@,L 91-100 ,240,33,89,0.371,29,70,0.414,4,19,0.211,21,24,0.875,91,36,85,0.424,28,65,0.431,8,20,0.4,20,29,0.69,100,2015-12-27,NYK,BOS,2016,104.0
10894,10894,94,@,L 91-95 ,240,36,86,0.419,31,65,0.477,5,21,0.238,14,19,0.737,91,28,84,0.333,21,58,0.362,7,26,0.269,32,36,0.889,95,2015-12-28,PHI,UTA,2016,98.5
10895,10895,95,Home,L 91-108 ,240,34,87,0.391,27,63,0.429,7,24,0.292,16,24,0.667,91,41,78,0.526,34,55,0.618,7,23,0.304,19,25,0.76,108,2015-12-28,WAS,LAC,2016,111.5
10896,10896,96,@,L 91-114 ,240,33,81,0.407,26,62,0.419,7,19,0.368,18,24,0.75,91,42,82,0.512,28,55,0.509,14,27,0.519,16,20,0.8,114,2015-12-30,GSW,DAL,2016,121.0
10897,10897,97,@,L 91-94 ,240,35,87,0.402,27,65,0.415,8,22,0.364,13,17,0.765,91,28,82,0.341,22,58,0.379,6,24,0.25,32,39,0.821,94,2015-12-30,WAS,TOR,2016,97.0
10898,10898,98,@,L 91-103 ,240,40,85,0.471,35,65,0.538,5,20,0.25,6,8,0.75,91,43,92,0.467,35,66,0.53,8,26,0.308,9,10,0.9,103,2016-01-01,ORL,WAS,2016,107.0
10899,10899,99,@,W 91-78 ,240,35,91,0.385,32,76,0.421,3,15,0.2,18,26,0.692,91,28,72,0.389,21,44,0.477,7,28,0.25,15,24,0.625,78,2016-01-04,MEM,POR,2016,81.5
10900,10900,0,Home,L 91-93 ,240,30,75,0.4,18,46,0.391,12,29,0.414,19,25,0.76,91,33,68,0.485,22,42,0.524,11,26,0.423,16,21,0.762,93,2016-01-04,UTA,HOU,2016,98.5
10901,10901,1,@,W 91-74 ,240,35,80,0.438,31,58,0.534,4,22,0.182,17,18,0.944,91,31,78,0.397,26,62,0.419,5,16,0.313,7,12,0.583,74,2016-01-06,TOR,BRK,2016,76.5
10902,10902,2,Home,L 91-100 ,240,34,92,0.37,27,62,0.435,7,30,0.233,16,20,0.8,91,37,87,0.425,30,59,0.508,7,28,0.25,19,22,0.864,100,2016-01-06,NOP,DAL,2016,103.5
10903,10903,3,Home,W 91-84 ,240,30,82,0.366,22,64,0.344,8,18,0.444,23,30,0.767,91,32,87,0.368,28,68,0.412,4,19,0.211,16,19,0.842,84,2016-01-08,MEM,DEN,2016,86.0
10904,10904,4,@,W 91-86 ,240,36,81,0.444,31,60,0.517,5,21,0.238,14,19,0.737,91,31,83,0.373,22,54,0.407,9,29,0.31,15,20,0.75,86,2016-01-08,IND,NOP,2016,90.5
10905,10905,5,@,L 91-95 ,240,38,91,0.418,32,68,0.471,6,23,0.261,9,14,0.643,91,32,87,0.368,26,58,0.448,6,29,0.207,25,32,0.781,95,2016-01-12,NOP,LAL,2016,98.0
10906,10906,6,Home,L 91-107 ,240,33,72,0.458,26,54,0.481,7,18,0.389,18,24,0.75,91,33,77,0.429,15,42,0.357,18,35,0.514,23,27,0.852,107,2016-01-12,MEM,HOU,2016,116.0
10907,10907,7,@,W 91-77 ,240,34,87,0.391,26,52,0.5,8,35,0.229,15,23,0.652,91,26,74,0.351,20,49,0.408,6,25,0.24,19,29,0.655,77,2016-01-15,CLE,HOU,2016,80.0
10908,10908,8,@,W 91-79 ,240,36,74,0.486,31,62,0.5,5,12,0.417,14,16,0.875,91,27,74,0.365,22,52,0.423,5,22,0.227,20,26,0.769,79,2016-01-19,MIL,MIA,2016,81.5
10909,10909,9,@,W 91-78 ,240,36,77,0.468,31,60,0.517,5,17,0.294,14,20,0.7,91,35,84,0.417,31,65,0.477,4,19,0.211,4,8,0.5,78,2016-01-20,CLE,BRK,2016,80.0
10910,10910,10,Home,W 91-88 ,240,33,92,0.359,26,68,0.382,7,24,0.292,18,24,0.75,91,35,84,0.417,27,51,0.529,8,33,0.242,10,15,0.667,88,2016-01-21,SAC,ATL,2016,92.0
10911,10911,11,Home,L 91-116 ,240,32,75,0.427,25,51,0.49,7,24,0.292,20,30,0.667,91,44,90,0.489,35,68,0.515,9,22,0.409,19,23,0.826,116,2016-01-25,WAS,BOS,2016,120.5
10912,10912,12,@,W 91-89 ,240,32,78,0.41,17,41,0.415,15,37,0.405,12,24,0.5,91,35,83,0.422,30,67,0.448,5,16,0.313,14,24,0.583,89,2016-01-26,LAC,IND,2016,91.5
10913,10913,13,Home,L 91-114 ,240,32,85,0.376,23,60,0.383,9,25,0.36,18,23,0.783,91,47,95,0.495,41,78,0.526,6,17,0.353,14,16,0.875,114,2016-01-28,LAL,CHI,2016,117.0
10914,10914,14,Home,W 91-79 ,240,37,80,0.463,29,59,0.492,8,21,0.381,9,15,0.6,91,28,78,0.359,24,58,0.414,4,20,0.2,19,23,0.826,79,2016-01-29,DAL,BRK,2016,81.0
10915,10915,15,@,L 91-109 ,240,31,80,0.388,21,51,0.412,10,29,0.345,19,28,0.679,91,45,92,0.489,38,72,0.528,7,20,0.35,12,16,0.75,109,2016-01-29,CHA,POR,2016,112.5
10916,10916,16,Home,W 91-78 ,240,31,78,0.397,23,49,0.469,8,29,0.276,21,23,0.913,91,27,74,0.365,22,51,0.431,5,23,0.217,19,24,0.792,78,2016-01-31,DAL,PHO,2016,80.5
10917,10917,17,@,W 91-85 ,240,33,76,0.434,29,58,0.5,4,18,0.222,21,24,0.875,91,30,80,0.375,20,51,0.392,10,29,0.345,15,17,0.882,85,2016-02-05,MEM,NYK,2016,90.0
10918,10918,18,@,L 91-108 ,240,35,90,0.389,25,65,0.385,10,25,0.4,11,14,0.786,91,35,80,0.438,21,44,0.477,14,36,0.389,24,31,0.774,108,2016-02-08,CHI,CHO,2016,115.0
10919,10919,19,@,L 91-111 ,240,33,83,0.398,26,60,0.433,7,23,0.304,18,26,0.692,91,39,83,0.47,28,55,0.509,11,28,0.393,22,34,0.647,111,2016-02-24,PHI,DET,2016,116.5
10920,10920,20,Home,L 91-102 ,240,38,78,0.487,31,66,0.47,7,12,0.583,8,12,0.667,91,37,88,0.42,25,58,0.431,12,30,0.4,16,24,0.667,102,2016-02-27,MIL,DET,2016,108.0
10921,10921,21,@,L 91-99 ,240,34,96,0.354,30,68,0.441,4,28,0.143,19,22,0.864,91,32,78,0.41,25,62,0.403,7,16,0.438,28,30,0.933,99,2016-03-07,SAS,IND,2016,102.5
10922,10922,22,Home,L 91-116 ,240,36,79,0.456,32,64,0.5,4,15,0.267,15,19,0.789,91,47,85,0.553,43,66,0.652,4,19,0.211,18,19,0.947,116,2016-03-08,MIN,SAS,2016,118.0
10923,10923,23,@,W 91-84 ,240,38,80,0.475,30,55,0.545,8,25,0.32,7,14,0.5,91,30,86,0.349,23,60,0.383,7,26,0.269,17,23,0.739,84,2016-03-08,ATL,UTA,2016,87.5
10924,10924,24,@,L 91-105 ,240,36,82,0.439,27,61,0.443,9,21,0.429,10,12,0.833,91,37,77,0.481,24,49,0.49,13,28,0.464,18,25,0.72,105,2016-03-18,BOS,TOR,2016,111.5
10925,10925,25,Home,W 91-88 ,240,35,87,0.402,27,68,0.397,8,19,0.421,13,19,0.684,91,37,86,0.43,33,69,0.478,4,17,0.235,10,13,0.769,88,2016-03-21,CHA,SAS,2016,90.0
10926,10926,26,@,L 91-124 ,240,32,81,0.395,24,59,0.407,8,22,0.364,19,25,0.76,91,48,86,0.558,33,55,0.6,15,31,0.484,13,17,0.765,124,2016-03-21,DEN,CLE,2016,131.5
10927,10927,27,@,L 91-92 ,240,41,76,0.539,36,67,0.537,5,9,0.556,4,7,0.571,91,35,85,0.412,26,52,0.5,9,33,0.273,13,17,0.765,92,2016-03-21,MIL,DET,2016,96.5
10928,10928,28,Home,W 91-75 ,240,35,81,0.432,25,55,0.455,10,26,0.385,11,13,0.846,91,31,80,0.388,27,62,0.435,4,18,0.222,9,14,0.643,75,2016-03-21,IND,PHI,2016,77.0
10929,10929,29,Home,W 91-79 ,240,35,80,0.438,27,60,0.45,8,20,0.4,13,21,0.619,91,31,89,0.348,25,67,0.373,6,22,0.273,11,20,0.55,79,2016-03-23,BOS,TOR,2016,82.0
10930,10930,30,@,L 91-113 ,240,35,73,0.479,30,51,0.588,5,22,0.227,16,23,0.696,91,45,83,0.542,36,61,0.59,9,22,0.409,14,22,0.636,113,2016-03-24,UTA,OKC,2016,117.5
10931,10931,31,Home,L 91-115 ,240,37,84,0.44,33,69,0.478,4,15,0.267,13,15,0.867,91,41,74,0.554,25,45,0.556,16,29,0.552,17,21,0.81,115,2016-03-26,MIL,CHO,2016,123.0
10932,10932,32,Home,L 91-115 ,240,37,85,0.435,33,70,0.471,4,15,0.267,13,20,0.65,91,39,73,0.534,27,44,0.614,12,29,0.414,25,28,0.893,115,2016-03-26,NOP,TOR,2016,121.0
10933,10933,33,@,L 91-99 ,240,36,89,0.404,26,58,0.448,10,31,0.323,9,13,0.692,91,32,75,0.427,24,56,0.429,8,19,0.421,27,37,0.73,99,2016-03-28,NYK,NOP,2016,103.0
10934,10934,34,Home,W 91-89 ,240,35,85,0.412,27,60,0.45,8,25,0.32,13,17,0.765,91,35,77,0.455,32,60,0.533,3,17,0.176,16,18,0.889,89,2016-03-30,DAL,NYK,2016,90.5
10935,10935,35,@,L 91-100 ,240,33,90,0.367,23,51,0.451,10,39,0.256,15,21,0.714,91,36,84,0.429,29,57,0.509,7,27,0.259,21,27,0.778,100,2016-04-01,PHI,CHO,2016,103.5
10936,10936,36,@,L 91-105 ,240,36,101,0.356,32,77,0.416,4,24,0.167,15,20,0.75,91,42,84,0.5,28,61,0.459,14,23,0.609,7,7,1.0,105,2016-04-01,BRK,NYK,2016,112.0
10937,10937,37,@,W 91-81 ,240,37,83,0.446,30,58,0.517,7,25,0.28,10,14,0.714,91,32,90,0.356,28,71,0.394,4,19,0.211,13,17,0.765,81,2016-04-06,LAC,LAL,2016,83.0
10938,10938,38,@,L 91-98 ,240,30,74,0.405,22,44,0.5,8,30,0.267,23,33,0.697,91,37,76,0.487,28,58,0.483,9,18,0.5,15,37,0.405,98,2016-04-10,DAL,LAC,2016,102.5
10939,10939,39,Home,L 91-96 ,240,31,77,0.403,19,38,0.5,12,39,0.308,17,21,0.81,91,35,74,0.473,29,51,0.569,6,23,0.261,20,26,0.769,96,2016-04-13,DAL,SAS,2016,99.0
10940,10940,40,@,L 91-109 ,240,35,84,0.417,31,62,0.5,4,22,0.182,17,22,0.773,91,41,86,0.477,38,68,0.559,3,18,0.167,24,29,0.828,109,2016-10-26,DET,TOR,2017,110.5
10941,10941,41,Home,L 91-97 ,240,32,86,0.372,18,52,0.346,14,34,0.412,13,20,0.65,91,35,92,0.38,28,70,0.4,7,22,0.318,20,24,0.833,97,2016-10-28,MIA,CHO,2017,100.5
10942,10942,42,Home,L 91-94 ,240,35,90,0.389,31,74,0.419,4,16,0.25,17,18,0.944,91,33,79,0.418,21,47,0.447,12,32,0.375,16,22,0.727,94,2016-10-28,TOR,CLE,2017,100.0
10943,10943,43,Home,L 91-106 ,240,33,76,0.434,27,56,0.482,6,20,0.3,19,21,0.905,91,38,76,0.5,23,45,0.511,15,31,0.484,15,18,0.833,106,2016-11-01,SAS,UTA,2017,113.5
10944,10944,44,@,L 91-117 ,240,33,84,0.393,23,56,0.411,10,28,0.357,15,19,0.789,91,41,82,0.5,27,49,0.551,14,33,0.424,21,25,0.84,117,2016-11-05,SAC,MIL,2017,124.0
10945,10945,45,Home,L 91-96 ,240,30,84,0.357,23,54,0.426,7,30,0.233,24,31,0.774,91,34,78,0.436,29,62,0.468,5,16,0.313,23,31,0.742,96,2016-11-06,TOR,SAC,2017,98.5
10946,10946,46,Home,L 91-101 ,240,34,85,0.4,26,64,0.406,8,21,0.381,15,20,0.75,91,38,74,0.514,29,47,0.617,9,27,0.333,16,22,0.727,101,2016-11-10,SAC,LAL,2017,105.5
10947,10947,47,Home,L 91-102 ,240,38,81,0.469,33,64,0.516,5,17,0.294,10,19,0.526,91,40,81,0.494,34,61,0.557,6,20,0.3,16,19,0.842,102,2016-11-12,MIA,UTA,2017,105.0
10948,10948,48,@,L 91-105 ,240,33,85,0.388,26,59,0.441,7,26,0.269,18,23,0.783,91,42,86,0.488,34,64,0.531,8,22,0.364,13,30,0.433,105,2016-11-20,UTA,DEN,2017,109.0
10949,10949,49,@,L 91-96 ,240,35,74,0.473,27,47,0.574,8,27,0.296,13,20,0.65,91,35,75,0.467,27,55,0.491,8,20,0.4,18,25,0.72,96,2016-11-21,DAL,SAS,2017,100.0
10950,10950,50,Home,L 91-94 ,240,35,80,0.438,28,57,0.491,7,23,0.304,14,20,0.7,91,40,88,0.455,34,59,0.576,6,29,0.207,8,10,0.8,94,2016-11-25,ORL,WAS,2017,97.0
10951,10951,51,Home,W 91-81 ,240,32,77,0.416,22,50,0.44,10,27,0.37,17,20,0.85,91,30,77,0.39,25,57,0.439,5,20,0.25,16,18,0.889,81,2016-11-27,DAL,NOP,2017,83.5
10952,10952,52,Home,W 91-70 ,240,40,92,0.435,35,73,0.479,5,19,0.263,6,7,0.857,91,22,70,0.314,18,46,0.391,4,24,0.167,22,27,0.815,70,2016-11-27,IND,LAC,2017,72.0
10953,10953,53,@,L 91-102 ,240,33,75,0.44,31,60,0.517,2,15,0.133,23,32,0.719,91,40,88,0.455,32,67,0.478,8,21,0.381,14,21,0.667,102,2016-12-06,CHI,DET,2017,106.0
10954,10954,54,@,L 91-96 ,240,32,82,0.39,18,41,0.439,14,41,0.341,13,26,0.5,91,33,86,0.384,31,69,0.449,2,17,0.118,28,35,0.8,96,2016-12-06,PHI,MEM,2017,97.0
10955,10955,55,Home,L 91-105 ,240,36,82,0.439,29,62,0.468,7,20,0.35,12,18,0.667,91,39,74,0.527,28,50,0.56,11,24,0.458,16,19,0.842,105,2016-12-06,MIN,SAS,2017,110.5
10956,10956,56,@,L 91-95 ,240,39,97,0.402,30,69,0.435,9,28,0.321,4,5,0.8,91,35,80,0.438,31,63,0.492,4,17,0.235,21,27,0.778,95,2016-12-08,SAS,CHI,2017,97.0
10957,10957,57,@,L 91-103 ,240,38,96,0.396,31,74,0.419,7,22,0.318,8,10,0.8,91,37,84,0.44,32,66,0.485,5,18,0.278,24,28,0.857,103,2016-12-23,CHI,CHO,2017,105.5
10958,10958,58,Home,W 91-87 ,240,33,89,0.371,22,61,0.361,11,28,0.393,14,21,0.667,91,36,87,0.414,28,67,0.418,8,20,0.4,7,13,0.538,87,2016-12-23,NOP,MIA,2017,91.0
10959,10959,59,Home,L 91-95 ,240,35,83,0.422,27,60,0.45,8,23,0.348,13,18,0.722,91,32,95,0.337,20,61,0.328,12,34,0.353,19,24,0.792,95,2016-12-26,POR,TOR,2017,101.0
10960,10960,60,Home,W 91-82 ,240,36,93,0.387,31,67,0.463,5,26,0.192,14,18,0.778,91,33,82,0.402,23,54,0.426,10,28,0.357,6,13,0.462,82,2016-12-29,CHA,MIA,2017,87.0
10961,10961,61,@,L 91-99 ,240,30,75,0.4,23,48,0.479,7,27,0.259,24,29,0.828,91,37,83,0.446,28,62,0.452,9,21,0.429,16,23,0.696,99,2016-12-29,TOR,PHO,2017,103.5
10962,10962,62,Home,W 91-86 ,240,35,73,0.479,27,53,0.509,8,20,0.4,13,20,0.65,91,36,87,0.414,29,70,0.414,7,17,0.412,7,10,0.7,86,2016-12-31,UTA,PHO,2017,89.5
10963,10963,63,@,L 91-101 ,240,38,87,0.437,32,61,0.525,6,26,0.231,9,12,0.75,91,37,86,0.43,25,47,0.532,12,39,0.308,15,21,0.714,101,2017-01-02,WAS,HOU,2017,107.0
10964,10964,64,@,L 91-93 ,240,33,82,0.402,26,58,0.448,7,24,0.292,18,20,0.9,91,33,85,0.388,26,53,0.491,7,32,0.219,20,25,0.8,93,2017-01-03,MIN,PHI,2017,96.5
10965,10965,65,@,L 91-126 ,240,31,88,0.352,22,54,0.407,9,34,0.265,20,27,0.741,91,46,91,0.505,31,57,0.544,15,34,0.441,19,24,0.792,126,2017-01-16,CLE,GSW,2017,133.5
10966,10966,66,@,L 91-107 ,240,31,76,0.408,25,47,0.532,6,29,0.207,23,32,0.719,91,38,83,0.458,27,55,0.491,11,28,0.393,20,25,0.8,107,2017-01-20,SAC,MEM,2017,112.5
10967,10967,67,@,L 91-107 ,240,37,100,0.37,31,74,0.419,6,26,0.231,11,16,0.688,91,41,92,0.446,33,63,0.524,8,29,0.276,17,22,0.773,107,2017-01-29,OKC,CLE,2017,111.0
10968,10968,68,@,L 91-105 ,240,37,84,0.44,32,67,0.478,5,17,0.294,12,22,0.545,91,38,83,0.458,28,52,0.538,10,31,0.323,19,22,0.864,105,2017-02-04,NOP,WAS,2017,110.0
10969,10969,69,@,L 91-110 ,240,29,87,0.333,24,64,0.375,5,23,0.217,28,34,0.824,91,35,72,0.486,21,48,0.438,14,24,0.583,26,34,0.765,110,2017-02-08,PHO,MEM,2017,117.0
10970,10970,70,@,L 91-98 ,240,35,92,0.38,25,55,0.455,10,37,0.27,11,11,1.0,91,36,82,0.439,30,63,0.476,6,19,0.316,20,22,0.909,98,2017-02-15,DAL,DET,2017,101.0
10971,10971,71,Home,L 91-95 ,240,33,89,0.371,27,56,0.482,6,33,0.182,19,25,0.76,91,37,75,0.493,29,57,0.509,8,18,0.444,13,22,0.591,95,2017-02-15,MEM,NOP,2017,99.0
10972,10972,72,Home,L 91-92 ,240,33,73,0.452,24,49,0.49,9,24,0.375,16,19,0.842,91,33,78,0.423,26,52,0.5,7,26,0.269,19,23,0.826,92,2017-02-27,NYK,TOR,2017,95.5
10973,10973,73,Home,L 91-101 ,240,35,83,0.422,29,66,0.439,6,17,0.353,15,20,0.75,91,41,85,0.482,35,60,0.583,6,25,0.24,13,16,0.813,101,2017-03-04,CHI,LAC,2017,104.0
10974,10974,74,@,L 91-107 ,240,35,83,0.422,26,59,0.441,9,24,0.375,12,18,0.667,91,42,86,0.488,37,66,0.561,5,20,0.25,18,20,0.9,107,2017-03-08,LAC,MIN,2017,109.5
10975,10975,75,@,L 91-98 ,240,36,81,0.444,24,53,0.453,12,28,0.429,7,11,0.636,91,37,89,0.416,30,64,0.469,7,25,0.28,17,21,0.81,98,2017-03-08,CHI,ORL,2017,101.5
10976,10976,76,@,W 90-84 ,240,34,86,0.395,28,60,0.467,6,26,0.231,16,20,0.8,90,31,74,0.419,30,67,0.448,1,7,0.143,21,34,0.618,84,2011-12-26,BRK,WAS,2012,84.5
10977,10977,77,@,L 90-115 ,240,29,74,0.392,22,54,0.407,7,20,0.35,25,33,0.758,90,45,80,0.563,35,61,0.574,10,19,0.526,15,15,1.0,115,2011-12-28,LAC,SAS,2012,120.0
10978,10978,78,@,W 90-85 ,240,32,81,0.395,25,65,0.385,7,16,0.438,19,22,0.864,90,36,79,0.456,30,64,0.469,6,15,0.4,7,13,0.538,85,2011-12-28,IND,TOR,2012,88.0
10979,10979,79,@,L 90-99 ,240,35,88,0.398,31,65,0.477,4,23,0.174,16,24,0.667,90,33,71,0.465,31,53,0.585,2,18,0.111,31,37,0.838,99,2012-01-01,LAL,DEN,2012,100.0
10980,10980,80,@,L 90-129 ,240,35,92,0.38,29,74,0.392,6,18,0.333,14,21,0.667,90,48,80,0.6,41,69,0.594,7,11,0.636,26,31,0.839,129,2012-01-01,CHA,MIA,2012,132.5
10981,10981,81,@,W 90-85 ,240,30,68,0.441,23,51,0.451,7,17,0.412,23,29,0.793,90,28,78,0.359,18,43,0.419,10,35,0.286,19,25,0.76,85,2012-01-02,TOR,NYK,2012,90.0
10982,10982,82,@,L 90-94 ,240,37,74,0.5,34,64,0.531,3,10,0.3,13,16,0.813,90,37,76,0.487,32,61,0.525,5,15,0.333,15,23,0.652,94,2012-01-02,NOP,UTA,2012,96.5
10983,10983,83,@,W 90-86 ,240,33,80,0.413,30,71,0.423,3,9,0.333,21,25,0.84,90,33,82,0.402,26,61,0.426,7,21,0.333,13,24,0.542,86,2012-01-04,MEM,MIN,2012,89.5
10984,10984,84,@,L 90-97 ,240,38,77,0.494,34,63,0.54,4,14,0.286,10,19,0.526,90,37,77,0.481,34,66,0.515,3,11,0.273,20,29,0.69,97,2012-01-06,GSW,LAL,2012,98.5
10985,10985,85,Home,L 90-101 ,240,28,83,0.337,18,50,0.36,10,33,0.303,24,32,0.75,90,38,76,0.5,33,61,0.541,5,15,0.333,20,24,0.833,101,2012-01-07,BRK,MIA,2012,103.5
10986,10986,86,Home,W 90-82 ,240,35,74,0.473,29,55,0.527,6,19,0.316,14,21,0.667,90,38,93,0.409,37,84,0.44,1,9,0.111,5,10,0.5,82,2012-01-08,LAL,MEM,2012,82.5
10987,10987,87,@,W 90-85 ,240,35,79,0.443,29,63,0.46,6,16,0.375,14,25,0.56,90,29,64,0.453,25,53,0.472,4,11,0.364,23,32,0.719,85,2012-01-11,DAL,BOS,2012,87.0
10988,10988,88,@,W 90-87 (OT),265,35,82,0.427,31,73,0.425,4,9,0.444,16,19,0.842,90,36,93,0.387,32,79,0.405,4,14,0.286,11,16,0.688,87,2012-01-11,LAL,UTA,2012,89.0
10989,10989,89,Home,L 90-101 ,240,34,75,0.453,26,54,0.481,8,21,0.381,14,20,0.7,90,39,89,0.438,29,70,0.414,10,19,0.526,13,21,0.619,101,2012-01-12,PHO,CLE,2012,106.0
10990,10990,90,Home,L 90-95 ,240,33,74,0.446,29,57,0.509,4,17,0.235,20,32,0.625,90,30,66,0.455,27,58,0.466,3,8,0.375,32,38,0.842,95,2012-01-13,TOR,IND,2012,96.5
10991,10991,91,Home,L 90-103 ,240,38,88,0.432,35,74,0.473,3,14,0.214,11,17,0.647,90,37,86,0.43,31,70,0.443,6,16,0.375,23,27,0.852,103,2012-01-14,WAS,PHI,2012,106.0
10992,10992,92,Home,W 90-88 (OT),265,35,88,0.398,26,61,0.426,9,27,0.333,11,13,0.846,90,37,94,0.394,34,83,0.41,3,11,0.273,11,16,0.688,88,2012-01-19,HOU,NOH,2012,89.5
10993,10993,93,Home,W 90-76 ,240,35,84,0.417,31,67,0.463,4,17,0.235,16,19,0.842,90,32,74,0.432,27,59,0.458,5,15,0.333,7,8,0.875,76,2012-01-20,PHI,ATL,2012,78.5
10994,10994,94,Home,L 90-91 ,240,38,76,0.5,29,51,0.569,9,25,0.36,5,8,0.625,90,36,85,0.424,34,72,0.472,2,13,0.154,17,23,0.739,91,2012-01-23,GSW,MEM,2012,92.0
10995,10995,95,Home,L 90-95 ,240,36,90,0.4,33,77,0.429,3,13,0.231,15,21,0.714,90,38,80,0.475,33,70,0.471,5,10,0.5,14,21,0.667,95,2012-01-25,CHI,IND,2012,97.5
10996,10996,96,Home,L 90-105 ,240,39,95,0.411,33,73,0.452,6,22,0.273,6,10,0.6,90,34,77,0.442,25,56,0.446,9,21,0.429,28,33,0.848,105,2012-01-25,DAL,MIN,2012,109.5
10997,10997,97,Home,L 90-97 (OT),265,35,79,0.443,30,65,0.462,5,14,0.357,15,19,0.789,90,37,82,0.451,25,55,0.455,12,27,0.444,11,14,0.786,97,2012-01-25,PHI,NJN,2012,103.0
10998,10998,98,Home,L 90-93 ,240,34,75,0.453,27,58,0.466,7,17,0.412,15,21,0.714,90,37,73,0.507,32,59,0.542,5,14,0.357,14,19,0.737,93,2012-01-31,CLE,BOS,2012,95.5
10999,10999,99,@,L 90-93 ,240,35,82,0.427,29,66,0.439,6,16,0.375,14,19,0.737,90,37,91,0.407,29,67,0.433,8,24,0.333,11,13,0.846,93,2012-01-31,SAC,GSW,2012,97.0
11000,11000,0,Home,L 90-113 ,240,37,93,0.398,36,81,0.444,1,12,0.083,15,19,0.789,90,48,90,0.533,34,60,0.567,14,30,0.467,3,4,0.75,113,2012-02-04,MIL,CHI,2012,120.0
11001,11001,1,Home,L 90-99 ,240,33,84,0.393,27,60,0.45,6,24,0.25,18,21,0.857,90,41,79,0.519,30,55,0.545,11,24,0.458,6,7,0.857,99,2012-02-06,ATL,PHO,2012,104.5
11002,11002,2,Home,L 90-99 ,240,34,78,0.436,31,56,0.554,3,22,0.136,19,33,0.576,90,35,81,0.432,25,62,0.403,10,19,0.526,19,24,0.792,99,2012-02-06,DEN,HOU,2012,104.0
11003,11003,3,@,L 90-95 ,240,34,81,0.42,27,57,0.474,7,24,0.292,15,20,0.75,90,38,81,0.469,30,64,0.469,8,17,0.471,11,17,0.647,95,2012-02-06,LAL,PHI,2012,99.0
11004,11004,4,@,W 90-67 ,240,39,85,0.459,35,69,0.507,4,16,0.25,8,12,0.667,90,28,75,0.373,27,72,0.375,1,3,0.333,10,17,0.588,67,2012-02-08,CHI,NOH,2012,67.5
11005,11005,5,Home,L 90-100 ,240,38,93,0.409,31,79,0.392,7,14,0.5,7,11,0.636,90,37,84,0.44,32,69,0.464,5,15,0.333,21,26,0.808,100,2012-02-08,PHI,SAS,2012,102.5
11006,11006,6,Home,L 90-105 ,240,33,76,0.434,31,61,0.508,2,15,0.133,22,29,0.759,90,35,70,0.5,30,57,0.526,5,13,0.385,30,35,0.857,105,2012-02-14,IND,MIA,2012,107.5
11007,11007,7,@,W 90-87 ,240,33,80,0.413,27,63,0.429,6,17,0.353,18,27,0.667,90,37,73,0.507,33,58,0.569,4,15,0.267,9,15,0.6,87,2012-02-14,NYK,TOR,2012,89.0
11008,11008,8,@,L 90-102 ,240,38,85,0.447,31,67,0.463,7,18,0.389,7,15,0.467,90,43,85,0.506,39,69,0.565,4,16,0.25,12,16,0.75,102,2012-02-15,CHA,MIN,2012,104.0
11009,11009,9,Home,W 90-78 ,240,38,80,0.475,35,68,0.515,3,12,0.25,11,14,0.786,90,27,74,0.365,16,45,0.356,11,29,0.379,13,25,0.52,78,2012-02-19,MIA,ORL,2012,83.5
11010,11010,10,@,L 90-102 ,240,35,78,0.449,32,60,0.533,3,18,0.167,17,25,0.68,90,34,80,0.425,27,60,0.45,7,20,0.35,27,32,0.844,102,2012-02-19,LAL,PHO,2012,105.5
11011,11011,11,Home,W 90-79 ,240,34,88,0.386,26,68,0.382,8,20,0.4,14,19,0.737,90,30,74,0.405,21,49,0.429,9,25,0.36,10,21,0.476,79,2012-02-20,CHI,ATL,2012,83.5
11012,11012,12,Home,L 90-93 ,240,37,91,0.407,32,69,0.464,5,22,0.227,11,13,0.846,90,33,76,0.434,25,54,0.463,8,22,0.364,19,25,0.76,93,2012-02-20,MIL,ORL,2012,97.0
11013,11013,13,@,L 90-97 ,240,30,73,0.411,24,50,0.48,6,23,0.261,24,29,0.828,90,37,85,0.435,29,68,0.426,8,17,0.471,15,22,0.682,97,2012-03-03,OKC,ATL,2012,101.0
11014,11014,14,Home,L 90-96 ,240,37,76,0.487,31,52,0.596,6,24,0.25,10,17,0.588,90,38,91,0.418,33,74,0.446,5,17,0.294,15,24,0.625,96,2012-03-09,OKC,CLE,2012,98.5
11015,11015,15,@,L 90-105 ,240,34,71,0.479,31,59,0.525,3,12,0.25,19,28,0.679,90,39,72,0.542,32,61,0.525,7,11,0.636,20,26,0.769,105,2012-03-12,DET,UTA,2012,108.5
11016,11016,16,Home,L 90-103 ,240,34,78,0.436,29,56,0.518,5,22,0.227,17,25,0.68,90,36,79,0.456,24,54,0.444,12,25,0.48,19,24,0.792,103,2012-03-15,DEN,OKC,2012,109.0
11017,11017,17,@,L 90-97 ,240,30,71,0.423,22,52,0.423,8,19,0.421,22,30,0.733,90,38,80,0.475,33,70,0.471,5,10,0.5,16,22,0.727,97,2012-03-20,OKC,UTA,2012,99.5
11018,11018,18,@,L 90-97 ,240,35,90,0.389,30,63,0.476,5,27,0.185,15,24,0.625,90,34,59,0.576,32,54,0.593,2,5,0.4,27,34,0.794,97,2012-03-22,LAC,NOH,2012,98.0
11019,11019,19,Home,W 90-87 ,240,31,85,0.365,21,55,0.382,10,30,0.333,18,27,0.667,90,32,74,0.432,25,52,0.481,7,22,0.318,16,17,0.941,87,2012-03-25,POR,GSW,2012,90.5
11020,11020,20,@,L 90-105 ,240,29,69,0.42,21,49,0.429,8,20,0.4,24,37,0.649,90,37,81,0.457,27,63,0.429,10,18,0.556,21,28,0.75,105,2012-03-26,MIA,IND,2012,110.0
11021,11021,21,Home,W 90-81 ,240,34,73,0.466,28,54,0.519,6,19,0.316,16,20,0.8,90,33,79,0.418,27,58,0.466,6,21,0.286,9,12,0.75,81,2012-03-27,DAL,HOU,2012,84.0
11022,11022,22,@,L 90-100 ,240,31,70,0.443,25,53,0.472,6,17,0.353,22,33,0.667,90,37,73,0.507,33,54,0.611,4,19,0.211,22,26,0.846,100,2012-03-30,NYK,ATL,2012,102.0
11023,11023,23,@,L 90-95 ,240,35,74,0.473,31,60,0.517,4,14,0.286,16,22,0.727,90,37,77,0.481,31,65,0.477,6,12,0.5,15,19,0.789,95,2012-03-31,ATL,PHI,2012,98.0
11024,11024,24,Home,L 90-125 ,240,34,82,0.415,25,58,0.431,9,24,0.375,13,15,0.867,90,48,81,0.593,37,58,0.638,11,23,0.478,18,21,0.857,125,2012-04-03,CLE,SAS,2012,130.5
11025,11025,25,@,L 90-95 ,240,36,85,0.424,34,73,0.466,2,12,0.167,16,24,0.667,90,37,91,0.407,32,76,0.421,5,15,0.333,16,24,0.667,95,2012-04-06,CHA,MIL,2012,97.5
11026,11026,26,@,L 90-99 ,240,33,81,0.407,23,56,0.411,10,25,0.4,14,18,0.778,90,40,82,0.488,36,69,0.522,4,13,0.308,15,19,0.789,99,2012-04-07,MIN,NOH,2012,101.0
11027,11027,27,Home,L 90-114 ,240,32,83,0.386,26,61,0.426,6,22,0.273,20,23,0.87,90,47,82,0.573,40,62,0.645,7,20,0.35,13,16,0.813,114,2012-04-09,MIN,PHO,2012,117.5
11028,11028,28,@,L 90-103 ,240,37,79,0.468,34,68,0.5,3,11,0.273,13,16,0.813,90,40,83,0.482,29,64,0.453,11,19,0.579,12,14,0.857,103,2012-04-10,CHA,CLE,2012,108.5
11029,11029,29,@,L 90-93 ,240,37,83,0.446,32,67,0.478,5,16,0.313,11,17,0.647,90,33,74,0.446,24,50,0.48,9,24,0.375,18,24,0.75,93,2012-04-19,LAC,PHO,2012,97.5
11030,11030,30,@,L 90-98 ,240,35,83,0.422,23,50,0.46,12,33,0.364,8,15,0.533,90,36,79,0.456,30,60,0.5,6,19,0.316,20,27,0.741,98,2012-04-20,NYK,CLE,2012,101.0
11031,11031,31,@,W 90-85 ,240,36,101,0.356,31,85,0.365,5,16,0.313,13,18,0.722,90,36,81,0.444,30,65,0.462,6,16,0.375,7,9,0.778,85,2012-04-25,PHI,MIL,2012,88.0
11032,11032,32,@,W 90-88 ,240,37,78,0.474,32,67,0.478,5,11,0.455,11,16,0.688,90,33,91,0.363,27,74,0.365,6,17,0.353,16,19,0.842,88,2012-10-31,IND,TOR,2013,91.0
11033,11033,33,Home,W 90-89 ,240,31,85,0.365,24,66,0.364,7,19,0.368,21,24,0.875,90,33,83,0.398,26,57,0.456,7,26,0.269,16,27,0.593,89,2012-11-02,CHA,IND,2013,92.5
11034,11034,34,Home,L 90-108 ,240,35,91,0.385,29,76,0.382,6,15,0.4,14,21,0.667,90,44,83,0.53,38,67,0.567,6,16,0.375,14,19,0.737,108,2012-11-07,MIL,MEM,2013,111.0
11035,11035,35,Home,W 90-75 ,240,34,76,0.447,27,56,0.482,7,20,0.35,15,22,0.682,90,28,80,0.35,25,68,0.368,3,12,0.25,16,20,0.8,75,2012-11-07,MIN,ORL,2013,76.5
11036,11036,36,Home,L 90-103 ,240,32,75,0.427,25,55,0.455,7,20,0.35,19,30,0.633,90,41,77,0.532,38,64,0.594,3,13,0.231,18,25,0.72,103,2012-11-08,POR,LAC,2013,104.5
11037,11037,37,@,L 90-103 ,240,36,90,0.4,29,67,0.433,7,23,0.304,11,14,0.786,90,36,81,0.444,28,56,0.5,8,25,0.32,23,30,0.767,103,2012-11-11,SAC,LAL,2013,107.0
11038,11038,38,@,W 90-82 ,240,30,65,0.462,26,50,0.52,4,15,0.267,26,32,0.813,90,29,80,0.363,25,64,0.391,4,16,0.25,20,25,0.8,82,2012-11-12,MIN,DAL,2013,84.0
11039,11039,39,Home,L 90-92 ,240,33,83,0.398,27,66,0.409,6,17,0.353,18,27,0.667,90,27,73,0.37,26,63,0.413,1,10,0.1,37,42,0.881,92,2012-11-12,DET,OKC,2013,92.5
11040,11040,40,Home,L 90-99 ,240,37,80,0.463,31,62,0.5,6,18,0.333,10,19,0.526,90,36,75,0.48,31,58,0.534,5,17,0.294,22,25,0.88,99,2012-11-18,SAC,BRK,2013,101.5
11041,11041,41,@,L 90-95 ,240,34,82,0.415,27,59,0.458,7,23,0.304,15,21,0.714,90,35,73,0.479,29,52,0.558,6,21,0.286,19,37,0.514,95,2012-11-20,BRK,LAL,2013,98.0
11042,11042,42,Home,W 90-74 ,240,36,83,0.434,31,63,0.492,5,20,0.25,13,18,0.722,90,28,85,0.329,25,68,0.368,3,17,0.176,15,22,0.682,74,2012-11-21,ORL,DET,2013,75.5
11043,11043,43,@,L 90-91 ,240,32,78,0.41,26,60,0.433,6,18,0.333,20,25,0.8,90,36,78,0.462,32,65,0.492,4,13,0.308,15,26,0.577,91,2012-11-23,TOR,DET,2013,93.0
11044,11044,44,Home,W 90-78 ,240,34,85,0.4,30,73,0.411,4,12,0.333,18,21,0.857,90,29,72,0.403,25,56,0.446,4,16,0.25,16,20,0.8,78,2012-11-30,MEM,DET,2013,80.0
11045,11045,45,@,L 90-112 ,240,34,84,0.405,29,65,0.446,5,19,0.263,17,19,0.895,90,45,90,0.5,39,70,0.557,6,20,0.3,16,21,0.762,112,2012-12-05,DAL,LAC,2013,115.0
11046,11046,46,@,L 90-106 ,240,35,78,0.449,27,60,0.45,8,18,0.444,12,13,0.923,90,40,69,0.58,33,58,0.569,7,11,0.636,19,24,0.792,106,2012-12-08,NOP,MIA,2013,109.5
11047,11047,47,Home,L 90-98 ,240,36,78,0.462,31,58,0.534,5,20,0.25,13,18,0.722,90,40,77,0.519,35,62,0.565,5,15,0.333,13,18,0.722,98,2012-12-09,PHO,ORL,2013,100.5
11048,11048,48,@,L 90-113 ,240,34,79,0.43,28,58,0.483,6,21,0.286,16,20,0.8,90,43,75,0.573,29,46,0.63,14,29,0.483,13,23,0.565,113,2012-12-13,CHA,ATL,2013,120.0
11049,11049,49,@,L 90-98 ,240,33,72,0.458,27,53,0.509,6,19,0.316,18,25,0.72,90,40,88,0.455,33,61,0.541,7,27,0.259,11,12,0.917,98,2012-12-13,SAS,POR,2013,101.5
11050,11050,50,@,W 90-86 ,240,33,83,0.398,28,68,0.412,5,15,0.333,19,27,0.704,90,32,81,0.395,23,63,0.365,9,18,0.5,13,14,0.929,86,2012-12-14,MIL,CLE,2013,90.5
11051,11051,51,@,L 90-101 ,240,34,83,0.41,31,70,0.443,3,13,0.231,19,24,0.792,90,41,85,0.482,33,63,0.524,8,22,0.364,11,15,0.733,101,2012-12-17,SAC,PHO,2013,105.0
11052,11052,52,Home,L 90-92 ,240,33,77,0.429,26,60,0.433,7,17,0.412,17,22,0.773,90,37,83,0.446,32,63,0.508,5,20,0.25,13,16,0.813,92,2012-12-18,BRK,UTA,2013,94.5
11053,11053,53,Home,W 90-80 ,240,36,88,0.409,33,80,0.413,3,8,0.375,15,19,0.789,90,30,85,0.353,25,65,0.385,5,20,0.25,15,19,0.789,80,2012-12-19,MEM,MIL,2013,82.5
11054,11054,54,Home,W 90-83 ,240,34,81,0.42,26,61,0.426,8,20,0.4,14,17,0.824,90,34,77,0.442,25,60,0.417,9,17,0.529,6,8,0.75,83,2012-12-19,ORL,WAS,2013,87.5
11055,11055,55,@,L 90-93 ,240,35,70,0.5,31,56,0.554,4,14,0.286,16,19,0.842,90,33,81,0.407,25,62,0.403,8,19,0.421,19,21,0.905,93,2012-12-21,ORL,TOR,2013,97.0
11056,11056,56,Home,W 90-72 ,240,39,80,0.488,38,69,0.551,1,11,0.091,11,13,0.846,90,29,74,0.392,27,64,0.422,2,10,0.2,12,19,0.632,72,2013-01-09,TOR,PHI,2013,73.0
11057,11057,57,@,L 90-92 ,240,35,77,0.455,29,58,0.5,6,19,0.316,14,20,0.7,90,30,80,0.375,21,53,0.396,9,27,0.333,23,30,0.767,92,2013-01-10,MIA,POR,2013,96.5
11058,11058,58,@,W 90-87 ,240,36,71,0.507,31,61,0.508,5,10,0.5,13,18,0.722,90,34,65,0.523,28,49,0.571,6,16,0.375,13,21,0.619,87,2013-01-12,UTA,DET,2013,90.0
11059,11059,59,Home,L 90-102 ,240,35,84,0.417,26,59,0.441,9,25,0.36,11,18,0.611,90,40,84,0.476,35,67,0.522,5,17,0.294,17,22,0.773,102,2013-01-14,PHO,OKC,2013,104.5
11060,11060,60,@,W 90-78 ,240,31,71,0.437,29,54,0.537,2,17,0.118,26,31,0.839,90,34,74,0.459,30,56,0.536,4,18,0.222,6,16,0.375,78,2013-01-16,NOP,BOS,2013,80.0
11061,11061,61,Home,L 90-99 ,240,31,72,0.431,21,50,0.42,10,22,0.455,18,28,0.643,90,40,83,0.482,38,70,0.543,2,13,0.154,17,23,0.739,99,2013-01-17,LAL,MIA,2013,100.0
11062,11062,62,@,W 90-77 ,240,35,77,0.455,30,64,0.469,5,13,0.385,15,23,0.652,90,30,84,0.357,26,65,0.4,4,19,0.211,13,20,0.65,77,2013-01-17,LAC,MIN,2013,79.0
11063,11063,63,@,W 90-85 ,240,34,81,0.42,31,63,0.492,3,18,0.167,19,26,0.731,90,37,84,0.44,33,70,0.471,4,14,0.286,7,11,0.636,85,2013-01-21,SAS,PHI,2013,87.0
11064,11064,64,@,L 90-95 ,240,32,84,0.381,25,67,0.373,7,17,0.412,19,22,0.864,90,37,82,0.451,35,70,0.5,2,12,0.167,19,22,0.864,95,2013-01-22,BOS,CLE,2013,96.0
11065,11065,65,@,L 90-105 ,240,38,84,0.452,30,64,0.469,8,20,0.4,6,8,0.75,90,42,91,0.462,35,68,0.515,7,23,0.304,14,21,0.667,105,2013-01-22,ORL,DET,2013,108.5
11066,11066,66,Home,L 90-117 ,240,34,84,0.405,32,73,0.438,2,11,0.182,20,28,0.714,90,46,98,0.469,35,75,0.467,11,23,0.478,14,22,0.636,117,2013-01-29,DET,MIL,2013,122.5
11067,11067,67,Home,L 90-96 ,240,33,76,0.434,28,57,0.491,5,19,0.263,19,27,0.704,90,35,76,0.461,32,67,0.478,3,9,0.333,23,36,0.639,96,2013-01-30,MIN,LAC,2013,97.5
11068,11068,68,@,L 90-98 ,240,37,79,0.468,33,62,0.532,4,17,0.235,12,15,0.8,90,37,84,0.44,30,72,0.417,7,12,0.583,17,27,0.63,98,2013-02-04,LAC,WAS,2013,101.5
11069,11069,69,Home,L 90-96 ,240,36,82,0.439,33,73,0.452,3,9,0.333,15,17,0.882,90,37,73,0.507,33,63,0.524,4,10,0.4,18,22,0.818,96,2013-02-05,MEM,PHO,2013,98.0
11070,11070,70,Home,L 90-93 ,240,36,83,0.434,33,66,0.5,3,17,0.176,15,21,0.714,90,34,82,0.415,28,66,0.424,6,16,0.375,19,25,0.76,93,2013-02-06,DET,BRK,2013,96.0
11071,11071,71,Home,L 90-102 ,240,36,95,0.379,31,72,0.431,5,23,0.217,13,22,0.591,90,42,74,0.568,38,62,0.613,4,12,0.333,14,17,0.824,102,2013-02-11,MIL,WAS,2013,104.0
11072,11072,72,Home,L 90-107 ,240,35,84,0.417,26,66,0.394,9,18,0.5,11,16,0.688,90,44,75,0.587,36,56,0.643,8,19,0.421,11,22,0.5,107,2013-02-11,PHI,LAC,2013,111.0
11073,11073,73,@,L 90-97 ,240,35,79,0.443,28,59,0.475,7,20,0.35,13,16,0.813,90,33,77,0.429,26,57,0.456,7,20,0.35,24,36,0.667,97,2013-02-19,BOS,DEN,2013,100.5
11074,11074,74,Home,L 90-103 ,240,36,72,0.5,29,46,0.63,7,26,0.269,11,16,0.688,90,37,78,0.474,27,55,0.491,10,23,0.435,19,25,0.76,103,2013-02-20,ATL,MIA,2013,108.0
11075,11075,75,Home,L 90-116 ,240,32,76,0.421,27,60,0.45,5,16,0.313,21,25,0.84,90,43,73,0.589,35,56,0.625,8,17,0.471,22,28,0.786,116,2013-02-21,LAC,SAS,2013,120.0
11076,11076,76,@,W 90-72 ,240,34,75,0.453,26,53,0.491,8,22,0.364,14,19,0.737,90,26,77,0.338,24,63,0.381,2,14,0.143,18,24,0.75,72,2013-02-23,IND,DET,2013,73.0
11077,11077,77,Home,L 90-114 ,240,35,78,0.449,24,50,0.48,11,28,0.393,9,10,0.9,90,45,77,0.584,36,56,0.643,9,21,0.429,15,18,0.833,114,2013-02-23,PHI,MIA,2013,118.5
11078,11078,78,@,W 90-84 ,240,34,81,0.42,27,69,0.391,7,12,0.583,15,17,0.882,90,29,79,0.367,24,60,0.4,5,19,0.263,21,27,0.778,84,2013-02-25,WAS,TOR,2013,86.5
11079,11079,79,Home,L 90-95 ,240,36,85,0.424,35,68,0.515,1,17,0.059,17,21,0.81,90,34,82,0.415,27,64,0.422,7,18,0.389,20,26,0.769,95,2013-02-26,DAL,MIL,2013,98.5
11080,11080,80,Home,W 90-84 ,240,29,78,0.372,24,64,0.375,5,14,0.357,27,34,0.794,90,33,76,0.434,30,64,0.469,3,12,0.25,15,19,0.789,84,2013-02-27,MEM,DAL,2013,85.5
11081,11081,81,Home,L 90-98 ,240,36,78,0.462,29,55,0.527,7,23,0.304,11,14,0.786,90,39,78,0.5,30,57,0.526,9,21,0.429,11,14,0.786,98,2013-03-01,BRK,DAL,2013,102.5
11082,11082,82,Home,W 90-87 ,240,34,80,0.425,28,65,0.431,6,15,0.4,16,21,0.762,90,33,85,0.388,27,66,0.409,6,19,0.316,15,20,0.75,87,2013-03-03,WAS,PHI,2013,90.0
11083,11083,83,Home,W 90-81 ,240,39,86,0.453,34,60,0.567,5,26,0.192,7,14,0.5,90,33,89,0.371,29,73,0.397,4,16,0.25,11,12,0.917,81,2013-03-10,LAL,CHI,2013,83.0
11084,11084,84,@,L 90-103 ,240,34,80,0.425,27,60,0.45,7,20,0.35,15,18,0.833,90,42,81,0.519,36,65,0.554,6,16,0.375,13,15,0.867,103,2013-03-11,DET,UTA,2013,106.0
11085,11085,85,@,L 90-95 ,240,31,76,0.408,26,59,0.441,5,17,0.294,23,28,0.821,90,34,83,0.41,26,57,0.456,8,26,0.308,19,25,0.76,95,2013-03-12,WAS,CLE,2013,99.0
11086,11086,86,@,L 90-105 ,240,36,82,0.439,29,57,0.509,7,25,0.28,11,17,0.647,90,40,78,0.513,30,50,0.6,10,28,0.357,15,21,0.714,105,2013-03-14,NYK,POR,2013,110.0
11087,11087,87,Home,W 90-84 ,240,31,71,0.437,26,55,0.473,5,16,0.313,23,31,0.742,90,33,77,0.429,29,65,0.446,4,12,0.333,14,22,0.636,84,2013-03-16,UTA,MEM,2013,86.0
11088,11088,88,Home,L 90-111 ,240,35,92,0.38,29,68,0.426,6,24,0.25,14,21,0.667,90,39,88,0.443,31,66,0.47,8,22,0.364,25,29,0.862,111,2013-03-18,CLE,IND,2013,115.0
11089,11089,89,@,W 90-83 ,240,32,69,0.464,24,46,0.522,8,23,0.348,18,25,0.72,90,29,76,0.382,20,57,0.351,9,19,0.474,16,24,0.667,83,2013-03-18,NYK,UTA,2013,87.5
11090,11090,90,@,L 90-98 ,240,37,99,0.374,29,80,0.363,8,19,0.421,8,11,0.727,90,38,79,0.481,30,61,0.492,8,18,0.444,14,17,0.824,98,2013-03-20,MIL,ATL,2013,102.0
11091,11091,91,Home,W 90-89 (OT),265,32,89,0.36,26,74,0.351,6,15,0.4,20,24,0.833,90,30,84,0.357,28,66,0.424,2,18,0.111,27,32,0.844,89,2013-03-20,MEM,OKC,2013,90.0
11092,11092,92,Home,W 90-83 ,240,36,76,0.474,32,62,0.516,4,14,0.286,14,18,0.778,90,30,73,0.411,27,63,0.429,3,10,0.3,20,25,0.8,83,2013-03-22,NOP,MEM,2013,84.5
11093,11093,93,@,L 90-92 ,240,36,75,0.48,28,52,0.538,8,23,0.348,10,11,0.909,90,36,79,0.456,34,72,0.472,2,7,0.286,18,24,0.75,92,2013-04-01,SAS,MEM,2013,93.0
11094,11094,94,Home,L 90-102 ,240,30,60,0.5,22,40,0.55,8,20,0.4,22,27,0.815,90,37,71,0.521,23,44,0.523,14,27,0.519,14,20,0.7,102,2013-04-02,MIA,NYK,2013,109.0
11095,11095,95,Home,W 90-86 ,240,33,78,0.423,27,65,0.415,6,13,0.462,18,26,0.692,90,35,89,0.393,30,66,0.455,5,23,0.217,11,16,0.688,86,2013-04-02,WAS,CHI,2013,88.5
11096,11096,96,Home,L 90-92 ,240,31,70,0.443,26,57,0.456,5,13,0.385,23,30,0.767,90,38,82,0.463,34,71,0.479,4,11,0.364,12,19,0.632,92,2013-04-04,BRK,CHI,2013,94.0
11097,11097,97,Home,L 90-101 ,240,34,73,0.466,29,56,0.518,5,17,0.294,17,27,0.63,90,37,80,0.463,28,64,0.438,9,16,0.563,18,24,0.75,101,2013-04-05,ATL,PHI,2013,105.5
11098,11098,98,Home,L 90-97 ,240,35,74,0.473,28,57,0.491,7,17,0.412,13,18,0.722,90,40,88,0.455,29,63,0.46,11,25,0.44,6,7,0.857,97,2013-04-07,GSW,UTA,2013,102.5
11099,11099,99,@,W 90-80 ,240,32,81,0.395,23,60,0.383,9,21,0.429,17,18,0.944,90,31,79,0.392,24,54,0.444,7,25,0.28,11,14,0.786,80,2013-04-09,OKC,UTA,2013,83.5
11100,11100,0,Home,L 90-106 ,240,36,88,0.409,30,68,0.441,6,20,0.3,12,18,0.667,90,40,77,0.519,31,55,0.564,9,22,0.409,17,21,0.81,106,2013-04-12,POR,OKC,2013,110.5
11101,11101,1,Home,W 90-80 ,240,35,82,0.427,24,51,0.471,11,31,0.355,9,11,0.818,90,28,65,0.431,20,37,0.541,8,28,0.286,16,26,0.615,80,2013-04-14,NYK,IND,2013,84.0
11102,11102,2,@,L 90-114 ,240,37,84,0.44,30,67,0.448,7,17,0.412,9,13,0.692,90,40,80,0.5,28,59,0.475,12,21,0.571,22,28,0.786,114,2013-04-17,BOS,TOR,2013,120.0
11103,11103,3,Home,L 90-95 ,240,34,85,0.4,29,74,0.392,5,11,0.455,17,21,0.81,90,30,70,0.429,20,47,0.426,10,23,0.435,25,30,0.833,95,2013-10-30,NOP,IND,2014,100.0
11104,11104,4,Home,W 90-83 ,240,36,71,0.507,33,58,0.569,3,13,0.231,15,17,0.882,90,34,74,0.459,29,58,0.5,5,16,0.313,10,12,0.833,83,2013-10-30,NYK,MIL,2014,85.5
11105,11105,5,Home,W 90-88 ,240,33,81,0.407,25,60,0.417,8,21,0.381,16,23,0.696,90,34,79,0.43,29,64,0.453,5,15,0.333,15,17,0.882,88,2013-10-30,SAC,DEN,2014,90.5
11106,11106,6,Home,W 90-84 ,240,33,73,0.452,30,61,0.492,3,12,0.25,21,34,0.618,90,32,84,0.381,28,66,0.424,4,18,0.222,16,22,0.727,84,2013-11-01,CHA,CLE,2014,86.0
11107,11107,7,@,L 90-110 ,240,32,92,0.348,26,80,0.325,6,12,0.5,20,26,0.769,90,39,70,0.557,28,48,0.583,11,22,0.5,21,27,0.778,110,2013-11-01,NOP,ORL,2014,115.5
11108,11108,8,Home,L 90-97 ,240,37,84,0.44,31,67,0.463,6,17,0.353,10,18,0.556,90,31,78,0.397,24,55,0.436,7,23,0.304,28,38,0.737,97,2013-11-02,MIL,TOR,2014,100.5
11109,11109,9,Home,L 90-110 ,240,31,88,0.352,26,63,0.413,5,25,0.2,23,37,0.622,90,41,92,0.446,26,54,0.481,15,38,0.395,13,20,0.65,110,2013-11-04,PHI,GSW,2014,117.5
11110,11110,10,@,L 90-92 ,240,35,79,0.443,28,63,0.444,7,16,0.438,13,15,0.867,90,36,73,0.493,33,58,0.569,3,15,0.2,17,30,0.567,92,2013-11-06,TOR,CHA,2014,93.5
11111,11111,11,@,L 90-98 ,240,36,95,0.379,33,76,0.434,3,19,0.158,15,21,0.714,90,40,82,0.488,35,66,0.53,5,16,0.313,13,17,0.765,98,2013-11-06,LAC,ORL,2014,100.5
11112,11112,12,@,L 90-108 ,240,33,78,0.423,23,48,0.479,10,30,0.333,14,26,0.538,90,42,79,0.532,37,66,0.561,5,13,0.385,19,25,0.76,108,2013-11-09,GSW,MEM,2014,110.5
11113,11113,13,Home,L 90-113 ,240,35,92,0.38,25,66,0.379,10,26,0.385,10,18,0.556,90,44,90,0.489,34,70,0.486,10,20,0.5,15,19,0.789,113,2013-11-10,LAL,MIN,2014,118.0
11114,11114,14,Home,W 90-89 ,240,35,84,0.417,29,69,0.42,6,15,0.4,14,23,0.609,90,37,86,0.43,32,71,0.451,5,15,0.333,10,13,0.769,89,2013-11-13,POR,PHO,2014,91.5
11115,11115,15,Home,L 90-97 ,240,34,80,0.425,24,55,0.436,10,25,0.4,12,17,0.706,90,38,85,0.447,32,62,0.516,6,23,0.261,15,24,0.625,97,2013-11-15,SAC,DET,2014,100.0
11116,11116,16,Home,L 90-110 ,240,34,90,0.378,24,60,0.4,10,30,0.333,12,16,0.75,90,44,78,0.564,35,56,0.625,9,22,0.409,13,17,0.765,110,2013-11-16,NYK,ATL,2014,114.5
11117,11117,17,@,W 90-83 ,240,36,76,0.474,27,54,0.5,9,22,0.409,9,13,0.692,90,28,73,0.384,20,43,0.465,8,30,0.267,19,32,0.594,83,2013-11-29,MIA,TOR,2014,87.0
11118,11118,18,@,W 90-82 ,240,34,74,0.459,29,56,0.518,5,18,0.278,17,23,0.739,90,30,73,0.411,23,53,0.434,7,20,0.35,15,22,0.682,82,2013-12-07,BRK,MIL,2014,85.5
11119,11119,19,Home,W 90-84 ,240,34,67,0.507,29,52,0.558,5,15,0.333,17,25,0.68,90,33,77,0.429,29,56,0.518,4,21,0.19,14,20,0.7,84,2013-12-10,IND,MIA,2014,86.0
11120,11120,20,Home,W 90-86 ,240,33,68,0.485,26,47,0.553,7,21,0.333,17,25,0.68,90,32,80,0.4,27,59,0.458,5,21,0.238,17,19,0.895,86,2013-12-13,BOS,NYK,2014,88.5
11121,11121,21,Home,L 90-91 ,240,33,74,0.446,29,64,0.453,4,10,0.4,20,25,0.8,90,34,81,0.42,27,57,0.474,7,24,0.292,16,19,0.842,91,2013-12-13,MIL,CHI,2014,94.5
11122,11122,22,@,L 90-117 ,240,30,81,0.37,24,61,0.393,6,20,0.3,24,37,0.649,90,42,90,0.467,28,58,0.483,14,32,0.438,19,25,0.76,117,2013-12-23,LAL,PHO,2014,124.0
11123,11123,23,@,L 90-98 ,240,32,76,0.421,25,57,0.439,7,19,0.368,19,21,0.905,90,35,77,0.455,32,63,0.508,3,14,0.214,25,32,0.781,98,2013-12-28,UTA,LAC,2014,99.5
11124,11124,24,@,L 90-112 ,240,39,93,0.419,32,74,0.432,7,19,0.368,5,8,0.625,90,40,76,0.526,31,56,0.554,9,20,0.45,23,26,0.885,112,2014-01-08,DAL,SAS,2014,116.5
11125,11125,25,Home,L 90-107 ,240,36,80,0.45,33,73,0.452,3,7,0.429,15,19,0.789,90,41,78,0.526,27,50,0.54,14,28,0.5,11,16,0.688,107,2014-01-10,NOP,DAL,2014,114.0
11126,11126,26,Home,W 90-87 ,240,32,80,0.4,28,66,0.424,4,14,0.286,22,27,0.815,90,33,81,0.407,28,60,0.467,5,21,0.238,16,20,0.8,87,2014-01-14,MEM,OKC,2014,89.5
11127,11127,27,@,L 90-91 ,240,33,81,0.407,28,70,0.4,5,11,0.455,19,23,0.826,90,36,78,0.462,30,61,0.492,6,17,0.353,13,18,0.722,91,2014-01-17,SAC,MEM,2014,94.0
11128,11128,28,@,L 90-101 ,240,33,72,0.458,26,53,0.491,7,19,0.368,17,23,0.739,90,40,81,0.494,30,53,0.566,10,28,0.357,11,13,0.846,101,2014-01-21,ORL,BRK,2014,106.0
11129,11129,29,Home,L 90-99 ,240,34,86,0.395,29,70,0.414,5,16,0.313,17,24,0.708,90,34,82,0.415,25,55,0.455,9,27,0.333,22,28,0.786,99,2014-01-26,CLE,PHO,2014,103.5
11130,11130,30,@,L 90-97 ,240,35,82,0.427,29,59,0.492,6,23,0.261,14,21,0.667,90,33,75,0.44,28,57,0.491,5,18,0.278,26,47,0.553,97,2014-01-28,SAS,HOU,2014,99.5
11131,11131,31,Home,L 90-100 ,240,36,80,0.45,28,59,0.475,8,21,0.381,10,14,0.714,90,37,85,0.435,29,64,0.453,8,21,0.381,18,20,0.9,100,2014-01-31,DEN,TOR,2014,104.0
11132,11132,32,Home,L 90-94 ,240,39,84,0.464,33,62,0.532,6,22,0.273,6,7,0.857,90,38,80,0.475,34,68,0.5,4,12,0.333,14,22,0.636,94,2014-01-31,MIN,MEM,2014,96.0
11133,11133,33,Home,L 90-95 ,240,35,73,0.479,32,64,0.5,3,9,0.333,17,21,0.81,90,33,88,0.375,23,62,0.371,10,26,0.385,19,24,0.792,95,2014-01-31,UTA,GSW,2014,100.0
11134,11134,34,@,L 90-99 ,240,30,76,0.395,21,53,0.396,9,23,0.391,21,25,0.84,90,38,79,0.481,32,69,0.464,6,10,0.6,17,22,0.773,99,2014-02-01,MIL,MEM,2014,102.0
11135,11135,35,@,L 90-100 ,240,37,81,0.457,32,62,0.516,5,19,0.263,11,12,0.917,90,37,84,0.44,30,67,0.448,7,17,0.412,19,22,0.864,100,2014-02-03,POR,WAS,2014,103.5
11136,11136,36,Home,L 90-94 ,240,36,90,0.4,32,69,0.464,4,21,0.19,14,20,0.7,90,30,79,0.38,22,58,0.379,8,21,0.381,26,33,0.788,94,2014-02-05,NYK,POR,2014,98.0
11137,11137,37,@,L 90-117 ,240,32,76,0.421,25,50,0.5,7,26,0.269,19,26,0.731,90,48,85,0.565,37,57,0.649,11,28,0.393,10,14,0.714,117,2014-02-07,DEN,NYK,2014,122.5
11138,11138,38,@,L 90-117 ,240,33,84,0.393,24,60,0.4,9,24,0.375,15,20,0.75,90,45,86,0.523,33,60,0.55,12,26,0.462,15,23,0.652,117,2014-02-12,DEN,MIN,2014,123.0
11139,11139,39,Home,L 90-101 ,240,35,82,0.427,31,61,0.508,4,21,0.19,16,20,0.8,90,39,76,0.513,31,58,0.534,8,18,0.444,15,26,0.577,101,2014-02-20,MIL,DEN,2014,105.0
11140,11140,40,Home,W 90-87 ,240,31,80,0.388,28,65,0.431,3,15,0.2,25,36,0.694,90,35,83,0.422,26,60,0.433,9,23,0.391,8,11,0.727,87,2014-02-21,CHA,NOP,2014,91.5
11141,11141,41,@,L 90-105 ,240,36,87,0.414,31,73,0.425,5,14,0.357,13,17,0.765,90,34,65,0.523,25,48,0.521,9,17,0.529,28,36,0.778,105,2014-02-23,ORL,TOR,2014,109.5
11142,11142,42,Home,L 90-101 ,240,32,87,0.368,27,65,0.415,5,22,0.227,21,28,0.75,90,39,94,0.415,30,76,0.395,9,18,0.5,14,16,0.875,101,2014-02-26,PHI,ORL,2014,105.5
11143,11143,43,@,L 90-109 ,240,35,79,0.443,30,61,0.492,5,18,0.278,15,18,0.833,90,39,84,0.464,31,62,0.5,8,22,0.364,23,33,0.697,109,2014-03-02,NYK,CHI,2014,113.0
11144,11144,44,@,L 90-99 ,240,36,89,0.404,24,58,0.414,12,31,0.387,6,9,0.667,90,40,80,0.5,30,59,0.508,10,21,0.476,9,9,1.0,99,2014-03-10,WAS,MIA,2014,104.0
11145,11145,45,@,W 90-88 ,240,32,74,0.432,28,56,0.5,4,18,0.222,22,27,0.815,90,31,75,0.413,27,57,0.474,4,18,0.222,22,22,1.0,88,2014-03-12,MEM,NOP,2014,90.0
11146,11146,46,@,L 90-103 ,240,32,83,0.386,28,62,0.452,4,21,0.19,22,30,0.733,90,38,88,0.432,27,64,0.422,11,24,0.458,16,22,0.727,103,2014-03-12,POR,SAS,2014,108.5
11147,11147,47,@,L 90-99 ,240,35,81,0.432,26,58,0.448,9,23,0.391,11,20,0.55,90,31,81,0.383,25,63,0.397,6,18,0.333,31,38,0.816,99,2014-03-17,PHI,IND,2014,102.0
11148,11148,48,Home,L 90-99 ,240,31,77,0.403,28,62,0.452,3,15,0.2,25,29,0.862,90,35,89,0.393,25,61,0.41,10,28,0.357,19,25,0.76,99,2014-03-22,GSW,SAS,2014,104.0
11149,11149,49,Home,L 90-99 ,240,32,79,0.405,23,57,0.404,9,22,0.409,17,22,0.773,90,36,80,0.45,25,57,0.439,11,23,0.478,16,18,0.889,99,2014-03-26,BOS,TOR,2014,104.5
11150,11150,50,Home,W 90-76 ,240,34,76,0.447,29,62,0.468,5,14,0.357,17,21,0.81,90,29,78,0.372,21,56,0.375,8,22,0.364,10,16,0.625,76,2014-03-30,CLE,IND,2014,80.0
11151,11151,51,@,L 90-111 ,240,36,85,0.424,28,64,0.438,8,21,0.381,10,10,1.0,90,44,83,0.53,40,64,0.625,4,19,0.211,19,22,0.864,111,2014-04-02,GSW,SAS,2014,113.0
11152,11152,52,@,L 90-102 ,240,31,68,0.456,29,60,0.483,2,8,0.25,26,35,0.743,90,31,84,0.369,24,62,0.387,7,22,0.318,33,42,0.786,102,2014-04-04,MIL,CHI,2014,105.5
11153,11153,53,@,W 90-89 ,240,38,78,0.487,33,59,0.559,5,19,0.263,9,15,0.6,90,34,76,0.447,20,45,0.444,14,31,0.452,7,8,0.875,89,2014-04-04,WAS,NYK,2014,96.0
11154,11154,54,Home,L 90-102 ,240,35,80,0.438,24,53,0.453,11,27,0.407,9,11,0.818,90,42,88,0.477,34,73,0.466,8,15,0.533,10,13,0.769,102,2014-04-13,LAL,MEM,2014,106.0
11155,11155,55,Home,L 90-108 ,240,28,79,0.354,25,69,0.362,3,10,0.3,31,39,0.795,90,31,73,0.425,19,44,0.432,12,29,0.414,34,50,0.68,108,2014-10-28,LAL,HOU,2015,114.0
11156,11156,56,Home,L 90-95 ,240,32,70,0.457,23,46,0.5,9,24,0.375,17,20,0.85,90,37,69,0.536,31,57,0.544,6,12,0.5,15,18,0.833,95,2014-10-30,CLE,NYK,2015,98.0
11157,11157,57,@,L 90-93 ,240,28,65,0.431,22,44,0.5,6,21,0.286,28,34,0.824,90,34,87,0.391,27,57,0.474,7,30,0.233,18,25,0.72,93,2014-10-30,OKC,LAC,2015,96.5
11158,11158,58,Home,L 90-102 ,240,32,76,0.421,31,59,0.525,1,17,0.059,25,35,0.714,90,42,87,0.483,35,61,0.574,7,26,0.269,11,13,0.846,102,2014-11-01,DET,BRK,2015,105.5
11159,11159,59,@,L 90-104 ,240,37,98,0.378,36,73,0.493,1,25,0.04,15,18,0.833,90,32,76,0.421,20,42,0.476,12,34,0.353,28,40,0.7,104,2014-11-01,BOS,HOU,2015,110.0
11160,11160,60,Home,L 90-95 ,240,37,92,0.402,30,65,0.462,7,27,0.259,9,14,0.643,90,36,81,0.444,30,62,0.484,6,19,0.316,17,21,0.81,95,2014-11-02,POR,GSW,2015,98.0
11161,11161,61,@,L 90-98 ,240,38,88,0.432,32,74,0.432,6,14,0.429,8,14,0.571,90,35,75,0.467,28,60,0.467,7,15,0.467,21,27,0.778,98,2014-11-04,ORL,CHI,2015,101.5
11162,11162,62,Home,L 90-97 ,240,33,77,0.429,25,53,0.472,8,24,0.333,16,25,0.64,90,39,81,0.481,37,70,0.529,2,11,0.182,17,23,0.739,97,2014-11-08,IND,WAS,2015,98.0
11163,11163,63,Home,L 90-99 ,240,35,83,0.422,31,66,0.47,4,17,0.235,16,23,0.696,90,37,77,0.481,30,59,0.508,7,18,0.389,18,25,0.72,99,2014-11-15,CHI,IND,2015,102.5
11164,11164,64,Home,L 90-92 ,240,37,83,0.446,30,65,0.462,7,18,0.389,9,13,0.692,90,35,74,0.473,30,58,0.517,5,16,0.313,17,25,0.68,92,2014-11-19,CLE,SAS,2015,94.5
11165,11165,65,Home,L 90-114 ,240,34,86,0.395,26,62,0.419,8,24,0.333,14,18,0.778,90,45,84,0.536,33,63,0.524,12,21,0.571,12,16,0.75,114,2014-11-19,ORL,LAC,2015,120.0
11166,11166,66,Home,L 90-101 ,240,34,86,0.395,27,65,0.415,7,21,0.333,15,21,0.714,90,41,83,0.494,35,63,0.556,6,20,0.3,13,21,0.619,101,2014-11-19,PHI,BOS,2015,104.0
11167,11167,67,Home,L 90-93 ,240,34,85,0.4,27,59,0.458,7,26,0.269,15,18,0.833,90,35,76,0.461,30,61,0.492,5,15,0.333,18,25,0.72,93,2014-11-30,PHO,ORL,2015,95.5
11168,11168,68,@,W 90-87 ,240,32,70,0.457,27,52,0.519,5,18,0.278,21,26,0.808,90,37,88,0.42,29,62,0.468,8,26,0.308,5,6,0.833,87,2014-12-04,CLE,NYK,2015,91.0
11169,11169,69,Home,W 90-82 ,240,32,81,0.395,31,69,0.449,1,12,0.083,25,33,0.758,90,31,80,0.388,21,45,0.467,10,35,0.286,10,12,0.833,82,2014-12-10,MIN,POR,2015,87.0
11170,11170,70,Home,L 90-95 ,240,33,93,0.355,22,64,0.344,11,29,0.379,13,19,0.684,90,35,79,0.443,29,59,0.492,6,20,0.3,19,23,0.826,95,2014-12-13,SAC,DET,2015,98.0
11171,11171,71,Home,L 90-95 (OT),265,29,78,0.372,20,49,0.408,9,29,0.31,23,28,0.821,90,36,78,0.462,27,54,0.5,9,24,0.375,14,18,0.778,95,2014-12-14,NYK,TOR,2015,99.5
11172,11172,72,Home,L 90-99 ,240,33,86,0.384,27,61,0.443,6,25,0.24,18,23,0.783,90,38,82,0.463,33,64,0.516,5,18,0.278,18,22,0.818,99,2014-12-18,HOU,NOP,2015,101.5
11173,11173,73,Home,L 90-99 ,240,35,88,0.398,28,66,0.424,7,22,0.318,13,16,0.813,90,35,78,0.449,25,53,0.472,10,25,0.4,19,23,0.826,99,2014-12-20,NYK,PHO,2015,104.0
11174,11174,74,@,L 90-97 ,240,37,75,0.493,31,61,0.508,6,14,0.429,10,14,0.714,90,35,84,0.417,29,67,0.433,6,17,0.353,21,24,0.875,97,2014-12-26,SAS,NOP,2015,100.0
11175,11175,75,@,W 90-85 ,240,33,90,0.367,24,61,0.393,9,29,0.31,15,19,0.789,90,31,80,0.388,19,50,0.38,12,30,0.4,11,14,0.786,85,2014-12-27,ATL,MIL,2015,91.0
11176,11176,76,Home,L 90-92 ,240,36,83,0.434,31,70,0.443,5,13,0.385,13,21,0.619,90,29,84,0.345,24,71,0.338,5,13,0.385,29,33,0.879,92,2014-12-29,IND,CHI,2015,94.5
11177,11177,77,Home,L 90-98 ,240,33,87,0.379,29,68,0.426,4,19,0.211,20,21,0.952,90,35,78,0.449,31,62,0.5,4,16,0.25,24,32,0.75,98,2015-01-03,ORL,CHO,2015,100.0
11178,11178,78,Home,L 90-109 ,240,35,86,0.407,27,61,0.443,8,25,0.32,12,17,0.706,90,44,78,0.564,32,52,0.615,12,26,0.462,9,11,0.818,109,2015-01-04,CLE,DAL,2015,115.0
11179,11179,79,@,L 90-93 ,240,35,88,0.398,27,66,0.409,8,22,0.364,12,16,0.75,90,33,74,0.446,26,57,0.456,7,17,0.412,20,26,0.769,93,2015-01-07,ORL,DEN,2015,96.5
11180,11180,80,@,W 90-88 ,240,36,79,0.456,28,62,0.452,8,17,0.471,10,17,0.588,90,33,73,0.452,30,57,0.526,3,16,0.188,19,27,0.704,88,2015-01-09,PHI,BRK,2015,89.5
11181,11181,81,Home,L 90-104 ,240,34,75,0.453,25,49,0.51,9,26,0.346,13,18,0.722,90,39,81,0.481,33,60,0.55,6,21,0.286,20,24,0.833,104,2015-01-11,LAC,MIA,2015,107.0
11182,11182,82,Home,L 90-99 ,240,36,82,0.439,32,65,0.492,4,17,0.235,14,18,0.778,90,40,77,0.519,35,61,0.574,5,16,0.313,14,27,0.519,99,2015-01-17,BRK,WAS,2015,101.5
11183,11183,83,@,W 90-89 ,240,39,87,0.448,32,68,0.471,7,19,0.368,5,7,0.714,90,33,89,0.371,24,61,0.393,9,28,0.321,14,19,0.737,89,2015-01-22,BOS,POR,2015,93.5
11184,11184,84,@,L 90-129 ,240,36,89,0.404,34,73,0.466,2,16,0.125,16,24,0.667,90,46,89,0.517,31,61,0.508,15,28,0.536,22,28,0.786,129,2015-01-23,CHA,CLE,2015,136.5
11185,11185,85,Home,L 90-99 ,240,35,82,0.427,26,58,0.448,9,24,0.375,11,19,0.579,90,35,74,0.473,27,55,0.491,8,19,0.421,21,23,0.913,99,2015-01-26,UTA,BOS,2015,103.0
11186,11186,86,Home,L 90-109 ,240,38,78,0.487,31,52,0.596,7,26,0.269,7,10,0.7,90,42,79,0.532,32,58,0.552,10,21,0.476,15,20,0.75,109,2015-01-27,DAL,MEM,2015,114.0
11187,11187,87,@,L 90-101 ,240,30,84,0.357,27,66,0.409,3,18,0.167,27,32,0.844,90,38,80,0.475,27,49,0.551,11,31,0.355,14,22,0.636,101,2015-01-30,SAC,CLE,2015,106.5
11188,11188,88,Home,L 90-106 ,240,34,82,0.415,28,69,0.406,6,13,0.462,16,21,0.762,90,42,87,0.483,32,55,0.582,10,32,0.313,12,19,0.632,106,2015-01-31,MIN,CLE,2015,111.0
11189,11189,89,@,L 90-101 ,240,31,89,0.348,23,64,0.359,8,25,0.32,20,26,0.769,90,38,92,0.413,30,65,0.462,8,27,0.296,17,23,0.739,101,2015-02-04,CHI,HOU,2015,105.0
11190,11190,90,Home,L 90-100 ,240,33,73,0.452,26,50,0.52,7,23,0.304,17,26,0.654,90,38,80,0.475,32,67,0.478,6,13,0.462,18,22,0.818,100,2015-02-04,UTA,MEM,2015,103.0
11191,11191,91,Home,W 90-89 ,240,35,81,0.432,30,64,0.469,5,17,0.294,15,17,0.882,90,36,69,0.522,34,57,0.596,2,12,0.167,15,20,0.75,89,2015-02-06,MIN,MEM,2015,90.0
11192,11192,92,@,L 90-102 ,240,32,82,0.39,29,69,0.42,3,13,0.231,23,33,0.697,90,43,86,0.5,38,67,0.567,5,19,0.263,11,17,0.647,102,2015-02-07,SAC,UTA,2015,104.5
11193,11193,93,@,W 90-87 ,240,33,81,0.407,28,66,0.424,5,15,0.333,19,26,0.731,90,35,79,0.443,26,52,0.5,9,27,0.333,8,12,0.667,87,2015-02-23,MEM,LAC,2015,91.5
11194,11194,94,Home,W 90-81 ,240,34,83,0.41,30,68,0.441,4,15,0.267,18,23,0.783,90,32,79,0.405,27,60,0.45,5,19,0.263,12,21,0.571,81,2015-02-23,UTA,SAS,2015,83.5
11195,11195,95,Home,L 90-93 (OT),265,33,78,0.423,27,56,0.482,6,22,0.273,18,31,0.581,90,32,84,0.381,26,53,0.491,6,31,0.194,23,32,0.719,93,2015-02-25,ORL,MIA,2015,96.0
11196,11196,96,@,L 90-102 ,240,34,84,0.405,30,68,0.441,4,16,0.25,18,23,0.783,90,39,80,0.488,33,64,0.516,6,16,0.375,18,25,0.72,102,2015-02-25,MEM,SAC,2015,105.0
11197,11197,97,@,L 90-97 ,240,39,84,0.464,34,72,0.472,5,12,0.417,7,9,0.778,90,34,77,0.442,33,66,0.5,1,11,0.091,28,33,0.848,97,2015-03-06,LAL,MEM,2015,97.5
11198,11198,98,Home,L 90-100 ,240,29,69,0.42,25,52,0.481,4,17,0.235,28,34,0.824,90,39,87,0.448,33,62,0.532,6,25,0.24,16,17,0.941,100,2015-03-09,MIA,BOS,2015,103.0
11199,11199,99,Home,L 90-108 ,240,38,70,0.543,35,58,0.603,3,12,0.25,11,14,0.786,90,42,84,0.5,29,53,0.547,13,31,0.419,11,16,0.688,108,2015-03-22,MIL,CLE,2015,114.5
11200,11200,0,Home,L 90-97 ,240,39,89,0.438,34,73,0.466,5,16,0.313,7,13,0.538,90,40,86,0.465,32,65,0.492,8,21,0.381,9,13,0.692,97,2015-04-04,MIL,ORL,2015,101.0
11201,11201,1,@,L 90-99 ,240,39,85,0.459,32,69,0.464,7,16,0.438,5,10,0.5,90,36,84,0.429,30,68,0.441,6,16,0.375,21,23,0.913,99,2015-04-04,NOP,POR,2015,102.0
11202,11202,2,Home,L 90-119 ,240,31,89,0.348,22,62,0.355,9,27,0.333,19,27,0.704,90,47,72,0.653,39,57,0.684,8,15,0.533,17,23,0.739,119,2015-04-08,PHI,WAS,2015,123.0
11203,11203,3,Home,L 90-99 ,240,32,77,0.416,23,43,0.535,9,34,0.265,17,25,0.68,90,38,84,0.452,30,62,0.484,8,22,0.364,15,21,0.714,99,2015-04-10,CLE,BOS,2015,103.0
11204,11204,4,Home,W 90-75 ,240,37,84,0.44,32,65,0.492,5,19,0.263,11,19,0.579,90,30,85,0.353,23,60,0.383,7,25,0.28,8,10,0.8,75,2015-04-10,NOP,PHO,2015,78.5
11205,11205,5,Home,L 90-100 ,240,34,83,0.41,21,51,0.412,13,32,0.406,9,17,0.529,90,35,85,0.412,26,50,0.52,9,35,0.257,21,26,0.808,100,2015-04-13,CHA,HOU,2015,104.5
11206,11206,6,@,L 90-101 ,240,38,83,0.458,30,60,0.5,8,23,0.348,6,9,0.667,90,39,96,0.406,35,75,0.467,4,21,0.19,19,27,0.704,101,2015-04-13,POR,OKC,2015,103.0
11207,11207,7,Home,L 90-112 ,240,33,77,0.429,26,58,0.448,7,19,0.368,17,27,0.63,90,41,81,0.506,31,55,0.564,10,26,0.385,20,27,0.741,112,2015-04-15,NYK,DET,2015,117.0
11208,11208,8,Home,L 90-101 ,240,33,79,0.418,25,49,0.51,8,30,0.267,16,28,0.571,90,39,94,0.415,28,62,0.452,11,32,0.344,12,16,0.75,101,2015-10-31,POR,PHO,2016,106.5
11209,11209,9,Home,W 90-87 ,240,36,80,0.45,31,65,0.477,5,15,0.333,13,24,0.542,90,36,81,0.444,30,61,0.492,6,20,0.3,9,13,0.692,87,2015-11-06,IND,MIA,2016,90.0
11210,11210,10,Home,W 90-82 ,240,30,82,0.366,23,55,0.418,7,27,0.259,23,29,0.793,90,29,88,0.33,20,61,0.328,9,27,0.333,15,18,0.833,82,2015-11-13,DAL,LAL,2016,86.5
11211,11211,11,@,W 90-84 ,240,33,78,0.423,27,50,0.54,6,28,0.214,18,31,0.581,90,29,79,0.367,20,52,0.385,9,27,0.333,17,21,0.81,84,2015-11-13,CLE,NYK,2016,88.5
11212,11212,12,Home,W 90-88 ,240,37,84,0.44,28,64,0.438,9,20,0.45,7,13,0.538,90,33,76,0.434,21,47,0.447,12,29,0.414,10,14,0.714,88,2015-11-17,BRK,ATL,2016,94.0
11213,11213,13,@,L 90-104 ,240,34,84,0.405,25,67,0.373,9,17,0.529,13,16,0.813,90,40,88,0.455,32,66,0.485,8,22,0.364,16,17,0.941,104,2015-11-20,SAS,NOP,2016,108.0
11214,11214,14,Home,L 90-93 ,240,35,92,0.38,32,63,0.508,3,29,0.103,17,23,0.739,90,33,72,0.458,21,52,0.404,12,20,0.6,15,23,0.652,93,2015-11-20,OKC,NYK,2016,99.0
11215,11215,15,Home,L 90-95 ,240,33,80,0.413,28,55,0.509,5,25,0.2,19,25,0.76,90,34,81,0.42,26,56,0.464,8,25,0.32,19,25,0.76,95,2015-11-27,CHA,CLE,2016,99.0
11216,11216,16,@,L 90-111 ,240,34,94,0.362,29,74,0.392,5,20,0.25,17,23,0.739,90,40,83,0.482,33,64,0.516,7,19,0.368,24,30,0.8,111,2015-11-27,NOP,LAC,2016,114.5
11217,11217,17,@,L 90-114 ,240,31,74,0.419,23,48,0.479,8,26,0.308,20,22,0.909,90,43,82,0.524,31,55,0.564,12,27,0.444,16,22,0.727,114,2015-11-27,MIL,ORL,2016,120.0
11218,11218,18,Home,W 90-88 ,240,35,87,0.402,26,60,0.433,9,27,0.333,11,17,0.647,90,33,81,0.407,29,64,0.453,4,17,0.235,18,24,0.75,88,2015-11-28,CLE,BRK,2016,90.0
11219,11219,19,@,L 90-99 ,240,36,93,0.387,31,78,0.397,5,15,0.333,13,22,0.591,90,36,89,0.404,30,72,0.417,6,17,0.353,21,27,0.778,99,2015-12-02,DEN,CHI,2016,102.0
11220,11220,20,Home,W 90-88 ,240,30,73,0.411,26,60,0.433,4,13,0.308,26,33,0.788,90,33,85,0.388,25,52,0.481,8,33,0.242,14,18,0.778,88,2015-12-07,MIL,POR,2016,92.0
11221,11221,21,Home,W 90-83 ,240,34,70,0.486,27,50,0.54,7,20,0.35,15,23,0.652,90,33,80,0.413,29,69,0.42,4,11,0.364,13,16,0.813,83,2015-12-11,TOR,MIL,2016,85.0
11222,11222,22,Home,L 90-94 ,240,33,78,0.423,25,50,0.5,8,28,0.286,16,24,0.667,90,37,79,0.468,31,62,0.5,6,17,0.353,14,16,0.875,94,2015-12-11,UTA,OKC,2016,97.0
11223,11223,23,@,L 90-106 ,240,29,79,0.367,19,51,0.373,10,28,0.357,22,26,0.846,90,41,86,0.477,31,64,0.484,10,22,0.455,14,16,0.875,106,2015-12-14,TOR,IND,2016,111.0
11224,11224,24,@,L 90-103 ,240,38,88,0.432,33,72,0.458,5,16,0.313,9,11,0.818,90,36,75,0.48,25,54,0.463,11,21,0.524,20,24,0.833,103,2015-12-16,MIL,LAC,2016,108.5
11225,11225,25,@,L 90-106 ,240,32,92,0.348,21,66,0.318,11,26,0.423,15,18,0.833,90,38,79,0.481,36,65,0.554,2,14,0.143,28,37,0.757,106,2015-12-16,POR,OKC,2016,107.0
11226,11226,26,Home,L 90-104 ,240,31,66,0.47,24,43,0.558,7,23,0.304,21,32,0.656,90,40,85,0.471,35,70,0.5,5,15,0.333,19,24,0.792,104,2015-12-22,PHI,MEM,2016,106.5
11227,11227,27,Home,L 90-111 ,240,34,81,0.42,28,67,0.418,6,14,0.429,16,18,0.889,90,42,81,0.519,29,52,0.558,13,29,0.448,14,19,0.737,111,2015-12-26,MIL,TOR,2016,117.5
11228,11228,28,@,L 90-99 (OT),265,35,79,0.443,24,50,0.48,11,29,0.379,9,18,0.5,90,38,87,0.437,34,72,0.472,4,15,0.267,19,20,0.95,99,2015-12-29,MIA,MEM,2016,101.0
11229,11229,29,@,L 90-115 ,240,35,86,0.407,30,72,0.417,5,14,0.357,15,19,0.789,90,41,86,0.477,27,51,0.529,14,35,0.4,19,28,0.679,115,2015-12-31,MIN,DET,2016,122.0
11230,11230,30,Home,L 90-109 ,240,29,84,0.345,23,62,0.371,6,22,0.273,26,34,0.765,90,35,79,0.443,26,56,0.464,9,23,0.391,30,37,0.811,109,2016-01-02,CHA,OKC,2016,113.5
11231,11231,31,Home,L 90-98 ,240,37,82,0.451,35,65,0.538,2,17,0.118,14,15,0.933,90,39,70,0.557,36,62,0.581,3,8,0.375,17,18,0.944,98,2016-01-06,MIA,NYK,2016,99.5
11232,11232,32,@,L 90-104 ,240,31,70,0.443,22,46,0.478,9,24,0.375,19,29,0.655,90,40,94,0.426,29,69,0.42,11,25,0.44,13,16,0.813,104,2016-01-13,MIA,LAC,2016,109.5
11233,11233,33,@,L 90-120 ,240,31,74,0.419,26,60,0.433,5,14,0.357,23,31,0.742,90,44,85,0.518,33,59,0.559,11,26,0.423,21,25,0.84,120,2016-01-25,SAS,GSW,2016,125.5
11234,11234,34,Home,L 90-92 ,240,30,74,0.405,23,49,0.469,7,25,0.28,23,28,0.821,90,33,76,0.434,27,51,0.529,6,25,0.24,20,26,0.769,92,2016-01-26,LAL,DAL,2016,95.0
11235,11235,35,@,L 90-103 ,240,35,75,0.467,33,65,0.508,2,10,0.2,18,26,0.692,90,40,76,0.526,30,51,0.588,10,25,0.4,13,16,0.813,103,2016-01-29,MIN,UTA,2016,108.0
11236,11236,36,Home,L 90-93 ,240,34,87,0.391,26,67,0.388,8,20,0.4,14,19,0.737,90,37,88,0.42,35,73,0.479,2,15,0.133,17,23,0.739,93,2016-02-03,DAL,MIA,2016,94.0
11237,11237,37,Home,L 90-116 ,240,33,73,0.452,30,58,0.517,3,15,0.2,21,27,0.778,90,41,80,0.513,29,58,0.5,12,22,0.545,22,25,0.88,116,2016-02-05,DAL,SAS,2016,122.0
11238,11238,38,Home,L 90-109 ,240,33,71,0.465,22,49,0.449,11,22,0.5,13,19,0.684,90,45,86,0.523,36,66,0.545,9,20,0.45,10,12,0.833,109,2016-02-10,BRK,MEM,2016,113.5
11239,11239,39,Home,L 90-113 ,240,38,86,0.442,33,72,0.458,5,14,0.357,9,12,0.75,90,43,90,0.478,30,57,0.526,13,33,0.394,14,15,0.933,113,2016-02-10,CHI,ATL,2016,119.5
11240,11240,40,@,L 90-100 ,240,36,91,0.396,29,73,0.397,7,18,0.389,11,17,0.647,90,39,78,0.5,29,53,0.547,10,25,0.4,12,15,0.8,100,2016-03-07,MIL,CHI,2016,105.0
11241,11241,41,Home,L 90-109 ,240,30,81,0.37,26,56,0.464,4,25,0.16,26,32,0.813,90,39,83,0.47,27,51,0.529,12,32,0.375,19,29,0.655,109,2016-03-07,DAL,LAC,2016,115.0
11242,11242,42,Home,L 90-114 ,240,32,79,0.405,22,47,0.468,10,32,0.313,16,19,0.842,90,41,84,0.488,23,47,0.489,18,37,0.486,14,20,0.7,114,2016-03-13,LAC,CLE,2016,123.0
11243,11243,43,@,W 90-87 ,240,33,75,0.44,28,54,0.519,5,21,0.238,19,27,0.704,90,34,85,0.4,31,69,0.449,3,16,0.188,16,21,0.762,87,2016-03-13,NYK,LAL,2016,88.5
11244,11244,44,Home,L 90-95 ,240,31,86,0.36,25,63,0.397,6,23,0.261,22,26,0.846,90,32,89,0.36,24,59,0.407,8,30,0.267,23,26,0.885,95,2016-03-18,LAL,PHO,2016,99.0
11245,11245,45,@,L 90-101 ,240,35,84,0.417,32,71,0.451,3,13,0.231,17,26,0.654,90,41,97,0.423,36,65,0.554,5,32,0.156,14,17,0.824,101,2016-03-25,MIL,ATL,2016,103.5
11246,11246,46,@,L 90-105 ,240,37,94,0.394,30,65,0.462,7,29,0.241,9,13,0.692,90,38,80,0.475,28,52,0.538,10,28,0.357,19,26,0.731,105,2016-03-27,DEN,LAC,2016,110.0
11247,11247,47,@,L 90-114 ,240,31,89,0.348,24,70,0.343,7,19,0.368,21,27,0.778,90,44,84,0.524,33,59,0.559,11,25,0.44,15,18,0.833,114,2016-03-28,BOS,LAC,2016,119.5
11248,11248,48,Home,L 90-94 ,240,34,88,0.386,25,63,0.397,9,25,0.36,13,15,0.867,90,32,76,0.421,22,56,0.393,10,20,0.5,20,34,0.588,94,2016-04-02,CHI,DET,2016,99.0
11249,11249,49,@,L 90-103 ,240,30,81,0.37,18,50,0.36,12,31,0.387,18,30,0.6,90,39,95,0.411,28,61,0.459,11,34,0.324,14,19,0.737,103,2016-04-05,PHO,ATL,2016,108.5
11250,11250,50,@,L 90-96 ,240,32,88,0.364,21,53,0.396,11,35,0.314,15,21,0.714,90,34,78,0.436,28,55,0.509,6,23,0.261,22,31,0.71,96,2016-04-05,CHA,TOR,2016,99.0
11251,11251,51,@,L 90-102 ,240,36,80,0.45,26,53,0.491,10,27,0.37,8,9,0.889,90,41,80,0.513,35,61,0.574,6,19,0.316,14,20,0.7,102,2016-04-12,NYK,IND,2016,105.0
11252,11252,52,@,L 90-94 ,240,37,84,0.44,33,69,0.478,4,15,0.267,12,21,0.571,90,33,82,0.402,25,67,0.373,8,15,0.533,20,27,0.741,94,2016-11-14,MIA,SAS,2017,98.0
11253,11253,53,Home,L 90-93 ,240,36,89,0.404,29,66,0.439,7,23,0.304,11,14,0.786,90,37,80,0.463,31,63,0.492,6,17,0.353,13,19,0.684,93,2016-11-15,MIA,ATL,2017,96.0
11254,11254,54,Home,W 90-83 ,240,33,76,0.434,26,55,0.473,7,21,0.333,17,23,0.739,90,34,83,0.41,26,60,0.433,8,23,0.348,7,10,0.7,83,2016-11-16,BOS,DAL,2017,87.0
11255,11255,55,Home,L 90-105 ,240,30,73,0.411,21,42,0.5,9,31,0.29,21,33,0.636,90,40,84,0.476,28,58,0.483,12,26,0.462,13,17,0.765,105,2016-11-21,CHA,MEM,2017,111.0
11256,11256,56,@,L 90-128 ,240,37,91,0.407,29,56,0.518,8,35,0.229,8,12,0.667,90,43,85,0.506,23,42,0.548,20,43,0.465,22,24,0.917,128,2016-11-25,DAL,CLE,2017,138.0
11257,11257,57,@,W 90-81 ,240,33,85,0.388,21,54,0.389,12,31,0.387,12,18,0.667,90,29,82,0.354,25,63,0.397,4,19,0.211,19,23,0.826,81,2016-11-25,MIA,MEM,2017,83.0
11258,11258,58,Home,L 90-96 ,240,32,91,0.352,28,70,0.4,4,21,0.19,22,29,0.759,90,33,81,0.407,31,73,0.425,2,8,0.25,28,41,0.683,96,2016-11-30,CHI,LAL,2017,97.0
11259,11259,59,Home,L 90-117 ,240,37,78,0.474,34,62,0.548,3,16,0.188,13,20,0.65,90,42,84,0.5,28,55,0.509,14,29,0.483,19,23,0.826,117,2016-12-09,MIN,DET,2017,124.0
11260,11260,60,@,L 90-103 ,240,38,93,0.409,33,72,0.458,5,21,0.238,9,19,0.474,90,45,96,0.469,36,64,0.563,9,32,0.281,4,8,0.5,103,2016-12-15,NYK,GSW,2017,107.5
11261,11261,61,Home,L 90-105 ,240,32,84,0.381,22,54,0.407,10,30,0.333,16,22,0.727,90,40,83,0.482,34,64,0.531,6,19,0.316,19,25,0.76,105,2016-12-17,DET,IND,2017,108.0
11262,11262,62,@,L 90-135 ,240,34,86,0.395,26,58,0.448,8,28,0.286,14,20,0.7,90,51,87,0.586,37,59,0.627,14,28,0.5,19,26,0.731,135,2016-12-17,POR,GSW,2017,142.0
11263,11263,63,@,W 90-88 ,240,37,87,0.425,30,58,0.517,7,29,0.241,9,15,0.6,90,34,74,0.459,21,45,0.467,13,29,0.448,7,11,0.636,88,2016-12-23,DAL,LAC,2017,94.5
11264,11264,64,@,L 90-109 ,240,31,87,0.356,23,64,0.359,8,23,0.348,20,24,0.833,90,45,89,0.506,34,62,0.548,11,27,0.407,8,14,0.571,109,2016-12-23,LAL,ORL,2017,114.5
11265,11265,65,Home,L 90-110 ,240,35,79,0.443,23,49,0.469,12,30,0.4,8,16,0.5,90,39,78,0.5,27,58,0.466,12,20,0.6,20,21,0.952,110,2016-12-23,POR,SAS,2017,116.0
11266,11266,66,Home,W 90-85 ,240,32,83,0.386,26,58,0.448,6,25,0.24,20,28,0.714,90,34,81,0.42,25,56,0.446,9,25,0.36,8,10,0.8,85,2016-12-26,CHI,IND,2017,89.5
11267,11267,67,@,L 90-106 ,240,30,79,0.38,19,51,0.373,11,28,0.393,19,23,0.826,90,41,92,0.446,25,64,0.391,16,28,0.571,8,15,0.533,106,2016-12-26,CLE,DET,2017,114.0
11268,11268,68,@,L 90-104 ,240,35,83,0.422,27,51,0.529,8,32,0.25,12,17,0.706,90,37,82,0.451,22,51,0.431,15,31,0.484,15,18,0.833,104,2016-12-26,ATL,MIN,2017,111.5
11269,11269,69,Home,W 90-82 ,240,34,90,0.378,28,59,0.475,6,31,0.194,16,22,0.727,90,32,88,0.364,21,62,0.339,11,26,0.423,7,10,0.7,82,2017-01-02,CLE,NOP,2017,87.5
11270,11270,70,@,L 90-99 ,240,36,91,0.396,30,68,0.441,6,23,0.261,12,16,0.75,90,36,77,0.468,27,54,0.5,9,23,0.391,18,22,0.818,99,2017-01-03,MIA,PHO,2017,103.5
11271,11271,71,Home,L 90-95 ,240,37,88,0.42,32,63,0.508,5,25,0.2,11,16,0.688,90,35,99,0.354,29,72,0.403,6,27,0.222,19,31,0.613,95,2017-02-01,BRK,NYK,2017,98.0
11272,11272,72,@,L 90-93 ,240,34,88,0.386,27,60,0.45,7,28,0.25,15,21,0.714,90,33,87,0.379,25,61,0.41,8,26,0.308,19,29,0.655,93,2017-02-06,OKC,IND,2017,97.0
11273,11273,73,@,L 90-94 ,240,33,91,0.363,27,62,0.435,6,29,0.207,18,22,0.818,90,34,68,0.5,25,54,0.463,9,14,0.643,17,21,0.81,94,2017-02-12,SAS,NYK,2017,98.5
11274,11274,74,Home,W 90-85 ,240,32,84,0.381,20,52,0.385,12,32,0.375,14,19,0.737,90,32,76,0.421,19,38,0.5,13,38,0.342,8,9,0.889,85,2017-02-15,TOR,CHO,2017,91.5
11275,11275,75,Home,L 90-108 ,240,30,79,0.38,24,59,0.407,6,20,0.3,24,36,0.667,90,40,99,0.404,23,62,0.371,17,37,0.459,11,13,0.846,108,2017-02-24,ATL,MIA,2017,116.5
11276,11276,76,Home,L 90-101 ,240,34,83,0.41,29,58,0.5,5,25,0.2,17,22,0.773,90,34,81,0.42,26,52,0.5,8,29,0.276,25,31,0.806,101,2017-03-01,ORL,NYK,2017,105.0
11277,11277,77,@,L 90-97 (OT),265,35,89,0.393,31,73,0.425,4,16,0.25,16,22,0.727,90,38,94,0.404,32,70,0.457,6,24,0.25,15,24,0.625,97,2017-03-04,MIN,SAS,2017,100.0
11278,11278,78,@,L 89-97 ,240,30,81,0.37,22,53,0.415,8,28,0.286,21,26,0.808,89,34,72,0.472,24,53,0.453,10,19,0.526,19,26,0.731,97,2011-12-25,ORL,OKC,2012,102.0
11279,11279,79,Home,L 89-105 ,240,36,81,0.444,27,60,0.45,9,21,0.429,8,11,0.727,89,40,70,0.571,33,58,0.569,7,12,0.583,18,22,0.818,105,2011-12-28,DET,CLE,2012,108.5
11280,11280,80,@,L 89-92 ,240,34,80,0.425,27,54,0.5,7,26,0.269,14,22,0.636,89,39,86,0.453,37,62,0.597,2,24,0.083,12,15,0.8,92,2011-12-31,DEN,LAL,2012,93.0
11281,11281,81,@,L 89-104 ,240,33,89,0.371,31,73,0.425,2,16,0.125,21,25,0.84,89,36,74,0.486,26,58,0.448,10,16,0.625,22,31,0.71,104,2011-12-31,UTA,SAS,2012,109.0
11282,11282,82,Home,W 89-78 ,240,31,62,0.5,29,54,0.537,2,8,0.25,25,33,0.758,89,28,63,0.444,20,41,0.488,8,22,0.364,14,21,0.667,78,2012-01-02,DET,ORL,2012,82.0
11283,11283,83,Home,W 89-70 ,240,35,71,0.493,29,55,0.527,6,16,0.375,13,21,0.619,89,30,74,0.405,26,54,0.481,4,20,0.2,6,10,0.6,70,2012-01-04,BOS,NJN,2012,72.0
11284,11284,84,@,L 89-98 ,240,37,82,0.451,32,65,0.492,5,17,0.294,10,15,0.667,89,38,91,0.418,30,69,0.435,8,22,0.364,14,21,0.667,98,2012-01-04,PHO,DAL,2012,102.0
11285,11285,85,@,L 89-117 ,240,35,76,0.461,28,60,0.467,7,16,0.438,12,17,0.706,89,47,82,0.573,41,66,0.621,6,16,0.375,17,24,0.708,117,2012-01-04,HOU,LAC,2012,120.0
11286,11286,86,@,L 89-95 (OT),265,32,81,0.395,27,65,0.415,5,16,0.313,20,34,0.588,89,36,86,0.419,30,69,0.435,6,17,0.353,17,23,0.739,95,2012-01-11,MIA,LAC,2012,98.0
11287,11287,87,@,L 89-103 ,240,35,80,0.438,31,60,0.517,4,20,0.2,15,16,0.938,89,40,89,0.449,32,68,0.471,8,21,0.381,15,19,0.789,103,2012-01-13,SAC,HOU,2012,107.0
11288,11288,88,@,L 89-120 ,240,36,81,0.444,32,64,0.5,4,17,0.235,13,20,0.65,89,47,85,0.553,35,67,0.522,12,18,0.667,14,19,0.737,120,2012-01-13,WAS,PHI,2012,126.0
11289,11289,89,@,L 89-96 ,240,36,77,0.468,31,60,0.517,5,17,0.294,12,17,0.706,89,36,78,0.462,29,56,0.518,7,22,0.318,17,26,0.654,96,2012-01-17,CHA,ORL,2012,99.5
11290,11290,90,@,L 89-92 ,240,35,92,0.38,30,73,0.411,5,19,0.263,14,20,0.7,89,33,71,0.465,28,60,0.467,5,11,0.455,21,27,0.778,92,2012-01-18,POR,ATL,2012,94.5
11291,11291,91,@,L 89-91 ,240,34,81,0.42,25,61,0.41,9,20,0.45,12,18,0.667,89,37,87,0.425,29,65,0.446,8,22,0.364,9,17,0.529,91,2012-01-18,DAL,LAC,2012,95.0
11292,11292,92,@,L 89-95 ,240,35,74,0.473,33,63,0.524,2,11,0.182,17,23,0.739,89,40,85,0.471,34,70,0.486,6,15,0.4,9,15,0.6,95,2012-01-21,CHA,CHI,2012,98.0
11293,11293,93,@,L 89-101 ,240,32,80,0.4,25,62,0.403,7,18,0.389,18,25,0.72,89,41,88,0.466,34,69,0.493,7,19,0.368,12,21,0.571,101,2012-01-23,SAC,POR,2012,104.5
11294,11294,94,@,L 89-99 ,240,30,84,0.357,12,41,0.293,18,43,0.419,11,14,0.786,89,37,80,0.463,35,70,0.5,2,10,0.2,23,26,0.885,99,2012-01-27,NYK,MIA,2012,100.0
11295,11295,95,Home,W 89-72 ,240,35,78,0.449,29,63,0.46,6,15,0.4,13,16,0.813,89,27,70,0.386,23,55,0.418,4,15,0.267,14,21,0.667,72,2012-01-27,PHI,CHA,2012,74.0
11296,11296,96,@,L 89-100 ,240,36,82,0.439,30,63,0.476,6,19,0.316,11,17,0.647,89,40,80,0.5,35,61,0.574,5,19,0.263,15,16,0.938,100,2012-01-28,LAL,MIL,2012,102.5
11297,11297,97,@,L 89-93 ,240,37,80,0.463,32,60,0.533,5,20,0.25,10,13,0.769,89,32,84,0.381,29,72,0.403,3,12,0.25,26,38,0.684,93,2012-01-30,POR,UTA,2012,94.5
11298,11298,98,@,L 89-91 ,240,34,80,0.425,31,65,0.477,3,15,0.2,18,21,0.857,89,31,76,0.408,21,56,0.375,10,20,0.5,19,25,0.76,91,2012-02-03,NYK,BOS,2012,96.0
11299,11299,99,Home,L 89-93 ,240,33,75,0.44,28,52,0.538,5,23,0.217,18,23,0.783,89,37,78,0.474,33,65,0.508,4,13,0.308,15,25,0.6,93,2012-02-03,DEN,LAL,2012,95.0
11300,11300,0,@,L 89-106 ,240,33,87,0.379,28,68,0.412,5,19,0.263,18,25,0.72,89,42,93,0.452,39,80,0.488,3,13,0.231,19,28,0.679,106,2012-02-03,WAS,TOR,2012,107.5
11301,11301,1,Home,W 89-87 ,240,35,78,0.449,33,68,0.485,2,10,0.2,17,23,0.739,89,34,72,0.472,30,60,0.5,4,12,0.333,15,18,0.833,87,2012-02-04,DET,NOH,2012,89.0
11302,11302,2,@,L 89-95 ,240,33,75,0.44,24,56,0.429,9,19,0.474,14,19,0.737,89,34,85,0.4,24,63,0.381,10,22,0.455,17,24,0.708,95,2012-02-04,CHA,PHO,2012,100.0
11303,11303,3,@,L 89-95 ,240,34,79,0.43,28,57,0.491,6,22,0.273,15,21,0.714,89,31,69,0.449,27,57,0.474,4,12,0.333,29,34,0.853,95,2012-02-05,TOR,MIA,2012,97.0
11304,11304,4,@,W 89-84 ,240,34,73,0.466,27,57,0.474,7,16,0.438,14,21,0.667,89,31,83,0.373,27,70,0.386,4,13,0.308,18,21,0.857,84,2012-02-06,SAS,MEM,2012,86.0
11305,11305,5,@,L 89-102 ,240,36,76,0.474,31,61,0.508,5,15,0.333,12,17,0.706,89,35,83,0.422,18,41,0.439,17,42,0.405,15,21,0.714,102,2012-02-08,MIA,ORL,2012,110.5
11306,11306,6,Home,L 89-96 ,240,35,74,0.473,26,47,0.553,9,27,0.333,10,16,0.625,89,42,86,0.488,34,70,0.486,8,16,0.5,4,6,0.667,96,2012-02-09,PHO,HOU,2012,100.0
11307,11307,7,@,W 89-87 (OT),265,36,82,0.439,30,65,0.462,6,17,0.353,11,18,0.611,89,35,83,0.422,26,59,0.441,9,24,0.375,8,14,0.571,87,2012-02-10,ATL,ORL,2012,91.5
11308,11308,8,Home,L 89-106 ,240,34,89,0.382,30,68,0.441,4,21,0.19,17,28,0.607,89,40,81,0.494,35,66,0.53,5,15,0.333,21,23,0.913,106,2012-02-10,WAS,MIA,2012,108.5
11309,11309,9,Home,L 89-103 ,240,35,87,0.402,28,63,0.444,7,24,0.292,12,15,0.8,89,42,80,0.525,35,58,0.603,7,22,0.318,12,17,0.706,103,2012-02-11,BRK,SAS,2012,106.5
11310,11310,10,Home,L 89-98 ,240,30,73,0.411,23,56,0.411,7,17,0.412,22,30,0.733,89,36,83,0.434,30,65,0.462,6,18,0.333,20,24,0.833,98,2012-02-13,CHA,PHI,2012,101.0
11311,11311,11,@,L 89-102 ,240,33,80,0.413,27,59,0.458,6,21,0.286,17,25,0.68,89,36,85,0.424,24,55,0.436,12,30,0.4,18,22,0.818,102,2012-02-13,MIN,ORL,2012,108.0
11312,11312,12,Home,L 89-92 ,240,33,86,0.384,26,68,0.382,7,18,0.389,16,18,0.889,89,36,80,0.45,29,65,0.446,7,15,0.467,13,17,0.765,92,2012-02-15,MIL,NOH,2012,95.5
11313,11313,13,Home,W 89-80 ,240,30,76,0.395,20,55,0.364,10,21,0.476,19,28,0.679,89,31,78,0.397,28,63,0.444,3,15,0.2,15,18,0.833,80,2012-02-16,CHI,BOS,2012,81.5
11314,11314,14,@,W 89-85 ,240,32,75,0.427,25,63,0.397,7,12,0.583,18,23,0.783,89,31,75,0.413,27,51,0.529,4,24,0.167,19,29,0.655,85,2012-02-17,NOP,NYK,2012,87.0
11315,11315,15,Home,W 89-73 ,240,36,89,0.404,29,64,0.453,7,25,0.28,10,14,0.714,89,29,74,0.392,22,50,0.44,7,24,0.292,8,11,0.727,73,2012-02-20,DAL,BOS,2012,76.5
11316,11316,16,Home,W 89-76 ,240,31,78,0.397,25,66,0.379,6,12,0.5,21,29,0.724,89,31,85,0.365,23,70,0.329,8,15,0.533,6,8,0.75,76,2012-02-21,MEM,PHI,2012,80.0
11317,11317,17,@,W 89-84 ,240,36,89,0.404,34,79,0.43,2,10,0.2,15,20,0.75,89,27,85,0.318,21,58,0.362,6,27,0.222,24,37,0.649,84,2012-02-22,NOP,CLE,2012,87.0
11318,11318,18,Home,L 89-96 ,240,37,86,0.43,29,66,0.439,8,20,0.4,7,12,0.583,89,37,88,0.42,30,73,0.411,7,15,0.467,15,21,0.714,96,2012-02-29,SAS,CHI,2012,99.5
11319,11319,19,Home,W 89-86 ,240,35,80,0.438,35,70,0.5,0,10,0.0,19,25,0.76,89,35,76,0.461,27,53,0.509,8,23,0.348,8,9,0.889,86,2012-03-07,MIA,ATL,2012,90.0
11320,11320,20,Home,L 89-95 ,240,33,80,0.413,28,57,0.491,5,23,0.217,18,25,0.72,89,39,85,0.459,36,78,0.462,3,7,0.429,14,16,0.875,95,2012-03-10,MIN,NOH,2012,96.5
11321,11321,21,Home,L 89-115 ,240,33,82,0.402,26,63,0.413,7,19,0.368,16,21,0.762,89,46,91,0.505,34,67,0.507,12,24,0.5,11,15,0.733,115,2012-03-13,SAC,GSW,2012,121.0
11322,11322,22,Home,L 89-99 ,240,34,75,0.453,30,61,0.492,4,14,0.286,17,19,0.895,89,39,75,0.52,33,57,0.579,6,18,0.333,15,17,0.882,99,2012-03-15,NOP,WAS,2012,102.0
11323,11323,23,Home,L 89-100 ,240,36,85,0.424,28,58,0.483,8,27,0.296,9,11,0.818,89,39,79,0.494,28,58,0.483,11,21,0.524,11,12,0.917,100,2012-03-16,CHI,POR,2012,105.5
11324,11324,24,Home,W 89-80 ,240,31,77,0.403,25,56,0.446,6,21,0.286,21,31,0.677,89,33,79,0.418,30,66,0.455,3,13,0.231,11,15,0.733,80,2012-03-17,CHI,PHI,2012,81.5
11325,11325,25,@,L 89-102 ,240,37,85,0.435,31,63,0.492,6,22,0.273,9,20,0.45,89,35,72,0.486,27,58,0.466,8,14,0.571,24,26,0.923,102,2012-03-20,LAC,IND,2012,106.0
11326,11326,26,Home,L 89-108 ,240,31,84,0.369,25,64,0.391,6,20,0.3,21,27,0.778,89,40,83,0.482,34,66,0.515,6,17,0.353,22,29,0.759,108,2012-03-21,BRK,WAS,2012,111.0
11327,11327,27,@,L 89-102 ,240,35,79,0.443,32,65,0.492,3,14,0.214,16,22,0.727,89,39,88,0.443,34,72,0.472,5,16,0.313,19,22,0.864,102,2012-03-24,CHA,NJN,2012,104.5
11328,11328,28,@,W 89-86 ,240,36,90,0.4,34,71,0.479,2,19,0.105,15,17,0.882,89,37,81,0.457,36,76,0.474,1,5,0.2,11,12,0.917,86,2012-03-24,SAS,NOH,2012,86.5
11329,11329,29,Home,W 89-80 ,240,26,74,0.351,19,43,0.442,7,31,0.226,30,35,0.857,89,31,85,0.365,25,61,0.41,6,24,0.25,12,18,0.667,80,2012-03-26,NYK,MIL,2012,83.0
11330,11330,30,@,L 89-93 ,240,33,78,0.423,26,56,0.464,7,22,0.318,16,25,0.64,89,31,79,0.392,25,63,0.397,6,16,0.375,25,32,0.781,93,2012-03-29,WAS,IND,2012,96.0
11331,11331,31,@,L 89-98 ,240,35,94,0.372,34,79,0.43,1,15,0.067,18,26,0.692,89,38,73,0.521,31,59,0.525,7,14,0.5,15,20,0.75,98,2012-03-30,MEM,HOU,2012,101.5
11332,11332,32,@,L 89-94 ,240,34,73,0.466,25,52,0.481,9,21,0.429,12,17,0.706,89,31,80,0.388,22,60,0.367,9,20,0.45,23,27,0.852,94,2012-04-07,DAL,MEM,2012,98.5
11333,11333,33,Home,L 89-109 ,240,37,87,0.425,31,68,0.456,6,19,0.316,9,13,0.692,89,39,81,0.481,31,61,0.508,8,20,0.4,23,25,0.92,109,2012-04-09,MIL,OKC,2012,113.0
11334,11334,34,@,L 89-119 ,240,30,74,0.405,23,54,0.426,7,20,0.35,22,26,0.846,89,42,80,0.525,27,52,0.519,15,28,0.536,20,24,0.833,119,2012-04-09,DET,ORL,2012,126.5
11335,11335,35,Home,L 89-94 ,240,33,83,0.398,27,62,0.435,6,21,0.286,17,19,0.895,89,37,80,0.463,27,61,0.443,10,19,0.526,10,13,0.769,94,2012-04-09,POR,HOU,2012,99.0
11336,11336,36,@,L 89-115 ,240,35,90,0.389,26,65,0.4,9,25,0.36,10,14,0.714,89,43,90,0.478,38,78,0.487,5,12,0.417,24,32,0.75,115,2012-04-13,SAC,OKC,2012,117.5
11337,11337,37,Home,L 89-95 ,240,34,81,0.42,33,71,0.465,1,10,0.1,20,27,0.741,89,34,81,0.42,28,65,0.431,6,16,0.375,21,27,0.778,95,2012-04-13,PHI,NJN,2012,98.0
11338,11338,38,Home,L 89-98 ,240,38,87,0.437,34,73,0.466,4,14,0.286,9,12,0.75,89,34,66,0.515,31,58,0.534,3,8,0.375,27,33,0.818,98,2012-04-14,WAS,CLE,2012,99.5
11339,11339,39,@,L 89-93 ,240,29,78,0.372,23,54,0.426,6,24,0.25,25,31,0.806,89,40,90,0.444,36,73,0.493,4,17,0.235,9,10,0.9,93,2012-04-21,POR,MEM,2012,95.0
11340,11340,40,@,L 89-124 ,240,37,96,0.385,31,80,0.388,6,16,0.375,9,11,0.818,89,48,81,0.593,36,59,0.61,12,22,0.545,16,21,0.762,124,2012-04-23,POR,SAS,2012,130.0
11341,11341,41,@,L 89-106 ,240,33,78,0.423,28,63,0.444,5,15,0.333,18,23,0.783,89,45,85,0.529,36,58,0.621,9,27,0.333,7,9,0.778,106,2012-04-26,DAL,ATL,2012,110.5
11342,11342,42,@,L 89-90 ,240,33,83,0.398,26,57,0.456,7,26,0.269,16,27,0.593,89,31,85,0.365,24,66,0.364,7,19,0.368,21,24,0.875,90,2012-11-02,IND,CHA,2013,93.5
11343,11343,43,@,L 89-102 ,240,32,84,0.381,25,58,0.431,7,26,0.269,18,27,0.667,89,42,86,0.488,37,71,0.521,5,15,0.333,13,18,0.722,102,2012-11-02,DEN,ORL,2013,104.5
11344,11344,44,@,L 89-92 ,240,37,90,0.411,33,77,0.429,4,13,0.308,11,19,0.579,89,40,92,0.435,38,81,0.469,2,11,0.182,10,14,0.714,92,2012-11-02,DET,PHO,2013,93.0
11345,11345,45,@,W 89-82 ,240,32,75,0.427,27,57,0.474,5,18,0.278,20,23,0.87,89,29,88,0.33,26,71,0.366,3,17,0.176,21,25,0.84,82,2012-11-03,NOP,CHI,2013,83.5
11346,11346,46,@,W 89-86 ,240,36,84,0.429,28,63,0.444,8,21,0.381,9,13,0.692,89,34,78,0.436,28,58,0.483,6,20,0.3,12,17,0.706,86,2012-11-03,BOS,WAS,2013,89.0
11347,11347,47,Home,W 89-86 ,240,38,87,0.437,31,65,0.477,7,22,0.318,6,12,0.5,89,35,85,0.412,27,59,0.458,8,26,0.308,8,9,0.889,86,2012-11-07,ATL,IND,2013,90.0
11348,11348,48,Home,L 89-95 ,240,34,81,0.42,25,56,0.446,9,25,0.36,12,16,0.75,89,37,76,0.487,30,54,0.556,7,22,0.318,14,16,0.875,95,2012-11-09,ATL,MIA,2013,98.5
11349,11349,49,Home,W 89-85 ,240,34,80,0.425,27,64,0.422,7,16,0.438,14,24,0.583,89,35,79,0.443,25,55,0.455,10,24,0.417,5,7,0.714,85,2012-11-10,IND,WAS,2013,90.0
11350,11350,50,Home,W 89-76 ,240,38,82,0.463,33,67,0.493,5,15,0.333,8,8,1.0,89,30,72,0.417,21,47,0.447,9,25,0.36,7,16,0.438,76,2012-11-11,LAC,ATL,2013,80.5
11351,11351,51,Home,L 89-99 ,240,37,75,0.493,32,61,0.525,5,14,0.357,10,17,0.588,89,41,84,0.488,32,60,0.533,9,24,0.375,8,11,0.727,99,2012-11-13,ORL,NYK,2013,103.5
11352,11352,52,@,W 89-87 ,240,38,84,0.452,34,68,0.5,4,16,0.25,9,14,0.643,89,31,81,0.383,26,62,0.419,5,19,0.263,20,37,0.541,87,2012-11-14,CHA,MIN,2013,89.5
11353,11353,53,@,L 89-107 ,240,30,70,0.429,22,48,0.458,8,22,0.364,21,31,0.677,89,43,76,0.566,37,61,0.607,6,15,0.4,15,19,0.789,107,2012-11-17,TOR,BOS,2013,110.0
11354,11354,54,Home,L 89-96 ,240,31,87,0.356,27,70,0.386,4,17,0.235,23,31,0.742,89,34,70,0.486,31,51,0.608,3,19,0.158,25,29,0.862,96,2012-11-19,WAS,IND,2013,97.5
11355,11355,55,@,L 89-93 ,240,38,95,0.4,36,79,0.456,2,16,0.125,11,19,0.579,89,32,74,0.432,25,55,0.455,7,19,0.368,22,31,0.71,93,2012-11-21,CHI,HOU,2013,96.5
11356,11356,56,Home,L 89-115 ,240,34,92,0.37,24,64,0.375,10,28,0.357,11,20,0.55,89,40,82,0.488,28,60,0.467,12,22,0.545,23,34,0.676,115,2012-11-24,DAL,LAL,2013,121.0
11357,11357,57,@,L 89-96 (OT),265,33,85,0.388,27,64,0.422,6,21,0.286,17,24,0.708,89,37,91,0.407,28,63,0.444,9,28,0.321,13,19,0.684,96,2012-11-26,NYK,BRK,2013,100.5
11358,11358,58,Home,L 89-97 ,240,37,84,0.44,31,67,0.463,6,17,0.353,9,14,0.643,89,38,83,0.458,32,61,0.525,6,22,0.273,15,18,0.833,97,2012-11-27,SAC,MIN,2013,100.0
11359,11359,59,Home,L 89-110 ,240,41,95,0.432,39,80,0.488,2,15,0.133,5,8,0.625,89,44,84,0.524,33,59,0.559,11,25,0.44,11,15,0.733,110,2012-11-28,ORL,SAS,2013,115.5
11360,11360,60,@,L 89-102 ,240,33,75,0.44,27,47,0.574,6,28,0.214,17,27,0.63,89,40,78,0.513,33,58,0.569,7,20,0.35,15,19,0.789,102,2012-12-01,BRK,MIA,2013,105.5
11361,11361,61,Home,W 89-79 ,240,36,84,0.429,32,66,0.485,4,18,0.222,13,19,0.684,89,32,95,0.337,29,75,0.387,3,20,0.15,12,17,0.706,79,2012-12-03,DET,CLE,2013,80.5
11362,11362,62,Home,L 89-92 ,240,34,76,0.447,24,53,0.453,10,23,0.435,11,18,0.611,89,38,86,0.442,35,69,0.507,3,17,0.176,13,20,0.65,92,2012-12-07,IND,DEN,2013,93.5
11363,11363,63,Home,L 89-96 ,240,36,75,0.48,28,59,0.475,8,16,0.5,9,12,0.75,89,36,72,0.5,28,55,0.509,8,17,0.471,16,22,0.727,96,2012-12-07,NOP,MEM,2013,100.0
11364,11364,64,Home,L 89-94 ,240,35,87,0.402,25,67,0.373,10,20,0.5,9,12,0.75,89,37,80,0.463,33,69,0.478,4,11,0.364,16,23,0.696,94,2012-12-11,CHI,LAC,2013,96.0
11365,11365,65,Home,L 89-96 ,240,41,91,0.451,39,77,0.506,2,14,0.143,5,11,0.455,89,34,78,0.436,30,67,0.448,4,11,0.364,24,26,0.923,96,2012-12-12,PHI,CHI,2013,98.0
11366,11366,66,@,L 89-101 ,240,34,85,0.4,26,65,0.4,8,20,0.4,13,17,0.765,89,37,76,0.487,27,49,0.551,10,27,0.37,17,23,0.739,101,2012-12-14,BOS,HOU,2013,106.0
11367,11367,67,@,L 89-100 ,240,35,81,0.432,30,71,0.423,5,10,0.5,14,19,0.737,89,37,74,0.5,32,65,0.492,5,9,0.556,21,24,0.875,100,2012-12-18,BOS,CHI,2013,102.5
11368,11368,68,Home,L 89-99 ,240,32,80,0.4,27,64,0.422,5,16,0.313,20,26,0.769,89,39,80,0.488,34,64,0.531,5,16,0.313,16,25,0.64,99,2012-12-21,CLE,IND,2013,101.5
11369,11369,69,@,L 89-105 ,240,30,73,0.411,23,57,0.404,7,16,0.438,22,26,0.846,89,38,73,0.521,27,49,0.551,11,24,0.458,18,22,0.818,105,2012-12-22,UTA,MIA,2013,110.5
11370,11370,70,Home,L 89-99 ,240,35,90,0.389,30,75,0.4,5,15,0.333,14,17,0.824,89,37,71,0.521,28,55,0.509,9,16,0.563,16,23,0.696,99,2012-12-26,MEM,PHI,2013,103.5
11371,11371,71,@,L 89-96 ,240,35,87,0.402,30,67,0.448,5,20,0.25,14,23,0.609,89,34,80,0.425,27,63,0.429,7,17,0.412,21,26,0.808,96,2012-12-28,PHI,GSW,2013,99.5
11372,11372,72,Home,W 89-85 ,240,34,76,0.447,26,53,0.491,8,23,0.348,13,16,0.813,89,36,85,0.424,32,68,0.471,4,17,0.235,9,11,0.818,85,2012-12-29,POR,PHI,2013,87.0
11373,11373,73,Home,W 89-81 ,240,29,77,0.377,24,61,0.393,5,16,0.313,26,31,0.839,89,35,83,0.422,32,70,0.457,3,13,0.231,8,10,0.8,81,2013-01-02,IND,WAS,2013,82.5
11374,11374,74,@,L 89-95 ,240,37,84,0.44,32,70,0.457,5,14,0.357,10,12,0.833,89,39,85,0.459,36,72,0.5,3,13,0.231,14,20,0.7,95,2013-01-02,PHI,PHO,2013,96.5
11375,11375,75,Home,L 89-96 ,240,30,65,0.462,25,45,0.556,5,20,0.25,24,31,0.774,89,36,80,0.45,31,66,0.47,5,14,0.357,19,24,0.792,96,2013-01-04,MIA,CHI,2013,98.5
11376,11376,76,@,W 89-81 ,240,39,85,0.459,36,69,0.522,3,16,0.188,8,12,0.667,89,28,68,0.412,18,39,0.462,10,29,0.345,15,19,0.789,81,2013-01-05,BOS,ATL,2013,86.0
11377,11377,77,@,L 89-115 ,240,32,72,0.444,27,52,0.519,5,20,0.25,20,26,0.769,89,47,90,0.522,37,62,0.597,10,28,0.357,11,15,0.733,115,2013-01-05,GSW,LAC,2013,120.0
11378,11378,78,Home,L 89-109 ,240,38,79,0.481,31,62,0.5,7,17,0.412,6,10,0.6,89,40,83,0.482,30,59,0.508,10,24,0.417,19,22,0.864,109,2013-01-08,PHI,BRK,2013,114.0
11379,11379,79,@,L 89-100 ,240,33,79,0.418,27,64,0.422,6,15,0.4,17,24,0.708,89,39,80,0.488,31,59,0.525,8,21,0.381,14,20,0.7,100,2013-01-14,CHA,BOS,2013,104.0
11380,11380,80,@,L 89-94 ,240,35,80,0.438,26,59,0.441,9,21,0.429,10,14,0.714,89,30,74,0.405,21,48,0.438,9,26,0.346,25,38,0.658,94,2013-01-18,ATL,BRK,2013,98.5
11381,11381,81,@,W 89-86 ,240,32,83,0.386,24,55,0.436,8,28,0.286,17,20,0.85,89,31,76,0.408,28,58,0.483,3,18,0.167,21,28,0.75,86,2013-01-24,NYK,BOS,2013,87.5
11382,11382,82,@,L 89-106 ,240,34,98,0.347,28,73,0.384,6,25,0.24,15,19,0.789,89,40,72,0.556,35,58,0.603,5,14,0.357,21,25,0.84,106,2013-01-31,MEM,OKC,2013,108.5
11383,11383,83,@,L 89-93 ,240,34,78,0.436,33,64,0.516,1,14,0.071,20,22,0.909,89,39,75,0.52,34,64,0.531,5,11,0.455,10,20,0.5,93,2013-02-01,CHI,BRK,2013,95.5
11384,11384,84,@,L 89-102 ,240,33,70,0.471,28,56,0.5,5,14,0.357,18,24,0.75,89,39,70,0.557,32,53,0.604,7,17,0.412,17,24,0.708,102,2013-02-01,MIA,IND,2013,105.5
11385,11385,85,Home,W 89-80 ,240,36,76,0.474,33,62,0.532,3,14,0.214,14,19,0.737,89,30,79,0.38,29,69,0.42,1,10,0.1,19,25,0.76,80,2013-02-01,PHI,SAC,2013,80.5
11386,11386,86,@,L 89-111 ,240,34,77,0.442,27,61,0.443,7,16,0.438,14,19,0.737,89,36,68,0.529,21,41,0.512,15,27,0.556,24,32,0.75,111,2013-02-08,LAC,MIA,2013,118.5
11387,11387,87,Home,L 89-93 ,240,37,78,0.474,33,62,0.532,4,16,0.25,11,17,0.647,89,36,79,0.456,31,67,0.463,5,12,0.417,16,18,0.889,93,2013-02-08,UTA,CHI,2013,95.5
11388,11388,88,Home,W 89-74 ,240,36,80,0.45,29,64,0.453,7,16,0.438,10,11,0.909,89,25,76,0.329,20,58,0.345,5,18,0.278,19,32,0.594,74,2013-02-08,WAS,BRK,2013,76.5
11389,11389,89,@,L 89-102 ,240,34,69,0.493,29,56,0.518,5,13,0.385,16,25,0.64,89,40,78,0.513,32,62,0.516,8,16,0.5,14,18,0.778,102,2013-02-10,NOP,TOR,2013,106.0
11390,11390,90,Home,L 89-103 ,240,37,78,0.474,35,66,0.53,2,12,0.167,13,20,0.65,89,39,75,0.52,31,59,0.525,8,16,0.5,17,20,0.85,103,2013-02-11,CHI,SAS,2013,107.0
11391,11391,91,@,W 89-84 (OT),265,31,80,0.388,27,68,0.397,4,12,0.333,23,32,0.719,89,33,96,0.344,28,74,0.378,5,22,0.227,13,18,0.722,84,2013-02-11,BRK,IND,2013,86.5
11392,11392,92,Home,L 89-105 ,240,33,74,0.446,28,58,0.483,5,16,0.313,18,28,0.643,89,43,83,0.518,36,58,0.621,7,25,0.28,12,20,0.6,105,2013-03-01,CLE,LAC,2013,108.5
11393,11393,93,Home,W 89-88 ,240,30,81,0.37,26,64,0.406,4,17,0.235,25,30,0.833,89,37,81,0.457,35,71,0.493,2,10,0.2,12,18,0.667,88,2013-03-08,CHI,UTA,2013,89.0
11394,11394,94,@,L 89-90 (OT),265,30,84,0.357,28,66,0.424,2,18,0.111,27,32,0.844,89,32,89,0.36,26,74,0.351,6,15,0.4,20,24,0.833,90,2013-03-20,OKC,MEM,2013,93.0
11395,11395,95,Home,L 89-99 ,240,39,89,0.438,35,75,0.467,4,14,0.286,7,11,0.636,89,41,84,0.488,31,63,0.492,10,21,0.476,7,10,0.7,99,2013-03-21,CHI,POR,2013,104.0
11396,11396,96,@,L 89-103 ,240,34,83,0.41,27,61,0.443,7,22,0.318,14,18,0.778,89,38,68,0.559,30,53,0.566,8,15,0.533,19,26,0.731,103,2013-03-22,DET,MIA,2013,107.0
11397,11397,97,Home,L 89-97 ,240,38,92,0.413,33,76,0.434,5,16,0.313,8,10,0.8,89,34,80,0.425,29,59,0.492,5,21,0.238,24,33,0.727,97,2013-03-22,ORL,OKC,2013,99.5
11398,11398,98,Home,L 89-108 ,240,34,74,0.459,29,56,0.518,5,18,0.278,16,18,0.889,89,42,69,0.609,28,42,0.667,14,27,0.519,10,16,0.625,108,2013-03-29,NOP,MIA,2013,115.0
11399,11399,99,@,L 89-108 ,240,32,74,0.432,25,49,0.51,7,25,0.28,18,23,0.783,89,35,72,0.486,21,45,0.467,14,27,0.519,24,31,0.774,108,2013-03-31,BOS,NYK,2013,115.0
11400,11400,0,@,W 89-79 ,240,31,69,0.449,18,36,0.5,13,33,0.394,14,17,0.824,89,28,88,0.318,25,72,0.347,3,16,0.188,20,22,0.909,79,2013-04-05,MIA,CHA,2013,80.5
11401,11401,1,@,W 89-87 ,240,32,73,0.438,29,66,0.439,3,7,0.429,22,29,0.759,89,29,81,0.358,22,56,0.393,7,25,0.28,22,28,0.786,87,2013-04-07,MEM,SAC,2013,90.5
11402,11402,2,@,L 89-105 ,240,33,90,0.367,26,71,0.366,7,19,0.368,16,20,0.8,89,39,91,0.429,29,67,0.433,10,24,0.417,17,22,0.773,105,2013-04-09,MIN,GSW,2013,110.0
11403,11403,3,Home,L 89-107 ,240,33,87,0.379,24,65,0.369,9,22,0.409,14,18,0.778,89,45,86,0.523,36,65,0.554,9,21,0.429,8,8,1.0,107,2013-04-14,NOP,DAL,2013,111.5
11404,11404,4,Home,L 89-95 ,240,37,89,0.416,34,68,0.5,3,21,0.143,12,14,0.857,89,36,85,0.424,26,58,0.448,10,27,0.37,13,18,0.722,95,2013-04-17,OKC,MIL,2013,100.0
11405,11405,5,Home,W 89-74 ,240,32,77,0.416,22,49,0.449,10,28,0.357,15,20,0.75,89,29,83,0.349,26,68,0.382,3,15,0.2,13,15,0.867,74,2013-11-02,IND,CLE,2014,75.5
11406,11406,6,Home,L 89-91 ,240,33,83,0.398,29,63,0.46,4,20,0.2,19,29,0.655,89,34,95,0.358,32,81,0.395,2,14,0.143,21,26,0.808,91,2013-11-08,ORL,BOS,2014,92.0
11407,11407,7,Home,L 89-120 ,240,31,82,0.378,25,60,0.417,6,22,0.273,21,29,0.724,89,41,76,0.539,29,48,0.604,12,28,0.429,26,30,0.867,120,2013-11-10,NYK,SAS,2014,126.0
11408,11408,8,@,W 89-83 ,240,30,82,0.366,27,70,0.386,3,12,0.25,26,30,0.867,89,29,77,0.377,22,56,0.393,7,21,0.333,18,25,0.72,83,2013-11-13,CHA,BOS,2014,86.5
11409,11409,9,@,L 89-90 ,240,37,86,0.43,32,71,0.451,5,15,0.333,10,13,0.769,89,35,84,0.417,29,69,0.42,6,15,0.4,14,23,0.609,90,2013-11-13,PHO,POR,2014,93.0
11410,11410,10,@,W 89-86 ,240,37,85,0.435,36,72,0.5,1,13,0.077,14,14,1.0,89,35,80,0.438,25,56,0.446,10,24,0.417,6,11,0.545,86,2013-11-15,MEM,LAL,2014,91.0
11411,11411,11,Home,L 89-96 ,240,36,84,0.429,33,71,0.465,3,13,0.231,14,22,0.636,89,37,85,0.435,29,62,0.468,8,23,0.348,14,21,0.667,96,2013-11-22,DET,ATL,2014,100.0
11412,11412,12,@,L 89-98 ,240,36,82,0.439,25,53,0.472,11,29,0.379,6,15,0.4,89,37,76,0.487,30,57,0.526,7,19,0.368,17,22,0.773,98,2013-11-23,NYK,WAS,2014,101.5
11413,11413,13,Home,W 89-83 (OT),265,33,85,0.388,26,68,0.382,7,17,0.412,16,19,0.842,89,31,79,0.392,30,66,0.455,1,13,0.077,20,28,0.714,83,2013-11-25,UTA,CHI,2014,83.5
11414,11414,14,Home,W 89-82 ,240,33,82,0.402,25,61,0.41,8,21,0.381,15,17,0.882,89,30,78,0.385,27,61,0.443,3,17,0.176,19,25,0.76,82,2013-12-03,DAL,CHA,2014,83.5
11415,11415,15,@,L 89-108 ,240,38,94,0.404,33,74,0.446,5,20,0.25,8,17,0.471,89,47,91,0.516,39,68,0.574,8,23,0.348,6,11,0.545,108,2013-12-06,CLE,ATL,2014,112.0
11416,11416,16,@,W 89-81 ,240,36,84,0.429,29,68,0.426,7,16,0.438,10,18,0.556,89,31,81,0.383,28,68,0.412,3,13,0.231,16,21,0.762,81,2013-12-23,GSW,DEN,2014,82.5
11417,11417,17,@,W 89-85 ,240,33,80,0.413,25,55,0.455,8,25,0.32,15,24,0.625,89,30,80,0.375,21,57,0.368,9,23,0.391,16,20,0.8,85,2013-12-27,OKC,CHA,2014,89.5
11418,11418,18,@,L 89-105 ,240,33,82,0.402,27,59,0.458,6,23,0.261,17,24,0.708,89,42,89,0.472,31,65,0.477,11,24,0.458,10,15,0.667,105,2013-12-27,DEN,NOP,2014,110.5
11419,11419,19,Home,W 89-82 ,240,31,71,0.437,23,47,0.489,8,24,0.333,19,22,0.864,89,29,79,0.367,19,57,0.333,10,22,0.455,14,20,0.7,82,2014-01-04,BRK,CLE,2014,87.0
11420,11420,20,Home,W 89-85 ,240,33,81,0.407,24,55,0.436,9,26,0.346,14,20,0.7,89,32,86,0.372,29,67,0.433,3,19,0.158,18,23,0.783,85,2014-01-07,NYK,DET,2014,86.5
11421,11421,21,@,L 89-117 ,240,34,85,0.4,30,66,0.455,4,19,0.211,17,22,0.773,89,43,86,0.5,33,63,0.524,10,23,0.435,21,23,0.913,117,2014-01-16,NYK,IND,2014,122.0
11422,11422,22,Home,L 89-110 ,240,32,74,0.432,28,58,0.483,4,16,0.25,21,31,0.677,89,43,79,0.544,34,57,0.596,9,22,0.409,15,19,0.789,110,2014-01-17,DET,UTA,2014,114.5
11423,11423,23,@,L 89-94 ,240,36,82,0.439,33,64,0.516,3,18,0.167,14,20,0.7,89,34,78,0.436,23,54,0.426,11,24,0.458,15,20,0.75,94,2014-01-17,MIN,TOR,2014,99.5
11424,11424,24,@,W 89-87 ,240,31,77,0.403,20,54,0.37,11,23,0.478,16,22,0.727,89,37,88,0.42,31,69,0.449,6,19,0.316,7,10,0.7,87,2014-01-25,CHI,CHA,2014,90.0
11425,11425,25,Home,L 89-100 ,240,33,80,0.413,27,65,0.415,6,15,0.4,17,27,0.63,89,39,74,0.527,35,61,0.574,4,13,0.308,18,23,0.783,100,2014-01-28,CLE,NOP,2014,102.0
11426,11426,26,Home,L 89-99 ,240,38,79,0.481,33,58,0.569,5,21,0.238,8,8,1.0,89,41,75,0.547,37,61,0.607,4,14,0.286,13,16,0.813,99,2014-01-29,SAC,MEM,2014,101.0
11427,11427,27,@,L 89-96 ,240,33,80,0.413,28,66,0.424,5,14,0.357,18,22,0.818,89,41,82,0.5,37,68,0.544,4,14,0.286,10,12,0.833,96,2014-02-02,ORL,BOS,2014,98.0
11428,11428,28,@,W 89-85 ,240,34,74,0.459,29,56,0.518,5,18,0.278,16,20,0.8,89,33,76,0.434,26,51,0.51,7,25,0.28,12,15,0.8,85,2014-02-04,IND,ATL,2014,88.5
11429,11429,29,@,L 89-103 ,240,29,73,0.397,22,52,0.423,7,21,0.333,24,29,0.828,89,46,93,0.495,42,80,0.525,4,13,0.308,7,10,0.7,103,2014-02-06,SAS,BRK,2014,105.0
11430,11430,30,@,L 89-99 ,240,31,87,0.356,26,72,0.361,5,15,0.333,22,24,0.917,89,40,88,0.455,31,66,0.47,9,22,0.409,10,15,0.667,99,2014-02-07,SAC,BOS,2014,103.5
11431,11431,31,@,L 89-94 ,240,29,67,0.433,22,44,0.5,7,23,0.304,24,30,0.8,89,36,74,0.486,26,49,0.531,10,25,0.4,12,19,0.632,94,2014-02-08,MIA,UTA,2014,99.0
11432,11432,32,Home,L 89-107 ,240,31,87,0.356,25,62,0.403,6,25,0.24,21,21,1.0,89,39,82,0.476,28,55,0.509,11,27,0.407,18,20,0.9,107,2014-02-10,MIN,HOU,2014,112.5
11433,11433,33,@,L 89-114 ,240,37,82,0.451,32,68,0.471,5,14,0.357,10,12,0.833,89,45,82,0.549,33,58,0.569,12,24,0.5,12,15,0.8,114,2014-02-11,DAL,CHA,2014,120.0
11434,11434,34,@,L 89-92 ,240,34,74,0.459,27,50,0.54,7,24,0.292,14,20,0.7,89,33,70,0.471,30,57,0.526,3,13,0.231,23,27,0.852,92,2014-02-11,WAS,MEM,2014,93.5
11435,11435,35,@,L 89-105 ,240,36,87,0.414,26,60,0.433,10,27,0.37,7,15,0.467,89,40,80,0.5,27,49,0.551,13,31,0.419,12,15,0.8,105,2014-02-12,CHA,BRK,2014,111.5
11436,11436,36,Home,L 89-93 ,240,33,83,0.398,29,60,0.483,4,23,0.174,19,27,0.704,89,34,84,0.405,29,69,0.42,5,15,0.333,20,30,0.667,93,2014-02-12,DET,CLE,2014,95.5
11437,11437,37,@,L 89-117 ,240,35,87,0.402,28,72,0.389,7,15,0.467,12,22,0.545,89,42,84,0.5,32,67,0.478,10,17,0.588,23,27,0.852,117,2014-02-21,DEN,CHI,2014,122.0
11438,11438,38,@,L 89-92 ,240,34,79,0.43,30,64,0.469,4,15,0.267,17,22,0.773,89,30,82,0.366,22,62,0.355,8,20,0.4,24,27,0.889,92,2014-02-22,MEM,CHA,2014,96.0
11439,11439,39,@,L 89-108 ,240,36,71,0.507,27,51,0.529,9,20,0.45,8,19,0.421,89,41,79,0.519,31,57,0.544,10,22,0.455,16,17,0.941,108,2014-02-26,NOP,DAL,2014,113.0
11440,11440,40,Home,L 89-112 ,240,30,81,0.37,24,59,0.407,6,22,0.273,23,33,0.697,89,39,82,0.476,29,51,0.569,10,31,0.323,24,29,0.828,112,2014-02-27,DEN,BRK,2014,117.0
11441,11441,41,@,L 89-96 ,240,32,75,0.427,26,55,0.473,6,20,0.3,19,28,0.679,89,32,68,0.471,31,61,0.508,1,7,0.143,31,41,0.756,96,2014-03-03,NOP,SAC,2014,96.5
11442,11442,42,Home,L 89-101 ,240,38,84,0.452,35,70,0.5,3,14,0.214,10,12,0.833,89,40,82,0.488,34,60,0.567,6,22,0.273,15,24,0.625,101,2014-03-05,ORL,HOU,2014,104.0
11443,11443,43,@,L 89-111 ,240,37,93,0.398,32,72,0.444,5,21,0.238,10,14,0.714,89,44,87,0.506,37,74,0.5,7,13,0.538,16,22,0.727,111,2014-03-08,CHA,MEM,2014,114.5
11444,11444,44,@,L 89-104 ,240,36,81,0.444,31,58,0.534,5,23,0.217,12,21,0.571,89,41,77,0.532,29,52,0.558,12,25,0.48,10,16,0.625,104,2014-03-09,SAC,BRK,2014,110.0
11445,11445,45,@,L 89-99 ,240,34,84,0.405,31,69,0.449,3,15,0.2,18,30,0.6,89,38,87,0.437,31,69,0.449,7,18,0.389,16,19,0.842,99,2014-03-11,SAC,DET,2014,102.5
11446,11446,46,@,L 89-94 ,240,34,93,0.366,25,71,0.352,9,22,0.409,12,14,0.857,89,33,78,0.423,24,51,0.471,9,27,0.333,19,21,0.905,94,2014-03-17,BOS,DAL,2014,98.5
11447,11447,47,@,L 89-103 ,240,35,77,0.455,31,64,0.484,4,13,0.308,15,20,0.75,89,37,82,0.451,27,55,0.491,10,27,0.37,19,21,0.905,103,2014-03-18,ORL,GSW,2014,108.0
11448,11448,48,Home,W 89-88 ,240,29,75,0.387,18,48,0.375,11,27,0.407,20,26,0.769,89,31,79,0.392,24,62,0.387,7,17,0.412,19,24,0.792,88,2014-03-22,UTA,ORL,2014,91.5
11449,11449,49,Home,L 89-100 ,240,32,86,0.372,28,65,0.431,4,21,0.19,21,25,0.84,89,39,82,0.476,27,55,0.491,12,27,0.444,10,18,0.556,100,2014-03-24,CHA,HOU,2014,106.0
11450,11450,50,Home,W 89-77 ,240,35,84,0.417,31,69,0.449,4,15,0.267,15,16,0.938,89,27,73,0.37,23,63,0.365,4,10,0.4,19,21,0.905,77,2014-03-24,CHI,IND,2014,79.0
11451,11451,51,@,W 89-84 ,240,32,80,0.4,23,55,0.418,9,25,0.36,16,18,0.889,89,28,79,0.354,18,48,0.375,10,31,0.323,18,22,0.818,84,2014-03-30,NYK,GSW,2014,89.0
11452,11452,52,Home,L 89-90 ,240,34,76,0.447,20,45,0.444,14,31,0.452,7,8,0.875,89,38,78,0.487,33,59,0.559,5,19,0.263,9,15,0.6,90,2014-04-04,NYK,WAS,2014,92.5
11453,11453,53,@,L 89-100 ,240,29,74,0.392,23,52,0.442,6,22,0.273,25,32,0.781,89,37,81,0.457,28,56,0.5,9,25,0.36,17,21,0.81,100,2014-04-13,CHI,NYK,2014,104.5
11454,11454,54,@,L 89-101 ,240,31,77,0.403,22,45,0.489,9,32,0.281,18,22,0.818,89,35,79,0.443,26,50,0.52,9,29,0.31,22,30,0.733,101,2014-04-14,OKC,NOP,2014,105.5
11455,11455,55,Home,W 89-79 ,240,30,85,0.353,24,61,0.393,6,24,0.25,23,31,0.742,89,31,84,0.369,25,58,0.431,6,26,0.231,11,19,0.579,79,2014-10-29,DEN,DET,2015,82.0
11456,11456,56,@,L 89-106 ,240,33,81,0.407,31,65,0.477,2,16,0.125,21,26,0.808,89,39,87,0.448,28,58,0.483,11,29,0.379,17,22,0.773,106,2014-10-29,OKC,POR,2015,111.5
11457,11457,57,Home,L 89-97 ,240,34,74,0.459,26,53,0.491,8,21,0.381,13,16,0.813,89,35,79,0.443,28,60,0.467,7,19,0.368,20,27,0.741,97,2014-10-31,IND,MEM,2015,100.5
11458,11458,58,@,L 89-94 ,240,32,78,0.41,24,53,0.453,8,25,0.32,17,23,0.739,89,35,87,0.402,33,69,0.478,2,18,0.111,22,26,0.846,94,2014-10-31,SAS,PHO,2015,95.0
11459,11459,59,@,L 89-96 ,240,30,77,0.39,26,55,0.473,4,22,0.182,25,31,0.806,89,35,82,0.427,30,64,0.469,5,18,0.278,21,29,0.724,96,2014-11-05,MIA,CHO,2015,98.5
11460,11460,60,Home,L 89-91 ,240,33,77,0.429,25,52,0.481,8,25,0.32,15,23,0.652,89,39,88,0.443,36,68,0.529,3,20,0.15,10,12,0.833,91,2014-11-05,PHI,ORL,2015,92.5
11461,11461,61,Home,L 89-91 ,240,37,79,0.468,25,54,0.463,12,25,0.48,3,11,0.273,89,34,81,0.42,25,63,0.397,9,18,0.5,14,17,0.824,91,2014-11-07,OKC,MEM,2015,95.5
11462,11462,62,@,W 89-85 ,240,33,83,0.398,31,64,0.484,2,19,0.105,21,27,0.778,89,33,74,0.446,28,52,0.538,5,22,0.227,14,17,0.824,85,2014-11-10,SAS,LAC,2015,87.5
11463,11463,63,Home,L 89-96 (OT),265,38,96,0.396,26,60,0.433,12,36,0.333,1,6,0.167,89,38,89,0.427,27,58,0.466,11,31,0.355,9,15,0.6,96,2014-11-14,OKC,DET,2015,101.5
11464,11464,64,Home,L 89-105 ,240,36,81,0.444,29,58,0.5,7,23,0.304,10,22,0.455,89,39,80,0.488,29,54,0.537,10,26,0.385,17,25,0.68,105,2014-11-17,LAC,CHI,2015,110.0
11465,11465,65,@,L 89-99 ,240,31,83,0.373,27,62,0.435,4,21,0.19,23,24,0.958,89,38,80,0.475,33,56,0.589,5,24,0.208,18,26,0.692,99,2014-11-21,DET,ATL,2015,101.5
11466,11466,66,Home,L 89-99 ,240,33,79,0.418,30,62,0.484,3,17,0.176,20,29,0.69,89,37,77,0.481,32,63,0.508,5,14,0.357,20,24,0.833,99,2014-11-25,NOP,SAC,2015,101.5
11467,11467,67,@,L 89-102 ,240,31,71,0.437,26,55,0.473,5,16,0.313,22,28,0.786,89,42,94,0.447,30,59,0.508,12,35,0.343,6,15,0.4,102,2014-11-26,SAC,HOU,2015,108.0
11468,11468,68,Home,L 89-111 ,240,36,87,0.414,30,69,0.435,6,18,0.333,11,15,0.733,89,41,85,0.482,30,59,0.508,11,26,0.423,18,20,0.9,111,2014-11-30,BOS,SAS,2015,116.5
11469,11469,69,@,L 89-119 ,240,31,82,0.378,26,60,0.433,5,22,0.227,22,30,0.733,89,45,85,0.529,38,65,0.585,7,20,0.35,22,27,0.815,119,2014-12-05,DEN,WAS,2015,122.5
11470,11470,70,Home,L 89-91 ,240,38,84,0.452,31,69,0.449,7,15,0.467,6,9,0.667,89,41,81,0.506,36,69,0.522,5,12,0.417,4,9,0.444,91,2014-12-10,ORL,WAS,2015,93.5
11471,11471,71,@,L 89-105 ,240,35,81,0.432,26,54,0.481,9,27,0.333,10,22,0.455,89,41,80,0.513,31,60,0.517,10,20,0.5,13,19,0.684,105,2014-12-17,BRK,TOR,2015,110.0
11472,11472,72,Home,L 89-98 ,240,36,73,0.493,27,52,0.519,9,21,0.429,8,12,0.667,89,33,80,0.413,25,50,0.5,8,30,0.267,24,26,0.923,98,2014-12-26,ORL,CLE,2015,102.0
11473,11473,73,Home,L 89-101 ,240,34,86,0.395,28,67,0.418,6,19,0.316,15,18,0.833,89,38,75,0.507,27,55,0.491,11,20,0.55,14,21,0.667,101,2015-01-03,MIN,UTA,2015,106.5
11474,11474,74,@,W 89-81 ,240,35,88,0.398,30,70,0.429,5,18,0.278,14,17,0.824,89,30,74,0.405,27,60,0.45,3,14,0.214,18,26,0.692,81,2015-01-07,BOS,BRK,2015,82.5
11475,11475,75,@,L 89-114 ,240,37,85,0.435,32,65,0.492,5,20,0.25,10,17,0.588,89,40,85,0.471,28,52,0.538,12,33,0.364,22,30,0.733,114,2015-01-07,LAL,LAC,2015,120.0
11476,11476,76,@,L 89-120 ,240,36,76,0.474,31,56,0.554,5,20,0.25,12,15,0.8,89,42,89,0.472,26,58,0.448,16,31,0.516,20,24,0.833,120,2015-01-11,WAS,ATL,2015,128.0
11477,11477,77,@,L 89-104 ,240,30,71,0.423,24,53,0.453,6,18,0.333,23,27,0.852,89,38,81,0.469,25,52,0.481,13,29,0.448,15,19,0.789,104,2015-01-14,MIA,GSW,2015,110.5
11478,11478,78,@,L 89-97 ,240,34,83,0.41,25,58,0.431,9,25,0.36,12,25,0.48,89,33,79,0.418,25,54,0.463,8,25,0.32,23,29,0.793,97,2015-01-16,DEN,DAL,2015,101.0
11479,11479,79,Home,L 89-110 ,240,35,82,0.427,29,57,0.509,6,25,0.24,13,17,0.765,89,42,69,0.609,30,46,0.652,12,23,0.522,14,16,0.875,110,2015-01-16,TOR,ATL,2015,116.0
11480,11480,80,@,L 89-107 ,240,38,82,0.463,31,54,0.574,7,28,0.25,6,7,0.857,89,38,88,0.432,23,53,0.434,15,35,0.429,16,19,0.842,107,2015-01-17,PHI,DET,2015,114.5
11481,11481,81,Home,W 89-69 ,240,31,80,0.388,23,63,0.365,8,17,0.471,19,23,0.826,89,28,84,0.333,25,74,0.338,3,10,0.3,10,16,0.625,69,2015-01-18,SAS,UTA,2015,70.5
11482,11482,82,Home,L 89-92 ,240,34,76,0.447,29,58,0.5,5,18,0.278,16,25,0.64,89,36,90,0.4,30,66,0.455,6,24,0.25,14,24,0.583,92,2015-01-19,MIL,TOR,2015,95.0
11483,11483,83,Home,L 89-90 ,240,33,89,0.371,24,61,0.393,9,28,0.321,14,19,0.737,89,39,87,0.448,32,68,0.471,7,19,0.368,5,7,0.714,90,2015-01-22,POR,BOS,2015,93.5
11484,11484,84,Home,W 89-87 ,240,36,75,0.48,32,58,0.552,4,17,0.235,13,15,0.867,89,32,78,0.41,29,63,0.46,3,15,0.2,20,23,0.87,87,2015-01-23,MIA,IND,2015,88.5
11485,11485,85,Home,W 89-69 ,240,37,78,0.474,30,57,0.526,7,21,0.333,8,12,0.667,89,23,75,0.307,21,55,0.382,2,20,0.1,21,23,0.913,69,2015-01-28,PHI,DET,2015,70.0
11486,11486,86,Home,L 89-94 ,240,35,81,0.432,30,57,0.526,5,24,0.208,14,20,0.7,89,34,76,0.447,25,50,0.5,9,26,0.346,17,25,0.68,94,2015-01-28,UTA,LAC,2015,98.5
11487,11487,87,@,L 89-90 ,240,36,69,0.522,34,57,0.596,2,12,0.167,15,20,0.75,89,35,81,0.432,30,64,0.469,5,17,0.294,15,17,0.882,90,2015-02-06,MEM,MIN,2015,92.5
11488,11488,88,Home,W 89-81 ,240,29,74,0.392,20,51,0.392,9,23,0.391,22,30,0.733,89,29,84,0.345,23,61,0.377,6,23,0.261,17,20,0.85,81,2015-02-07,PHI,CHO,2015,84.0
11489,11489,89,@,W 89-84 ,240,34,85,0.4,27,56,0.482,7,29,0.241,14,19,0.737,89,33,79,0.418,26,55,0.473,7,24,0.292,11,14,0.786,84,2015-02-09,GSW,PHI,2015,87.5
11490,11490,90,Home,W 89-88 ,240,30,93,0.323,20,62,0.323,10,31,0.323,19,20,0.95,89,33,78,0.423,26,49,0.531,7,29,0.241,15,23,0.652,88,2015-02-11,BOS,ATL,2015,91.5
11491,11491,91,@,L 89-105 ,240,32,86,0.372,30,74,0.405,2,12,0.167,23,30,0.767,89,37,83,0.446,30,63,0.476,7,20,0.35,24,25,0.96,105,2015-02-11,MEM,OKC,2015,108.5
11492,11492,92,Home,W 89-83 ,240,31,67,0.463,27,56,0.482,4,11,0.364,23,28,0.821,89,25,73,0.342,20,58,0.345,5,15,0.333,28,36,0.778,83,2015-02-11,ORL,NYK,2015,85.5
11493,11493,93,@,L 89-104 ,240,33,91,0.363,24,64,0.375,9,27,0.333,14,17,0.824,89,38,91,0.418,31,69,0.449,7,22,0.318,21,26,0.808,104,2015-02-19,DAL,OKC,2015,107.5
11494,11494,94,Home,W 89-81 ,240,33,78,0.423,28,63,0.444,5,15,0.333,18,22,0.818,89,30,84,0.357,23,58,0.397,7,26,0.269,14,21,0.667,81,2015-02-20,MIL,DEN,2015,84.5
11495,11495,95,Home,L 89-127 ,240,38,86,0.442,37,70,0.529,1,16,0.063,12,16,0.75,89,46,90,0.511,32,57,0.561,14,33,0.424,21,28,0.75,127,2015-02-20,WAS,CLE,2015,134.0
11496,11496,96,@,L 89-106 ,240,37,85,0.435,31,68,0.456,6,17,0.353,9,14,0.643,89,37,89,0.416,24,57,0.421,13,32,0.406,19,25,0.76,106,2015-02-22,WAS,DET,2015,112.5
11497,11497,97,@,L 89-96 ,240,33,77,0.429,31,63,0.492,2,14,0.143,21,31,0.677,89,37,96,0.385,28,65,0.431,9,31,0.29,13,16,0.813,96,2015-02-27,MIN,CHI,2015,100.5
11498,11498,98,Home,W 89-81 ,240,28,80,0.35,16,47,0.34,12,33,0.364,21,34,0.618,89,30,93,0.323,26,76,0.342,4,17,0.235,17,22,0.773,81,2015-02-27,PHI,WAS,2015,83.0
11499,11499,99,Home,L 89-113 ,240,31,77,0.403,27,55,0.491,4,22,0.182,23,28,0.821,89,42,87,0.483,29,59,0.492,13,28,0.464,16,19,0.842,113,2015-02-27,TOR,GSW,2015,119.5
11500,11500,0,@,L 89-104 ,240,32,87,0.368,26,67,0.388,6,20,0.3,19,26,0.731,89,38,81,0.469,27,58,0.466,11,23,0.478,17,19,0.895,104,2015-03-06,DAL,GSW,2015,109.5
11501,11501,1,@,W 89-83 ,240,27,71,0.38,21,59,0.356,6,12,0.5,29,41,0.707,89,32,88,0.364,22,56,0.393,10,32,0.313,9,18,0.5,83,2015-03-06,UTA,PHI,2015,88.0
11502,11502,2,Home,W 89-79 ,240,31,75,0.413,23,55,0.418,8,20,0.4,19,23,0.826,89,30,84,0.357,21,59,0.356,9,25,0.36,10,14,0.714,79,2015-03-07,CLE,PHO,2015,83.5
11503,11503,3,@,L 89-95 ,240,32,74,0.432,26,58,0.448,6,16,0.375,19,29,0.655,89,38,80,0.475,30,57,0.526,8,23,0.348,11,13,0.846,95,2015-03-07,MEM,NOP,2015,99.0
11504,11504,4,Home,W 89-76 ,240,35,79,0.443,24,48,0.5,11,31,0.355,8,15,0.533,89,31,83,0.373,29,75,0.387,2,8,0.25,12,21,0.571,76,2015-03-09,LAC,MIN,2015,77.0
11505,11505,5,Home,L 89-93 ,240,34,85,0.4,25,61,0.41,9,24,0.375,12,15,0.8,89,35,83,0.422,27,55,0.491,8,28,0.286,15,21,0.714,93,2015-03-14,IND,BOS,2015,97.0
11506,11506,6,@,L 89-102 ,240,32,73,0.438,27,59,0.458,5,14,0.357,20,30,0.667,89,41,83,0.494,35,65,0.538,6,18,0.333,14,23,0.609,102,2015-03-15,NYK,PHO,2015,105.0
11507,11507,7,@,L 89-108 ,240,34,84,0.405,26,60,0.433,8,24,0.333,13,24,0.542,89,44,88,0.5,36,68,0.529,8,20,0.4,12,15,0.8,108,2015-03-16,PHI,BOS,2015,112.0
11508,11508,8,@,L 89-101 ,240,35,88,0.398,30,68,0.441,5,20,0.25,14,20,0.7,89,38,81,0.469,33,58,0.569,5,23,0.217,20,23,0.87,101,2015-03-20,BOS,SAS,2015,103.5
11509,11509,9,@,L 89-106 ,240,35,84,0.417,27,65,0.415,8,19,0.421,11,16,0.688,89,39,75,0.52,35,64,0.547,4,11,0.364,24,29,0.828,106,2015-03-22,NYK,TOR,2015,108.0
11510,11510,10,Home,W 89-88 ,240,36,87,0.414,32,70,0.457,4,17,0.235,13,17,0.765,89,33,75,0.44,25,56,0.446,8,19,0.421,14,18,0.778,88,2015-03-24,MIL,MIA,2015,92.0
11511,11511,11,Home,L 89-111 ,240,37,85,0.435,33,68,0.485,4,17,0.235,11,16,0.688,89,43,84,0.512,29,50,0.58,14,34,0.412,11,13,0.846,111,2015-03-25,MEM,CLE,2015,118.0
11512,11512,12,Home,L 89-92 ,240,35,80,0.438,31,64,0.484,4,16,0.25,15,23,0.652,89,34,81,0.42,27,54,0.5,7,27,0.259,17,20,0.85,92,2015-03-25,UTA,POR,2015,95.5
11513,11513,13,@,L 89-94 ,240,31,73,0.425,25,57,0.439,6,16,0.375,21,32,0.656,89,32,84,0.381,26,55,0.473,6,29,0.207,24,35,0.686,94,2015-03-28,OKC,UTA,2015,97.0
11514,11514,14,@,L 89-103 ,240,36,82,0.439,30,68,0.441,6,14,0.429,11,12,0.917,89,42,83,0.506,38,66,0.576,4,17,0.235,15,18,0.833,103,2015-03-29,MEM,SAS,2015,105.0
11515,11515,15,@,L 89-112 ,240,37,82,0.451,35,62,0.565,2,20,0.1,13,19,0.684,89,37,85,0.435,23,55,0.418,14,30,0.467,24,36,0.667,112,2015-04-05,MIA,IND,2015,119.0
11516,11516,16,@,W 89-78 ,240,35,91,0.385,29,68,0.426,6,23,0.261,13,17,0.765,89,34,88,0.386,29,70,0.414,5,18,0.278,5,7,0.714,78,2015-04-09,CHI,MIA,2015,80.5
11517,11517,17,@,W 89-88 ,240,36,76,0.474,31,61,0.508,5,15,0.333,12,19,0.632,89,31,71,0.437,20,48,0.417,11,23,0.478,15,22,0.682,88,2015-04-10,MEM,UTA,2015,93.5
11518,11518,18,@,L 89-109 ,240,32,79,0.405,22,43,0.512,10,36,0.278,15,18,0.833,89,42,86,0.488,33,64,0.516,9,22,0.409,16,21,0.762,109,2015-11-01,HOU,MIA,2016,113.5
11519,11519,19,Home,L 89-103 ,240,29,74,0.392,22,54,0.407,7,20,0.35,24,40,0.6,89,40,83,0.482,37,63,0.587,3,20,0.15,20,25,0.8,103,2015-11-03,SAC,MEM,2016,104.5
11520,11520,20,Home,W 89-79 ,240,31,74,0.419,19,47,0.404,12,27,0.444,15,18,0.833,89,30,91,0.33,24,72,0.333,6,19,0.316,13,14,0.929,79,2015-11-07,UTA,MEM,2016,82.0
11521,11521,21,@,L 89-93 ,240,34,80,0.425,29,60,0.483,5,20,0.25,16,18,0.889,89,35,72,0.486,28,50,0.56,7,22,0.318,16,22,0.727,93,2015-11-18,TOR,UTA,2016,96.5
11522,11522,22,Home,L 89-111 ,240,28,73,0.384,23,54,0.426,5,19,0.263,28,40,0.7,89,42,77,0.545,31,50,0.62,11,27,0.407,16,18,0.889,111,2015-11-23,UTA,OKC,2016,116.5
11523,11523,23,@,L 89-92 ,240,37,90,0.411,35,76,0.461,2,14,0.143,13,18,0.722,89,37,86,0.43,31,70,0.443,6,16,0.375,12,20,0.6,92,2015-11-30,SAS,CHI,2016,95.0
11524,11524,24,@,W 89-77 ,240,36,78,0.462,28,55,0.509,8,23,0.348,9,10,0.9,89,28,87,0.322,19,55,0.345,9,32,0.281,12,14,0.857,77,2015-12-15,CLE,BOS,2016,81.5
11525,11525,25,@,L 89-110 ,240,31,79,0.392,24,55,0.436,7,24,0.292,20,22,0.909,89,36,79,0.456,27,54,0.5,9,25,0.36,29,37,0.784,110,2015-12-21,PHO,UTA,2016,114.5
11526,11526,26,Home,L 89-102 ,240,29,81,0.358,21,53,0.396,8,28,0.286,23,32,0.719,89,36,85,0.424,29,56,0.518,7,29,0.241,23,26,0.885,102,2015-12-23,CHA,BOS,2016,105.5
11527,11527,27,@,L 89-115 ,240,33,95,0.347,26,67,0.388,7,28,0.25,16,24,0.667,89,41,85,0.482,28,54,0.519,13,31,0.419,20,23,0.87,115,2015-12-23,POR,NOP,2016,121.5
11528,11528,28,Home,W 89-83 ,240,32,78,0.41,27,60,0.45,5,18,0.278,20,27,0.741,89,30,95,0.316,25,65,0.385,5,30,0.167,18,25,0.72,83,2015-12-25,GSW,CLE,2016,85.5
11529,11529,29,@,L 89-104 ,240,37,83,0.446,32,63,0.508,5,20,0.25,10,15,0.667,89,45,82,0.549,38,65,0.585,7,17,0.412,7,11,0.636,104,2015-12-28,NOP,ORL,2016,107.5
11530,11530,30,Home,L 89-95 ,240,36,82,0.439,29,57,0.509,7,25,0.28,10,15,0.667,89,35,90,0.389,25,56,0.446,10,34,0.294,15,19,0.789,95,2015-12-31,NOP,LAC,2016,100.0
11531,11531,31,@,L 89-115 ,240,36,81,0.444,30,61,0.492,6,20,0.3,11,11,1.0,89,43,88,0.489,29,58,0.5,14,30,0.467,15,21,0.714,115,2016-01-04,ORL,DET,2016,122.0
11532,11532,32,@,L 89-103 ,240,38,82,0.463,33,73,0.452,5,9,0.556,8,10,0.8,89,43,92,0.467,35,65,0.538,8,27,0.296,9,14,0.643,103,2016-01-09,BRK,DET,2016,107.0
11533,11533,33,@,L 89-108 ,240,32,82,0.39,26,51,0.51,6,31,0.194,19,25,0.76,89,38,82,0.463,23,49,0.469,15,33,0.455,17,29,0.586,108,2016-01-13,DAL,OKC,2016,115.5
11534,11534,34,@,L 89-114 ,240,34,87,0.391,29,58,0.5,5,29,0.172,16,24,0.667,89,42,76,0.553,32,53,0.604,10,23,0.435,20,30,0.667,114,2016-01-16,POR,PHI,2016,119.0
11535,11535,35,Home,L 89-117 ,240,32,81,0.395,26,63,0.413,6,18,0.333,19,23,0.826,89,42,86,0.488,33,72,0.458,9,14,0.643,24,28,0.857,117,2016-01-21,PHO,SAS,2016,121.5
11536,11536,36,@,W 89-84 ,240,37,81,0.457,34,67,0.507,3,14,0.214,12,17,0.706,89,35,88,0.398,30,70,0.429,5,18,0.278,9,12,0.75,84,2016-01-25,MIA,CHI,2016,86.5
11537,11537,37,Home,L 89-91 ,240,35,83,0.422,30,67,0.448,5,16,0.313,14,24,0.583,89,32,78,0.41,17,41,0.415,15,37,0.405,12,24,0.5,91,2016-01-26,IND,LAC,2016,98.5
11538,11538,38,@,L 89-106 ,240,32,78,0.41,28,63,0.444,4,15,0.267,21,28,0.75,89,35,79,0.443,24,50,0.48,11,29,0.379,25,32,0.781,106,2016-01-26,WAS,TOR,2016,111.5
11539,11539,39,Home,L 89-97 ,240,31,82,0.378,25,62,0.403,6,20,0.3,21,28,0.75,89,40,90,0.444,37,71,0.521,3,19,0.158,14,17,0.824,97,2016-02-02,NYK,BOS,2016,98.5
11540,11540,40,Home,L 89-98 ,240,30,80,0.375,21,56,0.375,9,24,0.375,20,26,0.769,89,34,78,0.436,29,62,0.468,5,16,0.313,25,31,0.806,98,2016-02-06,PHO,UTA,2016,100.5
11541,11541,41,Home,L 89-103 ,240,36,80,0.45,28,52,0.538,8,28,0.286,9,17,0.529,89,39,70,0.557,28,50,0.56,11,20,0.55,14,17,0.824,103,2016-02-08,DET,TOR,2016,108.5
11542,11542,42,Home,W 89-87 ,240,31,78,0.397,27,51,0.529,4,27,0.148,23,33,0.697,89,29,93,0.312,21,58,0.362,8,35,0.229,21,26,0.808,87,2016-02-08,IND,LAL,2016,91.0
11543,11543,43,@,L 89-103 ,240,31,77,0.403,27,62,0.435,4,15,0.267,23,29,0.793,89,42,86,0.488,35,68,0.515,7,18,0.389,12,21,0.571,103,2016-02-18,UTA,WAS,2016,106.5
11544,11544,44,@,L 89-109 ,240,29,83,0.349,23,60,0.383,6,23,0.261,25,33,0.758,89,43,94,0.457,31,68,0.456,12,26,0.462,11,17,0.647,109,2016-02-23,NOP,WAS,2016,115.0
11545,11545,45,@,L 89-101 ,240,36,87,0.414,35,74,0.473,1,13,0.077,16,23,0.696,89,39,96,0.406,34,80,0.425,5,16,0.313,18,22,0.818,101,2016-02-27,MIA,BOS,2016,103.5
11546,11546,46,@,L 89-102 ,240,38,99,0.384,32,80,0.4,6,19,0.316,7,11,0.636,89,39,97,0.402,32,76,0.421,7,21,0.333,17,22,0.773,102,2016-03-02,CHI,ORL,2016,105.5
11547,11547,47,@,L 89-102 ,240,36,92,0.391,30,66,0.455,6,26,0.231,11,15,0.733,89,42,79,0.532,38,63,0.603,4,16,0.25,14,18,0.778,102,2016-03-05,DET,NYK,2016,104.0
11548,11548,48,@,L 89-95 ,240,33,87,0.379,28,70,0.4,5,17,0.294,18,22,0.818,89,38,84,0.452,29,56,0.518,9,28,0.321,10,15,0.667,95,2016-03-11,BRK,PHI,2016,99.5
11549,11549,49,Home,L 89-107 ,240,34,77,0.442,32,64,0.5,2,13,0.154,19,26,0.731,89,39,83,0.47,25,53,0.472,14,30,0.467,15,17,0.882,107,2016-03-15,MIL,TOR,2016,114.0
11550,11550,50,@,L 89-99 ,240,32,81,0.395,22,60,0.367,10,21,0.476,15,17,0.882,89,39,87,0.448,31,58,0.534,8,29,0.276,13,17,0.765,99,2016-03-19,NYK,WAS,2016,103.0
11551,11551,51,@,W 89-87 ,240,31,77,0.403,20,48,0.417,11,29,0.379,16,20,0.8,89,33,74,0.446,24,51,0.471,9,23,0.391,12,22,0.545,87,2016-03-23,UTA,HOU,2016,91.5
11552,11552,52,@,L 89-111 ,240,36,88,0.409,30,64,0.469,6,24,0.25,11,17,0.647,89,48,89,0.539,41,70,0.586,7,19,0.368,8,12,0.667,111,2016-03-26,CHI,ORL,2016,114.5
11553,11553,53,@,L 89-91 ,240,35,77,0.455,32,60,0.533,3,17,0.176,16,18,0.889,89,35,85,0.412,27,60,0.45,8,25,0.32,13,17,0.765,91,2016-03-30,NYK,DAL,2016,95.0
11554,11554,54,Home,L 89-98 ,240,31,81,0.383,18,48,0.375,13,33,0.394,14,24,0.583,89,39,85,0.459,31,61,0.508,8,24,0.333,12,14,0.857,98,2016-04-01,DET,DAL,2016,102.0
11555,11555,55,@,L 89-107 ,240,32,80,0.4,27,58,0.466,5,22,0.227,20,25,0.8,89,44,84,0.524,35,70,0.5,9,14,0.643,10,14,0.714,107,2016-04-05,DET,MIA,2016,111.5
11556,11556,56,Home,L 89-93 ,240,32,89,0.36,25,69,0.362,7,20,0.35,18,21,0.857,89,37,78,0.474,30,58,0.517,7,20,0.35,12,19,0.632,93,2016-04-10,NYK,TOR,2016,96.5
11557,11557,57,@,L 89-96 ,240,32,84,0.381,23,61,0.377,9,23,0.391,16,21,0.762,89,31,75,0.413,25,50,0.5,6,25,0.24,28,40,0.7,96,2016-10-28,LAL,UTA,2017,99.0
11558,11558,58,@,L 89-102 ,240,35,86,0.407,28,64,0.438,7,22,0.318,12,15,0.8,89,41,89,0.461,33,76,0.434,8,13,0.615,12,21,0.571,102,2016-11-01,NYK,DET,2017,106.0
11559,11559,59,Home,W 89-83 (OT),265,33,94,0.351,25,67,0.373,8,27,0.296,15,20,0.75,89,30,81,0.37,19,47,0.404,11,34,0.324,12,16,0.75,83,2016-11-02,MEM,NOP,2017,88.5
11560,11560,60,Home,W 89-82 ,240,34,88,0.386,24,61,0.393,10,27,0.37,11,19,0.579,89,30,82,0.366,23,61,0.377,7,21,0.333,15,19,0.789,82,2016-11-16,ORL,NOP,2017,85.5
11561,11561,61,@,L 89-93 ,240,32,77,0.416,25,52,0.481,7,25,0.28,18,24,0.75,89,35,86,0.407,27,57,0.474,8,29,0.276,15,21,0.714,93,2016-11-21,ORL,MIL,2017,97.0
11562,11562,62,Home,L 89-105 ,240,31,78,0.397,22,56,0.393,9,22,0.409,18,22,0.818,89,40,90,0.444,34,69,0.493,6,21,0.286,19,26,0.731,105,2016-11-25,PHI,CHI,2017,108.0
11563,11563,63,Home,L 89-112 ,240,31,78,0.397,22,51,0.431,9,27,0.333,18,21,0.857,89,45,92,0.489,33,64,0.516,12,28,0.429,10,11,0.909,112,2016-11-29,CHA,DET,2017,118.0
11564,11564,64,Home,L 89-120 ,240,32,78,0.41,22,48,0.458,10,30,0.333,15,20,0.75,89,47,84,0.56,37,62,0.597,10,22,0.455,16,21,0.762,120,2016-12-07,DAL,SAC,2017,125.0
11565,11565,65,@,L 89-110 ,240,34,77,0.442,25,50,0.5,9,27,0.333,12,20,0.6,89,38,87,0.437,30,61,0.492,8,26,0.308,26,29,0.897,110,2016-12-10,GSW,MEM,2017,114.0
11566,11566,66,@,L 89-95 ,240,33,89,0.371,24,62,0.387,9,27,0.333,14,17,0.824,89,37,82,0.451,30,57,0.526,7,25,0.28,14,25,0.56,95,2016-12-14,IND,MIA,2017,98.5
11567,11567,67,@,L 89-109 ,240,30,82,0.366,24,63,0.381,6,19,0.316,23,27,0.852,89,42,72,0.583,29,49,0.592,13,23,0.565,12,15,0.8,109,2016-12-14,OKC,UTA,2017,115.5
11568,11568,68,Home,L 89-100 ,240,32,88,0.364,26,57,0.456,6,31,0.194,19,24,0.792,89,36,79,0.456,27,49,0.551,9,30,0.3,19,22,0.864,100,2016-12-16,PHI,LAL,2017,104.5
11569,11569,69,@,L 89-102 ,240,31,79,0.392,22,51,0.431,9,28,0.321,18,23,0.783,89,35,74,0.473,23,49,0.469,12,25,0.48,20,22,0.909,102,2016-12-28,SAC,POR,2017,108.0
11570,11570,70,Home,L 89-101 ,240,32,68,0.471,25,49,0.51,7,19,0.368,18,25,0.72,89,38,77,0.494,24,46,0.522,14,31,0.452,11,14,0.786,101,2016-12-29,LAL,DAL,2017,108.0
11571,11571,71,Home,L 89-95 ,240,35,87,0.402,28,64,0.438,7,23,0.304,12,18,0.667,89,36,73,0.493,30,51,0.588,6,22,0.273,17,28,0.607,95,2017-01-01,MIN,POR,2017,98.0
11572,11572,72,Home,L 89-101 ,240,33,78,0.423,27,51,0.529,6,27,0.222,17,23,0.739,89,39,93,0.419,32,69,0.464,7,24,0.292,16,20,0.8,101,2017-01-02,BRK,UTA,2017,104.5
11573,11573,73,@,L 89-104 ,240,35,89,0.393,32,71,0.451,3,18,0.167,16,21,0.762,89,44,92,0.478,37,69,0.536,7,23,0.304,9,11,0.818,104,2017-01-12,CHI,NYK,2017,107.5
11574,11574,74,@,L 89-94 ,240,34,86,0.395,28,62,0.452,6,24,0.25,15,23,0.652,89,31,69,0.449,23,45,0.511,8,24,0.333,24,32,0.75,94,2017-01-18,TOR,PHI,2017,98.0
11575,11575,75,Home,W 89-74 ,240,32,81,0.395,28,62,0.452,4,19,0.211,21,25,0.84,89,30,82,0.366,26,63,0.413,4,19,0.211,10,18,0.556,74,2017-02-06,MEM,SAS,2017,76.0
11576,11576,76,@,L 89-117 ,240,35,84,0.417,25,59,0.424,10,25,0.4,9,13,0.692,89,44,81,0.543,38,57,0.667,6,24,0.25,23,26,0.885,117,2017-02-12,CHI,MIN,2017,120.0
11577,11577,77,@,L 89-102 ,240,34,78,0.436,27,57,0.474,7,21,0.333,14,19,0.737,89,40,79,0.506,34,58,0.586,6,21,0.286,16,16,1.0,102,2017-02-13,DET,MIL,2017,105.0
11578,11578,78,@,L 89-96 ,240,37,83,0.446,28,57,0.491,9,26,0.346,6,13,0.462,89,33,76,0.434,24,58,0.414,9,18,0.5,21,23,0.913,96,2017-02-27,MIA,DAL,2017,100.5
11579,11579,79,@,L 89-104 ,240,33,82,0.402,31,60,0.517,2,22,0.091,21,30,0.7,89,42,86,0.488,35,61,0.574,7,25,0.28,13,16,0.813,104,2017-03-05,OKC,DAL,2017,107.5
11580,11580,80,@,W 88-87 ,240,36,89,0.404,29,74,0.392,7,15,0.467,9,14,0.643,88,36,76,0.474,32,60,0.533,4,16,0.25,11,20,0.55,87,2011-12-25,CHI,LAL,2012,89.0
11581,11581,81,@,L 88-96 ,240,30,76,0.395,25,61,0.41,5,15,0.333,23,28,0.821,88,39,82,0.476,31,67,0.463,8,15,0.533,10,13,0.769,96,2011-12-31,IND,DET,2012,100.0
11582,11582,82,@,L 88-93 ,240,33,78,0.423,29,63,0.46,4,15,0.267,18,22,0.818,88,36,75,0.48,30,51,0.588,6,24,0.25,15,24,0.625,93,2012-01-01,POR,LAC,2012,96.0
11583,11583,83,Home,L 88-96 ,240,36,77,0.468,28,60,0.467,8,17,0.471,8,10,0.8,88,37,79,0.468,32,58,0.552,5,21,0.238,17,22,0.773,96,2012-01-06,NOP,DEN,2012,98.5
11584,11584,84,@,W 88-87 ,240,32,81,0.395,28,65,0.431,4,16,0.25,20,28,0.714,88,29,70,0.414,22,51,0.431,7,19,0.368,22,24,0.917,87,2012-01-07,UTA,GSW,2012,90.5
11585,11585,85,@,W 88-79 ,240,34,76,0.447,30,63,0.476,4,13,0.308,16,21,0.762,88,31,75,0.413,25,61,0.41,6,14,0.429,11,13,0.846,79,2012-01-13,CHI,BOS,2012,82.0
11586,11586,86,Home,L 88-97 ,240,34,87,0.391,28,73,0.384,6,14,0.429,14,16,0.875,88,36,80,0.45,29,61,0.475,7,19,0.368,18,19,0.947,97,2012-01-16,BOS,OKC,2012,100.5
11587,11587,87,Home,L 88-91 ,240,32,86,0.372,28,71,0.394,4,15,0.267,20,30,0.667,88,36,79,0.456,29,67,0.433,7,12,0.583,12,16,0.75,91,2012-01-18,NYK,PHO,2012,94.5
11588,11588,88,@,L 88-92 ,240,34,78,0.436,33,65,0.508,1,13,0.077,19,27,0.704,88,28,93,0.301,20,62,0.323,8,31,0.258,28,41,0.683,92,2012-01-18,IND,SAC,2012,96.0
11589,11589,89,@,L 88-90 (OT),265,37,94,0.394,34,83,0.41,3,11,0.273,11,16,0.688,88,35,88,0.398,26,61,0.426,9,27,0.333,11,13,0.846,90,2012-01-19,NOP,HOU,2012,94.5
11590,11590,90,@,W 88-86 ,240,36,83,0.434,31,62,0.5,5,21,0.238,11,19,0.579,88,31,82,0.378,26,57,0.456,5,25,0.2,19,21,0.905,86,2012-01-20,SAC,SAS,2012,88.5
11591,11591,91,@,W 88-87 ,240,34,79,0.43,31,66,0.47,3,13,0.231,17,20,0.85,88,36,69,0.522,31,58,0.534,5,11,0.455,10,14,0.714,87,2012-01-29,CLE,BOS,2012,89.5
11592,11592,92,Home,L 88-98 ,240,37,92,0.402,34,78,0.436,3,14,0.214,11,13,0.846,88,34,75,0.453,28,55,0.509,6,20,0.3,24,31,0.774,98,2012-01-30,WAS,CHI,2012,101.0
11593,11593,93,Home,W 88-80 ,240,34,81,0.42,30,67,0.448,4,14,0.286,16,19,0.842,88,26,74,0.351,23,57,0.404,3,17,0.176,25,33,0.758,80,2012-02-03,DET,MIL,2012,81.5
11594,11594,94,@,L 88-91 ,240,32,67,0.478,26,54,0.481,6,13,0.462,18,27,0.667,88,37,93,0.398,31,70,0.443,6,23,0.261,11,15,0.733,91,2012-02-04,DAL,CLE,2012,94.0
11595,11595,95,@,L 88-99 ,240,33,76,0.434,31,65,0.477,2,11,0.182,20,26,0.769,88,35,73,0.479,26,45,0.578,9,28,0.321,20,31,0.645,99,2012-02-06,UTA,NYK,2012,103.5
11596,11596,96,@,W 88-87 (OT),265,36,91,0.396,35,76,0.461,1,15,0.067,15,20,0.75,88,38,97,0.392,32,78,0.41,6,19,0.316,5,5,1.0,87,2012-02-09,LAL,BOS,2012,90.0
11597,11597,97,Home,L 88-98 ,240,34,78,0.436,32,68,0.471,2,10,0.2,18,23,0.783,88,42,83,0.506,37,70,0.529,5,13,0.385,9,13,0.692,98,2012-02-12,MEM,UTA,2012,100.5
11598,11598,98,Home,L 88-98 ,240,34,77,0.442,33,71,0.465,1,6,0.167,19,32,0.594,88,35,74,0.473,31,62,0.5,4,12,0.333,24,29,0.828,98,2012-02-15,BOS,DET,2012,100.0
11599,11599,99,@,L 88-93 ,240,35,75,0.467,31,58,0.534,4,17,0.235,14,16,0.875,88,32,81,0.395,25,62,0.403,7,19,0.368,22,26,0.846,93,2012-02-16,BRK,IND,2012,96.5
11600,11600,0,@,L 88-104 ,240,36,84,0.429,31,64,0.484,5,20,0.25,11,19,0.579,88,37,79,0.468,30,58,0.517,7,21,0.333,23,29,0.793,104,2012-02-20,WAS,PHO,2012,107.5
11601,11601,1,Home,L 88-102 ,240,31,88,0.352,23,69,0.333,8,19,0.421,18,23,0.783,88,34,85,0.4,27,69,0.391,7,16,0.438,27,32,0.844,102,2012-02-22,CHA,IND,2012,105.5
11602,11602,2,@,L 88-102 ,240,31,79,0.392,24,62,0.387,7,17,0.412,19,22,0.864,88,42,85,0.494,38,71,0.535,4,14,0.286,14,19,0.737,102,2012-02-23,NYK,MIA,2012,104.0
11603,11603,3,Home,W 88-85 ,240,29,75,0.387,22,55,0.4,7,20,0.35,23,28,0.821,88,35,75,0.467,33,58,0.569,2,17,0.118,13,18,0.722,85,2012-02-28,HOU,TOR,2012,86.0
11604,11604,4,Home,L 88-92 ,240,37,90,0.411,33,73,0.452,4,17,0.235,10,12,0.833,88,30,78,0.385,24,59,0.407,6,19,0.316,26,34,0.765,92,2012-02-29,PHI,OKC,2012,95.0
11605,11605,5,@,L 88-96 ,240,38,99,0.384,36,86,0.419,2,13,0.154,10,14,0.714,88,40,88,0.455,35,76,0.461,5,12,0.417,11,16,0.688,96,2012-03-04,SAC,PHO,2012,98.5
11606,11606,6,Home,L 88-92 ,240,32,79,0.405,24,59,0.407,8,20,0.4,16,20,0.8,88,35,79,0.443,26,51,0.51,9,28,0.321,13,28,0.464,92,2012-03-05,TOR,ORL,2012,96.5
11607,11607,7,Home,W 88-85 (OT),265,37,93,0.398,34,83,0.41,3,10,0.3,11,12,0.917,88,34,81,0.42,31,59,0.525,3,22,0.136,14,17,0.824,85,2012-03-06,DET,LAL,2012,86.5
11608,11608,8,Home,L 88-96 ,240,29,76,0.382,26,61,0.426,3,15,0.2,27,33,0.818,88,37,74,0.5,29,55,0.527,8,19,0.421,14,21,0.667,96,2012-03-13,CLE,TOR,2012,100.0
11609,11609,9,@,L 88-102 ,240,38,78,0.487,33,67,0.493,5,11,0.455,7,9,0.778,88,40,83,0.482,28,56,0.5,12,27,0.444,10,13,0.769,102,2012-03-16,WAS,ATL,2012,108.0
11610,11610,10,Home,L 88-102 ,240,32,79,0.405,28,60,0.467,4,19,0.211,20,27,0.741,88,32,77,0.416,25,53,0.472,7,24,0.292,31,40,0.775,102,2012-03-17,IND,NYK,2012,105.5
11611,11611,11,@,W 88-73 ,240,34,77,0.442,32,61,0.525,2,16,0.125,18,20,0.9,88,29,75,0.387,23,60,0.383,6,15,0.4,9,17,0.529,73,2012-03-23,MIA,DET,2012,76.0
11612,11612,12,Home,W 88-76 ,240,34,70,0.486,31,60,0.517,3,10,0.3,17,18,0.944,88,30,87,0.345,27,73,0.37,3,14,0.214,13,19,0.684,76,2012-03-25,BOS,WAS,2012,77.5
11613,11613,13,@,W 88-83 ,240,33,81,0.407,25,60,0.417,8,21,0.381,14,20,0.7,88,31,78,0.397,28,65,0.431,3,13,0.231,18,22,0.818,83,2012-03-28,MIN,CHA,2012,84.5
11614,11614,14,Home,L 88-99 ,240,36,98,0.367,30,76,0.395,6,22,0.273,10,11,0.909,88,38,73,0.521,36,56,0.643,2,17,0.118,21,29,0.724,99,2012-03-30,CHA,DEN,2012,100.0
11615,11615,15,Home,W 88-85 ,240,32,77,0.416,25,55,0.455,7,22,0.318,17,22,0.773,88,39,92,0.424,37,82,0.451,2,10,0.2,5,10,0.5,85,2012-03-31,LAL,NOH,2012,86.0
11616,11616,16,Home,L 88-94 ,240,33,73,0.452,28,52,0.538,5,21,0.238,17,24,0.708,88,34,87,0.391,30,71,0.423,4,16,0.25,22,24,0.917,94,2012-04-02,OKC,MEM,2012,96.0
11617,11617,17,@,L 88-101 ,240,32,86,0.372,26,67,0.388,6,19,0.316,18,19,0.947,88,37,81,0.457,25,57,0.439,12,24,0.5,15,19,0.789,101,2012-04-04,BRK,POR,2012,107.0
11618,11618,18,@,W 88-82 ,240,29,80,0.363,23,60,0.383,6,20,0.3,24,31,0.774,88,31,78,0.397,26,65,0.4,5,13,0.385,15,20,0.75,82,2012-04-07,ORL,PHI,2012,84.5
11619,11619,19,Home,L 88-107 ,240,34,88,0.386,32,77,0.416,2,11,0.182,18,21,0.857,88,39,85,0.459,33,68,0.485,6,17,0.353,23,26,0.885,107,2012-04-10,BRK,PHI,2012,110.0
11620,11620,20,Home,W 88-86 (OT),265,37,89,0.416,34,76,0.447,3,13,0.231,11,13,0.846,88,34,83,0.41,32,63,0.508,2,20,0.1,16,23,0.696,86,2012-04-11,BOS,ATL,2012,87.0
11621,11621,21,Home,W 88-75 ,240,32,73,0.438,29,60,0.483,3,13,0.231,21,21,1.0,88,25,70,0.357,20,52,0.385,5,18,0.278,20,25,0.8,75,2012-04-15,NOP,MEM,2012,77.5
11622,11622,22,@,L 88-111 ,240,32,87,0.368,25,62,0.403,7,25,0.28,17,25,0.68,88,39,88,0.443,28,64,0.438,11,24,0.458,22,25,0.88,111,2012-04-16,MIN,IND,2012,116.5
11623,11623,23,Home,L 88-114 ,240,39,89,0.438,37,74,0.5,2,15,0.133,8,14,0.571,88,48,87,0.552,45,78,0.577,3,9,0.333,15,20,0.75,114,2012-04-22,CHA,SAC,2012,115.5
11624,11624,24,@,L 88-97 ,240,35,76,0.461,28,56,0.5,7,20,0.35,11,13,0.846,88,35,85,0.412,30,69,0.435,5,16,0.313,22,24,0.917,97,2012-04-22,HOU,MIA,2012,99.5
11625,11625,25,Home,L 88-93 ,240,30,82,0.366,23,56,0.411,7,26,0.269,21,21,1.0,88,41,92,0.446,36,76,0.474,5,16,0.313,6,10,0.6,93,2012-04-22,MIN,GSW,2012,95.5
11626,11626,26,@,L 88-100 ,240,34,84,0.405,29,61,0.475,5,23,0.217,15,23,0.652,88,37,87,0.425,33,74,0.446,4,13,0.308,22,29,0.759,100,2012-04-24,PHO,UTA,2012,102.0
11627,11627,27,Home,W 88-76 ,240,34,72,0.472,32,60,0.533,2,12,0.167,18,22,0.818,88,30,73,0.411,23,47,0.489,7,26,0.269,9,15,0.6,76,2012-04-26,MEM,ORL,2012,79.5
11628,11628,28,Home,L 88-90 ,240,33,91,0.363,27,74,0.365,6,17,0.353,16,19,0.842,88,37,78,0.474,32,67,0.478,5,11,0.455,11,16,0.688,90,2012-10-31,TOR,IND,2013,92.5
11629,11629,29,Home,L 88-99 ,240,33,74,0.446,28,60,0.467,5,14,0.357,17,21,0.81,88,40,86,0.465,32,68,0.471,8,18,0.444,11,12,0.917,99,2012-11-02,BOS,MIL,2013,103.0
11630,11630,30,Home,W 88-86 ,240,37,81,0.457,32,67,0.478,5,14,0.357,9,14,0.643,88,35,85,0.412,25,57,0.439,10,28,0.357,6,12,0.5,86,2012-11-02,NOP,UTA,2013,91.0
11631,11631,31,Home,L 88-110 ,240,29,86,0.337,21,64,0.328,8,22,0.364,22,26,0.846,88,39,84,0.464,26,52,0.5,13,32,0.406,19,19,1.0,110,2012-11-05,PHI,NYK,2013,116.5
11632,11632,32,@,L 88-108 ,240,30,84,0.357,23,54,0.426,7,30,0.233,21,25,0.84,88,35,74,0.473,26,49,0.531,9,25,0.36,29,34,0.853,108,2012-11-06,TOR,OKC,2013,112.5
11633,11633,33,@,L 88-92 ,240,34,78,0.436,27,55,0.491,7,23,0.304,13,18,0.722,88,33,71,0.465,28,53,0.528,5,18,0.278,21,25,0.84,92,2012-11-14,ATL,GSW,2013,94.5
11634,11634,34,Home,L 88-97 ,240,34,79,0.43,29,61,0.475,5,18,0.278,15,21,0.714,88,38,71,0.535,30,52,0.577,8,19,0.421,13,19,0.684,97,2012-11-17,PHO,MIA,2013,101.0
11635,11635,35,Home,W 88-76 ,240,33,90,0.367,26,65,0.4,7,25,0.28,15,19,0.789,88,28,71,0.394,20,51,0.392,8,20,0.4,12,18,0.667,76,2012-11-18,NYK,IND,2013,80.0
11636,11636,36,Home,L 88-102 ,240,33,72,0.458,28,59,0.475,5,13,0.385,17,21,0.81,88,35,73,0.479,24,52,0.462,11,21,0.524,21,25,0.84,102,2012-11-28,MIL,NYK,2013,107.5
11637,11637,37,@,L 88-93 ,240,36,82,0.439,33,70,0.471,3,12,0.25,13,18,0.722,88,38,81,0.469,34,74,0.459,4,7,0.571,13,21,0.619,93,2012-12-01,PHI,CHI,2013,95.0
11638,11638,38,@,L 88-91 ,240,34,82,0.415,28,63,0.444,6,19,0.316,14,17,0.824,88,36,79,0.456,32,66,0.485,4,13,0.308,15,20,0.75,91,2012-12-01,BOS,MIL,2013,93.0
11639,11639,39,Home,L 88-105 ,240,35,83,0.422,30,63,0.476,5,20,0.25,13,23,0.565,88,41,77,0.532,28,52,0.538,13,25,0.52,10,17,0.588,105,2012-12-04,PHI,MIN,2013,111.5
11640,11640,40,Home,L 88-97 ,240,32,79,0.405,25,54,0.463,7,25,0.28,17,23,0.739,88,33,71,0.465,26,55,0.473,7,16,0.438,24,30,0.8,97,2012-12-09,BRK,MIL,2013,100.5
11641,11641,41,@,L 88-92 ,240,33,83,0.398,24,61,0.393,9,22,0.409,13,16,0.813,88,31,71,0.437,26,56,0.464,5,15,0.333,25,32,0.781,92,2012-12-12,NOP,OKC,2013,94.5
11642,11642,42,Home,L 88-94 ,240,37,75,0.493,33,57,0.579,4,18,0.222,10,17,0.588,88,29,64,0.453,19,45,0.422,10,19,0.526,26,35,0.743,94,2012-12-12,TOR,BRK,2013,99.0
11643,11643,43,@,W 88-77 ,240,35,72,0.486,28,48,0.583,7,24,0.292,11,16,0.688,88,32,83,0.386,29,70,0.414,3,13,0.231,10,15,0.667,77,2012-12-15,IND,DET,2013,78.5
11644,11644,44,@,L 88-103 ,240,38,81,0.469,32,65,0.492,6,16,0.375,6,8,0.75,88,38,81,0.469,26,56,0.464,12,25,0.48,15,20,0.75,103,2012-12-15,BOS,SAS,2013,109.0
11645,11645,45,@,W 88-76 ,240,35,78,0.449,30,56,0.536,5,22,0.227,13,17,0.765,88,29,71,0.408,22,51,0.431,7,20,0.35,11,19,0.579,76,2012-12-17,LAC,DET,2013,79.5
11646,11646,46,@,L 88-110 ,240,33,87,0.379,30,67,0.448,3,20,0.15,19,30,0.633,88,47,92,0.511,41,72,0.569,6,20,0.3,10,15,0.667,110,2012-12-22,CHA,DEN,2013,113.0
11647,11647,47,Home,L 88-123 ,240,36,81,0.444,31,63,0.492,5,18,0.278,11,22,0.5,88,46,82,0.561,31,55,0.564,15,27,0.556,16,21,0.762,123,2012-12-29,ORL,TOR,2013,130.5
11648,11648,48,Home,W 88-83 ,240,28,70,0.4,16,45,0.356,12,25,0.48,20,24,0.833,88,31,82,0.378,28,71,0.394,3,11,0.273,18,24,0.75,83,2012-12-31,IND,MEM,2013,84.5
11649,11649,49,@,L 88-95 ,240,33,73,0.452,27,52,0.519,6,21,0.286,16,20,0.8,88,40,83,0.482,35,70,0.5,5,13,0.385,10,12,0.833,95,2013-01-07,SAS,NOH,2013,97.5
11650,11650,50,Home,W 88-79 ,240,35,84,0.417,30,65,0.462,5,19,0.263,13,16,0.813,88,30,75,0.4,21,48,0.438,9,27,0.333,10,13,0.769,79,2013-01-09,NOP,HOU,2013,83.5
11651,11651,51,@,L 88-96 ,240,36,78,0.462,33,71,0.465,3,7,0.429,13,16,0.813,88,38,89,0.427,27,61,0.443,11,28,0.393,9,12,0.75,96,2013-01-12,CHA,IND,2013,101.5
11652,11652,52,@,L 88-106 ,240,33,89,0.371,29,73,0.397,4,16,0.25,18,23,0.783,88,45,80,0.563,37,59,0.627,8,21,0.381,8,11,0.727,106,2013-01-13,MIN,SAS,2013,110.0
11653,11653,53,@,L 88-104 ,240,34,95,0.358,27,67,0.403,7,28,0.25,13,22,0.591,88,42,84,0.5,32,55,0.582,10,29,0.345,10,18,0.556,104,2013-01-15,MIL,LAL,2013,109.0
11654,11654,54,Home,L 88-93 ,240,31,79,0.392,22,50,0.44,9,29,0.31,17,26,0.654,88,32,83,0.386,28,66,0.424,4,17,0.235,25,32,0.781,93,2013-01-16,POR,CLE,2013,95.0
11655,11655,55,@,L 88-95 ,240,36,84,0.429,32,68,0.471,4,16,0.25,12,14,0.857,88,36,80,0.45,31,58,0.534,5,22,0.227,18,20,0.9,95,2013-01-18,GSW,SAS,2013,97.5
11656,11656,56,@,L 88-103 ,240,33,83,0.398,29,68,0.426,4,15,0.267,18,25,0.72,88,36,78,0.462,27,59,0.458,9,19,0.474,22,31,0.71,103,2013-01-20,BOS,DET,2013,107.5
11657,11657,57,@,W 88-85 ,240,31,74,0.419,19,50,0.38,12,24,0.5,14,20,0.7,88,34,84,0.405,28,63,0.444,6,21,0.286,11,17,0.647,85,2013-01-21,BRK,NYK,2013,88.0
11658,11658,58,@,L 88-92 ,240,31,86,0.36,24,68,0.353,7,18,0.389,19,26,0.731,88,38,85,0.447,35,73,0.479,3,12,0.25,13,19,0.684,92,2013-01-23,WAS,UTA,2013,93.5
11659,11659,59,@,L 88-93 ,240,33,83,0.398,27,65,0.415,6,18,0.333,16,26,0.615,88,30,71,0.423,25,55,0.455,5,16,0.313,28,37,0.757,93,2013-01-24,LAC,PHO,2013,95.5
11660,11660,60,@,L 88-110 ,240,34,72,0.472,30,60,0.5,4,12,0.333,16,23,0.696,88,43,77,0.558,38,60,0.633,5,17,0.294,19,23,0.826,110,2013-01-25,DET,MIA,2013,112.5
11661,11661,61,Home,L 88-104 ,240,34,82,0.415,28,68,0.412,6,14,0.429,14,19,0.737,88,45,91,0.495,41,78,0.526,4,13,0.308,10,13,0.769,104,2013-01-30,MIL,CHI,2013,106.0
11662,11662,62,@,W 88-69 ,240,32,81,0.395,27,64,0.422,5,17,0.294,19,25,0.76,88,31,89,0.348,29,81,0.358,2,8,0.25,5,7,0.714,69,2013-02-06,IND,PHI,2013,70.0
11663,11663,63,@,L 88-105 ,240,34,69,0.493,30,53,0.566,4,16,0.25,16,25,0.64,88,41,79,0.519,35,66,0.53,6,13,0.462,17,22,0.773,105,2013-02-10,MIN,MEM,2013,108.0
11664,11664,64,Home,L 88-102 ,240,33,74,0.446,26,51,0.51,7,23,0.304,15,18,0.833,88,41,80,0.513,31,52,0.596,10,28,0.357,10,16,0.625,102,2013-02-10,NYK,LAC,2013,107.0
11665,11665,65,Home,L 88-92 ,240,28,79,0.354,19,54,0.352,9,25,0.36,23,32,0.719,88,31,73,0.425,22,52,0.423,9,21,0.429,21,24,0.875,92,2013-02-13,NYK,TOR,2013,96.5
11666,11666,66,Home,L 88-96 ,240,30,78,0.385,24,63,0.381,6,15,0.4,22,27,0.815,88,35,78,0.449,27,58,0.466,8,20,0.4,18,20,0.9,96,2013-02-19,WAS,TOR,2013,100.0
11667,11667,67,@,W 88-82 ,240,29,80,0.363,23,67,0.343,6,13,0.462,24,34,0.706,88,26,71,0.366,18,53,0.34,8,18,0.444,22,26,0.846,82,2013-02-20,MEM,TOR,2013,86.0
11668,11668,68,Home,W 88-82 ,240,34,76,0.447,31,60,0.517,3,16,0.188,17,29,0.586,88,35,84,0.417,30,69,0.435,5,15,0.333,7,9,0.778,82,2013-02-22,MEM,ORL,2013,84.5
11669,11669,69,Home,L 88-113 ,240,35,84,0.417,31,65,0.477,4,19,0.211,14,23,0.609,88,44,79,0.557,34,57,0.596,10,22,0.455,15,23,0.652,113,2013-02-22,PHO,BOS,2013,118.0
11670,11670,70,Home,L 88-96 ,240,31,74,0.419,24,58,0.414,7,16,0.438,19,29,0.655,88,35,81,0.432,27,53,0.509,8,28,0.286,18,21,0.857,96,2013-03-01,WAS,NYK,2013,100.0
11671,11671,71,@,L 88-104 ,240,36,89,0.404,29,65,0.446,7,24,0.292,9,11,0.818,88,46,86,0.535,41,71,0.577,5,15,0.333,7,9,0.778,104,2013-03-04,ATL,DEN,2013,106.5
11672,11672,72,@,L 88-89 ,240,37,81,0.457,35,71,0.493,2,10,0.2,12,18,0.667,88,30,81,0.37,26,64,0.406,4,17,0.235,25,30,0.833,89,2013-03-08,UTA,CHI,2013,91.0
11673,11673,73,Home,L 88-94 ,240,33,87,0.379,24,66,0.364,9,21,0.429,13,20,0.65,88,27,74,0.365,12,39,0.308,15,35,0.429,25,34,0.735,94,2013-03-08,GSW,HOU,2013,101.5
11674,11674,74,@,L 88-111 ,240,35,84,0.417,30,66,0.455,5,18,0.278,13,19,0.684,88,42,78,0.538,33,61,0.541,9,17,0.529,18,22,0.818,111,2013-03-09,MIN,DEN,2013,115.5
11675,11675,75,@,L 88-112 ,240,34,79,0.43,31,66,0.47,3,13,0.231,17,19,0.895,88,39,76,0.513,33,61,0.541,6,15,0.4,28,35,0.8,112,2013-03-13,TOR,BOS,2013,115.0
11676,11676,76,@,L 88-105 ,240,34,76,0.447,27,56,0.482,7,20,0.35,13,21,0.619,88,41,79,0.519,31,64,0.484,10,15,0.667,13,20,0.65,105,2013-03-16,CHA,BOS,2013,110.0
11677,11677,77,@,W 88-79 ,240,33,68,0.485,27,53,0.509,6,15,0.4,16,25,0.64,88,28,83,0.337,25,68,0.368,3,15,0.2,20,22,0.909,79,2013-03-20,WAS,PHO,2013,80.5
11678,11678,78,Home,L 88-107 ,240,35,78,0.449,31,61,0.508,4,17,0.235,14,20,0.7,88,40,81,0.494,30,60,0.5,10,21,0.476,17,20,0.85,107,2013-03-27,TOR,ATL,2013,112.0
11679,11679,79,@,L 88-103 ,240,34,76,0.447,28,60,0.467,6,16,0.375,14,19,0.737,88,44,85,0.518,38,70,0.543,6,15,0.4,9,13,0.692,103,2013-03-27,PHO,UTA,2013,106.0
11680,11680,80,@,L 88-97 ,240,34,87,0.391,30,74,0.405,4,13,0.308,16,27,0.593,88,34,78,0.436,28,57,0.491,6,21,0.286,23,31,0.742,97,2013-03-30,ORL,ATL,2013,100.0
11681,11681,81,@,W 88-86 ,240,33,71,0.465,21,43,0.488,12,28,0.429,10,15,0.667,88,35,79,0.443,28,55,0.509,7,24,0.292,9,16,0.563,86,2013-03-31,MIA,SAS,2013,89.5
11682,11682,82,Home,W 88-83 ,240,35,81,0.432,31,67,0.463,4,14,0.286,14,16,0.875,88,33,94,0.351,29,78,0.372,4,16,0.25,13,16,0.813,83,2013-04-03,CHA,PHI,2013,85.0
11683,11683,83,@,L 88-98 ,240,33,83,0.398,29,68,0.426,4,15,0.267,18,23,0.783,88,36,78,0.462,29,59,0.492,7,19,0.368,19,22,0.864,98,2013-04-03,NOP,GSW,2013,101.5
11684,11684,84,Home,W 88-78 ,240,30,66,0.455,29,58,0.5,1,8,0.125,27,36,0.75,88,26,80,0.325,21,61,0.344,5,19,0.263,21,29,0.724,78,2013-04-03,TOR,WAS,2013,80.5
11685,11685,85,@,L 88-100 ,240,33,83,0.398,25,62,0.403,8,21,0.381,14,17,0.824,88,38,82,0.463,26,58,0.448,12,24,0.5,12,13,0.923,100,2013-04-04,SAS,OKC,2013,106.0
11686,11686,86,@,L 88-97 ,240,34,77,0.442,25,59,0.424,9,18,0.5,11,14,0.786,88,34,72,0.472,32,64,0.5,2,8,0.25,27,33,0.818,97,2013-04-12,CHI,TOR,2013,98.0
11687,11687,87,Home,L 88-120 ,240,35,83,0.422,30,69,0.435,5,14,0.357,13,15,0.867,88,48,81,0.593,38,65,0.585,10,16,0.625,14,19,0.737,120,2013-04-13,ORL,BOS,2013,125.0
11688,11688,88,Home,L 88-99 ,240,35,82,0.427,29,70,0.414,6,12,0.5,12,14,0.857,88,40,93,0.43,31,72,0.431,9,21,0.429,10,13,0.769,99,2013-04-17,POR,GSW,2013,103.5
11689,11689,89,@,L 88-90 ,240,34,79,0.43,29,64,0.453,5,15,0.333,15,17,0.882,88,33,81,0.407,25,60,0.417,8,21,0.381,16,23,0.696,90,2013-10-30,DEN,SAC,2014,94.0
11690,11690,90,@,L 88-95 ,240,33,70,0.471,26,50,0.52,7,20,0.35,15,18,0.833,88,36,74,0.486,31,59,0.525,5,15,0.333,18,22,0.818,95,2013-11-04,BOS,MEM,2014,97.5
11691,11691,91,@,L 88-104 ,240,31,82,0.378,27,64,0.422,4,18,0.222,22,30,0.733,88,40,78,0.513,36,67,0.537,4,11,0.364,20,32,0.625,104,2013-11-05,UTA,BRK,2014,106.0
11692,11692,92,@,L 88-102 ,240,35,77,0.455,27,60,0.45,8,17,0.471,10,16,0.625,88,41,80,0.513,32,59,0.542,9,21,0.429,11,14,0.786,102,2013-11-16,UTA,GSW,2014,106.5
11693,11693,93,@,L 88-106 ,240,34,86,0.395,29,68,0.426,5,18,0.278,15,18,0.833,88,40,94,0.426,33,71,0.465,7,23,0.304,19,22,0.864,106,2013-11-16,BOS,MIN,2014,109.5
11694,11694,94,@,L 88-104 ,240,33,74,0.446,22,50,0.44,11,24,0.458,11,15,0.733,88,41,81,0.506,31,60,0.517,10,21,0.476,12,19,0.632,104,2013-11-19,ATL,MIA,2014,109.0
11695,11695,95,@,W 88-81 (OT),265,34,88,0.386,31,76,0.408,3,12,0.25,17,19,0.895,88,36,82,0.439,31,64,0.484,5,18,0.278,4,8,0.5,81,2013-11-20,MEM,GSW,2014,83.5
11696,11696,96,@,L 88-96 ,240,36,86,0.419,30,69,0.435,6,17,0.353,10,13,0.769,88,37,78,0.474,32,60,0.533,5,18,0.278,17,23,0.739,96,2013-11-22,WAS,TOR,2014,98.5
11697,11697,97,@,L 88-94 ,240,36,92,0.391,29,65,0.446,7,27,0.259,9,14,0.643,88,39,84,0.464,35,69,0.507,4,15,0.267,12,15,0.8,94,2013-11-27,SAS,OKC,2014,96.0
11698,11698,98,Home,W 88-87 ,240,31,73,0.425,28,58,0.483,3,15,0.2,23,30,0.767,88,29,77,0.377,20,53,0.377,9,24,0.375,20,21,0.952,87,2013-11-29,ATL,DAL,2014,91.5
11699,11699,99,Home,L 88-97 ,240,36,77,0.468,29,62,0.468,7,15,0.467,9,12,0.75,88,34,73,0.466,25,55,0.455,9,18,0.5,20,26,0.769,97,2013-11-30,MEM,BRK,2014,101.5
11700,11700,0,@,L 88-98 ,240,36,92,0.391,30,69,0.435,6,23,0.261,10,13,0.769,88,37,91,0.407,32,77,0.416,5,14,0.357,19,24,0.792,98,2013-12-04,DEN,CLE,2014,100.5
11701,11701,1,Home,L 88-97 ,240,31,88,0.352,22,57,0.386,9,31,0.29,17,19,0.895,88,36,79,0.456,25,55,0.455,11,24,0.458,14,19,0.737,97,2013-12-04,HOU,PHO,2014,102.5
11702,11702,2,@,L 88-105 ,240,37,92,0.402,31,65,0.477,6,27,0.222,8,13,0.615,88,42,91,0.462,38,70,0.543,4,21,0.19,17,25,0.68,105,2013-12-06,PHI,CHA,2014,107.0
11703,11703,3,Home,W 88-82 ,240,31,83,0.373,27,69,0.391,4,14,0.286,22,30,0.733,88,28,87,0.322,21,52,0.404,7,35,0.2,19,26,0.731,82,2013-12-07,CLE,LAC,2014,85.5
11704,11704,4,@,L 88-98 ,240,32,93,0.344,24,64,0.375,8,29,0.276,16,28,0.571,88,32,76,0.421,22,43,0.512,10,33,0.303,24,42,0.571,98,2013-12-08,ORL,HOU,2014,103.0
11705,11705,5,Home,L 88-96 ,240,33,80,0.413,27,63,0.429,6,17,0.353,16,19,0.842,88,34,76,0.447,28,59,0.475,6,17,0.353,22,34,0.647,96,2013-12-11,BOS,LAC,2014,99.0
11706,11706,6,@,W 88-85 ,240,30,77,0.39,23,57,0.404,7,20,0.35,21,23,0.913,88,39,89,0.438,37,76,0.487,2,13,0.154,5,8,0.625,85,2013-12-14,LAL,CHA,2014,86.0
11707,11707,7,@,W 88-85 ,240,32,83,0.386,22,62,0.355,10,21,0.476,14,18,0.778,88,36,83,0.434,34,71,0.479,2,12,0.167,11,16,0.688,85,2013-12-21,UTA,CHA,2014,86.0
11708,11708,8,Home,L 88-107 ,240,31,85,0.365,24,65,0.369,7,20,0.35,19,26,0.731,88,41,85,0.482,29,54,0.537,12,31,0.387,13,22,0.591,107,2013-12-30,LAC,PHO,2014,113.0
11709,11709,9,Home,L 88-101 ,240,34,82,0.415,30,70,0.429,4,12,0.333,16,17,0.941,88,40,79,0.506,29,57,0.509,11,22,0.5,10,13,0.769,101,2014-01-03,WAS,TOR,2014,106.5
11710,11710,10,@,L 88-107 ,240,36,77,0.468,33,68,0.485,3,9,0.333,13,17,0.765,88,40,78,0.513,31,51,0.608,9,27,0.333,18,23,0.783,107,2014-01-07,NOP,MIA,2014,111.5
11711,11711,11,@,L 88-101 ,240,30,85,0.353,24,61,0.393,6,24,0.25,22,27,0.815,88,37,90,0.411,23,59,0.39,14,31,0.452,13,18,0.722,101,2014-01-09,OKC,DEN,2014,108.0
11712,11712,12,Home,L 88-102 ,240,34,79,0.43,25,58,0.431,9,21,0.429,11,19,0.579,88,39,75,0.52,32,57,0.561,7,18,0.389,17,28,0.607,102,2014-01-13,CHI,WAS,2014,105.5
11713,11713,13,@,L 88-107 ,240,34,76,0.447,27,52,0.519,7,24,0.292,13,16,0.813,88,40,79,0.506,27,52,0.519,13,27,0.481,14,15,0.933,107,2014-01-13,ORL,DAL,2014,113.5
11714,11714,14,Home,W 88-83 ,240,29,84,0.345,25,67,0.373,4,17,0.235,26,36,0.722,88,30,78,0.385,19,54,0.352,11,24,0.458,12,25,0.48,83,2014-01-15,BOS,TOR,2014,88.5
11715,11715,15,@,W 88-87 ,240,36,78,0.462,32,71,0.451,4,7,0.571,12,16,0.75,88,32,79,0.405,18,45,0.4,14,34,0.412,9,14,0.643,87,2014-01-24,MEM,HOU,2014,94.0
11716,11716,16,@,L 88-103 ,240,28,83,0.337,22,62,0.355,6,21,0.286,26,33,0.788,88,38,91,0.418,28,66,0.424,10,25,0.4,17,21,0.81,103,2014-01-26,POR,GSW,2014,108.0
11717,11717,17,@,W 88-85 ,240,34,90,0.378,24,68,0.353,10,22,0.455,10,15,0.667,88,30,80,0.375,23,57,0.404,7,23,0.304,18,23,0.783,85,2014-01-28,WAS,GSW,2014,88.5
11718,11718,18,@,L 88-114 ,240,32,82,0.39,26,60,0.433,6,22,0.273,18,24,0.75,88,44,82,0.537,34,62,0.548,10,20,0.5,16,23,0.696,114,2014-01-28,BOS,NYK,2014,119.0
11719,11719,19,Home,W 88-77 ,240,33,82,0.402,29,62,0.468,4,20,0.2,18,25,0.72,88,29,82,0.354,27,61,0.443,2,21,0.095,17,23,0.739,77,2014-01-29,MIN,NOP,2014,78.0
11720,11720,20,Home,W 88-79 ,240,38,80,0.475,34,71,0.479,4,9,0.444,8,10,0.8,88,27,70,0.386,24,54,0.444,3,16,0.188,22,33,0.667,79,2014-02-01,NOP,CHI,2014,80.5
11721,11721,21,@,L 88-114 ,240,31,79,0.392,25,58,0.431,6,21,0.286,20,26,0.769,88,42,74,0.568,34,61,0.557,8,13,0.615,22,26,0.846,114,2014-03-03,UTA,MIL,2014,118.0
11722,11722,22,Home,L 88-108 ,240,30,76,0.395,23,50,0.46,7,26,0.269,21,26,0.808,88,46,98,0.469,41,70,0.586,5,28,0.179,11,12,0.917,108,2014-03-05,BOS,GSW,2014,110.5
11723,11723,23,@,L 88-95 (OT),265,30,74,0.405,23,54,0.426,7,20,0.35,21,22,0.955,88,38,90,0.422,31,71,0.437,7,19,0.368,12,17,0.706,95,2014-03-09,MIA,CHI,2014,98.5
11724,11724,24,Home,L 88-90 ,240,31,75,0.413,27,57,0.474,4,18,0.222,22,22,1.0,88,32,74,0.432,28,56,0.5,4,18,0.222,22,27,0.815,90,2014-03-12,NOP,MEM,2014,92.0
11725,11725,25,@,L 88-89 ,240,31,79,0.392,24,62,0.387,7,17,0.412,19,24,0.792,88,29,75,0.387,18,48,0.375,11,27,0.407,20,26,0.769,89,2014-03-22,ORL,UTA,2014,94.5
11726,11726,26,@,L 88-112 ,240,35,87,0.402,27,62,0.435,8,25,0.32,10,16,0.625,88,40,88,0.455,26,55,0.473,14,33,0.424,18,23,0.783,112,2014-03-28,NYK,PHO,2014,119.0
11727,11727,27,@,W 88-67 ,240,32,74,0.432,25,51,0.49,7,23,0.304,17,21,0.81,88,27,79,0.342,23,65,0.354,4,14,0.286,9,14,0.643,67,2014-03-29,MIA,MIL,2014,69.0
11728,11728,28,@,L 88-102 ,240,40,95,0.421,36,84,0.429,4,11,0.364,4,6,0.667,88,43,81,0.531,38,65,0.585,5,16,0.313,11,16,0.688,102,2014-04-02,MEM,MIN,2014,104.5
11729,11729,29,Home,L 88-107 ,240,32,78,0.41,27,58,0.466,5,20,0.25,19,30,0.633,88,41,73,0.562,29,46,0.63,12,27,0.444,13,17,0.765,107,2014-04-06,IND,ATL,2014,113.0
11730,11730,30,@,W 88-87 ,240,36,68,0.529,27,45,0.6,9,23,0.391,7,14,0.5,88,33,69,0.478,26,45,0.578,7,24,0.292,14,19,0.737,87,2014-04-08,BRK,MIA,2014,90.5
11731,11731,31,Home,L 88-94 ,240,34,80,0.425,28,66,0.424,6,14,0.429,14,17,0.824,88,39,80,0.488,30,61,0.492,9,19,0.474,7,10,0.7,94,2014-04-09,NOP,PHO,2014,98.5
11732,11732,32,Home,L 88-94 (OT),265,37,82,0.451,36,67,0.537,1,15,0.067,13,20,0.65,88,35,92,0.38,24,67,0.358,11,25,0.44,13,15,0.867,94,2014-04-09,WAS,CHA,2014,99.5
11733,11733,33,Home,L 88-93 ,240,34,80,0.425,28,58,0.483,6,22,0.273,14,25,0.56,88,36,79,0.456,35,60,0.583,1,19,0.053,20,21,0.952,93,2014-04-11,BRK,ATL,2014,93.5
11734,11734,34,@,L 88-97 ,240,35,74,0.473,27,54,0.5,8,20,0.4,10,14,0.714,88,34,73,0.466,22,44,0.5,12,29,0.414,17,23,0.739,97,2014-04-13,ORL,BRK,2014,103.0
11735,11735,35,@,L 88-100 ,240,34,65,0.523,28,44,0.636,6,21,0.286,14,25,0.56,88,32,81,0.395,24,50,0.48,8,31,0.258,28,33,0.848,100,2014-11-04,OKC,TOR,2015,104.0
11736,11736,36,@,L 88-120 ,240,33,87,0.379,23,53,0.434,10,34,0.294,12,18,0.667,88,43,76,0.566,36,59,0.61,7,17,0.412,27,30,0.9,120,2014-11-09,PHI,TOR,2015,123.5
11737,11737,37,Home,W 88-87 ,240,29,78,0.372,22,44,0.5,7,34,0.206,23,37,0.622,88,34,80,0.425,27,59,0.458,7,21,0.333,12,18,0.667,87,2014-11-14,HOU,PHI,2015,90.5
11738,11738,38,@,L 88-95 ,240,34,82,0.415,24,56,0.429,10,26,0.385,10,17,0.588,88,32,86,0.372,28,71,0.394,4,15,0.267,27,33,0.818,95,2014-11-15,DET,MEM,2015,97.0
11739,11739,39,@,W 88-86 ,240,37,75,0.493,33,60,0.55,4,15,0.267,10,13,0.769,88,33,87,0.379,26,62,0.419,7,25,0.28,13,19,0.684,86,2014-11-19,PHO,DET,2015,89.5
11740,11740,40,Home,W 88-86 ,240,35,78,0.449,33,63,0.524,2,15,0.133,16,24,0.667,88,37,86,0.43,32,72,0.444,5,14,0.357,7,12,0.583,86,2014-11-19,IND,CHO,2015,88.5
11741,11741,41,@,L 88-103 ,240,36,84,0.429,31,65,0.477,5,19,0.263,11,16,0.688,88,38,74,0.514,34,68,0.5,4,6,0.667,23,27,0.852,103,2014-11-20,CHI,SAC,2015,105.0
11742,11742,42,@,L 88-101 ,240,35,82,0.427,29,65,0.446,6,17,0.353,12,19,0.632,88,41,82,0.5,35,59,0.593,6,23,0.261,13,19,0.684,101,2014-11-21,UTA,GSW,2015,104.0
11743,11743,43,Home,L 88-94 ,240,37,95,0.389,32,72,0.444,5,23,0.217,9,12,0.75,88,37,86,0.43,30,67,0.448,7,19,0.368,13,15,0.867,94,2014-11-23,BOS,POR,2015,97.5
11744,11744,44,Home,L 88-104 ,240,34,83,0.41,28,60,0.467,6,23,0.261,14,25,0.56,88,39,77,0.506,26,48,0.542,13,29,0.448,13,16,0.813,104,2014-11-28,DET,MIL,2015,110.5
11745,11745,45,Home,W 88-82 ,240,33,83,0.398,29,62,0.468,4,21,0.19,18,23,0.783,88,36,91,0.396,31,73,0.425,5,18,0.278,5,8,0.625,82,2014-12-04,POR,IND,2015,84.5
11746,11746,46,Home,L 88-110 ,240,36,81,0.444,32,62,0.516,4,19,0.211,12,19,0.632,88,43,90,0.478,34,65,0.523,9,25,0.36,15,22,0.682,110,2014-12-08,BRK,CLE,2015,114.5
11747,11747,47,Home,W 88-70 ,240,36,81,0.444,31,61,0.508,5,20,0.25,11,17,0.647,88,22,69,0.319,11,41,0.268,11,28,0.393,15,20,0.75,70,2014-12-12,BRK,PHI,2015,75.5
11748,11748,48,@,L 88-112 ,240,34,99,0.343,27,68,0.397,7,31,0.226,13,18,0.722,88,39,80,0.488,35,62,0.565,4,18,0.222,30,34,0.882,112,2014-12-14,PHO,OKC,2015,114.0
11749,11749,49,@,L 88-97 ,240,38,83,0.458,33,67,0.493,5,16,0.313,7,14,0.5,88,38,83,0.458,29,59,0.492,9,24,0.375,12,17,0.706,97,2014-12-15,CHA,CLE,2015,101.5
11750,11750,50,Home,L 88-114 ,240,30,85,0.353,27,70,0.386,3,15,0.2,25,28,0.893,88,48,90,0.533,39,65,0.6,9,25,0.36,9,15,0.6,114,2014-12-20,NOP,POR,2015,118.5
11751,11751,51,Home,L 88-96 ,240,35,84,0.417,28,61,0.459,7,23,0.304,11,20,0.55,88,35,82,0.427,29,59,0.492,6,23,0.261,20,25,0.8,96,2014-12-21,ORL,PHI,2015,99.0
11752,11752,52,Home,W 88-71 ,240,30,84,0.357,26,61,0.426,4,23,0.174,24,28,0.857,88,24,74,0.324,19,48,0.396,5,26,0.192,18,28,0.643,71,2014-12-27,UTA,PHI,2015,73.5
11753,11753,53,@,L 88-101 ,240,32,79,0.405,26,55,0.473,6,24,0.25,18,24,0.75,88,45,90,0.5,40,77,0.519,5,13,0.385,6,10,0.6,101,2014-12-27,BOS,WAS,2015,103.5
11754,11754,54,Home,W 88-87 ,240,27,71,0.38,21,53,0.396,6,18,0.333,28,30,0.933,88,33,90,0.367,25,62,0.403,8,28,0.286,13,18,0.722,87,2015-01-04,LAL,IND,2015,91.0
11755,11755,55,Home,W 88-84 ,240,31,67,0.463,26,53,0.491,5,14,0.357,21,28,0.75,88,34,86,0.395,27,62,0.435,7,24,0.292,9,13,0.692,84,2015-01-04,MIA,BRK,2015,87.5
11756,11756,56,Home,L 88-96 (OT),265,33,84,0.393,30,59,0.508,3,25,0.12,19,23,0.826,88,37,94,0.394,27,67,0.403,10,27,0.37,12,19,0.632,96,2015-01-05,BRK,DAL,2015,101.0
11757,11757,57,Home,L 88-90 ,240,33,73,0.452,30,57,0.526,3,16,0.188,19,27,0.704,88,36,79,0.456,28,62,0.452,8,17,0.471,10,17,0.588,90,2015-01-09,BRK,PHI,2015,94.0
11758,11758,58,@,L 88-95 ,240,33,89,0.371,24,58,0.414,9,31,0.29,13,18,0.722,88,37,82,0.451,29,61,0.475,8,21,0.381,13,14,0.929,95,2015-01-31,POR,MIL,2015,99.0
11759,11759,59,Home,L 88-92 ,240,33,81,0.407,27,66,0.409,6,15,0.4,16,19,0.842,88,37,79,0.468,33,64,0.516,4,15,0.267,14,19,0.737,92,2015-02-02,WAS,CHO,2015,94.0
11760,11760,60,@,L 88-92 ,240,34,89,0.382,28,65,0.431,6,24,0.25,14,17,0.824,88,37,74,0.5,34,63,0.54,3,11,0.273,15,22,0.682,92,2015-02-06,NYK,BRK,2015,93.5
11761,11761,61,@,L 88-98 ,240,33,85,0.388,28,63,0.444,5,22,0.227,17,22,0.773,88,37,82,0.451,33,58,0.569,4,24,0.167,20,26,0.769,98,2015-02-06,DEN,DET,2015,100.0
11762,11762,62,@,L 88-94 ,240,33,80,0.413,21,50,0.42,12,30,0.4,10,11,0.909,88,36,92,0.391,33,79,0.418,3,13,0.231,19,21,0.905,94,2015-02-08,ATL,MEM,2015,95.5
11763,11763,63,@,L 88-89 ,240,33,78,0.423,26,49,0.531,7,29,0.241,15,23,0.652,88,30,93,0.323,20,62,0.323,10,31,0.323,19,20,0.95,89,2015-02-11,ATL,BOS,2015,94.0
11764,11764,64,@,L 88-104 ,240,31,75,0.413,20,50,0.4,11,25,0.44,15,19,0.789,88,44,82,0.537,39,67,0.582,5,15,0.333,11,16,0.688,104,2015-02-25,PHI,MIL,2015,106.5
11765,11765,65,@,L 88-95 ,240,36,80,0.45,27,54,0.5,9,26,0.346,7,13,0.538,88,36,81,0.444,22,50,0.44,14,31,0.452,9,12,0.75,95,2015-02-27,ORL,ATL,2015,102.0
11766,11766,66,Home,W 88-85 ,240,37,90,0.411,35,78,0.449,2,12,0.167,12,16,0.75,88,38,93,0.409,36,79,0.456,2,14,0.143,7,9,0.778,85,2015-03-04,NOP,DET,2015,86.0
11767,11767,67,Home,L 88-95 ,240,38,76,0.5,30,61,0.492,8,15,0.533,4,11,0.364,88,34,72,0.472,24,50,0.48,10,22,0.455,17,21,0.81,95,2015-03-08,BRK,UTA,2015,100.0
11768,11768,68,@,L 88-95 ,240,34,80,0.425,28,60,0.467,6,20,0.3,14,28,0.5,88,37,86,0.43,27,60,0.45,10,26,0.385,11,20,0.55,95,2015-03-13,ORL,BOS,2015,100.0
11769,11769,69,Home,W 88-85 ,240,33,69,0.478,27,55,0.491,6,14,0.429,16,24,0.667,88,32,84,0.381,24,61,0.393,8,23,0.348,13,22,0.591,85,2015-03-14,UTA,DET,2015,89.0
11770,11770,70,@,W 88-84 ,240,33,63,0.524,27,52,0.519,6,11,0.545,16,23,0.696,88,34,82,0.415,30,60,0.5,4,22,0.182,12,24,0.5,84,2015-03-18,WAS,UTA,2015,86.0
11771,11771,71,@,L 88-89 ,240,33,75,0.44,25,56,0.446,8,19,0.421,14,18,0.778,88,36,87,0.414,32,70,0.457,4,17,0.235,13,17,0.765,89,2015-03-24,MIA,MIL,2015,91.0
11772,11772,72,Home,L 88-91 ,240,36,91,0.396,33,79,0.418,3,12,0.25,13,20,0.65,88,39,91,0.429,36,77,0.468,3,14,0.214,10,11,0.909,91,2015-03-25,CHA,BRK,2015,92.5
11773,11773,73,@,L 88-102 ,240,35,79,0.443,28,64,0.438,7,15,0.467,11,18,0.611,88,43,84,0.512,34,64,0.531,9,20,0.45,7,12,0.583,102,2015-03-27,SAC,NOP,2015,106.5
11774,11774,74,@,L 88-110 ,240,32,75,0.427,30,63,0.476,2,12,0.167,22,24,0.917,88,43,75,0.573,37,62,0.597,6,13,0.462,18,24,0.75,110,2015-03-29,MIN,NOP,2015,113.0
11775,11775,75,@,L 88-101 ,240,34,75,0.453,30,58,0.517,4,17,0.235,16,23,0.696,88,36,79,0.456,27,50,0.54,9,29,0.31,20,24,0.833,101,2015-03-30,MIL,ATL,2015,105.5
11776,11776,76,@,L 88-114 ,240,32,75,0.427,25,54,0.463,7,21,0.333,17,21,0.81,88,40,80,0.5,25,45,0.556,15,35,0.429,19,25,0.76,114,2015-04-02,MIA,CLE,2015,121.5
11777,11777,77,Home,W 88-82 ,240,33,85,0.388,29,68,0.426,4,17,0.235,18,21,0.857,88,32,74,0.432,26,55,0.473,6,19,0.316,12,15,0.8,82,2015-04-03,CHI,DET,2015,85.0
11778,11778,78,Home,L 88-113 ,240,34,84,0.405,29,65,0.446,5,19,0.263,15,28,0.536,88,47,89,0.528,37,65,0.569,10,24,0.417,9,13,0.692,113,2015-04-07,OKC,SAS,2015,118.0
11779,11779,79,Home,L 88-89 ,240,31,71,0.437,20,48,0.417,11,23,0.478,15,22,0.682,88,36,76,0.474,31,61,0.508,5,15,0.333,12,19,0.632,89,2015-04-10,UTA,MEM,2015,91.5
11780,11780,80,Home,L 88-100 ,240,31,78,0.397,27,64,0.422,4,14,0.286,22,28,0.786,88,37,84,0.44,31,63,0.492,6,21,0.286,20,24,0.833,100,2015-04-13,MIN,NOP,2015,103.0
11781,11781,81,@,L 88-101 ,240,38,79,0.481,31,59,0.525,7,20,0.35,5,13,0.385,88,39,80,0.488,30,56,0.536,9,24,0.375,14,23,0.609,101,2015-04-15,ORL,BRK,2015,105.5
11782,11782,82,@,W 88-87 ,240,33,84,0.393,26,56,0.464,7,28,0.25,15,25,0.6,88,37,100,0.37,32,74,0.432,5,26,0.192,8,12,0.667,87,2015-10-28,WAS,ORL,2016,89.5
11783,11783,83,@,L 88-104 ,240,35,97,0.361,29,67,0.433,6,30,0.2,12,15,0.8,88,38,87,0.437,30,56,0.536,8,31,0.258,20,33,0.606,104,2015-10-29,DAL,LAC,2016,108.0
11784,11784,84,Home,L 88-111 ,240,35,100,0.35,30,75,0.4,5,25,0.2,13,23,0.565,88,41,96,0.427,31,71,0.437,10,25,0.4,19,23,0.826,111,2015-11-09,PHI,CHI,2016,116.0
11785,11785,85,Home,L 88-106 ,240,34,84,0.405,27,65,0.415,7,19,0.368,13,19,0.684,88,46,87,0.529,40,64,0.625,6,23,0.261,8,11,0.727,106,2015-11-09,SAC,SAS,2016,109.0
11786,11786,86,@,L 88-101 ,240,34,77,0.442,23,55,0.418,11,22,0.5,9,12,0.75,88,38,84,0.452,33,64,0.516,5,20,0.25,20,27,0.741,101,2015-11-10,LAL,MIA,2016,103.5
11787,11787,87,@,L 88-90 ,240,33,76,0.434,21,47,0.447,12,29,0.414,10,14,0.714,88,37,84,0.44,28,64,0.438,9,20,0.45,7,13,0.538,90,2015-11-17,ATL,BRK,2016,94.5
11788,11788,88,@,L 88-113 ,240,32,79,0.405,24,53,0.453,8,26,0.308,16,22,0.727,88,40,81,0.494,28,56,0.5,12,25,0.48,21,22,0.955,113,2015-11-20,PHI,CHO,2016,119.0
11789,11789,89,@,L 88-109 ,240,31,91,0.341,25,63,0.397,6,28,0.214,20,24,0.833,88,43,83,0.518,34,70,0.486,9,13,0.692,14,17,0.824,109,2015-11-23,DET,MIL,2016,113.5
11790,11790,90,Home,L 88-93 ,240,31,88,0.352,25,66,0.379,6,22,0.273,20,27,0.741,88,33,86,0.384,26,68,0.382,7,18,0.389,20,23,0.87,93,2015-11-24,POR,CHI,2016,96.5
11791,11791,91,Home,W 88-83 ,240,33,81,0.407,25,53,0.472,8,28,0.286,14,19,0.737,88,34,83,0.41,28,61,0.459,6,22,0.273,9,12,0.75,83,2015-11-25,SAS,DAL,2016,86.0
11792,11792,92,@,L 88-90 ,240,33,81,0.407,29,64,0.453,4,17,0.235,18,24,0.75,88,35,87,0.402,26,60,0.433,9,27,0.333,11,17,0.647,90,2015-11-28,BRK,CLE,2016,94.5
11793,11793,93,@,L 88-108 ,240,37,87,0.425,31,61,0.508,6,26,0.231,8,13,0.615,88,40,85,0.471,31,68,0.456,9,17,0.529,19,20,0.95,108,2015-11-28,ATL,SAS,2016,112.5
11794,11794,94,@,L 88-90 ,240,33,85,0.388,25,52,0.481,8,33,0.242,14,18,0.778,88,30,73,0.411,26,60,0.433,4,13,0.308,26,33,0.788,90,2015-12-07,POR,MIL,2016,92.0
11795,11795,95,Home,L 88-125 ,240,33,81,0.407,30,67,0.448,3,14,0.214,19,22,0.864,88,47,84,0.56,34,58,0.586,13,26,0.5,18,23,0.783,125,2015-12-08,MEM,OKC,2016,131.5
11796,11796,96,Home,L 88-100 ,240,33,84,0.393,25,51,0.49,8,33,0.242,14,15,0.933,88,40,89,0.449,33,73,0.452,7,16,0.438,13,15,0.867,100,2015-12-14,ATL,MIA,2016,103.5
11797,11797,97,@,L 88-97 ,240,30,80,0.375,24,63,0.381,6,17,0.353,22,24,0.917,88,34,78,0.436,24,49,0.49,10,29,0.345,19,21,0.905,97,2015-12-18,MEM,DAL,2016,102.0
11798,11798,98,@,L 88-104 ,240,26,71,0.366,22,49,0.449,4,22,0.182,32,38,0.842,88,44,84,0.524,38,68,0.559,6,16,0.375,10,17,0.588,104,2015-12-18,NOP,PHO,2016,107.0
11799,11799,99,@,L 88-97 ,240,31,79,0.392,25,51,0.49,6,28,0.214,20,25,0.8,88,34,73,0.466,24,48,0.5,10,25,0.4,19,25,0.76,97,2015-12-18,DEN,UTA,2016,102.0
11800,11800,0,Home,W 88-84 ,240,32,74,0.432,25,59,0.424,7,15,0.467,17,26,0.654,88,36,88,0.409,31,68,0.456,5,20,0.25,7,8,0.875,84,2015-12-25,HOU,SAS,2016,86.5
11801,11801,1,@,L 88-94 (OT),265,36,90,0.4,30,70,0.429,6,20,0.3,10,11,0.909,88,35,88,0.398,29,62,0.468,6,26,0.231,18,27,0.667,94,2015-12-25,NOP,MIA,2016,97.0
11802,11802,2,Home,L 88-102 ,240,35,75,0.467,31,63,0.492,4,12,0.333,14,18,0.778,88,40,80,0.5,31,54,0.574,9,26,0.346,13,14,0.929,102,2015-12-26,MIN,IND,2016,106.5
11803,11803,3,Home,L 88-109 ,240,29,91,0.319,24,70,0.343,5,21,0.238,25,30,0.833,88,40,86,0.465,27,55,0.491,13,31,0.419,16,21,0.762,109,2016-01-05,LAL,GSW,2016,115.5
11804,11804,4,Home,L 88-97 ,240,33,84,0.393,25,59,0.424,8,25,0.32,14,15,0.933,88,34,75,0.453,29,61,0.475,5,14,0.357,24,26,0.923,97,2016-01-08,WAS,TOR,2016,99.5
11805,11805,5,@,L 88-100 ,240,32,80,0.4,29,67,0.433,3,13,0.231,21,30,0.7,88,39,84,0.464,32,60,0.533,7,24,0.292,15,18,0.833,100,2016-01-10,MIL,NYK,2016,103.5
11806,11806,6,@,L 88-91 ,240,35,84,0.417,27,51,0.529,8,33,0.242,10,15,0.667,88,33,92,0.359,26,68,0.382,7,24,0.292,18,24,0.75,91,2016-01-21,ATL,SAC,2016,94.5
11807,11807,7,Home,L 88-116 ,240,33,85,0.388,29,67,0.433,4,18,0.222,18,20,0.9,88,43,76,0.566,30,53,0.566,13,23,0.565,17,24,0.708,116,2016-01-22,NYK,LAC,2016,122.5
11808,11808,8,Home,L 88-96 ,240,34,79,0.43,26,53,0.491,8,26,0.308,12,13,0.923,88,37,80,0.463,29,55,0.527,8,25,0.32,14,21,0.667,96,2016-02-22,CLE,DET,2016,100.0
11809,11809,9,@,L 88-103 ,240,32,88,0.364,27,68,0.397,5,20,0.25,19,22,0.864,88,37,89,0.416,30,55,0.545,7,34,0.206,22,24,0.917,103,2016-02-26,CHI,ATL,2016,106.5
11810,11810,10,@,L 88-94 ,240,32,75,0.427,27,56,0.482,5,19,0.263,19,29,0.655,88,37,81,0.457,33,63,0.524,4,18,0.222,16,19,0.842,94,2016-03-04,UTA,MEM,2016,96.0
11811,11811,11,@,W 88-80 ,240,35,88,0.398,28,63,0.444,7,25,0.28,11,14,0.786,88,32,91,0.352,28,72,0.389,4,19,0.211,12,15,0.8,80,2016-03-20,SAC,NYK,2016,82.0
11812,11812,12,@,L 88-91 ,240,37,86,0.43,33,69,0.478,4,17,0.235,10,13,0.769,88,35,87,0.402,27,68,0.397,8,19,0.421,13,19,0.684,91,2016-03-21,SAS,CHO,2016,95.0
11813,11813,13,@,L 88-112 ,240,37,77,0.481,30,63,0.476,7,14,0.5,7,12,0.583,88,42,81,0.519,34,67,0.507,8,14,0.571,20,24,0.833,112,2016-03-23,MIA,SAS,2016,116.0
11814,11814,14,Home,L 88-101 ,240,33,87,0.379,26,59,0.441,7,28,0.25,15,17,0.882,88,39,72,0.542,32,54,0.593,7,18,0.389,16,29,0.552,101,2016-03-27,LAL,WAS,2016,104.5
11815,11815,15,Home,L 88-97 ,240,31,70,0.443,22,46,0.478,9,24,0.375,17,19,0.895,88,36,88,0.409,25,56,0.446,11,32,0.344,14,15,0.933,97,2016-03-28,DEN,DAL,2016,102.5
11816,11816,16,Home,W 88-82 ,240,33,87,0.379,29,68,0.426,4,19,0.211,18,20,0.9,88,31,82,0.378,25,61,0.41,6,21,0.286,14,22,0.636,82,2016-03-29,DET,OKC,2016,85.0
11817,11817,17,@,W 88-78 ,240,32,83,0.386,18,43,0.419,14,40,0.35,10,17,0.588,88,29,71,0.408,25,50,0.5,4,21,0.19,16,18,0.889,78,2016-04-03,DAL,MIN,2016,80.0
11818,11818,18,@,W 88-86 ,240,32,72,0.444,25,55,0.455,7,17,0.412,17,19,0.895,88,32,68,0.471,27,51,0.529,5,17,0.294,17,21,0.81,86,2016-04-05,SAS,UTA,2016,88.5
11819,11819,19,Home,W 88-86 ,240,33,80,0.413,23,47,0.489,10,33,0.303,12,14,0.857,88,34,78,0.436,28,58,0.483,6,20,0.3,12,18,0.667,86,2016-04-06,DAL,HOU,2016,89.0
11820,11820,20,@,L 88-98 ,240,38,88,0.432,36,69,0.522,2,19,0.105,10,12,0.833,88,37,86,0.43,32,72,0.444,5,14,0.357,19,22,0.864,98,2016-04-13,MIA,BOS,2016,100.5
11821,11821,21,@,L 88-117 ,240,32,87,0.368,23,60,0.383,9,27,0.333,15,20,0.75,88,45,94,0.479,32,59,0.542,13,35,0.371,14,19,0.737,117,2016-10-25,NYK,CLE,2017,123.5
11822,11822,22,Home,W 88-75 ,240,34,83,0.41,28,56,0.5,6,27,0.222,14,20,0.7,88,29,73,0.397,22,54,0.407,7,19,0.368,10,13,0.769,75,2016-10-30,LAC,UTA,2017,78.5
11823,11823,23,Home,L 88-118 ,240,33,96,0.344,28,65,0.431,5,31,0.161,17,21,0.81,88,45,89,0.506,34,62,0.548,11,27,0.407,17,18,0.944,118,2016-10-31,BRK,CHI,2017,123.5
11824,11824,24,Home,L 88-99 ,240,31,84,0.369,22,58,0.379,9,26,0.346,17,22,0.773,88,32,85,0.376,24,58,0.414,8,27,0.296,27,33,0.818,99,2016-11-04,MEM,LAC,2017,103.0
11825,11825,25,Home,W 88-86 ,240,31,78,0.397,22,50,0.44,9,28,0.321,17,27,0.63,88,34,86,0.395,28,69,0.406,6,17,0.353,12,17,0.706,86,2016-11-05,ORL,WAS,2017,89.0
11826,11826,26,@,L 88-104 ,240,33,88,0.375,28,61,0.459,5,27,0.185,17,22,0.773,88,43,92,0.467,38,76,0.5,5,16,0.313,13,16,0.813,104,2016-11-14,OKC,DET,2017,106.5
11827,11827,27,@,L 88-115 ,240,34,90,0.378,29,68,0.426,5,22,0.227,15,17,0.882,88,44,91,0.484,27,51,0.529,17,40,0.425,10,17,0.588,115,2016-11-14,PHI,HOU,2017,123.5
11828,11828,28,Home,W 88-69 ,240,35,90,0.389,27,65,0.415,8,25,0.32,10,10,1.0,88,27,84,0.321,22,59,0.373,5,25,0.2,10,13,0.769,69,2016-11-14,IND,ORL,2017,71.5
11829,11829,29,Home,L 88-113 ,240,34,95,0.358,25,61,0.41,9,34,0.265,11,18,0.611,88,41,98,0.418,34,78,0.436,7,20,0.35,24,28,0.857,113,2016-11-15,POR,CHI,2017,116.5
11830,11830,30,Home,L 88-104 ,240,31,83,0.373,20,51,0.392,11,32,0.344,15,19,0.789,88,44,90,0.489,35,62,0.565,9,28,0.321,7,12,0.583,104,2016-11-18,BOS,GSW,2017,108.5
11831,11831,31,@,L 88-106 ,240,37,82,0.451,36,63,0.571,1,19,0.053,13,17,0.765,88,42,83,0.506,34,60,0.567,8,23,0.348,14,26,0.538,106,2016-11-26,DET,OKC,2017,110.0
11832,11832,32,@,L 88-105 ,240,37,87,0.425,32,57,0.561,5,30,0.167,9,18,0.5,88,38,88,0.432,30,57,0.526,8,31,0.258,21,25,0.84,105,2016-11-29,LAL,NOP,2017,109.0
11833,11833,33,Home,L 88-105 ,240,36,95,0.379,27,63,0.429,9,32,0.281,7,10,0.7,88,37,78,0.474,24,52,0.462,13,26,0.5,18,26,0.692,105,2016-12-02,PHI,ORL,2017,111.5
11834,11834,34,Home,W 88-86 ,240,31,87,0.356,25,67,0.373,6,20,0.3,20,30,0.667,88,25,82,0.305,18,54,0.333,7,28,0.25,29,40,0.725,86,2016-12-08,MEM,POR,2017,89.5
11835,11835,35,Home,L 88-99 ,240,33,84,0.393,26,59,0.441,7,25,0.28,15,22,0.682,88,39,91,0.429,27,51,0.529,12,40,0.3,9,13,0.692,99,2016-12-08,NOP,PHI,2017,105.0
11836,11836,36,@,L 88-109 ,240,34,91,0.374,25,57,0.439,9,34,0.265,11,14,0.786,88,41,85,0.482,32,63,0.508,9,22,0.409,18,23,0.783,109,2016-12-09,ORL,CHO,2017,113.5
11837,11837,37,@,L 88-96 ,240,32,98,0.327,24,68,0.353,8,30,0.267,16,19,0.842,88,34,78,0.436,25,50,0.5,9,28,0.321,19,26,0.731,96,2016-12-16,CHA,BOS,2017,100.5
11838,11838,38,Home,L 88-90 ,240,34,74,0.459,21,45,0.467,13,29,0.448,7,11,0.636,88,37,87,0.425,30,58,0.517,7,29,0.241,9,15,0.6,90,2016-12-23,LAC,DAL,2017,93.5
11839,11839,39,@,L 88-114 ,240,31,75,0.413,23,45,0.511,8,30,0.267,18,21,0.857,88,37,78,0.474,27,49,0.551,10,29,0.345,30,35,0.857,114,2016-12-31,LAC,OKC,2017,119.0
11840,11840,40,Home,W 88-79 ,240,34,78,0.436,25,54,0.463,9,24,0.375,11,14,0.786,88,28,72,0.389,19,49,0.388,9,23,0.391,14,23,0.609,79,2017-01-08,MEM,UTA,2017,83.5
11841,11841,41,@,L 88-96 ,240,36,84,0.429,32,70,0.457,4,14,0.286,12,13,0.923,88,33,81,0.407,27,55,0.491,6,26,0.231,24,28,0.857,96,2017-01-26,LAL,UTA,2017,99.0
11842,11842,42,Home,L 88-100 ,240,33,79,0.418,30,66,0.455,3,13,0.231,19,25,0.76,88,41,89,0.461,32,65,0.492,9,24,0.375,9,11,0.818,100,2017-01-27,CHI,MIA,2017,104.5
11843,11843,43,Home,L 88-98 ,240,31,77,0.403,25,53,0.472,6,24,0.25,20,28,0.714,88,33,69,0.478,24,49,0.49,9,20,0.45,23,26,0.885,98,2017-02-01,ORL,IND,2017,102.5
11844,11844,44,@,L 88-104 ,240,32,73,0.438,23,50,0.46,9,23,0.391,15,25,0.6,88,36,78,0.462,25,49,0.51,11,29,0.379,21,27,0.778,104,2017-02-01,MIL,UTA,2017,109.5
11845,11845,45,Home,L 88-106 ,240,33,71,0.465,27,56,0.482,6,15,0.4,16,28,0.571,88,41,86,0.477,30,53,0.566,11,33,0.333,13,18,0.722,106,2017-02-08,MIL,MIA,2017,111.5
11846,11846,46,@,W 88-72 ,240,36,81,0.444,27,56,0.482,9,25,0.36,7,11,0.636,88,28,87,0.322,24,64,0.375,4,23,0.174,12,18,0.667,72,2017-02-13,LAC,UTA,2017,74.0
11847,11847,47,@,L 88-111 ,240,32,79,0.405,23,57,0.404,9,22,0.409,15,20,0.75,88,42,81,0.519,31,59,0.525,11,22,0.5,16,23,0.696,111,2017-02-15,POR,UTA,2017,116.5
11848,11848,48,Home,L 88-102 ,240,36,82,0.439,30,65,0.462,6,17,0.353,10,15,0.667,88,40,95,0.421,32,72,0.444,8,23,0.348,14,20,0.7,102,2017-02-27,SAC,MIN,2017,106.0
11849,11849,49,@,L 88-100 ,240,37,81,0.457,25,51,0.49,12,30,0.4,2,3,0.667,88,35,86,0.407,24,55,0.436,11,31,0.355,19,21,0.905,100,2017-03-06,IND,CHO,2017,105.5
11850,11850,50,Home,W 88-83 ,240,33,81,0.407,23,54,0.426,10,27,0.37,12,15,0.8,88,30,84,0.357,20,51,0.392,10,33,0.303,13,18,0.722,83,2017-03-06,UTA,NOP,2017,88.0
11851,11851,51,Home,L 87-88 ,240,36,76,0.474,32,60,0.533,4,16,0.25,11,20,0.55,87,36,89,0.404,29,74,0.392,7,15,0.467,9,14,0.643,88,2011-12-25,LAL,CHI,2012,91.5
11852,11852,52,@,L 87-100 ,240,31,77,0.403,26,58,0.448,5,19,0.263,20,26,0.769,87,39,80,0.488,34,64,0.531,5,16,0.313,17,20,0.85,100,2012-01-02,OKC,DAL,2012,102.5
11853,11853,53,@,W 87-74 ,240,32,80,0.4,24,66,0.364,8,14,0.571,15,18,0.833,87,26,66,0.394,21,52,0.404,5,14,0.357,17,24,0.708,74,2012-01-06,IND,BOS,2012,76.5
11854,11854,54,Home,L 87-98 ,240,31,79,0.392,27,59,0.458,4,20,0.2,21,31,0.677,87,37,80,0.463,29,63,0.46,8,17,0.471,16,22,0.727,98,2012-01-06,MIN,CLE,2012,102.0
11855,11855,55,Home,L 87-88 ,240,29,70,0.414,22,51,0.431,7,19,0.368,22,24,0.917,87,32,81,0.395,28,65,0.431,4,16,0.25,20,28,0.714,88,2012-01-07,GSW,UTA,2012,90.0
11856,11856,56,@,L 87-91 ,240,34,82,0.415,27,63,0.429,7,19,0.368,12,15,0.8,87,30,79,0.38,29,69,0.42,1,10,0.1,30,40,0.75,91,2012-01-09,CHA,NYK,2012,91.5
11857,11857,57,@,L 87-97 ,240,27,80,0.338,20,56,0.357,7,24,0.292,26,33,0.788,87,34,77,0.442,31,58,0.534,3,19,0.158,26,28,0.929,97,2012-01-09,MIN,TOR,2012,98.5
11858,11858,58,Home,L 87-90 (OT),265,36,93,0.387,32,79,0.405,4,14,0.286,11,16,0.688,87,35,82,0.427,31,73,0.425,4,9,0.444,16,19,0.842,90,2012-01-11,UTA,LAL,2012,92.0
11859,11859,59,@,W 87-80 ,240,24,70,0.343,18,45,0.4,6,25,0.24,33,38,0.868,87,34,90,0.378,30,74,0.405,4,16,0.25,8,16,0.5,80,2012-01-13,MIN,NOH,2012,82.0
11860,11860,60,Home,L 87-93 ,240,34,70,0.486,29,58,0.5,5,12,0.417,14,16,0.875,87,36,73,0.493,30,59,0.508,6,14,0.429,15,17,0.882,93,2012-01-18,NOP,MEM,2012,96.0
11861,11861,61,@,L 87-98 ,240,34,81,0.42,28,61,0.459,6,20,0.3,13,16,0.813,87,38,85,0.447,29,67,0.433,9,18,0.5,13,18,0.722,98,2012-01-19,LAL,MIA,2012,102.5
11862,11862,62,@,L 87-97 ,240,37,79,0.468,32,65,0.492,5,14,0.357,8,15,0.533,87,38,86,0.442,31,59,0.525,7,27,0.259,14,15,0.933,97,2012-01-22,CHA,NJN,2012,100.5
11863,11863,63,Home,W 87-56 ,240,33,78,0.423,31,65,0.477,2,13,0.154,19,19,1.0,87,16,65,0.246,12,49,0.245,4,16,0.25,20,30,0.667,56,2012-01-23,BOS,ORL,2012,58.0
11864,11864,64,@,L 87-93 ,240,31,83,0.373,25,63,0.397,6,20,0.3,19,22,0.864,87,33,81,0.407,25,56,0.446,8,25,0.32,19,29,0.655,93,2012-01-23,PHO,DAL,2012,97.0
11865,11865,65,@,L 87-94 ,240,28,80,0.35,27,61,0.443,1,19,0.053,30,31,0.968,87,38,83,0.458,32,69,0.464,6,14,0.429,12,14,0.857,94,2012-01-27,IND,BOS,2012,97.0
11866,11866,66,Home,W 87-79 ,240,36,82,0.439,34,73,0.466,2,9,0.222,13,18,0.722,87,31,75,0.413,24,59,0.407,7,16,0.438,10,11,0.909,79,2012-01-27,MIN,SAS,2012,82.5
11867,11867,67,Home,L 87-88 ,240,36,69,0.522,31,58,0.534,5,11,0.455,10,14,0.714,87,34,79,0.43,31,66,0.47,3,13,0.231,17,20,0.85,88,2012-01-29,BOS,CLE,2012,89.5
11868,11868,68,Home,L 87-98 ,240,35,83,0.422,29,67,0.433,6,16,0.375,11,13,0.846,87,37,87,0.425,25,62,0.403,12,25,0.48,12,16,0.75,98,2012-02-03,DAL,IND,2012,104.0
11869,11869,69,Home,L 87-98 ,240,32,74,0.432,27,59,0.458,5,15,0.333,18,27,0.667,87,44,88,0.5,40,79,0.506,4,9,0.444,6,9,0.667,98,2012-02-04,ATL,PHI,2012,100.0
11870,11870,70,@,L 87-89 ,240,34,72,0.472,30,60,0.5,4,12,0.333,15,18,0.833,87,35,78,0.449,33,68,0.485,2,10,0.2,17,23,0.739,89,2012-02-04,NOP,DET,2012,90.0
11871,11871,71,@,L 87-96 ,240,29,75,0.387,25,61,0.41,4,14,0.286,25,30,0.833,87,39,87,0.448,35,75,0.467,4,12,0.333,14,20,0.7,96,2012-02-04,LAL,UTA,2012,98.0
11872,11872,72,Home,L 87-108 ,240,32,79,0.405,29,62,0.468,3,17,0.176,20,26,0.769,87,40,72,0.556,31,57,0.544,9,15,0.6,19,23,0.826,108,2012-02-06,BRK,CHI,2012,112.5
11873,11873,73,@,L 87-97 ,240,33,75,0.44,28,61,0.459,5,14,0.357,16,23,0.696,87,35,76,0.461,26,55,0.473,9,21,0.429,18,24,0.75,97,2012-02-08,IND,ATL,2012,101.5
11874,11874,74,Home,L 87-88 (OT),265,38,97,0.392,32,78,0.41,6,19,0.316,5,5,1.0,87,36,91,0.396,35,76,0.461,1,15,0.067,15,20,0.75,88,2012-02-09,BOS,LAL,2012,88.5
11875,11875,75,Home,L 87-89 (OT),265,35,83,0.422,26,59,0.441,9,24,0.375,8,14,0.571,87,36,82,0.439,30,65,0.462,6,17,0.353,11,18,0.611,89,2012-02-10,ORL,ATL,2012,92.0
11876,11876,76,Home,L 87-101 ,240,38,80,0.475,35,71,0.493,3,9,0.333,8,13,0.615,87,35,74,0.473,31,54,0.574,4,20,0.2,27,32,0.844,101,2012-02-10,UTA,OKC,2012,103.0
11877,11877,77,Home,L 87-107 ,240,35,90,0.389,24,63,0.381,11,27,0.407,6,7,0.857,87,38,83,0.458,33,71,0.465,5,12,0.417,26,31,0.839,107,2012-02-12,ATL,MIA,2012,109.5
11878,11878,78,Home,L 87-90 ,240,37,73,0.507,33,58,0.569,4,15,0.267,9,15,0.6,87,33,80,0.413,27,63,0.429,6,17,0.353,18,27,0.667,90,2012-02-14,TOR,NYK,2012,93.0
11879,11879,79,@,L 87-98 ,240,32,87,0.368,27,71,0.38,5,16,0.313,18,27,0.667,87,36,77,0.468,26,50,0.52,10,27,0.37,16,23,0.696,98,2012-02-15,IND,CLE,2012,103.0
11880,11880,80,@,L 87-103 ,240,36,85,0.424,30,67,0.448,6,18,0.333,9,12,0.75,87,40,75,0.533,25,50,0.5,15,25,0.6,8,13,0.615,103,2012-02-15,PHI,ORL,2012,110.5
11881,11881,81,Home,L 87-111 ,240,30,76,0.395,24,60,0.4,6,16,0.375,21,31,0.677,87,40,79,0.506,26,58,0.448,14,21,0.667,17,20,0.85,111,2012-02-17,CLE,MIA,2012,118.0
11882,11882,82,@,L 87-110 ,240,31,89,0.348,24,66,0.364,7,23,0.304,18,21,0.857,87,39,74,0.527,29,50,0.58,10,24,0.417,22,27,0.815,110,2012-02-17,GSW,OKC,2012,115.0
11883,11883,83,@,L 87-93 ,240,33,82,0.402,33,73,0.452,0,9,0.0,21,27,0.778,87,36,78,0.462,31,60,0.517,5,18,0.278,16,20,0.8,93,2012-02-22,PHI,HOU,2012,95.5
11884,11884,84,@,L 87-111 ,240,28,75,0.373,18,52,0.346,10,23,0.435,21,26,0.808,87,40,74,0.541,30,49,0.612,10,25,0.4,21,25,0.84,111,2012-03-10,DAL,GSW,2012,116.0
11885,11885,85,@,L 87-107 ,240,33,81,0.407,29,69,0.42,4,12,0.333,17,19,0.895,87,45,84,0.536,39,75,0.52,6,9,0.667,11,17,0.647,107,2012-03-14,CHA,HOU,2012,110.0
11886,11886,86,Home,L 87-91 ,240,39,85,0.459,35,69,0.507,4,16,0.25,5,12,0.417,87,32,78,0.41,23,54,0.426,9,24,0.375,18,23,0.783,91,2012-03-15,LAC,PHO,2012,95.5
11887,11887,87,Home,L 87-103 ,240,33,84,0.393,28,64,0.438,5,20,0.25,16,20,0.8,87,43,85,0.506,35,67,0.522,8,18,0.444,9,12,0.75,103,2012-03-18,CLE,ATL,2012,107.0
11888,11888,88,Home,W 87-83 (OT),265,35,87,0.402,31,67,0.463,4,20,0.2,13,19,0.684,87,31,81,0.383,29,65,0.446,2,16,0.125,19,23,0.826,83,2012-03-18,LAC,DET,2012,84.0
11889,11889,89,@,L 87-106 ,240,33,69,0.478,31,56,0.554,2,13,0.154,19,22,0.864,87,39,81,0.481,34,65,0.523,5,16,0.313,23,33,0.697,106,2012-03-20,TOR,NYK,2012,108.5
11890,11890,90,Home,L 87-116 ,240,29,82,0.354,22,58,0.379,7,24,0.292,22,26,0.846,87,48,83,0.578,37,62,0.597,11,21,0.524,9,13,0.692,116,2012-03-20,POR,MIL,2012,121.5
11891,11891,91,@,L 87-104 ,240,31,81,0.383,20,55,0.364,11,26,0.423,14,17,0.824,87,43,88,0.489,34,63,0.54,9,25,0.36,9,11,0.818,104,2012-03-23,DAL,SAS,2012,108.5
11892,11892,92,@,L 87-103 ,240,33,71,0.465,26,49,0.531,7,22,0.318,14,14,1.0,87,39,74,0.527,33,63,0.524,6,11,0.545,19,23,0.826,103,2012-03-25,MIA,OKC,2012,106.0
11893,11893,93,@,L 87-90 ,240,32,74,0.432,25,52,0.481,7,22,0.318,16,17,0.941,87,31,85,0.365,21,55,0.382,10,30,0.333,18,27,0.667,90,2012-03-25,GSW,POR,2012,95.0
11894,11894,94,@,W 87-75 ,240,35,83,0.422,28,68,0.412,7,15,0.467,10,16,0.625,87,30,87,0.345,25,70,0.357,5,17,0.294,10,12,0.833,75,2012-03-28,DET,CLE,2012,77.5
11895,11895,95,Home,L 87-102 ,240,33,74,0.446,23,46,0.5,10,28,0.357,11,15,0.733,87,43,79,0.544,36,68,0.529,7,11,0.636,9,14,0.643,102,2012-03-28,GSW,NOH,2012,105.5
11896,11896,96,@,L 87-91 ,240,34,85,0.4,28,67,0.418,6,18,0.333,13,15,0.867,87,39,81,0.481,32,59,0.542,7,22,0.318,6,6,1.0,91,2012-04-03,BRK,LAL,2012,94.5
11897,11897,97,@,L 87-92 ,240,31,77,0.403,27,65,0.415,4,12,0.333,21,30,0.7,87,35,76,0.461,28,58,0.483,7,18,0.389,15,22,0.682,92,2012-04-03,CHA,TOR,2012,95.5
11898,11898,98,@,W 87-86 ,240,36,86,0.419,29,58,0.5,7,28,0.25,8,11,0.727,87,38,83,0.458,34,73,0.466,4,10,0.4,6,13,0.462,86,2012-04-04,SAS,BOS,2012,88.0
11899,11899,99,Home,L 87-104 ,240,30,70,0.429,23,56,0.411,7,14,0.5,20,37,0.541,87,42,93,0.452,33,71,0.465,9,22,0.409,11,13,0.846,104,2012-04-08,SAC,HOU,2012,108.5
11900,11900,0,@,W 87-84 ,240,34,89,0.382,30,71,0.423,4,18,0.222,15,19,0.789,87,32,84,0.381,28,70,0.4,4,14,0.286,16,22,0.727,84,2012-04-16,WAS,CHI,2012,86.0
11901,11901,1,Home,L 87-109 ,240,35,79,0.443,31,70,0.443,4,9,0.444,13,16,0.813,87,39,80,0.488,33,59,0.559,6,21,0.286,25,36,0.694,109,2012-04-16,TOR,ATL,2012,112.0
11902,11902,2,Home,L 87-103 ,240,36,79,0.456,31,65,0.477,5,14,0.357,10,16,0.625,87,43,82,0.524,34,67,0.507,9,15,0.6,8,10,0.8,103,2012-04-18,CLE,PHI,2012,107.5
11903,11903,3,Home,L 87-99 ,240,38,90,0.422,34,71,0.479,4,19,0.211,7,10,0.7,87,37,79,0.468,33,63,0.524,4,16,0.25,21,28,0.75,99,2012-04-18,GSW,LAL,2012,101.0
11904,11904,4,Home,L 87-105 ,240,31,72,0.431,27,58,0.466,4,14,0.286,21,23,0.913,87,43,80,0.538,38,66,0.576,5,14,0.357,14,17,0.824,105,2012-04-23,BRK,PHI,2012,107.5
11905,11905,5,Home,L 87-92 ,240,35,80,0.438,29,66,0.439,6,14,0.429,11,16,0.688,87,38,81,0.469,32,64,0.5,6,17,0.353,10,10,1.0,92,2012-04-25,IND,CHI,2012,95.0
11906,11906,6,Home,W 87-74 ,240,35,87,0.402,27,63,0.429,8,24,0.333,9,11,0.818,87,29,78,0.372,27,69,0.391,2,9,0.222,14,23,0.609,74,2012-04-26,BOS,MIL,2012,75.0
11907,11907,7,@,L 87-93 ,240,34,84,0.405,28,67,0.418,6,17,0.353,13,16,0.813,87,33,79,0.418,31,70,0.443,2,9,0.222,25,33,0.758,93,2012-10-31,SAC,CHI,2013,94.0
11908,11908,8,@,W 87-85 ,240,33,86,0.384,28,69,0.406,5,17,0.294,16,23,0.696,87,32,80,0.4,28,59,0.475,4,21,0.19,17,22,0.773,85,2012-10-31,GSW,PHO,2013,87.0
11909,11909,9,Home,L 87-93 ,240,31,84,0.369,23,51,0.451,8,33,0.242,17,23,0.739,87,37,82,0.451,30,64,0.469,7,18,0.389,12,21,0.571,93,2012-11-07,HOU,DEN,2013,96.5
11910,11910,10,Home,W 87-80 ,240,34,80,0.425,28,67,0.418,6,13,0.462,13,16,0.813,87,33,85,0.388,30,72,0.417,3,13,0.231,11,15,0.733,80,2012-11-10,CHI,MIN,2013,81.5
11911,11911,11,Home,L 87-95 ,240,30,83,0.361,24,60,0.4,6,23,0.261,21,26,0.808,87,35,79,0.443,28,61,0.459,7,18,0.389,18,22,0.818,95,2012-11-12,POR,ATL,2013,98.5
11912,11912,12,Home,L 87-89 ,240,31,81,0.383,26,62,0.419,5,19,0.263,20,37,0.541,87,38,84,0.452,34,68,0.5,4,16,0.25,9,14,0.643,89,2012-11-14,MIN,CHA,2013,91.0
11913,11913,13,Home,L 87-94 ,240,32,85,0.376,28,72,0.389,4,13,0.308,19,28,0.679,87,31,80,0.388,29,66,0.439,2,14,0.143,30,34,0.882,94,2012-11-17,CHA,MEM,2013,95.0
11914,11914,14,Home,L 87-92 ,240,29,82,0.354,23,62,0.371,6,20,0.3,23,28,0.821,87,40,85,0.471,39,73,0.534,1,12,0.083,11,19,0.579,92,2012-11-19,SAS,LAC,2013,92.5
11915,11915,15,@,L 87-114 ,240,31,77,0.403,26,58,0.448,5,19,0.263,20,26,0.769,87,46,77,0.597,39,60,0.65,7,17,0.412,15,18,0.833,114,2012-11-21,POR,PHO,2013,117.5
11916,11916,16,@,L 87-108 ,240,35,78,0.449,30,60,0.5,5,18,0.278,12,21,0.571,87,43,81,0.531,31,52,0.596,12,29,0.414,10,15,0.667,108,2012-11-30,WAS,NYK,2013,114.0
11917,11917,17,Home,L 87-103 ,240,35,85,0.412,28,66,0.424,7,19,0.368,10,18,0.556,87,37,80,0.463,24,52,0.462,13,28,0.464,16,22,0.727,103,2012-12-05,NOP,LAL,2013,109.5
11918,11918,18,Home,W 87-81 ,240,32,77,0.416,31,67,0.463,1,10,0.1,22,27,0.815,87,34,77,0.442,33,62,0.532,1,15,0.067,12,17,0.706,81,2012-12-05,UTA,ORL,2013,81.5
11919,11919,19,Home,L 87-96 ,240,29,77,0.377,25,56,0.446,4,21,0.19,25,32,0.781,87,36,88,0.409,28,69,0.406,8,19,0.421,16,20,0.8,96,2012-12-22,WAS,DET,2013,100.0
11920,11920,20,@,W 87-84 ,240,33,81,0.407,24,50,0.48,9,31,0.29,12,15,0.8,87,32,84,0.381,25,56,0.446,7,28,0.25,13,17,0.765,84,2012-12-26,HOU,MIN,2013,87.5
11921,11921,21,@,W 87-84 ,240,31,82,0.378,21,55,0.382,10,27,0.37,15,23,0.652,87,35,76,0.461,31,58,0.534,4,18,0.222,10,14,0.714,84,2012-12-26,CLE,WAS,2013,86.0
11922,11922,22,@,L 87-104 ,240,36,87,0.414,33,68,0.485,3,19,0.158,12,16,0.75,87,40,86,0.465,33,62,0.532,7,24,0.292,17,28,0.607,104,2012-12-28,POR,LAL,2013,107.5
11923,11923,23,Home,W 87-77 ,240,34,87,0.391,27,71,0.38,7,16,0.438,12,18,0.667,87,31,85,0.365,28,75,0.373,3,10,0.3,12,18,0.667,77,2012-12-29,CHI,WAS,2013,78.5
11924,11924,24,@,W 87-80 ,240,40,89,0.449,39,80,0.488,1,9,0.111,6,9,0.667,87,34,75,0.453,30,60,0.5,4,15,0.267,8,11,0.727,80,2013-01-04,UTA,PHO,2013,82.0
11925,11925,25,Home,W 87-77 ,240,33,91,0.363,24,69,0.348,9,22,0.409,12,19,0.632,87,28,68,0.412,20,49,0.408,8,19,0.421,13,18,0.722,77,2013-01-08,IND,MIA,2013,81.0
11926,11926,26,Home,W 87-79 ,240,37,81,0.457,34,67,0.507,3,14,0.214,10,12,0.833,87,33,84,0.393,31,72,0.431,2,12,0.167,11,18,0.611,79,2013-01-09,BOS,PHO,2013,80.0
11927,11927,27,Home,L 87-94 ,240,33,71,0.465,26,54,0.481,7,17,0.412,14,20,0.7,87,40,88,0.455,38,71,0.535,2,17,0.118,12,16,0.75,94,2013-01-09,GSW,MEM,2013,95.0
11928,11928,28,Home,L 87-103 ,240,36,91,0.396,35,75,0.467,1,16,0.063,14,19,0.737,87,39,90,0.433,31,68,0.456,8,22,0.364,17,25,0.68,103,2013-01-11,MIL,DET,2013,107.0
11929,11929,29,Home,L 87-90 ,240,34,65,0.523,28,49,0.571,6,16,0.375,13,21,0.619,87,36,71,0.507,31,61,0.508,5,10,0.5,13,18,0.722,90,2013-01-12,DET,UTA,2013,92.5
11930,11930,30,@,L 87-100 ,240,33,82,0.402,29,59,0.492,4,23,0.174,17,22,0.773,87,35,81,0.432,24,51,0.471,11,30,0.367,19,25,0.76,100,2013-01-13,NOP,NYK,2013,105.5
11931,11931,31,@,W 87-83 ,240,32,71,0.451,26,48,0.542,6,23,0.261,17,22,0.773,87,31,86,0.36,25,65,0.385,6,21,0.286,15,18,0.833,83,2013-01-13,OKC,POR,2013,86.0
11932,11932,32,Home,L 87-102 ,240,35,79,0.443,29,62,0.468,6,17,0.353,11,22,0.5,87,33,72,0.458,22,41,0.537,11,31,0.355,25,31,0.806,102,2013-01-17,DET,NYK,2013,107.5
11933,11933,33,@,L 87-94 ,240,32,77,0.416,24,57,0.421,8,20,0.4,15,27,0.556,87,34,93,0.366,29,72,0.403,5,21,0.238,21,31,0.677,94,2013-01-19,WAS,LAC,2013,96.5
11934,11934,34,@,L 87-103 ,240,27,78,0.346,23,59,0.39,4,19,0.211,29,33,0.879,87,41,88,0.466,32,68,0.471,9,20,0.45,12,18,0.667,103,2013-01-25,GSW,CHI,2013,107.5
11935,11935,35,Home,W 87-76 ,240,39,93,0.419,37,77,0.481,2,16,0.125,7,10,0.7,87,27,88,0.307,25,72,0.347,2,16,0.125,20,23,0.87,76,2013-02-09,PHI,CHA,2013,77.0
11936,11936,36,Home,L 87-96 ,240,35,84,0.417,31,67,0.463,4,17,0.235,13,20,0.65,87,39,84,0.464,34,71,0.479,5,13,0.385,13,17,0.765,96,2013-02-19,NOP,CHI,2013,98.5
11937,11937,37,@,L 87-94 ,240,31,81,0.383,27,68,0.397,4,13,0.308,21,32,0.656,87,28,70,0.4,23,57,0.404,5,13,0.385,33,44,0.75,94,2013-02-20,PHI,MIN,2013,96.5
11938,11938,38,Home,L 87-97 ,240,30,81,0.37,27,72,0.375,3,9,0.333,24,33,0.727,87,32,72,0.444,27,55,0.491,5,17,0.294,28,35,0.8,97,2013-02-24,PHO,SAS,2013,99.5
11939,11939,39,@,L 87-92 ,240,31,73,0.425,23,50,0.46,8,23,0.348,17,22,0.773,87,36,81,0.444,26,59,0.441,10,22,0.455,10,12,0.833,92,2013-03-01,ATL,PHO,2013,97.0
11940,11940,40,@,L 87-90 ,240,33,85,0.388,27,66,0.409,6,19,0.316,15,20,0.75,87,34,80,0.425,28,65,0.431,6,15,0.4,16,21,0.762,90,2013-03-03,PHI,WAS,2013,93.0
11941,11941,41,@,W 87-77 ,240,31,75,0.413,18,40,0.45,13,35,0.371,12,15,0.8,87,32,74,0.432,25,54,0.463,7,20,0.35,6,10,0.6,77,2013-03-06,NYK,DET,2013,80.5
11942,11942,42,Home,W 87-83 ,240,27,75,0.36,19,52,0.365,8,23,0.348,25,29,0.862,87,33,83,0.398,25,59,0.424,8,24,0.333,9,12,0.75,83,2013-03-06,GSW,SAC,2013,87.0
11943,11943,43,Home,W 87-82 ,240,31,76,0.408,27,62,0.435,4,14,0.286,21,31,0.677,87,29,65,0.446,23,46,0.5,6,19,0.316,18,22,0.818,82,2013-03-06,MIN,WAS,2013,85.0
11944,11944,44,@,L 87-104 ,240,32,79,0.405,27,64,0.422,5,15,0.333,18,23,0.783,87,35,70,0.5,25,52,0.481,10,18,0.556,24,32,0.75,104,2013-03-09,CHA,WAS,2013,109.0
11945,11945,45,@,L 87-110 ,240,28,80,0.35,23,65,0.354,5,15,0.333,26,33,0.788,87,37,69,0.536,30,53,0.566,7,16,0.438,29,33,0.879,110,2013-03-13,UTA,OKC,2013,113.5
11946,11946,46,Home,W 87-80 ,240,35,77,0.455,34,65,0.523,1,12,0.083,16,22,0.727,87,30,85,0.353,26,73,0.356,4,12,0.333,16,19,0.842,80,2013-03-15,DEN,MEM,2013,82.0
11947,11947,47,@,L 87-96 ,240,35,80,0.438,32,61,0.525,3,19,0.158,14,19,0.737,87,36,72,0.5,27,52,0.519,9,20,0.45,15,19,0.789,96,2013-03-15,NOP,WAS,2013,100.5
11948,11948,48,Home,W 87-86 ,240,31,71,0.437,26,55,0.473,5,16,0.313,20,26,0.769,87,33,72,0.458,29,58,0.5,4,14,0.286,16,17,0.941,86,2013-03-20,NOP,BOS,2013,88.0
11949,11949,49,Home,W 87-84 ,240,35,81,0.432,32,70,0.457,3,11,0.273,14,22,0.636,87,30,78,0.385,25,64,0.391,5,14,0.357,19,24,0.792,84,2013-03-23,CHI,IND,2013,86.5
11950,11950,50,Home,L 87-97 ,240,37,86,0.43,33,68,0.485,4,18,0.222,9,15,0.6,87,42,86,0.488,35,68,0.515,7,18,0.389,6,10,0.6,97,2013-03-29,CLE,PHI,2013,100.5
11951,11951,51,@,L 87-109 ,240,32,79,0.405,27,59,0.458,5,20,0.25,18,36,0.5,87,42,74,0.568,38,60,0.633,4,14,0.286,21,31,0.677,109,2013-03-29,BRK,DEN,2013,111.0
11952,11952,52,Home,W 87-86 ,240,33,82,0.402,25,62,0.403,8,20,0.4,13,14,0.929,87,34,80,0.425,30,70,0.429,4,10,0.4,14,17,0.824,86,2013-04-05,CHI,ORL,2013,88.0
11953,11953,53,@,L 87-106 ,240,33,82,0.402,27,62,0.435,6,20,0.3,15,20,0.75,87,40,83,0.482,26,58,0.448,14,25,0.56,12,14,0.857,106,2013-04-06,PHI,MIA,2013,113.0
11954,11954,54,Home,L 87-89 ,240,29,81,0.358,22,56,0.393,7,25,0.28,22,28,0.786,87,32,73,0.438,29,66,0.439,3,7,0.429,22,29,0.759,89,2013-04-07,SAC,MEM,2013,90.5
11955,11955,55,Home,L 87-91 ,240,34,83,0.41,28,70,0.4,6,13,0.462,13,20,0.65,87,37,80,0.463,31,64,0.484,6,16,0.375,11,18,0.611,91,2013-04-13,MEM,LAC,2013,94.0
11956,11956,56,@,L 87-93 ,240,34,84,0.405,26,54,0.481,8,30,0.267,11,19,0.579,87,36,82,0.439,30,67,0.448,6,15,0.4,15,21,0.714,93,2013-04-14,BRK,TOR,2013,96.0
11957,11957,57,@,L 87-99 ,240,31,84,0.369,27,73,0.37,4,11,0.364,21,28,0.75,87,42,82,0.512,36,66,0.545,6,16,0.375,9,11,0.818,99,2013-04-17,NOP,DAL,2013,102.0
11958,11958,58,@,L 87-97 ,240,36,93,0.387,27,74,0.365,9,19,0.474,6,10,0.6,87,34,71,0.479,27,54,0.5,7,17,0.412,22,32,0.688,97,2013-10-29,ORL,IND,2014,100.5
11959,11959,59,@,L 87-93 ,240,32,66,0.485,29,53,0.547,3,13,0.231,20,29,0.69,87,38,86,0.442,33,69,0.478,5,17,0.294,12,23,0.522,93,2013-10-30,BOS,TOR,2014,95.5
11960,11960,60,Home,W 87-84 ,240,31,83,0.373,25,61,0.41,6,22,0.273,19,24,0.792,87,31,85,0.365,26,68,0.382,5,17,0.294,17,27,0.63,84,2013-11-01,PHO,UTA,2014,86.5
11961,11961,61,@,L 87-98 ,240,30,87,0.345,24,61,0.393,6,26,0.231,21,24,0.875,87,39,76,0.513,28,49,0.571,11,27,0.407,9,12,0.75,98,2013-11-02,SAC,GSW,2014,103.5
11962,11962,62,Home,W 87-77 ,240,34,76,0.447,32,63,0.508,2,13,0.154,17,29,0.586,87,31,74,0.419,28,58,0.483,3,16,0.188,12,12,1.0,77,2013-11-03,DET,BOS,2014,78.5
11963,11963,63,@,L 87-97 ,240,37,80,0.463,36,70,0.514,1,10,0.1,12,18,0.667,87,40,89,0.449,33,69,0.478,7,20,0.35,10,14,0.714,97,2013-11-06,UTA,BOS,2014,100.5
11964,11964,64,Home,L 87-103 ,240,35,82,0.427,29,61,0.475,6,21,0.286,11,17,0.647,87,31,67,0.463,23,52,0.442,8,15,0.533,33,39,0.846,103,2013-11-13,MEM,TOR,2014,107.0
11965,11965,65,Home,L 87-98 ,240,32,81,0.395,25,66,0.379,7,15,0.467,16,19,0.842,87,32,79,0.405,20,57,0.351,12,22,0.545,22,30,0.733,98,2013-11-18,UTA,GSW,2014,104.0
11966,11966,66,@,L 87-97 ,240,38,98,0.388,35,88,0.398,3,10,0.3,8,14,0.571,87,38,84,0.452,29,63,0.46,9,21,0.429,12,22,0.545,97,2013-11-21,CHI,DEN,2014,101.5
11967,11967,67,Home,L 87-94 ,240,36,93,0.387,31,73,0.425,5,20,0.25,10,12,0.833,87,33,72,0.458,29,56,0.518,4,16,0.25,24,31,0.774,94,2013-11-23,ATL,BOS,2014,96.0
11968,11968,68,@,L 87-88 ,240,29,77,0.377,20,53,0.377,9,24,0.375,20,21,0.952,87,31,73,0.425,28,58,0.483,3,15,0.2,23,30,0.767,88,2013-11-29,DAL,ATL,2014,89.5
11969,11969,69,Home,L 87-111 ,240,30,75,0.4,28,59,0.475,2,16,0.125,25,34,0.735,87,43,85,0.506,36,67,0.537,7,18,0.389,18,28,0.643,111,2013-12-03,BRK,DEN,2014,114.5
11970,11970,70,@,L 87-107 ,240,32,77,0.416,26,55,0.473,6,22,0.273,17,24,0.708,87,37,74,0.5,27,55,0.491,10,19,0.526,23,32,0.719,107,2013-12-05,MIA,CHI,2014,112.0
11971,11971,71,@,L 87-95 ,240,30,80,0.375,26,65,0.4,4,15,0.267,23,28,0.821,87,35,78,0.449,27,61,0.443,8,17,0.471,17,24,0.708,95,2013-12-17,SAC,CHA,2014,99.0
11972,11972,72,Home,L 87-95 ,240,33,79,0.418,27,57,0.474,6,22,0.273,15,23,0.652,87,39,82,0.476,38,73,0.521,1,9,0.111,16,19,0.842,95,2013-12-21,NYK,MEM,2014,95.5
11973,11973,73,@,W 87-78 ,240,30,78,0.385,24,54,0.444,6,24,0.25,21,23,0.913,87,33,88,0.375,28,64,0.438,5,24,0.208,7,10,0.7,78,2014-01-01,DAL,WAS,2014,80.5
11974,11974,74,Home,W 87-81 (OT),265,33,96,0.344,29,77,0.377,4,19,0.211,17,24,0.708,87,32,84,0.381,25,59,0.424,7,25,0.28,10,18,0.556,81,2014-01-02,CLE,ORL,2014,84.5
11975,11975,75,@,L 87-96 ,240,36,76,0.474,32,54,0.593,4,22,0.182,11,14,0.786,87,36,81,0.444,29,65,0.446,7,16,0.438,17,17,1.0,96,2014-01-02,MIL,UTA,2014,99.5
11976,11976,76,@,L 87-92 ,240,33,82,0.402,27,59,0.458,6,23,0.261,15,19,0.789,87,36,82,0.439,30,68,0.441,6,14,0.429,14,23,0.609,92,2014-01-07,PHO,CHI,2014,95.0
11977,11977,77,@,L 87-97 ,240,35,87,0.402,26,60,0.433,9,27,0.333,8,9,0.889,87,34,75,0.453,24,52,0.462,10,23,0.435,19,22,0.864,97,2014-01-08,IND,ATL,2014,102.0
11978,11978,78,@,L 87-123 ,240,29,84,0.345,25,68,0.368,4,16,0.25,25,28,0.893,87,45,92,0.489,38,69,0.551,7,23,0.304,26,35,0.743,123,2014-01-10,LAL,LAC,2014,126.5
11979,11979,79,@,L 87-90 ,240,33,81,0.407,28,60,0.467,5,21,0.238,16,20,0.8,87,32,80,0.4,28,66,0.424,4,14,0.286,22,27,0.815,90,2014-01-14,OKC,MEM,2014,92.0
11980,11980,80,Home,L 87-97 ,240,32,83,0.386,30,72,0.417,2,11,0.182,21,28,0.75,87,37,84,0.44,31,62,0.5,6,22,0.273,17,19,0.895,97,2014-01-18,NOP,GSW,2014,100.0
11981,11981,81,Home,L 87-98 ,240,33,88,0.375,25,69,0.362,8,19,0.421,13,18,0.722,87,37,70,0.529,27,49,0.551,10,21,0.476,14,18,0.778,98,2014-01-22,CLE,CHI,2014,103.0
11982,11982,82,Home,L 87-88 ,240,32,79,0.405,18,45,0.4,14,34,0.412,9,14,0.643,87,36,78,0.462,32,71,0.451,4,7,0.571,12,16,0.75,88,2014-01-24,HOU,MEM,2014,90.0
11983,11983,83,Home,L 87-89 ,240,37,88,0.42,31,69,0.449,6,19,0.316,7,10,0.7,87,31,77,0.403,20,54,0.37,11,23,0.478,16,22,0.727,89,2014-01-25,CHA,CHI,2014,94.5
11984,11984,84,Home,L 87-112 ,240,38,82,0.463,33,61,0.541,5,21,0.238,6,13,0.462,87,40,76,0.526,27,50,0.54,13,26,0.5,19,25,0.76,112,2014-01-25,MIL,ATL,2014,118.5
11985,11985,85,@,L 87-103 ,240,32,77,0.416,24,57,0.421,8,20,0.4,15,25,0.6,87,39,86,0.453,33,66,0.5,6,20,0.3,19,28,0.679,103,2014-01-28,ORL,DET,2014,106.0
11986,11986,86,@,L 87-102 ,240,29,81,0.358,19,51,0.373,10,30,0.333,19,28,0.679,87,38,74,0.514,36,62,0.581,2,12,0.167,24,37,0.649,102,2014-02-01,UTA,LAC,2014,103.0
11987,11987,87,@,L 87-102 ,240,32,77,0.416,28,63,0.444,4,14,0.286,19,20,0.95,87,40,83,0.482,29,61,0.475,11,22,0.5,11,15,0.733,102,2014-02-06,CHI,GSW,2014,107.5
11988,11988,88,@,L 87-90 ,240,35,83,0.422,26,60,0.433,9,23,0.391,8,11,0.727,87,31,80,0.388,28,65,0.431,3,15,0.2,25,36,0.694,90,2014-02-21,NOP,CHA,2014,91.5
11989,11989,89,@,L 87-109 ,240,31,76,0.408,21,53,0.396,10,23,0.435,15,20,0.75,87,43,84,0.512,34,66,0.515,9,18,0.5,14,20,0.7,109,2014-03-05,IND,CHA,2014,113.5
11990,11990,90,@,L 87-111 ,240,34,79,0.43,30,66,0.455,4,13,0.308,15,18,0.833,87,40,79,0.506,31,56,0.554,9,23,0.391,22,26,0.846,111,2014-03-06,MIA,SAS,2014,115.5
11991,11991,91,@,L 87-99 ,240,30,72,0.417,25,53,0.472,5,19,0.263,22,37,0.595,87,34,73,0.466,24,52,0.462,10,21,0.476,21,28,0.75,99,2014-03-07,SAC,TOR,2014,104.0
11992,11992,92,@,L 87-101 ,240,34,78,0.436,25,56,0.446,9,22,0.409,10,24,0.417,87,37,88,0.42,29,68,0.426,8,20,0.4,19,25,0.76,101,2014-03-12,DET,TOR,2014,105.0
11993,11993,93,@,L 87-111 ,240,28,79,0.354,23,53,0.434,5,26,0.192,26,34,0.765,87,43,86,0.5,29,62,0.468,14,24,0.583,11,13,0.846,111,2014-03-13,HOU,CHI,2014,118.0
11994,11994,94,@,W 87-80 ,240,34,80,0.425,29,54,0.537,5,26,0.192,14,20,0.7,87,29,94,0.309,26,73,0.356,3,21,0.143,19,21,0.905,80,2014-03-14,PHO,BOS,2014,81.5
11995,11995,95,Home,L 87-96 ,240,35,77,0.455,28,63,0.444,7,14,0.5,10,13,0.769,87,37,76,0.487,28,53,0.528,9,23,0.391,13,20,0.65,96,2014-03-14,UTA,LAC,2014,100.5
11996,11996,96,@,L 87-94 ,240,31,85,0.365,29,71,0.408,2,14,0.143,23,37,0.622,87,31,78,0.397,25,58,0.431,6,20,0.3,26,33,0.788,94,2014-03-15,SAC,CHI,2014,97.0
11997,11997,97,Home,L 87-91 ,240,32,69,0.464,27,53,0.509,5,16,0.313,18,26,0.692,87,36,79,0.456,32,70,0.457,4,9,0.444,15,16,0.938,91,2014-03-26,UTA,MEM,2014,93.0
11998,11998,98,Home,L 87-88 ,240,33,69,0.478,26,45,0.578,7,24,0.292,14,19,0.737,87,36,68,0.529,27,45,0.6,9,23,0.391,7,14,0.5,88,2014-04-08,MIA,BRK,2014,92.5
11999,11999,99,Home,L 87-102 ,240,34,80,0.425,30,63,0.476,4,17,0.235,15,16,0.938,87,41,82,0.5,30,61,0.492,11,21,0.524,9,12,0.75,102,2014-04-09,MIN,CHI,2014,107.5
12000,12000,0,Home,L 87-100 ,240,30,73,0.411,20,43,0.465,10,30,0.333,17,22,0.773,87,38,74,0.514,28,51,0.549,10,23,0.435,14,16,0.875,100,2014-04-16,MIA,PHI,2014,105.0
12001,12001,1,@,W 87-81 ,240,37,83,0.446,30,62,0.484,7,21,0.333,6,7,0.857,87,31,78,0.397,25,54,0.463,6,24,0.25,13,22,0.591,81,2014-11-04,MIL,IND,2015,84.0
12002,12002,2,@,L 87-108 ,240,33,90,0.367,28,67,0.418,5,23,0.217,16,16,1.0,87,40,77,0.519,28,47,0.596,12,30,0.4,16,19,0.842,108,2014-11-06,DAL,POR,2015,114.0
12003,12003,3,Home,L 87-98 ,240,30,86,0.349,20,44,0.455,10,42,0.238,17,21,0.81,87,39,87,0.448,30,59,0.508,9,28,0.321,11,17,0.647,98,2014-11-08,HOU,GSW,2015,102.5
12004,12004,4,@,L 87-88 ,240,34,80,0.425,27,59,0.458,7,21,0.333,12,18,0.667,87,29,78,0.372,22,44,0.5,7,34,0.206,23,37,0.622,88,2014-11-14,PHI,HOU,2015,91.5
12005,12005,5,Home,L 87-108 ,240,34,84,0.405,26,62,0.419,8,22,0.364,11,22,0.5,87,43,87,0.494,35,64,0.547,8,23,0.348,14,25,0.56,108,2014-11-14,IND,DEN,2015,112.0
12006,12006,6,@,L 87-112 ,240,32,84,0.381,25,67,0.373,7,17,0.412,16,28,0.571,87,45,87,0.517,34,61,0.557,11,26,0.423,11,14,0.786,112,2014-11-15,CHA,GSW,2015,117.5
12007,12007,7,@,L 87-97 ,240,35,89,0.393,34,70,0.486,1,19,0.053,16,17,0.941,87,33,78,0.423,22,52,0.423,11,26,0.423,20,27,0.741,97,2014-11-15,BRK,POR,2015,102.5
12008,12008,8,@,L 87-105 ,240,30,83,0.361,22,61,0.361,8,22,0.364,19,28,0.679,87,39,79,0.494,30,63,0.476,9,16,0.563,18,22,0.818,105,2014-11-21,CHI,POR,2015,109.5
12009,12009,9,@,L 87-99 ,240,34,91,0.374,25,64,0.391,9,27,0.333,10,10,1.0,87,41,79,0.519,33,58,0.569,8,21,0.381,9,11,0.818,99,2014-11-22,BRK,SAS,2015,103.0
12010,12010,10,@,L 87-113 ,240,33,71,0.465,28,58,0.483,5,13,0.385,16,22,0.727,87,38,74,0.514,32,54,0.593,6,20,0.3,31,38,0.816,113,2014-11-26,WAS,CLE,2015,116.0
12011,12011,11,Home,L 87-90 ,240,37,88,0.42,29,62,0.468,8,26,0.308,5,6,0.833,87,32,70,0.457,27,52,0.519,5,18,0.278,21,26,0.808,90,2014-12-04,NYK,CLE,2015,92.5
12012,12012,12,Home,L 87-104 ,240,36,90,0.4,31,71,0.437,5,19,0.263,10,15,0.667,87,43,83,0.518,35,65,0.538,8,18,0.444,10,15,0.667,104,2014-12-07,LAL,NOP,2015,108.0
12013,12013,13,@,L 87-103 ,240,39,80,0.488,34,64,0.531,5,16,0.313,4,8,0.5,87,43,73,0.589,35,60,0.583,8,13,0.615,9,11,0.818,103,2014-12-07,MIA,MEM,2015,107.0
12014,12014,14,@,L 87-96 ,240,38,87,0.437,33,64,0.516,5,23,0.217,6,10,0.6,87,35,84,0.417,32,70,0.457,3,14,0.214,23,29,0.793,96,2014-12-10,BOS,CHO,2015,97.5
12015,12015,15,Home,W 87-81 ,240,29,78,0.372,20,49,0.408,9,29,0.31,20,27,0.741,87,30,77,0.39,21,51,0.412,9,26,0.346,12,16,0.75,81,2014-12-12,ATL,ORL,2015,85.5
12016,12016,16,Home,L 87-114 ,240,31,79,0.392,23,57,0.404,8,22,0.364,17,27,0.63,87,42,72,0.583,26,49,0.531,16,23,0.696,14,20,0.7,114,2014-12-13,CHA,BRK,2015,122.0
12017,12017,17,Home,L 87-105 ,240,33,93,0.355,29,65,0.446,4,28,0.143,17,21,0.81,87,38,86,0.442,32,61,0.525,6,25,0.24,23,35,0.657,105,2014-12-15,PHI,BOS,2015,108.0
12018,12018,18,Home,L 87-107 ,240,37,84,0.44,32,63,0.508,5,21,0.238,8,10,0.8,87,42,83,0.506,27,50,0.54,15,33,0.455,8,8,1.0,107,2014-12-16,NYK,DAL,2015,114.5
12019,12019,19,Home,L 87-105 ,240,27,70,0.386,23,53,0.434,4,17,0.235,29,40,0.725,87,35,66,0.53,21,41,0.512,14,25,0.56,21,24,0.875,105,2014-12-17,MIA,UTA,2015,112.0
12020,12020,20,Home,L 87-91 ,240,33,80,0.413,25,54,0.463,8,26,0.308,13,18,0.722,87,33,77,0.429,28,58,0.483,5,19,0.263,20,27,0.741,91,2014-12-23,MIA,PHI,2015,93.5
12021,12021,21,@,L 87-114 ,240,33,74,0.446,29,62,0.468,4,12,0.333,17,27,0.63,87,43,82,0.524,35,67,0.522,8,15,0.533,20,29,0.69,114,2014-12-30,WAS,DAL,2015,118.0
12022,12022,22,@,L 87-95 ,240,35,78,0.449,30,56,0.536,5,22,0.227,12,17,0.706,87,35,72,0.486,28,57,0.491,7,15,0.467,18,22,0.818,95,2014-12-30,SAS,MEM,2015,98.5
12023,12023,23,Home,L 87-91 ,240,32,87,0.368,26,59,0.441,6,28,0.214,17,26,0.654,87,33,87,0.379,29,72,0.403,4,15,0.267,21,30,0.7,91,2015-01-02,CHA,CLE,2015,93.0
12024,12024,24,@,L 87-88 ,240,33,90,0.367,25,62,0.403,8,28,0.286,13,18,0.722,87,27,71,0.38,21,53,0.396,6,18,0.333,28,30,0.933,88,2015-01-04,IND,LAL,2015,91.0
12025,12025,25,@,L 87-95 ,240,36,81,0.444,33,70,0.471,3,11,0.273,12,16,0.75,87,35,88,0.398,31,71,0.437,4,17,0.235,21,24,0.875,95,2015-01-10,MIL,CHI,2015,97.0
12026,12026,26,Home,L 87-105 ,240,31,76,0.408,22,51,0.431,9,25,0.36,16,25,0.64,87,42,87,0.483,30,64,0.469,12,23,0.522,9,16,0.563,105,2015-01-13,PHI,ATL,2015,111.0
12027,12027,27,@,L 87-89 ,240,32,78,0.41,29,63,0.46,3,15,0.2,20,23,0.87,87,36,75,0.48,32,58,0.552,4,17,0.235,13,15,0.867,89,2015-01-23,IND,MIA,2015,91.0
12028,12028,28,Home,L 87-99 ,240,34,79,0.43,33,66,0.5,1,13,0.077,18,25,0.72,87,35,87,0.402,22,43,0.512,13,44,0.295,16,21,0.762,99,2015-01-25,LAL,HOU,2015,105.5
12029,12029,29,Home,L 87-93 ,240,32,90,0.356,25,66,0.379,7,24,0.292,16,23,0.696,87,35,84,0.417,27,54,0.5,8,30,0.267,15,20,0.75,93,2015-01-30,BOS,HOU,2015,97.0
12030,12030,30,@,L 87-106 ,240,33,91,0.363,24,65,0.369,9,26,0.346,12,17,0.706,87,40,87,0.46,28,55,0.509,12,32,0.375,14,18,0.778,106,2015-01-31,PHO,GSW,2015,112.0
12031,12031,31,@,L 87-94 ,240,35,84,0.417,30,74,0.405,5,10,0.5,12,17,0.706,87,33,76,0.434,27,51,0.529,6,25,0.24,22,27,0.815,94,2015-02-05,WAS,CHO,2015,97.0
12032,12032,32,@,L 87-108 ,240,34,88,0.386,28,65,0.431,6,23,0.261,13,17,0.765,87,40,90,0.444,32,59,0.542,8,31,0.258,20,23,0.87,108,2015-02-05,PHO,POR,2015,112.0
12033,12033,33,Home,W 87-82 ,240,32,74,0.432,28,61,0.459,4,13,0.308,19,24,0.792,87,31,93,0.333,24,65,0.369,7,28,0.25,13,16,0.813,82,2015-02-08,TOR,SAS,2015,85.5
12034,12034,34,Home,W 87-82 ,240,28,75,0.373,18,47,0.383,10,28,0.357,21,26,0.808,87,30,80,0.375,19,51,0.373,11,29,0.379,11,21,0.524,82,2015-02-11,DAL,UTA,2015,87.5
12035,12035,35,Home,L 87-104 ,240,33,81,0.407,24,60,0.4,9,21,0.429,12,17,0.706,87,42,88,0.477,32,61,0.525,10,27,0.37,10,11,0.909,104,2015-02-11,DET,SAS,2015,109.0
12036,12036,36,Home,L 87-111 ,240,35,82,0.427,29,64,0.453,6,18,0.333,11,16,0.688,87,38,79,0.481,29,59,0.492,9,20,0.45,26,35,0.743,111,2015-02-20,NYK,MIA,2015,115.5
12037,12037,37,Home,W 87-71 ,240,27,76,0.355,19,50,0.38,8,26,0.308,25,32,0.781,87,30,89,0.337,26,71,0.366,4,18,0.222,7,13,0.538,71,2015-02-23,CHI,MIL,2015,73.0
12038,12038,38,Home,L 87-90 ,240,35,79,0.443,26,52,0.5,9,27,0.333,8,12,0.667,87,33,81,0.407,28,66,0.424,5,15,0.333,19,26,0.731,90,2015-02-23,LAC,MEM,2015,92.5
12039,12039,39,@,L 87-104 ,240,34,80,0.425,29,49,0.592,5,31,0.161,14,18,0.778,87,39,85,0.459,26,50,0.52,13,35,0.371,13,16,0.813,104,2015-02-25,DAL,ATL,2015,110.5
12040,12040,40,Home,W 87-82 ,240,30,70,0.429,24,52,0.462,6,18,0.333,21,29,0.724,87,31,79,0.392,26,66,0.394,5,13,0.385,15,17,0.882,82,2015-03-10,UTA,NYK,2015,84.5
12041,12041,41,@,L 87-107 ,240,31,80,0.388,28,61,0.459,3,19,0.158,22,30,0.733,87,40,80,0.5,35,63,0.556,5,17,0.294,22,31,0.71,107,2015-03-12,MEM,WAS,2015,109.5
12042,12042,42,Home,L 87-96 ,240,32,78,0.41,22,52,0.423,10,26,0.385,13,21,0.619,87,39,83,0.47,31,65,0.477,8,18,0.444,10,12,0.833,96,2015-03-13,PHO,ATL,2015,100.0
12043,12043,43,Home,L 87-94 ,240,35,94,0.372,27,57,0.474,8,37,0.216,9,14,0.643,87,37,84,0.44,35,67,0.522,2,17,0.118,18,26,0.692,94,2015-03-14,PHI,BRK,2015,95.0
12044,12044,44,@,L 87-101 ,240,32,89,0.36,23,62,0.371,9,27,0.333,14,21,0.667,87,39,81,0.481,34,67,0.507,5,14,0.357,18,22,0.818,101,2015-03-22,PHI,LAL,2015,103.5
12045,12045,45,@,W 87-81 ,240,36,89,0.404,29,63,0.46,7,26,0.269,8,18,0.444,87,32,87,0.368,26,67,0.388,6,20,0.3,11,12,0.917,81,2015-03-27,POR,PHO,2015,84.0
12046,12046,46,Home,W 87-86 ,240,33,85,0.388,24,62,0.387,9,23,0.391,12,18,0.667,87,34,84,0.405,24,54,0.444,10,30,0.333,8,15,0.533,86,2015-03-29,CLE,PHI,2015,91.0
12047,12047,47,@,L 87-100 ,240,34,81,0.42,28,66,0.424,6,15,0.4,13,23,0.565,87,39,86,0.453,33,59,0.559,6,27,0.222,16,18,0.889,100,2015-04-01,IND,BOS,2015,103.0
12048,12048,48,@,L 87-101 ,240,31,84,0.369,24,63,0.381,7,21,0.333,18,20,0.9,87,43,93,0.462,36,77,0.468,7,16,0.438,8,12,0.667,101,2015-04-03,NYK,WAS,2015,104.5
12049,12049,49,Home,W 87-85 ,240,30,69,0.435,25,55,0.455,5,14,0.357,22,29,0.759,87,29,74,0.392,22,53,0.415,7,21,0.333,20,24,0.833,85,2015-04-04,PHO,UTA,2015,88.5
12050,12050,50,@,L 87-92 ,240,30,71,0.423,18,38,0.474,12,33,0.364,15,16,0.938,87,38,77,0.494,26,44,0.591,12,33,0.364,4,4,1.0,92,2015-04-15,CHA,TOR,2015,98.0
12051,12051,51,@,L 87-92 ,240,35,75,0.467,33,63,0.524,2,12,0.167,15,21,0.714,87,30,74,0.405,23,55,0.418,7,19,0.368,25,34,0.735,92,2015-10-28,UTA,DET,2016,95.5
12052,12052,52,Home,L 87-88 ,240,37,100,0.37,32,74,0.432,5,26,0.192,8,12,0.667,87,33,84,0.393,26,56,0.464,7,28,0.25,15,25,0.6,88,2015-10-28,ORL,WAS,2016,91.5
12053,12053,53,Home,L 87-95 ,240,35,98,0.357,29,69,0.42,6,29,0.207,11,14,0.786,87,36,83,0.434,31,64,0.484,5,19,0.263,18,25,0.72,95,2015-11-01,BOS,SAS,2016,97.5
12054,12054,54,@,L 87-92 ,240,35,90,0.389,28,67,0.418,7,23,0.304,10,17,0.588,87,33,87,0.379,26,59,0.441,7,28,0.25,19,22,0.864,92,2015-11-01,ORL,CHI,2016,95.5
12055,12055,55,@,L 87-106 ,240,29,69,0.42,24,50,0.48,5,19,0.263,24,24,1.0,87,41,90,0.456,30,65,0.462,11,25,0.44,13,20,0.65,106,2015-11-01,MIL,TOR,2016,111.5
12056,12056,56,@,L 87-101 ,240,36,83,0.434,31,62,0.5,5,21,0.238,10,13,0.769,87,37,76,0.487,29,54,0.537,8,22,0.364,19,24,0.792,101,2015-11-04,BRK,ATL,2016,105.0
12057,12057,57,@,L 87-91 ,240,34,81,0.42,28,53,0.528,6,28,0.214,13,15,0.867,87,35,86,0.407,27,63,0.429,8,23,0.348,13,17,0.765,91,2015-11-04,PHI,MIL,2016,95.0
12058,12058,58,@,L 87-90 ,240,36,81,0.444,30,61,0.492,6,20,0.3,9,13,0.692,87,36,80,0.45,31,65,0.477,5,15,0.333,13,24,0.542,90,2015-11-06,MIA,IND,2016,92.5
12059,12059,59,@,L 87-92 ,240,30,86,0.349,25,63,0.397,5,23,0.217,22,29,0.759,87,33,77,0.429,24,52,0.462,9,25,0.36,17,22,0.773,92,2015-11-06,TOR,ORL,2016,96.5
12060,12060,60,@,L 87-95 ,240,32,71,0.451,26,50,0.52,6,21,0.286,17,19,0.895,87,38,88,0.432,34,70,0.486,4,18,0.222,15,19,0.789,95,2015-11-15,NOP,NYK,2016,97.0
12061,12061,61,@,L 87-101 ,240,31,87,0.356,21,55,0.382,10,32,0.313,15,18,0.833,87,39,83,0.47,31,57,0.544,8,26,0.308,15,15,1.0,101,2015-11-25,WAS,CHO,2016,105.0
12062,12062,62,@,L 87-103 ,240,31,90,0.344,22,61,0.361,9,29,0.31,16,20,0.8,87,37,79,0.468,30,55,0.545,7,24,0.292,22,26,0.846,103,2015-11-27,DET,OKC,2016,106.5
12063,12063,63,@,L 87-101 ,240,29,69,0.42,24,52,0.462,5,17,0.294,24,30,0.8,87,38,82,0.463,29,64,0.453,9,18,0.5,16,21,0.762,101,2015-11-28,NOP,UTA,2016,105.5
12064,12064,64,Home,W 87-83 ,240,35,81,0.432,31,69,0.449,4,12,0.333,13,16,0.813,87,34,101,0.337,28,77,0.364,6,24,0.25,9,21,0.429,83,2015-11-29,BRK,DET,2016,86.0
12065,12065,65,Home,W 87-82 ,240,27,70,0.386,12,39,0.308,15,31,0.484,18,22,0.818,87,33,82,0.402,25,54,0.463,8,28,0.286,8,14,0.571,82,2015-11-29,CHA,MIL,2016,86.0
12066,12066,66,@,L 87-102 ,240,33,87,0.379,28,64,0.438,5,23,0.217,16,27,0.593,87,33,85,0.388,25,66,0.379,8,19,0.421,28,56,0.5,102,2015-11-30,POR,LAC,2016,106.0
12067,12067,67,@,L 87-99 ,240,32,86,0.372,23,56,0.411,9,30,0.3,14,24,0.583,87,38,88,0.432,34,69,0.493,4,19,0.211,19,22,0.864,99,2015-12-02,PHI,NYK,2016,101.0
12068,12068,68,@,L 87-100 ,240,32,86,0.372,19,59,0.322,13,27,0.481,10,13,0.769,87,37,74,0.5,27,48,0.563,10,26,0.385,16,20,0.8,100,2015-12-04,LAL,ATL,2016,105.0
12069,12069,69,@,L 87-109 ,240,36,88,0.409,27,63,0.429,9,25,0.36,6,10,0.6,87,44,82,0.537,38,68,0.559,6,14,0.429,15,25,0.6,109,2015-12-11,LAL,SAS,2016,112.0
12070,12070,70,Home,L 87-107 ,240,36,84,0.429,31,60,0.517,5,24,0.208,10,18,0.556,87,34,88,0.386,22,57,0.386,12,31,0.387,27,42,0.643,107,2015-12-17,LAL,HOU,2016,113.0
12071,12071,71,@,L 87-93 ,240,31,74,0.419,25,49,0.51,6,25,0.24,19,25,0.76,87,38,87,0.437,31,61,0.508,7,26,0.269,10,18,0.556,93,2015-12-28,ATL,IND,2016,96.5
12072,12072,72,Home,L 87-93 ,240,37,89,0.416,32,65,0.492,5,24,0.208,8,11,0.727,87,38,86,0.442,34,64,0.531,4,22,0.182,13,22,0.591,93,2015-12-29,DEN,CLE,2016,95.0
12073,12073,73,@,L 87-92 (OT),265,33,81,0.407,26,63,0.413,7,18,0.389,14,26,0.538,87,31,75,0.413,22,48,0.458,9,27,0.333,21,28,0.75,92,2016-01-02,MEM,UTA,2016,96.5
12074,12074,74,Home,L 87-93 ,240,33,79,0.418,29,63,0.46,4,16,0.25,17,22,0.773,87,36,77,0.468,30,57,0.526,6,20,0.3,15,21,0.714,93,2016-01-10,MIN,DAL,2016,96.0
12075,12075,75,@,L 87-117 ,240,35,81,0.432,32,66,0.485,3,15,0.2,14,25,0.56,87,39,69,0.565,32,51,0.627,7,18,0.389,32,40,0.8,117,2016-01-17,PHO,MIN,2016,120.5
12076,12076,76,Home,L 87-96 ,240,33,84,0.393,29,67,0.433,4,17,0.235,17,26,0.654,87,36,74,0.486,27,55,0.491,9,19,0.474,15,21,0.714,96,2016-01-20,ORL,PHI,2016,100.5
12077,12077,77,@,L 87-106 ,240,33,68,0.485,26,53,0.491,7,15,0.467,14,18,0.778,87,45,86,0.523,40,70,0.571,5,16,0.313,11,13,0.846,106,2016-01-20,MIA,WAS,2016,108.5
12078,12078,78,@,L 87-105 ,240,27,70,0.386,22,48,0.458,5,22,0.227,28,32,0.875,87,39,81,0.481,34,61,0.557,5,20,0.25,22,26,0.846,105,2016-01-31,ATL,MIA,2016,107.5
12079,12079,79,@,L 87-89 ,240,29,93,0.312,21,58,0.362,8,35,0.229,21,26,0.808,87,31,78,0.397,27,51,0.529,4,27,0.148,23,33,0.697,89,2016-02-08,LAL,IND,2016,91.0
12080,12080,80,@,W 87-81 ,240,34,90,0.378,28,66,0.424,6,24,0.25,13,17,0.765,87,30,85,0.353,17,39,0.436,13,46,0.283,8,14,0.571,81,2016-02-24,DEN,LAC,2016,87.5
12081,12081,81,Home,W 87-76 ,240,38,77,0.494,30,60,0.5,8,17,0.471,3,5,0.6,87,27,81,0.333,20,49,0.408,7,32,0.219,15,23,0.652,76,2016-02-28,ATL,CHO,2016,79.5
12082,12082,82,Home,L 87-90 ,240,34,85,0.4,31,69,0.449,3,16,0.188,16,21,0.762,87,33,75,0.44,28,54,0.519,5,21,0.238,19,27,0.704,90,2016-03-13,LAL,NYK,2016,92.5
12083,12083,83,@,L 87-108 ,240,32,69,0.464,24,50,0.48,8,19,0.421,15,22,0.682,87,44,82,0.537,36,62,0.581,8,20,0.4,12,16,0.75,108,2016-03-15,LAC,SAS,2016,112.0
12084,12084,84,Home,W 87-79 ,240,32,78,0.41,24,57,0.421,8,21,0.381,15,18,0.833,87,31,82,0.378,22,46,0.478,9,36,0.25,8,10,0.8,79,2016-03-19,SAS,GSW,2016,83.5
12085,12085,85,Home,L 87-89 ,240,33,74,0.446,24,51,0.471,9,23,0.391,12,22,0.545,87,31,77,0.403,20,48,0.417,11,29,0.379,16,20,0.8,89,2016-03-23,HOU,UTA,2016,94.5
12086,12086,86,Home,L 87-101 ,240,33,83,0.398,27,64,0.422,6,19,0.316,15,24,0.625,87,37,72,0.514,32,57,0.561,5,15,0.333,22,30,0.733,101,2016-03-28,MEM,SAS,2016,103.5
12087,12087,87,@,L 87-107 ,240,35,94,0.372,31,73,0.425,4,21,0.19,13,21,0.619,87,38,87,0.437,26,49,0.531,12,38,0.316,19,24,0.792,107,2016-03-31,BRK,CLE,2016,113.0
12088,12088,88,Home,L 87-106 ,240,33,85,0.388,25,62,0.403,8,23,0.348,13,21,0.619,87,42,76,0.553,34,54,0.63,8,22,0.364,14,23,0.609,106,2016-04-03,BRK,NOP,2016,110.0
12089,12089,89,Home,L 87-92 ,240,33,96,0.344,26,71,0.366,7,25,0.28,14,20,0.7,87,34,81,0.42,27,59,0.458,7,22,0.318,17,20,0.85,92,2016-04-03,NYK,IND,2016,95.5
12090,12090,90,@,L 87-95 ,240,32,84,0.381,24,63,0.381,8,21,0.381,15,20,0.75,87,33,76,0.434,21,44,0.477,12,32,0.375,17,21,0.81,95,2016-04-07,TOR,ATL,2016,101.0
12091,12091,91,@,L 87-96 ,240,34,88,0.386,25,60,0.417,9,28,0.321,10,15,0.667,87,37,84,0.44,31,59,0.525,6,25,0.24,16,18,0.889,96,2016-11-04,MIA,TOR,2017,99.0
12092,12092,92,@,L 87-115 ,240,33,94,0.351,27,71,0.38,6,23,0.261,15,17,0.882,87,35,90,0.389,24,63,0.381,11,27,0.407,34,43,0.791,115,2016-11-11,NYK,BOS,2017,120.5
12093,12093,93,@,W 87-74 ,240,33,81,0.407,26,53,0.491,7,28,0.25,14,16,0.875,87,26,78,0.333,18,58,0.31,8,20,0.4,14,19,0.737,74,2016-11-11,UTA,ORL,2017,78.0
12094,12094,94,@,L 87-95 ,240,26,77,0.338,13,49,0.265,13,28,0.464,22,27,0.815,87,34,78,0.436,26,57,0.456,8,21,0.381,19,22,0.864,95,2016-11-19,DAL,ORL,2017,99.0
12095,12095,95,Home,L 87-92 ,240,33,91,0.363,26,66,0.394,7,25,0.28,14,23,0.609,87,33,73,0.452,24,51,0.471,9,22,0.409,17,22,0.773,92,2016-11-23,ORL,PHO,2017,96.5
12096,12096,96,Home,L 87-94 ,240,33,77,0.429,23,47,0.489,10,30,0.333,11,14,0.786,87,33,71,0.465,22,52,0.423,11,19,0.579,17,24,0.708,94,2016-11-30,DAL,SAS,2017,99.5
12097,12097,97,@,L 87-97 ,240,32,86,0.372,23,55,0.418,9,31,0.29,14,18,0.778,87,35,74,0.473,30,56,0.536,5,18,0.278,22,31,0.71,97,2016-12-01,DAL,CHO,2017,99.5
12098,12098,98,Home,W 87-77 ,240,30,88,0.341,24,67,0.358,6,21,0.286,21,29,0.724,87,34,89,0.382,30,62,0.484,4,27,0.148,5,8,0.625,77,2016-12-07,CHA,DET,2017,79.0
12099,12099,99,Home,L 87-117 ,240,30,81,0.37,19,55,0.345,11,26,0.423,16,24,0.667,87,43,84,0.512,36,58,0.621,7,26,0.269,24,29,0.828,117,2016-12-07,ORL,BOS,2017,120.5
12100,12100,0,@,L 87-109 ,240,32,79,0.405,21,45,0.467,11,34,0.324,12,14,0.857,87,37,74,0.5,18,37,0.486,19,37,0.514,16,22,0.727,109,2016-12-10,DAL,HOU,2017,118.5
12101,12101,1,@,L 87-91 ,240,36,87,0.414,28,67,0.418,8,20,0.4,7,13,0.538,87,33,89,0.371,22,61,0.361,11,28,0.393,14,21,0.667,91,2016-12-23,MIA,NOP,2017,96.5
12102,12102,2,Home,L 87-108 ,240,32,83,0.386,23,59,0.39,9,24,0.375,14,26,0.538,87,43,85,0.506,36,64,0.563,7,21,0.333,15,20,0.75,108,2017-01-10,LAL,POR,2017,111.5
12103,12103,3,@,L 87-98 ,240,35,80,0.438,30,59,0.508,5,21,0.238,12,18,0.667,87,36,77,0.468,24,48,0.5,12,29,0.414,14,19,0.737,98,2017-01-15,MIN,DAL,2017,104.0
12104,12104,4,@,L 87-110 ,240,34,79,0.43,26,53,0.491,8,26,0.308,11,17,0.647,87,42,84,0.5,31,56,0.554,11,28,0.393,15,16,0.938,110,2017-02-06,DAL,DEN,2017,115.5
12105,12105,5,@,L 87-94 ,240,34,88,0.386,28,58,0.483,6,30,0.2,13,14,0.929,87,36,82,0.439,31,63,0.492,5,19,0.263,17,21,0.81,94,2017-03-02,GSW,CHI,2017,96.5
12106,12106,6,Home,L 87-94 ,240,34,80,0.425,25,51,0.49,9,29,0.31,10,13,0.769,87,36,76,0.474,28,55,0.509,8,21,0.381,14,23,0.609,94,2017-03-08,NOP,TOR,2017,98.0
12107,12107,7,Home,L 86-105 ,240,32,82,0.39,27,61,0.443,5,21,0.238,17,24,0.708,86,37,81,0.457,29,58,0.5,8,23,0.348,23,38,0.605,105,2011-12-25,GSW,LAC,2012,109.0
12108,12108,8,@,L 86-99 ,240,33,72,0.458,27,58,0.466,6,14,0.429,14,18,0.778,86,32,72,0.444,25,47,0.532,7,25,0.28,28,38,0.737,99,2011-12-30,TOR,DAL,2012,102.5
12109,12109,9,Home,L 86-94 ,240,32,78,0.41,30,62,0.484,2,16,0.125,20,23,0.87,86,37,74,0.5,32,62,0.516,5,12,0.417,15,23,0.652,94,2012-01-01,WAS,BOS,2012,96.5
12110,12110,10,@,L 86-91 ,240,37,88,0.42,32,69,0.464,5,19,0.263,7,11,0.636,86,33,83,0.398,29,64,0.453,4,19,0.211,21,27,0.778,91,2012-01-02,MIL,DEN,2012,93.0
12111,12111,11,Home,L 86-90 ,240,33,82,0.402,26,61,0.426,7,21,0.333,13,24,0.542,86,33,80,0.413,30,71,0.423,3,9,0.333,21,25,0.84,90,2012-01-04,MIN,MEM,2012,91.5
12112,12112,12,@,L 86-92 ,240,29,80,0.363,23,60,0.383,6,20,0.3,22,27,0.815,86,31,69,0.449,27,50,0.54,4,19,0.211,26,40,0.65,92,2012-01-07,MIL,LAC,2012,94.0
12113,12113,13,@,L 86-96 ,240,30,82,0.366,26,69,0.377,4,13,0.308,22,30,0.733,86,38,76,0.5,32,59,0.542,6,17,0.353,14,19,0.737,96,2012-01-09,IND,PHI,2012,99.0
12114,12114,14,Home,L 86-100 ,240,30,69,0.435,24,56,0.429,6,13,0.462,20,25,0.8,86,38,69,0.551,34,54,0.63,4,15,0.267,20,27,0.741,100,2012-01-10,DET,DAL,2012,102.0
12115,12115,15,@,L 86-102 ,240,33,78,0.423,32,66,0.485,1,12,0.083,19,25,0.76,86,47,87,0.54,44,77,0.571,3,10,0.3,5,9,0.556,102,2012-01-16,CHI,MEM,2012,103.5
12116,12116,16,@,L 86-99 ,240,35,79,0.443,31,62,0.5,4,17,0.235,12,20,0.6,86,37,80,0.463,27,54,0.5,10,26,0.385,15,19,0.789,99,2012-01-16,SAC,MIN,2012,104.0
12117,12117,17,Home,L 86-100 ,240,27,73,0.37,21,51,0.412,6,22,0.273,26,33,0.788,86,39,82,0.476,31,60,0.517,8,22,0.364,14,20,0.7,100,2012-01-20,NYK,MIL,2012,104.0
12118,12118,18,Home,L 86-88 ,240,31,82,0.378,26,57,0.456,5,25,0.2,19,21,0.905,86,36,83,0.434,31,62,0.5,5,21,0.238,11,19,0.579,88,2012-01-20,SAS,SAC,2012,90.5
12119,12119,19,Home,W 86-84 ,240,32,88,0.364,27,70,0.386,5,18,0.278,17,24,0.708,86,33,76,0.434,32,73,0.438,1,3,0.333,17,20,0.85,84,2012-01-28,PHO,MEM,2012,84.5
12120,12120,20,@,L 86-113 ,240,32,71,0.451,29,62,0.468,3,9,0.333,19,25,0.76,86,42,70,0.6,33,52,0.635,9,18,0.5,20,25,0.8,113,2012-01-31,DET,NYK,2012,117.5
12121,12121,21,Home,L 86-95 ,240,30,84,0.357,26,65,0.4,4,19,0.211,22,25,0.88,86,33,81,0.407,28,61,0.459,5,20,0.25,24,33,0.727,95,2012-02-01,DAL,OKC,2012,97.5
12122,12122,22,Home,W 86-84 ,240,32,79,0.405,28,65,0.431,4,14,0.286,18,28,0.643,86,31,82,0.378,23,59,0.39,8,23,0.348,14,21,0.667,84,2012-02-07,MIN,SAC,2012,88.0
12123,12123,23,Home,L 86-94 ,240,33,75,0.44,30,59,0.508,3,16,0.188,17,25,0.68,86,35,68,0.515,31,51,0.608,4,17,0.235,20,25,0.8,94,2012-02-10,NOP,POR,2012,96.0
12124,12124,24,Home,W 86-74 ,240,33,75,0.44,28,56,0.5,5,19,0.263,15,20,0.75,86,29,65,0.446,26,55,0.473,3,10,0.3,13,18,0.722,74,2012-02-10,TOR,BOS,2012,75.5
12125,12125,25,Home,L 86-111 ,240,26,74,0.351,25,60,0.417,1,14,0.071,33,43,0.767,86,41,78,0.526,33,58,0.569,8,20,0.4,21,24,0.875,111,2012-02-11,CHA,LAC,2012,115.0
12126,12126,26,Home,W 86-80 ,240,32,75,0.427,29,64,0.453,3,11,0.273,19,28,0.679,86,30,73,0.411,26,59,0.441,4,14,0.286,16,23,0.696,80,2012-02-13,NOP,UTA,2012,82.0
12127,12127,27,Home,W 86-78 ,240,37,84,0.44,29,67,0.433,8,17,0.471,4,9,0.444,86,31,90,0.344,24,63,0.381,7,27,0.259,9,14,0.643,78,2012-02-14,LAL,ATL,2012,81.5
12128,12128,28,@,W 86-83 ,240,33,74,0.446,26,57,0.456,7,17,0.412,13,14,0.929,86,31,78,0.397,27,61,0.443,4,17,0.235,17,25,0.68,83,2012-02-28,BOS,CLE,2012,85.0
12129,12129,29,Home,W 86-74 ,240,31,72,0.431,25,50,0.5,6,22,0.273,18,24,0.75,86,29,70,0.414,26,61,0.426,3,9,0.333,13,22,0.591,74,2012-03-05,POR,NOH,2012,75.5
12130,12130,30,@,L 86-89 ,240,35,76,0.461,27,53,0.509,8,23,0.348,8,9,0.889,86,35,80,0.438,35,70,0.5,0,10,0.0,19,25,0.76,89,2012-03-07,ATL,MIA,2012,89.0
12131,12131,31,@,L 86-104 ,240,31,72,0.431,25,57,0.439,6,15,0.4,18,23,0.783,86,42,88,0.477,34,70,0.486,8,18,0.444,12,17,0.706,104,2012-03-09,POR,BOS,2012,108.0
12132,12132,32,Home,W 86-85 ,240,38,68,0.559,37,60,0.617,1,8,0.125,9,15,0.6,86,31,73,0.425,23,54,0.426,8,19,0.421,15,22,0.682,85,2012-03-09,DET,ATL,2012,89.0
12133,12133,33,@,L 86-105 ,240,29,73,0.397,24,52,0.462,5,21,0.238,23,25,0.92,86,39,74,0.527,32,53,0.604,7,21,0.333,20,25,0.8,105,2012-03-10,TOR,DET,2012,108.5
12134,12134,34,Home,W 86-70 ,240,34,67,0.507,26,38,0.684,8,29,0.276,10,14,0.714,86,28,83,0.337,22,63,0.349,6,20,0.3,8,10,0.8,70,2012-03-16,ORL,NJN,2012,73.0
12135,12135,35,@,L 86-99 ,240,35,82,0.427,34,71,0.479,1,11,0.091,15,22,0.682,86,40,85,0.471,33,65,0.508,7,20,0.35,12,19,0.632,99,2012-03-18,HOU,PHO,2012,102.5
12136,12136,36,@,L 86-99 ,240,36,74,0.486,32,64,0.5,4,10,0.4,10,13,0.769,86,41,92,0.446,38,82,0.463,3,10,0.3,14,18,0.778,99,2012-03-23,BOS,PHI,2012,100.5
12137,12137,37,Home,L 86-89 ,240,37,81,0.457,36,76,0.474,1,5,0.2,11,12,0.917,86,36,90,0.4,34,71,0.479,2,19,0.105,15,17,0.882,89,2012-03-24,NOP,SAS,2012,90.0
12138,12138,38,@,L 86-93 ,240,33,85,0.388,24,56,0.429,9,29,0.31,11,13,0.846,86,34,80,0.425,34,69,0.493,0,11,0.0,25,28,0.893,93,2012-03-27,MIN,MEM,2012,93.0
12139,12139,39,@,L 86-103 ,240,30,80,0.375,25,54,0.463,5,26,0.192,21,32,0.656,86,41,82,0.5,34,63,0.54,7,19,0.368,14,23,0.609,103,2012-03-28,PHO,LAC,2012,106.5
12140,12140,40,@,L 86-108 ,240,31,69,0.449,22,43,0.512,9,26,0.346,15,26,0.577,86,43,85,0.506,31,51,0.608,12,34,0.353,10,12,0.833,108,2012-03-28,ORL,NYK,2012,114.0
12141,12141,41,Home,L 86-87 ,240,38,83,0.458,34,73,0.466,4,10,0.4,6,13,0.462,86,36,86,0.419,29,58,0.5,7,28,0.25,8,11,0.727,87,2012-04-04,BOS,SAS,2012,90.5
12142,12142,42,@,L 86-93 ,240,33,77,0.429,28,64,0.438,5,13,0.385,15,18,0.833,86,33,80,0.413,28,64,0.438,5,16,0.313,22,26,0.846,93,2012-04-05,BOS,CHI,2012,95.5
12143,12143,43,@,W 86-72 ,240,32,76,0.421,23,58,0.397,9,18,0.5,13,14,0.929,86,26,74,0.351,21,52,0.404,5,22,0.227,15,19,0.789,72,2012-04-07,BOS,IND,2012,74.5
12144,12144,44,@,L 86-98 ,240,31,73,0.425,24,52,0.462,7,21,0.333,17,21,0.81,86,39,90,0.433,30,70,0.429,9,20,0.45,11,16,0.688,98,2012-04-10,NYK,CHI,2012,102.5
12145,12145,45,@,L 86-88 (OT),265,34,83,0.41,32,63,0.508,2,20,0.1,16,23,0.696,86,37,89,0.416,34,76,0.447,3,13,0.231,11,13,0.846,88,2012-04-11,ATL,BOS,2012,89.5
12146,12146,46,@,L 86-96 (OT),265,36,82,0.439,32,71,0.451,4,11,0.364,10,16,0.625,86,37,86,0.43,26,64,0.406,11,22,0.5,11,19,0.579,96,2012-04-12,MIA,CHI,2012,101.5
12147,12147,47,Home,L 86-102 ,240,29,72,0.403,24,50,0.48,5,22,0.227,23,31,0.742,86,41,74,0.554,37,62,0.597,4,12,0.333,16,23,0.696,102,2012-04-15,ATL,TOR,2012,104.0
12148,12148,48,@,L 86-101 ,240,32,87,0.368,22,61,0.361,10,26,0.385,12,20,0.6,86,41,83,0.494,37,67,0.552,4,16,0.25,15,21,0.714,101,2012-04-15,HOU,DEN,2012,103.0
12149,12149,49,@,W 86-84 ,240,36,87,0.414,29,69,0.42,7,18,0.389,7,9,0.778,86,31,77,0.403,22,52,0.423,9,25,0.36,13,16,0.813,84,2012-04-21,WAS,MIA,2012,88.5
12150,12150,50,@,L 86-92 ,240,34,76,0.447,30,62,0.484,4,14,0.286,14,18,0.778,86,29,78,0.372,23,61,0.377,6,17,0.353,28,36,0.778,92,2012-04-23,TOR,MIL,2012,95.0
12151,12151,51,@,L 86-108 ,240,34,87,0.391,29,72,0.403,5,15,0.333,13,16,0.813,86,41,81,0.506,27,49,0.551,14,32,0.438,12,16,0.75,108,2012-04-26,PHI,DET,2012,115.0
12152,12152,52,Home,W 86-84 ,240,35,79,0.443,30,60,0.5,5,19,0.263,11,16,0.688,86,29,77,0.377,22,60,0.367,7,17,0.412,19,23,0.826,84,2012-11-01,SAS,OKC,2013,87.5
12153,12153,53,Home,L 86-115 ,240,32,79,0.405,24,59,0.407,8,20,0.4,14,27,0.519,86,44,69,0.638,40,59,0.678,4,10,0.4,23,30,0.767,115,2012-11-02,CLE,CHI,2013,117.0
12154,12154,54,@,L 86-88 ,240,35,85,0.412,25,57,0.439,10,28,0.357,6,12,0.5,86,37,81,0.457,32,67,0.478,5,14,0.357,9,14,0.643,88,2012-11-02,UTA,NOH,2013,90.5
12155,12155,55,Home,L 86-89 ,240,34,78,0.436,28,58,0.483,6,20,0.3,12,17,0.706,86,36,84,0.429,28,63,0.444,8,21,0.381,9,13,0.692,89,2012-11-03,WAS,BOS,2013,93.0
12156,12156,56,@,L 86-105 ,240,29,64,0.453,23,48,0.479,6,16,0.375,22,31,0.71,86,40,90,0.444,30,69,0.435,10,21,0.476,15,17,0.882,105,2012-11-04,MIN,TOR,2013,110.0
12157,12157,57,@,L 86-89 ,240,35,85,0.412,27,59,0.458,8,26,0.308,8,9,0.889,86,38,87,0.437,31,65,0.477,7,22,0.318,6,12,0.5,89,2012-11-07,IND,ATL,2013,92.5
12158,12158,58,@,L 86-95 ,240,25,74,0.338,21,51,0.412,4,23,0.174,32,46,0.696,86,37,83,0.446,32,66,0.485,5,17,0.294,16,18,0.889,95,2012-11-07,LAL,UTA,2013,97.5
12159,12159,59,Home,L 86-97 ,240,32,91,0.352,29,75,0.387,3,16,0.188,19,26,0.731,86,35,72,0.486,30,54,0.556,5,18,0.278,22,26,0.846,97,2012-11-09,SAC,SAS,2013,99.5
12160,12160,60,@,L 86-104 ,240,30,79,0.38,26,64,0.406,4,15,0.267,22,36,0.611,86,38,86,0.442,24,62,0.387,14,24,0.583,14,16,0.875,104,2012-11-11,MIA,MEM,2013,111.0
12161,12161,61,Home,L 86-103 ,240,36,77,0.468,35,66,0.53,1,11,0.091,13,19,0.684,86,35,72,0.486,21,45,0.467,14,27,0.519,19,22,0.864,103,2012-11-13,SAC,POR,2013,110.0
12162,12162,62,Home,W 86-79 ,240,34,80,0.425,25,60,0.417,9,20,0.45,9,12,0.75,86,30,84,0.357,25,64,0.391,5,20,0.25,14,15,0.933,79,2012-11-18,PHI,CLE,2013,81.5
12163,12163,63,@,L 86-97 ,240,32,80,0.4,28,67,0.418,4,13,0.308,18,21,0.857,86,38,80,0.475,31,62,0.5,7,18,0.389,14,23,0.609,97,2012-11-18,ORL,TOR,2013,100.5
12164,12164,64,Home,W 86-76 ,240,34,73,0.466,29,60,0.483,5,13,0.385,13,19,0.684,86,29,72,0.403,25,55,0.455,4,17,0.235,14,22,0.636,76,2012-11-23,BRK,LAC,2013,78.0
12165,12165,65,Home,L 86-93 ,240,38,88,0.432,35,71,0.493,3,17,0.176,7,10,0.7,86,32,82,0.39,28,66,0.424,4,16,0.25,25,26,0.962,93,2012-11-24,MIL,CHI,2013,95.0
12166,12166,66,Home,L 86-98 ,240,35,78,0.449,34,67,0.507,1,11,0.091,15,19,0.789,86,38,83,0.458,27,63,0.429,11,20,0.55,11,13,0.846,98,2012-11-30,ORL,BRK,2013,103.5
12167,12167,67,@,W 86-80 ,240,35,80,0.438,29,58,0.5,6,22,0.273,10,16,0.625,86,31,81,0.383,24,59,0.407,7,22,0.318,11,11,1.0,80,2012-12-12,ATL,ORL,2013,83.5
12168,12168,68,Home,L 86-90 ,240,32,81,0.395,23,63,0.365,9,18,0.5,13,14,0.929,86,33,83,0.398,28,68,0.412,5,15,0.333,19,27,0.704,90,2012-12-14,CLE,MIL,2013,92.5
12169,12169,69,Home,L 86-99 ,240,31,74,0.419,26,57,0.456,5,17,0.294,19,24,0.792,86,38,85,0.447,34,74,0.459,4,11,0.364,19,24,0.792,99,2012-12-15,UTA,MEM,2013,101.0
12170,12170,70,@,L 86-100 ,240,35,78,0.449,25,53,0.472,10,25,0.4,6,9,0.667,86,38,83,0.458,27,54,0.5,11,29,0.379,13,17,0.765,100,2012-12-19,BRK,NYK,2013,105.5
12171,12171,71,Home,L 86-111 ,240,38,95,0.4,37,79,0.468,1,16,0.063,9,10,0.9,86,41,81,0.506,33,62,0.532,8,19,0.421,21,24,0.875,111,2012-12-30,DAL,SAS,2013,115.0
12172,12172,72,Home,L 86-95 ,240,36,82,0.439,26,62,0.419,10,20,0.5,4,12,0.333,86,41,83,0.494,32,61,0.525,9,22,0.409,4,8,0.5,95,2013-01-01,NOP,ATL,2013,99.5
12173,12173,73,@,W 86-84 ,240,33,81,0.407,23,54,0.426,10,27,0.37,10,15,0.667,86,32,81,0.395,30,76,0.395,2,5,0.4,18,18,1.0,84,2013-01-04,POR,MEM,2013,85.0
12174,12174,74,@,L 86-109 ,240,35,84,0.417,32,67,0.478,3,17,0.176,13,20,0.65,86,41,85,0.482,33,60,0.55,8,25,0.32,19,23,0.826,109,2013-01-05,PHI,SAS,2013,113.0
12175,12175,75,@,L 86-97 ,240,35,83,0.422,29,59,0.492,6,24,0.25,10,12,0.833,86,33,81,0.407,27,67,0.403,6,14,0.429,25,31,0.806,97,2013-01-13,IND,BRK,2013,100.0
12176,12176,76,@,L 86-97 ,240,37,85,0.435,35,68,0.515,2,17,0.118,10,12,0.833,86,40,86,0.465,28,65,0.431,12,21,0.571,5,5,1.0,97,2013-01-16,IND,ORL,2013,103.0
12177,12177,77,Home,L 86-89 ,240,31,76,0.408,28,58,0.483,3,18,0.167,21,28,0.75,86,32,83,0.386,24,55,0.436,8,28,0.286,17,20,0.85,89,2013-01-24,BOS,NYK,2013,93.0
12178,12178,78,Home,W 86-73 ,240,34,79,0.43,31,69,0.449,3,10,0.3,15,19,0.789,86,29,71,0.408,25,56,0.446,4,15,0.267,11,12,0.917,73,2013-01-26,WAS,CHI,2013,75.0
12179,12179,79,@,L 86-92 ,240,33,78,0.423,25,51,0.49,8,27,0.296,12,19,0.632,86,38,83,0.458,35,71,0.493,3,12,0.25,13,15,0.867,92,2013-01-30,LAL,PHO,2013,93.5
12180,12180,80,@,L 86-96 ,240,33,83,0.398,25,63,0.397,8,20,0.4,12,17,0.706,86,32,76,0.421,19,41,0.463,13,35,0.371,19,26,0.731,96,2013-02-01,MIL,NYK,2013,102.5
12181,12181,81,Home,W 86-77 ,240,35,81,0.432,31,66,0.47,4,15,0.267,12,17,0.706,86,29,79,0.367,22,59,0.373,7,20,0.35,12,16,0.75,77,2013-02-01,UTA,POR,2013,80.5
12182,12182,82,@,L 86-115 ,240,28,70,0.4,25,56,0.446,3,14,0.214,27,33,0.818,86,45,77,0.584,40,62,0.645,5,15,0.333,20,29,0.69,115,2013-02-02,NOP,MIN,2013,117.5
12183,12183,83,@,L 86-96 ,240,36,88,0.409,30,66,0.455,6,22,0.273,8,17,0.471,86,38,78,0.487,33,58,0.569,5,20,0.25,15,16,0.938,96,2013-02-02,WAS,SAS,2013,98.5
12184,12184,84,@,W 86-76 ,240,33,82,0.402,27,64,0.422,6,18,0.333,14,22,0.636,86,30,87,0.345,24,67,0.358,6,20,0.3,10,14,0.714,76,2013-02-06,LAC,ORL,2013,79.0
12185,12185,85,@,L 86-100 ,240,29,82,0.354,23,63,0.365,6,19,0.316,22,29,0.759,86,39,81,0.481,34,71,0.479,5,10,0.5,17,26,0.654,100,2013-02-06,MIL,UTA,2013,102.5
12186,12186,86,Home,L 86-111 ,240,34,72,0.472,28,53,0.528,6,19,0.316,12,17,0.706,86,43,73,0.589,31,54,0.574,12,19,0.632,13,20,0.65,111,2013-02-10,BRK,SAS,2013,117.0
12187,12187,87,Home,L 86-105 ,240,29,81,0.358,24,62,0.387,5,19,0.263,23,33,0.697,86,41,83,0.494,31,62,0.5,10,21,0.476,13,14,0.929,105,2013-02-11,DET,NOH,2013,110.0
12188,12188,88,@,W 86-67 ,240,37,73,0.507,34,60,0.567,3,13,0.231,9,14,0.643,86,28,75,0.373,26,65,0.4,2,10,0.2,9,11,0.818,67,2013-02-21,MIA,CHI,2013,68.0
12189,12189,89,@,L 86-92 ,240,36,85,0.424,34,72,0.472,2,13,0.154,12,15,0.8,86,35,79,0.443,28,58,0.483,7,21,0.333,15,19,0.789,92,2013-02-24,BOS,POR,2013,95.5
12190,12190,90,@,L 86-94 ,240,32,94,0.34,27,71,0.38,5,23,0.217,17,22,0.773,86,36,75,0.48,33,60,0.55,3,15,0.2,19,28,0.679,94,2013-03-01,GSW,BOS,2013,95.5
12191,12191,91,Home,L 86-115 ,240,32,82,0.39,27,67,0.403,5,15,0.333,17,19,0.895,86,43,83,0.518,32,64,0.5,11,19,0.579,18,23,0.783,115,2013-03-08,ORL,IND,2013,120.5
12192,12192,92,@,L 86-96 ,240,34,78,0.436,27,62,0.435,7,16,0.438,11,18,0.611,86,41,82,0.5,34,61,0.557,7,21,0.333,7,11,0.636,96,2013-03-15,CLE,DAL,2013,99.5
12193,12193,93,@,L 86-87 ,240,33,72,0.458,29,58,0.5,4,14,0.286,16,17,0.941,86,31,71,0.437,26,55,0.473,5,16,0.313,20,26,0.769,87,2013-03-20,BOS,NOH,2013,89.5
12194,12194,94,Home,L 86-117 ,240,36,95,0.379,32,73,0.438,4,22,0.182,10,21,0.476,86,42,79,0.532,40,67,0.597,2,12,0.167,31,40,0.775,117,2013-03-22,PHO,MIN,2013,118.0
12195,12195,95,@,L 86-110 ,240,25,66,0.379,20,50,0.4,5,16,0.313,31,39,0.795,86,41,85,0.482,27,60,0.45,14,25,0.56,14,15,0.933,110,2013-03-25,DEN,NOH,2013,117.0
12196,12196,96,Home,L 86-99 ,240,29,67,0.433,24,51,0.471,5,16,0.313,23,34,0.676,86,37,73,0.507,31,63,0.492,6,10,0.6,19,27,0.704,99,2013-03-30,MIN,MEM,2013,102.0
12197,12197,97,Home,L 86-88 ,240,35,79,0.443,28,55,0.509,7,24,0.292,9,16,0.563,86,33,71,0.465,21,43,0.488,12,28,0.429,10,15,0.667,88,2013-03-31,SAS,MIA,2013,94.0
12198,12198,98,@,L 86-90 ,240,35,89,0.393,30,66,0.455,5,23,0.217,11,16,0.688,86,33,78,0.423,27,65,0.415,6,13,0.462,18,26,0.692,90,2013-04-02,CHI,WAS,2013,93.0
12199,12199,99,@,L 86-87 ,240,34,80,0.425,30,70,0.429,4,10,0.4,14,17,0.824,86,33,82,0.402,25,62,0.403,8,20,0.4,13,14,0.929,87,2013-04-05,ORL,CHI,2013,91.0
12200,12200,0,Home,W 86-84 ,240,34,74,0.459,29,54,0.537,5,20,0.25,13,18,0.722,86,38,86,0.442,35,72,0.486,3,14,0.214,5,7,0.714,84,2013-04-05,LAL,MEM,2013,85.5
12201,12201,1,@,L 86-96 ,240,35,87,0.402,31,66,0.47,4,21,0.19,12,17,0.706,86,39,86,0.453,33,71,0.465,6,15,0.4,12,21,0.571,96,2013-04-10,SAS,DEN,2013,99.0
12202,12202,2,Home,L 86-97 ,240,36,87,0.414,35,74,0.473,1,13,0.077,13,21,0.619,86,40,93,0.43,33,71,0.465,7,22,0.318,10,11,0.909,97,2013-04-12,WAS,PHI,2013,100.5
12203,12203,3,@,L 86-91 ,240,33,89,0.371,27,71,0.38,6,18,0.333,14,19,0.737,86,31,85,0.365,22,58,0.379,9,27,0.333,20,31,0.645,91,2013-04-14,SAS,LAL,2013,95.5
12204,12204,4,Home,W 86-70 ,240,34,84,0.405,30,71,0.423,4,13,0.308,14,20,0.7,86,25,78,0.321,22,67,0.328,3,11,0.273,17,26,0.654,70,2013-04-17,MEM,UTA,2013,71.5
12205,12205,5,@,L 86-107 ,240,34,89,0.382,30,72,0.417,4,17,0.235,14,15,0.933,86,42,89,0.472,35,72,0.486,7,17,0.412,16,22,0.727,107,2013-11-03,BRK,ORL,2014,110.5
12206,12206,6,@,L 86-107 ,240,31,82,0.378,28,69,0.406,3,13,0.231,21,27,0.778,86,41,94,0.436,33,70,0.471,8,24,0.333,17,23,0.739,107,2013-11-13,BRK,SAC,2014,111.0
12207,12207,7,@,W 86-80 ,240,32,80,0.4,24,60,0.4,8,20,0.4,14,20,0.7,86,32,79,0.405,28,64,0.438,4,15,0.267,12,17,0.706,80,2013-11-15,CHA,CLE,2014,82.0
12208,12208,8,Home,L 86-89 ,240,35,80,0.438,25,56,0.446,10,24,0.417,6,11,0.545,86,37,85,0.435,36,72,0.5,1,13,0.077,14,14,1.0,89,2013-11-15,LAL,MEM,2014,89.5
12209,12209,9,Home,L 86-97 ,240,33,87,0.379,26,64,0.406,7,23,0.304,13,17,0.765,86,40,72,0.556,36,59,0.61,4,13,0.308,13,18,0.722,97,2013-11-17,SAC,MEM,2014,99.0
12210,12210,10,Home,W 86-81 ,240,27,75,0.36,21,63,0.333,6,12,0.5,26,31,0.839,86,33,91,0.363,26,75,0.347,7,16,0.438,8,16,0.5,81,2013-11-18,CHI,CHA,2014,84.5
12211,12211,11,@,L 86-92 ,240,33,76,0.434,27,52,0.519,6,24,0.25,14,18,0.778,86,35,70,0.5,28,51,0.549,7,19,0.368,15,21,0.714,92,2013-11-19,NYK,DET,2014,95.5
12212,12212,12,Home,L 86-102 ,240,35,80,0.438,32,69,0.464,3,11,0.273,13,17,0.765,86,42,79,0.532,35,62,0.565,7,17,0.412,11,16,0.688,102,2013-11-22,MEM,SAS,2014,105.5
12213,12213,13,@,L 86-100 ,240,35,84,0.417,27,60,0.45,8,24,0.333,8,15,0.533,86,40,87,0.46,32,61,0.525,8,26,0.308,12,15,0.8,100,2013-11-24,SAC,LAL,2014,104.0
12214,12214,14,Home,L 86-96 ,240,33,74,0.446,30,65,0.462,3,9,0.333,17,20,0.85,86,35,80,0.438,26,60,0.433,9,20,0.45,17,21,0.81,96,2013-11-25,CHA,BOS,2014,100.5
12215,12215,15,Home,L 86-93 ,240,34,82,0.415,30,69,0.435,4,13,0.308,14,18,0.778,86,34,69,0.493,28,45,0.622,6,24,0.25,19,27,0.704,93,2013-11-25,MEM,HOU,2014,96.0
12216,12216,16,@,L 86-103 ,240,32,86,0.372,28,68,0.412,4,18,0.222,18,27,0.667,86,38,76,0.5,27,53,0.509,11,23,0.478,16,26,0.615,103,2013-11-29,CLE,BOS,2014,108.5
12217,12217,17,Home,L 86-95 ,240,33,80,0.413,29,69,0.42,4,11,0.364,16,18,0.889,86,40,84,0.476,37,68,0.544,3,16,0.188,12,15,0.8,95,2013-12-04,UTA,IND,2014,96.5
12218,12218,18,@,L 86-90 ,240,32,80,0.4,27,59,0.458,5,21,0.238,17,19,0.895,86,33,68,0.485,26,47,0.553,7,21,0.333,17,25,0.68,90,2013-12-13,NYK,BOS,2014,93.5
12219,12219,19,@,W 86-82 ,240,33,82,0.402,25,61,0.41,8,21,0.381,12,15,0.8,86,28,86,0.326,21,71,0.296,7,15,0.467,19,20,0.95,82,2013-12-18,UTA,ORL,2014,85.5
12220,12220,20,Home,L 86-103 ,240,29,76,0.382,23,50,0.46,6,26,0.231,22,25,0.88,86,38,83,0.458,29,55,0.527,9,28,0.321,18,19,0.947,103,2013-12-23,BRK,IND,2014,107.5
12221,12221,21,@,L 86-115 ,240,32,89,0.36,28,66,0.424,4,23,0.174,18,23,0.783,86,45,85,0.529,37,65,0.569,8,20,0.4,17,24,0.708,115,2013-12-27,PHO,GSW,2014,119.0
12222,12222,22,@,L 86-117 ,240,31,85,0.365,24,57,0.421,7,28,0.25,17,31,0.548,86,47,82,0.573,37,60,0.617,10,22,0.455,13,16,0.813,117,2013-12-29,HOU,OKC,2014,122.0
12223,12223,23,@,L 86-91 ,240,27,70,0.386,19,46,0.413,8,24,0.333,24,26,0.923,86,33,80,0.413,25,53,0.472,8,27,0.296,17,26,0.654,91,2014-01-06,ATL,BRK,2014,95.0
12224,12224,24,Home,W 86-79 ,240,32,75,0.427,31,64,0.484,1,11,0.091,21,26,0.808,86,30,81,0.37,25,62,0.403,5,19,0.263,14,18,0.778,79,2014-01-07,IND,TOR,2014,81.5
12225,12225,25,@,L 86-104 ,240,33,93,0.355,28,76,0.368,5,17,0.294,15,18,0.833,86,42,74,0.568,33,61,0.541,9,13,0.692,11,14,0.786,104,2014-01-12,MIN,SAS,2014,108.5
12226,12226,26,Home,L 86-101 ,240,31,84,0.369,29,64,0.453,2,20,0.1,22,37,0.595,86,38,80,0.475,30,57,0.526,8,23,0.348,17,20,0.85,101,2014-01-17,PHI,MIA,2014,105.0
12227,12227,27,@,L 86-93 ,240,33,84,0.393,28,57,0.491,5,27,0.185,15,18,0.833,86,38,74,0.514,33,54,0.611,5,20,0.25,12,16,0.75,93,2014-01-21,BOS,MIA,2014,95.5
12228,12228,28,Home,L 86-95 ,240,32,85,0.376,24,61,0.393,8,24,0.333,14,16,0.875,86,34,73,0.466,29,56,0.518,5,17,0.294,22,26,0.846,95,2014-01-27,CHI,MIN,2014,97.5
12229,12229,29,Home,L 86-114 ,240,34,89,0.382,30,67,0.448,4,22,0.182,14,22,0.636,86,43,79,0.544,29,51,0.569,14,28,0.5,14,19,0.737,114,2014-01-27,MIL,LAC,2014,121.0
12230,12230,30,Home,L 86-96 ,240,33,71,0.465,28,58,0.483,5,13,0.385,15,16,0.938,86,37,83,0.446,33,71,0.465,4,12,0.333,18,23,0.783,96,2014-01-29,SAS,CHI,2014,98.0
12231,12231,31,@,L 86-117 ,240,31,87,0.356,23,64,0.359,8,23,0.348,16,22,0.727,86,43,76,0.566,31,50,0.62,12,26,0.462,19,28,0.679,117,2014-01-30,CLE,NYK,2014,123.0
12232,12232,32,Home,W 86-77 ,240,34,76,0.447,30,58,0.517,4,18,0.222,14,23,0.609,86,32,81,0.395,30,65,0.462,2,16,0.125,11,15,0.733,77,2014-02-03,OKC,MEM,2014,78.0
12233,12233,33,Home,L 86-92 ,240,36,82,0.439,30,63,0.476,6,19,0.316,8,11,0.727,86,34,80,0.425,27,58,0.466,7,22,0.318,17,17,1.0,92,2014-02-09,LAL,CHI,2014,95.5
12234,12234,34,Home,L 86-102 ,240,31,72,0.431,25,56,0.446,6,16,0.375,18,25,0.72,86,42,88,0.477,35,68,0.515,7,20,0.35,11,14,0.786,102,2014-02-10,MIL,BOS,2014,105.5
12235,12235,35,@,W 86-81 ,240,36,77,0.468,34,65,0.523,2,12,0.167,12,18,0.667,86,34,83,0.41,30,70,0.429,4,13,0.308,9,10,0.9,81,2014-02-12,MEM,ORL,2014,83.0
12236,12236,36,@,L 86-93 ,240,32,78,0.41,30,57,0.526,2,21,0.095,20,24,0.833,86,37,85,0.435,31,65,0.477,6,20,0.3,13,17,0.765,93,2014-02-22,BRK,GSW,2014,96.0
12237,12237,37,@,L 86-109 ,240,31,80,0.388,25,61,0.41,6,19,0.316,18,29,0.621,86,42,74,0.568,33,56,0.589,9,18,0.5,16,24,0.667,109,2014-02-26,PHO,UTA,2014,113.5
12238,12238,38,@,L 86-112 ,240,34,74,0.459,27,58,0.466,7,16,0.438,11,15,0.733,86,40,76,0.526,27,48,0.563,13,28,0.464,19,25,0.76,112,2014-03-07,IND,HOU,2014,118.5
12239,12239,39,@,L 86-99 ,240,33,74,0.446,31,66,0.47,2,8,0.25,18,27,0.667,86,36,71,0.507,27,54,0.5,9,17,0.529,18,22,0.818,99,2014-03-14,MEM,TOR,2014,103.5
12240,12240,40,Home,L 86-109 ,240,29,79,0.367,20,50,0.4,9,29,0.31,19,27,0.704,86,40,75,0.533,27,51,0.529,13,24,0.542,16,20,0.8,109,2014-03-16,OKC,DAL,2014,115.5
12241,12241,41,@,L 86-124 ,240,34,83,0.41,30,65,0.462,4,18,0.222,14,18,0.778,86,46,79,0.582,33,54,0.611,13,25,0.52,19,26,0.731,124,2014-03-17,UTA,HOU,2014,130.5
12242,12242,42,@,L 86-96 ,240,37,84,0.44,30,66,0.455,7,18,0.389,5,10,0.5,86,36,81,0.444,34,70,0.486,2,11,0.182,22,25,0.88,96,2014-03-19,UTA,MEM,2014,97.0
12243,12243,43,@,L 86-92 ,240,31,73,0.425,26,50,0.52,5,23,0.217,19,27,0.704,86,32,82,0.39,28,65,0.431,4,17,0.235,24,29,0.828,92,2014-03-19,IND,NYK,2014,94.0
12244,12244,44,@,L 86-91 ,240,36,79,0.456,33,65,0.508,3,14,0.214,11,17,0.647,86,35,75,0.467,28,55,0.509,7,20,0.35,14,16,0.875,91,2014-03-21,MEM,MIA,2014,94.5
12245,12245,45,@,L 86-96 ,240,33,76,0.434,28,56,0.5,5,20,0.25,15,20,0.75,86,34,80,0.425,26,56,0.464,8,24,0.333,20,28,0.714,96,2014-03-23,ATL,TOR,2014,100.0
12246,12246,46,@,L 86-98 ,240,31,65,0.477,23,51,0.451,8,14,0.571,16,19,0.842,86,35,75,0.467,29,59,0.492,6,16,0.375,22,28,0.786,98,2014-04-11,IND,MIA,2014,101.0
12247,12247,47,Home,L 86-96 ,240,32,77,0.416,28,58,0.483,4,19,0.211,18,24,0.75,86,35,82,0.427,33,63,0.524,2,19,0.105,24,33,0.727,96,2014-04-11,ORL,WAS,2014,97.0
12248,12248,48,@,L 86-91 (OT),265,34,86,0.395,26,64,0.406,8,22,0.364,10,15,0.667,86,34,85,0.4,29,64,0.453,5,21,0.238,18,26,0.692,91,2014-04-16,CHI,CHA,2014,93.5
12249,12249,49,Home,L 86-101 ,240,32,79,0.405,27,64,0.422,5,15,0.333,17,24,0.708,86,41,88,0.466,30,65,0.462,11,23,0.478,8,11,0.727,101,2014-04-16,ORL,IND,2014,106.5
12250,12250,50,Home,L 86-95 ,240,33,89,0.371,30,74,0.405,3,15,0.2,17,20,0.85,86,34,73,0.466,29,57,0.509,5,16,0.313,22,30,0.733,95,2014-11-05,MIL,CHI,2015,97.5
12251,12251,51,@,L 86-97 ,240,32,74,0.432,26,53,0.491,6,21,0.286,16,21,0.762,86,39,90,0.433,33,75,0.44,6,15,0.4,13,15,0.867,97,2014-11-10,UTA,IND,2015,100.0
12252,12252,52,Home,L 86-88 ,240,33,87,0.379,26,62,0.419,7,25,0.28,13,19,0.684,86,37,75,0.493,33,60,0.55,4,15,0.267,10,13,0.769,88,2014-11-19,DET,PHO,2015,90.0
12253,12253,53,@,L 86-88 ,240,37,86,0.43,32,72,0.444,5,14,0.357,7,12,0.583,86,35,78,0.449,33,63,0.524,2,15,0.133,16,24,0.667,88,2014-11-19,CHA,IND,2015,89.0
12254,12254,54,Home,L 86-91 ,240,32,90,0.356,29,73,0.397,3,17,0.176,19,27,0.704,86,33,93,0.355,26,68,0.382,7,25,0.28,18,24,0.75,91,2014-11-23,OKC,GSW,2015,94.5
12255,12255,55,@,L 86-91 ,240,35,76,0.461,29,54,0.537,6,22,0.273,10,15,0.667,86,32,76,0.421,18,40,0.45,14,36,0.389,13,19,0.684,91,2014-11-24,NYK,HOU,2015,98.0
12256,12256,56,@,L 86-98 ,240,36,78,0.462,29,58,0.5,7,20,0.35,7,17,0.412,86,39,90,0.433,29,68,0.426,10,22,0.455,10,13,0.769,98,2014-11-25,DET,MIL,2015,103.0
12257,12257,57,Home,L 86-103 ,240,31,81,0.383,28,67,0.418,3,14,0.214,21,34,0.618,86,40,85,0.471,35,69,0.507,5,16,0.313,18,19,0.947,103,2014-11-26,MIN,MIL,2015,105.5
12258,12258,58,@,W 86-79 ,240,30,72,0.417,23,49,0.469,7,23,0.304,19,31,0.613,86,31,88,0.352,28,64,0.438,3,24,0.125,14,20,0.7,79,2014-11-30,MIA,NYK,2015,80.5
12259,12259,59,@,L 86-107 ,240,33,72,0.458,31,50,0.62,2,22,0.091,18,30,0.6,86,39,72,0.542,29,53,0.547,10,19,0.526,19,24,0.792,107,2014-12-01,MIA,WAS,2015,112.0
12260,12260,60,@,L 86-114 ,240,33,79,0.418,26,59,0.441,7,20,0.35,13,25,0.52,86,42,78,0.538,30,47,0.638,12,31,0.387,18,25,0.72,114,2014-12-03,ORL,LAC,2015,120.0
12261,12261,61,Home,L 86-102 ,240,32,88,0.364,30,77,0.39,2,11,0.182,20,29,0.69,86,42,91,0.462,37,69,0.536,5,22,0.227,13,14,0.929,102,2014-12-08,MIN,GSW,2015,104.5
12262,12262,62,Home,L 86-98 ,240,34,97,0.351,29,75,0.387,5,22,0.227,13,16,0.813,86,41,84,0.488,32,63,0.508,9,21,0.429,7,8,0.875,98,2014-12-09,DET,POR,2015,102.5
12263,12263,63,@,L 86-93 ,240,35,93,0.376,29,64,0.453,6,29,0.207,10,14,0.714,86,36,83,0.434,29,62,0.468,7,21,0.333,14,17,0.824,93,2014-12-15,CHI,ATL,2015,96.5
12264,12264,64,@,L 86-104 ,240,33,85,0.388,25,54,0.463,8,31,0.258,12,15,0.8,86,42,87,0.483,33,65,0.508,9,22,0.409,11,16,0.688,104,2014-12-20,UTA,CHO,2015,108.5
12265,12265,65,@,L 86-100 ,240,34,80,0.425,28,52,0.538,6,28,0.214,12,22,0.545,86,34,87,0.391,25,55,0.455,9,32,0.281,23,31,0.742,100,2014-12-25,GSW,LAC,2015,104.5
12266,12266,66,@,L 86-126 ,240,33,86,0.384,27,66,0.409,6,20,0.3,14,23,0.609,86,46,82,0.561,34,54,0.63,12,28,0.429,22,27,0.815,126,2014-12-30,PHI,GSW,2015,132.0
12267,12267,67,Home,L 86-109 ,240,38,85,0.447,34,65,0.523,4,20,0.2,6,10,0.6,86,40,86,0.465,26,53,0.491,14,33,0.424,15,29,0.517,109,2014-12-30,ORL,DET,2015,116.0
12268,12268,68,@,L 86-96 ,240,35,79,0.443,30,62,0.484,5,17,0.294,11,11,1.0,86,32,72,0.444,19,47,0.404,13,25,0.52,19,23,0.826,96,2015-01-07,MEM,ATL,2015,102.5
12269,12269,69,@,L 86-102 ,240,32,83,0.386,22,57,0.386,10,26,0.385,12,19,0.632,86,41,86,0.477,33,71,0.465,8,15,0.533,12,19,0.632,102,2015-01-09,CHI,WAS,2015,106.0
12270,12270,70,Home,L 86-94 ,240,32,68,0.471,24,46,0.522,8,22,0.364,14,19,0.737,86,41,92,0.446,35,66,0.53,6,26,0.231,6,10,0.6,94,2015-01-20,MIA,OKC,2015,97.0
12271,12271,71,@,L 86-92 ,240,27,85,0.318,22,57,0.386,5,28,0.179,27,32,0.844,86,34,74,0.459,33,67,0.493,1,7,0.143,23,29,0.793,92,2015-01-21,TOR,MEM,2015,92.5
12272,12272,72,Home,L 86-91 ,240,31,81,0.383,22,52,0.423,9,29,0.31,15,18,0.833,86,33,80,0.413,27,56,0.482,6,24,0.25,19,24,0.792,91,2015-01-23,PHI,TOR,2015,94.0
12273,12273,73,@,L 86-101 ,240,31,86,0.36,25,61,0.41,6,25,0.24,18,25,0.72,86,41,81,0.506,30,64,0.469,11,17,0.647,8,10,0.8,101,2015-01-24,DET,MIL,2015,106.5
12274,12274,74,@,L 86-95 ,240,34,83,0.41,28,65,0.431,6,18,0.333,12,14,0.857,86,35,83,0.422,25,54,0.463,10,29,0.345,15,18,0.833,95,2015-01-28,CHA,SAS,2015,100.0
12275,12275,75,Home,L 86-104 ,240,33,92,0.359,28,68,0.412,5,24,0.208,15,20,0.75,86,44,93,0.473,44,82,0.537,0,11,0.0,16,25,0.64,104,2015-01-31,DEN,CHO,2015,104.0
12276,12276,76,@,L 86-104 ,240,35,75,0.467,33,63,0.524,2,12,0.167,14,27,0.519,86,42,80,0.525,35,60,0.583,7,20,0.35,13,15,0.867,104,2015-02-10,SAC,CHI,2015,107.5
12277,12277,77,@,L 86-95 ,240,35,81,0.432,32,69,0.464,3,12,0.25,13,17,0.765,86,36,81,0.444,30,62,0.484,6,19,0.316,17,25,0.68,95,2015-02-10,BRK,MEM,2015,98.0
12278,12278,78,@,L 86-102 ,240,34,93,0.366,27,77,0.351,7,16,0.438,11,11,1.0,86,35,86,0.407,25,56,0.446,10,30,0.333,22,23,0.957,102,2015-02-11,LAL,POR,2015,107.0
12279,12279,79,Home,L 86-97 ,240,32,72,0.444,28,56,0.5,4,16,0.25,18,18,1.0,86,35,87,0.402,26,57,0.456,9,30,0.3,18,21,0.857,97,2015-02-22,MIL,ATL,2015,101.5
12280,12280,80,Home,L 86-98 ,240,34,77,0.442,31,60,0.517,3,17,0.176,15,23,0.652,86,39,84,0.464,35,70,0.5,4,14,0.286,16,21,0.762,98,2015-02-25,CHI,CHO,2015,100.0
12281,12281,81,@,L 86-93 ,240,33,92,0.359,24,63,0.381,9,29,0.31,11,14,0.786,86,34,80,0.425,28,63,0.444,6,17,0.353,19,29,0.655,93,2015-02-27,CLE,IND,2015,96.0
12282,12282,82,Home,L 86-96 ,240,27,87,0.31,17,61,0.279,10,26,0.385,22,30,0.733,86,38,87,0.437,31,60,0.517,7,27,0.259,13,24,0.542,96,2015-03-01,CHI,LAC,2015,99.5
12283,12283,83,Home,L 86-124 ,240,30,82,0.366,26,60,0.433,4,22,0.182,22,30,0.733,86,41,83,0.494,31,65,0.477,10,18,0.556,32,37,0.865,124,2015-03-03,NYK,SAC,2015,129.0
12284,12284,84,Home,L 86-92 ,240,30,78,0.385,27,63,0.429,3,15,0.2,23,30,0.767,86,30,79,0.38,23,61,0.377,7,18,0.389,25,30,0.833,92,2015-03-07,NYK,IND,2015,95.5
12285,12285,85,@,L 86-118 ,240,34,92,0.37,30,75,0.4,4,17,0.235,14,20,0.7,86,45,85,0.529,28,51,0.549,17,34,0.5,11,12,0.917,118,2015-03-10,ORL,IND,2015,126.5
12286,12286,86,Home,L 86-91 ,240,34,85,0.4,27,67,0.403,7,18,0.389,11,15,0.733,86,34,76,0.447,29,53,0.547,5,23,0.217,18,27,0.667,91,2015-03-15,LAL,ATL,2015,93.5
12287,12287,87,@,L 86-103 ,240,32,81,0.395,26,62,0.419,6,19,0.316,16,21,0.762,86,34,82,0.415,24,58,0.414,10,24,0.417,25,28,0.893,103,2015-03-18,IND,CHI,2015,108.0
12288,12288,88,@,L 86-97 ,240,33,76,0.434,27,54,0.5,6,22,0.273,14,15,0.933,86,37,89,0.416,26,71,0.366,11,18,0.611,12,16,0.75,97,2015-03-21,POR,MEM,2015,102.5
12289,12289,89,@,L 86-109 ,240,35,87,0.402,32,70,0.457,3,17,0.176,13,18,0.722,86,40,79,0.506,32,62,0.516,8,17,0.471,21,23,0.913,109,2015-03-22,WAS,SAC,2015,113.0
12290,12290,90,@,L 86-98 ,240,28,81,0.346,20,61,0.328,8,20,0.4,22,28,0.786,86,37,82,0.451,34,66,0.515,3,16,0.188,21,29,0.724,98,2015-03-23,CHA,CHI,2015,99.5
12291,12291,91,Home,L 86-93 ,240,28,69,0.406,23,50,0.46,5,19,0.263,25,37,0.676,86,34,77,0.442,25,53,0.472,9,24,0.375,16,23,0.696,93,2015-03-25,BOS,MIA,2015,97.5
12292,12292,92,@,L 86-99 ,240,32,82,0.39,21,47,0.447,11,35,0.314,11,15,0.733,86,37,72,0.514,31,54,0.574,6,18,0.333,19,24,0.792,99,2015-03-27,MIA,ATL,2015,102.0
12293,12293,93,@,L 86-87 ,240,34,84,0.405,24,54,0.444,10,30,0.333,8,15,0.533,86,33,85,0.388,24,62,0.387,9,23,0.391,12,18,0.667,87,2015-03-29,PHI,CLE,2015,91.5
12294,12294,94,@,L 86-109 ,240,38,87,0.437,35,71,0.493,3,16,0.188,7,10,0.7,86,44,86,0.512,32,59,0.542,12,27,0.444,9,10,0.9,109,2015-03-30,PHO,POR,2015,115.0
12295,12295,95,Home,L 86-102 ,240,29,84,0.345,22,67,0.328,7,17,0.412,21,26,0.808,86,38,77,0.494,34,55,0.618,4,22,0.182,22,27,0.815,102,2015-04-08,NYK,IND,2015,104.0
12296,12296,96,@,L 86-94 ,240,34,77,0.442,32,68,0.471,2,9,0.222,16,24,0.667,86,35,88,0.398,29,61,0.475,6,27,0.222,18,22,0.818,94,2015-04-11,MEM,LAC,2015,97.0
12297,12297,97,Home,L 86-113 ,240,32,87,0.368,29,75,0.387,3,12,0.25,19,22,0.864,86,44,88,0.5,32,58,0.552,12,30,0.4,13,17,0.765,113,2015-04-13,BRK,CHI,2015,119.0
12298,12298,98,@,L 86-96 ,240,33,84,0.393,25,60,0.417,8,24,0.333,12,15,0.8,86,33,83,0.398,26,56,0.464,7,27,0.259,23,32,0.719,96,2015-11-04,NYK,CLE,2016,99.5
12299,12299,99,@,L 86-94 ,240,34,82,0.415,31,73,0.425,3,9,0.333,15,19,0.789,86,37,82,0.451,29,62,0.468,8,20,0.4,12,16,0.75,94,2015-11-07,BRK,MIL,2016,98.0
12300,12300,0,Home,L 86-92 ,240,34,76,0.447,29,54,0.537,5,22,0.227,13,20,0.65,86,30,76,0.395,23,52,0.442,7,24,0.292,25,30,0.833,92,2015-11-16,PHI,DAL,2016,95.5
12301,12301,1,@,L 86-115 ,240,31,72,0.431,21,51,0.412,10,21,0.476,14,24,0.583,86,37,70,0.529,25,48,0.521,12,22,0.545,29,41,0.707,115,2015-11-17,MIL,WAS,2016,121.0
12302,12302,2,Home,L 86-96 ,240,33,77,0.429,30,64,0.469,3,13,0.231,17,25,0.68,86,40,87,0.46,34,59,0.576,6,28,0.214,10,13,0.769,96,2015-11-20,MIN,DET,2016,99.0
12303,12303,3,@,L 86-123 ,240,34,79,0.43,29,62,0.468,5,17,0.294,13,19,0.684,86,47,91,0.516,32,61,0.525,15,30,0.5,14,23,0.609,123,2015-11-21,MIL,IND,2016,130.5
12304,12304,4,Home,L 86-96 ,240,33,90,0.367,25,63,0.397,8,27,0.296,12,16,0.75,86,36,79,0.456,30,54,0.556,6,25,0.24,18,24,0.75,96,2015-12-02,ATL,TOR,2016,99.0
12305,12305,5,@,L 86-108 ,240,30,86,0.349,25,62,0.403,5,24,0.208,21,30,0.7,86,40,85,0.471,29,60,0.483,11,25,0.44,17,21,0.81,108,2015-12-20,PHI,CLE,2016,113.5
12306,12306,6,@,L 86-101 ,240,38,86,0.442,33,68,0.485,5,18,0.278,5,6,0.833,86,39,81,0.481,32,71,0.451,7,10,0.7,16,17,0.941,101,2015-12-26,DEN,SAS,2016,104.5
12307,12307,7,Home,L 86-95 ,240,32,79,0.405,26,48,0.542,6,31,0.194,16,17,0.941,86,32,76,0.421,26,54,0.481,6,22,0.273,25,29,0.862,95,2016-01-06,ORL,IND,2016,98.0
12308,12308,8,Home,L 86-91 ,240,31,83,0.373,22,54,0.407,9,29,0.31,15,20,0.75,86,36,81,0.444,31,60,0.517,5,21,0.238,14,19,0.737,91,2016-01-08,NOP,IND,2016,93.5
12309,12309,9,@,W 86-74 ,240,31,69,0.449,26,53,0.491,5,16,0.313,19,25,0.76,86,29,89,0.326,26,68,0.382,3,21,0.143,13,15,0.867,74,2016-01-10,UTA,LAL,2016,75.5
12310,12310,10,@,L 86-114 ,240,34,78,0.436,28,58,0.483,6,20,0.3,12,19,0.632,86,44,79,0.557,36,50,0.72,8,29,0.276,18,24,0.75,114,2016-01-16,BRK,ATL,2016,118.0
12311,12311,11,Home,L 86-108 ,240,33,75,0.44,27,59,0.458,6,16,0.375,14,18,0.778,86,43,75,0.573,34,59,0.576,9,16,0.563,13,15,0.867,108,2016-01-22,BRK,UTA,2016,112.5
12312,12312,12,Home,L 86-124 ,240,35,84,0.417,29,57,0.509,6,27,0.222,10,14,0.714,86,48,92,0.522,38,72,0.528,10,20,0.5,18,25,0.72,124,2016-02-03,PHI,ATL,2016,129.0
12313,12313,13,@,L 86-105 ,240,35,83,0.422,31,66,0.47,4,17,0.235,12,15,0.8,86,39,78,0.5,27,53,0.509,12,25,0.48,15,20,0.75,105,2016-02-18,SAS,LAC,2016,111.0
12314,12314,14,@,L 86-98 ,240,35,82,0.427,28,59,0.475,7,23,0.304,9,17,0.529,86,36,78,0.462,29,56,0.518,7,22,0.318,19,26,0.731,98,2016-02-19,DET,WAS,2016,101.5
12315,12315,15,Home,L 86-94 ,240,35,89,0.393,27,65,0.415,8,24,0.333,8,8,1.0,86,36,81,0.444,28,60,0.467,8,21,0.381,14,15,0.933,94,2016-03-03,NOP,SAS,2016,98.0
12316,12316,16,@,L 86-96 ,240,34,92,0.37,31,79,0.392,3,13,0.231,15,17,0.882,86,37,75,0.493,32,56,0.571,5,19,0.263,17,25,0.68,96,2016-03-17,MEM,MIL,2016,98.5
12317,12317,17,Home,L 86-101 ,240,33,78,0.423,25,51,0.49,8,27,0.296,12,19,0.632,86,39,81,0.481,29,54,0.537,10,27,0.37,13,17,0.765,101,2016-04-03,PHO,UTA,2016,106.0
12318,12318,18,Home,L 86-88 ,240,32,68,0.471,27,51,0.529,5,17,0.294,17,21,0.81,86,32,72,0.444,25,55,0.455,7,17,0.412,17,19,0.895,88,2016-04-05,UTA,SAS,2016,91.5
12319,12319,19,@,L 86-88 ,240,34,78,0.436,28,58,0.483,6,20,0.3,12,18,0.667,86,33,80,0.413,23,47,0.489,10,33,0.303,12,14,0.857,88,2016-04-06,HOU,DAL,2016,93.0
12320,12320,20,Home,L 86-92 ,240,34,90,0.378,31,73,0.425,3,17,0.176,15,19,0.789,86,34,77,0.442,24,50,0.48,10,27,0.37,14,18,0.778,92,2016-04-10,SAS,GSW,2016,97.0
12321,12321,21,Home,L 86-100 ,240,30,80,0.375,19,54,0.352,11,26,0.423,15,24,0.625,86,37,83,0.446,31,63,0.492,6,20,0.3,20,22,0.909,100,2016-11-04,UTA,SAS,2017,103.0
12322,12322,22,@,L 86-103 ,240,31,94,0.33,24,69,0.348,7,25,0.28,17,20,0.85,86,40,84,0.476,33,64,0.516,7,20,0.35,16,22,0.727,103,2016-11-05,DEN,DET,2017,106.5
12323,12323,23,@,L 86-88 ,240,34,86,0.395,28,69,0.406,6,17,0.353,12,17,0.706,86,31,78,0.397,22,50,0.44,9,28,0.321,17,27,0.63,88,2016-11-05,WAS,ORL,2017,92.5
12324,12324,24,Home,W 86-75 (OT),265,33,88,0.375,24,50,0.48,9,38,0.237,11,12,0.917,86,30,82,0.366,24,53,0.453,6,29,0.207,9,12,0.75,75,2016-11-06,DAL,MIL,2017,78.0
12325,12325,25,@,L 86-96 ,240,32,76,0.421,27,51,0.529,5,25,0.2,17,21,0.81,86,36,81,0.444,27,61,0.443,9,20,0.45,15,19,0.789,96,2016-11-11,DET,SAS,2017,100.5
12326,12326,26,@,L 86-110 ,240,31,83,0.373,22,51,0.431,9,32,0.281,15,19,0.789,86,43,84,0.512,37,59,0.627,6,25,0.24,18,20,0.9,110,2016-11-17,PHI,MIN,2017,113.0
12327,12327,27,@,L 86-88 ,240,25,82,0.305,18,54,0.333,7,28,0.25,29,40,0.725,86,31,87,0.356,25,67,0.373,6,20,0.3,20,30,0.667,88,2016-12-08,POR,MEM,2017,91.0
12328,12328,28,@,L 86-103 ,240,35,86,0.407,31,64,0.484,4,22,0.182,12,15,0.8,86,37,81,0.457,25,50,0.5,12,31,0.387,17,23,0.739,103,2016-12-13,MEM,CLE,2017,109.0
12329,12329,29,Home,L 86-98 ,240,26,72,0.361,20,49,0.408,6,23,0.261,28,37,0.757,86,35,82,0.427,23,52,0.442,12,30,0.4,16,19,0.842,98,2016-12-21,DET,MEM,2017,104.0
12330,12330,30,@,L 86-91 ,240,36,87,0.414,29,70,0.414,7,17,0.412,7,10,0.7,86,35,73,0.479,27,53,0.509,8,20,0.4,13,20,0.65,91,2016-12-31,PHO,UTA,2017,95.0
12331,12331,31,@,L 86-98 ,240,31,84,0.369,24,57,0.421,7,27,0.259,17,21,0.81,86,36,86,0.419,27,56,0.482,9,30,0.3,17,25,0.68,98,2017-01-08,MIA,LAC,2017,102.5
12332,12332,32,@,L 86-102 ,240,28,82,0.341,19,52,0.365,9,30,0.3,21,28,0.75,86,40,93,0.43,30,63,0.476,10,30,0.333,12,16,0.75,102,2017-01-11,CLE,POR,2017,107.0
12333,12333,33,@,L 86-96 ,240,33,85,0.388,30,65,0.462,3,20,0.15,17,21,0.81,86,39,86,0.453,34,68,0.5,5,18,0.278,13,14,0.929,96,2017-01-13,OKC,MIN,2017,98.5
12334,12334,34,Home,L 86-112 ,240,32,81,0.395,27,56,0.482,5,25,0.2,17,18,0.944,86,45,95,0.474,36,73,0.493,9,22,0.409,13,16,0.813,112,2017-01-23,BRK,SAS,2017,116.5
12335,12335,35,Home,L 86-112 ,240,30,83,0.361,21,52,0.404,9,31,0.29,17,25,0.68,86,43,89,0.483,30,58,0.517,13,31,0.419,13,19,0.684,112,2017-01-27,ATL,WAS,2017,118.5
12336,12336,36,@,L 86-102 ,240,31,80,0.388,24,57,0.421,7,23,0.304,17,24,0.708,86,37,84,0.44,27,59,0.458,10,25,0.4,18,23,0.783,102,2017-01-27,MIL,TOR,2017,107.0
12337,12337,37,@,L 86-102 ,240,30,88,0.341,21,63,0.333,9,25,0.36,17,23,0.739,86,38,89,0.427,32,68,0.471,6,21,0.286,20,27,0.741,102,2017-02-02,PHI,SAS,2017,105.0
12338,12338,38,@,L 86-113 ,240,27,78,0.346,20,51,0.392,7,27,0.259,25,28,0.893,86,41,78,0.526,31,50,0.62,10,28,0.357,21,27,0.778,113,2017-02-04,ORL,ATL,2017,118.0
12339,12339,39,@,L 86-109 ,240,33,89,0.371,26,65,0.4,7,24,0.292,13,17,0.765,86,41,84,0.488,28,48,0.583,13,36,0.361,14,21,0.667,109,2017-02-15,SAC,GSW,2017,115.5
12340,12340,40,@,L 86-105 ,240,32,85,0.376,24,60,0.4,8,25,0.32,14,26,0.538,86,37,81,0.457,29,54,0.537,8,27,0.296,23,24,0.958,105,2017-02-25,ATL,ORL,2017,109.0
12341,12341,41,@,L 86-109 ,240,40,103,0.388,37,80,0.463,3,23,0.13,3,17,0.176,86,39,78,0.5,30,53,0.566,9,25,0.36,22,23,0.957,109,2017-03-01,DET,NOP,2017,113.5
12342,12342,42,Home,L 86-99 ,240,37,84,0.44,31,54,0.574,6,30,0.2,6,9,0.667,86,37,84,0.44,27,55,0.491,10,29,0.345,15,19,0.789,99,2017-03-08,GSW,BOS,2017,104.0
12343,12343,43,@,W 85-84 ,240,35,79,0.443,33,63,0.524,2,16,0.125,13,21,0.619,85,32,81,0.395,27,56,0.482,5,25,0.2,15,19,0.789,84,2011-12-26,NOP,PHO,2012,86.5
12344,12344,44,Home,L 85-90 ,240,36,79,0.456,30,64,0.469,6,15,0.4,7,13,0.538,85,32,81,0.395,25,65,0.385,7,16,0.438,19,22,0.864,90,2011-12-28,TOR,IND,2012,93.5
12345,12345,45,@,L 85-105 ,240,35,93,0.376,33,76,0.434,2,17,0.118,13,20,0.65,85,43,85,0.506,34,59,0.576,9,26,0.346,10,13,0.769,105,2011-12-29,SAS,HOU,2012,109.5
12346,12346,46,@,L 85-96 ,240,34,79,0.43,31,63,0.492,3,16,0.188,14,15,0.933,85,35,67,0.522,28,51,0.549,7,16,0.438,19,19,1.0,96,2011-12-30,DET,BOS,2012,99.5
12347,12347,47,Home,L 85-90 ,240,28,78,0.359,18,43,0.419,10,35,0.286,19,25,0.76,85,30,68,0.441,23,51,0.451,7,17,0.412,23,29,0.793,90,2012-01-02,NYK,TOR,2012,93.5
12348,12348,48,Home,W 85-73 ,240,32,66,0.485,29,53,0.547,3,13,0.231,18,28,0.643,85,29,95,0.305,27,74,0.365,2,21,0.095,13,16,0.813,73,2012-01-03,UTA,MIL,2012,74.0
12349,12349,49,@,L 85-103 ,240,34,93,0.366,32,81,0.395,2,12,0.167,15,18,0.833,85,39,85,0.459,31,66,0.47,8,19,0.421,17,25,0.68,103,2012-01-04,WAS,ORL,2012,107.0
12350,12350,50,Home,L 85-97 ,240,33,73,0.452,27,56,0.482,6,17,0.353,13,19,0.684,85,31,80,0.388,16,49,0.327,15,31,0.484,20,27,0.741,97,2012-01-06,TOR,NJN,2012,104.5
12351,12351,51,@,L 85-94 ,240,33,80,0.413,29,63,0.46,4,17,0.235,15,21,0.714,85,36,71,0.507,34,63,0.54,2,8,0.25,20,30,0.667,94,2012-01-06,MEM,UTA,2012,95.0
12352,12352,52,@,L 85-112 ,240,34,86,0.395,30,67,0.448,4,19,0.211,13,21,0.619,85,47,83,0.566,42,70,0.6,5,13,0.385,13,19,0.684,112,2012-01-10,SAC,PHI,2012,114.5
12353,12353,53,Home,L 85-90 ,240,29,64,0.453,25,53,0.472,4,11,0.364,23,32,0.719,85,35,79,0.443,29,63,0.46,6,16,0.375,14,25,0.56,90,2012-01-11,BOS,DAL,2012,93.0
12354,12354,54,Home,L 85-95 ,240,36,80,0.45,35,64,0.547,1,16,0.063,12,17,0.706,85,35,73,0.479,28,53,0.528,7,20,0.35,18,26,0.692,95,2012-01-11,NOP,OKC,2012,98.5
12355,12355,55,Home,W 85-79 ,240,32,77,0.416,26,55,0.473,6,22,0.273,15,19,0.789,85,32,81,0.395,29,66,0.439,3,15,0.2,12,18,0.667,79,2012-01-11,NYK,PHI,2012,80.5
12356,12356,56,@,L 85-93 ,240,35,79,0.443,30,68,0.441,5,11,0.455,10,21,0.476,85,30,75,0.4,22,52,0.423,8,23,0.348,25,34,0.735,93,2012-01-18,DET,MIN,2012,97.0
12357,12357,57,@,W 85-83 (OT),265,36,84,0.429,34,67,0.507,2,17,0.118,11,18,0.611,85,29,87,0.333,25,66,0.379,4,21,0.19,21,27,0.778,83,2012-01-18,SAS,ORL,2012,85.0
12358,12358,58,@,L 85-92 ,240,34,68,0.5,28,52,0.538,6,16,0.375,11,17,0.647,85,32,70,0.457,27,52,0.519,5,18,0.278,23,26,0.885,92,2012-01-24,CLE,MIA,2012,94.5
12359,12359,59,Home,L 85-106 ,240,31,64,0.484,21,41,0.512,10,23,0.435,13,29,0.448,85,45,88,0.511,37,71,0.521,8,17,0.471,8,11,0.727,106,2012-01-29,ORL,IND,2012,110.0
12360,12360,60,@,W 85-81 ,240,29,72,0.403,20,47,0.426,9,25,0.36,18,23,0.783,85,29,85,0.341,25,63,0.397,4,22,0.182,19,21,0.905,81,2012-02-04,ORL,IND,2012,83.0
12361,12361,61,Home,W 85-80 ,240,35,94,0.372,31,83,0.373,4,11,0.364,11,15,0.733,85,31,79,0.392,27,60,0.45,4,19,0.211,14,19,0.737,80,2012-02-08,MEM,MIN,2012,82.0
12362,12362,62,@,L 85-92 ,240,30,80,0.375,24,56,0.429,6,24,0.25,19,23,0.826,85,33,77,0.429,28,56,0.5,5,21,0.238,21,34,0.618,92,2012-02-10,LAL,NYK,2012,94.5
12363,12363,63,@,L 85-111 ,240,32,90,0.356,29,77,0.377,3,13,0.231,18,24,0.75,85,42,77,0.545,37,63,0.587,5,14,0.357,22,34,0.647,111,2012-02-14,UTA,OKC,2012,113.5
12364,12364,64,@,L 85-100 ,240,33,87,0.379,29,69,0.42,4,18,0.222,15,20,0.75,85,39,77,0.506,32,53,0.604,7,24,0.292,15,17,0.882,100,2012-02-15,SAC,NYK,2012,103.5
12365,12365,65,Home,L 85-89 ,240,31,75,0.413,27,51,0.529,4,24,0.167,19,29,0.655,85,32,75,0.427,25,63,0.397,7,12,0.583,18,23,0.783,89,2012-02-17,NYK,NOH,2012,92.5
12366,12366,66,@,L 85-94 ,240,33,90,0.367,27,69,0.391,6,21,0.286,13,17,0.765,85,33,76,0.434,24,47,0.511,9,29,0.31,19,26,0.731,94,2012-02-17,MIL,ORL,2012,98.5
12367,12367,67,Home,L 85-97 ,240,33,84,0.393,30,71,0.423,3,13,0.231,16,27,0.593,85,34,85,0.4,24,63,0.381,10,22,0.455,19,25,0.76,97,2012-02-18,CHI,NJN,2012,102.0
12368,12368,68,@,L 85-101 ,240,32,81,0.395,27,67,0.403,5,14,0.357,16,20,0.8,85,37,72,0.514,27,53,0.509,10,19,0.526,17,24,0.708,101,2012-02-19,UTA,HOU,2012,106.0
12369,12369,69,Home,L 85-92 ,240,29,85,0.341,24,62,0.387,5,23,0.217,22,33,0.667,85,33,86,0.384,26,67,0.388,7,19,0.368,19,24,0.792,92,2012-02-19,BRK,MIL,2012,95.5
12370,12370,70,@,L 85-100 ,240,30,78,0.385,26,65,0.4,4,13,0.308,21,23,0.913,85,36,77,0.468,29,52,0.558,7,25,0.28,21,25,0.84,100,2012-02-23,LAL,OKC,2012,103.5
12371,12371,71,@,L 85-88 ,240,35,75,0.467,33,58,0.569,2,17,0.118,13,18,0.722,85,29,75,0.387,22,55,0.4,7,20,0.35,23,28,0.821,88,2012-02-28,TOR,HOU,2012,91.5
12372,12372,72,@,W 85-82 ,240,34,83,0.41,33,71,0.465,1,12,0.083,16,17,0.941,85,31,92,0.337,27,74,0.365,4,18,0.222,16,26,0.615,82,2012-02-29,GSW,ATL,2012,84.0
12373,12373,73,@,L 85-104 ,240,35,89,0.393,30,70,0.429,5,19,0.263,10,18,0.556,85,41,84,0.488,36,63,0.571,5,21,0.238,17,22,0.773,104,2012-02-29,MIN,LAL,2012,106.5
12374,12374,74,@,L 85-96 ,240,35,79,0.443,31,56,0.554,4,23,0.174,11,14,0.786,85,39,80,0.488,37,68,0.544,2,12,0.167,16,19,0.842,96,2012-02-29,DAL,MEM,2012,97.0
12375,12375,75,@,L 85-95 ,240,32,84,0.381,26,61,0.426,6,23,0.261,15,23,0.652,85,31,80,0.388,24,54,0.444,7,26,0.269,26,30,0.867,95,2012-03-06,NYK,DAL,2012,98.5
12376,12376,76,@,L 85-88 (OT),265,34,81,0.42,31,59,0.525,3,22,0.136,14,17,0.824,85,37,93,0.398,34,83,0.41,3,10,0.3,11,12,0.917,88,2012-03-06,LAL,DET,2012,89.5
12377,12377,77,@,L 85-86 ,240,31,73,0.425,23,54,0.426,8,19,0.421,15,22,0.682,85,38,68,0.559,37,60,0.617,1,8,0.125,9,15,0.6,86,2012-03-09,ATL,DET,2012,86.5
12378,12378,78,Home,L 85-94 ,240,31,83,0.373,26,60,0.433,5,23,0.217,18,21,0.857,85,33,67,0.493,28,54,0.519,5,13,0.385,23,27,0.852,94,2012-03-12,LAC,BOS,2012,96.5
12379,12379,79,@,W 85-59 ,240,35,79,0.443,28,61,0.459,7,18,0.389,8,11,0.727,85,24,68,0.353,20,48,0.417,4,20,0.2,7,18,0.389,59,2012-03-19,CHI,ORL,2012,61.0
12380,12380,80,@,W 85-83 ,240,31,74,0.419,27,56,0.482,4,18,0.222,19,28,0.679,85,30,71,0.423,25,53,0.472,5,18,0.278,18,23,0.783,83,2012-03-22,IND,WAS,2012,85.5
12381,12381,81,@,L 85-101 ,240,33,78,0.423,24,63,0.381,9,15,0.6,10,14,0.714,85,36,72,0.5,31,56,0.554,5,16,0.313,24,33,0.727,101,2012-03-24,MEM,LAC,2012,103.5
12382,12382,82,@,L 85-97 ,240,31,62,0.5,29,51,0.569,2,11,0.182,21,31,0.677,85,37,74,0.5,29,48,0.604,8,26,0.308,15,21,0.714,97,2012-03-26,NOP,LAC,2012,101.0
12383,12383,83,@,L 85-103 ,240,28,70,0.4,19,47,0.404,9,23,0.391,20,28,0.714,85,45,92,0.489,35,73,0.479,10,19,0.526,3,5,0.6,103,2012-03-27,CLE,PHI,2012,108.0
12384,12384,84,@,L 85-106 ,240,33,78,0.423,24,54,0.444,9,24,0.375,10,13,0.769,85,39,80,0.488,34,63,0.54,5,17,0.294,23,27,0.852,106,2012-03-29,DAL,MIA,2012,108.5
12385,12385,85,@,L 85-88 ,240,39,92,0.424,37,82,0.451,2,10,0.2,5,10,0.5,85,32,77,0.416,25,55,0.455,7,22,0.318,17,22,0.773,88,2012-03-31,NOP,LAL,2012,91.5
12386,12386,86,@,L 85-95 ,240,35,83,0.422,28,67,0.418,7,16,0.438,8,14,0.571,85,40,80,0.5,36,65,0.554,4,15,0.267,11,16,0.688,95,2012-04-04,MEM,DAL,2012,97.0
12387,12387,87,Home,L 85-93 ,240,35,84,0.417,31,67,0.463,4,17,0.235,11,15,0.733,85,36,80,0.45,31,61,0.508,5,19,0.263,16,24,0.667,93,2012-04-05,SAC,LAC,2012,95.5
12388,12388,88,Home,L 85-113 ,240,32,82,0.39,29,73,0.397,3,9,0.333,18,22,0.818,85,40,83,0.482,29,58,0.5,11,25,0.44,22,26,0.846,113,2012-04-09,CHA,WAS,2012,118.5
12389,12389,89,@,L 85-94 ,240,34,84,0.405,30,66,0.455,4,18,0.222,13,18,0.722,85,37,74,0.5,33,61,0.541,4,13,0.308,16,20,0.8,94,2012-04-09,LAC,MEM,2012,96.0
12390,12390,90,@,L 85-93 ,240,34,93,0.366,23,58,0.397,11,35,0.314,6,10,0.6,85,39,78,0.5,36,63,0.571,3,15,0.2,12,15,0.8,93,2012-04-10,ORL,WAS,2012,94.5
12391,12391,91,Home,L 85-109 ,240,31,70,0.443,25,59,0.424,6,11,0.545,17,23,0.739,85,43,82,0.524,38,69,0.551,5,13,0.385,18,21,0.857,109,2012-04-12,CHA,DET,2012,111.5
12392,12392,92,@,L 85-96 ,240,33,73,0.452,31,62,0.5,2,11,0.182,17,21,0.81,85,38,69,0.551,32,56,0.571,6,13,0.462,14,21,0.667,96,2012-04-13,UTA,NOH,2012,99.0
12393,12393,93,Home,L 85-93 ,240,31,73,0.425,22,43,0.512,9,30,0.3,14,23,0.609,85,36,78,0.462,32,61,0.525,4,17,0.235,17,21,0.81,93,2012-04-15,NYK,MIA,2012,95.0
12394,12394,94,@,W 85-80 ,240,34,75,0.453,32,67,0.478,2,8,0.25,15,21,0.714,85,32,79,0.405,29,70,0.414,3,9,0.333,13,18,0.722,80,2012-04-20,MEM,CHA,2012,81.5
12395,12395,95,Home,L 85-96 ,240,34,77,0.442,30,60,0.5,4,17,0.235,13,18,0.722,85,40,91,0.44,36,75,0.48,4,16,0.25,12,16,0.75,96,2012-04-25,CLE,WAS,2012,98.0
12396,12396,96,Home,L 85-90 ,240,36,81,0.444,30,65,0.462,6,16,0.375,7,9,0.778,85,36,101,0.356,31,85,0.365,5,16,0.313,13,18,0.722,90,2012-04-25,MIL,PHI,2012,92.5
12397,12397,97,Home,L 85-87 ,240,32,80,0.4,28,59,0.475,4,21,0.19,17,22,0.773,85,33,86,0.384,28,69,0.406,5,17,0.294,16,23,0.696,87,2012-10-31,PHO,GSW,2013,89.5
12398,12398,98,Home,L 85-95 (OT),265,34,96,0.354,29,70,0.414,5,26,0.192,12,18,0.667,85,39,93,0.419,29,69,0.42,10,24,0.417,7,12,0.583,95,2012-11-03,HOU,POR,2013,100.0
12399,12399,99,@,L 85-93 ,240,31,76,0.408,22,49,0.449,9,27,0.333,14,15,0.933,85,35,94,0.372,29,75,0.387,6,19,0.316,17,23,0.739,93,2012-11-09,HOU,MEM,2013,96.0
12400,12400,0,@,L 85-89 ,240,35,79,0.443,25,55,0.455,10,24,0.417,5,7,0.714,85,34,80,0.425,27,64,0.422,7,16,0.438,14,24,0.583,89,2012-11-10,WAS,IND,2013,92.5
12401,12401,1,@,L 85-99 ,240,30,80,0.375,25,60,0.417,5,20,0.25,20,31,0.645,85,38,91,0.418,35,75,0.467,3,16,0.188,20,25,0.8,99,2012-11-14,IND,MIL,2013,100.5
12402,12402,2,@,L 85-96 ,240,33,86,0.384,28,59,0.475,5,27,0.185,14,19,0.737,85,33,78,0.423,27,57,0.474,6,21,0.286,24,29,0.828,96,2012-11-24,MIN,GSW,2013,99.0
12403,12403,3,@,L 85-98 ,240,34,78,0.436,27,61,0.443,7,17,0.412,10,13,0.769,85,39,92,0.424,34,75,0.453,5,17,0.294,15,21,0.714,98,2012-11-25,POR,BRK,2013,100.5
12404,12404,4,@,L 85-95 ,240,34,93,0.366,29,75,0.387,5,18,0.278,12,16,0.75,85,34,87,0.391,26,68,0.382,8,19,0.421,19,27,0.704,95,2012-11-30,MIL,MIN,2013,99.0
12405,12405,5,Home,L 85-95 ,240,31,85,0.365,26,69,0.377,5,16,0.313,18,25,0.72,85,34,72,0.472,30,57,0.526,4,15,0.267,23,27,0.852,95,2012-12-05,CLE,CHI,2013,97.0
12406,12406,6,@,L 85-93 ,240,27,84,0.321,19,61,0.311,8,23,0.348,23,28,0.821,85,34,78,0.436,27,65,0.415,7,13,0.538,18,18,1.0,93,2012-12-08,NYK,CHI,2013,96.5
12407,12407,7,@,L 85-98 ,240,32,86,0.372,29,67,0.433,3,19,0.158,18,21,0.857,85,39,96,0.406,33,79,0.418,6,17,0.353,14,24,0.583,98,2012-12-12,SAC,MIL,2013,101.0
12408,12408,8,@,L 85-95 ,240,35,81,0.432,32,69,0.464,3,12,0.25,12,16,0.75,85,35,77,0.455,27,63,0.429,8,14,0.571,17,27,0.63,95,2012-12-14,PHI,IND,2013,99.0
12409,12409,9,@,L 85-99 ,240,34,92,0.37,27,72,0.375,7,20,0.35,10,11,0.909,85,41,86,0.477,32,65,0.492,9,21,0.429,8,11,0.727,99,2012-12-14,GSW,ORL,2013,103.5
12410,12410,10,Home,L 85-111 ,240,30,83,0.361,23,62,0.371,7,21,0.333,18,25,0.72,85,44,82,0.537,39,71,0.549,5,11,0.455,18,24,0.75,111,2012-12-15,MIL,LAC,2013,113.5
12411,12411,11,@,L 85-97 ,240,33,79,0.418,25,57,0.439,8,22,0.364,11,16,0.688,85,37,87,0.425,30,64,0.469,7,23,0.304,16,24,0.667,97,2012-12-21,SAC,LAC,2013,100.5
12412,12412,12,Home,L 85-106 ,240,33,88,0.375,28,63,0.444,5,25,0.2,14,21,0.667,85,43,94,0.457,31,66,0.47,12,28,0.429,8,14,0.571,106,2012-12-28,DAL,DEN,2013,112.0
12413,12413,13,@,L 85-104 ,240,33,76,0.434,29,63,0.46,4,13,0.308,15,24,0.625,85,40,98,0.408,32,77,0.416,8,21,0.381,16,17,0.941,104,2012-12-29,MIA,MIL,2013,108.0
12414,12414,14,@,L 85-89 ,240,36,85,0.424,32,68,0.471,4,17,0.235,9,11,0.818,85,34,76,0.447,26,53,0.491,8,23,0.348,13,16,0.813,89,2012-12-29,PHI,POR,2013,93.0
12415,12415,15,Home,W 85-84 ,240,35,85,0.412,32,70,0.457,3,15,0.2,12,21,0.571,85,31,75,0.413,21,46,0.457,10,29,0.345,12,20,0.6,84,2013-01-04,DET,ATL,2013,89.0
12416,12416,16,@,L 85-109 ,240,34,84,0.405,23,60,0.383,11,24,0.458,6,8,0.75,85,39,75,0.52,29,58,0.5,10,17,0.588,21,27,0.778,109,2013-01-04,PHI,OKC,2013,114.0
12417,12417,17,Home,W 85-69 ,240,34,78,0.436,31,71,0.437,3,7,0.429,14,20,0.7,85,29,85,0.341,27,75,0.36,2,10,0.2,9,15,0.6,69,2013-01-18,MEM,SAC,2013,70.0
12418,12418,18,@,W 85-82 (OT),265,34,84,0.405,34,79,0.43,0,5,0.0,17,28,0.607,85,31,85,0.365,28,71,0.394,3,14,0.214,17,21,0.81,82,2013-01-19,MEM,CHI,2013,83.5
12419,12419,19,Home,L 85-88 ,240,34,84,0.405,28,63,0.444,6,21,0.286,11,17,0.647,85,31,74,0.419,19,50,0.38,12,24,0.5,14,20,0.7,88,2013-01-21,NYK,BRK,2013,94.0
12420,12420,20,Home,L 85-90 ,240,37,84,0.44,33,70,0.471,4,14,0.286,7,11,0.636,85,34,81,0.42,31,63,0.492,3,18,0.167,19,26,0.731,90,2013-01-21,PHI,SAS,2013,91.5
12421,12421,21,Home,W 85-82 ,240,31,71,0.437,28,57,0.491,3,14,0.214,20,26,0.769,85,34,82,0.415,30,69,0.435,4,13,0.308,10,14,0.714,82,2013-01-23,CHI,DET,2013,84.0
12422,12422,22,@,L 85-93 ,240,32,81,0.395,26,69,0.377,6,12,0.5,15,21,0.714,85,35,78,0.449,28,60,0.467,7,18,0.389,16,25,0.64,93,2013-01-28,CHA,CHI,2013,96.5
12423,12423,23,Home,L 85-105 ,240,31,69,0.449,26,52,0.5,5,17,0.294,18,24,0.75,85,43,83,0.518,32,64,0.5,11,19,0.579,8,14,0.571,105,2013-01-30,BRK,MIA,2013,110.5
12424,12424,24,Home,W 85-76 ,240,35,78,0.449,34,71,0.479,1,7,0.143,14,17,0.824,85,34,83,0.41,29,63,0.46,5,20,0.25,3,3,1.0,76,2013-02-01,MEM,WAS,2013,78.5
12425,12425,25,Home,L 85-100 ,240,28,75,0.373,24,57,0.421,4,18,0.222,25,32,0.781,85,40,75,0.533,37,63,0.587,3,12,0.25,17,23,0.739,100,2013-02-03,TOR,MIA,2013,101.5
12426,12426,26,@,L 85-99 ,240,38,90,0.422,35,77,0.455,3,13,0.231,6,12,0.5,85,36,79,0.456,22,45,0.489,14,34,0.412,13,16,0.813,99,2013-02-04,DET,NYK,2013,106.0
12427,12427,27,@,L 85-91 ,240,35,85,0.412,32,72,0.444,3,13,0.231,12,17,0.706,85,36,83,0.434,29,62,0.468,7,21,0.333,12,18,0.667,91,2013-02-12,PHO,LAL,2013,94.5
12428,12428,28,@,L 85-96 ,240,34,70,0.486,31,59,0.525,3,11,0.273,14,22,0.636,85,35,79,0.443,26,61,0.426,9,18,0.5,17,25,0.68,96,2013-02-13,WAS,DET,2013,100.5
12429,12429,29,@,L 85-96 ,240,32,72,0.444,27,57,0.474,5,15,0.333,16,23,0.696,85,38,73,0.521,32,58,0.552,6,15,0.4,14,14,1.0,96,2013-03-02,BRK,CHI,2013,99.0
12430,12430,30,@,L 85-91 ,240,31,76,0.408,25,56,0.446,6,20,0.3,17,28,0.607,85,38,87,0.437,34,75,0.453,4,12,0.333,11,18,0.611,91,2013-03-06,POR,MEM,2013,93.0
12431,12431,31,@,L 85-96 ,240,34,79,0.43,32,67,0.478,2,12,0.167,15,17,0.882,85,38,81,0.469,34,68,0.5,4,13,0.308,16,20,0.8,96,2013-03-09,NOP,MEM,2013,98.0
12432,12432,32,Home,L 85-96 ,240,31,72,0.431,25,46,0.543,6,26,0.231,17,18,0.944,85,37,68,0.544,31,56,0.554,6,12,0.5,16,21,0.762,96,2013-03-13,LAC,MEM,2013,99.0
12433,12433,33,Home,L 85-100 ,240,31,69,0.449,25,49,0.51,6,20,0.3,17,22,0.773,85,39,90,0.433,31,62,0.5,8,28,0.286,14,18,0.778,100,2013-03-26,BOS,NYK,2013,104.0
12434,12434,34,@,L 85-104 ,240,35,86,0.407,32,66,0.485,3,20,0.15,12,15,0.8,85,39,79,0.494,35,67,0.522,4,12,0.333,22,31,0.71,104,2013-04-06,IND,WAS,2013,106.0
12435,12435,35,@,L 85-91 ,240,34,90,0.378,33,77,0.429,1,13,0.077,16,22,0.727,85,32,89,0.36,25,72,0.347,7,17,0.412,20,24,0.833,91,2013-04-07,ORL,CLE,2013,94.5
12436,12436,36,@,L 85-99 ,240,33,73,0.452,30,58,0.517,3,15,0.2,16,25,0.64,85,39,73,0.534,30,55,0.545,9,18,0.5,12,17,0.706,99,2013-04-07,CHI,DET,2013,103.5
12437,12437,37,@,L 85-95 ,240,34,87,0.391,25,58,0.431,9,29,0.31,8,12,0.667,85,37,80,0.463,33,71,0.465,4,9,0.444,17,24,0.708,95,2013-04-13,MIL,CHA,2013,97.0
12438,12438,38,Home,L 85-91 ,240,30,82,0.366,22,55,0.4,8,27,0.296,17,24,0.708,85,38,94,0.404,33,73,0.452,5,21,0.238,10,14,0.714,91,2013-11-01,LAL,SAS,2014,93.5
12439,12439,39,@,L 85-96 ,240,31,80,0.388,25,61,0.41,6,19,0.316,17,26,0.654,85,38,87,0.437,35,78,0.449,3,9,0.333,17,22,0.773,96,2013-11-08,LAL,NOP,2014,97.5
12440,12440,40,Home,L 85-96 ,240,36,78,0.462,33,66,0.5,3,12,0.25,10,14,0.714,85,36,82,0.439,27,62,0.435,9,20,0.45,15,22,0.682,96,2013-11-09,SAC,POR,2014,100.5
12441,12441,41,Home,L 85-109 ,240,34,82,0.415,29,63,0.46,5,19,0.263,12,16,0.75,85,44,89,0.494,31,61,0.508,13,28,0.464,8,11,0.727,109,2013-11-11,PHI,SAS,2014,115.5
12442,12442,42,@,L 85-109 ,240,32,99,0.323,25,79,0.316,7,20,0.35,14,20,0.7,85,41,72,0.569,32,51,0.627,9,21,0.429,18,24,0.75,109,2013-11-19,BOS,HOU,2014,113.5
12443,12443,43,@,L 85-93 ,240,35,87,0.402,29,65,0.446,6,22,0.273,9,12,0.75,85,36,71,0.507,32,56,0.571,4,15,0.267,17,24,0.708,93,2013-11-20,DET,ATL,2014,95.0
12444,12444,44,@,L 85-92 ,240,35,84,0.417,31,65,0.477,4,19,0.211,11,15,0.733,85,36,78,0.462,28,61,0.459,8,17,0.471,12,20,0.6,92,2013-11-30,BOS,MIL,2014,96.0
12445,12445,45,@,L 85-94 ,240,30,75,0.4,24,53,0.453,6,22,0.273,19,20,0.95,85,36,86,0.419,26,69,0.377,10,17,0.588,12,17,0.706,94,2013-12-09,ORL,MEM,2014,99.0
12446,12446,46,Home,L 85-88 ,240,39,89,0.438,37,76,0.487,2,13,0.154,5,8,0.625,85,30,77,0.39,23,57,0.404,7,20,0.35,21,23,0.913,88,2013-12-14,CHA,LAL,2014,91.5
12447,12447,47,@,L 85-118 ,240,35,94,0.372,32,76,0.421,3,18,0.167,12,15,0.8,85,45,86,0.523,35,60,0.583,10,26,0.385,18,24,0.75,118,2013-12-20,UTA,ATL,2014,123.0
12448,12448,48,Home,L 85-88 ,240,36,83,0.434,34,71,0.479,2,12,0.167,11,16,0.688,85,32,83,0.386,22,62,0.355,10,21,0.476,14,18,0.778,88,2013-12-21,CHA,UTA,2014,93.0
12449,12449,49,Home,L 85-89 ,240,30,80,0.375,21,57,0.368,9,23,0.391,16,20,0.8,85,33,80,0.413,25,55,0.455,8,25,0.32,15,24,0.625,89,2013-12-27,CHA,OKC,2014,93.0
12450,12450,50,@,W 85-79 ,240,29,69,0.42,25,55,0.455,4,14,0.286,23,31,0.742,85,30,82,0.366,28,73,0.384,2,9,0.222,17,21,0.81,79,2013-12-31,TOR,CHI,2014,80.0
12451,12451,51,@,L 85-112 ,240,29,76,0.382,23,55,0.418,6,21,0.286,21,22,0.955,85,47,85,0.553,36,51,0.706,11,34,0.324,7,10,0.7,112,2014-01-01,CHA,LAC,2014,117.5
12452,12452,52,@,L 85-89 ,240,32,86,0.372,29,67,0.433,3,19,0.158,18,23,0.783,85,33,81,0.407,24,55,0.436,9,26,0.346,14,20,0.7,89,2014-01-07,DET,NYK,2014,93.5
12453,12453,53,@,L 85-101 ,240,32,81,0.395,20,50,0.4,12,31,0.387,9,14,0.643,85,35,86,0.407,25,61,0.41,10,25,0.4,21,27,0.778,101,2014-01-11,MIL,OKC,2014,106.0
12454,12454,54,@,L 85-93 ,240,34,73,0.466,27,53,0.509,7,20,0.35,10,14,0.714,85,32,76,0.421,25,53,0.472,7,23,0.304,22,32,0.688,93,2014-01-22,DAL,TOR,2014,96.5
12455,12455,55,@,W 85-79 ,240,33,84,0.393,27,59,0.458,6,25,0.24,13,18,0.722,85,28,75,0.373,21,49,0.429,7,26,0.269,16,19,0.842,79,2014-01-26,BRK,BOS,2014,82.5
12456,12456,56,Home,L 85-88 ,240,30,80,0.375,23,57,0.404,7,23,0.304,18,23,0.783,85,34,90,0.378,24,68,0.353,10,22,0.455,10,15,0.667,88,2014-01-28,GSW,WAS,2014,93.0
12457,12457,57,Home,L 85-89 ,240,33,76,0.434,26,51,0.51,7,25,0.28,12,15,0.8,85,34,74,0.459,29,56,0.518,5,18,0.278,16,20,0.8,89,2014-02-04,ATL,IND,2014,91.5
12458,12458,58,@,L 85-100 ,240,35,80,0.438,25,57,0.439,10,23,0.435,5,9,0.556,85,43,85,0.506,35,65,0.538,8,20,0.4,6,13,0.462,100,2014-02-11,ATL,CHI,2014,104.0
12459,12459,59,Home,L 85-114 ,240,31,87,0.356,26,65,0.4,5,22,0.227,18,27,0.667,85,40,87,0.46,34,69,0.493,6,18,0.333,28,33,0.848,114,2014-02-18,PHI,CLE,2014,117.0
12460,12460,60,@,L 85-106 ,240,29,83,0.349,27,62,0.435,2,21,0.095,25,27,0.926,85,42,82,0.512,37,57,0.649,5,25,0.2,17,25,0.68,106,2014-02-21,SAS,PHO,2014,108.5
12461,12461,61,@,L 85-96 ,240,32,83,0.386,22,55,0.4,10,28,0.357,11,14,0.786,85,35,83,0.422,31,71,0.437,4,12,0.333,22,30,0.733,96,2014-03-03,NYK,DET,2014,98.0
12462,12462,62,@,W 85-77 ,240,35,78,0.449,30,70,0.429,5,8,0.625,10,18,0.556,85,31,75,0.413,29,62,0.468,2,13,0.154,13,14,0.929,77,2014-03-07,MEM,CHI,2014,78.0
12463,12463,63,@,L 85-108 ,240,30,82,0.366,25,64,0.391,5,18,0.278,20,31,0.645,85,41,80,0.513,29,55,0.527,12,25,0.48,14,17,0.824,108,2014-03-11,DAL,GSW,2014,114.0
12464,12464,64,Home,L 85-98 ,240,35,82,0.427,26,57,0.456,9,25,0.36,6,9,0.667,85,38,78,0.487,33,60,0.55,5,18,0.278,17,22,0.773,98,2014-03-12,WAS,CHA,2014,100.5
12465,12465,65,@,L 85-119 ,240,31,91,0.341,27,70,0.386,4,21,0.19,19,25,0.76,85,48,98,0.49,35,71,0.493,13,27,0.481,10,13,0.769,119,2014-03-14,LAL,SAS,2014,125.5
12466,12466,66,Home,L 85-97 ,240,29,84,0.345,24,62,0.387,5,22,0.227,22,31,0.71,85,31,75,0.413,18,50,0.36,13,25,0.52,22,28,0.786,97,2014-03-17,CHI,OKC,2014,103.5
12467,12467,67,@,L 85-95 ,240,32,86,0.372,25,60,0.417,7,26,0.269,14,17,0.824,85,37,85,0.435,31,68,0.456,6,17,0.353,15,22,0.682,95,2014-03-25,POR,ORL,2014,98.0
12468,12468,68,Home,L 85-100 ,240,34,84,0.405,30,62,0.484,4,22,0.182,13,17,0.765,85,37,80,0.463,27,54,0.5,10,26,0.385,16,21,0.762,100,2014-03-27,ATL,POR,2014,105.0
12469,12469,69,@,L 85-98 ,240,35,73,0.479,29,48,0.604,6,25,0.24,9,19,0.474,85,36,78,0.462,26,56,0.464,10,22,0.455,16,19,0.842,98,2014-04-12,MIA,ATL,2014,103.0
12470,12470,70,@,L 85-114 ,240,30,79,0.38,22,54,0.407,8,25,0.32,17,23,0.739,85,46,87,0.529,38,67,0.567,8,20,0.4,14,17,0.824,114,2014-04-16,BRK,CLE,2014,118.0
12471,12471,71,@,L 85-116 ,240,32,82,0.39,24,59,0.407,8,23,0.348,13,21,0.619,85,44,84,0.524,33,61,0.541,11,23,0.478,17,19,0.895,116,2014-11-03,OKC,BRK,2015,121.5
12472,12472,72,Home,L 85-89 ,240,33,74,0.446,28,52,0.538,5,22,0.227,14,17,0.824,85,33,83,0.398,31,64,0.484,2,19,0.105,21,27,0.778,89,2014-11-10,LAC,SAS,2015,90.0
12473,12473,73,Home,L 85-91 ,240,36,83,0.434,30,57,0.526,6,26,0.231,7,12,0.583,85,27,71,0.38,17,44,0.386,10,27,0.37,27,28,0.964,91,2014-11-10,NYK,ATL,2015,96.0
12474,12474,74,Home,W 85-78 ,240,33,81,0.407,30,66,0.455,3,15,0.2,16,24,0.667,85,29,87,0.333,23,67,0.343,6,20,0.3,14,19,0.737,78,2014-11-11,MIL,OKC,2015,81.0
12475,12475,75,@,L 85-101 ,240,36,80,0.45,34,61,0.557,2,19,0.105,11,14,0.786,85,35,80,0.438,25,56,0.446,10,24,0.417,21,27,0.778,101,2014-11-14,MIL,ORL,2015,106.0
12476,12476,76,Home,L 85-102 ,240,32,82,0.39,22,45,0.489,10,37,0.27,11,15,0.733,85,38,81,0.469,29,56,0.518,9,25,0.36,17,22,0.773,102,2014-11-28,HOU,LAC,2015,106.5
12477,12477,77,Home,L 85-97 ,240,33,70,0.471,32,59,0.542,1,11,0.091,18,27,0.667,85,38,79,0.481,35,66,0.53,3,13,0.231,18,28,0.643,97,2014-11-30,SAC,MEM,2015,98.5
12478,12478,78,@,W 85-77 ,240,32,82,0.39,27,58,0.466,5,24,0.208,16,25,0.64,85,30,84,0.357,27,67,0.403,3,17,0.176,14,17,0.824,77,2014-12-03,PHI,MIN,2015,78.5
12479,12479,79,@,L 85-112 ,240,37,89,0.416,34,74,0.459,3,15,0.2,8,13,0.615,85,47,100,0.47,37,78,0.474,10,22,0.455,8,17,0.471,112,2014-12-04,NOP,GSW,2015,117.0
12480,12480,80,@,L 85-109 ,240,30,68,0.441,23,50,0.46,7,18,0.389,18,27,0.667,85,39,69,0.565,30,53,0.566,9,16,0.563,22,26,0.846,109,2014-12-05,MIA,MIL,2015,113.5
12481,12481,81,Home,L 85-95 ,240,34,88,0.386,30,73,0.411,4,15,0.267,13,16,0.813,85,40,90,0.444,35,73,0.479,5,17,0.294,10,12,0.833,95,2014-12-13,IND,POR,2015,97.5
12482,12482,82,Home,L 85-110 ,240,28,77,0.364,21,52,0.404,7,25,0.28,22,27,0.815,85,44,86,0.512,35,68,0.515,9,18,0.5,13,18,0.722,110,2014-12-27,BRK,IND,2015,114.5
12483,12483,83,Home,L 85-90 ,240,31,80,0.388,19,50,0.38,12,30,0.4,11,14,0.786,85,33,90,0.367,24,61,0.393,9,29,0.31,15,19,0.789,90,2014-12-27,MIL,ATL,2015,94.5
12484,12484,84,@,L 85-114 ,240,37,86,0.43,35,72,0.486,2,14,0.143,9,13,0.692,85,41,79,0.519,34,64,0.531,7,15,0.467,25,31,0.806,114,2015-01-03,MEM,DEN,2015,117.5
12485,12485,85,Home,L 85-92 ,240,33,74,0.446,27,55,0.491,6,19,0.316,13,17,0.765,85,38,79,0.481,36,69,0.522,2,10,0.2,14,17,0.824,92,2015-01-05,NOP,WAS,2015,93.0
12486,12486,86,@,L 85-94 ,240,31,65,0.477,28,58,0.483,3,7,0.429,20,27,0.741,85,36,85,0.424,24,54,0.444,12,31,0.387,10,10,1.0,94,2015-01-16,LAL,UTA,2015,100.0
12487,12487,87,@,L 85-99 ,240,33,83,0.398,28,70,0.4,5,13,0.385,14,20,0.7,85,36,84,0.429,29,60,0.483,7,24,0.292,20,27,0.741,99,2015-01-23,LAL,SAS,2015,102.5
12488,12488,88,Home,L 85-93 ,240,32,82,0.39,29,67,0.433,3,15,0.2,18,24,0.75,85,39,85,0.459,29,68,0.426,10,17,0.588,5,7,0.714,93,2015-01-28,NOP,DEN,2015,98.0
12489,12489,89,@,L 85-91 ,240,31,81,0.383,17,46,0.37,14,35,0.4,9,15,0.6,85,34,78,0.436,24,50,0.48,10,28,0.357,13,18,0.722,91,2015-01-31,PHI,ATL,2015,96.0
12490,12490,90,Home,W 85-74 ,240,34,91,0.374,31,80,0.388,3,11,0.273,14,17,0.824,85,27,78,0.346,21,58,0.362,6,20,0.3,14,18,0.778,74,2015-01-31,MEM,OKC,2015,77.0
12491,12491,91,Home,L 85-105 ,240,28,75,0.373,18,45,0.4,10,30,0.333,19,28,0.679,85,40,91,0.44,32,69,0.464,8,22,0.364,17,18,0.944,105,2015-01-31,SAS,LAC,2015,109.0
12492,12492,92,@,L 85-98 ,240,36,80,0.45,31,64,0.484,5,16,0.313,8,9,0.889,85,40,83,0.482,29,54,0.537,11,29,0.379,7,9,0.778,98,2015-02-06,MIA,SAS,2015,103.5
12493,12493,93,Home,W 85-83 ,240,34,75,0.453,30,63,0.476,4,12,0.333,13,21,0.619,85,33,91,0.363,28,63,0.444,5,28,0.179,12,17,0.706,83,2015-02-08,SAC,PHO,2015,85.5
12494,12494,94,Home,W 85-84 ,240,33,88,0.375,25,61,0.41,8,27,0.296,11,20,0.55,85,34,75,0.453,31,56,0.554,3,19,0.158,13,21,0.619,84,2015-03-04,BOS,UTA,2015,85.5
12495,12495,95,Home,L 85-100 ,240,32,82,0.39,29,64,0.453,3,18,0.167,18,25,0.72,85,42,92,0.457,34,72,0.472,8,20,0.4,8,10,0.8,100,2015-03-04,MIN,DEN,2015,104.0
12496,12496,96,@,L 85-88 ,240,38,93,0.409,36,79,0.456,2,14,0.143,7,9,0.778,85,37,90,0.411,35,78,0.449,2,12,0.167,12,16,0.75,88,2015-03-04,DET,NOP,2015,89.0
12497,12497,97,@,L 85-112 ,240,29,78,0.372,26,69,0.377,3,9,0.333,24,34,0.706,85,45,85,0.529,35,62,0.565,10,23,0.435,12,16,0.75,112,2015-03-04,SAC,SAS,2015,117.0
12498,12498,98,@,L 85-91 ,240,31,81,0.383,22,53,0.415,9,28,0.321,14,22,0.636,85,36,78,0.462,26,58,0.448,10,20,0.5,9,15,0.6,91,2015-03-07,WAS,MIL,2015,96.0
12499,12499,99,@,L 85-93 ,240,32,84,0.381,24,49,0.49,8,35,0.229,13,19,0.684,85,32,75,0.427,29,62,0.468,3,13,0.231,26,30,0.867,93,2015-03-10,DET,LAL,2015,94.5
12500,12500,0,@,L 85-88 ,240,32,84,0.381,24,61,0.393,8,23,0.348,13,22,0.591,85,33,69,0.478,27,55,0.491,6,14,0.429,16,24,0.667,88,2015-03-14,DET,UTA,2015,91.0
12501,12501,1,Home,W 85-84 ,240,29,83,0.349,21,58,0.362,8,25,0.32,19,26,0.731,85,32,86,0.372,28,66,0.424,4,20,0.2,16,21,0.762,84,2015-03-17,NOP,MIL,2015,86.0
12502,12502,2,Home,L 85-99 ,240,29,84,0.345,21,55,0.382,8,29,0.276,19,27,0.704,85,35,84,0.417,21,50,0.42,14,34,0.412,15,22,0.682,99,2015-03-25,DEN,PHI,2015,106.0
12503,12503,3,@,L 85-87 ,240,29,74,0.392,22,53,0.415,7,21,0.333,20,24,0.833,85,30,69,0.435,25,55,0.455,5,14,0.357,22,29,0.759,87,2015-04-04,UTA,PHO,2015,89.5
12504,12504,4,@,L 85-91 ,240,36,92,0.391,28,63,0.444,8,29,0.276,5,7,0.714,85,31,77,0.403,24,53,0.453,7,24,0.292,22,26,0.846,91,2015-04-15,ATL,CHI,2015,94.5
12505,12505,5,Home,L 85-105 ,240,30,87,0.345,22,52,0.423,8,35,0.229,17,26,0.654,85,40,79,0.506,27,52,0.519,13,27,0.481,12,18,0.667,105,2015-10-28,HOU,DEN,2016,111.5
12506,12506,6,@,L 85-102 ,240,30,86,0.349,25,69,0.362,5,17,0.294,20,28,0.714,85,39,97,0.402,31,72,0.431,8,25,0.32,16,21,0.762,102,2015-11-13,PHI,OKC,2016,106.0
12507,12507,7,@,L 85-97 ,240,35,96,0.365,28,69,0.406,7,27,0.259,8,15,0.533,85,31,75,0.413,25,56,0.446,6,19,0.316,29,39,0.744,97,2015-11-15,DET,LAL,2016,100.0
12508,12508,8,Home,L 85-100 ,240,28,77,0.364,22,52,0.423,6,25,0.24,23,29,0.793,85,39,82,0.476,30,59,0.508,9,23,0.391,13,20,0.65,100,2015-11-15,OKC,BOS,2016,104.5
12509,12509,9,Home,L 85-112 ,240,35,76,0.461,30,51,0.588,5,25,0.2,10,16,0.625,85,42,92,0.457,30,65,0.462,12,27,0.444,16,20,0.8,112,2015-11-18,PHI,IND,2016,118.0
12510,12510,10,Home,L 85-97 ,240,28,83,0.337,19,53,0.358,9,30,0.3,20,23,0.87,85,39,83,0.47,32,55,0.582,7,28,0.25,12,16,0.75,97,2015-12-01,CLE,WAS,2016,100.5
12511,12511,11,@,W 85-74 ,240,38,88,0.432,37,72,0.514,1,16,0.063,8,10,0.8,85,28,84,0.333,21,60,0.35,7,24,0.292,11,20,0.55,74,2015-12-08,ORL,DEN,2016,77.5
12512,12512,12,@,L 85-106 ,240,31,78,0.397,23,57,0.404,8,21,0.381,15,27,0.556,85,39,80,0.488,30,59,0.508,9,21,0.429,19,23,0.826,106,2015-12-09,NYK,UTA,2016,110.5
12513,12513,13,@,L 85-98 ,240,32,76,0.421,27,57,0.474,5,19,0.263,16,28,0.571,85,38,86,0.442,29,62,0.468,9,24,0.375,13,19,0.684,98,2015-12-16,MEM,CHI,2016,102.5
12514,12514,14,Home,L 85-100 ,240,32,78,0.41,27,57,0.474,5,21,0.238,16,20,0.8,85,38,80,0.475,35,68,0.515,3,12,0.25,21,24,0.875,100,2015-12-20,BRK,MIN,2016,101.5
12515,12515,15,@,L 85-103 ,240,33,80,0.413,26,60,0.433,7,20,0.35,12,14,0.857,85,39,83,0.47,30,60,0.5,9,23,0.391,16,16,1.0,103,2015-12-23,UTA,GSW,2016,107.5
12516,12516,16,Home,L 85-120 ,240,32,89,0.36,25,64,0.391,7,25,0.28,14,22,0.636,85,51,95,0.537,46,76,0.605,5,19,0.263,13,17,0.765,120,2015-12-23,LAL,OKC,2016,122.5
12517,12517,17,Home,L 85-95 ,240,33,84,0.393,30,70,0.429,3,14,0.214,16,24,0.667,85,32,75,0.427,24,59,0.407,8,16,0.5,23,28,0.821,95,2016-01-02,MIN,MIL,2016,99.0
12518,12518,18,Home,L 85-95 ,240,35,77,0.455,29,59,0.492,6,18,0.333,9,19,0.474,85,35,90,0.389,26,58,0.448,9,32,0.281,16,23,0.696,95,2016-01-10,PHI,CLE,2016,99.5
12519,12519,19,@,L 85-99 ,240,31,76,0.408,23,57,0.404,8,19,0.421,15,22,0.682,85,39,88,0.443,28,62,0.452,11,26,0.423,10,15,0.667,99,2016-01-13,UTA,POR,2016,104.5
12520,12520,20,@,W 85-83 ,240,33,85,0.388,28,58,0.483,5,27,0.185,14,21,0.667,85,33,79,0.418,23,56,0.411,10,23,0.435,7,14,0.5,83,2016-01-27,LAC,ATL,2016,88.0
12521,12521,21,Home,W 85-81 ,240,33,74,0.446,28,52,0.538,5,22,0.227,14,20,0.7,85,26,70,0.371,22,52,0.423,4,18,0.222,25,33,0.758,81,2016-02-03,UTA,DEN,2016,83.0
12522,12522,22,Home,L 85-91 ,240,30,80,0.375,20,51,0.392,10,29,0.345,15,17,0.882,85,33,76,0.434,29,58,0.5,4,18,0.222,21,24,0.875,91,2016-02-05,NYK,MEM,2016,93.0
12523,12523,23,@,L 85-98 ,240,28,76,0.368,25,56,0.446,3,20,0.15,26,32,0.813,85,33,81,0.407,26,53,0.491,7,28,0.25,25,31,0.806,98,2016-02-21,MEM,TOR,2016,101.5
12524,12524,24,Home,L 85-104 ,240,33,88,0.375,27,67,0.403,6,21,0.286,13,18,0.722,85,37,88,0.42,25,58,0.431,12,30,0.4,18,20,0.9,104,2016-03-01,NYK,POR,2016,110.0
12525,12525,25,@,L 85-93 ,240,31,81,0.383,29,63,0.46,2,18,0.111,21,25,0.84,85,34,85,0.4,30,61,0.492,4,24,0.167,21,25,0.84,93,2016-03-12,OKC,SAS,2016,95.0
12526,12526,26,@,L 85-94 ,240,35,88,0.398,25,45,0.556,10,43,0.233,5,8,0.625,85,35,71,0.493,23,44,0.523,12,27,0.444,12,14,0.857,94,2016-03-14,CLE,UTA,2016,100.0
12527,12527,27,@,L 85-121 ,240,36,91,0.396,29,72,0.403,7,19,0.368,6,10,0.6,85,46,91,0.505,28,54,0.519,18,37,0.486,11,12,0.917,121,2016-03-16,NYK,GSW,2016,130.0
12528,12528,28,@,L 85-92 ,240,35,86,0.407,27,59,0.458,8,27,0.296,7,12,0.583,85,39,80,0.488,33,61,0.541,6,19,0.316,8,11,0.727,92,2016-03-19,UTA,CHI,2016,95.0
12529,12529,29,Home,L 85-94 ,240,34,65,0.523,31,57,0.544,3,8,0.375,14,17,0.824,85,34,83,0.41,21,45,0.467,13,38,0.342,13,14,0.929,94,2016-03-20,MIL,UTA,2016,100.5
12530,12530,30,Home,L 85-100 ,240,30,96,0.313,14,52,0.269,16,44,0.364,9,10,0.9,85,38,87,0.437,31,62,0.5,7,25,0.28,17,18,0.944,100,2016-03-29,PHI,CHO,2016,103.5
12531,12531,31,@,L 85-98 ,240,35,79,0.443,26,56,0.464,9,23,0.391,6,10,0.6,85,38,72,0.528,30,50,0.6,8,22,0.364,14,23,0.609,98,2016-04-01,MIN,UTA,2016,102.0
12532,12532,32,@,W 85-83 ,240,34,84,0.405,29,64,0.453,5,20,0.25,12,20,0.6,85,34,87,0.391,27,65,0.415,7,22,0.318,8,18,0.444,83,2016-11-02,OKC,LAC,2017,86.5
12533,12533,33,@,L 85-97 ,240,31,84,0.369,27,67,0.403,4,17,0.235,19,22,0.864,85,37,85,0.435,28,57,0.491,9,28,0.321,14,17,0.824,97,2016-11-07,MIA,OKC,2017,101.5
12534,12534,34,@,W 85-77 ,240,33,90,0.367,28,73,0.384,5,17,0.294,14,16,0.875,85,30,78,0.385,25,53,0.472,5,25,0.2,12,14,0.857,77,2016-11-17,CHI,UTA,2017,79.5
12535,12535,35,Home,L 85-96 ,240,34,84,0.405,27,57,0.474,7,27,0.259,10,14,0.714,85,36,85,0.424,31,65,0.477,5,20,0.25,19,22,0.864,96,2016-11-23,IND,ATL,2017,98.5
12536,12536,36,Home,L 85-109 ,240,32,90,0.356,27,68,0.397,5,22,0.227,16,23,0.696,85,43,83,0.518,32,55,0.582,11,28,0.393,12,17,0.706,109,2016-11-25,LAL,GSW,2017,114.5
12537,12537,37,Home,L 85-98 ,240,32,79,0.405,26,53,0.491,6,26,0.231,15,21,0.714,85,34,85,0.4,27,63,0.429,7,22,0.318,23,25,0.92,98,2016-11-25,PHO,MIN,2017,101.5
12538,12538,38,Home,L 85-104 ,240,36,89,0.404,29,60,0.483,7,29,0.241,6,13,0.462,85,36,82,0.439,27,56,0.482,9,26,0.346,23,31,0.742,104,2016-11-28,MEM,CHO,2017,108.5
12539,12539,39,Home,L 85-121 ,240,32,88,0.364,26,64,0.406,6,24,0.25,15,20,0.75,85,48,89,0.539,31,60,0.517,17,29,0.586,8,12,0.667,121,2016-12-02,ATL,DET,2017,129.5
12540,12540,40,@,L 85-92 ,240,31,76,0.408,24,44,0.545,7,32,0.219,16,24,0.667,85,35,78,0.449,29,59,0.492,6,19,0.316,16,17,0.941,92,2016-12-08,DEN,WAS,2017,95.0
12541,12541,41,Home,L 85-95 ,240,32,78,0.41,24,53,0.453,8,25,0.32,13,16,0.813,85,36,71,0.507,31,54,0.574,5,17,0.294,18,22,0.818,95,2016-12-14,DAL,DET,2017,97.5
12542,12542,42,@,L 85-93 ,240,28,75,0.373,19,50,0.38,9,25,0.36,20,31,0.645,85,35,81,0.432,23,58,0.397,12,23,0.522,11,16,0.688,93,2016-12-14,CLE,MEM,2017,99.0
12543,12543,43,@,L 85-90 ,240,34,81,0.42,25,56,0.446,9,25,0.36,8,10,0.8,85,32,83,0.386,26,58,0.448,6,25,0.24,20,28,0.714,90,2016-12-26,IND,CHI,2017,93.0
12544,12544,44,@,L 85-102 ,240,30,75,0.4,26,54,0.481,4,21,0.19,21,25,0.84,85,36,89,0.404,23,55,0.418,13,34,0.382,17,20,0.85,102,2017-01-07,CHA,SAS,2017,108.5
12545,12545,45,@,L 85-107 ,240,33,94,0.351,25,63,0.397,8,31,0.258,11,11,1.0,85,41,87,0.471,30,61,0.492,11,26,0.423,14,17,0.824,107,2017-01-18,POR,CHO,2017,112.5
12546,12546,46,@,L 85-90 ,240,32,76,0.421,19,38,0.5,13,38,0.342,8,9,0.889,85,32,84,0.381,20,52,0.385,12,32,0.375,14,19,0.737,90,2017-02-15,CHA,TOR,2017,96.0
12547,12547,47,Home,L 85-99 ,240,31,79,0.392,20,51,0.392,11,28,0.393,12,15,0.8,85,34,85,0.4,20,47,0.426,14,38,0.368,17,18,0.944,99,2017-02-25,SAC,CHO,2017,106.0
12548,12548,48,Home,L 84-85 ,240,32,81,0.395,27,56,0.482,5,25,0.2,15,19,0.789,84,35,79,0.443,33,63,0.524,2,16,0.125,13,21,0.619,85,2011-12-26,PHO,NOH,2012,86.0
12549,12549,49,Home,L 84-90 ,240,31,74,0.419,30,67,0.448,1,7,0.143,21,34,0.618,84,34,86,0.395,28,60,0.467,6,26,0.231,16,20,0.8,90,2011-12-26,WAS,NJN,2012,93.0
12550,12550,50,@,L 84-95 ,240,35,80,0.438,31,64,0.484,4,16,0.25,10,16,0.625,84,38,82,0.463,29,63,0.46,9,19,0.474,10,13,0.769,95,2011-12-31,ATL,HOU,2012,99.5
12551,12551,51,@,L 84-96 ,240,30,80,0.375,25,67,0.373,5,13,0.385,19,27,0.704,84,39,85,0.459,33,71,0.465,6,14,0.429,12,16,0.75,96,2012-01-11,ATL,IND,2012,99.0
12552,12552,52,@,L 84-93 ,240,33,78,0.423,30,66,0.455,3,12,0.25,15,22,0.682,84,32,71,0.451,27,58,0.466,5,13,0.385,24,31,0.774,93,2012-01-16,TOR,ATL,2012,95.5
12553,12553,53,@,W 84-77 ,240,34,72,0.472,28,52,0.538,6,20,0.3,10,15,0.667,84,28,68,0.412,28,59,0.475,0,9,0.0,21,28,0.75,77,2012-01-16,POR,NOH,2012,77.0
12554,12554,54,Home,L 84-94 ,240,30,82,0.366,25,67,0.373,5,15,0.333,19,25,0.76,84,33,82,0.402,28,67,0.418,5,15,0.333,23,31,0.742,94,2012-01-20,TOR,POR,2012,96.5
12555,12555,55,@,W 84-74 ,240,32,77,0.416,28,60,0.467,4,17,0.235,16,24,0.667,84,27,87,0.31,24,64,0.375,3,23,0.13,17,19,0.895,74,2012-01-21,OKC,NJN,2012,75.5
12556,12556,56,@,L 84-97 ,240,34,90,0.378,31,76,0.408,3,14,0.214,13,17,0.765,84,31,72,0.431,26,50,0.52,5,22,0.227,30,36,0.833,97,2012-01-24,MEM,POR,2012,99.5
12557,12557,57,@,L 84-97 ,240,34,89,0.382,29,63,0.46,5,26,0.192,11,15,0.733,84,38,77,0.494,34,65,0.523,4,12,0.333,17,22,0.773,97,2012-01-28,NYK,HOU,2012,99.0
12558,12558,58,@,L 84-86 ,240,33,76,0.434,32,73,0.438,1,3,0.333,17,20,0.85,84,32,88,0.364,27,70,0.386,5,18,0.278,17,24,0.708,86,2012-01-28,MEM,PHO,2012,88.5
12559,12559,59,Home,L 84-89 ,240,31,83,0.373,27,70,0.386,4,13,0.308,18,21,0.857,84,34,73,0.466,27,57,0.474,7,16,0.438,14,21,0.667,89,2012-02-06,MEM,SAS,2012,92.5
12560,12560,60,@,L 84-94 ,240,32,71,0.451,28,55,0.509,4,16,0.25,16,20,0.8,84,41,81,0.506,37,58,0.638,4,23,0.174,8,8,1.0,94,2012-02-07,CHA,BOS,2012,96.0
12561,12561,61,@,L 84-86 ,240,31,82,0.378,23,59,0.39,8,23,0.348,14,21,0.667,84,32,79,0.405,28,65,0.431,4,14,0.286,18,28,0.643,86,2012-02-07,SAC,MIN,2012,88.0
12562,12562,62,Home,L 84-99 ,240,31,84,0.369,28,70,0.4,3,14,0.214,19,25,0.76,84,35,79,0.443,29,65,0.446,6,14,0.429,23,30,0.767,99,2012-02-11,CLE,PHI,2012,102.0
12563,12563,63,Home,L 84-98 ,240,27,77,0.351,19,56,0.339,8,21,0.381,22,28,0.786,84,39,78,0.5,31,55,0.564,8,23,0.348,12,15,0.8,98,2012-02-11,SAC,PHO,2012,102.0
12564,12564,64,@,L 84-102 ,240,30,84,0.357,24,57,0.421,6,27,0.222,18,31,0.581,84,37,80,0.463,27,54,0.5,10,26,0.385,18,22,0.818,102,2012-02-15,DEN,DAL,2012,107.0
12565,12565,65,@,L 84-102 ,240,30,76,0.395,25,54,0.463,5,22,0.227,19,28,0.679,84,35,83,0.422,24,62,0.387,11,21,0.524,21,28,0.75,102,2012-02-15,WAS,LAC,2012,107.5
12566,12566,66,Home,L 84-89 ,240,27,85,0.318,21,58,0.362,6,27,0.222,24,37,0.649,84,36,89,0.404,34,79,0.43,2,10,0.2,15,20,0.75,89,2012-02-22,CLE,NOH,2012,90.0
12567,12567,67,Home,L 84-95 ,240,30,80,0.375,27,64,0.422,3,16,0.188,21,27,0.778,84,34,77,0.442,25,62,0.403,9,15,0.6,18,23,0.783,95,2012-02-29,NOP,TOR,2012,99.5
12568,12568,68,Home,L 84-102 ,240,33,81,0.407,29,69,0.42,4,12,0.333,14,21,0.667,84,35,80,0.438,26,61,0.426,9,19,0.474,23,32,0.719,102,2012-03-03,NOP,IND,2012,106.5
12569,12569,69,@,L 84-100 ,240,31,80,0.388,18,45,0.4,13,35,0.371,9,17,0.529,84,38,80,0.475,34,70,0.486,4,10,0.4,20,27,0.741,100,2012-03-06,ORL,CHA,2012,102.0
12570,12570,70,@,L 84-98 ,240,31,81,0.383,30,71,0.423,1,10,0.1,21,25,0.84,84,38,79,0.481,31,62,0.5,7,17,0.412,15,17,0.882,98,2012-03-14,TOR,NJN,2012,101.5
12571,12571,71,@,W 84-78 ,240,35,74,0.473,31,62,0.5,4,12,0.333,10,19,0.526,84,33,93,0.355,28,75,0.373,5,18,0.278,7,14,0.5,78,2012-03-16,MIA,PHI,2012,80.5
12572,12572,72,@,L 84-93 ,240,32,80,0.4,26,55,0.473,6,25,0.24,14,21,0.667,84,36,77,0.468,29,56,0.518,7,21,0.333,14,20,0.7,93,2012-03-23,BRK,ATL,2012,96.5
12573,12573,73,Home,L 84-105 ,240,29,81,0.358,24,60,0.4,5,21,0.238,21,35,0.6,84,42,81,0.519,37,67,0.552,5,14,0.357,16,18,0.889,105,2012-03-26,BRK,UTA,2012,107.5
12574,12574,74,@,L 84-100 ,240,35,77,0.455,29,57,0.509,6,20,0.3,8,13,0.615,84,40,82,0.488,33,66,0.5,7,16,0.438,13,15,0.867,100,2012-03-28,IND,NJN,2012,103.5
12575,12575,75,Home,L 84-121 ,240,34,85,0.4,28,63,0.444,6,22,0.273,10,19,0.526,84,50,88,0.568,40,72,0.556,10,16,0.625,11,18,0.611,121,2012-03-30,CLE,MIL,2012,126.0
12576,12576,76,@,W 84-80 ,240,25,73,0.342,20,56,0.357,5,17,0.294,29,40,0.725,84,31,73,0.425,28,58,0.483,3,15,0.2,15,24,0.625,80,2012-04-06,CLE,TOR,2012,81.5
12577,12577,77,@,L 84-123 ,240,31,84,0.369,19,59,0.322,12,25,0.48,10,14,0.714,84,48,88,0.545,39,70,0.557,9,18,0.5,18,24,0.75,123,2012-04-09,GSW,DEN,2012,127.5
12578,12578,78,@,L 84-91 ,240,35,87,0.402,28,63,0.444,7,24,0.292,7,10,0.7,84,31,73,0.425,27,59,0.458,4,14,0.286,25,33,0.758,91,2012-04-09,SAS,UTA,2012,93.0
12579,12579,79,Home,L 84-98 ,240,33,81,0.407,20,57,0.351,13,24,0.542,5,9,0.556,84,40,89,0.449,29,66,0.439,11,23,0.478,7,12,0.583,98,2012-04-11,SAS,LAL,2012,103.5
12580,12580,80,Home,W 84-79 ,240,25,72,0.347,18,54,0.333,7,18,0.389,27,31,0.871,84,30,80,0.375,26,61,0.426,4,19,0.211,15,19,0.789,79,2012-04-13,TOR,BOS,2012,81.0
12581,12581,81,Home,L 84-100 ,240,28,75,0.373,22,56,0.393,6,19,0.316,22,29,0.759,84,36,79,0.456,25,50,0.5,11,29,0.379,17,21,0.81,100,2012-04-15,CLE,ORL,2012,105.5
12582,12582,82,Home,L 84-87 ,240,32,84,0.381,28,70,0.4,4,14,0.286,16,22,0.727,84,34,89,0.382,30,71,0.423,4,18,0.222,15,19,0.789,87,2012-04-16,CHI,WAS,2012,89.0
12583,12583,83,Home,L 84-91 ,240,26,73,0.356,19,51,0.373,7,22,0.318,25,30,0.833,84,40,91,0.44,35,78,0.449,5,13,0.385,6,11,0.545,91,2012-04-17,MIN,MEM,2012,93.5
12584,12584,84,@,L 84-116 ,240,32,92,0.348,25,67,0.373,7,25,0.28,13,19,0.684,84,42,85,0.494,34,57,0.596,8,28,0.286,24,29,0.828,116,2012-04-18,DET,ATL,2012,120.0
12585,12585,85,Home,L 84-86 ,240,31,77,0.403,22,52,0.423,9,25,0.36,13,16,0.813,84,36,87,0.414,29,69,0.42,7,18,0.389,7,9,0.778,86,2012-04-21,MIA,WAS,2012,89.5
12586,12586,86,Home,L 84-104 ,240,32,74,0.432,26,58,0.448,6,16,0.375,14,26,0.538,84,44,85,0.518,36,65,0.554,8,20,0.4,8,15,0.533,104,2012-04-26,CHA,NYK,2012,108.0
12587,12587,87,Home,W 84-77 ,240,32,91,0.352,23,63,0.365,9,28,0.321,11,14,0.786,84,27,68,0.397,22,53,0.415,5,15,0.333,18,30,0.6,77,2012-04-26,HOU,NOH,2012,79.5
12588,12588,88,@,L 84-94 ,240,32,90,0.356,24,58,0.414,8,32,0.25,12,20,0.6,84,36,79,0.456,29,59,0.492,7,20,0.35,15,22,0.682,94,2012-10-30,WAS,CLE,2013,97.5
12589,12589,89,Home,W 84-75 ,240,30,85,0.353,23,60,0.383,7,25,0.28,17,21,0.81,84,33,88,0.375,29,70,0.414,4,18,0.222,5,11,0.455,75,2012-10-31,PHI,DEN,2013,77.0
12590,12590,90,@,L 84-86 ,240,29,77,0.377,22,60,0.367,7,17,0.412,19,23,0.826,84,35,79,0.443,30,60,0.5,5,19,0.263,11,16,0.688,86,2012-11-01,OKC,SAS,2013,88.5
12591,12591,91,@,L 84-104 ,240,33,71,0.465,26,51,0.51,7,20,0.35,11,13,0.846,84,36,84,0.429,17,48,0.354,19,36,0.528,13,15,0.867,104,2012-11-02,MIA,NYK,2013,113.5
12592,12592,92,@,L 84-100 ,240,34,79,0.43,26,62,0.419,8,17,0.471,8,10,0.8,84,39,77,0.506,28,50,0.56,11,27,0.407,11,18,0.611,100,2012-11-04,PHI,NYK,2013,105.5
12593,12593,93,@,L 84-106 ,240,30,73,0.411,22,50,0.44,8,23,0.348,16,24,0.667,84,46,83,0.554,40,66,0.606,6,17,0.353,8,9,0.889,106,2012-11-07,SAS,LAC,2013,109.0
12594,12594,94,@,L 84-104 ,240,32,87,0.368,28,64,0.438,4,23,0.174,16,22,0.727,84,40,92,0.435,34,75,0.453,6,17,0.353,18,25,0.72,104,2012-11-09,UTA,DEN,2013,107.0
12595,12595,95,@,W 84-82 ,240,35,90,0.389,28,70,0.4,7,20,0.35,7,11,0.636,84,31,74,0.419,25,54,0.463,6,20,0.3,14,22,0.636,82,2012-11-13,SAS,LAL,2013,85.0
12596,12596,96,@,L 84-102 ,240,33,85,0.388,27,72,0.375,6,13,0.462,12,20,0.6,84,40,75,0.533,35,62,0.565,5,13,0.385,17,21,0.81,102,2012-11-25,NOP,DEN,2013,104.5
12597,12597,97,Home,W 84-78 ,240,33,71,0.465,29,60,0.483,4,11,0.364,14,18,0.778,84,31,76,0.408,27,60,0.45,4,16,0.25,12,15,0.8,78,2012-11-26,MEM,CLE,2013,80.0
12598,12598,98,Home,L 84-96 ,240,31,73,0.425,26,52,0.5,5,21,0.238,17,21,0.81,84,31,63,0.492,25,52,0.481,6,11,0.545,28,38,0.737,96,2012-11-28,NOP,UTA,2013,99.0
12599,12599,99,Home,W 84-82 ,240,31,71,0.437,26,59,0.441,5,12,0.417,17,19,0.895,84,30,86,0.349,20,55,0.364,10,31,0.323,12,18,0.667,82,2012-11-28,WAS,POR,2013,87.0
12600,12600,0,@,L 84-99 ,240,33,82,0.402,30,71,0.423,3,11,0.273,15,21,0.714,84,38,83,0.458,32,70,0.457,6,13,0.462,17,22,0.773,99,2012-12-14,UTA,PHO,2013,102.0
12601,12601,1,@,L 84-104 ,240,32,86,0.372,30,71,0.423,2,15,0.133,18,25,0.72,84,41,80,0.513,32,64,0.5,9,16,0.563,13,18,0.722,104,2012-12-19,UTA,IND,2013,108.5
12602,12602,2,Home,L 84-87 ,240,32,84,0.381,25,56,0.446,7,28,0.25,13,17,0.765,84,33,81,0.407,24,50,0.48,9,31,0.29,12,15,0.8,87,2012-12-26,MIN,HOU,2013,91.5
12603,12603,3,Home,L 84-87 ,240,35,76,0.461,31,58,0.534,4,18,0.222,10,14,0.714,84,31,82,0.378,21,55,0.382,10,27,0.37,15,23,0.652,87,2012-12-26,WAS,CLE,2013,92.0
12604,12604,4,@,L 84-106 ,240,29,84,0.345,27,67,0.403,2,17,0.118,24,30,0.8,84,43,87,0.494,39,75,0.52,4,12,0.333,16,19,0.842,106,2013-01-02,MIN,UTA,2013,108.0
12605,12605,5,@,L 84-85 ,240,31,75,0.413,21,46,0.457,10,29,0.345,12,20,0.6,84,35,85,0.412,32,70,0.457,3,15,0.2,12,21,0.571,85,2013-01-04,ATL,DET,2013,86.5
12606,12606,6,Home,L 84-86 ,240,32,81,0.395,30,76,0.395,2,5,0.4,18,18,1.0,84,33,81,0.407,23,54,0.426,10,27,0.37,10,15,0.667,86,2013-01-04,MEM,POR,2013,91.0
12607,12607,7,@,L 84-106 ,240,31,72,0.431,28,60,0.467,3,12,0.25,19,24,0.792,84,36,76,0.474,25,56,0.446,11,20,0.55,23,27,0.852,106,2013-01-09,MIN,OKC,2013,111.5
12608,12608,8,@,L 84-102 ,240,34,81,0.42,31,67,0.463,3,14,0.214,13,16,0.813,84,43,80,0.538,34,59,0.576,9,21,0.429,7,13,0.538,102,2013-01-25,UTA,LAL,2013,106.5
12609,12609,9,@,L 84-92 ,240,30,75,0.4,23,53,0.434,7,22,0.318,17,21,0.81,84,40,95,0.421,34,82,0.415,6,13,0.462,6,10,0.6,92,2013-01-30,WAS,PHI,2013,95.0
12610,12610,10,@,L 84-97 ,240,36,95,0.379,33,76,0.434,3,19,0.158,9,9,1.0,84,42,84,0.5,38,66,0.576,4,18,0.222,9,14,0.643,97,2013-02-01,ORL,BOS,2013,99.0
12611,12611,11,@,L 84-93 ,240,35,78,0.449,34,63,0.54,1,15,0.067,13,15,0.867,84,39,75,0.52,35,61,0.574,4,14,0.286,11,17,0.647,93,2013-02-06,PHO,NOH,2013,95.0
12612,12612,12,Home,L 84-89 (OT),265,33,96,0.344,28,74,0.378,5,22,0.227,13,18,0.722,84,31,80,0.388,27,68,0.397,4,12,0.333,23,32,0.719,89,2013-02-11,IND,BRK,2013,91.0
12613,12613,13,Home,L 84-90 ,240,29,79,0.367,24,60,0.4,5,19,0.263,21,27,0.778,84,34,81,0.42,27,69,0.391,7,12,0.583,15,17,0.882,90,2013-02-25,TOR,WAS,2013,93.5
12614,12614,14,@,L 84-106 ,240,33,81,0.407,27,65,0.415,6,16,0.375,12,14,0.857,84,41,76,0.539,29,54,0.537,12,22,0.545,12,26,0.462,106,2013-02-26,CHA,LAC,2013,112.0
12615,12615,15,Home,L 84-98 ,240,32,81,0.395,25,60,0.417,7,21,0.333,13,18,0.722,84,41,76,0.539,36,63,0.571,5,13,0.385,11,16,0.688,98,2013-02-26,PHI,ORL,2013,100.5
12616,12616,16,Home,W 84-83 (OT),265,37,91,0.407,32,78,0.41,5,13,0.385,5,14,0.357,84,31,90,0.344,26,71,0.366,5,19,0.263,16,25,0.64,83,2013-02-26,PHO,MIN,2013,85.5
12617,12617,17,@,L 84-90 ,240,33,76,0.434,30,64,0.469,3,12,0.25,15,19,0.789,84,29,78,0.372,24,64,0.375,5,14,0.357,27,34,0.794,90,2013-02-27,DAL,MEM,2013,92.5
12618,12618,18,@,L 84-113 ,240,30,78,0.385,22,52,0.423,8,26,0.308,16,21,0.762,84,38,75,0.507,25,43,0.581,13,32,0.406,24,30,0.8,113,2013-03-09,UTA,NYK,2013,119.5
12619,12619,19,@,L 84-90 ,240,33,77,0.429,29,65,0.446,4,12,0.333,14,22,0.636,84,31,71,0.437,26,55,0.473,5,16,0.313,23,31,0.742,90,2013-03-16,MEM,UTA,2013,92.5
12620,12620,20,@,L 84-87 ,240,30,78,0.385,25,64,0.391,5,14,0.357,19,24,0.792,84,35,81,0.432,32,70,0.457,3,11,0.273,14,22,0.636,87,2013-03-23,IND,CHI,2013,88.5
12621,12621,21,@,L 84-110 ,240,34,76,0.447,30,53,0.566,4,23,0.174,12,18,0.667,84,41,79,0.519,34,60,0.567,7,19,0.368,21,23,0.913,110,2013-03-23,TOR,NYK,2013,113.5
12622,12622,22,@,L 84-98 ,240,35,90,0.389,29,73,0.397,6,17,0.353,8,9,0.889,84,40,90,0.444,30,61,0.492,10,29,0.345,8,13,0.615,98,2013-04-03,ORL,SAS,2013,103.0
12623,12623,23,@,L 84-86 ,240,38,86,0.442,35,72,0.486,3,14,0.214,5,7,0.714,84,34,74,0.459,29,54,0.537,5,20,0.25,13,18,0.722,86,2013-04-05,MEM,LAL,2013,88.5
12624,12624,24,Home,L 84-102 ,240,31,74,0.419,29,64,0.453,2,10,0.2,20,33,0.606,84,42,75,0.56,33,58,0.569,9,17,0.529,9,13,0.692,102,2013-04-15,ORL,CHI,2013,106.5
12625,12625,25,@,L 84-90 ,240,32,84,0.381,28,66,0.424,4,18,0.222,16,22,0.727,84,33,73,0.452,30,61,0.492,3,12,0.25,21,34,0.618,90,2013-11-01,CLE,CHA,2014,91.5
12626,12626,26,@,L 84-87 ,240,31,85,0.365,26,68,0.382,5,17,0.294,17,27,0.63,84,31,83,0.373,25,61,0.41,6,22,0.273,19,24,0.792,87,2013-11-01,UTA,PHO,2014,90.0
12627,12627,27,@,L 84-105 ,240,30,80,0.375,27,59,0.458,3,21,0.143,21,36,0.583,84,37,75,0.493,30,62,0.484,7,13,0.538,24,28,0.857,105,2013-11-02,CHA,NOP,2014,108.5
12628,12628,28,Home,L 84-99 ,240,34,71,0.479,30,56,0.536,4,15,0.267,12,14,0.857,84,38,78,0.487,34,65,0.523,4,13,0.308,19,21,0.905,99,2013-11-06,MEM,NOP,2014,101.0
12629,12629,29,@,L 84-91 ,240,32,81,0.395,26,63,0.413,6,18,0.333,14,16,0.875,84,36,78,0.462,30,57,0.526,6,21,0.286,13,16,0.813,91,2013-11-08,TOR,IND,2014,94.0
12630,12630,30,@,L 84-98 ,240,29,88,0.33,26,69,0.377,3,19,0.158,23,28,0.821,84,40,80,0.5,32,65,0.492,8,15,0.533,10,17,0.588,98,2013-11-25,MIN,IND,2014,102.0
12631,12631,31,Home,L 84-95 ,240,29,83,0.349,19,55,0.345,10,28,0.357,16,24,0.667,84,35,72,0.486,31,53,0.585,4,19,0.211,21,25,0.84,95,2013-11-27,CLE,MIA,2014,97.0
12632,12632,32,@,L 84-113 ,240,32,75,0.427,24,53,0.453,8,22,0.364,12,15,0.8,84,43,78,0.551,29,51,0.569,14,27,0.519,13,21,0.619,113,2013-11-27,ATL,HOU,2014,120.0
12633,12633,33,@,L 84-90 ,240,33,77,0.429,29,56,0.518,4,21,0.19,14,20,0.7,84,34,67,0.507,29,52,0.558,5,15,0.333,17,25,0.68,90,2013-12-10,MIA,IND,2014,92.5
12634,12634,34,Home,L 84-100 ,240,35,89,0.393,29,69,0.42,6,20,0.3,8,11,0.727,84,41,88,0.466,33,68,0.485,8,20,0.4,10,12,0.833,100,2013-12-14,UTA,SAS,2014,104.0
12635,12635,35,@,L 84-100 ,240,36,90,0.4,32,72,0.444,4,18,0.222,8,9,0.889,84,37,69,0.536,27,54,0.5,10,15,0.667,16,24,0.667,100,2013-12-21,CLE,CHI,2014,105.0
12636,12636,36,@,L 84-91 ,240,32,86,0.372,24,58,0.414,8,28,0.286,12,14,0.857,84,33,81,0.407,27,64,0.422,6,17,0.353,19,24,0.792,91,2014-01-04,ATL,CHI,2014,94.0
12637,12637,37,Home,L 84-112 ,240,35,86,0.407,31,69,0.449,4,17,0.235,10,20,0.5,84,43,92,0.467,35,77,0.455,8,15,0.533,18,22,0.818,112,2014-01-05,DET,MEM,2014,116.0
12638,12638,38,@,L 84-93 ,240,29,82,0.354,27,71,0.38,2,11,0.182,24,28,0.857,84,34,79,0.43,26,58,0.448,8,21,0.381,17,22,0.773,93,2014-02-09,SAC,WAS,2014,97.0
12639,12639,39,@,L 84-91 ,240,29,80,0.363,25,50,0.5,4,30,0.133,22,26,0.846,84,31,70,0.443,23,49,0.469,8,21,0.381,21,26,0.808,91,2014-03-07,BRK,BOS,2014,95.0
12640,12640,40,Home,W 84-83 ,240,30,81,0.37,23,67,0.343,7,14,0.5,17,21,0.81,84,28,61,0.459,22,42,0.524,6,19,0.316,21,29,0.724,83,2014-03-26,IND,MIA,2014,86.0
12641,12641,41,Home,L 84-89 ,240,28,79,0.354,18,48,0.375,10,31,0.323,18,22,0.818,84,32,80,0.4,23,55,0.418,9,25,0.36,16,18,0.889,89,2014-03-30,GSW,NYK,2014,93.5
12642,12642,42,@,L 84-101 ,240,32,84,0.381,28,73,0.384,4,11,0.364,16,21,0.762,84,41,101,0.406,37,84,0.44,4,17,0.235,15,31,0.484,101,2014-10-28,ORL,NOP,2015,103.0
12643,12643,43,@,L 84-103 ,240,30,83,0.361,27,64,0.422,3,19,0.158,21,32,0.656,84,35,80,0.438,26,58,0.448,9,22,0.409,24,31,0.774,103,2014-11-07,WAS,TOR,2015,107.5
12644,12644,44,Home,L 84-91 ,240,30,73,0.411,19,48,0.396,11,25,0.44,13,22,0.591,84,35,74,0.473,30,56,0.536,5,18,0.278,16,26,0.615,91,2014-11-16,MIA,MIL,2015,93.5
12645,12645,45,Home,L 84-102 ,240,32,86,0.372,30,72,0.417,2,14,0.143,18,24,0.75,84,34,69,0.493,27,45,0.6,7,24,0.292,27,34,0.794,102,2014-11-30,BRK,CHI,2015,105.5
12646,12646,46,@,L 84-96 ,240,34,93,0.366,28,58,0.483,6,35,0.171,10,13,0.769,84,36,87,0.414,26,60,0.433,10,27,0.37,14,19,0.737,96,2014-12-07,DEN,ATL,2015,101.0
12647,12647,47,@,L 84-93 ,240,30,78,0.385,25,61,0.41,5,17,0.294,19,28,0.679,84,41,84,0.488,37,71,0.521,4,13,0.308,7,12,0.583,93,2014-12-14,UTA,WAS,2015,95.0
12648,12648,48,@,L 84-100 ,240,33,83,0.398,27,60,0.45,6,23,0.261,12,15,0.8,84,37,78,0.474,31,57,0.544,6,21,0.286,20,26,0.769,100,2014-12-21,BOS,MIA,2015,103.0
12649,12649,49,@,L 84-96 ,240,33,83,0.398,29,63,0.46,4,20,0.2,14,19,0.737,84,39,78,0.5,34,63,0.54,5,15,0.333,13,18,0.722,96,2014-12-23,NOP,IND,2015,98.5
12650,12650,50,@,L 84-106 ,240,32,87,0.368,30,72,0.417,2,15,0.133,18,28,0.643,84,44,94,0.468,39,73,0.534,5,21,0.238,13,15,0.867,106,2014-12-31,SAC,BOS,2015,108.5
12651,12651,51,@,L 84-88 ,240,34,86,0.395,27,62,0.435,7,24,0.292,9,13,0.692,84,31,67,0.463,26,53,0.491,5,14,0.357,21,28,0.75,88,2015-01-04,BRK,MIA,2015,90.5
12652,12652,52,@,L 84-101 ,240,30,76,0.395,24,62,0.387,6,14,0.429,18,23,0.783,84,36,90,0.4,29,69,0.42,7,21,0.333,22,31,0.71,101,2015-01-09,ORL,LAL,2015,104.5
12653,12653,53,@,L 84-98 ,240,32,79,0.405,26,57,0.456,6,22,0.273,14,17,0.824,84,39,75,0.52,27,56,0.482,12,19,0.632,8,10,0.8,98,2015-01-09,MIN,MIL,2015,104.0
12654,12654,54,@,L 84-103 ,240,33,78,0.423,22,46,0.478,11,32,0.344,7,12,0.583,84,42,86,0.488,36,69,0.522,6,17,0.353,13,17,0.765,103,2015-01-11,CLE,SAC,2015,106.0
12655,12655,55,@,L 84-100 ,240,31,80,0.388,28,61,0.459,3,19,0.158,19,31,0.613,84,38,82,0.463,28,53,0.528,10,29,0.345,14,22,0.636,100,2015-01-14,PHI,TOR,2015,105.0
12656,12656,56,@,L 84-123 ,240,33,88,0.375,29,67,0.433,4,21,0.19,14,25,0.56,84,49,83,0.59,38,58,0.655,11,25,0.44,14,21,0.667,123,2015-01-22,BRK,LAC,2015,128.5
12657,12657,57,Home,L 84-92 ,240,35,84,0.417,33,75,0.44,2,9,0.222,12,17,0.706,84,40,80,0.5,37,76,0.487,3,4,0.75,9,14,0.643,92,2015-01-23,MIN,NOP,2015,93.5
12658,12658,58,Home,L 84-96 ,240,31,87,0.356,24,63,0.381,7,24,0.292,15,19,0.789,84,38,84,0.452,37,71,0.521,1,13,0.077,19,23,0.826,96,2015-01-25,CHI,MIA,2015,96.5
12659,12659,59,@,L 84-92 ,240,29,85,0.341,27,72,0.375,2,13,0.154,24,32,0.75,84,36,86,0.419,32,66,0.485,4,20,0.2,16,24,0.667,92,2015-01-26,MIN,OKC,2015,94.0
12660,12660,60,@,L 84-97 ,240,31,78,0.397,19,45,0.422,12,33,0.364,10,14,0.714,84,35,78,0.449,23,51,0.451,12,27,0.444,15,22,0.682,97,2015-02-02,PHI,CLE,2015,103.0
12661,12661,61,Home,L 84-89 ,240,33,79,0.418,26,55,0.473,7,24,0.292,11,14,0.786,84,34,85,0.4,27,56,0.482,7,29,0.241,14,19,0.737,89,2015-02-09,PHI,GSW,2015,92.5
12662,12662,62,@,L 84-95 ,240,29,69,0.42,24,50,0.48,5,19,0.263,21,28,0.75,84,44,88,0.5,40,70,0.571,4,18,0.222,3,6,0.5,95,2015-02-20,NOP,ORL,2015,97.0
12663,12663,63,@,L 84-85 ,240,34,75,0.453,31,56,0.554,3,19,0.158,13,21,0.619,84,33,88,0.375,25,61,0.41,8,27,0.296,11,20,0.55,85,2015-03-04,UTA,BOS,2015,89.0
12664,12664,64,@,L 84-98 ,240,31,86,0.36,26,63,0.413,5,23,0.217,17,19,0.895,84,34,80,0.425,28,60,0.467,6,20,0.3,24,33,0.727,98,2015-03-06,CHI,IND,2015,101.0
12665,12665,65,@,L 84-92 ,240,30,77,0.39,19,52,0.365,11,25,0.44,13,16,0.813,84,35,95,0.368,22,58,0.379,13,37,0.351,9,17,0.529,92,2015-03-07,ATL,PHI,2015,98.5
12666,12666,66,@,L 84-85 ,240,32,86,0.372,28,66,0.424,4,20,0.2,16,21,0.762,84,29,83,0.349,21,58,0.362,8,25,0.32,19,26,0.731,85,2015-03-17,MIL,NOP,2015,89.0
12667,12667,67,Home,L 84-88 ,240,34,82,0.415,30,60,0.5,4,22,0.182,12,24,0.5,84,33,63,0.524,27,52,0.519,6,11,0.545,16,23,0.696,88,2015-03-18,UTA,WAS,2015,91.0
12668,12668,68,Home,L 84-107 ,240,34,76,0.447,29,63,0.46,5,13,0.385,11,15,0.733,84,39,90,0.433,23,59,0.39,16,31,0.516,13,17,0.765,107,2015-03-27,MEM,GSW,2015,115.0
12669,12669,69,Home,L 84-104 ,240,28,76,0.368,22,60,0.367,6,16,0.375,22,27,0.815,84,39,82,0.476,29,49,0.592,10,33,0.303,16,18,0.889,104,2015-03-30,MIN,UTA,2015,109.0
12670,12670,70,@,L 84-98 ,240,33,95,0.347,26,62,0.419,7,33,0.212,11,12,0.917,84,37,77,0.481,28,54,0.519,9,23,0.391,15,24,0.625,98,2015-04-01,DEN,UTA,2015,102.5
12671,12671,71,Home,L 84-97 ,240,29,64,0.453,28,53,0.528,1,11,0.091,25,32,0.781,84,40,92,0.435,34,71,0.479,6,21,0.286,11,17,0.647,97,2015-04-03,MIN,ORL,2015,100.0
12672,12672,72,Home,L 84-94 ,240,32,89,0.36,28,76,0.368,4,13,0.308,16,21,0.762,84,39,79,0.494,35,66,0.53,4,13,0.308,12,17,0.706,94,2015-11-02,NYK,SAS,2016,96.0
12673,12673,73,Home,L 84-96 ,240,28,72,0.389,23,52,0.442,5,20,0.25,23,34,0.676,84,37,85,0.435,26,61,0.426,11,24,0.458,11,17,0.647,96,2015-11-05,DEN,UTA,2016,101.5
12674,12674,74,Home,L 84-96 ,240,30,85,0.353,26,73,0.356,4,12,0.333,20,22,0.909,84,37,76,0.487,33,62,0.532,4,14,0.286,18,25,0.72,96,2015-11-05,MIN,MIA,2016,98.0
12675,12675,75,@,L 84-97 ,240,31,78,0.397,21,45,0.467,10,33,0.303,12,17,0.706,84,34,77,0.442,23,52,0.442,11,25,0.44,18,22,0.818,97,2015-11-09,ORL,IND,2016,102.5
12676,12676,76,Home,L 84-100 ,240,24,70,0.343,21,55,0.382,3,15,0.2,33,36,0.917,84,36,75,0.48,25,48,0.521,11,27,0.407,17,23,0.739,100,2015-11-11,MEM,GSW,2016,105.5
12677,12677,77,Home,L 84-90 ,240,29,79,0.367,20,52,0.385,9,27,0.333,17,21,0.81,84,33,78,0.423,27,50,0.54,6,28,0.214,18,31,0.581,90,2015-11-13,NYK,CLE,2016,93.0
12678,12678,78,@,L 84-96 ,240,28,74,0.378,22,45,0.489,6,29,0.207,22,37,0.595,84,36,85,0.424,28,61,0.459,8,24,0.333,16,19,0.842,96,2015-11-20,HOU,MEM,2016,100.0
12679,12679,79,@,L 84-98 ,240,34,73,0.466,27,54,0.5,7,19,0.368,9,10,0.9,84,42,82,0.512,33,62,0.532,9,20,0.45,5,10,0.5,98,2015-11-23,PHO,SAS,2016,102.5
12680,12680,80,Home,W 84-80 ,240,31,91,0.341,22,62,0.355,9,29,0.31,13,18,0.722,84,31,83,0.373,24,56,0.429,7,27,0.259,11,15,0.733,80,2015-11-25,BOS,PHI,2016,83.5
12681,12681,81,@,W 84-82 ,240,31,72,0.431,20,48,0.417,11,24,0.458,11,14,0.786,84,27,82,0.329,20,59,0.339,7,23,0.304,21,27,0.778,82,2015-11-28,TOR,WAS,2016,85.5
12682,12682,82,@,L 84-92 ,240,30,77,0.39,18,41,0.439,12,36,0.333,12,16,0.75,84,34,81,0.42,30,68,0.441,4,13,0.308,20,27,0.741,92,2015-11-29,PHI,MEM,2016,94.0
12683,12683,83,@,L 84-99 ,240,31,85,0.365,25,57,0.439,6,28,0.214,16,24,0.667,84,37,68,0.544,30,52,0.577,7,16,0.438,18,29,0.621,99,2015-12-05,CLE,MIA,2016,102.5
12684,12684,84,@,L 84-104 ,240,32,87,0.368,22,53,0.415,10,34,0.294,10,22,0.455,84,36,84,0.429,28,58,0.483,8,26,0.308,24,35,0.686,104,2015-12-07,DET,CHO,2016,108.0
12685,12685,85,@,L 84-96 ,240,30,77,0.39,25,49,0.51,5,28,0.179,19,25,0.76,84,37,83,0.446,32,64,0.5,5,19,0.263,17,21,0.81,96,2015-12-19,IND,MEM,2016,98.5
12686,12686,86,@,L 84-91 ,240,32,82,0.39,27,66,0.409,5,16,0.313,15,16,0.938,84,32,83,0.386,27,61,0.443,5,22,0.227,22,25,0.88,91,2015-12-23,NYK,CLE,2016,93.5
12687,12687,87,@,L 84-88 ,240,36,88,0.409,31,68,0.456,5,20,0.25,7,8,0.875,84,32,74,0.432,25,59,0.424,7,15,0.467,17,26,0.654,88,2015-12-25,SAS,HOU,2016,91.5
12688,12688,88,Home,L 84-94 ,240,32,77,0.416,25,54,0.463,7,23,0.304,13,25,0.52,84,38,85,0.447,28,59,0.475,10,26,0.385,8,11,0.727,94,2015-12-25,LAL,LAC,2016,99.0
12689,12689,89,@,L 84-93 ,240,31,84,0.369,27,60,0.45,4,24,0.167,18,25,0.72,84,33,87,0.379,28,71,0.394,5,16,0.313,22,29,0.759,93,2016-01-01,PHI,LAL,2016,95.5
12690,12690,90,@,L 84-91 ,240,32,87,0.368,28,68,0.412,4,19,0.211,16,19,0.842,84,30,82,0.366,22,64,0.344,8,18,0.444,23,30,0.767,91,2016-01-08,DEN,MEM,2016,95.0
12691,12691,91,@,L 84-107 ,240,30,81,0.37,23,56,0.411,7,25,0.28,17,21,0.81,84,36,82,0.439,23,43,0.535,13,39,0.333,22,26,0.846,107,2016-01-13,ATL,CHO,2016,113.5
12692,12692,92,@,L 84-97 ,240,29,77,0.377,22,53,0.415,7,24,0.292,19,32,0.594,84,28,82,0.341,19,51,0.373,9,31,0.29,32,37,0.865,97,2016-01-23,NYK,CHO,2016,101.5
12693,12693,93,Home,L 84-89 ,240,35,88,0.398,30,70,0.429,5,18,0.278,9,12,0.75,84,37,81,0.457,34,67,0.507,3,14,0.214,12,17,0.706,89,2016-01-25,CHI,MIA,2016,90.5
12694,12694,94,@,L 84-102 ,240,35,85,0.412,28,59,0.475,7,26,0.269,7,12,0.583,84,36,84,0.429,29,64,0.453,7,20,0.35,23,26,0.885,102,2016-01-29,PHO,NYK,2016,105.5
12695,12695,95,Home,W 84-81 ,240,30,77,0.39,22,50,0.44,8,27,0.296,16,23,0.696,84,30,71,0.423,23,57,0.404,7,14,0.5,14,21,0.667,81,2016-02-05,UTA,MIL,2016,84.5
12696,12696,96,@,L 84-99 ,240,34,87,0.391,29,64,0.453,5,23,0.217,11,16,0.688,84,39,90,0.433,25,49,0.51,14,41,0.341,7,7,1.0,99,2016-02-06,NOP,CLE,2016,106.0
12697,12697,97,@,L 84-124 ,240,31,88,0.352,24,64,0.375,7,24,0.292,15,20,0.75,84,44,80,0.55,31,56,0.554,13,24,0.542,23,35,0.657,124,2016-02-22,PHO,LAC,2016,130.5
12698,12698,98,Home,L 84-102 ,240,35,101,0.347,28,74,0.378,7,27,0.259,7,14,0.5,84,35,78,0.449,30,64,0.469,5,14,0.357,27,39,0.692,102,2016-03-04,ORL,PHO,2016,104.5
12699,12699,99,Home,L 84-91 ,240,30,86,0.349,23,60,0.383,7,26,0.269,17,23,0.739,84,38,80,0.475,30,55,0.545,8,25,0.32,7,14,0.5,91,2016-03-08,UTA,ATL,2016,95.0
12700,12700,0,@,L 84-121 ,240,34,91,0.374,27,65,0.415,7,26,0.269,9,18,0.5,84,47,84,0.56,30,49,0.612,17,35,0.486,10,11,0.909,121,2016-03-12,ORL,POR,2016,129.5
12701,12701,1,@,L 84-92 ,240,35,85,0.412,31,69,0.449,4,16,0.25,10,14,0.714,84,36,79,0.456,29,59,0.492,7,20,0.35,13,15,0.867,92,2016-03-24,NOP,IND,2016,95.5
12702,12702,2,Home,L 84-93 ,240,32,84,0.381,28,73,0.384,4,11,0.364,16,19,0.842,84,39,83,0.47,30,62,0.484,9,21,0.429,6,7,0.857,93,2016-03-26,MIN,UTA,2016,97.5
12703,12703,3,Home,L 84-100 ,240,32,80,0.4,26,53,0.491,6,27,0.222,14,19,0.737,84,36,79,0.456,24,48,0.5,12,31,0.387,16,21,0.762,100,2016-04-10,DEN,UTA,2016,106.0
12704,12704,4,@,L 84-110 ,240,35,86,0.407,30,66,0.455,5,20,0.25,9,14,0.643,84,41,75,0.547,29,50,0.58,12,25,0.48,16,21,0.762,110,2016-04-12,MEM,LAC,2016,116.0
12705,12705,5,Home,L 84-109 ,240,31,77,0.403,24,56,0.429,7,21,0.333,15,22,0.682,84,43,85,0.506,32,66,0.485,11,19,0.579,12,20,0.6,109,2016-11-07,PHI,UTA,2017,114.5
12706,12706,6,@,L 84-107 ,240,27,75,0.36,20,49,0.408,7,26,0.269,23,30,0.767,84,40,81,0.494,34,62,0.548,6,19,0.316,21,25,0.84,107,2016-11-23,MIA,DET,2017,110.0
12707,12707,7,@,L 84-128 ,240,35,88,0.398,28,60,0.467,7,28,0.25,7,14,0.5,84,53,92,0.576,40,68,0.588,13,24,0.542,9,11,0.818,128,2016-12-03,ATL,TOR,2017,134.5
12708,12708,8,@,L 84-114 ,240,31,90,0.344,25,63,0.397,6,27,0.222,16,21,0.762,84,46,83,0.554,37,59,0.627,9,24,0.375,13,19,0.684,114,2016-12-09,MIA,CLE,2017,118.5
12709,12709,9,@,L 84-104 ,240,34,90,0.378,25,64,0.391,9,26,0.346,7,13,0.538,84,37,77,0.481,24,48,0.5,13,29,0.448,17,18,0.944,104,2016-12-10,SAC,UTA,2017,110.5
12710,12710,10,Home,L 84-92 ,240,34,82,0.415,27,56,0.482,7,26,0.269,9,13,0.692,84,35,83,0.422,26,54,0.481,9,29,0.31,13,14,0.929,92,2016-12-21,ATL,MIN,2017,96.5
12711,12711,11,@,L 84-105 ,240,31,75,0.413,25,58,0.431,6,17,0.353,16,20,0.8,84,44,91,0.484,37,67,0.552,7,24,0.292,10,15,0.667,105,2017-02-04,DET,IND,2017,108.5
12712,12712,12,@,L 84-99 ,240,32,79,0.405,25,53,0.472,7,26,0.269,13,19,0.684,84,37,79,0.468,23,42,0.548,14,37,0.378,11,12,0.917,99,2017-02-15,ATL,LAC,2017,106.0
12713,12713,13,@,L 84-97 ,240,35,83,0.422,27,50,0.54,8,33,0.242,6,9,0.667,84,41,78,0.526,36,65,0.554,5,13,0.385,10,14,0.714,97,2017-02-24,DAL,MIN,2017,99.5
12714,12714,14,@,L 83-101 ,240,30,77,0.39,24,61,0.393,6,16,0.375,17,22,0.773,83,32,75,0.427,23,52,0.442,9,23,0.391,28,35,0.8,101,2011-12-28,WAS,ATL,2012,105.5
12715,12715,15,Home,L 83-103 ,240,33,80,0.413,31,69,0.449,2,11,0.182,15,18,0.833,83,41,86,0.477,34,69,0.493,7,17,0.412,14,18,0.778,103,2011-12-28,PHO,PHI,2012,106.5
12716,12716,16,@,L 83-110 ,240,30,93,0.323,28,72,0.389,2,21,0.095,21,24,0.875,83,46,76,0.605,43,67,0.642,3,9,0.333,15,22,0.682,110,2012-01-04,SAC,DEN,2012,111.5
12717,12717,17,Home,L 83-99 ,240,36,88,0.409,35,82,0.427,1,6,0.167,10,12,0.833,83,40,76,0.526,35,64,0.547,5,12,0.417,14,21,0.667,99,2012-01-04,DET,CHI,2012,101.5
12718,12718,18,@,L 83-118 ,240,24,69,0.348,19,50,0.38,5,19,0.263,30,39,0.769,83,42,80,0.525,34,59,0.576,8,21,0.381,26,28,0.929,118,2012-01-04,IND,MIA,2012,122.0
12719,12719,19,Home,L 83-97 ,240,30,75,0.4,23,55,0.418,7,20,0.35,16,21,0.762,83,38,86,0.442,30,72,0.417,8,14,0.571,13,17,0.765,97,2012-01-06,ORL,CHI,2012,101.0
12720,12720,20,@,L 83-99 ,240,34,80,0.425,27,60,0.45,7,20,0.35,8,12,0.667,83,39,80,0.488,37,63,0.587,2,17,0.118,19,23,0.826,99,2012-01-10,PHO,LAL,2012,100.0
12721,12721,21,@,L 83-94 ,240,31,83,0.373,20,57,0.351,11,26,0.423,10,11,0.909,83,34,75,0.453,28,63,0.444,6,12,0.5,20,30,0.667,94,2012-01-12,NYK,MEM,2012,97.0
12722,12722,22,@,L 83-99 ,240,34,84,0.405,29,66,0.439,5,18,0.278,10,14,0.714,83,38,74,0.514,32,57,0.561,6,17,0.353,17,25,0.68,99,2012-01-13,POR,SAS,2012,102.0
12723,12723,23,@,L 83-97 ,240,32,83,0.386,27,68,0.397,5,15,0.333,14,18,0.778,83,35,94,0.372,30,78,0.385,5,16,0.313,22,23,0.957,97,2012-01-14,BOS,IND,2012,99.5
12724,12724,24,Home,L 83-85 (OT),265,29,87,0.333,25,66,0.379,4,21,0.19,21,27,0.778,83,36,84,0.429,34,67,0.507,2,17,0.118,11,18,0.611,85,2012-01-18,ORL,SAS,2012,86.0
12725,12725,25,@,W 83-81 ,240,32,79,0.405,28,53,0.528,4,26,0.154,15,20,0.75,83,29,79,0.367,27,60,0.45,2,19,0.105,21,32,0.656,81,2012-01-21,DAL,NOH,2012,82.0
12726,12726,26,@,L 83-103 ,240,32,74,0.432,32,67,0.478,0,7,0.0,19,27,0.704,83,43,83,0.518,37,67,0.552,6,16,0.375,11,20,0.55,103,2012-01-23,WAS,PHI,2012,106.0
12727,12727,27,Home,L 83-102 ,240,31,78,0.397,28,67,0.418,3,11,0.273,18,18,1.0,83,38,83,0.458,25,51,0.49,13,32,0.406,13,19,0.684,102,2012-01-24,IND,ORL,2012,108.5
12728,12728,28,@,L 83-105 ,240,35,80,0.438,29,63,0.46,6,17,0.353,7,10,0.7,83,42,82,0.512,31,59,0.525,11,23,0.478,10,15,0.667,105,2012-01-25,ATL,SAS,2012,110.5
12729,12729,29,Home,L 83-91 ,240,30,79,0.38,25,62,0.403,5,17,0.294,18,31,0.581,83,34,73,0.466,24,52,0.462,10,21,0.476,13,19,0.684,91,2012-01-26,ORL,BOS,2012,96.0
12730,12730,30,@,W 83-73 ,240,32,80,0.4,22,56,0.393,10,24,0.417,9,15,0.6,83,27,73,0.37,24,64,0.375,3,9,0.333,16,20,0.8,73,2012-01-30,SAS,MEM,2012,74.5
12731,12731,31,@,L 83-93 ,240,30,78,0.385,27,68,0.397,3,10,0.3,20,24,0.833,83,35,73,0.479,30,64,0.469,5,9,0.556,18,21,0.857,93,2012-02-14,HOU,MEM,2012,95.5
12732,12732,32,Home,W 83-78 ,240,31,78,0.397,24,61,0.393,7,17,0.412,14,20,0.7,83,31,82,0.378,24,50,0.48,7,32,0.219,9,13,0.692,78,2012-02-23,ATL,ORL,2012,81.5
12733,12733,33,Home,L 83-86 ,240,31,78,0.397,27,61,0.443,4,17,0.235,17,25,0.68,83,33,74,0.446,26,57,0.456,7,17,0.412,13,14,0.929,86,2012-02-28,CLE,BOS,2012,89.5
12734,12734,34,@,L 83-104 ,240,32,82,0.39,26,59,0.441,6,23,0.261,13,16,0.813,83,42,87,0.483,38,75,0.507,4,12,0.333,16,16,1.0,104,2012-02-29,HOU,UTA,2012,106.0
12735,12735,35,@,L 83-105 ,240,33,82,0.402,28,64,0.438,5,18,0.278,12,14,0.857,83,42,89,0.472,34,72,0.472,8,17,0.471,13,16,0.813,105,2012-03-02,GSW,PHI,2012,109.0
12736,12736,36,@,L 83-100 ,240,29,76,0.382,27,67,0.403,2,9,0.222,23,29,0.793,83,37,75,0.493,31,64,0.484,6,11,0.545,20,22,0.909,100,2012-03-03,DET,MEM,2012,103.0
12737,12737,37,@,L 83-93 ,240,33,88,0.375,26,64,0.406,7,24,0.292,10,15,0.667,83,35,71,0.493,30,54,0.556,5,17,0.294,18,25,0.72,93,2012-03-04,MIA,LAL,2012,95.5
12738,12738,38,Home,W 83-75 ,240,29,78,0.372,25,68,0.368,4,10,0.4,21,24,0.875,83,29,80,0.363,25,61,0.41,4,19,0.211,13,19,0.684,75,2012-03-04,TOR,GSW,2012,77.0
12739,12739,39,@,W 83-74 ,240,30,83,0.361,26,61,0.426,4,22,0.182,19,26,0.731,83,30,86,0.349,28,75,0.373,2,11,0.182,12,21,0.571,74,2012-03-09,BRK,CHA,2012,75.0
12740,12740,40,@,L 83-87 (OT),265,31,81,0.383,29,65,0.446,2,16,0.125,19,23,0.826,83,35,87,0.402,31,67,0.463,4,20,0.2,13,19,0.684,87,2012-03-18,DET,LAC,2012,89.0
12741,12741,41,@,L 83-109 ,240,34,82,0.415,28,66,0.424,6,16,0.375,9,10,0.9,83,40,85,0.471,34,68,0.5,6,17,0.353,23,27,0.852,109,2012-03-22,GSW,HOU,2012,112.0
12742,12742,42,Home,L 83-85 ,240,30,71,0.423,25,53,0.472,5,18,0.278,18,23,0.783,83,31,74,0.419,27,56,0.482,4,18,0.222,19,28,0.679,85,2012-03-22,WAS,IND,2012,87.0
12743,12743,43,Home,L 83-108 ,240,27,70,0.386,23,54,0.426,4,16,0.25,25,30,0.833,83,42,82,0.512,36,65,0.554,6,17,0.353,18,26,0.692,108,2012-03-25,CLE,PHO,2012,111.0
12744,12744,44,Home,L 83-88 ,240,31,78,0.397,28,65,0.431,3,13,0.231,18,22,0.818,83,33,81,0.407,25,60,0.417,8,21,0.381,14,20,0.7,88,2012-03-28,CHA,MIN,2012,92.0
12745,12745,45,Home,W 83-71 ,240,32,75,0.427,30,63,0.476,2,12,0.167,17,21,0.81,83,31,84,0.369,28,73,0.384,3,11,0.273,6,7,0.857,71,2012-03-30,CHI,DET,2012,72.5
12746,12746,46,@,L 83-102 ,240,28,79,0.354,21,58,0.362,7,21,0.333,20,22,0.909,83,37,90,0.411,31,70,0.443,6,20,0.3,22,26,0.846,102,2012-04-13,CLE,IND,2012,105.0
12747,12747,47,Home,W 83-72 ,240,32,76,0.421,28,63,0.444,4,13,0.308,15,21,0.714,83,25,70,0.357,23,54,0.426,2,16,0.125,20,28,0.714,72,2012-04-19,MIA,CHI,2012,73.0
12748,12748,48,@,L 83-93 ,240,31,79,0.392,27,64,0.422,4,15,0.267,17,19,0.895,83,38,84,0.452,29,64,0.453,9,20,0.45,8,12,0.667,93,2012-04-21,DAL,CHI,2012,97.5
12749,12749,49,@,W 83-81 ,240,31,71,0.437,29,66,0.439,2,5,0.4,19,31,0.613,83,33,79,0.418,27,65,0.415,6,14,0.429,9,13,0.692,81,2012-04-24,NOP,GSW,2012,84.0
12750,12750,50,Home,L 83-93 ,240,30,79,0.38,18,53,0.34,12,26,0.462,11,16,0.688,83,34,73,0.466,28,59,0.475,6,14,0.429,19,25,0.76,93,2012-11-10,TOR,PHI,2013,96.0
12751,12751,51,@,L 83-103 ,240,30,81,0.37,28,68,0.412,2,13,0.154,21,25,0.84,83,39,83,0.47,33,67,0.493,6,16,0.375,19,31,0.613,103,2012-11-16,DAL,IND,2013,106.0
12752,12752,52,@,W 83-76 ,240,31,82,0.378,29,73,0.397,2,9,0.222,19,27,0.704,83,31,85,0.365,26,69,0.377,5,16,0.313,9,12,0.75,76,2012-11-17,UTA,WAS,2013,78.5
12753,12753,53,@,L 83-103 ,240,32,71,0.451,28,54,0.519,4,17,0.235,15,19,0.789,83,39,72,0.542,35,61,0.574,4,11,0.364,21,26,0.808,103,2012-11-18,BOS,DET,2013,105.0
12754,12754,54,@,L 83-92 ,240,31,86,0.36,27,69,0.391,4,17,0.235,17,22,0.773,83,35,86,0.407,22,63,0.349,13,23,0.565,9,14,0.643,92,2012-11-21,PHI,CLE,2013,98.5
12755,12755,55,Home,L 83-95 ,240,32,75,0.427,31,68,0.456,1,7,0.143,18,24,0.75,83,33,82,0.402,23,58,0.397,10,24,0.417,19,29,0.655,95,2012-11-28,BOS,BRK,2013,100.0
12756,12756,56,Home,L 83-93 ,240,33,77,0.429,27,61,0.443,6,16,0.375,11,18,0.611,83,34,77,0.442,27,60,0.45,7,17,0.412,18,25,0.72,93,2012-12-08,MEM,ATL,2013,96.5
12757,12757,57,@,L 83-102 ,240,30,77,0.39,20,51,0.392,10,26,0.385,13,17,0.765,83,36,79,0.456,30,60,0.5,6,19,0.316,24,34,0.706,102,2012-12-09,TOR,LAC,2013,105.0
12758,12758,58,Home,W 83-82 ,240,33,75,0.44,31,65,0.477,2,10,0.2,15,19,0.789,83,29,75,0.387,22,56,0.393,7,19,0.368,17,22,0.773,82,2012-12-15,CHI,BRK,2013,85.5
12759,12759,59,@,L 83-90 ,240,34,77,0.442,25,60,0.417,9,17,0.529,6,8,0.75,83,34,81,0.42,26,61,0.426,8,20,0.4,14,17,0.824,90,2012-12-19,WAS,ORL,2013,94.0
12760,12760,60,Home,L 83-94 ,240,32,83,0.386,28,66,0.424,4,17,0.235,15,22,0.682,83,33,82,0.402,24,64,0.375,9,18,0.5,19,20,0.95,94,2012-12-26,UTA,GSW,2013,98.5
12761,12761,61,@,L 83-101 ,240,31,86,0.36,26,64,0.406,5,22,0.227,16,21,0.762,83,38,73,0.521,26,54,0.481,12,19,0.632,13,16,0.813,101,2012-12-29,BOS,GSW,2013,107.0
12762,12762,62,@,L 83-88 ,240,31,82,0.378,28,71,0.394,3,11,0.273,18,24,0.75,83,28,70,0.4,16,45,0.356,12,25,0.48,20,24,0.833,88,2012-12-31,MEM,IND,2013,94.0
12763,12763,63,Home,L 83-93 ,240,32,71,0.451,24,49,0.49,8,22,0.364,11,16,0.688,83,34,71,0.479,26,53,0.491,8,18,0.444,17,22,0.773,93,2013-01-02,BOS,MEM,2013,97.0
12764,12764,64,@,L 83-100 ,240,28,77,0.364,19,43,0.442,9,34,0.265,18,21,0.857,83,39,82,0.476,27,55,0.491,12,27,0.444,10,16,0.625,100,2013-01-03,SAS,NYK,2013,106.0
12765,12765,65,@,L 83-99 ,240,37,84,0.44,30,62,0.484,7,22,0.318,2,5,0.4,83,37,81,0.457,25,58,0.431,12,23,0.522,13,20,0.65,99,2013-01-09,ATL,CLE,2013,105.0
12766,12766,66,@,L 83-104 ,240,32,84,0.381,29,76,0.382,3,8,0.375,16,26,0.615,83,39,80,0.488,28,63,0.444,11,17,0.647,15,21,0.714,104,2013-01-12,MEM,DAL,2013,109.5
12767,12767,67,@,L 83-93 ,240,30,78,0.385,23,54,0.426,7,24,0.292,16,25,0.64,83,36,79,0.456,34,68,0.5,2,11,0.182,19,27,0.704,93,2013-01-12,ATL,WAS,2013,94.0
12768,12768,68,Home,L 83-87 ,240,31,86,0.36,25,65,0.385,6,21,0.286,15,18,0.833,83,32,71,0.451,26,48,0.542,6,23,0.261,17,22,0.773,87,2013-01-13,POR,OKC,2013,90.0
12769,12769,69,@,L 83-95 ,240,32,81,0.395,29,64,0.453,3,17,0.176,16,23,0.696,83,39,93,0.419,30,76,0.395,9,17,0.529,8,12,0.667,95,2013-01-21,LAL,CHI,2013,99.5
12770,12770,70,Home,L 83-91 ,240,38,83,0.458,35,68,0.515,3,15,0.2,4,6,0.667,83,37,84,0.44,31,64,0.484,6,20,0.3,11,16,0.688,91,2013-01-23,MIN,BRK,2013,94.0
12771,12771,71,@,L 83-96 ,240,29,66,0.439,26,51,0.51,3,15,0.2,22,29,0.759,83,42,82,0.512,36,65,0.554,6,17,0.353,6,9,0.667,96,2013-01-27,POR,LAC,2013,99.0
12772,12772,72,Home,L 83-91 ,240,32,88,0.364,29,72,0.403,3,16,0.188,16,18,0.889,83,33,77,0.429,24,57,0.421,9,20,0.45,16,23,0.696,91,2013-01-27,MEM,NOH,2013,95.5
12773,12773,73,Home,L 83-92 ,240,31,89,0.348,25,66,0.379,6,23,0.261,15,19,0.789,83,37,82,0.451,34,69,0.493,3,13,0.231,15,18,0.833,92,2013-02-05,BRK,LAL,2013,93.5
12774,12774,74,@,L 83-84 (OT),265,31,90,0.344,26,71,0.366,5,19,0.263,16,25,0.64,83,37,91,0.407,32,78,0.41,5,13,0.385,5,14,0.357,84,2013-02-26,MIN,PHO,2013,86.5
12775,12775,75,@,L 83-119 ,240,28,77,0.364,22,54,0.407,6,23,0.261,21,27,0.778,83,42,90,0.467,29,57,0.509,13,33,0.394,22,27,0.815,119,2013-03-03,CHA,SAC,2013,125.5
12776,12776,76,@,L 83-87 ,240,33,83,0.398,25,59,0.424,8,24,0.333,9,12,0.75,83,27,75,0.36,19,52,0.365,8,23,0.348,25,29,0.862,87,2013-03-06,SAC,GSW,2013,91.0
12777,12777,77,@,W 83-81 ,240,34,83,0.41,27,66,0.409,7,17,0.412,8,9,0.889,83,32,88,0.364,26,61,0.426,6,27,0.222,11,14,0.786,81,2013-03-06,BOS,IND,2013,84.0
12778,12778,78,@,L 83-101 ,240,33,90,0.367,24,70,0.343,9,20,0.45,8,8,1.0,83,40,74,0.541,32,60,0.533,8,14,0.571,13,18,0.722,101,2013-03-06,CHI,SAS,2013,105.0
12779,12779,79,@,L 83-107 ,240,29,82,0.354,20,53,0.377,9,29,0.31,16,18,0.889,83,44,82,0.537,32,62,0.516,12,20,0.6,7,18,0.389,107,2013-03-12,SAS,MIN,2013,113.0
12780,12780,80,Home,L 83-90 ,240,29,76,0.382,20,57,0.351,9,19,0.474,16,24,0.667,83,32,69,0.464,24,46,0.522,8,23,0.348,18,25,0.72,90,2013-03-18,UTA,NYK,2013,94.0
12781,12781,81,@,L 83-90 ,240,30,73,0.411,27,63,0.429,3,10,0.3,20,25,0.8,83,36,76,0.474,32,62,0.516,4,14,0.286,14,18,0.778,90,2013-03-22,MEM,NOH,2013,92.0
12782,12782,82,@,L 83-103 ,240,32,79,0.405,22,53,0.415,10,26,0.385,9,13,0.692,83,43,82,0.524,39,71,0.549,4,11,0.364,13,18,0.722,103,2013-03-24,POR,OKC,2013,105.0
12783,12783,83,@,L 83-88 ,240,33,94,0.351,29,78,0.372,4,16,0.25,13,16,0.813,83,35,81,0.432,31,67,0.463,4,14,0.286,14,16,0.875,88,2013-04-03,PHI,CHA,2013,90.0
12784,12784,84,@,L 83-101 ,240,29,76,0.382,17,46,0.37,12,30,0.4,13,18,0.722,83,41,89,0.461,29,53,0.547,12,36,0.333,7,8,0.875,101,2013-04-05,MIL,NYK,2013,107.0
12785,12785,85,@,L 83-95 ,240,32,77,0.416,30,65,0.462,2,12,0.167,17,20,0.85,83,39,77,0.506,28,51,0.549,11,26,0.423,6,11,0.545,95,2013-04-05,NOP,UTA,2013,100.5
12786,12786,86,@,L 83-100 ,240,30,83,0.361,27,73,0.37,3,10,0.3,20,23,0.87,83,36,76,0.474,30,57,0.526,6,19,0.316,22,29,0.759,100,2013-04-06,TOR,MIL,2013,103.0
12787,12787,87,@,L 83-104 ,240,30,80,0.375,23,66,0.348,7,14,0.5,16,20,0.8,83,42,93,0.452,37,73,0.507,5,20,0.25,15,23,0.652,104,2013-04-09,PHI,BRK,2013,106.5
12788,12788,88,@,L 83-94 ,240,33,75,0.44,24,50,0.48,9,25,0.36,8,14,0.571,83,38,88,0.432,30,53,0.566,8,35,0.229,10,10,1.0,94,2013-04-09,MIL,MIA,2013,98.0
12789,12789,89,@,L 83-96 ,240,33,90,0.367,29,80,0.363,4,10,0.4,13,20,0.65,83,36,76,0.474,27,51,0.529,9,25,0.36,15,24,0.625,96,2013-10-30,CHA,HOU,2014,100.5
12790,12790,90,@,L 83-90 ,240,34,74,0.459,29,58,0.5,5,16,0.313,10,12,0.833,83,36,71,0.507,33,58,0.569,3,13,0.231,15,17,0.882,90,2013-10-30,MIL,NYK,2014,91.5
12791,12791,91,Home,L 83-91 ,240,31,81,0.383,20,58,0.345,11,23,0.478,10,16,0.625,83,33,78,0.423,27,59,0.458,6,19,0.316,19,21,0.905,91,2013-11-09,MIL,DAL,2014,94.0
12792,12792,92,Home,L 83-89 ,240,29,77,0.377,22,56,0.393,7,21,0.333,18,25,0.72,83,30,82,0.366,27,70,0.386,3,12,0.25,26,30,0.867,89,2013-11-13,BOS,CHA,2014,90.5
12793,12793,93,@,L 83-89 (OT),265,31,79,0.392,30,66,0.455,1,13,0.077,20,28,0.714,83,33,85,0.388,26,68,0.382,7,17,0.412,16,19,0.842,89,2013-11-25,CHI,UTA,2014,92.5
12794,12794,94,Home,L 83-90 ,240,28,73,0.384,20,43,0.465,8,30,0.267,19,32,0.594,83,36,76,0.474,27,54,0.5,9,22,0.409,9,13,0.692,90,2013-11-29,TOR,MIA,2014,94.5
12795,12795,95,Home,L 83-113 ,240,29,73,0.397,25,57,0.439,4,16,0.25,21,31,0.677,83,44,77,0.571,28,50,0.56,16,27,0.593,9,11,0.818,113,2013-12-05,BRK,NYK,2014,121.0
12796,12796,96,@,L 83-105 ,240,27,76,0.355,25,60,0.417,2,16,0.125,27,34,0.794,83,37,83,0.446,31,55,0.564,6,28,0.214,25,39,0.641,105,2013-12-06,GSW,HOU,2014,108.0
12797,12797,97,@,L 83-121 ,240,30,70,0.429,20,45,0.444,10,25,0.4,13,20,0.65,83,44,83,0.53,27,49,0.551,17,34,0.5,16,19,0.842,121,2013-12-06,ORL,NYK,2014,129.5
12798,12798,98,Home,L 83-94 ,240,33,92,0.359,30,71,0.423,3,21,0.143,14,19,0.737,83,35,82,0.427,30,55,0.545,5,27,0.185,19,29,0.655,94,2013-12-09,PHI,LAC,2014,96.5
12799,12799,99,Home,L 83-92 ,240,31,84,0.369,27,67,0.403,4,17,0.235,17,18,0.944,83,38,90,0.422,31,71,0.437,7,19,0.368,9,9,1.0,92,2013-12-11,CHA,ORL,2014,95.5
12800,12800,0,Home,W 83-78 ,240,31,76,0.408,26,57,0.456,5,19,0.263,16,19,0.842,83,24,72,0.333,18,51,0.353,6,21,0.286,24,29,0.828,78,2013-12-11,NYK,CHI,2014,81.0
12801,12801,1,@,W 83-82 ,240,33,83,0.398,28,71,0.394,5,12,0.417,12,16,0.75,83,28,81,0.346,23,63,0.365,5,18,0.278,21,26,0.808,82,2013-12-16,ORL,CHI,2014,84.5
12802,12802,2,@,L 83-102 ,240,26,80,0.325,22,60,0.367,4,20,0.2,27,33,0.818,83,38,98,0.388,26,67,0.388,12,31,0.387,14,19,0.737,102,2013-12-21,LAL,GSW,2014,108.0
12803,12803,3,Home,L 83-95 ,240,30,79,0.38,20,60,0.333,10,19,0.526,13,21,0.619,83,31,73,0.425,21,45,0.467,10,28,0.357,23,33,0.697,95,2013-12-27,NYK,TOR,2014,100.0
12804,12804,4,Home,L 83-105 ,240,32,74,0.432,29,57,0.509,3,17,0.176,16,19,0.842,83,41,78,0.526,28,52,0.538,13,26,0.5,10,11,0.909,105,2013-12-28,CHI,DAL,2014,111.5
12805,12805,5,Home,W 83-80 ,240,34,80,0.425,26,59,0.441,8,21,0.381,7,9,0.778,83,31,84,0.369,24,70,0.343,7,14,0.5,11,15,0.733,80,2013-12-30,UTA,CHA,2014,83.5
12806,12806,6,Home,L 83-97 ,240,31,72,0.431,25,56,0.446,6,16,0.375,15,24,0.625,83,40,85,0.471,35,68,0.515,5,17,0.294,12,15,0.8,97,2014-01-07,CHA,WAS,2014,99.5
12807,12807,7,Home,W 83-80 ,240,32,86,0.372,23,54,0.426,9,32,0.281,10,11,0.909,83,29,70,0.414,23,51,0.451,6,19,0.316,16,22,0.727,80,2014-01-10,ATL,HOU,2014,83.0
12808,12808,8,@,L 83-103 ,240,26,78,0.333,18,51,0.353,8,27,0.296,23,29,0.793,83,41,80,0.513,38,66,0.576,3,14,0.214,18,19,0.947,103,2014-01-10,ORL,SAC,2014,104.5
12809,12809,9,@,L 83-88 ,240,30,78,0.385,19,54,0.352,11,24,0.458,12,25,0.48,83,29,84,0.345,25,67,0.373,4,17,0.235,26,36,0.722,88,2014-01-15,TOR,BOS,2014,90.0
12810,12810,10,Home,L 83-101 ,240,32,75,0.427,27,48,0.563,5,27,0.185,14,19,0.737,83,43,80,0.538,38,67,0.567,5,13,0.385,10,13,0.769,101,2014-01-24,BOS,OKC,2014,103.5
12811,12811,11,@,L 83-98 ,240,28,84,0.333,22,65,0.338,6,19,0.316,21,26,0.808,83,37,87,0.425,23,56,0.411,14,31,0.452,10,13,0.769,98,2014-01-29,ORL,TOR,2014,105.0
12812,12812,12,@,L 83-91 (OT),265,33,86,0.384,30,72,0.417,3,14,0.214,14,16,0.875,83,35,88,0.398,25,68,0.368,10,20,0.5,11,18,0.611,91,2014-02-09,MEM,CLE,2014,96.0
12813,12813,13,@,L 83-104 ,240,30,78,0.385,26,58,0.448,4,20,0.2,19,23,0.826,83,38,94,0.404,27,61,0.443,11,33,0.333,17,22,0.773,104,2014-02-12,ATL,TOR,2014,109.5
12814,12814,14,Home,L 83-96 ,240,30,78,0.385,28,60,0.467,2,18,0.111,21,26,0.808,83,41,96,0.427,33,76,0.434,8,20,0.4,6,10,0.6,96,2014-02-23,CLE,WAS,2014,100.0
12815,12815,15,@,L 83-103 ,240,30,84,0.357,25,63,0.397,5,21,0.238,18,22,0.818,83,37,83,0.446,32,69,0.464,5,14,0.357,24,30,0.8,103,2014-02-26,GSW,CHI,2014,105.5
12816,12816,16,@,L 83-94 ,240,32,91,0.352,29,72,0.403,3,19,0.158,16,19,0.842,83,40,73,0.548,36,57,0.632,4,16,0.25,10,13,0.769,94,2014-03-11,BOS,IND,2014,96.0
12817,12817,17,Home,L 83-97 ,240,30,85,0.353,21,60,0.35,9,25,0.36,14,16,0.875,83,39,85,0.459,26,51,0.51,13,34,0.382,6,7,0.857,97,2014-03-17,CHA,ATL,2014,103.5
12818,12818,18,@,L 83-84 ,240,28,61,0.459,22,42,0.524,6,19,0.316,21,29,0.724,83,30,81,0.37,23,67,0.343,7,14,0.5,17,21,0.81,84,2014-03-26,MIA,IND,2014,87.5
12819,12819,19,@,L 83-107 ,240,31,82,0.378,24,54,0.444,7,28,0.25,14,16,0.875,83,43,86,0.5,34,64,0.531,9,22,0.409,12,16,0.75,107,2014-03-26,ATL,MIN,2014,111.5
12820,12820,20,@,L 83-93 ,240,35,70,0.5,27,44,0.614,8,26,0.308,5,10,0.5,83,34,66,0.515,27,41,0.659,7,25,0.28,18,22,0.818,93,2014-03-31,TOR,MIA,2014,96.5
12821,12821,21,Home,L 83-92 ,240,33,85,0.388,25,61,0.41,8,24,0.333,9,15,0.6,83,33,70,0.471,24,41,0.585,9,29,0.31,17,24,0.708,92,2014-03-31,UTA,NYK,2014,96.5
12822,12822,22,Home,L 83-95 ,240,36,87,0.414,32,63,0.508,4,24,0.167,7,13,0.538,83,40,72,0.556,31,49,0.633,9,23,0.391,6,11,0.545,95,2014-04-08,UTA,DAL,2014,99.5
12823,12823,23,Home,L 83-98 ,240,30,81,0.37,22,66,0.333,8,15,0.533,15,19,0.789,83,39,80,0.488,31,62,0.5,8,18,0.444,12,19,0.632,98,2014-11-04,NYK,WAS,2015,102.0
12824,12824,24,Home,L 83-95 ,240,29,70,0.414,20,47,0.426,9,23,0.391,16,26,0.615,83,31,72,0.431,22,45,0.489,9,27,0.333,24,27,0.889,95,2014-11-17,BRK,MIA,2015,99.5
12825,12825,25,Home,L 83-106 ,240,31,84,0.369,24,61,0.393,7,23,0.304,14,20,0.7,83,38,85,0.447,26,54,0.481,12,31,0.387,18,20,0.9,106,2014-11-22,IND,PHO,2015,112.0
12826,12826,26,@,L 83-91 ,240,30,75,0.4,22,49,0.449,8,26,0.308,15,25,0.6,83,33,66,0.5,27,49,0.551,6,17,0.353,19,21,0.905,91,2014-11-22,PHI,NYK,2015,94.0
12827,12827,27,@,L 83-98 ,240,31,70,0.443,24,52,0.462,7,18,0.389,14,16,0.875,83,41,94,0.436,37,78,0.474,4,16,0.25,12,14,0.857,98,2014-11-28,ORL,IND,2015,100.0
12828,12828,28,Home,W 83-80 ,240,35,76,0.461,30,64,0.469,5,12,0.417,8,12,0.667,83,30,81,0.37,24,64,0.375,6,17,0.353,14,21,0.667,80,2014-11-29,WAS,NOP,2015,83.0
12829,12829,29,@,L 83-102 ,240,29,76,0.382,26,58,0.448,3,18,0.167,22,26,0.846,83,38,88,0.432,21,45,0.467,17,43,0.395,9,14,0.643,102,2014-12-31,CHA,HOU,2015,110.5
12830,12830,30,@,L 83-111 ,240,35,88,0.398,29,59,0.492,6,29,0.207,7,11,0.636,83,44,83,0.53,37,68,0.544,7,15,0.467,16,20,0.8,111,2015-01-02,HOU,NOP,2015,114.5
12831,12831,31,@,L 83-105 ,240,33,76,0.434,25,50,0.5,8,26,0.308,9,13,0.692,83,43,82,0.524,36,67,0.537,7,15,0.467,12,19,0.632,105,2015-01-05,NYK,MEM,2015,108.5
12832,12832,32,@,L 83-104 ,240,29,89,0.326,20,59,0.339,9,30,0.3,16,23,0.696,83,36,92,0.391,26,73,0.356,10,19,0.526,22,28,0.786,104,2015-01-07,OKC,SAC,2015,109.0
12833,12833,33,@,L 83-99 ,240,29,77,0.377,26,63,0.413,3,14,0.214,22,30,0.733,83,40,95,0.421,32,68,0.471,8,27,0.296,11,15,0.733,99,2015-01-08,MIA,POR,2015,103.0
12834,12834,34,Home,L 83-95 ,240,32,75,0.427,25,59,0.424,7,16,0.438,12,14,0.857,83,35,74,0.473,27,57,0.474,8,17,0.471,17,21,0.81,95,2015-01-16,SAC,MIA,2015,99.0
12835,12835,35,@,L 83-101 ,240,31,81,0.383,22,57,0.386,9,24,0.375,12,22,0.545,83,37,79,0.468,31,65,0.477,6,14,0.429,21,25,0.84,101,2015-01-24,PHI,MEM,2015,104.0
12836,12836,36,@,W 83-75 ,240,32,77,0.416,28,56,0.5,4,21,0.19,15,21,0.714,83,30,81,0.37,26,62,0.419,4,19,0.211,11,18,0.611,75,2015-02-01,MIA,BOS,2015,77.0
12837,12837,37,@,L 83-85 ,240,33,91,0.363,28,63,0.444,5,28,0.179,12,17,0.706,83,34,75,0.453,30,63,0.476,4,12,0.333,13,21,0.619,85,2015-02-08,PHO,SAC,2015,87.0
12838,12838,38,@,L 83-89 ,240,25,73,0.342,20,58,0.345,5,15,0.333,28,36,0.778,83,31,67,0.463,27,56,0.482,4,11,0.364,23,28,0.821,89,2015-02-11,NYK,ORL,2015,91.0
12839,12839,39,Home,L 83-101 ,240,37,99,0.374,34,80,0.425,3,19,0.158,6,7,0.857,83,40,79,0.506,28,46,0.609,12,33,0.364,9,15,0.6,101,2015-02-22,NYK,CLE,2015,107.0
12840,12840,40,Home,L 83-98 ,240,31,85,0.365,25,70,0.357,6,15,0.4,15,20,0.75,83,40,80,0.5,32,62,0.516,8,18,0.444,10,14,0.714,98,2015-03-01,ORL,CHO,2015,102.0
12841,12841,41,Home,L 83-89 ,240,32,88,0.364,22,56,0.393,10,32,0.313,9,18,0.5,83,27,71,0.38,21,59,0.356,6,12,0.5,29,41,0.707,89,2015-03-06,PHI,UTA,2015,92.0
12842,12842,42,@,L 83-96 ,240,30,72,0.417,25,53,0.472,5,19,0.263,18,27,0.667,83,37,78,0.474,29,64,0.453,8,14,0.571,14,16,0.875,96,2015-03-14,MIL,MEM,2015,100.0
12843,12843,43,@,L 83-94 ,240,29,88,0.33,21,62,0.339,8,26,0.308,17,19,0.895,83,36,84,0.429,25,57,0.439,11,27,0.407,11,18,0.611,94,2015-03-18,DET,PHI,2015,99.5
12844,12844,44,Home,L 83-95 ,240,32,78,0.41,29,62,0.468,3,16,0.188,16,20,0.8,83,39,90,0.433,29,59,0.492,10,31,0.323,7,10,0.7,95,2015-03-25,ORL,ATL,2015,100.0
12845,12845,45,@,L 83-94 ,240,29,84,0.345,25,67,0.373,4,17,0.235,21,29,0.724,83,36,75,0.48,29,57,0.509,7,18,0.389,15,21,0.714,94,2015-03-27,LAL,TOR,2015,97.5
12846,12846,46,@,L 83-97 ,240,33,81,0.407,28,65,0.431,5,16,0.313,12,20,0.6,83,38,83,0.458,30,60,0.5,8,23,0.348,13,17,0.765,97,2015-03-30,SAC,MEM,2015,101.0
12847,12847,47,Home,L 83-92 ,240,34,81,0.42,33,66,0.5,1,15,0.067,14,18,0.778,83,38,79,0.481,30,57,0.526,8,22,0.364,8,10,0.8,92,2015-04-04,MEM,WAS,2015,96.0
12848,12848,48,@,L 83-95 ,240,32,78,0.41,24,54,0.444,8,24,0.333,11,15,0.733,83,36,76,0.474,34,67,0.507,2,9,0.222,21,26,0.808,95,2015-04-15,IND,MEM,2015,96.0
12849,12849,49,Home,L 83-99 ,240,30,73,0.411,24,56,0.429,6,17,0.353,17,23,0.739,83,38,86,0.442,31,56,0.554,7,30,0.233,16,19,0.842,99,2015-11-10,MIL,BOS,2016,102.5
12850,12850,50,@,L 83-92 ,240,33,82,0.402,25,60,0.417,8,22,0.364,9,11,0.818,83,33,85,0.388,28,69,0.406,5,16,0.313,21,25,0.84,92,2015-11-14,PHI,SAS,2016,94.5
12851,12851,51,@,L 83-88 ,240,34,83,0.41,28,61,0.459,6,22,0.273,9,12,0.75,83,33,81,0.407,25,53,0.472,8,28,0.286,14,19,0.737,88,2015-11-25,DAL,SAS,2016,92.0
12852,12852,52,@,L 83-87 ,240,34,101,0.337,28,77,0.364,6,24,0.25,9,21,0.429,83,35,81,0.432,31,69,0.449,4,12,0.333,13,16,0.813,87,2015-11-29,DET,BRK,2016,89.0
12853,12853,53,Home,L 83-103 ,240,30,80,0.375,28,64,0.438,2,16,0.125,21,25,0.84,83,40,80,0.5,30,62,0.484,10,18,0.556,13,18,0.722,103,2015-12-03,MEM,SAS,2016,108.0
12854,12854,54,Home,W 83-80 ,240,31,87,0.356,24,64,0.375,7,23,0.304,14,16,0.875,83,30,88,0.341,20,66,0.303,10,22,0.455,10,12,0.833,80,2015-12-10,CHI,LAC,2016,85.0
12855,12855,55,@,L 83-96 ,240,35,81,0.432,30,61,0.492,5,20,0.25,8,13,0.615,83,36,86,0.419,30,58,0.517,6,28,0.214,18,20,0.9,96,2015-12-11,MIA,IND,2016,99.0
12856,12856,56,@,L 83-90 ,240,33,80,0.413,29,69,0.42,4,11,0.364,13,16,0.813,83,34,70,0.486,27,50,0.54,7,20,0.35,15,23,0.652,90,2015-12-11,MIL,TOR,2016,93.5
12857,12857,57,Home,L 83-108 ,240,30,72,0.417,27,62,0.435,3,10,0.3,20,25,0.8,83,44,82,0.537,34,58,0.586,10,24,0.417,10,14,0.714,108,2015-12-23,MIN,SAS,2016,113.0
12858,12858,58,@,L 83-89 ,240,30,95,0.316,25,65,0.385,5,30,0.167,18,25,0.72,83,32,78,0.41,27,60,0.45,5,18,0.278,20,27,0.741,89,2015-12-25,CLE,GSW,2016,91.5
12859,12859,59,@,W 83-77 ,240,33,83,0.398,20,55,0.364,13,28,0.464,4,6,0.667,83,29,73,0.397,22,51,0.431,7,22,0.318,12,20,0.6,77,2016-01-08,ORL,BRK,2016,80.5
12860,12860,60,@,L 83-97 ,240,31,84,0.369,24,61,0.393,7,23,0.304,14,19,0.737,83,40,91,0.44,32,60,0.533,8,31,0.258,9,10,0.9,97,2016-01-09,CHA,LAC,2016,101.0
12861,12861,61,@,L 83-98 ,240,34,82,0.415,28,63,0.444,6,19,0.316,9,17,0.529,83,39,71,0.549,30,51,0.588,9,20,0.45,11,18,0.611,98,2016-01-09,MIA,UTA,2016,102.5
12862,12862,62,@,W 83-77 ,240,30,77,0.39,22,55,0.4,8,22,0.364,15,17,0.882,83,31,86,0.36,29,67,0.433,2,19,0.105,13,15,0.867,77,2016-01-15,DAL,CHI,2016,78.0
12863,12863,63,@,L 83-112 ,240,29,81,0.358,23,58,0.397,6,23,0.261,19,25,0.76,83,42,90,0.467,37,70,0.529,5,20,0.25,23,28,0.821,112,2016-01-17,DAL,SAS,2016,114.5
12864,12864,64,Home,L 83-96 ,240,35,94,0.372,31,70,0.443,4,24,0.167,9,22,0.409,83,38,87,0.437,31,70,0.443,7,17,0.412,13,15,0.867,96,2016-01-23,CLE,CHI,2016,99.5
12865,12865,65,Home,L 83-85 ,240,33,79,0.418,23,56,0.411,10,23,0.435,7,14,0.5,83,33,85,0.388,28,58,0.483,5,27,0.185,14,21,0.667,85,2016-01-27,ATL,LAC,2016,87.5
12866,12866,66,@,L 83-103 ,240,29,79,0.367,28,63,0.444,1,16,0.063,24,27,0.889,83,38,80,0.475,28,52,0.538,10,28,0.357,17,20,0.85,103,2016-01-28,MIL,MEM,2016,108.0
12867,12867,67,@,L 83-108 ,240,32,81,0.395,29,61,0.475,3,20,0.15,16,24,0.667,83,42,90,0.467,30,63,0.476,12,27,0.444,12,16,0.75,108,2016-03-04,WAS,CLE,2016,114.0
12868,12868,68,@,L 83-95 ,240,33,95,0.347,27,72,0.375,6,23,0.261,11,14,0.786,83,36,84,0.429,25,50,0.5,11,34,0.324,12,17,0.706,95,2016-03-12,MEM,ATL,2016,100.5
12869,12869,69,@,L 83-98 ,240,34,87,0.391,30,70,0.429,4,17,0.235,11,14,0.786,83,39,88,0.443,34,68,0.5,5,20,0.25,15,20,0.75,98,2016-10-30,MIL,DET,2017,100.5
12870,12870,70,Home,L 83-85 ,240,34,87,0.391,27,65,0.415,7,22,0.318,8,18,0.444,83,34,84,0.405,29,64,0.453,5,20,0.25,12,20,0.6,85,2016-11-02,LAC,OKC,2017,87.5
12871,12871,71,@,L 83-89 (OT),265,30,81,0.37,19,47,0.404,11,34,0.324,12,16,0.75,83,33,94,0.351,25,67,0.373,8,27,0.296,15,20,0.75,89,2016-11-02,NOP,MEM,2017,93.0
12872,12872,72,@,L 83-90 ,240,34,83,0.41,26,60,0.433,8,23,0.348,7,10,0.7,83,33,76,0.434,26,55,0.473,7,21,0.333,17,23,0.739,90,2016-11-16,DAL,BOS,2017,93.5
12873,12873,73,Home,L 83-120 ,240,33,103,0.32,27,80,0.338,6,23,0.261,11,12,0.917,83,40,90,0.444,27,54,0.5,13,36,0.361,27,32,0.844,120,2016-11-21,IND,GSW,2017,126.5
12874,12874,74,@,L 83-108 ,240,28,88,0.318,19,61,0.311,9,27,0.333,18,31,0.581,83,39,79,0.494,31,53,0.585,8,26,0.308,22,31,0.71,108,2016-11-23,DEN,UTA,2017,112.0
12875,12875,75,Home,L 83-95 ,240,28,76,0.368,23,56,0.411,5,20,0.25,22,26,0.846,83,39,86,0.453,33,71,0.465,6,15,0.4,11,12,0.917,95,2016-11-29,SAS,ORL,2017,98.0
12876,12876,76,@,L 83-100 ,240,35,87,0.402,29,63,0.46,6,24,0.25,7,8,0.875,83,35,73,0.479,20,47,0.426,15,26,0.577,15,28,0.536,100,2016-12-29,PHI,UTA,2017,107.5
12877,12877,77,@,L 83-105 ,240,30,86,0.349,22,57,0.386,8,29,0.276,15,26,0.577,83,38,85,0.447,24,40,0.6,14,45,0.311,15,22,0.682,105,2017-01-31,SAC,HOU,2017,112.0
12878,12878,78,@,L 83-96 ,240,31,77,0.403,26,54,0.481,5,23,0.217,16,25,0.64,83,36,78,0.462,24,52,0.462,12,26,0.462,12,16,0.75,96,2017-02-25,NOP,DAL,2017,102.0
12879,12879,79,@,L 83-88 ,240,30,84,0.357,20,51,0.392,10,33,0.303,13,18,0.722,83,33,81,0.407,23,54,0.426,10,27,0.37,12,15,0.8,88,2017-03-06,NOP,UTA,2017,93.0
12880,12880,80,@,L 82-95 ,240,34,73,0.466,31,66,0.47,3,7,0.429,11,19,0.579,82,35,88,0.398,25,55,0.455,10,33,0.303,15,22,0.682,95,2011-12-26,MEM,SAS,2012,100.0
12881,12881,81,@,L 82-99 ,240,21,67,0.313,15,45,0.333,6,22,0.273,34,41,0.829,82,38,73,0.521,29,57,0.509,9,16,0.563,14,22,0.636,99,2011-12-29,NYK,LAL,2012,103.5
12882,12882,82,@,L 82-98 ,240,27,71,0.38,20,49,0.408,7,22,0.318,21,28,0.75,82,38,78,0.487,22,52,0.423,16,26,0.615,6,11,0.545,98,2012-01-01,BRK,CLE,2012,106.0
12883,12883,83,@,L 82-99 ,240,29,77,0.377,22,53,0.415,7,24,0.292,17,21,0.81,82,36,85,0.424,26,63,0.413,10,22,0.455,17,24,0.708,99,2012-01-01,DAL,MIN,2012,104.0
12884,12884,84,@,L 82-90 ,240,38,93,0.409,37,84,0.44,1,9,0.111,5,10,0.5,82,35,74,0.473,29,55,0.527,6,19,0.316,14,21,0.667,90,2012-01-08,MEM,LAL,2012,93.0
12885,12885,85,@,W 82-70 ,240,32,83,0.386,26,66,0.394,6,17,0.353,12,16,0.75,82,30,88,0.341,29,75,0.387,1,13,0.077,9,11,0.818,70,2012-01-10,HOU,CHA,2012,70.5
12886,12886,86,@,L 82-94 ,240,35,75,0.467,32,61,0.525,3,14,0.214,9,14,0.643,82,37,84,0.44,26,61,0.426,11,23,0.478,9,13,0.692,94,2012-01-16,MIL,PHI,2012,99.5
12887,12887,87,Home,L 82-91 ,240,25,67,0.373,22,55,0.4,3,12,0.25,29,35,0.829,82,28,80,0.35,23,50,0.46,5,30,0.167,30,34,0.882,91,2012-01-22,MIA,MIL,2012,93.5
12888,12888,88,@,L 82-103 ,240,32,83,0.386,31,74,0.419,1,9,0.111,17,20,0.85,82,36,70,0.514,26,53,0.491,10,17,0.588,21,26,0.808,103,2012-01-30,DET,MIL,2012,108.0
12889,12889,89,@,L 82-98 ,240,32,74,0.432,25,57,0.439,7,17,0.412,11,16,0.688,82,40,84,0.476,36,73,0.493,4,11,0.364,14,19,0.737,98,2012-02-01,CHI,PHI,2012,100.0
12890,12890,90,@,W 82-75 ,240,31,81,0.383,26,67,0.388,5,14,0.357,15,18,0.833,82,29,86,0.337,28,72,0.389,1,14,0.071,16,19,0.842,75,2012-02-17,DAL,PHI,2012,75.5
12891,12891,91,@,L 82-99 ,240,32,81,0.395,24,52,0.462,8,29,0.276,10,18,0.556,82,38,80,0.475,30,58,0.517,8,22,0.364,15,24,0.625,99,2012-02-22,ATL,NYK,2012,103.0
12892,12892,92,Home,L 82-85 ,240,31,92,0.337,27,74,0.365,4,18,0.222,16,26,0.615,82,34,83,0.41,33,71,0.465,1,12,0.083,16,17,0.941,85,2012-02-29,ATL,GSW,2012,85.5
12893,12893,93,@,L 82-96 ,240,29,68,0.426,21,43,0.488,8,25,0.32,16,20,0.8,82,38,70,0.543,28,50,0.56,10,20,0.5,10,17,0.588,96,2012-03-14,ATL,LAC,2012,101.0
12894,12894,94,@,W 82-79 ,240,29,79,0.367,27,66,0.409,2,13,0.154,22,28,0.786,82,29,75,0.387,21,58,0.362,8,17,0.471,13,18,0.722,79,2012-03-21,NYK,PHI,2012,83.0
12895,12895,95,Home,L 82-94 ,240,35,85,0.412,34,77,0.442,1,8,0.125,11,11,1.0,82,36,82,0.439,29,66,0.439,7,16,0.438,15,23,0.652,94,2012-03-21,TOR,CHI,2012,97.5
12896,12896,96,@,L 82-94 ,240,32,82,0.39,29,72,0.403,3,10,0.3,15,24,0.625,82,36,77,0.468,32,62,0.516,4,15,0.267,18,21,0.857,94,2012-03-28,UTA,BOS,2012,96.0
12897,12897,97,Home,L 82-97 ,240,33,82,0.402,29,64,0.453,4,18,0.222,12,16,0.75,82,38,82,0.463,30,65,0.462,8,17,0.471,13,17,0.765,97,2012-04-06,MIA,MEM,2012,101.0
12898,12898,98,Home,L 82-88 ,240,31,78,0.397,26,65,0.4,5,13,0.385,15,20,0.75,82,29,80,0.363,23,60,0.383,6,20,0.3,24,31,0.774,88,2012-04-07,PHI,ORL,2012,91.0
12899,12899,99,Home,L 82-95 ,240,31,77,0.403,26,56,0.464,5,21,0.238,15,22,0.682,82,39,91,0.429,27,60,0.45,12,31,0.387,5,10,0.5,95,2012-04-12,MIN,LAC,2012,101.0
12900,12900,0,@,L 82-105 ,240,33,74,0.446,28,57,0.491,5,17,0.294,11,19,0.579,82,44,85,0.518,42,71,0.592,2,14,0.143,15,17,0.882,105,2012-04-13,CHA,MIA,2012,106.0
12901,12901,1,Home,L 82-94 ,240,32,87,0.368,26,65,0.4,6,22,0.273,12,14,0.857,82,37,81,0.457,32,67,0.478,5,14,0.357,15,22,0.682,94,2012-04-14,BRK,BOS,2012,96.5
12902,12902,2,Home,L 82-94 ,240,32,79,0.405,29,66,0.439,3,13,0.231,15,20,0.75,82,39,80,0.488,34,65,0.523,5,15,0.333,11,17,0.647,94,2012-04-15,CHA,BOS,2012,96.5
12903,12903,3,Home,L 82-89 ,240,29,88,0.33,26,71,0.366,3,17,0.176,21,25,0.84,82,32,75,0.427,27,57,0.474,5,18,0.278,20,23,0.87,89,2012-11-03,CHI,NOH,2013,91.5
12904,12904,4,@,L 82-96 ,240,32,80,0.4,25,60,0.417,7,20,0.35,11,16,0.688,82,33,82,0.402,24,56,0.429,9,26,0.346,21,26,0.808,96,2012-11-10,DET,HOU,2013,100.5
12905,12905,5,Home,W 82-74 ,240,29,78,0.372,22,54,0.407,7,24,0.292,17,25,0.68,82,30,84,0.357,29,71,0.408,1,13,0.077,13,18,0.722,74,2012-11-11,BRK,ORL,2013,74.5
12906,12906,6,Home,L 82-90 ,240,29,80,0.363,25,64,0.391,4,16,0.25,20,25,0.8,82,30,65,0.462,26,50,0.52,4,15,0.267,26,32,0.813,90,2012-11-12,DAL,MIN,2013,92.0
12907,12907,7,Home,L 82-84 ,240,31,74,0.419,25,54,0.463,6,20,0.3,14,22,0.636,82,35,90,0.389,28,70,0.4,7,20,0.35,7,11,0.636,84,2012-11-13,LAL,SAS,2013,87.5
12908,12908,8,@,L 82-103 ,240,29,74,0.392,24,57,0.421,5,17,0.294,19,24,0.792,82,38,80,0.475,30,62,0.484,8,18,0.444,19,28,0.679,103,2012-11-28,TOR,MEM,2013,107.0
12909,12909,9,@,L 82-84 ,240,30,86,0.349,20,55,0.364,10,31,0.323,12,18,0.667,82,31,71,0.437,26,59,0.441,5,12,0.417,17,19,0.895,84,2012-11-28,POR,WAS,2013,86.5
12910,12910,10,@,L 82-91 ,240,30,80,0.375,26,65,0.4,4,15,0.267,18,21,0.857,82,32,79,0.405,28,58,0.483,4,21,0.19,23,28,0.821,91,2012-12-07,ORL,SAC,2013,93.0
12911,12911,11,Home,W 82-80 ,240,34,89,0.382,29,67,0.433,5,22,0.227,9,11,0.818,82,33,73,0.452,31,63,0.492,2,10,0.2,12,12,1.0,80,2012-12-12,PHO,MEM,2013,81.0
12912,12912,12,@,L 82-83 ,240,29,75,0.387,22,56,0.393,7,19,0.368,17,22,0.773,82,33,75,0.44,31,65,0.477,2,10,0.2,15,19,0.789,83,2012-12-15,BRK,CHI,2013,84.0
12913,12913,13,@,L 82-92 ,240,31,76,0.408,25,55,0.455,6,21,0.286,14,17,0.824,82,36,89,0.404,33,76,0.434,3,13,0.231,17,20,0.85,92,2012-12-21,DAL,MEM,2013,93.5
12914,12914,14,Home,L 82-94 ,240,31,79,0.392,27,59,0.458,4,20,0.2,16,23,0.696,82,38,88,0.432,33,71,0.465,5,17,0.294,13,16,0.813,94,2012-12-22,MIL,CLE,2013,96.5
12915,12915,15,@,L 82-103 ,240,29,69,0.42,28,60,0.467,1,9,0.111,23,28,0.821,82,44,76,0.579,35,58,0.603,9,18,0.5,6,10,0.6,103,2013-01-16,MEM,SAS,2013,107.5
12916,12916,16,Home,L 82-85 (OT),265,31,85,0.365,28,71,0.394,3,14,0.214,17,21,0.81,82,34,84,0.405,34,79,0.43,0,5,0.0,17,28,0.607,85,2013-01-19,CHI,MEM,2013,85.0
12917,12917,17,@,W 82-81 ,240,34,69,0.493,26,52,0.5,8,17,0.471,6,11,0.545,82,35,83,0.422,31,73,0.425,4,10,0.4,7,7,1.0,81,2013-01-21,IND,MEM,2013,83.0
12918,12918,18,@,L 82-85 ,240,34,82,0.415,30,69,0.435,4,13,0.308,10,14,0.714,82,31,71,0.437,28,57,0.491,3,14,0.214,20,26,0.769,85,2013-01-23,DET,CHI,2013,86.5
12919,12919,19,Home,L 82-100 ,240,31,80,0.388,28,60,0.467,3,20,0.15,17,20,0.85,82,34,71,0.479,23,50,0.46,11,21,0.524,21,26,0.808,100,2013-01-25,NOP,HOU,2013,105.5
12920,12920,20,Home,L 82-88 ,240,26,71,0.366,18,53,0.34,8,18,0.444,22,26,0.846,82,29,80,0.363,23,67,0.343,6,13,0.462,24,34,0.706,88,2013-02-20,TOR,MEM,2013,91.0
12921,12921,21,@,L 82-114 ,240,29,82,0.354,26,63,0.413,3,19,0.158,21,37,0.568,82,41,73,0.562,31,59,0.525,10,14,0.714,22,33,0.667,114,2013-02-22,DET,IND,2013,119.0
12922,12922,22,@,L 82-88 ,240,35,84,0.417,30,69,0.435,5,15,0.333,7,9,0.778,82,34,76,0.447,31,60,0.517,3,16,0.188,17,29,0.586,88,2013-02-22,ORL,MEM,2013,89.5
12923,12923,23,@,L 82-93 ,240,33,85,0.388,29,74,0.392,4,11,0.364,12,21,0.571,82,32,83,0.386,29,69,0.42,3,14,0.214,26,33,0.788,93,2013-02-28,PHI,CHI,2013,94.5
12924,12924,24,Home,L 82-108 ,240,29,73,0.397,27,58,0.466,2,15,0.133,22,26,0.846,82,44,83,0.53,33,59,0.559,11,24,0.458,9,15,0.6,108,2013-03-03,ORL,MEM,2013,113.5
12925,12925,25,@,L 82-87 ,240,29,65,0.446,23,46,0.5,6,19,0.316,18,22,0.818,82,31,76,0.408,27,62,0.435,4,14,0.286,21,31,0.677,87,2013-03-06,WAS,MIN,2013,89.0
12926,12926,26,Home,L 82-119 ,240,34,78,0.436,33,60,0.55,1,18,0.056,13,15,0.867,82,45,83,0.542,36,62,0.581,9,21,0.429,20,23,0.87,119,2013-03-18,DET,BRK,2013,123.5
12927,12927,27,Home,L 82-105 ,240,32,79,0.405,25,59,0.424,7,20,0.35,11,13,0.846,82,42,79,0.532,28,53,0.528,14,26,0.538,7,8,0.875,105,2013-03-26,DET,MIN,2013,112.0
12928,12928,28,Home,L 82-99 ,240,31,76,0.408,26,58,0.448,5,18,0.278,15,23,0.652,82,44,82,0.537,40,69,0.58,4,13,0.308,7,9,0.778,99,2013-03-29,DET,TOR,2013,101.0
12929,12929,29,Home,L 82-95 ,240,32,66,0.485,23,40,0.575,9,26,0.346,9,19,0.474,82,40,77,0.519,33,55,0.6,7,22,0.318,8,12,0.667,95,2013-04-03,ATL,NYK,2013,98.5
12930,12930,30,@,W 82-78 ,240,29,83,0.349,24,66,0.364,5,17,0.294,19,28,0.679,82,23,74,0.311,12,42,0.286,11,32,0.344,21,28,0.75,78,2013-04-12,MEM,HOU,2013,83.5
12931,12931,31,Home,W 82-81 ,240,31,76,0.408,28,60,0.467,3,16,0.188,17,19,0.895,82,31,86,0.36,22,62,0.355,9,24,0.375,10,14,0.714,81,2013-10-31,CHI,NYK,2014,85.5
12932,12932,32,Home,L 82-91 ,240,35,91,0.385,30,75,0.4,5,16,0.313,7,11,0.636,82,35,76,0.461,31,61,0.508,4,15,0.267,17,22,0.773,91,2013-11-15,UTA,SAS,2014,93.0
12933,12933,33,Home,L 82-91 ,240,35,80,0.438,30,66,0.455,5,14,0.357,7,12,0.583,82,35,86,0.407,24,55,0.436,11,31,0.355,10,15,0.667,91,2013-11-20,MIL,POR,2014,96.5
12934,12934,34,Home,L 82-97 ,240,35,69,0.507,30,58,0.517,5,11,0.455,7,9,0.778,82,38,81,0.469,32,64,0.5,6,17,0.353,15,18,0.833,97,2013-11-22,BOS,IND,2014,100.0
12935,12935,35,@,L 82-121 ,240,32,81,0.395,28,69,0.406,4,12,0.333,14,23,0.609,82,48,82,0.585,40,61,0.656,8,21,0.381,17,19,0.895,121,2013-11-24,CHI,LAC,2014,125.0
12936,12936,36,@,L 82-89 ,240,30,78,0.385,27,61,0.443,3,17,0.176,19,25,0.76,82,33,82,0.402,25,61,0.41,8,21,0.381,15,17,0.882,89,2013-12-03,CHA,DAL,2014,93.0
12937,12937,37,@,L 82-88 ,240,28,87,0.322,21,52,0.404,7,35,0.2,19,26,0.731,82,31,83,0.373,27,69,0.391,4,14,0.286,22,30,0.733,88,2013-12-07,LAC,CLE,2014,90.0
12938,12938,38,Home,L 82-108 ,240,31,85,0.365,29,75,0.387,2,10,0.2,18,22,0.818,82,44,88,0.5,36,70,0.514,8,18,0.444,12,14,0.857,108,2013-12-07,MEM,GSW,2014,112.0
12939,12939,39,Home,L 82-90 ,240,30,73,0.411,23,53,0.434,7,20,0.35,15,22,0.682,82,34,74,0.459,29,56,0.518,5,18,0.278,17,23,0.739,90,2013-12-07,MIL,BRK,2014,92.5
12940,12940,40,Home,L 82-103 ,240,24,82,0.293,19,60,0.317,5,22,0.227,29,39,0.744,82,43,78,0.551,39,60,0.65,4,18,0.222,13,19,0.684,103,2013-12-07,MIN,MIA,2014,105.0
12941,12941,41,Home,L 82-83 ,240,28,81,0.346,23,63,0.365,5,18,0.278,21,26,0.808,82,33,83,0.398,28,71,0.394,5,12,0.417,12,16,0.75,83,2013-12-16,CHI,ORL,2014,85.5
12942,12942,42,Home,L 82-86 ,240,28,86,0.326,21,71,0.296,7,15,0.467,19,20,0.95,82,33,82,0.402,25,61,0.41,8,21,0.381,12,15,0.8,86,2013-12-18,ORL,UTA,2014,90.0
12943,12943,43,@,L 82-106 ,240,31,77,0.403,24,56,0.429,7,21,0.333,13,17,0.765,82,43,86,0.5,34,67,0.507,9,19,0.474,11,17,0.647,106,2013-12-28,DET,WAS,2014,110.5
12944,12944,44,@,L 82-95 ,240,32,74,0.432,27,60,0.45,5,14,0.357,13,20,0.65,82,34,78,0.436,27,59,0.458,7,19,0.368,20,23,0.87,95,2014-01-01,IND,TOR,2014,98.5
12945,12945,45,@,L 82-94 ,240,32,81,0.395,30,69,0.435,2,12,0.167,16,23,0.696,82,35,84,0.417,33,69,0.478,2,15,0.133,22,28,0.786,94,2014-01-02,BOS,CHI,2014,95.0
12946,12946,46,@,L 82-89 ,240,29,79,0.367,19,57,0.333,10,22,0.455,14,20,0.7,82,31,71,0.437,23,47,0.489,8,24,0.333,19,22,0.864,89,2014-01-04,CLE,BRK,2014,93.0
12947,12947,47,@,L 82-99 ,240,31,68,0.456,28,59,0.475,3,9,0.333,17,26,0.654,82,39,83,0.47,32,61,0.525,7,22,0.318,14,19,0.737,99,2014-01-04,NOP,IND,2014,102.5
12948,12948,48,@,W 82-78 ,240,28,77,0.364,20,53,0.377,8,24,0.333,18,22,0.818,82,27,79,0.342,21,59,0.356,6,20,0.3,18,20,0.9,78,2014-01-05,IND,CLE,2014,81.0
12949,12949,49,@,W 82-77 ,240,33,82,0.402,28,62,0.452,5,20,0.25,11,18,0.611,82,31,82,0.378,25,62,0.403,6,20,0.3,9,12,0.75,77,2014-01-15,MEM,MIL,2014,80.0
12950,12950,50,@,L 82-110 ,240,33,88,0.375,27,67,0.403,6,21,0.286,10,17,0.588,82,43,76,0.566,32,58,0.552,11,18,0.611,13,21,0.619,110,2014-01-19,MIL,SAS,2014,115.5
12951,12951,51,@,L 82-108 ,240,31,83,0.373,27,60,0.45,4,23,0.174,16,22,0.727,82,45,74,0.608,39,59,0.661,6,15,0.4,12,18,0.667,108,2014-02-27,NYK,MIA,2014,111.0
12952,12952,52,@,L 82-92 ,240,33,90,0.367,30,73,0.411,3,17,0.176,13,15,0.867,82,34,73,0.466,25,53,0.472,9,20,0.45,15,15,1.0,92,2014-02-28,CHA,SAS,2014,96.5
12953,12953,53,Home,W 82-71 ,240,33,75,0.44,28,62,0.452,5,13,0.385,11,17,0.647,82,27,74,0.365,21,59,0.356,6,15,0.4,11,14,0.786,71,2014-03-22,MEM,IND,2014,74.0
12954,12954,54,@,L 82-101 ,240,31,85,0.365,22,64,0.344,9,21,0.429,11,14,0.786,82,37,75,0.493,29,50,0.58,8,25,0.32,19,25,0.76,101,2014-11-04,CLE,POR,2015,105.0
12955,12955,55,Home,L 82-105 ,240,29,68,0.426,20,40,0.5,9,28,0.321,15,19,0.789,82,42,88,0.477,33,64,0.516,9,24,0.375,12,14,0.857,105,2014-11-07,UTA,DAL,2015,109.5
12956,12956,56,@,L 82-124 ,240,27,74,0.365,21,54,0.389,6,20,0.3,22,32,0.688,82,45,86,0.523,30,61,0.492,15,25,0.6,19,24,0.792,124,2014-11-21,MIL,TOR,2015,131.5
12957,12957,57,@,L 82-97 ,240,31,70,0.443,28,54,0.519,3,16,0.188,17,28,0.607,82,40,83,0.482,28,57,0.491,12,26,0.462,5,10,0.5,97,2014-11-26,UTA,OKC,2015,103.0
12958,12958,58,@,L 82-88 ,240,36,91,0.396,31,73,0.425,5,18,0.278,5,8,0.625,82,33,83,0.398,29,62,0.468,4,21,0.19,18,23,0.783,88,2014-12-04,IND,POR,2015,90.0
12959,12959,59,@,L 82-102 ,240,30,82,0.366,23,60,0.383,7,22,0.318,15,21,0.714,82,38,85,0.447,30,62,0.484,8,23,0.348,18,27,0.667,102,2014-12-10,MIA,DEN,2015,106.0
12960,12960,60,@,L 82-90 ,240,31,80,0.388,21,45,0.467,10,35,0.286,10,12,0.833,82,32,81,0.395,31,69,0.449,1,12,0.083,25,33,0.758,90,2014-12-10,POR,MIN,2015,90.5
12961,12961,61,@,L 82-95 ,240,36,74,0.486,32,59,0.542,4,15,0.267,6,8,0.75,82,37,83,0.446,26,53,0.491,11,30,0.367,10,15,0.667,95,2014-12-15,ORL,TOR,2015,100.5
12962,12962,62,@,L 82-110 ,240,31,82,0.378,29,64,0.453,2,18,0.111,18,24,0.75,82,43,80,0.538,35,61,0.574,8,19,0.421,16,24,0.667,110,2014-12-22,DEN,CHO,2015,114.0
12963,12963,63,Home,L 82-96 ,240,33,86,0.384,25,61,0.41,8,25,0.32,8,15,0.533,82,36,83,0.434,30,69,0.435,6,14,0.429,18,21,0.857,96,2014-12-30,CHI,BRK,2015,99.0
12964,12964,64,Home,L 82-95 ,240,31,76,0.408,22,51,0.431,9,25,0.36,11,14,0.786,82,35,77,0.455,31,61,0.508,4,16,0.25,21,27,0.778,95,2015-01-04,NYK,MIL,2015,97.0
12965,12965,65,@,L 82-97 ,240,29,70,0.414,24,53,0.453,5,17,0.294,19,21,0.905,82,33,77,0.429,20,43,0.465,13,34,0.382,18,21,0.857,97,2015-01-10,UTA,HOU,2015,103.5
12966,12966,66,Home,L 82-110 ,240,33,85,0.388,25,56,0.446,8,29,0.276,8,9,0.889,82,39,78,0.5,32,62,0.516,7,16,0.438,25,33,0.758,110,2015-01-10,NYK,CHO,2015,113.5
12967,12967,67,@,L 82-93 ,240,29,82,0.354,20,47,0.426,9,35,0.257,15,26,0.577,82,37,84,0.44,28,54,0.519,9,30,0.3,10,14,0.714,93,2015-01-19,DET,ATL,2015,97.5
12968,12968,68,@,L 82-103 ,240,34,81,0.42,29,65,0.446,5,16,0.313,9,13,0.692,82,42,79,0.532,36,61,0.59,6,18,0.333,13,18,0.722,103,2015-01-29,NYK,IND,2015,106.0
12969,12969,69,@,W 82-75 ,240,33,80,0.413,26,64,0.406,7,16,0.438,9,17,0.529,82,25,78,0.321,18,51,0.353,7,27,0.259,18,22,0.818,75,2015-02-02,MIL,TOR,2015,78.5
12970,12970,70,@,L 82-87 ,240,31,93,0.333,24,65,0.369,7,28,0.25,13,16,0.813,82,32,74,0.432,28,61,0.459,4,13,0.308,19,24,0.792,87,2015-02-08,SAS,TOR,2015,89.0
12971,12971,71,@,L 82-87 ,240,30,80,0.375,19,51,0.373,11,29,0.379,11,21,0.524,82,28,75,0.373,18,47,0.383,10,28,0.357,21,26,0.808,87,2015-02-11,UTA,DAL,2015,92.0
12972,12972,72,Home,L 82-110 ,240,31,94,0.33,24,67,0.358,7,27,0.259,13,22,0.591,82,43,92,0.467,39,71,0.549,4,21,0.19,20,23,0.87,110,2015-02-23,DEN,BRK,2015,112.0
12973,12973,73,Home,L 82-104 ,240,28,84,0.333,20,52,0.385,8,32,0.25,18,29,0.621,82,39,68,0.574,30,47,0.638,9,21,0.429,17,21,0.81,104,2015-02-27,DEN,UTA,2015,108.5
12974,12974,74,Home,W 82-75 ,240,29,76,0.382,23,54,0.426,6,22,0.273,18,23,0.783,82,29,74,0.392,24,59,0.407,5,15,0.333,12,14,0.857,75,2015-02-28,UTA,MIL,2015,77.5
12975,12975,75,Home,L 82-93 ,240,33,82,0.402,30,71,0.423,3,11,0.273,13,19,0.684,82,36,80,0.45,31,55,0.564,5,25,0.2,16,19,0.842,93,2015-03-03,MEM,UTA,2015,95.5
12976,12976,76,@,L 82-105 ,240,30,76,0.395,24,60,0.4,6,16,0.375,16,23,0.696,82,38,80,0.475,28,58,0.483,10,22,0.455,19,24,0.792,105,2015-03-04,NYK,IND,2015,110.0
12977,12977,77,@,L 82-87 ,240,31,79,0.392,26,66,0.394,5,13,0.385,15,17,0.882,82,30,70,0.429,24,52,0.462,6,18,0.333,21,29,0.724,87,2015-03-10,NYK,UTA,2015,90.0
12978,12978,78,Home,L 82-103 ,240,32,76,0.421,28,58,0.483,4,18,0.222,14,17,0.824,82,41,79,0.519,34,67,0.507,7,12,0.583,14,19,0.737,103,2015-03-23,NYK,MEM,2015,106.5
12979,12979,79,@,L 82-88 ,240,32,74,0.432,26,55,0.473,6,19,0.316,12,15,0.8,82,33,85,0.388,29,68,0.426,4,17,0.235,18,21,0.857,88,2015-04-03,DET,CHI,2015,90.0
12980,12980,80,Home,L 82-94 ,240,33,86,0.384,28,64,0.438,5,22,0.227,11,17,0.647,82,38,88,0.432,31,65,0.477,7,23,0.304,11,12,0.917,94,2015-11-03,DET,IND,2016,97.5
12981,12981,81,@,L 82-90 ,240,29,88,0.33,20,61,0.328,9,27,0.333,15,18,0.833,82,30,82,0.366,23,55,0.418,7,27,0.259,23,29,0.793,90,2015-11-13,LAL,DAL,2016,93.5
12982,12982,82,@,L 82-92 ,240,32,74,0.432,31,65,0.477,1,9,0.111,17,17,1.0,82,34,72,0.472,27,51,0.529,7,21,0.333,17,22,0.773,92,2015-11-21,MEM,SAS,2016,95.5
12983,12983,83,Home,L 82-84 ,240,27,82,0.329,20,59,0.339,7,23,0.304,21,27,0.778,82,31,72,0.431,20,48,0.417,11,24,0.458,11,14,0.786,84,2015-11-28,WAS,TOR,2016,89.5
12984,12984,84,@,L 82-87 ,240,33,82,0.402,25,54,0.463,8,28,0.286,8,14,0.571,82,27,70,0.386,12,39,0.308,15,31,0.484,18,22,0.818,87,2015-11-29,MIL,CHO,2016,94.5
12985,12985,85,Home,L 82-105 ,240,31,80,0.388,24,61,0.393,7,19,0.368,13,16,0.813,82,41,76,0.539,32,55,0.582,9,21,0.429,14,20,0.7,105,2015-12-14,BRK,ORL,2016,109.5
12986,12986,86,@,L 82-106 ,240,32,88,0.364,25,57,0.439,7,31,0.226,11,14,0.786,82,46,82,0.561,38,64,0.594,8,18,0.444,6,9,0.667,106,2016-01-01,DAL,MIA,2016,110.0
12987,12987,87,@,L 82-94 ,240,33,93,0.355,30,73,0.411,3,20,0.15,13,23,0.565,82,33,73,0.452,26,55,0.473,7,18,0.389,21,29,0.724,94,2016-01-02,DET,IND,2016,97.5
12988,12988,88,@,L 82-109 ,240,31,90,0.344,22,67,0.328,9,23,0.391,11,18,0.611,82,41,83,0.494,29,59,0.492,12,24,0.5,15,18,0.833,109,2016-01-16,LAL,UTA,2016,115.0
12989,12989,89,Home,L 82-101 ,240,27,80,0.338,19,51,0.373,8,29,0.276,20,23,0.87,82,36,96,0.375,23,60,0.383,13,36,0.361,16,26,0.615,101,2016-01-31,LAL,CHO,2016,107.5
12990,12990,90,@,L 82-88 ,240,31,82,0.378,25,61,0.41,6,21,0.286,14,22,0.636,82,33,87,0.379,29,68,0.426,4,19,0.211,18,20,0.9,88,2016-03-29,OKC,DET,2016,90.0
12991,12991,91,@,L 82-108 ,240,33,95,0.347,25,69,0.362,8,26,0.308,8,12,0.667,82,48,95,0.505,41,76,0.539,7,19,0.368,5,6,0.833,108,2016-10-28,ORL,DET,2017,111.5
12992,12992,92,@,L 82-114 ,240,30,82,0.366,26,70,0.371,4,12,0.333,18,26,0.692,82,41,76,0.539,28,51,0.549,13,25,0.52,19,22,0.864,114,2016-11-07,DET,LAC,2017,120.5
12993,12993,93,@,L 82-89 ,240,30,82,0.366,23,61,0.377,7,21,0.333,15,19,0.789,82,34,88,0.386,24,61,0.393,10,27,0.37,11,19,0.579,89,2016-11-16,NOP,ORL,2017,94.0
12994,12994,94,@,L 82-107 ,240,32,71,0.451,29,58,0.5,3,13,0.231,15,21,0.714,82,40,87,0.46,27,56,0.482,13,31,0.419,14,18,0.778,107,2016-12-03,CHI,DAL,2017,113.5
12995,12995,95,@,W 82-73 ,240,30,66,0.455,22,39,0.564,8,27,0.296,14,25,0.56,82,28,93,0.301,26,70,0.371,2,23,0.087,15,18,0.833,73,2016-12-18,UTA,MEM,2017,74.0
12996,12996,96,@,L 82-113 ,240,34,83,0.41,31,60,0.517,3,23,0.13,11,13,0.846,82,49,82,0.598,41,66,0.621,8,16,0.5,7,7,1.0,113,2016-12-19,DET,CHI,2017,117.0
12997,12997,97,@,L 82-91 ,240,33,82,0.402,23,54,0.426,10,28,0.357,6,13,0.462,82,36,93,0.387,31,67,0.463,5,26,0.192,14,18,0.778,91,2016-12-29,MIA,CHO,2017,93.5
12998,12998,98,@,L 82-90 ,240,32,88,0.364,21,62,0.339,11,26,0.423,7,10,0.7,82,34,90,0.378,28,59,0.475,6,31,0.194,16,22,0.727,90,2017-01-02,NOP,CLE,2017,93.0
12999,12999,99,@,L 82-110 ,240,31,83,0.373,27,65,0.415,4,18,0.222,16,22,0.727,82,43,78,0.551,30,54,0.556,13,24,0.542,11,15,0.733,110,2017-01-03,TOR,SAS,2017,116.5
13000,13000,0,Home,L 82-97 ,240,32,82,0.39,23,46,0.5,9,36,0.25,9,10,0.9,82,30,74,0.405,19,52,0.365,11,22,0.5,26,32,0.813,97,2017-01-07,DAL,ATL,2017,102.5
13001,13001,1,@,L 81-102 ,240,30,85,0.353,23,67,0.343,7,18,0.389,14,19,0.737,81,39,73,0.534,31,53,0.585,8,20,0.4,16,25,0.64,102,2011-12-30,WAS,MIL,2012,106.0
13002,13002,2,@,L 81-96 ,240,26,64,0.406,20,53,0.377,6,11,0.545,23,28,0.821,81,32,74,0.432,24,55,0.436,8,19,0.421,24,29,0.828,96,2012-01-07,NOP,DAL,2012,100.0
13003,13003,3,Home,L 81-94 ,240,29,71,0.408,21,48,0.438,8,23,0.348,15,21,0.714,81,39,75,0.52,33,65,0.508,6,10,0.6,10,14,0.714,94,2012-01-09,DEN,NOH,2012,97.0
13004,13004,4,@,L 81-111 ,240,33,78,0.423,32,70,0.457,1,8,0.125,14,16,0.875,81,42,90,0.467,36,71,0.507,6,19,0.316,21,28,0.75,111,2012-01-12,CHA,ATL,2012,114.0
13005,13005,5,Home,L 81-98 ,240,33,74,0.446,32,66,0.485,1,8,0.125,14,16,0.875,81,40,82,0.488,33,68,0.485,7,14,0.5,11,16,0.688,98,2012-01-13,CHA,DET,2012,101.5
13006,13006,6,Home,L 81-98 ,240,29,66,0.439,25,56,0.446,4,10,0.4,19,26,0.731,81,39,68,0.574,34,59,0.576,5,9,0.556,15,20,0.75,98,2012-01-20,DET,MEM,2012,100.5
13007,13007,7,Home,L 81-83 ,240,29,79,0.367,27,60,0.45,2,19,0.105,21,32,0.656,81,32,79,0.405,28,53,0.528,4,26,0.154,15,20,0.75,83,2012-01-21,NOP,DAL,2012,85.0
13008,13008,8,@,L 81-91 ,240,32,76,0.421,29,56,0.518,3,20,0.15,14,20,0.7,81,34,78,0.436,25,58,0.431,9,20,0.45,14,26,0.538,91,2012-01-25,NYK,CLE,2012,95.5
13009,13009,9,@,L 81-96 ,240,32,82,0.39,25,63,0.397,7,19,0.368,10,14,0.714,81,32,70,0.457,24,43,0.558,8,27,0.296,24,32,0.75,96,2012-01-27,TOR,DEN,2012,100.0
13010,13010,10,@,L 81-93 ,240,33,74,0.446,30,66,0.455,3,8,0.375,12,16,0.75,81,34,74,0.459,30,55,0.545,4,19,0.211,21,27,0.778,93,2012-02-02,NOP,SAS,2012,95.0
13011,13011,11,@,L 81-99 ,240,34,83,0.41,30,64,0.469,4,19,0.211,9,14,0.643,81,39,89,0.438,35,74,0.473,4,15,0.267,17,17,1.0,99,2012-02-03,PHO,HOU,2012,101.0
13012,13012,12,Home,L 81-85 ,240,29,85,0.341,25,63,0.397,4,22,0.182,19,21,0.905,81,29,72,0.403,20,47,0.426,9,25,0.36,18,23,0.783,85,2012-02-04,IND,ORL,2012,89.5
13013,13013,13,Home,L 81-107 ,240,30,80,0.375,23,62,0.371,7,18,0.389,14,23,0.609,81,45,83,0.542,34,60,0.567,11,23,0.478,6,17,0.353,107,2012-02-04,WAS,LAC,2012,112.5
13014,13014,14,@,L 81-96 ,240,32,72,0.444,26,56,0.464,6,16,0.375,11,15,0.733,81,31,82,0.378,26,73,0.356,5,9,0.556,29,46,0.63,96,2012-02-19,BOS,DET,2012,98.5
13015,13015,15,Home,W 81-78 ,240,28,80,0.35,21,59,0.356,7,21,0.333,18,29,0.621,81,32,87,0.368,26,71,0.366,6,16,0.375,8,9,0.889,78,2012-03-02,PHO,LAC,2012,81.0
13016,13016,16,@,L 81-91 ,240,30,76,0.395,21,51,0.412,9,25,0.36,12,21,0.571,81,34,74,0.459,32,66,0.485,2,8,0.25,21,27,0.778,91,2012-03-18,ORL,MIA,2012,92.0
13017,13017,17,@,L 81-90 ,240,33,79,0.418,27,58,0.466,6,21,0.286,9,12,0.75,81,34,73,0.466,28,54,0.519,6,19,0.316,16,20,0.8,90,2012-03-27,HOU,DAL,2012,93.0
13018,13018,18,Home,L 81-109 ,240,33,85,0.388,27,57,0.474,6,28,0.214,9,14,0.643,81,40,79,0.506,26,44,0.591,14,35,0.4,15,16,0.938,109,2012-04-13,ORL,ATL,2012,116.0
13019,13019,19,Home,L 81-83 ,240,33,79,0.418,27,65,0.415,6,14,0.429,9,13,0.692,81,31,71,0.437,29,66,0.439,2,5,0.4,19,31,0.613,83,2012-04-24,GSW,NOH,2012,84.0
13020,13020,20,@,L 81-94 ,240,32,87,0.368,28,71,0.394,4,16,0.25,13,17,0.765,81,38,78,0.487,36,64,0.563,2,14,0.143,16,24,0.667,94,2012-11-10,PHO,UTA,2013,95.0
13021,13021,21,Home,W 81-72 ,240,34,89,0.382,29,64,0.453,5,25,0.2,8,13,0.615,81,31,82,0.378,29,72,0.403,2,10,0.2,8,14,0.571,72,2012-11-19,ATL,ORL,2013,73.0
13022,13022,22,@,L 81-116 ,240,29,76,0.382,20,53,0.377,9,23,0.391,14,18,0.778,81,47,86,0.547,35,62,0.565,12,24,0.5,10,16,0.625,116,2012-12-01,SAC,LAC,2013,122.0
13023,13023,23,@,L 81-102 ,240,29,76,0.382,21,57,0.368,8,19,0.421,15,23,0.652,81,43,82,0.524,38,70,0.543,5,12,0.417,11,11,1.0,102,2012-12-03,MIL,NOH,2013,104.5
13024,13024,24,@,L 81-87 ,240,34,77,0.442,33,62,0.532,1,15,0.067,12,17,0.706,81,32,77,0.416,31,67,0.463,1,10,0.1,22,27,0.815,87,2012-12-05,ORL,UTA,2013,87.5
13025,13025,25,@,L 81-96 ,240,27,81,0.333,18,59,0.305,9,22,0.409,18,25,0.72,81,34,83,0.41,29,65,0.446,5,18,0.278,23,28,0.821,96,2012-12-12,CLE,IND,2013,98.5
13026,13026,26,@,W 81-75 ,240,33,77,0.429,29,60,0.483,4,17,0.235,11,18,0.611,81,33,82,0.402,29,71,0.408,4,11,0.364,5,7,0.714,75,2012-12-22,IND,NOH,2013,77.0
13027,13027,27,@,L 81-97 ,240,28,73,0.384,25,63,0.397,3,10,0.3,22,32,0.688,81,34,76,0.447,25,49,0.51,9,27,0.333,20,26,0.769,97,2012-12-28,CHA,BRK,2013,101.5
13028,13028,28,Home,W 81-72 ,240,36,89,0.404,31,70,0.443,5,19,0.263,4,7,0.571,81,29,68,0.426,26,52,0.5,3,16,0.188,11,18,0.611,72,2012-12-29,MEM,DEN,2013,73.5
13029,13029,29,Home,L 81-91 ,240,33,94,0.351,29,78,0.372,4,16,0.25,11,18,0.611,81,33,70,0.471,29,60,0.483,4,10,0.4,21,38,0.553,91,2012-12-31,CHI,CHA,2013,93.0
13030,13030,30,@,L 81-89 ,240,35,83,0.422,32,70,0.457,3,13,0.231,8,10,0.8,81,29,77,0.377,24,61,0.393,5,16,0.313,26,31,0.839,89,2013-01-02,WAS,IND,2013,91.5
13031,13031,31,Home,L 81-89 ,240,28,68,0.412,18,39,0.462,10,29,0.345,15,19,0.789,81,39,85,0.459,36,69,0.522,3,16,0.188,8,12,0.667,89,2013-01-05,ATL,BOS,2013,90.5
13032,13032,32,Home,L 81-92 ,240,31,79,0.392,26,65,0.4,5,14,0.357,14,18,0.778,81,37,69,0.536,35,61,0.574,2,8,0.25,16,20,0.8,92,2013-01-06,PHO,MEM,2013,93.0
13033,13033,33,Home,L 81-113 ,240,28,76,0.368,23,55,0.418,5,21,0.238,20,23,0.87,81,39,80,0.488,28,60,0.467,11,20,0.55,24,27,0.889,113,2013-01-07,SAC,MEM,2013,118.5
13034,13034,34,Home,W 81-76 ,240,31,79,0.392,26,58,0.448,5,21,0.238,14,16,0.875,81,31,89,0.348,27,69,0.391,4,20,0.2,10,13,0.769,76,2013-01-10,IND,NYK,2013,78.0
13035,13035,35,Home,L 81-97 ,240,32,88,0.364,30,77,0.39,2,11,0.182,15,21,0.714,81,36,73,0.493,30,59,0.508,6,14,0.429,19,25,0.76,97,2013-01-12,CHI,PHO,2013,100.0
13036,13036,36,Home,L 81-82 ,240,35,83,0.422,31,73,0.425,4,10,0.4,7,7,1.0,81,34,69,0.493,26,52,0.5,8,17,0.471,6,11,0.545,82,2013-01-21,MEM,IND,2013,86.0
13037,13037,37,@,L 81-99 ,240,29,73,0.397,23,56,0.411,6,17,0.353,17,26,0.654,81,39,73,0.534,34,57,0.596,5,16,0.313,16,20,0.8,99,2013-01-30,SAC,BOS,2013,101.5
13038,13038,38,@,L 81-120 ,240,32,76,0.421,26,55,0.473,6,21,0.286,11,15,0.733,81,47,86,0.547,28,43,0.651,19,43,0.442,7,13,0.538,120,2013-02-02,SAC,NYK,2013,129.5
13039,13039,39,Home,L 81-93 ,240,29,72,0.403,26,61,0.426,3,11,0.273,20,25,0.8,81,34,70,0.486,27,50,0.54,7,20,0.35,18,22,0.818,93,2013-03-01,TOR,IND,2013,96.5
13040,13040,40,Home,L 81-97 ,240,33,88,0.375,28,68,0.412,5,20,0.25,10,15,0.667,81,38,74,0.514,33,53,0.623,5,21,0.238,16,19,0.842,97,2013-03-04,MIN,MIA,2013,99.5
13041,13041,41,Home,L 81-83 ,240,32,88,0.364,26,61,0.426,6,27,0.222,11,14,0.786,81,34,83,0.41,27,66,0.409,7,17,0.412,8,9,0.889,83,2013-03-06,IND,BOS,2013,86.5
13042,13042,42,@,L 81-90 ,240,33,89,0.371,29,73,0.397,4,16,0.25,11,12,0.917,81,39,86,0.453,34,60,0.567,5,26,0.192,7,14,0.5,90,2013-03-10,CHI,LAL,2013,92.5
13043,13043,43,@,L 81-98 ,240,33,78,0.423,28,56,0.5,5,22,0.227,10,14,0.714,81,35,82,0.427,29,62,0.468,6,20,0.3,22,30,0.733,98,2013-03-12,ATL,MIA,2013,101.0
13044,13044,44,@,L 81-111 ,240,34,81,0.42,28,60,0.467,6,21,0.286,7,10,0.7,81,39,76,0.513,29,55,0.527,10,21,0.476,23,30,0.767,111,2013-03-13,PHO,HOU,2013,116.0
13045,13045,45,@,L 81-98 ,240,31,78,0.397,24,56,0.429,7,22,0.318,12,14,0.857,81,35,80,0.438,26,56,0.464,9,24,0.375,19,27,0.704,98,2013-03-30,LAC,HOU,2013,102.5
13046,13046,46,@,L 81-101 ,240,34,81,0.42,27,62,0.435,7,19,0.368,6,12,0.5,81,36,81,0.444,28,57,0.491,8,24,0.333,21,33,0.636,101,2013-04-02,DAL,LAL,2013,105.0
13047,13047,47,@,L 81-82 ,240,31,86,0.36,22,62,0.355,9,24,0.375,10,14,0.714,81,31,76,0.408,28,60,0.467,3,16,0.188,17,19,0.895,82,2013-10-31,NYK,CHI,2014,83.5
13048,13048,48,@,L 81-100 ,240,29,83,0.349,22,52,0.423,7,31,0.226,16,19,0.842,81,33,77,0.429,25,57,0.439,8,20,0.4,26,33,0.788,100,2013-11-01,OKC,MIN,2014,104.0
13049,13049,49,@,L 81-96 ,240,31,75,0.413,26,61,0.426,5,14,0.357,14,20,0.7,81,34,83,0.41,30,67,0.448,4,16,0.25,24,26,0.923,96,2013-11-11,CLE,CHI,2014,98.0
13050,13050,50,Home,L 81-100 ,240,31,77,0.403,28,60,0.467,3,17,0.176,16,23,0.696,81,36,80,0.45,31,63,0.492,5,17,0.294,23,27,0.852,100,2013-11-11,UTA,DEN,2014,102.5
13051,13051,51,Home,L 81-97 ,240,29,83,0.349,21,56,0.375,8,27,0.296,15,20,0.75,81,35,69,0.507,29,54,0.537,6,15,0.4,21,23,0.913,97,2013-11-16,CHA,MIA,2014,100.0
13052,13052,52,@,L 81-86 ,240,33,91,0.363,26,75,0.347,7,16,0.438,8,16,0.5,81,27,75,0.36,21,63,0.333,6,12,0.5,26,31,0.839,86,2013-11-18,CHA,CHI,2014,89.0
13053,13053,53,Home,L 81-88 (OT),265,36,82,0.439,31,64,0.484,5,18,0.278,4,8,0.5,81,34,88,0.386,31,76,0.408,3,12,0.25,17,19,0.895,88,2013-11-20,GSW,MEM,2014,89.5
13054,13054,54,@,L 81-111 ,240,31,78,0.397,26,62,0.419,5,16,0.313,14,20,0.7,81,40,97,0.412,29,61,0.475,11,36,0.306,20,23,0.87,111,2013-11-22,BRK,MIN,2014,116.5
13055,13055,55,Home,L 81-101 ,240,29,77,0.377,26,64,0.406,3,13,0.231,20,26,0.769,81,38,80,0.475,27,60,0.45,11,20,0.55,14,18,0.778,101,2013-12-05,MEM,LAC,2014,106.5
13056,13056,56,@,L 81-114 ,240,32,84,0.381,28,62,0.452,4,22,0.182,13,24,0.542,81,43,81,0.531,31,55,0.564,12,26,0.462,16,22,0.727,114,2013-12-20,HOU,IND,2014,120.0
13057,13057,57,Home,L 81-89 ,240,31,81,0.383,28,68,0.412,3,13,0.231,16,21,0.762,81,36,84,0.429,29,68,0.426,7,16,0.438,10,18,0.556,89,2013-12-23,DEN,GSW,2014,92.5
13058,13058,58,Home,L 81-94 ,240,34,89,0.382,29,70,0.414,5,19,0.263,8,13,0.615,81,41,85,0.482,35,58,0.603,6,27,0.222,6,10,0.6,94,2013-12-31,ORL,GSW,2014,97.0
13059,13059,59,@,L 81-87 (OT),265,32,84,0.381,25,59,0.424,7,25,0.28,10,18,0.556,81,33,96,0.344,29,77,0.377,4,19,0.211,17,24,0.708,87,2014-01-02,ORL,CLE,2014,89.0
13060,13060,60,@,L 81-101 ,240,30,84,0.357,23,65,0.354,7,19,0.368,14,21,0.667,81,35,83,0.422,24,52,0.462,11,31,0.355,20,24,0.833,101,2014-01-06,ORL,LAC,2014,106.5
13061,13061,61,@,W 81-72 ,240,24,62,0.387,18,46,0.391,6,16,0.375,27,39,0.692,81,28,88,0.318,21,67,0.313,7,21,0.333,9,12,0.75,72,2014-01-10,CHI,MIL,2014,75.5
13062,13062,62,@,L 81-99 ,240,30,81,0.37,21,49,0.429,9,32,0.281,12,17,0.706,81,41,88,0.466,34,69,0.493,7,19,0.368,10,14,0.714,99,2014-01-25,HOU,MEM,2014,102.5
13063,13063,63,Home,L 81-98 ,240,30,87,0.345,26,63,0.413,4,24,0.167,17,22,0.773,81,43,83,0.518,37,70,0.529,6,13,0.462,6,10,0.6,98,2014-01-28,POR,MEM,2014,101.0
13064,13064,64,@,L 81-96 ,240,31,78,0.397,27,54,0.5,4,24,0.167,15,17,0.882,81,41,89,0.461,33,65,0.508,8,24,0.333,6,9,0.667,96,2014-02-01,OKC,WAS,2014,100.0
13065,13065,65,@,L 81-103 ,240,31,76,0.408,19,41,0.463,12,35,0.343,7,14,0.5,81,38,81,0.469,28,63,0.444,10,18,0.556,17,22,0.773,103,2014-02-07,UTA,DAL,2014,108.0
13066,13066,66,@,L 81-93 ,240,30,83,0.361,24,65,0.369,6,18,0.333,15,27,0.556,81,35,66,0.53,29,38,0.763,6,28,0.214,17,29,0.586,93,2014-02-09,NOP,BRK,2014,96.0
13067,13067,67,@,W 81-73 ,240,30,84,0.357,25,65,0.385,5,19,0.263,16,21,0.762,81,27,84,0.321,20,60,0.333,7,24,0.292,12,14,0.857,73,2014-02-12,DAL,IND,2014,76.5
13068,13068,68,Home,L 81-86 ,240,34,83,0.41,30,70,0.429,4,13,0.308,9,10,0.9,81,36,77,0.468,34,65,0.523,2,12,0.167,12,18,0.667,86,2014-02-12,ORL,MEM,2014,87.0
13069,13069,69,Home,L 81-103 ,240,28,74,0.378,26,54,0.481,2,20,0.1,23,30,0.767,81,41,75,0.547,36,54,0.667,5,21,0.238,16,21,0.762,103,2014-02-20,OKC,MIA,2014,105.5
13070,13070,70,@,L 81-92 ,240,32,86,0.372,27,62,0.435,5,24,0.208,12,18,0.667,81,35,83,0.422,34,70,0.486,1,13,0.077,21,27,0.778,92,2014-03-02,PHI,ORL,2014,92.5
13071,13071,71,@,L 81-108 ,240,30,73,0.411,24,46,0.522,6,27,0.222,15,20,0.75,81,42,85,0.494,30,54,0.556,12,31,0.387,12,18,0.667,108,2014-03-07,UTA,NYK,2014,114.0
13072,13072,72,@,L 81-91 ,240,30,87,0.345,29,67,0.433,1,20,0.05,20,22,0.909,81,31,70,0.443,26,56,0.464,5,14,0.357,24,31,0.774,91,2014-03-22,PHI,CHI,2014,93.5
13073,13073,73,@,L 81-94 ,240,31,85,0.365,22,67,0.328,9,18,0.5,10,16,0.625,81,33,69,0.478,24,46,0.522,9,23,0.391,19,25,0.76,94,2014-03-28,SAC,OKC,2014,98.5
13074,13074,74,@,L 81-110 ,240,26,65,0.4,18,39,0.462,8,26,0.308,21,28,0.75,81,42,70,0.6,31,45,0.689,11,25,0.44,15,20,0.75,110,2014-04-02,BRK,NYK,2014,115.5
13075,13075,75,@,L 81-93 ,240,32,86,0.372,27,63,0.429,5,23,0.217,12,22,0.545,81,36,88,0.409,27,64,0.422,9,24,0.375,12,21,0.571,93,2014-10-31,PHI,MIL,2015,97.5
13076,13076,76,@,L 81-93 ,240,29,86,0.337,25,62,0.403,4,24,0.167,19,29,0.655,81,31,76,0.408,27,62,0.435,4,14,0.286,27,37,0.73,93,2014-11-03,NOP,MEM,2015,95.0
13077,13077,77,Home,L 81-87 ,240,31,78,0.397,25,54,0.463,6,24,0.25,13,22,0.591,81,37,83,0.446,30,62,0.484,7,21,0.333,6,7,0.857,87,2014-11-04,IND,MIL,2015,90.5
13078,13078,78,@,L 81-98 ,240,31,90,0.344,29,70,0.414,2,20,0.1,17,19,0.895,81,34,72,0.472,24,45,0.533,10,27,0.37,20,33,0.606,98,2014-11-06,SAS,HOU,2015,103.0
13079,13079,79,@,W 81-75 ,240,30,80,0.375,22,54,0.407,8,26,0.308,13,15,0.867,81,29,68,0.426,20,48,0.417,9,20,0.45,8,18,0.444,75,2014-11-12,IND,MIA,2015,79.5
13080,13080,80,@,L 81-98 ,240,30,84,0.357,22,61,0.361,8,23,0.348,13,19,0.684,81,35,81,0.432,25,57,0.439,10,24,0.417,18,26,0.692,98,2014-11-18,OKC,UTA,2015,103.0
13081,13081,81,@,L 81-87 ,240,30,77,0.39,21,51,0.412,9,26,0.346,12,16,0.75,81,29,78,0.372,20,49,0.408,9,29,0.31,20,27,0.741,87,2014-12-12,ORL,ATL,2015,91.5
13082,13082,82,Home,L 81-97 ,240,32,91,0.352,22,67,0.328,10,24,0.417,7,14,0.5,81,38,76,0.5,25,43,0.581,13,33,0.394,8,14,0.571,97,2015-01-02,NYK,DET,2015,103.5
13083,13083,83,Home,L 81-89 ,240,30,74,0.405,27,60,0.45,3,14,0.214,18,26,0.692,81,35,88,0.398,30,70,0.429,5,18,0.278,14,17,0.824,89,2015-01-07,BRK,BOS,2015,91.5
13084,13084,84,@,L 81-96 ,240,29,75,0.387,25,58,0.431,4,17,0.235,19,29,0.655,81,36,80,0.45,29,58,0.5,7,22,0.318,17,27,0.63,96,2015-01-16,NOP,PHI,2015,99.5
13085,13085,85,@,L 81-104 ,240,30,81,0.37,24,60,0.4,6,21,0.286,15,18,0.833,81,36,76,0.474,30,57,0.526,6,19,0.316,26,32,0.813,104,2015-01-22,SAS,CHI,2015,107.0
13086,13086,86,@,L 81-89 ,240,29,84,0.345,23,61,0.377,6,23,0.261,17,20,0.85,81,29,74,0.392,20,51,0.392,9,23,0.391,22,30,0.733,89,2015-02-07,CHA,PHI,2015,93.5
13087,13087,87,@,L 81-89 ,240,30,84,0.357,23,58,0.397,7,26,0.269,14,21,0.667,81,33,78,0.423,28,63,0.444,5,15,0.333,18,22,0.818,89,2015-02-20,DEN,MIL,2015,91.5
13088,13088,88,@,L 81-92 ,240,33,90,0.367,27,71,0.38,6,19,0.316,9,13,0.692,81,36,78,0.462,31,60,0.517,5,18,0.278,15,19,0.789,92,2015-02-22,CHA,DAL,2015,94.5
13089,13089,89,@,L 81-90 ,240,32,79,0.405,27,60,0.45,5,19,0.263,12,21,0.571,81,34,83,0.41,30,68,0.441,4,15,0.267,18,23,0.783,90,2015-02-23,SAS,UTA,2015,92.0
13090,13090,90,@,L 81-89 ,240,30,93,0.323,26,76,0.342,4,17,0.235,17,22,0.773,81,28,80,0.35,16,47,0.34,12,33,0.364,21,34,0.618,89,2015-02-27,WAS,PHI,2015,95.0
13091,13091,91,@,L 81-92 ,240,30,81,0.37,22,63,0.349,8,18,0.444,13,21,0.619,81,33,80,0.413,31,71,0.437,2,9,0.222,24,28,0.857,92,2015-03-16,DEN,MEM,2015,93.0
13092,13092,92,@,L 81-97 ,240,25,69,0.362,17,53,0.321,8,16,0.5,23,26,0.885,81,37,88,0.42,26,58,0.448,11,30,0.367,12,15,0.8,97,2015-03-20,NYK,PHI,2015,102.5
13093,13093,93,Home,L 81-87 ,240,32,87,0.368,26,67,0.388,6,20,0.3,11,12,0.917,81,36,89,0.404,29,63,0.46,7,26,0.269,8,18,0.444,87,2015-03-27,PHO,POR,2015,90.5
13094,13094,94,Home,L 81-95 ,240,32,79,0.405,27,64,0.422,5,15,0.333,12,12,1.0,81,37,74,0.5,29,56,0.518,8,18,0.444,13,17,0.765,95,2015-03-31,MIA,SAS,2015,99.0
13095,13095,95,@,L 81-100 ,240,30,82,0.366,23,59,0.39,7,23,0.304,14,20,0.7,81,34,77,0.442,25,56,0.446,9,21,0.429,23,27,0.852,100,2015-11-13,NOP,TOR,2016,104.5
13096,13096,96,@,L 81-105 ,240,34,98,0.347,28,63,0.444,6,35,0.171,7,8,0.875,81,37,84,0.44,26,60,0.433,11,24,0.458,20,26,0.769,105,2015-11-14,DEN,PHO,2016,110.5
13097,13097,97,@,L 81-104 ,240,32,79,0.405,26,59,0.441,6,20,0.3,11,16,0.688,81,41,98,0.418,25,67,0.373,16,31,0.516,6,7,0.857,104,2015-11-25,MIA,DET,2016,112.0
13098,13098,98,@,L 81-92 ,240,30,75,0.4,22,50,0.44,8,25,0.32,13,17,0.765,81,33,77,0.429,26,51,0.51,7,26,0.269,19,27,0.704,92,2015-11-28,DEN,DAL,2016,95.5
13099,13099,99,@,L 81-99 ,240,29,75,0.387,23,54,0.426,6,21,0.286,17,24,0.708,81,40,81,0.494,29,54,0.537,11,27,0.407,8,17,0.471,99,2015-12-09,MIA,CHO,2016,104.5
13100,13100,0,@,L 81-118 ,240,32,79,0.405,29,68,0.426,3,11,0.273,14,17,0.824,81,42,75,0.56,33,54,0.611,9,21,0.429,25,27,0.926,118,2015-12-14,UTA,SAS,2016,122.5
13101,13101,1,@,L 81-107 ,240,33,90,0.367,25,57,0.439,8,33,0.242,7,10,0.7,81,43,89,0.483,32,60,0.533,11,29,0.379,10,17,0.588,107,2015-12-16,DAL,IND,2016,112.5
13102,13102,2,@,L 81-108 ,240,31,84,0.369,25,65,0.385,6,19,0.316,13,17,0.765,81,39,85,0.459,29,69,0.42,10,16,0.625,20,25,0.8,108,2016-01-01,NYK,CHI,2016,113.0
13103,13103,3,@,L 81-98 ,240,30,87,0.345,24,65,0.369,6,22,0.273,15,20,0.75,81,41,80,0.513,32,61,0.525,9,19,0.474,7,10,0.7,98,2016-01-18,ORL,ATL,2016,102.5
13104,13104,4,@,L 81-101 ,240,33,81,0.407,29,64,0.453,4,17,0.235,11,17,0.647,81,35,75,0.467,22,50,0.44,13,25,0.52,18,21,0.857,101,2016-01-22,MIA,TOR,2016,107.5
13105,13105,5,@,L 81-85 ,240,26,70,0.371,22,52,0.423,4,18,0.222,25,33,0.758,81,33,74,0.446,28,52,0.538,5,22,0.227,14,20,0.7,85,2016-02-03,DEN,UTA,2016,87.5
13106,13106,6,@,L 81-84 ,240,30,71,0.423,23,57,0.404,7,14,0.5,14,21,0.667,81,30,77,0.39,22,50,0.44,8,27,0.296,16,23,0.696,84,2016-02-05,MIL,UTA,2016,88.0
13107,13107,7,Home,L 81-87 ,240,30,85,0.353,17,39,0.436,13,46,0.283,8,14,0.571,81,34,90,0.378,28,66,0.424,6,24,0.25,13,17,0.765,87,2016-02-24,LAC,DEN,2016,90.0
13108,13108,8,Home,L 81-98 ,240,32,87,0.368,26,72,0.361,6,15,0.4,11,12,0.917,81,40,84,0.476,39,76,0.513,1,8,0.125,17,21,0.81,98,2016-02-28,NYK,MIA,2016,98.5
13109,13109,9,@,L 81-97 ,240,31,78,0.397,25,59,0.424,6,19,0.316,13,23,0.565,81,43,84,0.512,40,70,0.571,3,14,0.214,8,9,0.889,97,2016-03-02,DET,SAS,2016,98.5
13110,13110,10,@,L 81-130 ,240,30,101,0.297,26,84,0.31,4,17,0.235,17,28,0.607,81,46,85,0.541,30,52,0.577,16,33,0.485,22,34,0.647,130,2016-03-14,MEM,HOU,2016,138.0
13111,13111,11,@,L 81-124 ,240,32,79,0.405,29,56,0.518,3,23,0.13,14,22,0.636,81,51,90,0.567,43,72,0.597,8,18,0.444,14,18,0.778,124,2016-03-14,DET,WAS,2016,128.0
13112,13112,12,@,L 81-103 ,240,26,83,0.313,20,63,0.317,6,20,0.3,23,25,0.92,81,40,78,0.513,33,58,0.569,7,20,0.35,16,26,0.615,103,2016-04-05,LAL,LAC,2016,106.5
13113,13113,13,Home,L 81-91 ,240,32,90,0.356,28,71,0.394,4,19,0.211,13,17,0.765,81,37,83,0.446,30,58,0.517,7,25,0.28,10,14,0.714,91,2016-04-06,LAL,LAC,2016,94.5
13114,13114,14,@,L 81-116 ,240,32,96,0.333,21,59,0.356,11,37,0.297,6,13,0.462,81,47,97,0.485,37,62,0.597,10,35,0.286,12,19,0.632,116,2016-04-13,SAC,HOU,2016,121.0
13115,13115,15,@,L 81-97 ,240,33,77,0.429,26,51,0.51,7,26,0.269,8,10,0.8,81,35,77,0.455,23,52,0.442,12,25,0.48,15,26,0.577,97,2016-11-02,DAL,UTA,2017,103.0
13116,13116,16,@,L 81-104 ,240,29,93,0.312,23,74,0.311,6,19,0.316,17,20,0.85,81,40,83,0.482,29,58,0.5,11,25,0.44,13,14,0.929,104,2016-11-18,DET,CLE,2017,109.5
13117,13117,17,Home,L 81-90 ,240,29,82,0.354,25,63,0.397,4,19,0.211,19,23,0.826,81,33,85,0.388,21,54,0.389,12,31,0.387,12,18,0.667,90,2016-11-25,MEM,MIA,2017,96.0
13118,13118,18,@,L 81-91 ,240,30,77,0.39,25,57,0.439,5,20,0.25,16,18,0.889,81,32,77,0.416,22,50,0.44,10,27,0.37,17,20,0.85,91,2016-11-27,NOP,DAL,2017,96.0
13119,13119,19,@,L 80-96 ,240,36,89,0.404,36,74,0.486,0,15,0.0,8,16,0.5,80,35,85,0.412,27,62,0.435,8,23,0.348,18,21,0.857,96,2012-01-01,NOP,SAC,2012,100.0
13120,13120,20,Home,L 80-103 ,240,29,78,0.372,20,52,0.385,9,26,0.346,13,22,0.591,80,39,83,0.47,31,55,0.564,8,28,0.286,17,20,0.85,103,2012-01-07,DET,NYK,2012,107.0
13121,13121,21,Home,L 80-87 ,240,34,90,0.378,30,74,0.405,4,16,0.25,8,16,0.5,80,24,70,0.343,18,45,0.4,6,25,0.24,33,38,0.868,87,2012-01-13,NOP,MIN,2012,90.0
13122,13122,22,@,L 80-97 ,240,34,83,0.41,30,70,0.429,4,13,0.308,8,9,0.889,80,40,81,0.494,32,62,0.516,8,19,0.421,9,12,0.75,97,2012-01-17,DET,HOU,2012,101.0
13123,13123,23,@,L 80-92 ,240,29,76,0.382,23,56,0.411,6,20,0.3,16,22,0.727,80,32,77,0.416,20,50,0.4,12,27,0.444,16,26,0.615,92,2012-01-20,LAL,ORL,2012,98.0
13124,13124,24,@,L 80-88 ,240,26,74,0.351,23,57,0.404,3,17,0.176,25,33,0.758,80,34,81,0.42,30,67,0.448,4,14,0.286,16,19,0.842,88,2012-02-03,MIL,DET,2012,90.0
13125,13125,25,@,L 80-98 ,240,32,87,0.368,29,73,0.397,3,14,0.214,13,16,0.813,80,36,73,0.493,29,53,0.547,7,20,0.35,19,21,0.905,98,2012-02-05,MEM,BOS,2012,101.5
13126,13126,26,@,L 80-85 ,240,31,79,0.392,27,60,0.45,4,19,0.211,14,19,0.737,80,35,94,0.372,31,83,0.373,4,11,0.364,11,15,0.733,85,2012-02-08,MIN,MEM,2012,87.0
13127,13127,27,@,L 80-86 ,240,30,73,0.411,26,59,0.441,4,14,0.286,16,23,0.696,80,32,75,0.427,29,64,0.453,3,11,0.273,19,28,0.679,86,2012-02-13,UTA,NOH,2012,87.5
13128,13128,28,@,L 80-89 ,240,31,78,0.397,28,63,0.444,3,15,0.2,15,18,0.833,80,30,76,0.395,20,55,0.364,10,21,0.476,19,28,0.679,89,2012-02-16,BOS,CHI,2012,94.0
13129,13129,29,@,L 80-89 ,240,33,79,0.418,30,66,0.455,3,13,0.231,11,15,0.733,80,31,77,0.403,25,56,0.446,6,21,0.286,21,31,0.677,89,2012-03-17,PHI,CHI,2012,92.0
13130,13130,30,Home,L 80-105 ,240,29,75,0.387,27,67,0.403,2,8,0.25,20,28,0.714,80,46,86,0.535,41,75,0.547,5,11,0.455,8,9,0.889,105,2012-03-19,CHA,PHI,2012,107.5
13131,13131,31,@,L 80-93 ,240,31,82,0.378,27,64,0.422,4,18,0.222,14,21,0.667,80,37,79,0.468,25,44,0.568,12,35,0.343,7,12,0.583,93,2012-03-23,CLE,ORL,2012,99.0
13132,13132,32,@,L 80-89 ,240,31,85,0.365,25,61,0.41,6,24,0.25,12,18,0.667,80,26,74,0.351,19,43,0.442,7,31,0.226,30,35,0.857,89,2012-03-26,MIL,NYK,2012,92.5
13133,13133,33,Home,L 80-96 ,240,30,72,0.417,21,48,0.438,9,24,0.375,11,16,0.688,80,38,78,0.487,25,53,0.472,13,25,0.52,7,15,0.467,96,2012-04-05,ORL,NYK,2012,102.5
13134,13134,34,Home,L 80-84 ,240,31,73,0.425,28,58,0.483,3,15,0.2,15,24,0.625,80,25,73,0.342,20,56,0.357,5,17,0.294,29,40,0.725,84,2012-04-06,TOR,CLE,2012,86.5
13135,13135,35,Home,L 80-91 ,240,33,91,0.363,26,72,0.361,7,19,0.368,7,9,0.778,80,34,73,0.466,31,58,0.534,3,15,0.2,20,28,0.714,91,2012-04-19,DET,MIN,2012,92.5
13136,13136,36,Home,L 80-85 ,240,32,79,0.405,29,70,0.414,3,9,0.333,13,18,0.722,80,34,75,0.453,32,67,0.478,2,8,0.25,15,21,0.714,85,2012-04-20,CHA,MEM,2012,86.0
13137,13137,37,@,L 80-92 ,240,32,89,0.36,29,73,0.397,3,16,0.188,13,16,0.813,80,32,87,0.368,30,70,0.429,2,17,0.118,26,36,0.722,92,2012-11-02,SAC,MIN,2013,93.0
13138,13138,38,@,L 80-87 ,240,33,85,0.388,30,72,0.417,3,13,0.231,11,15,0.733,80,34,80,0.425,28,67,0.418,6,13,0.462,13,16,0.813,87,2012-11-10,MIN,CHI,2013,90.0
13139,13139,39,@,L 80-101 ,240,30,89,0.337,28,75,0.373,2,14,0.143,18,22,0.818,80,37,75,0.493,32,59,0.542,5,16,0.313,22,30,0.733,101,2012-11-17,CHI,LAC,2013,103.5
13140,13140,40,Home,L 80-102 ,240,29,69,0.42,21,51,0.412,8,18,0.444,14,21,0.667,80,37,83,0.446,23,47,0.489,14,36,0.389,14,19,0.737,102,2012-11-20,NOP,NYK,2013,109.0
13141,13141,41,@,W 80-76 ,240,29,80,0.363,27,70,0.386,2,10,0.2,20,27,0.741,80,28,73,0.384,24,61,0.393,4,12,0.333,16,20,0.8,76,2012-12-04,IND,CHI,2013,78.0
13142,13142,42,Home,L 80-99 ,240,29,75,0.387,21,54,0.389,8,21,0.381,14,18,0.778,80,36,86,0.419,27,67,0.403,9,19,0.474,18,22,0.818,99,2012-12-08,POR,SAC,2013,103.5
13143,13143,43,Home,L 80-86 ,240,31,81,0.383,24,59,0.407,7,22,0.318,11,11,1.0,80,35,80,0.438,29,58,0.5,6,22,0.273,10,16,0.625,86,2012-12-12,ORL,ATL,2013,89.0
13144,13144,44,@,L 80-82 ,240,33,73,0.452,31,63,0.492,2,10,0.2,12,12,1.0,80,34,89,0.382,29,67,0.433,5,22,0.227,9,11,0.818,82,2012-12-12,MEM,PHO,2013,84.5
13145,13145,45,Home,W 80-71 ,240,30,80,0.375,24,69,0.348,6,11,0.545,14,19,0.737,80,28,75,0.373,26,64,0.406,2,11,0.182,13,20,0.65,71,2012-12-17,MEM,CHI,2013,72.0
13146,13146,46,@,L 80-90 ,240,30,85,0.353,25,65,0.385,5,20,0.25,15,19,0.789,80,36,88,0.409,33,80,0.413,3,8,0.375,15,19,0.789,90,2012-12-19,MIL,MEM,2013,91.5
13147,13147,47,@,L 80-99 ,240,31,79,0.392,22,54,0.407,9,25,0.36,9,12,0.75,80,44,86,0.512,36,67,0.537,8,19,0.421,3,7,0.429,99,2012-12-21,ATL,PHI,2013,103.0
13148,13148,48,@,L 80-100 ,240,33,78,0.423,26,60,0.433,7,18,0.389,7,12,0.583,80,34,71,0.479,26,52,0.5,8,19,0.421,24,29,0.828,100,2012-12-26,TOR,SAS,2013,104.0
13149,13149,49,Home,L 80-87 ,240,34,75,0.453,30,60,0.5,4,15,0.267,8,11,0.727,80,40,89,0.449,39,80,0.488,1,9,0.111,6,9,0.667,87,2013-01-04,PHO,UTA,2013,87.5
13150,13150,50,@,L 80-95 ,240,31,82,0.378,26,64,0.406,5,18,0.278,13,18,0.722,80,40,92,0.435,37,72,0.514,3,20,0.15,12,20,0.6,95,2013-01-05,MIL,IND,2013,96.5
13151,13151,51,@,L 80-100 ,240,30,80,0.375,24,57,0.421,6,23,0.261,14,17,0.824,80,44,78,0.564,42,67,0.627,2,11,0.182,10,12,0.833,100,2013-01-23,IND,POR,2013,101.0
13152,13152,52,@,L 80-97 ,240,28,81,0.346,24,54,0.444,4,27,0.148,20,23,0.87,80,38,75,0.507,32,56,0.571,6,19,0.316,15,22,0.682,97,2013-01-26,NYK,PHI,2013,100.0
13153,13153,53,Home,L 80-125 ,240,32,81,0.395,27,63,0.429,5,18,0.278,11,19,0.579,80,47,89,0.528,31,55,0.564,16,34,0.471,15,18,0.833,125,2013-01-28,UTA,HOU,2013,133.0
13154,13154,54,@,L 80-89 ,240,30,79,0.38,29,69,0.42,1,10,0.1,19,25,0.76,80,36,76,0.474,33,62,0.532,3,14,0.214,14,19,0.737,89,2013-02-01,SAC,PHI,2013,90.5
13155,13155,55,Home,L 80-93 ,240,32,77,0.416,27,59,0.458,5,18,0.278,11,16,0.688,80,36,83,0.434,30,60,0.5,6,23,0.261,15,22,0.682,93,2013-03-09,ATL,BRK,2013,96.0
13156,13156,56,@,L 80-87 ,240,30,85,0.353,26,73,0.356,4,12,0.333,16,19,0.842,80,35,77,0.455,34,65,0.523,1,12,0.083,16,22,0.727,87,2013-03-15,MEM,DEN,2013,87.5
13157,13157,57,@,L 80-93 ,240,29,81,0.358,17,55,0.309,12,26,0.462,10,14,0.714,80,34,75,0.453,26,47,0.553,8,28,0.286,17,31,0.548,93,2013-03-17,NYK,LAC,2013,97.0
13158,13158,58,@,L 80-103 ,240,27,84,0.321,22,64,0.344,5,20,0.25,21,29,0.724,80,29,63,0.46,21,49,0.429,8,14,0.571,37,41,0.902,103,2013-03-27,WAS,OKC,2013,107.0
13159,13159,59,Home,L 80-90 ,240,31,79,0.392,24,54,0.444,7,25,0.28,11,14,0.786,80,32,81,0.395,23,60,0.383,9,21,0.429,17,18,0.944,90,2013-04-09,UTA,OKC,2013,94.5
13160,13160,60,@,L 80-90 ,240,28,65,0.431,20,37,0.541,8,28,0.286,16,26,0.615,80,35,82,0.427,24,51,0.471,11,31,0.355,9,11,0.818,90,2013-04-14,IND,NYK,2013,95.5
13161,13161,61,Home,L 80-96 ,240,32,75,0.427,30,58,0.517,2,17,0.118,14,18,0.778,80,36,77,0.468,33,67,0.493,3,10,0.3,21,23,0.913,96,2013-04-15,MIN,UTA,2013,97.5
13162,13162,62,@,L 80-97 ,240,26,73,0.356,21,58,0.362,5,15,0.333,23,27,0.852,80,36,86,0.419,29,68,0.426,7,18,0.389,18,21,0.857,97,2013-11-06,CHI,IND,2014,100.5
13163,13163,63,Home,L 80-86 ,240,32,79,0.405,28,64,0.438,4,15,0.267,12,17,0.706,80,32,80,0.4,24,60,0.4,8,20,0.4,14,20,0.7,86,2013-11-15,CLE,CHA,2014,90.0
13164,13164,64,Home,L 80-96 ,240,29,82,0.354,24,61,0.393,5,21,0.238,17,22,0.773,80,36,80,0.45,29,64,0.453,7,16,0.438,17,19,0.895,96,2013-11-15,TOR,CHI,2014,99.5
13165,13165,65,@,L 80-93 ,240,32,83,0.386,29,63,0.46,3,20,0.15,13,15,0.867,80,32,74,0.432,26,49,0.531,6,25,0.24,23,31,0.742,93,2013-11-27,NYK,LAC,2014,96.0
13166,13166,66,@,L 80-98 ,240,30,77,0.39,27,62,0.435,3,15,0.2,17,19,0.895,80,33,73,0.452,24,60,0.4,9,13,0.692,23,29,0.793,98,2013-12-02,ORL,WAS,2014,102.5
13167,13167,67,@,L 80-83 ,240,31,84,0.369,24,70,0.343,7,14,0.5,11,15,0.733,80,34,80,0.425,26,59,0.441,8,21,0.381,7,9,0.778,83,2013-12-30,CHA,UTA,2014,87.0
13168,13168,68,Home,L 80-92 ,240,32,78,0.41,26,52,0.5,6,26,0.231,10,18,0.556,80,37,76,0.487,32,63,0.508,5,13,0.385,13,16,0.813,92,2014-01-05,DAL,NYK,2014,94.5
13169,13169,69,Home,L 80-101 ,240,31,80,0.388,26,65,0.4,5,15,0.333,13,18,0.722,80,39,85,0.459,29,53,0.547,10,32,0.313,13,20,0.65,101,2014-01-07,MIL,GSW,2014,106.0
13170,13170,70,@,L 80-83 ,240,29,70,0.414,23,51,0.451,6,19,0.316,16,22,0.727,80,32,86,0.372,23,54,0.426,9,32,0.281,10,11,0.909,83,2014-01-10,HOU,ATL,2014,87.5
13171,13171,71,@,L 80-96 ,240,30,75,0.4,22,50,0.44,8,25,0.32,12,18,0.667,80,32,79,0.405,21,54,0.389,11,25,0.44,21,28,0.75,96,2014-01-11,BRK,TOR,2014,101.5
13172,13172,72,@,L 80-124 ,240,31,80,0.388,24,59,0.407,7,21,0.333,11,23,0.478,80,42,81,0.519,27,51,0.529,15,30,0.5,25,30,0.833,124,2014-01-12,CLE,SAC,2014,131.5
13173,13173,73,Home,L 80-103 ,240,24,71,0.338,16,46,0.348,8,25,0.32,24,37,0.649,80,37,75,0.493,23,37,0.622,14,38,0.368,15,20,0.75,103,2014-01-20,NYK,BRK,2014,110.0
13174,13174,74,@,L 80-123 ,240,33,90,0.367,31,73,0.425,2,17,0.118,12,17,0.706,80,43,88,0.489,31,59,0.525,12,29,0.414,25,30,0.833,123,2014-02-10,PHI,GSW,2014,129.0
13175,13175,75,@,L 80-119 ,240,28,89,0.315,22,63,0.349,6,26,0.231,18,26,0.692,80,46,80,0.575,42,64,0.656,4,16,0.25,23,26,0.885,119,2014-02-10,DEN,IND,2014,121.0
13176,13176,76,@,L 80-124 ,240,32,81,0.395,28,59,0.475,4,22,0.182,12,17,0.706,80,46,86,0.535,33,55,0.6,13,31,0.419,19,21,0.905,124,2014-02-26,BRK,POR,2014,130.5
13177,13177,77,@,L 80-96 ,240,30,65,0.462,26,52,0.5,4,13,0.308,16,23,0.696,80,34,73,0.466,27,48,0.563,7,25,0.28,21,28,0.75,96,2014-03-03,CHI,BRK,2014,99.5
13178,13178,78,Home,L 80-87 ,240,29,94,0.309,26,73,0.356,3,21,0.143,19,21,0.905,80,34,80,0.425,29,54,0.537,5,26,0.192,14,20,0.7,87,2014-03-14,BOS,PHO,2014,89.5
13179,13179,79,@,L 80-102 ,240,29,83,0.349,21,59,0.356,8,24,0.333,14,20,0.7,80,42,94,0.447,34,66,0.515,8,28,0.286,10,15,0.667,102,2014-03-16,CLE,LAC,2014,106.0
13180,13180,80,@,L 80-96 ,240,32,81,0.395,29,69,0.42,3,12,0.25,13,16,0.813,80,37,78,0.474,28,57,0.491,9,21,0.429,13,20,0.65,96,2014-03-29,NOP,SAS,2014,100.5
13181,13181,81,@,L 80-94 ,240,31,77,0.403,24,52,0.462,7,25,0.28,11,15,0.733,80,38,80,0.475,35,64,0.547,3,16,0.188,15,16,0.938,94,2014-03-31,BOS,CHI,2014,95.5
13182,13182,82,@,L 80-91 ,240,31,87,0.356,28,76,0.368,3,11,0.273,15,18,0.833,80,33,78,0.423,27,62,0.435,6,16,0.375,19,23,0.826,91,2014-04-04,ORL,CHA,2014,94.0
13183,13183,83,Home,L 80-104 ,240,31,85,0.365,28,68,0.412,3,17,0.176,15,17,0.882,80,36,71,0.507,29,47,0.617,7,24,0.292,25,30,0.833,104,2014-10-29,NYK,CHI,2015,107.5
13184,13184,84,Home,L 80-93 ,240,28,75,0.373,26,63,0.413,2,12,0.167,22,31,0.71,80,33,80,0.413,23,57,0.404,10,23,0.435,17,20,0.85,93,2014-11-14,LAL,SAS,2015,98.0
13185,13185,85,Home,L 80-107 ,240,32,80,0.4,22,58,0.379,10,22,0.455,6,13,0.462,80,43,84,0.512,33,56,0.589,10,28,0.357,11,16,0.688,107,2014-11-17,CHA,DAL,2015,112.0
13186,13186,86,@,L 80-83 ,240,30,81,0.37,24,64,0.375,6,17,0.353,14,21,0.667,80,35,76,0.461,30,64,0.469,5,12,0.417,8,12,0.667,83,2014-11-29,NOP,WAS,2015,85.5
13187,13187,87,@,L 80-105 ,240,29,88,0.33,26,74,0.351,3,14,0.214,19,24,0.792,80,37,79,0.468,29,57,0.509,8,22,0.364,23,32,0.719,105,2014-12-10,BRK,CHI,2015,109.0
13188,13188,88,Home,L 80-103 ,240,31,82,0.378,26,53,0.491,5,29,0.172,13,17,0.765,80,41,91,0.451,24,60,0.4,17,31,0.548,4,9,0.444,103,2014-12-28,CLE,DET,2015,111.5
13189,13189,89,Home,L 80-96 ,240,29,85,0.341,21,54,0.389,8,31,0.258,14,16,0.875,80,40,90,0.444,29,65,0.446,11,25,0.44,5,10,0.5,96,2014-12-31,CLE,MIL,2015,101.5
13190,13190,90,Home,L 80-102 ,240,31,73,0.425,27,56,0.482,4,17,0.235,14,16,0.875,80,37,81,0.457,33,69,0.478,4,12,0.333,24,31,0.774,102,2015-01-16,WAS,BRK,2015,104.0
13191,13191,91,Home,W 80-71 (OT),265,31,101,0.307,29,86,0.337,2,15,0.133,16,25,0.64,80,30,84,0.357,28,63,0.444,2,21,0.095,9,13,0.692,71,2015-01-17,CHA,IND,2015,72.0
13192,13192,92,@,L 80-105 ,240,29,80,0.363,23,61,0.377,6,19,0.316,16,20,0.8,80,40,89,0.449,28,67,0.418,12,22,0.545,13,19,0.684,105,2015-01-19,MIN,CHO,2015,111.0
13193,13193,93,@,L 80-96 ,240,28,77,0.364,22,57,0.386,6,20,0.3,18,21,0.857,80,38,83,0.458,35,67,0.522,3,16,0.188,17,21,0.81,96,2015-01-21,LAL,NOP,2015,97.5
13194,13194,94,@,L 80-92 ,240,27,76,0.355,20,60,0.333,7,16,0.438,19,23,0.826,80,37,84,0.44,27,62,0.435,10,22,0.455,8,13,0.615,92,2015-02-01,LAL,NYK,2015,97.0
13195,13195,95,@,L 80-96 ,240,33,83,0.398,29,61,0.475,4,22,0.182,10,15,0.667,80,33,77,0.429,26,52,0.5,7,25,0.28,23,27,0.852,96,2015-02-09,ORL,WAS,2015,99.5
13196,13196,96,Home,L 80-105 ,240,29,88,0.33,21,50,0.42,8,38,0.211,14,21,0.667,80,43,96,0.448,30,66,0.455,13,30,0.433,6,8,0.75,105,2015-02-20,ATL,TOR,2015,111.5
13197,13197,97,Home,L 80-98 ,240,29,77,0.377,25,66,0.379,4,11,0.364,18,23,0.783,80,35,83,0.422,22,52,0.423,13,31,0.419,15,19,0.789,98,2015-03-09,PHO,GSW,2015,104.5
13198,13198,98,@,W 80-73 ,240,25,62,0.403,16,37,0.432,9,25,0.36,21,31,0.677,80,31,77,0.403,28,66,0.424,3,11,0.273,8,17,0.471,73,2015-03-19,UTA,LAL,2015,74.5
13199,13199,99,Home,L 80-111 ,240,29,82,0.354,24,59,0.407,5,23,0.217,17,19,0.895,80,44,78,0.564,33,50,0.66,11,28,0.393,12,18,0.667,111,2015-03-25,NYK,LAC,2015,116.5
13200,13200,0,@,L 80-111 ,240,30,79,0.38,26,62,0.419,4,17,0.235,16,19,0.842,80,43,84,0.512,37,67,0.552,6,17,0.353,19,22,0.864,111,2015-03-28,NYK,CHI,2015,114.0
13201,13201,1,@,L 80-104 ,240,30,83,0.361,22,53,0.415,8,30,0.267,12,18,0.667,80,41,82,0.5,31,54,0.574,10,28,0.357,12,16,0.75,104,2015-04-10,CHA,ATL,2015,109.0
13202,13202,2,@,L 80-117 ,240,32,82,0.39,27,67,0.403,5,15,0.333,11,17,0.647,80,45,89,0.506,33,69,0.478,12,20,0.6,15,23,0.652,117,2015-04-10,WAS,BRK,2015,123.0
13203,13203,3,@,W 80-79 ,240,31,82,0.378,25,62,0.403,6,20,0.3,12,13,0.923,80,30,84,0.357,24,62,0.387,6,22,0.273,13,18,0.722,79,2015-04-11,NYK,ORL,2015,82.0
13204,13204,4,@,L 80-93 ,240,31,75,0.413,24,56,0.429,7,19,0.368,11,13,0.846,80,38,89,0.427,31,66,0.47,7,23,0.304,10,13,0.769,93,2015-11-16,POR,SAS,2016,96.5
13205,13205,5,Home,L 80-91 ,240,29,74,0.392,22,42,0.524,7,32,0.219,15,20,0.75,80,29,78,0.372,25,61,0.41,4,17,0.235,29,31,0.935,91,2015-11-22,LAC,TOR,2016,93.0
13206,13206,6,@,L 80-84 ,240,31,83,0.373,24,56,0.429,7,27,0.259,11,15,0.733,80,31,91,0.341,22,62,0.355,9,29,0.31,13,18,0.722,84,2015-11-25,PHI,BOS,2016,88.5
13207,13207,7,Home,L 80-91 ,240,31,77,0.403,24,57,0.421,7,20,0.35,11,13,0.846,80,36,75,0.48,28,53,0.528,8,22,0.364,11,14,0.786,91,2015-11-27,DEN,SAS,2016,95.0
13208,13208,8,@,L 80-83 ,240,30,88,0.341,20,66,0.303,10,22,0.455,10,12,0.833,80,31,87,0.356,24,64,0.375,7,23,0.304,14,16,0.875,83,2015-12-10,LAC,CHI,2016,86.5
13209,13209,9,@,L 80-94 ,240,28,80,0.35,18,41,0.439,10,39,0.256,14,20,0.7,80,36,77,0.468,31,67,0.463,5,10,0.5,17,27,0.63,94,2015-12-30,UTA,MIN,2016,96.5
13210,13210,10,Home,L 80-88 ,240,32,91,0.352,28,72,0.389,4,19,0.211,12,15,0.8,80,35,88,0.398,28,63,0.444,7,25,0.28,11,14,0.786,88,2016-03-20,NYK,SAC,2016,91.5
13211,13211,11,Home,L 80-109 ,240,35,88,0.398,31,72,0.431,4,16,0.25,6,12,0.5,80,41,75,0.547,23,39,0.59,18,36,0.5,9,10,0.9,109,2016-04-05,MIL,CLE,2016,118.0
13212,13212,12,@,L 80-116 ,240,27,75,0.36,23,51,0.451,4,24,0.167,22,29,0.759,80,43,78,0.551,31,58,0.534,12,20,0.6,18,23,0.783,116,2016-11-01,MEM,MIN,2017,122.0
13213,13213,13,@,L 80-112 ,240,33,85,0.388,24,55,0.436,9,30,0.3,5,6,0.833,80,42,89,0.472,39,70,0.557,3,19,0.158,25,31,0.806,112,2016-11-07,ORL,CHI,2017,113.5
13214,13214,14,@,L 80-111 ,240,31,88,0.352,25,58,0.431,6,30,0.2,12,14,0.857,80,38,87,0.437,27,55,0.491,11,32,0.344,24,33,0.727,111,2016-11-09,POR,LAC,2017,116.5
13215,13215,15,@,W 80-64 ,240,31,77,0.403,22,52,0.423,9,25,0.36,9,12,0.75,80,21,73,0.288,16,48,0.333,5,25,0.2,17,22,0.773,64,2016-11-18,MEM,DAL,2017,66.5
13216,13216,16,@,L 80-113 ,240,32,93,0.344,26,67,0.388,6,26,0.231,10,17,0.588,80,45,83,0.542,33,54,0.611,12,29,0.414,11,13,0.846,113,2016-12-02,LAL,TOR,2017,119.0
13217,13217,17,@,L 80-114 ,240,25,74,0.338,21,52,0.404,4,22,0.182,26,38,0.684,80,43,82,0.524,30,60,0.5,13,22,0.591,15,20,0.75,114,2016-12-29,OKC,MEM,2017,120.5
13218,13218,18,@,L 80-112 ,240,32,82,0.39,29,59,0.492,3,23,0.13,13,18,0.722,80,45,91,0.495,28,56,0.5,17,35,0.486,5,6,0.833,112,2017-02-11,ORL,DAL,2017,120.5
13219,13219,19,Home,L 80-107 ,240,35,90,0.389,31,71,0.437,4,19,0.211,6,11,0.545,80,39,78,0.5,31,62,0.5,8,16,0.5,21,26,0.808,107,2017-03-01,UTA,MIN,2017,111.0
13220,13220,20,@,L 79-91 ,240,27,75,0.36,20,56,0.357,7,19,0.368,18,21,0.857,79,32,87,0.368,25,72,0.347,7,15,0.467,20,25,0.8,91,2011-12-26,DET,IND,2012,94.5
13221,13221,21,@,L 79-101 ,240,31,82,0.378,28,66,0.424,3,16,0.188,14,22,0.636,79,38,85,0.447,35,67,0.522,3,18,0.167,22,28,0.786,101,2011-12-27,SAC,POR,2012,102.5
13222,13222,22,Home,L 79-100 ,240,30,83,0.361,25,68,0.368,5,15,0.333,14,18,0.778,79,37,84,0.44,25,56,0.446,12,28,0.429,14,24,0.583,100,2011-12-30,CHA,ORL,2012,106.0
13223,13223,23,Home,L 79-107 ,240,34,89,0.382,30,72,0.417,4,17,0.235,7,12,0.583,79,39,79,0.494,28,59,0.475,11,20,0.55,18,31,0.581,107,2011-12-31,GSW,PHI,2012,112.5
13224,13224,24,@,L 79-85 ,240,32,81,0.395,29,66,0.439,3,15,0.2,12,18,0.667,79,32,77,0.416,26,55,0.473,6,22,0.273,15,19,0.789,85,2012-01-11,PHI,NYK,2012,88.0
13225,13225,25,Home,L 79-88 ,240,31,75,0.413,25,61,0.41,6,14,0.429,11,13,0.846,79,34,76,0.447,30,63,0.476,4,13,0.308,16,21,0.762,88,2012-01-13,BOS,CHI,2012,90.0
13226,13226,26,@,L 79-108 ,240,31,85,0.365,27,65,0.415,4,20,0.2,13,21,0.619,79,39,82,0.476,36,74,0.486,3,8,0.375,27,31,0.871,108,2012-01-17,LAC,UTA,2012,109.5
13227,13227,27,@,W 79-71 ,240,31,69,0.449,26,50,0.52,5,19,0.263,12,16,0.75,79,30,74,0.405,26,64,0.406,4,10,0.4,7,9,0.778,71,2012-01-20,PHO,BOS,2012,73.0
13228,13228,28,@,L 79-99 ,240,28,82,0.341,24,68,0.353,4,14,0.286,19,27,0.704,79,41,77,0.532,34,61,0.557,7,16,0.438,10,14,0.714,99,2012-01-23,DET,OKC,2012,102.5
13229,13229,29,@,L 79-87 ,240,31,75,0.413,24,59,0.407,7,16,0.438,10,11,0.909,79,36,82,0.439,34,73,0.466,2,9,0.222,13,18,0.722,87,2012-01-27,SAS,MIN,2012,88.0
13230,13230,30,Home,L 79-99 ,240,32,81,0.395,27,69,0.391,5,12,0.417,10,14,0.714,79,40,77,0.519,32,64,0.5,8,13,0.615,11,20,0.55,99,2012-02-03,PHI,MIA,2012,103.0
13231,13231,31,@,L 79-90 ,240,30,74,0.405,21,49,0.429,9,25,0.36,10,21,0.476,79,34,88,0.386,26,68,0.382,8,20,0.4,14,19,0.737,90,2012-02-20,ATL,CHI,2012,94.0
13232,13232,32,@,L 79-121 ,240,28,75,0.373,23,58,0.397,5,17,0.294,18,23,0.783,79,43,80,0.538,24,42,0.571,19,38,0.5,16,26,0.615,121,2012-03-14,POR,NYK,2012,130.5
13233,13233,33,@,W 79-76 ,240,29,74,0.392,23,58,0.397,6,16,0.375,15,17,0.882,79,29,75,0.387,24,60,0.4,5,15,0.333,13,19,0.684,76,2012-03-19,BOS,ATL,2012,78.5
13234,13234,34,Home,L 79-82 ,240,29,75,0.387,21,58,0.362,8,17,0.471,13,18,0.722,79,29,79,0.367,27,66,0.409,2,13,0.154,22,28,0.786,82,2012-03-21,PHI,NYK,2012,83.0
13235,13235,35,@,L 79-96 ,240,32,85,0.376,27,57,0.474,5,28,0.179,10,18,0.556,79,38,83,0.458,37,70,0.529,1,13,0.077,19,26,0.731,96,2012-03-23,NYK,TOR,2012,96.5
13236,13236,36,@,L 79-101 ,240,28,76,0.368,22,57,0.386,6,19,0.316,17,22,0.773,79,38,78,0.487,32,58,0.552,6,20,0.3,19,30,0.633,101,2012-03-24,DET,NYK,2012,104.0
13237,13237,37,@,W 79-77 ,240,28,76,0.368,25,63,0.397,3,13,0.231,20,27,0.741,79,32,78,0.41,28,61,0.459,4,17,0.235,9,14,0.643,77,2012-03-26,DET,WAS,2012,79.0
13238,13238,38,Home,L 79-100 ,240,26,75,0.347,20,51,0.392,6,24,0.25,21,25,0.84,79,44,90,0.489,40,78,0.513,4,12,0.333,8,11,0.727,100,2012-03-30,MIN,BOS,2012,102.0
13239,13239,39,@,L 79-103 ,240,29,76,0.382,27,65,0.415,2,11,0.182,19,24,0.792,79,40,68,0.588,33,53,0.623,7,15,0.467,16,19,0.842,103,2012-04-08,PHI,BOS,2012,106.5
13240,13240,40,@,L 79-84 ,240,30,80,0.375,26,61,0.426,4,19,0.211,15,19,0.789,79,25,72,0.347,18,54,0.333,7,18,0.389,27,31,0.871,84,2012-04-13,BOS,TOR,2012,87.5
13241,13241,41,@,L 79-108 ,240,28,79,0.354,24,66,0.364,4,13,0.308,19,23,0.826,79,40,77,0.519,30,55,0.545,10,22,0.455,18,26,0.692,108,2012-11-04,DET,LAL,2013,113.0
13242,13242,42,@,L 79-101 ,240,27,79,0.342,21,59,0.356,6,20,0.3,19,22,0.864,79,41,87,0.471,33,69,0.478,8,18,0.444,11,13,0.846,101,2012-11-05,IND,SAS,2013,105.0
13243,13243,43,@,L 79-86 ,240,30,84,0.357,25,64,0.391,5,20,0.25,14,15,0.933,79,34,80,0.425,25,60,0.417,9,20,0.45,9,12,0.75,86,2012-11-18,CLE,PHI,2013,90.5
13244,13244,44,@,W 79-77 ,240,29,79,0.367,25,60,0.417,4,19,0.211,17,27,0.63,79,24,76,0.316,18,48,0.375,6,28,0.214,23,43,0.535,77,2012-11-27,IND,LAL,2013,80.0
13245,13245,45,Home,L 79-100 ,240,30,81,0.37,24,57,0.421,6,24,0.25,13,18,0.722,79,40,79,0.506,33,63,0.524,7,16,0.438,13,17,0.765,100,2012-12-01,NOP,OKC,2013,103.5
13246,13246,46,@,L 79-89 ,240,32,95,0.337,29,75,0.387,3,20,0.15,12,17,0.706,79,36,84,0.429,32,66,0.485,4,18,0.222,13,19,0.684,89,2012-12-03,CLE,DET,2013,91.0
13247,13247,47,@,L 79-92 ,240,31,79,0.392,27,62,0.435,4,17,0.235,13,16,0.813,79,40,75,0.533,36,61,0.59,4,14,0.286,8,12,0.667,92,2012-12-08,PHI,BOS,2013,94.0
13248,13248,48,@,L 79-102 ,240,31,70,0.443,27,48,0.563,4,22,0.182,13,16,0.813,79,41,77,0.532,33,54,0.611,8,23,0.348,12,17,0.706,102,2013-01-02,POR,TOR,2013,106.0
13249,13249,49,@,L 79-87 ,240,33,84,0.393,31,72,0.431,2,12,0.167,11,18,0.611,79,37,81,0.457,34,67,0.507,3,14,0.214,10,12,0.833,87,2013-01-09,PHO,BOS,2013,88.5
13250,13250,50,@,L 79-88 ,240,30,75,0.4,21,48,0.438,9,27,0.333,10,13,0.769,79,35,84,0.417,30,65,0.462,5,19,0.263,13,16,0.813,88,2013-01-09,HOU,NOH,2013,90.5
13251,13251,51,@,L 79-99 ,240,31,79,0.392,24,65,0.369,7,14,0.5,10,16,0.625,79,34,75,0.453,28,62,0.452,6,13,0.462,25,32,0.781,99,2013-01-11,PHO,BRK,2013,102.0
13252,13252,52,@,L 79-92 ,240,25,78,0.321,17,47,0.362,8,31,0.258,21,28,0.75,79,30,64,0.469,27,50,0.54,3,14,0.214,29,36,0.806,92,2013-01-19,HOU,MIN,2013,93.5
13253,13253,53,@,L 79-98 ,240,32,88,0.364,29,70,0.414,3,18,0.167,12,27,0.444,79,36,81,0.444,29,67,0.433,7,14,0.5,19,21,0.905,98,2013-01-30,DET,IND,2013,101.5
13254,13254,54,@,L 79-91 ,240,29,77,0.377,22,57,0.386,7,20,0.35,14,20,0.7,79,30,68,0.441,26,52,0.5,4,16,0.25,27,33,0.818,91,2013-03-10,BOS,OKC,2013,93.0
13255,13255,55,@,L 79-121 ,240,32,83,0.386,30,62,0.484,2,21,0.095,13,15,0.867,79,45,83,0.542,36,60,0.6,9,23,0.391,22,26,0.846,121,2013-03-13,CHI,SAC,2013,125.5
13256,13256,56,Home,L 79-88 ,240,28,83,0.337,25,68,0.368,3,15,0.2,20,22,0.909,79,33,68,0.485,27,53,0.509,6,15,0.4,16,25,0.64,88,2013-03-20,PHO,WAS,2013,91.0
13257,13257,57,Home,L 79-89 ,240,28,88,0.318,25,72,0.347,3,16,0.188,20,22,0.909,79,31,69,0.449,18,36,0.5,13,33,0.394,14,17,0.824,89,2013-04-05,CHA,MIA,2013,95.5
13258,13258,58,@,L 79-94 ,240,30,90,0.333,21,64,0.328,9,26,0.346,10,14,0.714,79,40,84,0.476,33,63,0.524,7,21,0.333,7,9,0.778,94,2013-11-08,CLE,PHI,2014,97.5
13259,13259,59,@,L 79-95 ,240,31,75,0.413,27,67,0.403,4,8,0.5,13,19,0.684,79,37,76,0.487,31,57,0.544,6,19,0.316,15,18,0.833,95,2013-11-11,MEM,IND,2014,98.0
13260,13260,60,@,L 79-92 ,240,33,91,0.363,28,76,0.368,5,15,0.333,8,11,0.727,79,39,77,0.506,31,55,0.564,8,22,0.364,6,8,0.75,92,2013-11-13,WAS,SAS,2014,96.0
13261,13261,61,Home,L 79-92 ,240,30,86,0.349,22,64,0.344,8,22,0.364,11,15,0.733,79,34,82,0.415,29,65,0.446,5,17,0.294,19,27,0.704,92,2013-11-16,MIL,OKC,2014,94.5
13262,13262,62,Home,L 79-99 ,240,34,77,0.442,32,65,0.492,2,12,0.167,9,19,0.474,79,42,79,0.532,36,62,0.581,6,17,0.353,9,12,0.75,99,2013-11-27,DET,CHI,2014,102.0
13263,13263,63,@,L 79-106 ,240,32,84,0.381,26,70,0.371,6,14,0.429,9,13,0.692,79,41,83,0.494,32,64,0.5,9,19,0.474,15,22,0.682,106,2013-12-22,BOS,IND,2014,110.5
13264,13264,64,Home,L 79-85 ,240,30,82,0.366,28,73,0.384,2,9,0.222,17,21,0.81,79,29,69,0.42,25,55,0.455,4,14,0.286,23,31,0.742,85,2013-12-31,CHI,TOR,2014,87.0
13265,13265,65,Home,L 79-94 ,240,29,81,0.358,22,57,0.386,7,24,0.292,14,18,0.778,79,40,91,0.44,34,68,0.5,6,23,0.261,8,14,0.571,94,2013-12-31,LAL,MIL,2014,97.0
13266,13266,66,@,L 79-86 ,240,30,81,0.37,25,62,0.403,5,19,0.263,14,18,0.778,79,32,75,0.427,31,64,0.484,1,11,0.091,21,26,0.808,86,2014-01-07,TOR,IND,2014,86.5
13267,13267,67,Home,L 79-105 ,240,29,76,0.382,27,63,0.429,2,13,0.154,19,27,0.704,79,41,84,0.488,30,66,0.455,11,18,0.611,12,17,0.706,105,2014-01-24,ATL,SAS,2014,110.5
13268,13268,68,Home,L 79-85 ,240,28,75,0.373,21,49,0.429,7,26,0.269,16,19,0.842,79,33,84,0.393,27,59,0.458,6,25,0.24,13,18,0.722,85,2014-01-26,BOS,BRK,2014,88.0
13269,13269,69,@,L 79-88 ,240,27,70,0.386,24,54,0.444,3,16,0.188,22,33,0.667,79,38,80,0.475,34,71,0.479,4,9,0.444,8,10,0.8,88,2014-02-01,CHI,NOP,2014,90.0
13270,13270,70,@,L 79-98 ,240,33,83,0.398,26,67,0.388,7,16,0.438,6,10,0.6,79,38,90,0.422,30,65,0.462,8,25,0.32,14,17,0.824,98,2014-02-03,ORL,IND,2014,102.0
13271,13271,71,Home,L 79-94 ,240,32,78,0.41,29,61,0.475,3,17,0.176,12,13,0.923,79,37,84,0.44,31,63,0.492,6,21,0.286,14,16,0.875,94,2014-02-03,UTA,TOR,2014,97.0
13272,13272,72,@,W 79-76 ,240,37,90,0.411,33,78,0.423,4,12,0.333,1,1,1.0,79,30,70,0.429,22,50,0.44,8,20,0.4,8,15,0.533,76,2014-02-08,MEM,ATL,2014,80.0
13273,13273,73,Home,L 79-96 ,240,33,85,0.388,29,69,0.42,4,16,0.25,9,13,0.692,79,37,85,0.435,31,68,0.456,6,17,0.353,16,25,0.64,96,2014-02-11,LAL,UTA,2014,99.0
13274,13274,74,@,L 79-93 ,240,29,81,0.358,23,60,0.383,6,21,0.286,15,17,0.882,79,37,88,0.42,28,65,0.431,9,23,0.391,10,14,0.714,93,2014-02-23,CHI,MIA,2014,97.5
13275,13275,75,@,L 79-99 ,240,28,80,0.35,14,51,0.275,14,29,0.483,9,14,0.643,79,43,88,0.489,39,73,0.534,4,15,0.267,9,12,0.75,99,2014-02-28,UTA,CLE,2014,101.0
13276,13276,76,@,L 79-91 ,240,28,77,0.364,23,66,0.348,5,11,0.455,18,24,0.75,79,34,79,0.43,32,68,0.471,2,11,0.182,21,25,0.84,91,2014-03-21,CHI,IND,2014,92.0
13277,13277,77,Home,L 79-99 ,240,32,80,0.4,28,66,0.424,4,14,0.286,11,18,0.611,79,36,93,0.387,31,68,0.456,5,25,0.2,22,27,0.815,99,2014-03-21,SAC,SAS,2014,101.5
13278,13278,78,@,L 79-89 ,240,31,84,0.369,25,58,0.431,6,26,0.231,11,19,0.579,79,30,85,0.353,24,61,0.393,6,24,0.25,23,31,0.742,89,2014-10-29,DET,DEN,2015,92.0
13279,13279,79,Home,L 79-86 ,240,31,88,0.352,28,64,0.438,3,24,0.125,14,20,0.7,79,30,72,0.417,23,49,0.469,7,23,0.304,19,31,0.613,86,2014-11-30,NYK,MIA,2015,89.5
13280,13280,80,@,L 79-95 ,240,30,72,0.417,24,47,0.511,6,25,0.24,13,22,0.591,79,38,91,0.418,28,61,0.459,10,30,0.333,9,13,0.692,95,2014-12-10,PHI,ATL,2015,100.0
13281,13281,81,@,L 79-101 ,240,31,93,0.333,24,66,0.364,7,27,0.259,10,15,0.667,79,38,81,0.469,22,45,0.489,16,36,0.444,9,12,0.75,101,2014-12-28,NYK,POR,2015,109.0
13282,13282,82,@,L 79-115 ,240,30,68,0.441,26,51,0.51,4,17,0.235,15,25,0.6,79,41,83,0.494,28,52,0.538,13,31,0.419,20,28,0.714,115,2015-01-03,MIA,HOU,2015,121.5
13283,13283,83,@,L 79-95 ,240,28,68,0.412,20,46,0.435,8,22,0.364,15,20,0.75,79,28,72,0.389,20,54,0.37,8,18,0.444,31,42,0.738,95,2015-01-15,NYK,MIL,2015,99.0
13284,13284,84,@,L 79-122 ,240,30,87,0.345,23,63,0.365,7,24,0.292,12,19,0.632,79,44,81,0.543,31,54,0.574,13,27,0.481,21,27,0.778,122,2015-01-19,DEN,GSW,2015,128.5
13285,13285,85,Home,L 79-97 ,240,33,87,0.379,30,75,0.4,3,12,0.25,10,15,0.667,79,36,78,0.462,27,52,0.519,9,26,0.346,16,28,0.571,97,2015-02-27,MEM,LAC,2015,101.5
13286,13286,86,@,L 79-110 ,240,31,88,0.352,24,60,0.4,7,28,0.25,10,13,0.769,79,43,89,0.483,33,61,0.541,10,28,0.357,14,14,1.0,110,2015-03-03,BOS,CLE,2015,115.0
13287,13287,87,@,L 79-89 ,240,30,84,0.357,21,59,0.356,9,25,0.36,10,14,0.714,79,31,75,0.413,23,55,0.418,8,20,0.4,19,23,0.826,89,2015-03-07,PHO,CLE,2015,93.0
13288,13288,88,Home,L 79-80 ,240,30,84,0.357,24,62,0.387,6,22,0.273,13,18,0.722,79,31,82,0.378,25,62,0.403,6,20,0.3,12,13,0.923,80,2015-04-11,ORL,NYK,2015,83.0
13289,13289,89,@,L 79-89 ,240,30,91,0.33,24,72,0.333,6,19,0.316,13,14,0.929,79,31,74,0.419,19,47,0.404,12,27,0.444,15,18,0.833,89,2015-11-07,MEM,UTA,2016,95.0
13290,13290,90,@,L 79-112 ,240,32,81,0.395,27,63,0.429,5,18,0.278,10,18,0.556,79,43,76,0.566,37,62,0.597,6,14,0.429,20,33,0.606,112,2015-12-30,PHO,SAS,2016,115.0
13291,13291,91,@,L 79-104 ,240,29,76,0.382,23,51,0.451,6,25,0.24,15,17,0.882,79,34,82,0.415,22,45,0.489,12,37,0.324,24,39,0.615,104,2016-01-02,ORL,CLE,2016,110.0
13292,13292,92,Home,L 79-106 ,240,33,73,0.452,31,61,0.508,2,12,0.167,11,13,0.846,79,44,82,0.537,40,69,0.58,4,13,0.308,14,19,0.737,106,2016-01-11,BRK,SAS,2016,108.0
13293,13293,93,Home,L 79-91 ,240,27,74,0.365,22,52,0.423,5,22,0.227,20,26,0.769,79,36,74,0.486,31,62,0.5,5,12,0.417,14,16,0.875,91,2016-01-19,MIA,MIL,2016,93.5
13294,13294,94,@,L 79-91 ,240,28,78,0.359,24,58,0.414,4,20,0.2,19,23,0.826,79,37,80,0.463,29,59,0.492,8,21,0.381,9,15,0.6,91,2016-01-29,BRK,DAL,2016,95.0
13295,13295,95,Home,L 79-96 ,240,25,77,0.325,18,41,0.439,7,36,0.194,22,30,0.733,79,35,87,0.402,24,52,0.462,11,35,0.314,15,23,0.652,96,2016-02-06,HOU,POR,2016,101.5
13296,13296,96,@,L 79-87 ,240,31,82,0.378,22,46,0.478,9,36,0.25,8,10,0.8,79,32,78,0.41,24,57,0.421,8,21,0.381,15,18,0.833,87,2016-03-19,GSW,SAS,2016,91.0
13297,13297,97,@,L 79-91 ,240,31,89,0.348,25,67,0.373,6,22,0.273,11,20,0.55,79,35,80,0.438,27,60,0.45,8,20,0.4,13,21,0.619,91,2016-03-23,TOR,BOS,2016,95.0
13298,13298,98,Home,L 79-99 ,240,30,87,0.345,22,64,0.344,8,23,0.348,11,17,0.647,79,37,84,0.44,28,53,0.528,9,31,0.29,16,18,0.889,99,2016-03-30,MIN,LAC,2016,103.5
13299,13299,99,@,L 79-112 ,240,23,81,0.284,16,50,0.32,7,31,0.226,26,30,0.867,79,42,96,0.438,30,59,0.508,12,37,0.324,16,27,0.593,112,2016-04-11,LAL,OKC,2016,118.0
13300,13300,0,@,L 79-98 ,240,32,86,0.372,28,64,0.438,4,22,0.182,11,15,0.733,79,35,83,0.422,25,59,0.424,10,24,0.417,18,23,0.783,98,2016-10-29,NOP,SAS,2017,103.0
13301,13301,1,Home,L 79-97 ,240,32,82,0.39,27,63,0.429,5,19,0.263,10,14,0.714,79,38,68,0.559,31,51,0.608,7,17,0.412,14,17,0.824,97,2016-12-11,DET,PHI,2017,100.5
13302,13302,2,@,L 79-99 ,240,30,76,0.395,22,45,0.489,8,31,0.258,11,17,0.647,79,34,77,0.442,21,44,0.477,13,33,0.394,18,22,0.818,99,2016-12-18,SAC,DAL,2017,105.5
13303,13303,3,Home,L 79-109 ,240,34,83,0.41,31,62,0.5,3,21,0.143,8,9,0.889,79,43,87,0.494,36,60,0.6,7,27,0.259,16,21,0.762,109,2016-12-18,ORL,TOR,2017,112.5
13304,13304,4,@,L 79-88 ,240,28,72,0.389,19,49,0.388,9,23,0.391,14,23,0.609,79,34,78,0.436,25,54,0.463,9,24,0.375,11,14,0.786,88,2017-01-08,UTA,MEM,2017,92.5
13305,13305,5,Home,L 79-107 ,240,30,76,0.395,26,58,0.448,4,18,0.222,15,19,0.789,79,42,89,0.472,34,58,0.586,8,31,0.258,15,19,0.789,107,2017-02-15,ORL,SAS,2017,111.0
13306,13306,6,@,L 78-92 ,240,28,70,0.4,24,49,0.49,4,21,0.19,18,25,0.72,78,35,77,0.455,29,61,0.475,6,16,0.375,16,24,0.667,92,2011-12-28,NYK,GSW,2012,95.0
13307,13307,7,@,L 78-97 ,240,29,78,0.372,22,61,0.361,7,17,0.412,13,18,0.722,78,36,79,0.456,32,67,0.478,4,12,0.333,21,25,0.84,97,2011-12-28,BOS,NOH,2012,99.0
13308,13308,8,@,L 78-94 ,240,29,77,0.377,23,60,0.383,6,17,0.353,14,21,0.667,78,36,81,0.444,27,60,0.45,9,21,0.429,13,25,0.52,94,2011-12-29,BRK,ORL,2012,98.5
13309,13309,9,Home,L 78-93 ,240,26,90,0.289,23,76,0.303,3,14,0.214,23,28,0.821,78,33,78,0.423,26,55,0.473,7,23,0.304,20,22,0.909,93,2011-12-30,NOP,PHO,2012,96.5
13310,13310,10,@,L 78-89 ,240,28,63,0.444,20,41,0.488,8,22,0.364,14,21,0.667,78,31,62,0.5,29,54,0.537,2,8,0.25,25,33,0.758,89,2012-01-02,ORL,DET,2012,90.0
13311,13311,11,@,L 78-98 ,240,29,79,0.367,26,55,0.473,3,24,0.125,17,24,0.708,78,38,92,0.413,32,69,0.464,6,23,0.261,16,18,0.889,98,2012-01-08,CLE,POR,2012,101.0
13312,13312,12,@,L 78-93 ,240,30,76,0.395,26,56,0.464,4,20,0.2,14,17,0.824,78,40,82,0.488,36,69,0.522,4,13,0.308,9,17,0.529,93,2012-01-10,TOR,WAS,2012,95.0
13313,13313,13,Home,W 78-64 ,240,33,90,0.367,30,78,0.385,3,12,0.25,9,16,0.563,78,26,84,0.31,23,75,0.307,3,9,0.333,9,12,0.75,64,2012-01-11,CHI,WAS,2012,65.5
13314,13314,14,Home,L 78-111 ,240,27,82,0.329,24,71,0.338,3,11,0.273,21,22,0.955,78,39,78,0.5,32,59,0.542,7,19,0.368,26,33,0.788,111,2012-01-24,CHA,NYK,2012,114.5
13315,13315,15,@,W 78-77 ,240,33,85,0.388,31,66,0.47,2,19,0.105,10,15,0.667,78,29,71,0.408,25,56,0.446,4,15,0.267,15,23,0.652,77,2012-02-10,LAC,PHI,2012,79.0
13316,13316,16,@,L 78-86 ,240,31,90,0.344,24,63,0.381,7,27,0.259,9,14,0.643,78,37,84,0.44,29,67,0.433,8,17,0.471,4,9,0.444,86,2012-02-14,ATL,LAL,2012,90.0
13317,13317,17,@,L 78-90 ,240,27,74,0.365,16,45,0.356,11,29,0.379,13,25,0.52,78,38,80,0.475,35,68,0.515,3,12,0.25,11,14,0.786,90,2012-02-19,ORL,MIA,2012,91.5
13318,13318,18,@,L 78-83 ,240,31,82,0.378,24,50,0.48,7,32,0.219,9,13,0.692,78,31,78,0.397,24,61,0.393,7,17,0.412,14,20,0.7,83,2012-02-23,ORL,ATL,2012,86.5
13319,13319,19,@,L 78-102 ,240,29,85,0.341,26,63,0.413,3,22,0.136,17,24,0.708,78,37,84,0.44,32,73,0.438,5,11,0.455,23,32,0.719,102,2012-02-28,GSW,IND,2012,104.5
13320,13320,20,@,L 78-81 ,240,32,87,0.368,26,71,0.366,6,16,0.375,8,9,0.889,78,28,80,0.35,21,59,0.356,7,21,0.333,18,29,0.621,81,2012-03-02,LAC,PHO,2012,84.5
13321,13321,21,@,L 78-108 ,240,31,83,0.373,23,61,0.377,8,22,0.364,8,12,0.667,78,45,77,0.584,35,60,0.583,10,17,0.588,8,9,0.889,108,2012-03-06,BRK,MIA,2012,113.0
13322,13322,22,Home,L 78-84 ,240,33,93,0.355,28,75,0.373,5,18,0.278,7,14,0.5,78,35,74,0.473,31,62,0.5,4,12,0.333,10,19,0.526,84,2012-03-16,PHI,MIA,2012,86.0
13323,13323,23,@,L 78-92 ,240,30,91,0.33,22,67,0.328,8,24,0.333,10,15,0.667,78,36,74,0.486,32,65,0.492,4,9,0.444,16,17,0.941,92,2012-04-01,CHI,OKC,2012,94.0
13324,13324,24,Home,L 78-99 ,240,34,79,0.43,31,67,0.463,3,12,0.25,7,8,0.875,78,39,77,0.506,30,56,0.536,9,21,0.429,12,12,1.0,99,2012-04-04,PHI,TOR,2012,103.5
13325,13325,25,Home,W 78-66 ,240,32,74,0.432,28,62,0.452,4,12,0.333,10,16,0.625,78,28,73,0.384,22,56,0.393,6,17,0.353,4,7,0.571,66,2012-04-24,BOS,MIA,2012,69.0
13326,13326,26,@,L 78-84 ,240,31,76,0.408,27,60,0.45,4,16,0.25,12,15,0.8,78,33,71,0.465,29,60,0.483,4,11,0.364,14,18,0.778,84,2012-11-26,CLE,MEM,2013,86.0
13327,13327,27,Home,L 78-91 ,240,30,84,0.357,28,69,0.406,2,15,0.133,16,22,0.727,78,37,79,0.468,31,62,0.5,6,17,0.353,11,18,0.611,91,2012-11-27,CLE,PHO,2013,94.0
13328,13328,28,@,L 78-101 ,240,28,81,0.346,24,63,0.381,4,18,0.222,18,20,0.9,78,34,69,0.493,28,59,0.475,6,10,0.6,27,33,0.818,101,2012-11-28,DAL,CHI,2013,104.0
13329,13329,29,@,L 78-96 ,240,24,69,0.348,21,54,0.389,3,15,0.2,27,37,0.73,78,36,73,0.493,30,57,0.526,6,16,0.375,18,20,0.9,96,2012-11-30,POR,BOS,2013,99.0
13330,13330,30,@,L 78-90 ,240,29,72,0.403,25,56,0.446,4,16,0.25,16,20,0.8,78,34,85,0.4,30,73,0.411,4,12,0.333,18,21,0.857,90,2012-11-30,DET,MEM,2013,92.0
13331,13331,31,@,L 78-92 ,240,30,78,0.385,25,49,0.51,5,29,0.172,13,29,0.448,78,37,82,0.451,30,59,0.508,7,23,0.304,11,21,0.524,92,2013-01-01,LAC,DEN,2013,95.5
13332,13332,32,@,L 78-99 ,240,28,75,0.373,25,63,0.397,3,12,0.25,19,22,0.864,78,39,86,0.453,27,59,0.458,12,27,0.444,9,11,0.818,99,2013-01-11,CHA,TOR,2013,105.0
13333,13333,33,Home,L 78-90 ,240,34,74,0.459,30,56,0.536,4,18,0.222,6,16,0.375,78,31,71,0.437,29,54,0.537,2,17,0.118,26,31,0.839,90,2013-01-16,BOS,NOH,2013,91.0
13334,13334,34,@,L 78-102 ,240,30,73,0.411,26,54,0.481,4,19,0.211,14,17,0.824,78,38,69,0.551,29,53,0.547,9,16,0.563,17,21,0.81,102,2013-01-30,CHA,SAS,2013,106.5
13335,13335,35,Home,W 78-61 ,240,36,79,0.456,33,59,0.559,3,20,0.15,3,5,0.6,78,27,80,0.338,26,68,0.382,1,12,0.083,6,8,0.75,61,2013-02-04,PHI,ORL,2013,61.5
13336,13336,36,Home,L 78-99 ,240,32,84,0.381,28,66,0.424,4,18,0.222,10,15,0.667,78,34,67,0.507,21,40,0.525,13,27,0.481,18,22,0.818,99,2013-03-06,CHA,BRK,2013,105.5
13337,13337,37,@,L 78-95 ,240,32,90,0.356,29,73,0.397,3,17,0.176,11,17,0.647,78,32,81,0.395,20,54,0.37,12,27,0.444,19,33,0.576,95,2013-03-08,WAS,BRK,2013,101.0
13338,13338,38,@,L 78-92 ,240,26,80,0.325,20,58,0.345,6,22,0.273,20,29,0.69,78,33,68,0.485,30,58,0.517,3,10,0.3,23,27,0.852,92,2013-03-15,CHA,TOR,2013,93.5
13339,13339,39,Home,L 78-108 ,240,28,86,0.326,19,51,0.373,9,35,0.257,13,16,0.813,78,44,96,0.458,31,70,0.443,13,26,0.5,7,9,0.778,108,2013-03-17,HOU,GSW,2013,114.5
13340,13340,40,@,L 78-116 ,240,31,86,0.36,27,66,0.409,4,20,0.2,12,15,0.8,78,44,77,0.571,34,48,0.708,10,29,0.345,18,27,0.667,116,2013-03-22,CLE,HOU,2013,121.0
13341,13341,41,@,L 78-102 ,240,31,101,0.307,28,82,0.341,3,19,0.158,13,22,0.591,78,38,79,0.481,35,67,0.522,3,12,0.25,23,30,0.767,102,2013-03-22,MIL,IND,2013,103.5
13342,13342,42,Home,L 78-103 ,240,32,83,0.386,28,69,0.406,4,14,0.286,10,14,0.714,78,40,84,0.476,33,69,0.478,7,15,0.467,16,26,0.615,103,2013-03-28,DAL,IND,2013,106.5
13343,13343,43,@,L 78-88 ,240,26,80,0.325,21,61,0.344,5,19,0.263,21,29,0.724,78,30,66,0.455,29,58,0.5,1,8,0.125,27,36,0.75,88,2013-04-03,WAS,TOR,2013,88.5
13344,13344,44,Home,L 78-82 ,240,23,74,0.311,12,42,0.286,11,32,0.344,21,28,0.75,78,29,83,0.349,24,66,0.364,5,17,0.294,19,28,0.679,82,2013-04-12,HOU,MEM,2013,84.5
13345,13345,45,@,W 78-74 ,240,30,75,0.4,28,64,0.438,2,11,0.182,16,20,0.8,78,31,83,0.373,28,68,0.412,3,15,0.2,9,14,0.643,74,2013-12-10,MIL,CHI,2014,75.5
13346,13346,46,@,L 78-83 ,240,24,72,0.333,18,51,0.353,6,21,0.286,24,29,0.828,78,31,76,0.408,26,57,0.456,5,19,0.263,16,19,0.842,83,2013-12-11,CHI,NYK,2014,85.5
13347,13347,47,Home,L 78-95 ,240,25,71,0.352,20,54,0.37,5,17,0.294,23,31,0.742,78,36,74,0.486,31,57,0.544,5,17,0.294,18,20,0.9,95,2013-12-25,BRK,CHI,2014,97.5
13348,13348,48,Home,L 78-87 ,240,33,88,0.375,28,64,0.438,5,24,0.208,7,10,0.7,78,30,78,0.385,24,54,0.444,6,24,0.25,21,23,0.913,87,2014-01-01,WAS,DAL,2014,90.0
13349,13349,49,Home,L 78-82 ,240,27,79,0.342,21,59,0.356,6,20,0.3,18,20,0.9,78,28,77,0.364,20,53,0.377,8,24,0.333,18,22,0.818,82,2014-01-05,CLE,IND,2014,86.0
13350,13350,50,@,L 78-103 ,240,34,97,0.351,32,78,0.41,2,19,0.105,8,12,0.667,78,40,82,0.488,34,62,0.548,6,20,0.3,17,20,0.85,103,2014-01-18,PHI,CHI,2014,106.0
13351,13351,51,@,L 78-93 ,240,30,74,0.405,23,50,0.46,7,24,0.292,11,14,0.786,78,37,88,0.42,33,74,0.446,4,14,0.286,15,23,0.652,93,2014-01-24,MIL,CLE,2014,95.0
13352,13352,52,@,L 78-123 ,240,27,100,0.27,24,72,0.333,3,28,0.107,21,25,0.84,78,50,89,0.562,41,61,0.672,9,28,0.321,14,17,0.824,123,2014-02-09,PHI,LAC,2014,127.5
13353,13353,53,@,L 78-102 ,240,29,88,0.33,25,61,0.41,4,27,0.148,16,19,0.842,78,35,79,0.443,22,50,0.44,13,29,0.448,19,21,0.905,102,2014-03-05,ATL,POR,2014,108.5
13354,13354,54,Home,L 78-110 ,240,30,79,0.38,27,55,0.491,3,24,0.125,15,21,0.714,78,43,79,0.544,35,60,0.583,8,19,0.421,16,22,0.727,110,2014-03-28,DET,MIA,2014,114.0
13355,13355,55,@,L 78-91 ,240,28,79,0.354,26,66,0.394,2,13,0.154,20,25,0.8,78,34,87,0.391,27,64,0.422,7,23,0.304,16,17,0.941,91,2014-03-28,IND,WAS,2014,94.5
13356,13356,56,Home,L 78-96 ,240,34,86,0.395,31,70,0.443,3,16,0.188,7,12,0.583,78,35,79,0.443,26,56,0.464,9,23,0.391,17,21,0.81,96,2014-04-05,WAS,CHI,2014,100.5
13357,13357,57,@,L 78-85 ,240,29,87,0.333,23,67,0.343,6,20,0.3,14,19,0.737,78,33,81,0.407,30,66,0.455,3,15,0.2,16,24,0.667,85,2014-11-11,OKC,MIL,2015,86.5
13358,13358,58,@,L 78-91 ,240,27,75,0.36,21,48,0.438,6,27,0.222,18,23,0.783,78,41,84,0.488,37,74,0.5,4,10,0.4,5,9,0.556,91,2014-11-21,CLE,WAS,2015,93.0
13359,13359,59,@,L 78-105 ,240,29,75,0.387,27,56,0.482,2,19,0.105,18,24,0.75,78,38,86,0.442,28,62,0.452,10,24,0.417,19,23,0.826,105,2014-11-28,NYK,OKC,2015,110.0
13360,13360,60,@,L 78-99 ,240,32,84,0.381,28,67,0.418,4,17,0.235,10,15,0.667,78,36,82,0.439,21,48,0.438,15,34,0.441,12,20,0.6,99,2014-12-31,NYK,LAC,2015,106.5
13361,13361,61,@,W 78-75 ,240,33,78,0.423,31,62,0.5,2,16,0.125,10,15,0.667,78,29,92,0.315,25,69,0.362,4,23,0.174,13,18,0.722,75,2015-01-13,MIA,LAL,2015,77.0
13362,13362,62,Home,W 78-76 ,240,27,80,0.338,23,61,0.377,4,19,0.211,20,30,0.667,78,29,84,0.345,24,66,0.364,5,18,0.278,13,15,0.867,76,2015-01-21,CHA,MIA,2015,78.5
13363,13363,63,Home,L 78-101 ,240,29,79,0.367,26,58,0.448,3,21,0.143,17,22,0.773,78,41,96,0.427,29,62,0.468,12,34,0.353,7,10,0.7,101,2015-02-05,SAC,DAL,2015,107.0
13364,13364,64,Home,L 78-106 ,240,29,81,0.358,20,57,0.351,9,24,0.375,11,14,0.786,78,37,83,0.446,32,64,0.5,5,19,0.263,27,30,0.9,106,2015-02-10,CHA,DET,2015,108.5
13365,13365,65,@,L 78-106 ,240,29,75,0.387,24,62,0.387,5,13,0.385,15,25,0.6,78,38,87,0.437,30,63,0.476,8,24,0.333,22,29,0.759,106,2015-03-09,NYK,DEN,2015,110.0
13366,13366,66,@,L 78-102 ,240,31,88,0.352,26,66,0.394,5,22,0.227,11,18,0.611,78,38,90,0.422,29,68,0.426,9,22,0.409,17,24,0.708,102,2015-04-01,DET,CHO,2015,106.5
13367,13367,67,Home,L 78-106 ,240,29,75,0.387,22,58,0.379,7,17,0.412,13,22,0.591,78,40,75,0.533,25,48,0.521,15,27,0.556,11,18,0.611,106,2015-04-05,LAL,LAC,2015,113.5
13368,13368,68,Home,L 78-89 ,240,34,88,0.386,29,70,0.414,5,18,0.278,5,7,0.714,78,35,91,0.385,29,68,0.426,6,23,0.261,13,17,0.765,89,2015-04-09,MIA,CHI,2015,92.0
13369,13369,69,@,L 78-117 ,240,31,79,0.392,28,57,0.491,3,22,0.136,13,19,0.684,78,46,84,0.548,36,60,0.6,10,24,0.417,15,22,0.682,117,2015-04-12,CLE,BOS,2015,122.0
13370,13370,70,Home,L 78-95 ,240,29,95,0.305,24,70,0.343,5,25,0.2,15,20,0.75,78,30,71,0.423,28,60,0.467,2,11,0.182,33,41,0.805,95,2015-10-30,DEN,MIN,2016,96.0
13371,13371,71,@,L 78-95 ,240,28,87,0.322,24,63,0.381,4,24,0.167,18,21,0.857,78,31,81,0.383,26,62,0.419,5,19,0.263,28,36,0.778,95,2015-11-23,NYK,MIA,2016,97.5
13372,13372,72,@,L 78-111 ,240,27,84,0.321,22,66,0.333,5,18,0.278,19,22,0.864,78,42,97,0.433,30,64,0.469,12,33,0.364,15,19,0.789,111,2015-11-27,WAS,BOS,2016,117.0
13373,13373,73,Home,L 78-97 ,240,32,85,0.376,29,71,0.408,3,14,0.214,11,15,0.733,78,33,76,0.434,26,59,0.441,7,17,0.412,24,28,0.857,97,2015-11-27,NYK,MIA,2016,100.5
13374,13374,74,Home,L 78-103 ,240,30,80,0.375,25,56,0.446,5,24,0.208,13,16,0.813,78,36,74,0.486,26,54,0.481,10,20,0.5,21,22,0.955,103,2015-12-12,ATL,SAS,2016,108.0
13375,13375,75,@,L 78-118 ,240,30,86,0.349,22,58,0.379,8,28,0.286,10,17,0.588,78,46,84,0.548,37,65,0.569,9,19,0.474,17,25,0.68,118,2015-12-19,LAL,OKC,2016,122.5
13376,13376,76,Home,L 78-91 ,240,28,72,0.389,21,44,0.477,7,28,0.25,15,24,0.625,78,35,91,0.385,32,76,0.421,3,15,0.2,18,26,0.692,91,2016-01-04,POR,MEM,2016,92.5
13377,13377,77,@,W 78-74 ,240,29,81,0.358,21,61,0.344,8,20,0.4,12,17,0.706,78,28,73,0.384,25,62,0.403,3,11,0.273,15,20,0.75,74,2016-01-06,DEN,MIN,2016,75.5
13378,13378,78,Home,L 78-91 ,240,35,84,0.417,31,65,0.477,4,19,0.211,4,8,0.5,78,36,77,0.468,31,60,0.517,5,17,0.294,14,20,0.7,91,2016-01-20,BRK,CLE,2016,93.5
13379,13379,79,@,L 78-91 ,240,27,74,0.365,22,51,0.431,5,23,0.217,19,24,0.792,78,31,78,0.397,23,49,0.469,8,29,0.276,21,23,0.913,91,2016-01-31,PHO,DAL,2016,95.0
13380,13380,80,Home,L 78-96 ,240,33,77,0.429,30,60,0.5,3,17,0.176,9,12,0.75,78,38,79,0.481,29,61,0.475,9,18,0.5,11,12,0.917,96,2016-02-25,UTA,SAS,2016,100.5
13381,13381,81,Home,L 78-88 ,240,29,71,0.408,25,50,0.5,4,21,0.19,16,18,0.889,78,32,83,0.386,18,43,0.419,14,40,0.35,10,17,0.588,88,2016-04-03,MIN,DAL,2016,95.0
13382,13382,82,@,L 78-113 ,240,29,86,0.337,22,56,0.393,7,30,0.233,13,14,0.929,78,40,80,0.5,28,55,0.509,12,25,0.48,21,25,0.84,113,2017-01-20,TOR,CHO,2017,119.0
13383,13383,83,@,L 77-92 ,240,24,81,0.296,17,58,0.293,7,23,0.304,22,26,0.846,77,36,77,0.468,26,50,0.52,10,27,0.37,10,13,0.769,92,2012-01-04,CLE,TOR,2012,97.0
13384,13384,84,@,L 77-102 ,240,25,77,0.325,23,58,0.397,2,19,0.105,25,35,0.714,77,37,79,0.468,30,59,0.508,7,20,0.35,21,25,0.84,102,2012-01-06,POR,PHO,2012,105.5
13385,13385,85,@,L 77-99 ,240,29,89,0.326,24,73,0.329,5,16,0.313,14,21,0.667,77,39,77,0.506,37,68,0.544,2,9,0.222,19,26,0.731,99,2012-01-07,CHA,IND,2012,100.0
13386,13386,86,Home,W 77-64 ,240,33,82,0.402,29,67,0.433,4,15,0.267,7,12,0.583,77,30,86,0.349,27,76,0.355,3,10,0.3,1,7,0.143,64,2012-01-14,CHI,TOR,2012,65.5
13387,13387,87,Home,L 77-84 ,240,28,68,0.412,28,59,0.475,0,9,0.0,21,28,0.75,77,34,72,0.472,28,52,0.538,6,20,0.3,10,15,0.667,84,2012-01-16,NOP,POR,2012,87.0
13388,13388,88,Home,L 77-100 ,240,27,73,0.37,23,53,0.434,4,20,0.2,19,23,0.826,77,41,80,0.513,34,62,0.548,7,18,0.389,11,13,0.846,100,2012-01-31,TOR,ATL,2012,103.5
13389,13389,89,Home,L 77-96 ,240,33,75,0.44,28,60,0.467,5,15,0.333,6,9,0.667,77,41,85,0.482,39,78,0.5,2,7,0.286,12,19,0.632,96,2012-02-02,ATL,MEM,2012,97.0
13390,13390,90,Home,L 77-78 ,240,29,71,0.408,25,56,0.446,4,15,0.267,15,23,0.652,77,33,85,0.388,31,66,0.47,2,19,0.105,10,15,0.667,78,2012-02-10,PHI,LAC,2012,79.0
13391,13391,91,Home,L 77-98 ,240,29,89,0.326,28,78,0.359,1,11,0.091,18,19,0.947,77,37,79,0.468,31,64,0.484,6,15,0.4,18,21,0.857,98,2012-02-12,DET,WAS,2012,101.0
13392,13392,92,@,L 77-97 ,240,30,73,0.411,23,46,0.5,7,27,0.259,10,13,0.769,77,38,81,0.469,29,59,0.492,9,22,0.409,12,16,0.75,97,2012-02-18,ATL,POR,2012,101.5
13393,13393,93,Home,L 77-79 ,240,32,78,0.41,28,61,0.459,4,17,0.235,9,14,0.643,77,28,76,0.368,25,63,0.397,3,13,0.231,20,27,0.741,79,2012-03-26,WAS,DET,2012,80.5
13394,13394,94,Home,L 77-98 ,240,32,80,0.4,27,63,0.429,5,17,0.294,8,9,0.889,77,38,81,0.469,29,65,0.446,9,16,0.563,13,20,0.65,98,2012-03-28,ATL,CHI,2012,102.5
13395,13395,95,@,L 77-92 ,240,27,72,0.375,22,50,0.44,5,22,0.227,18,29,0.621,77,36,81,0.444,27,61,0.443,9,20,0.45,11,16,0.688,92,2012-04-16,OKC,LAC,2012,96.5
13396,13396,96,@,L 77-116 ,240,27,78,0.346,20,57,0.351,7,21,0.333,16,21,0.762,77,45,75,0.6,37,57,0.649,8,18,0.444,18,20,0.9,116,2012-04-17,CLE,DET,2012,120.0
13397,13397,97,@,L 77-84 ,240,27,68,0.397,22,53,0.415,5,15,0.333,18,30,0.6,77,32,91,0.352,23,63,0.365,9,28,0.321,11,14,0.786,84,2012-04-26,NOP,HOU,2012,88.5
13398,13398,98,@,W 77-62 ,240,35,84,0.417,31,62,0.5,4,22,0.182,3,5,0.6,77,23,69,0.333,19,50,0.38,4,19,0.211,12,16,0.75,62,2012-11-07,PHI,NOH,2013,64.0
13399,13399,99,@,L 77-101 ,240,29,86,0.337,22,61,0.361,7,25,0.28,12,20,0.6,77,36,90,0.4,28,62,0.452,8,28,0.286,21,28,0.75,101,2012-11-09,GSW,LAL,2013,105.0
13400,13400,0,Home,L 77-79 ,240,24,76,0.316,18,48,0.375,6,28,0.214,23,43,0.535,77,29,79,0.367,25,60,0.417,4,19,0.211,17,27,0.63,79,2012-11-27,LAL,IND,2013,81.0
13401,13401,1,@,L 77-117 ,240,28,82,0.341,22,61,0.361,6,21,0.286,15,20,0.75,77,40,76,0.526,28,60,0.467,12,16,0.75,25,35,0.714,117,2012-11-28,PHO,DET,2013,123.0
13402,13402,2,@,L 77-92 ,240,29,85,0.341,24,64,0.375,5,21,0.238,14,18,0.778,77,38,93,0.409,27,68,0.397,11,25,0.44,5,8,0.625,92,2012-12-01,DET,DAL,2013,97.5
13403,13403,3,@,W 77-70 ,240,27,82,0.329,22,63,0.349,5,19,0.263,18,23,0.783,77,26,80,0.325,22,64,0.344,4,16,0.25,14,22,0.636,70,2012-12-11,WAS,NOH,2013,72.0
13404,13404,4,Home,L 77-88 ,240,32,83,0.386,29,70,0.414,3,13,0.231,10,15,0.667,77,35,72,0.486,28,48,0.583,7,24,0.292,11,16,0.688,88,2012-12-15,DET,IND,2013,91.5
13405,13405,5,@,L 77-93 ,240,29,75,0.387,27,56,0.482,2,19,0.105,17,22,0.773,77,37,74,0.5,33,54,0.611,4,20,0.2,15,19,0.789,93,2012-12-19,NOP,LAC,2013,95.0
13406,13406,6,Home,L 77-103 ,240,29,80,0.363,26,63,0.413,3,17,0.176,16,24,0.667,77,38,71,0.535,27,50,0.54,11,21,0.524,16,29,0.552,103,2012-12-23,PHO,LAC,2013,108.5
13407,13407,7,@,L 77-106 ,240,29,72,0.403,23,56,0.411,6,16,0.375,13,15,0.867,77,41,85,0.482,29,55,0.527,12,30,0.4,12,24,0.5,106,2012-12-27,BOS,LAC,2013,112.0
13408,13408,8,@,L 77-87 ,240,31,85,0.365,28,75,0.373,3,10,0.3,12,18,0.667,77,34,87,0.391,27,71,0.38,7,16,0.438,12,18,0.667,87,2012-12-29,WAS,CHI,2013,90.5
13409,13409,9,@,L 77-87 ,240,28,68,0.412,20,49,0.408,8,19,0.421,13,18,0.722,77,33,91,0.363,24,69,0.348,9,22,0.409,12,19,0.632,87,2013-01-08,MIA,IND,2013,91.5
13410,13410,10,Home,L 77-90 ,240,30,84,0.357,26,65,0.4,4,19,0.211,13,20,0.65,77,35,77,0.455,30,64,0.469,5,13,0.385,15,23,0.652,90,2013-01-17,MIN,LAC,2013,92.5
13411,13411,11,@,L 77-101 ,240,29,71,0.408,26,54,0.481,3,17,0.176,16,25,0.64,77,47,90,0.522,43,81,0.531,4,9,0.444,3,8,0.375,101,2013-01-25,BRK,MEM,2013,103.0
13412,13412,12,@,L 77-97 ,240,32,79,0.405,26,52,0.5,6,27,0.222,7,9,0.778,77,37,74,0.5,24,45,0.533,13,29,0.448,10,12,0.833,97,2013-01-28,ORL,BRK,2013,103.5
13413,13413,13,@,L 77-86 ,240,29,79,0.367,22,59,0.373,7,20,0.35,12,16,0.75,77,35,81,0.432,31,66,0.47,4,15,0.267,12,17,0.706,86,2013-02-01,POR,UTA,2013,88.0
13414,13414,14,@,L 77-101 ,240,26,82,0.317,21,66,0.318,5,16,0.313,20,28,0.714,77,41,95,0.432,35,76,0.461,6,19,0.316,13,19,0.684,101,2013-02-13,CHA,IND,2013,104.0
13415,13415,15,Home,L 77-87 ,240,32,74,0.432,25,54,0.463,7,20,0.35,6,10,0.6,77,31,75,0.413,18,40,0.45,13,35,0.371,12,15,0.8,87,2013-03-06,DET,NYK,2013,93.5
13416,13416,16,Home,L 77-100 ,240,32,88,0.364,30,70,0.429,2,18,0.111,11,14,0.786,77,42,92,0.457,34,71,0.479,8,21,0.381,8,10,0.8,100,2013-03-10,MIN,DAL,2013,104.0
13417,13417,17,@,L 77-92 ,240,29,86,0.337,23,62,0.371,6,24,0.25,13,18,0.722,77,40,82,0.488,35,66,0.53,5,16,0.313,7,11,0.636,92,2013-03-18,MIN,MEM,2013,94.5
13418,13418,18,@,L 77-109 ,240,30,89,0.337,25,64,0.391,5,25,0.2,12,18,0.667,77,38,76,0.5,25,46,0.543,13,30,0.433,20,23,0.87,109,2013-03-24,CHA,MIA,2013,115.5
13419,13419,19,@,L 77-91 ,240,31,85,0.365,26,69,0.377,5,16,0.313,10,15,0.667,77,38,86,0.442,30,65,0.462,8,21,0.381,7,11,0.636,91,2013-04-14,CLE,PHI,2013,95.0
13420,13420,20,@,L 77-93 ,240,30,73,0.411,23,52,0.442,7,21,0.333,10,15,0.667,77,37,79,0.468,30,52,0.577,7,27,0.259,12,15,0.8,93,2013-04-16,POR,LAC,2013,96.5
13421,13421,21,@,L 77-87 ,240,31,74,0.419,28,58,0.483,3,16,0.188,12,12,1.0,77,34,76,0.447,32,63,0.508,2,13,0.154,17,29,0.586,87,2013-11-03,BOS,DET,2014,88.0
13422,13422,22,@,L 77-104 ,240,30,88,0.341,22,72,0.306,8,16,0.5,9,11,0.818,77,40,79,0.506,35,63,0.556,5,16,0.313,19,21,0.905,104,2013-11-15,MIL,IND,2014,106.5
13423,13423,23,Home,L 77-109 ,240,29,84,0.345,27,69,0.391,2,15,0.133,17,23,0.739,77,46,88,0.523,42,71,0.592,4,17,0.235,13,17,0.765,109,2013-12-11,MIL,SAS,2014,111.0
13424,13424,24,Home,L 77-99 ,240,31,86,0.36,25,68,0.368,6,18,0.333,9,12,0.75,77,40,83,0.482,35,68,0.515,5,15,0.333,14,18,0.778,99,2013-12-14,CHI,TOR,2014,101.5
13425,13425,25,Home,L 77-82 ,240,31,82,0.378,25,62,0.403,6,20,0.3,9,12,0.75,77,33,82,0.402,28,62,0.452,5,20,0.25,11,18,0.611,82,2014-01-15,MIL,MEM,2014,84.5
13426,13426,26,@,L 77-88 ,240,29,82,0.354,27,61,0.443,2,21,0.095,17,23,0.739,77,33,82,0.402,29,62,0.468,4,20,0.2,18,25,0.72,88,2014-01-29,NOP,MIN,2014,90.0
13427,13427,27,@,L 77-86 ,240,32,81,0.395,30,65,0.462,2,16,0.125,11,15,0.733,77,34,76,0.447,30,58,0.517,4,18,0.222,14,23,0.609,86,2014-02-03,MEM,OKC,2014,88.0
13428,13428,28,Home,L 77-85 ,240,31,75,0.413,29,62,0.468,2,13,0.154,13,14,0.929,77,35,78,0.449,30,70,0.429,5,8,0.625,10,18,0.556,85,2014-03-07,CHI,MEM,2014,87.5
13429,13429,29,Home,L 77-103 ,240,31,83,0.373,25,60,0.417,6,23,0.261,9,19,0.474,77,38,70,0.543,34,55,0.618,4,15,0.267,23,32,0.719,103,2014-03-15,PHI,MEM,2014,105.0
13430,13430,30,@,L 77-89 ,240,27,73,0.37,23,63,0.365,4,10,0.4,19,21,0.905,77,35,84,0.417,31,69,0.449,4,15,0.267,15,16,0.938,89,2014-03-24,IND,CHI,2014,91.0
13431,13431,31,Home,L 77-103 ,240,26,69,0.377,20,55,0.364,6,14,0.429,19,24,0.792,77,37,80,0.463,29,63,0.46,8,17,0.471,21,25,0.84,103,2014-03-31,IND,SAS,2014,107.0
13432,13432,32,@,L 77-96 ,240,32,73,0.438,28,55,0.509,4,18,0.222,9,9,1.0,77,39,77,0.506,30,51,0.588,9,26,0.346,9,14,0.643,96,2014-04-02,MIL,MIA,2014,100.5
13433,13433,33,Home,L 77-95 ,240,24,78,0.308,21,60,0.35,3,18,0.167,26,35,0.743,77,33,75,0.44,27,48,0.563,6,27,0.222,23,32,0.719,95,2014-10-29,SAC,GSW,2015,98.0
13434,13434,34,Home,L 77-85 ,240,30,84,0.357,27,67,0.403,3,17,0.176,14,17,0.824,77,32,82,0.39,27,58,0.466,5,24,0.208,16,25,0.64,85,2014-12-03,MIN,PHI,2015,87.5
13435,13435,35,Home,L 77-107 ,240,31,76,0.408,27,53,0.509,4,23,0.174,11,14,0.786,77,40,79,0.506,32,60,0.533,8,19,0.421,19,23,0.826,107,2014-12-26,ATL,MIL,2015,111.0
13436,13436,36,Home,L 77-97 ,240,28,84,0.333,22,64,0.344,6,20,0.3,15,20,0.75,77,37,78,0.474,32,62,0.516,5,16,0.313,18,24,0.75,97,2015-01-07,CHI,UTA,2015,99.5
13437,13437,37,Home,L 77-97 ,240,25,83,0.301,23,58,0.397,2,25,0.08,25,29,0.862,77,41,76,0.539,33,59,0.559,8,17,0.471,7,11,0.636,97,2015-01-07,PHI,MIL,2015,101.0
13438,13438,38,@,L 77-114 ,240,26,77,0.338,22,59,0.373,4,18,0.222,21,31,0.677,77,44,87,0.506,35,67,0.522,9,20,0.45,17,23,0.739,114,2015-02-07,BRK,WAS,2015,118.5
13439,13439,39,@,L 77-97 ,240,33,87,0.379,29,69,0.42,4,18,0.222,7,8,0.875,77,35,81,0.432,31,68,0.456,4,13,0.308,23,28,0.821,97,2015-02-25,WAS,MIN,2015,99.0
13440,13440,40,Home,L 77-107 ,240,31,82,0.378,26,68,0.382,5,14,0.357,10,17,0.588,77,43,88,0.489,33,62,0.532,10,26,0.385,11,11,1.0,107,2015-04-03,LAL,POR,2015,112.0
13441,13441,41,@,L 77-116 ,240,27,79,0.342,23,64,0.359,4,15,0.267,19,29,0.655,77,41,81,0.506,25,53,0.472,16,28,0.571,18,23,0.783,116,2015-04-12,CHA,DET,2015,124.0
13442,13442,42,@,L 77-111 ,240,31,83,0.373,28,62,0.452,3,21,0.143,12,16,0.75,77,45,92,0.489,33,57,0.579,12,35,0.343,9,15,0.6,111,2015-11-24,LAL,GSW,2016,117.0
13443,13443,43,Home,L 77-89 ,240,28,87,0.322,19,55,0.345,9,32,0.281,12,14,0.857,77,36,78,0.462,28,55,0.509,8,23,0.348,9,10,0.9,89,2015-12-15,BOS,CLE,2016,93.0
13444,13444,44,@,L 77-97 ,240,32,89,0.36,26,62,0.419,6,27,0.222,7,9,0.778,77,38,84,0.452,30,62,0.484,8,22,0.364,13,17,0.765,97,2016-01-03,PHO,LAL,2016,101.0
13445,13445,45,Home,L 77-83 ,240,29,73,0.397,22,51,0.431,7,22,0.318,12,20,0.6,77,33,83,0.398,20,55,0.364,13,28,0.464,4,6,0.667,83,2016-01-08,BRK,ORL,2016,89.5
13446,13446,46,Home,L 77-83 ,240,31,86,0.36,29,67,0.433,2,19,0.105,13,15,0.867,77,30,77,0.39,22,55,0.4,8,22,0.364,15,17,0.882,83,2016-01-15,CHI,DAL,2016,87.0
13447,13447,47,Home,L 77-91 ,240,26,74,0.351,20,49,0.408,6,25,0.24,19,29,0.655,77,34,87,0.391,26,52,0.5,8,35,0.229,15,23,0.652,91,2016-01-15,HOU,CLE,2016,95.0
13448,13448,48,Home,L 77-106 ,240,29,85,0.341,24,58,0.414,5,27,0.185,14,20,0.7,77,37,68,0.544,24,40,0.6,13,28,0.464,19,26,0.731,106,2016-03-04,LAL,ATL,2016,112.5
13449,13449,49,@,L 77-93 ,240,32,84,0.381,27,57,0.474,5,27,0.185,8,11,0.727,77,34,78,0.436,25,53,0.472,9,25,0.36,16,18,0.889,93,2016-11-14,DAL,NYK,2017,97.5
13450,13450,50,Home,L 77-85 ,240,30,78,0.385,25,53,0.472,5,25,0.2,12,14,0.857,77,33,90,0.367,28,73,0.384,5,17,0.294,14,16,0.875,85,2016-11-17,UTA,CHI,2017,87.5
13451,13451,51,@,L 77-87 ,240,34,89,0.382,30,62,0.484,4,27,0.148,5,8,0.625,77,30,88,0.341,24,67,0.358,6,21,0.286,21,29,0.724,87,2016-12-07,DET,CHO,2017,90.0
13452,13452,52,@,L 77-110 ,240,30,76,0.395,24,59,0.407,6,17,0.353,11,16,0.688,77,43,80,0.538,27,49,0.551,16,31,0.516,8,13,0.615,110,2017-01-13,DET,UTA,2017,118.0
13453,13453,53,Home,W 76-74 ,240,26,77,0.338,22,60,0.367,4,17,0.235,20,26,0.769,76,28,80,0.35,24,65,0.369,4,15,0.267,14,25,0.56,74,2012-01-03,CHI,ATL,2012,76.0
13454,13454,54,@,L 76-102 ,240,29,78,0.372,24,54,0.444,5,24,0.208,13,16,0.813,76,39,75,0.52,29,53,0.547,10,22,0.455,14,18,0.778,102,2012-01-13,MIL,DAL,2012,107.0
13455,13455,55,@,L 76-90 ,240,32,74,0.432,27,59,0.458,5,15,0.333,7,8,0.875,76,35,84,0.417,31,67,0.463,4,17,0.235,16,19,0.842,90,2012-01-20,ATL,PHI,2012,92.0
13456,13456,56,@,L 76-103 ,240,32,88,0.364,31,80,0.388,1,8,0.125,11,16,0.688,76,38,90,0.422,33,75,0.44,5,15,0.333,22,30,0.733,103,2012-01-27,WAS,HOU,2012,105.5
13457,13457,57,@,L 76-89 ,240,31,85,0.365,23,70,0.329,8,15,0.533,6,8,0.75,76,31,78,0.397,25,66,0.379,6,12,0.5,21,29,0.724,89,2012-02-21,PHI,MEM,2012,92.0
13458,13458,58,Home,L 76-79 ,240,29,75,0.387,24,60,0.4,5,15,0.333,13,19,0.684,76,29,74,0.392,23,58,0.397,6,16,0.375,15,17,0.882,79,2012-03-19,ATL,BOS,2012,82.0
13459,13459,59,@,L 76-88 ,240,30,87,0.345,27,73,0.37,3,14,0.214,13,19,0.684,76,34,70,0.486,31,60,0.517,3,10,0.3,17,18,0.944,88,2012-03-25,WAS,BOS,2012,89.5
13460,13460,60,@,L 76-93 ,240,35,85,0.412,34,76,0.447,1,9,0.111,5,11,0.455,76,37,81,0.457,30,53,0.566,7,28,0.25,12,18,0.667,93,2012-03-25,PHI,SAS,2012,96.5
13461,13461,61,@,L 76-97 ,240,30,82,0.366,27,68,0.397,3,14,0.214,13,17,0.765,76,42,87,0.483,35,70,0.5,7,17,0.412,6,6,1.0,97,2012-03-30,PHI,WAS,2012,100.5
13462,13462,62,Home,W 76-73 ,240,26,71,0.366,24,56,0.429,2,15,0.133,22,35,0.629,76,29,77,0.377,25,64,0.391,4,13,0.308,11,16,0.688,73,2012-04-22,DET,TOR,2012,75.0
13463,13463,63,@,L 76-88 ,240,30,73,0.411,23,47,0.489,7,26,0.269,9,15,0.6,76,34,72,0.472,32,60,0.533,2,12,0.167,18,22,0.818,88,2012-04-26,ORL,MEM,2012,89.0
13464,13464,64,@,L 76-89 ,240,30,72,0.417,21,47,0.447,9,25,0.36,7,16,0.438,76,38,82,0.463,33,67,0.493,5,15,0.333,8,8,1.0,89,2012-11-11,ATL,LAC,2013,91.5
13465,13465,65,@,L 76-92 ,240,25,84,0.298,20,53,0.377,5,31,0.161,21,32,0.656,76,31,78,0.397,28,65,0.431,3,13,0.231,27,32,0.844,92,2012-11-13,WAS,CHA,2013,93.5
13466,13466,66,Home,L 76-94 ,240,25,84,0.298,20,68,0.294,5,16,0.313,21,32,0.656,76,35,73,0.479,32,66,0.485,3,7,0.429,21,31,0.677,94,2012-11-14,PHI,DET,2013,95.5
13467,13467,67,Home,L 76-83 ,240,31,85,0.365,26,69,0.377,5,16,0.313,9,12,0.75,76,31,82,0.378,29,73,0.397,2,9,0.222,19,27,0.704,83,2012-11-17,WAS,UTA,2013,84.0
13468,13468,68,@,L 76-88 ,240,28,71,0.394,20,51,0.392,8,20,0.4,12,18,0.667,76,33,90,0.367,26,65,0.4,7,25,0.28,15,19,0.789,88,2012-11-18,IND,NYK,2013,91.5
13469,13469,69,@,L 76-86 ,240,29,72,0.403,25,55,0.455,4,17,0.235,14,22,0.636,76,34,73,0.466,29,60,0.483,5,13,0.385,13,19,0.684,86,2012-11-23,LAC,BRK,2013,88.5
13470,13470,70,Home,L 76-80 ,240,28,73,0.384,24,61,0.393,4,12,0.333,16,20,0.8,76,29,80,0.363,27,70,0.386,2,10,0.2,20,27,0.741,80,2012-12-04,CHI,IND,2013,81.0
13471,13471,71,Home,L 76-88 ,240,29,71,0.408,22,51,0.431,7,20,0.35,11,19,0.579,76,35,78,0.449,30,56,0.536,5,22,0.227,13,17,0.765,88,2012-12-17,DET,LAC,2013,90.5
13472,13472,72,Home,L 76-93 ,240,26,64,0.406,19,44,0.432,7,20,0.35,17,29,0.586,76,38,77,0.494,32,67,0.478,6,10,0.6,11,13,0.846,93,2012-12-25,BRK,BOS,2013,96.0
13473,13473,73,@,L 76-81 ,240,31,89,0.348,27,69,0.391,4,20,0.2,10,13,0.769,76,31,79,0.392,26,58,0.448,5,21,0.238,14,16,0.875,81,2013-01-10,NYK,IND,2013,83.5
13474,13474,74,Home,L 76-103 ,240,25,72,0.347,22,63,0.349,3,9,0.333,23,30,0.767,76,36,87,0.414,28,65,0.431,8,22,0.364,23,28,0.821,103,2013-01-15,CHA,IND,2013,107.0
13475,13475,75,@,L 76-85 ,240,34,83,0.41,29,63,0.46,5,20,0.25,3,3,1.0,76,35,78,0.449,34,71,0.479,1,7,0.143,14,17,0.824,85,2013-02-01,WAS,MEM,2013,85.5
13476,13476,76,Home,L 76-93 ,240,31,79,0.392,25,60,0.417,6,19,0.316,8,15,0.533,76,38,93,0.409,30,73,0.411,8,20,0.4,9,13,0.692,93,2013-02-02,ATL,CHI,2013,97.0
13477,13477,77,Home,L 76-86 ,240,30,87,0.345,24,67,0.358,6,20,0.3,10,14,0.714,76,33,82,0.402,27,64,0.422,6,18,0.333,14,22,0.636,86,2013-02-06,ORL,LAC,2013,89.0
13478,13478,78,@,L 76-87 ,240,27,88,0.307,25,72,0.347,2,16,0.125,20,23,0.87,76,39,93,0.419,37,77,0.481,2,16,0.125,7,10,0.7,87,2013-02-09,CHA,PHI,2013,88.0
13479,13479,79,Home,L 76-108 ,240,34,82,0.415,31,68,0.456,3,14,0.214,5,9,0.556,76,41,92,0.446,31,58,0.534,10,34,0.294,16,23,0.696,108,2013-02-13,ORL,ATL,2013,113.0
13480,13480,80,@,W 76-72 ,240,32,71,0.451,30,64,0.469,2,7,0.286,10,12,0.833,76,29,77,0.377,20,56,0.357,9,21,0.429,5,13,0.385,72,2013-02-24,MEM,BRK,2013,76.5
13481,13481,81,@,L 76-99 ,240,29,87,0.333,24,65,0.369,5,22,0.227,13,16,0.813,76,42,87,0.483,34,67,0.507,8,20,0.4,7,15,0.467,99,2013-03-18,LAL,PHO,2013,103.0
13482,13482,82,Home,L 76-94 ,240,33,80,0.413,29,51,0.569,4,29,0.138,6,10,0.6,76,34,67,0.507,30,55,0.545,4,12,0.333,22,28,0.786,94,2013-04-03,POR,MEM,2013,96.0
13483,13483,83,Home,W 76-74 ,240,31,79,0.392,26,60,0.433,5,19,0.263,9,18,0.5,76,29,71,0.408,21,51,0.412,8,20,0.4,8,10,0.8,74,2013-11-08,SAS,GSW,2014,78.0
13484,13484,84,@,L 76-92 ,240,28,84,0.333,23,67,0.343,5,17,0.294,15,20,0.75,76,35,79,0.443,32,64,0.5,3,15,0.2,19,31,0.613,92,2013-11-29,MIL,CHA,2014,93.5
13485,13485,85,@,L 76-91 ,240,29,80,0.363,28,68,0.412,1,12,0.083,17,23,0.739,76,34,77,0.442,29,52,0.558,5,25,0.2,18,22,0.818,91,2013-12-31,CLE,IND,2014,93.5
13486,13486,86,Home,L 76-79 ,240,30,70,0.429,22,50,0.44,8,20,0.4,8,15,0.533,76,37,90,0.411,33,78,0.423,4,12,0.333,1,1,1.0,79,2014-02-08,ATL,MEM,2014,81.0
13487,13487,87,@,L 76-92 ,240,26,67,0.388,21,50,0.42,5,17,0.294,19,28,0.679,76,35,70,0.5,31,56,0.554,4,14,0.286,18,21,0.857,92,2014-02-13,BRK,CHI,2014,94.0
13488,13488,88,@,L 76-108 ,240,28,85,0.329,25,63,0.397,3,22,0.136,17,19,0.895,76,38,81,0.469,29,56,0.518,9,25,0.36,23,32,0.719,108,2014-03-01,NOP,LAC,2014,112.5
13489,13489,89,@,L 76-90 ,240,29,78,0.372,21,56,0.375,8,22,0.364,10,16,0.625,76,34,76,0.447,29,62,0.468,5,14,0.357,17,21,0.81,90,2014-03-30,IND,CLE,2014,92.5
13490,13490,90,Home,W 76-73 ,240,30,82,0.366,28,66,0.424,2,16,0.125,14,19,0.737,76,27,88,0.307,20,65,0.308,7,23,0.304,12,17,0.706,73,2014-12-20,DEN,IND,2015,76.5
13491,13491,91,@,L 76-111 ,240,28,85,0.329,22,61,0.361,6,24,0.25,14,23,0.609,76,45,81,0.556,38,68,0.559,7,13,0.538,14,18,0.778,111,2015-01-19,PHI,WAS,2015,114.5
13492,13492,92,@,L 76-78 ,240,29,84,0.345,24,66,0.364,5,18,0.278,13,15,0.867,76,27,80,0.338,23,61,0.377,4,19,0.211,20,30,0.667,78,2015-01-21,MIA,CHO,2015,80.0
13493,13493,93,Home,W 76-71 ,240,25,76,0.329,23,69,0.333,2,7,0.286,24,37,0.649,76,28,79,0.354,22,64,0.344,6,15,0.4,9,18,0.5,71,2015-01-24,CHA,NYK,2015,74.0
13494,13494,94,@,L 76-92 ,240,26,72,0.361,22,50,0.44,4,22,0.182,20,22,0.909,76,37,83,0.446,27,58,0.466,10,25,0.4,8,17,0.471,92,2015-02-20,POR,UTA,2015,97.0
13495,13495,95,@,L 76-98 ,240,25,77,0.325,21,59,0.356,4,18,0.222,22,28,0.786,76,35,84,0.417,29,55,0.527,6,29,0.207,22,31,0.71,98,2015-02-21,TOR,HOU,2015,101.0
13496,13496,96,@,L 76-89 ,240,31,83,0.373,29,75,0.387,2,8,0.25,12,21,0.571,76,35,79,0.443,24,48,0.5,11,31,0.355,8,15,0.533,89,2015-03-09,MIN,LAC,2015,94.5
13497,13497,97,@,L 76-107 ,240,27,81,0.333,24,70,0.343,3,11,0.273,19,26,0.731,76,39,95,0.411,26,62,0.419,13,33,0.394,16,21,0.762,107,2015-03-23,WAS,GSW,2015,113.5
13498,13498,98,@,L 76-94 ,240,31,82,0.378,27,64,0.422,4,18,0.222,10,15,0.667,76,37,84,0.44,28,58,0.483,9,26,0.346,11,14,0.786,94,2015-03-27,DAL,SAS,2015,98.5
13499,13499,99,Home,L 76-106 ,240,29,82,0.354,27,66,0.409,2,16,0.125,16,22,0.727,76,41,84,0.488,28,55,0.509,13,29,0.448,11,17,0.647,106,2015-10-28,MEM,CLE,2016,112.5
13500,13500,0,Home,L 76-97 ,240,28,70,0.4,24,53,0.453,4,17,0.235,16,21,0.762,76,39,88,0.443,33,73,0.452,6,15,0.4,13,18,0.722,97,2015-10-31,IND,UTA,2016,100.0
13501,13501,1,@,L 76-96 ,240,28,71,0.394,25,52,0.481,3,19,0.158,17,22,0.773,76,35,83,0.422,27,63,0.429,8,20,0.4,18,25,0.72,96,2015-11-08,TOR,MIA,2016,100.0
13502,13502,2,Home,L 76-111 ,240,28,72,0.389,22,50,0.44,6,22,0.273,14,20,0.7,76,41,72,0.569,30,51,0.588,11,21,0.524,18,27,0.667,111,2015-12-11,ORL,CLE,2016,116.5
13503,13503,3,@,L 76-96 ,240,28,84,0.333,18,56,0.321,10,28,0.357,10,14,0.714,76,32,78,0.41,25,56,0.446,7,22,0.318,25,34,0.735,96,2015-12-13,PHI,TOR,2016,99.5
13504,13504,4,@,L 76-105 ,240,28,77,0.364,17,46,0.37,11,31,0.355,9,15,0.6,76,41,89,0.461,32,67,0.478,9,22,0.409,14,19,0.737,105,2015-12-26,CLE,POR,2016,109.5
13505,13505,5,@,L 76-87 ,240,27,81,0.333,20,49,0.408,7,32,0.219,15,23,0.652,76,38,77,0.494,30,60,0.5,8,17,0.471,3,5,0.6,87,2016-02-28,CHA,ATL,2016,91.0
13506,13506,6,Home,L 75-114 ,240,27,89,0.303,20,75,0.267,7,14,0.5,14,19,0.737,75,46,83,0.554,40,74,0.541,6,9,0.667,16,17,0.941,114,2012-01-20,CLE,CHI,2012,117.0
13507,13507,7,@,L 75-92 ,240,28,78,0.359,27,69,0.391,1,9,0.111,18,25,0.72,75,39,83,0.47,36,73,0.493,3,10,0.3,11,16,0.688,92,2012-01-25,CHA,WAS,2012,93.5
13508,13508,8,Home,L 75-82 ,240,29,86,0.337,28,72,0.389,1,14,0.071,16,19,0.842,75,31,81,0.383,26,67,0.388,5,14,0.357,15,18,0.833,82,2012-02-17,PHI,DAL,2012,84.5
13509,13509,9,@,L 75-83 ,240,29,80,0.363,25,61,0.41,4,19,0.211,13,19,0.684,75,29,78,0.372,25,68,0.368,4,10,0.4,21,24,0.875,83,2012-03-04,GSW,TOR,2012,85.0
13510,13510,10,@,L 75-92 ,240,20,64,0.313,15,42,0.357,5,22,0.227,30,38,0.789,75,40,82,0.488,36,71,0.507,4,11,0.364,8,15,0.533,92,2012-03-13,POR,IND,2012,94.0
13511,13511,11,Home,L 75-87 ,240,30,87,0.345,25,70,0.357,5,17,0.294,10,12,0.833,75,35,83,0.422,28,68,0.412,7,15,0.467,10,16,0.625,87,2012-03-28,CLE,DET,2012,90.5
13512,13512,12,@,L 75-91 ,240,28,72,0.389,26,59,0.441,2,13,0.154,17,27,0.63,75,30,76,0.395,21,48,0.438,9,28,0.321,22,32,0.688,91,2012-03-31,CLE,NYK,2012,95.5
13513,13513,13,@,L 75-92 ,240,32,77,0.416,28,68,0.412,4,9,0.444,7,9,0.778,75,35,71,0.493,32,56,0.571,3,15,0.2,19,21,0.905,92,2012-04-01,NOP,PHO,2012,93.5
13514,13514,14,Home,L 75-94 ,240,30,77,0.39,25,54,0.463,5,23,0.217,10,17,0.588,75,39,83,0.47,28,51,0.549,11,32,0.344,5,12,0.417,94,2012-04-02,DAL,LAC,2012,99.5
13515,13515,15,@,L 75-98 ,240,28,75,0.373,25,56,0.446,3,19,0.158,16,23,0.696,75,36,83,0.434,29,60,0.483,7,23,0.304,19,29,0.655,98,2012-04-08,DET,MIA,2012,101.5
13516,13516,16,@,L 75-91 ,240,29,78,0.372,23,62,0.371,6,16,0.375,11,16,0.688,75,30,72,0.417,20,49,0.408,10,23,0.435,21,26,0.808,91,2012-04-08,TOR,OKC,2012,96.0
13517,13517,17,Home,L 75-93 ,240,29,80,0.363,22,62,0.355,7,18,0.389,10,12,0.833,75,41,77,0.532,40,67,0.597,1,10,0.1,10,16,0.625,93,2012-04-11,TOR,PHI,2012,93.5
13518,13518,18,@,L 75-88 ,240,25,70,0.357,20,52,0.385,5,18,0.278,20,25,0.8,75,32,73,0.438,29,60,0.483,3,13,0.231,21,21,1.0,88,2012-04-15,MEM,NOH,2012,89.5
13519,13519,19,@,W 75-67 ,240,26,77,0.338,25,66,0.379,1,11,0.091,22,25,0.88,75,23,76,0.303,22,60,0.367,1,16,0.063,20,30,0.667,67,2012-04-16,NOP,CHA,2012,67.5
13520,13520,20,@,L 75-107 ,240,28,87,0.322,26,74,0.351,2,13,0.154,17,26,0.654,75,45,85,0.529,40,69,0.58,5,16,0.313,12,17,0.706,107,2012-04-26,CLE,CHI,2012,109.5
13521,13521,21,@,L 75-84 ,240,33,88,0.375,29,70,0.414,4,18,0.222,5,11,0.455,75,30,85,0.353,23,60,0.383,7,25,0.28,17,21,0.81,84,2012-10-31,DEN,PHI,2013,87.5
13522,13522,22,@,L 75-90 ,240,28,80,0.35,25,68,0.368,3,12,0.25,16,20,0.8,75,34,76,0.447,27,56,0.482,7,20,0.35,15,22,0.682,90,2012-11-07,ORL,MIN,2013,93.5
13523,13523,23,@,L 75-92 ,240,32,76,0.421,27,62,0.435,5,14,0.357,6,8,0.75,75,38,77,0.494,31,58,0.534,7,19,0.368,9,10,0.9,92,2012-12-22,CHI,ATL,2013,95.5
13524,13524,24,Home,L 75-81 ,240,33,82,0.402,29,71,0.408,4,11,0.364,5,7,0.714,75,33,77,0.429,29,60,0.483,4,17,0.235,11,18,0.611,81,2012-12-22,NOP,IND,2013,83.0
13525,13525,25,@,L 75-94 ,240,27,85,0.318,23,68,0.338,4,17,0.235,17,28,0.607,75,40,89,0.449,36,80,0.45,4,9,0.444,10,18,0.556,94,2013-01-04,IND,BOS,2013,96.0
13526,13526,26,Home,L 75-92 ,240,29,80,0.363,26,68,0.382,3,12,0.25,14,18,0.778,75,36,90,0.4,28,61,0.459,8,29,0.276,12,18,0.667,92,2013-01-16,GSW,MIA,2013,96.0
13527,13527,27,Home,L 75-105 ,240,25,75,0.333,21,59,0.356,4,16,0.25,21,35,0.6,75,42,83,0.506,37,69,0.536,5,14,0.357,16,20,0.8,105,2013-02-22,CHA,CHI,2013,107.5
13528,13528,28,@,L 75-114 ,240,28,86,0.326,22,67,0.328,6,19,0.316,13,18,0.722,75,45,89,0.506,36,69,0.522,9,20,0.45,15,20,0.75,114,2013-03-03,DET,SAS,2013,118.5
13529,13529,29,Home,L 75-97 ,240,27,72,0.375,25,51,0.49,2,21,0.095,19,24,0.792,75,37,78,0.474,33,66,0.5,4,12,0.333,19,23,0.826,97,2013-04-05,IND,OKC,2013,99.0
13530,13530,30,@,L 75-94 ,240,30,80,0.375,28,66,0.424,2,14,0.143,13,18,0.722,75,39,82,0.476,36,69,0.522,3,13,0.231,13,20,0.65,94,2013-04-09,CHA,MEM,2013,95.5
13531,13531,31,Home,L 75-92 ,240,30,90,0.333,27,72,0.375,3,18,0.167,12,15,0.8,75,34,80,0.425,22,61,0.361,12,19,0.632,12,15,0.8,92,2013-12-07,CHI,DET,2014,98.0
13532,13532,32,@,W 75-74 ,240,30,73,0.411,23,52,0.442,7,21,0.333,8,14,0.571,75,32,89,0.36,27,65,0.415,5,24,0.208,5,9,0.556,74,2013-12-09,DEN,WAS,2014,76.5
13533,13533,33,Home,L 75-91 ,240,29,93,0.312,25,73,0.342,4,20,0.2,13,16,0.813,75,37,78,0.474,32,65,0.492,5,13,0.385,12,19,0.632,91,2014-02-04,GSW,CHA,2014,93.5
13534,13534,34,Home,L 75-81 ,240,29,68,0.426,20,48,0.417,9,20,0.45,8,18,0.444,75,30,80,0.375,22,54,0.407,8,26,0.308,13,15,0.867,81,2014-11-12,MIA,IND,2015,85.0
13535,13535,35,@,L 75-100 ,240,27,83,0.325,23,57,0.404,4,26,0.154,17,24,0.708,75,36,81,0.444,26,55,0.473,10,26,0.385,18,21,0.857,100,2014-11-17,PHI,SAS,2015,105.0
13536,13536,36,@,L 75-105 ,240,29,88,0.33,24,65,0.369,5,23,0.217,12,16,0.75,75,40,75,0.533,28,52,0.538,12,23,0.522,13,16,0.813,105,2014-11-29,CHA,ATL,2015,111.0
13537,13537,37,Home,L 75-98 ,240,30,80,0.375,27,62,0.435,3,18,0.167,12,19,0.632,75,35,81,0.432,22,47,0.468,13,34,0.382,15,24,0.625,98,2014-12-05,BRK,ATL,2015,104.5
13538,13538,38,Home,L 75-93 ,240,28,80,0.35,24,58,0.414,4,22,0.182,15,18,0.833,75,33,71,0.465,24,53,0.453,9,18,0.5,18,21,0.857,93,2014-12-14,MIA,CHI,2015,97.5
13539,13539,39,@,L 75-98 ,240,25,87,0.287,20,63,0.317,5,24,0.208,20,26,0.769,75,36,88,0.409,28,61,0.459,8,27,0.296,18,21,0.857,98,2014-12-26,CHA,OKC,2015,102.0
13540,13540,40,Home,L 75-78 ,240,29,92,0.315,25,69,0.362,4,23,0.174,13,18,0.722,75,33,78,0.423,31,62,0.5,2,16,0.125,10,15,0.667,78,2015-01-13,LAL,MIA,2015,79.0
13541,13541,41,Home,L 75-98 ,240,31,89,0.348,29,74,0.392,2,15,0.133,11,15,0.733,75,39,76,0.513,28,49,0.571,11,27,0.407,9,14,0.643,98,2015-01-21,MIN,DAL,2015,103.5
13542,13542,42,Home,L 75-83 ,240,30,81,0.37,26,62,0.419,4,19,0.211,11,18,0.611,75,32,77,0.416,28,56,0.5,4,21,0.19,15,21,0.714,83,2015-02-01,BOS,MIA,2015,85.0
13543,13543,43,Home,L 75-82 ,240,25,78,0.321,18,51,0.353,7,27,0.259,18,22,0.818,75,33,80,0.413,26,64,0.406,7,16,0.438,9,17,0.529,82,2015-02-02,TOR,MIL,2015,85.5
13544,13544,44,@,L 75-82 ,240,29,74,0.392,24,59,0.407,5,15,0.333,12,14,0.857,75,29,76,0.382,23,54,0.426,6,22,0.273,18,23,0.783,82,2015-02-28,MIL,UTA,2015,85.0
13545,13545,45,@,L 75-94 ,240,33,88,0.375,31,72,0.431,2,16,0.125,7,8,0.875,75,34,82,0.415,27,60,0.45,7,22,0.318,19,21,0.905,94,2015-03-05,DAL,POR,2015,97.5
13546,13546,46,@,L 75-93 ,240,32,81,0.395,29,63,0.46,3,18,0.167,8,15,0.533,75,40,90,0.444,34,72,0.472,6,18,0.333,7,13,0.538,93,2015-03-22,MIA,OKC,2015,96.0
13547,13547,47,@,L 75-90 ,240,30,85,0.353,23,60,0.383,7,25,0.28,8,10,0.8,75,37,84,0.44,32,65,0.492,5,19,0.263,11,19,0.579,90,2015-04-10,PHO,NOP,2015,92.5
13548,13548,48,@,L 75-102 ,240,31,77,0.403,26,61,0.426,5,16,0.313,8,15,0.533,75,40,86,0.465,31,64,0.484,9,22,0.409,13,13,1.0,102,2015-10-30,BRK,SAS,2016,106.5
13549,13549,49,Home,L 75-97 ,240,31,91,0.341,27,61,0.443,4,30,0.133,9,13,0.692,75,39,86,0.453,30,63,0.476,9,23,0.391,10,12,0.833,97,2016-01-03,WAS,MIA,2016,101.5
13550,13550,50,@,L 75-104 ,240,33,87,0.379,28,63,0.444,5,24,0.208,4,7,0.571,75,40,85,0.471,25,55,0.455,15,30,0.5,9,10,0.9,104,2016-03-13,IND,ATL,2016,111.5
13551,13551,51,@,L 75-91 ,240,31,80,0.388,27,62,0.435,4,18,0.222,9,14,0.643,75,35,81,0.432,25,55,0.455,10,26,0.385,11,13,0.846,91,2016-03-21,PHI,IND,2016,96.0
13552,13552,52,@,L 75-123 ,240,26,85,0.306,19,65,0.292,7,20,0.35,16,22,0.727,75,46,89,0.517,29,57,0.509,17,32,0.531,14,19,0.737,123,2016-03-28,LAL,UTA,2016,131.5
13553,13553,53,@,L 75-88 ,240,29,73,0.397,22,54,0.407,7,19,0.368,10,13,0.769,75,34,83,0.41,28,56,0.5,6,27,0.222,14,20,0.7,88,2016-10-30,UTA,LAC,2017,91.0
13554,13554,54,@,L 75-86 (OT),265,30,82,0.366,24,53,0.453,6,29,0.207,9,12,0.75,75,33,88,0.375,24,50,0.48,9,38,0.237,11,12,0.917,86,2016-11-06,MIL,DAL,2017,90.5
13555,13555,55,@,L 74-76 ,240,28,80,0.35,24,65,0.369,4,15,0.267,14,25,0.56,74,26,77,0.338,22,60,0.367,4,17,0.235,20,26,0.769,76,2012-01-03,ATL,CHI,2012,78.0
13556,13556,56,Home,L 74-87 ,240,26,66,0.394,21,52,0.404,5,14,0.357,17,24,0.708,74,32,80,0.4,24,66,0.364,8,14,0.571,15,18,0.833,87,2012-01-06,BOS,IND,2012,91.0
13557,13557,57,Home,L 74-84 ,240,27,87,0.31,24,64,0.375,3,23,0.13,17,19,0.895,74,32,77,0.416,28,60,0.467,4,17,0.235,16,24,0.667,84,2012-01-21,BRK,OKC,2012,86.0
13558,13558,58,@,L 74-95 ,240,29,83,0.349,26,72,0.361,3,11,0.273,13,17,0.765,74,38,78,0.487,29,63,0.46,9,15,0.6,10,15,0.667,95,2012-01-28,DET,PHI,2012,99.5
13559,13559,59,Home,W 74-69 ,240,30,80,0.375,26,65,0.4,4,15,0.267,10,19,0.526,74,26,78,0.333,19,56,0.339,7,22,0.318,10,22,0.455,69,2012-01-30,PHI,ORL,2012,72.5
13560,13560,60,@,L 74-86 ,240,29,65,0.446,26,55,0.473,3,10,0.3,13,18,0.722,74,33,75,0.44,28,56,0.5,5,19,0.263,15,20,0.75,86,2012-02-10,BOS,TOR,2012,88.5
13561,13561,61,@,W 74-71 ,240,30,78,0.385,28,61,0.459,2,17,0.118,12,19,0.632,74,27,71,0.38,21,57,0.368,6,14,0.429,11,18,0.611,71,2012-02-16,LAC,POR,2012,74.0
13562,13562,62,@,L 74-86 ,240,29,70,0.414,26,61,0.426,3,9,0.333,13,22,0.591,74,31,72,0.431,25,50,0.5,6,22,0.273,18,24,0.75,86,2012-03-05,NOP,POR,2012,89.0
13563,13563,63,Home,L 74-83 ,240,30,86,0.349,28,75,0.373,2,11,0.182,12,21,0.571,74,30,83,0.361,26,61,0.426,4,22,0.182,19,26,0.731,83,2012-03-09,CHA,NJN,2012,85.0
13564,13564,64,@,L 74-101 ,240,28,75,0.373,22,52,0.423,6,23,0.261,12,17,0.706,74,44,78,0.564,39,63,0.619,5,15,0.333,8,11,0.727,101,2012-04-22,ORL,DEN,2012,103.5
13565,13565,65,@,L 74-87 ,240,29,78,0.372,27,69,0.391,2,9,0.222,14,23,0.609,74,35,87,0.402,27,63,0.429,8,24,0.333,9,11,0.818,87,2012-04-26,MIL,BOS,2012,91.0
13566,13566,66,@,L 74-82 ,240,30,84,0.357,29,71,0.408,1,13,0.077,13,18,0.722,74,29,78,0.372,22,54,0.407,7,24,0.292,17,25,0.68,82,2012-11-11,ORL,BRK,2013,85.5
13567,13567,67,@,W 74-72 ,240,26,72,0.361,20,60,0.333,6,12,0.5,16,19,0.842,74,24,75,0.32,19,60,0.317,5,15,0.333,19,25,0.76,72,2012-11-13,TOR,IND,2013,74.5
13568,13568,68,@,L 74-90 ,240,28,85,0.329,25,68,0.368,3,17,0.176,15,22,0.682,74,36,83,0.434,31,63,0.492,5,20,0.25,13,18,0.722,90,2012-11-21,DET,ORL,2013,92.5
13569,13569,69,@,L 74-92 ,240,26,74,0.351,23,53,0.434,3,21,0.143,19,21,0.905,74,36,89,0.404,36,69,0.522,0,20,0.0,20,22,0.909,92,2012-12-10,TOR,POR,2013,92.0
13570,13570,70,@,L 74-95 ,240,27,69,0.391,27,56,0.482,0,13,0.0,20,23,0.87,74,34,84,0.405,22,48,0.458,12,36,0.333,15,22,0.682,95,2012-12-14,DAL,TOR,2013,101.0
13571,13571,71,@,L 74-89 ,240,25,76,0.329,20,58,0.345,5,18,0.278,19,32,0.594,74,36,80,0.45,29,64,0.453,7,16,0.438,10,11,0.909,89,2013-02-08,BRK,WAS,2013,92.5
13572,13572,72,@,L 74-119 ,240,27,77,0.351,21,56,0.375,6,21,0.286,14,18,0.778,74,42,76,0.553,34,58,0.586,8,18,0.444,27,28,0.964,119,2013-02-27,NOP,OKC,2013,123.0
13573,13573,73,@,L 74-100 ,240,27,66,0.409,23,53,0.434,4,13,0.308,16,25,0.64,74,35,77,0.455,29,60,0.483,6,17,0.353,24,30,0.8,100,2013-03-12,BOS,CHA,2013,103.0
13574,13574,74,@,L 74-89 ,240,29,83,0.349,26,68,0.382,3,15,0.2,13,15,0.867,74,32,77,0.416,22,49,0.449,10,28,0.357,15,20,0.75,89,2013-11-02,CLE,IND,2014,94.0
13575,13575,75,@,L 74-76 ,240,29,71,0.408,21,51,0.412,8,20,0.4,8,10,0.8,74,31,79,0.392,26,60,0.433,5,19,0.263,9,18,0.5,76,2013-11-08,GSW,SAS,2014,78.5
13576,13576,76,Home,L 74-99 ,240,26,83,0.313,23,74,0.311,3,9,0.333,19,28,0.679,74,32,84,0.381,22,59,0.373,10,25,0.4,25,32,0.781,99,2013-11-27,CHA,IND,2014,104.0
13577,13577,77,Home,L 74-75 ,240,32,89,0.36,27,65,0.415,5,24,0.208,5,9,0.556,74,30,73,0.411,23,52,0.442,7,21,0.333,8,14,0.571,75,2013-12-09,WAS,DEN,2014,78.5
13578,13578,78,Home,L 74-78 ,240,31,83,0.373,28,68,0.412,3,15,0.2,9,14,0.643,74,30,75,0.4,28,64,0.438,2,11,0.182,16,20,0.8,78,2013-12-10,CHI,MIL,2014,79.0
13579,13579,79,Home,L 74-91 ,240,33,84,0.393,30,67,0.448,3,17,0.176,5,7,0.714,74,35,80,0.438,25,58,0.431,10,22,0.455,11,16,0.688,91,2014-03-28,CHI,POR,2014,96.0
13580,13580,80,@,L 74-106 ,240,29,80,0.363,24,63,0.381,5,17,0.294,11,15,0.733,74,42,81,0.519,36,65,0.554,6,16,0.375,16,22,0.727,106,2014-11-24,ORL,CLE,2015,109.0
13581,13581,81,@,L 74-99 ,240,28,81,0.346,26,66,0.394,2,15,0.133,16,21,0.762,74,39,86,0.453,32,70,0.457,7,16,0.438,14,19,0.737,99,2015-01-26,PHI,NOP,2015,102.5
13582,13582,82,@,L 74-85 ,240,27,78,0.346,21,58,0.362,6,20,0.3,14,18,0.778,74,34,91,0.374,31,80,0.388,3,11,0.273,14,17,0.824,85,2015-01-31,OKC,MEM,2015,86.5
13583,13583,83,Home,L 74-101 ,240,25,84,0.298,20,68,0.294,5,16,0.313,19,24,0.792,74,41,92,0.446,37,73,0.507,4,19,0.211,15,17,0.882,101,2015-02-28,PHO,SAS,2015,103.0
13584,13584,84,@,L 74-94 ,240,29,84,0.345,24,60,0.4,5,24,0.208,11,17,0.647,74,36,88,0.409,33,70,0.471,3,18,0.167,19,25,0.76,94,2015-03-01,PHI,IND,2015,95.5
13585,13585,85,Home,W 74-72 ,240,29,83,0.349,27,61,0.443,2,22,0.091,14,21,0.667,74,31,83,0.373,26,65,0.4,5,18,0.278,5,10,0.5,72,2015-03-19,PHO,NOP,2015,74.5
13586,13586,86,@,L 74-93 ,240,28,80,0.35,24,62,0.387,4,18,0.222,14,20,0.7,74,36,83,0.434,28,67,0.418,8,16,0.5,13,18,0.722,93,2015-04-03,CHA,IND,2015,97.0
13587,13587,87,Home,L 74-92 ,240,28,81,0.346,18,59,0.305,10,22,0.455,8,11,0.727,74,33,77,0.429,21,50,0.42,12,27,0.444,14,19,0.737,92,2015-04-08,CHA,TOR,2015,98.0
13588,13588,88,@,L 74-110 ,240,28,80,0.35,22,59,0.373,6,21,0.286,12,18,0.667,74,45,88,0.511,37,71,0.521,8,17,0.471,12,14,0.857,110,2015-04-08,NOP,MEM,2015,114.0
13589,13589,89,@,L 74-92 ,240,28,75,0.373,22,56,0.393,6,19,0.316,12,16,0.75,74,35,77,0.455,29,59,0.492,6,18,0.333,16,22,0.727,92,2015-11-30,DEN,MIL,2016,95.0
13590,13590,90,Home,L 74-85 ,240,28,84,0.333,21,60,0.35,7,24,0.292,11,20,0.55,74,38,88,0.432,37,72,0.514,1,16,0.063,8,10,0.8,85,2015-12-08,DEN,ORL,2016,85.5
13591,13591,91,Home,L 74-91 ,240,31,78,0.397,26,62,0.419,5,16,0.313,7,12,0.583,74,35,80,0.438,31,58,0.534,4,22,0.182,17,18,0.944,91,2016-01-06,BRK,TOR,2016,93.0
13592,13592,92,Home,L 74-78 ,240,28,73,0.384,25,62,0.403,3,11,0.273,15,20,0.75,74,29,81,0.358,21,61,0.344,8,20,0.4,12,17,0.706,78,2016-01-06,MIN,DEN,2016,82.0
13593,13593,93,Home,L 74-86 ,240,29,89,0.326,26,68,0.382,3,21,0.143,13,15,0.867,74,31,69,0.449,26,53,0.491,5,16,0.313,19,25,0.76,86,2016-01-10,LAL,UTA,2016,88.5
13594,13594,94,@,L 74-99 ,240,30,72,0.417,26,58,0.448,4,14,0.286,10,11,0.909,74,40,88,0.455,33,66,0.5,7,22,0.318,12,12,1.0,99,2016-01-17,MIA,OKC,2016,102.5
13595,13595,95,Home,L 74-87 ,240,26,78,0.333,18,58,0.31,8,20,0.4,14,19,0.737,74,33,81,0.407,26,53,0.491,7,28,0.25,14,16,0.875,87,2016-11-11,ORL,UTA,2017,90.5
13596,13596,96,@,L 74-104 ,240,27,76,0.355,18,46,0.391,9,30,0.3,11,20,0.55,74,40,90,0.444,31,67,0.463,9,23,0.391,15,17,0.882,104,2016-12-20,UTA,GSW,2017,108.5
13597,13597,97,@,L 74-89 ,240,30,82,0.366,26,63,0.413,4,19,0.211,10,18,0.556,74,32,81,0.395,28,62,0.452,4,19,0.211,21,25,0.84,89,2017-02-06,SAS,MEM,2017,91.0
13598,13598,98,@,L 73-85 ,240,29,95,0.305,27,74,0.365,2,21,0.095,13,16,0.813,73,32,66,0.485,29,53,0.547,3,13,0.231,18,28,0.643,85,2012-01-03,MIL,UTA,2012,86.5
13599,13599,99,@,L 73-96 ,240,31,86,0.36,31,76,0.408,0,10,0.0,11,14,0.786,73,39,85,0.459,34,67,0.507,5,18,0.278,13,16,0.813,96,2012-01-06,DET,PHI,2012,98.5
13600,13600,0,Home,W 73-70 ,240,29,76,0.382,28,66,0.424,1,10,0.1,14,19,0.737,73,28,80,0.35,24,54,0.444,4,26,0.154,10,16,0.625,70,2012-01-16,LAL,DAL,2012,72.0
13601,13601,1,@,L 73-96 ,240,26,69,0.377,22,54,0.407,4,15,0.267,17,20,0.85,73,34,71,0.479,28,55,0.509,6,16,0.375,22,32,0.688,96,2012-01-18,TOR,BOS,2012,99.0
13602,13602,2,Home,L 73-94 ,240,27,74,0.365,20,52,0.385,7,22,0.318,12,18,0.667,73,35,68,0.515,32,54,0.593,3,14,0.214,21,29,0.724,94,2012-01-29,BRK,TOR,2012,95.5
13603,13603,3,Home,L 73-83 ,240,27,73,0.37,24,64,0.375,3,9,0.333,16,20,0.8,73,32,80,0.4,22,56,0.393,10,24,0.417,9,15,0.6,83,2012-01-30,MEM,SAS,2012,88.0
13604,13604,4,@,L 73-106 ,240,31,89,0.348,29,80,0.363,2,9,0.222,9,13,0.692,73,42,76,0.553,30,50,0.6,12,26,0.462,10,11,0.909,106,2012-01-31,CHA,LAL,2012,112.0
13605,13605,5,@,L 73-108 ,240,28,75,0.373,24,58,0.414,4,17,0.235,13,22,0.591,73,39,78,0.5,33,62,0.532,6,16,0.375,24,32,0.75,108,2012-02-19,CHA,IND,2012,111.0
13606,13606,6,@,L 73-89 ,240,29,74,0.392,22,50,0.44,7,24,0.292,8,11,0.727,73,36,89,0.404,29,64,0.453,7,25,0.28,10,14,0.714,89,2012-02-20,BOS,DAL,2012,92.5
13607,13607,7,@,W 73-71 ,240,34,79,0.43,34,67,0.507,0,12,0.0,5,7,0.714,73,30,78,0.385,25,66,0.379,5,12,0.417,6,7,0.857,71,2012-03-12,CHA,NOH,2012,73.5
13608,13608,8,Home,L 73-88 ,240,29,75,0.387,23,60,0.383,6,15,0.4,9,17,0.529,73,34,77,0.442,32,61,0.525,2,16,0.125,18,20,0.9,88,2012-03-23,DET,MIA,2012,89.0
13609,13609,9,@,L 73-76 ,240,29,77,0.377,25,64,0.391,4,13,0.308,11,16,0.688,73,26,71,0.366,24,56,0.429,2,15,0.133,22,35,0.629,76,2012-04-22,TOR,DET,2012,77.0
13610,13610,10,@,L 73-101 ,240,25,73,0.342,21,58,0.362,4,15,0.267,19,23,0.826,73,46,83,0.554,44,65,0.677,2,18,0.111,7,12,0.583,101,2012-04-23,CHA,WAS,2012,102.0
13611,13611,11,@,L 73-103 ,240,30,80,0.375,27,59,0.458,3,21,0.143,10,17,0.588,73,40,77,0.519,30,53,0.566,10,24,0.417,13,16,0.813,103,2012-11-07,BRK,MIA,2013,108.0
13612,13612,12,@,L 73-91 ,240,30,87,0.345,23,63,0.365,7,24,0.292,6,9,0.667,73,30,70,0.429,26,51,0.51,4,19,0.211,27,35,0.771,91,2012-12-07,CLE,MIN,2013,93.0
13613,13613,13,@,L 73-104 ,240,28,74,0.378,24,57,0.421,4,17,0.235,13,17,0.765,73,43,73,0.589,37,59,0.627,6,14,0.429,12,16,0.75,104,2012-12-31,BRK,SAS,2013,107.0
13614,13614,14,Home,L 73-99 ,240,27,89,0.303,21,69,0.304,6,20,0.3,13,17,0.765,73,35,76,0.461,30,62,0.484,5,14,0.357,24,32,0.75,99,2013-01-14,MEM,LAC,2013,101.5
13615,13615,15,@,L 73-86 ,240,29,71,0.408,25,56,0.446,4,15,0.267,11,12,0.917,73,34,79,0.43,31,69,0.449,3,10,0.3,15,19,0.789,86,2013-01-26,CHI,WAS,2013,87.5
13616,13616,16,@,L 73-98 ,240,25,72,0.347,22,53,0.415,3,19,0.158,20,31,0.645,73,38,81,0.469,26,55,0.473,12,26,0.462,10,17,0.588,98,2013-02-01,LAC,TOR,2013,104.0
13617,13617,17,@,L 73-95 ,240,28,88,0.318,25,73,0.342,3,15,0.2,14,21,0.667,73,34,87,0.391,28,64,0.438,6,23,0.261,21,24,0.875,95,2013-03-19,ORL,IND,2013,98.0
13618,13618,18,@,L 73-97 ,240,25,85,0.294,18,65,0.277,7,20,0.35,16,25,0.64,73,38,72,0.528,35,64,0.547,3,8,0.375,18,25,0.72,97,2013-11-08,UTA,CHI,2014,98.5
13619,13619,19,@,L 73-95 ,240,28,71,0.394,24,53,0.453,4,18,0.222,13,29,0.448,73,36,71,0.507,31,59,0.525,5,12,0.417,18,22,0.818,95,2013-11-24,UTA,OKC,2014,97.5
13620,13620,20,@,L 73-93 ,240,29,73,0.397,23,55,0.418,6,18,0.333,9,13,0.692,73,38,85,0.447,29,63,0.46,9,22,0.409,8,10,0.8,93,2013-11-29,WAS,IND,2014,97.5
13621,13621,21,Home,L 73-114 ,240,25,73,0.342,19,57,0.333,6,16,0.375,17,23,0.739,73,39,72,0.542,25,47,0.532,14,25,0.56,22,27,0.815,114,2013-12-08,NYK,BOS,2014,121.0
13622,13622,22,Home,L 73-81 ,240,27,84,0.321,20,60,0.333,7,24,0.292,12,14,0.857,73,30,84,0.357,25,65,0.385,5,19,0.263,16,21,0.762,81,2014-02-12,IND,DAL,2014,83.5
13623,13623,23,@,L 73-76 ,240,27,88,0.307,20,65,0.308,7,23,0.304,12,17,0.706,73,30,82,0.366,28,66,0.424,2,16,0.125,14,19,0.737,76,2014-12-20,IND,DEN,2015,77.0
13624,13624,24,@,L 73-108 ,240,29,75,0.387,24,60,0.4,5,15,0.333,10,16,0.625,73,42,79,0.532,29,50,0.58,13,29,0.448,11,14,0.786,108,2015-01-24,BRK,UTA,2015,114.5
13625,13625,25,Home,L 73-80 ,240,31,77,0.403,28,66,0.424,3,11,0.273,8,17,0.471,73,25,62,0.403,16,37,0.432,9,25,0.36,21,31,0.677,80,2015-03-19,LAL,UTA,2015,84.5
13626,13626,26,@,L 73-96 ,240,27,83,0.325,24,65,0.369,3,18,0.167,16,22,0.727,73,41,83,0.494,35,63,0.556,6,20,0.3,8,12,0.667,96,2015-04-12,BRK,MIL,2015,99.0
13627,13627,27,@,L 73-102 ,240,25,68,0.368,19,43,0.442,6,25,0.24,17,21,0.81,73,40,81,0.494,28,50,0.56,12,31,0.387,10,15,0.667,102,2016-01-27,CHA,UTA,2016,108.0
13628,13628,28,@,L 73-96 ,240,28,85,0.329,21,62,0.339,7,23,0.304,10,13,0.769,73,39,97,0.402,32,67,0.478,7,30,0.233,11,21,0.524,96,2016-11-17,MIL,MIA,2017,99.5
13629,13629,29,Home,L 73-82 ,240,28,93,0.301,26,70,0.371,2,23,0.087,15,18,0.833,73,30,66,0.455,22,39,0.564,8,27,0.296,14,25,0.56,82,2016-12-18,MEM,UTA,2017,86.0
13630,13630,30,@,L 73-122 ,240,28,73,0.384,25,52,0.481,3,21,0.143,14,17,0.824,73,43,87,0.494,26,48,0.542,17,39,0.436,19,19,1.0,122,2017-01-22,LAL,DAL,2017,130.5
13631,13631,31,Home,L 72-93 ,240,30,87,0.345,27,77,0.351,3,10,0.3,9,16,0.563,72,36,80,0.45,26,54,0.481,10,26,0.385,11,15,0.733,93,2012-01-08,WAS,MIN,2012,98.0
13632,13632,32,@,L 72-89 ,240,27,70,0.386,23,55,0.418,4,15,0.267,14,21,0.667,72,35,78,0.449,29,63,0.46,6,15,0.4,13,16,0.813,89,2012-01-27,CHA,PHI,2012,92.0
13633,13633,33,Home,L 72-94 ,240,27,73,0.37,24,63,0.381,3,10,0.3,15,19,0.789,72,36,81,0.444,24,58,0.414,12,23,0.522,10,17,0.588,94,2012-01-29,NOP,ATL,2012,100.0
13634,13634,34,@,L 72-102 ,240,31,83,0.373,28,67,0.418,3,16,0.188,7,10,0.7,72,39,82,0.476,29,62,0.468,10,20,0.5,14,21,0.667,102,2012-03-02,CHA,SAS,2012,107.0
13635,13635,35,@,L 72-92 ,240,27,79,0.342,24,63,0.381,3,16,0.188,15,22,0.682,72,33,78,0.423,24,63,0.381,9,15,0.6,17,27,0.63,92,2012-03-05,IND,CHI,2012,96.5
13636,13636,36,@,L 72-91 ,240,31,89,0.348,28,73,0.384,3,16,0.188,7,17,0.412,72,33,70,0.471,28,57,0.491,5,13,0.385,20,22,0.909,91,2012-04-01,MIA,BOS,2012,93.5
13637,13637,37,Home,L 72-86 ,240,26,74,0.351,21,52,0.404,5,22,0.227,15,19,0.789,72,32,76,0.421,23,58,0.397,9,18,0.5,13,14,0.929,86,2012-04-07,IND,BOS,2012,90.5
13638,13638,38,@,L 72-96 ,240,30,72,0.417,29,56,0.518,1,16,0.063,11,15,0.733,72,40,76,0.526,33,59,0.559,7,17,0.412,9,15,0.6,96,2012-04-18,TOR,MIA,2012,99.5
13639,13639,39,@,L 72-83 ,240,25,70,0.357,23,54,0.426,2,16,0.125,20,28,0.714,72,32,76,0.421,28,63,0.444,4,13,0.308,15,21,0.714,83,2012-04-19,CHI,MIA,2012,85.0
13640,13640,40,Home,L 72-74 ,240,24,75,0.32,19,60,0.317,5,15,0.333,19,25,0.76,72,26,72,0.361,20,60,0.333,6,12,0.5,16,19,0.842,74,2012-11-13,IND,TOR,2013,77.0
13641,13641,41,@,L 72-81 ,240,31,82,0.378,29,72,0.403,2,10,0.2,8,14,0.571,72,34,89,0.382,29,64,0.453,5,25,0.2,8,13,0.615,81,2012-11-19,ORL,ATL,2013,83.5
13642,13642,42,@,L 72-102 ,240,27,72,0.375,20,52,0.385,7,20,0.35,11,15,0.733,72,40,79,0.506,32,52,0.615,8,27,0.296,14,21,0.667,102,2012-12-15,WAS,MIA,2013,106.0
13643,13643,43,@,L 72-81 ,240,29,68,0.426,26,52,0.5,3,16,0.188,11,18,0.611,72,36,89,0.404,31,70,0.443,5,19,0.263,4,7,0.571,81,2012-12-29,DEN,MEM,2013,83.5
13644,13644,44,@,L 72-90 ,240,29,74,0.392,27,64,0.422,2,10,0.2,12,19,0.632,72,39,80,0.488,38,69,0.551,1,11,0.091,11,13,0.846,90,2013-01-09,PHI,TOR,2013,90.5
13645,13645,45,Home,L 72-90 ,240,26,77,0.338,24,63,0.381,2,14,0.143,18,24,0.75,72,34,75,0.453,26,53,0.491,8,22,0.364,14,19,0.737,90,2013-02-23,DET,IND,2013,94.0
13646,13646,46,Home,L 72-76 ,240,29,77,0.377,20,56,0.357,9,21,0.429,5,13,0.385,72,32,71,0.451,30,64,0.469,2,7,0.286,10,12,0.833,76,2013-02-24,BRK,MEM,2013,77.0
13647,13647,47,@,L 72-102 ,240,25,86,0.291,21,68,0.309,4,18,0.222,18,24,0.75,72,36,79,0.456,30,62,0.484,6,17,0.353,24,27,0.889,102,2013-02-24,CHI,OKC,2013,105.0
13648,13648,48,Home,L 72-93 ,240,28,83,0.337,25,66,0.379,3,17,0.176,13,13,1.0,72,35,70,0.5,25,51,0.49,10,19,0.526,13,15,0.867,93,2013-03-18,NOP,GSW,2013,98.0
13649,13649,49,@,L 72-101 ,240,29,79,0.367,23,59,0.39,6,20,0.3,8,10,0.8,72,41,78,0.526,35,58,0.603,6,20,0.3,13,19,0.684,101,2013-03-20,PHI,LAC,2013,104.0
13650,13650,50,Home,L 72-96 ,240,30,85,0.353,25,67,0.373,5,18,0.278,7,9,0.778,72,38,77,0.494,33,63,0.524,5,14,0.357,15,27,0.556,96,2013-11-23,MIL,CHA,2014,98.5
13651,13651,51,Home,L 72-81 ,240,28,88,0.318,21,67,0.313,7,21,0.333,9,12,0.75,72,24,62,0.387,18,46,0.391,6,16,0.375,27,39,0.692,81,2014-01-10,MIL,CHI,2014,84.0
13652,13652,52,@,L 72-98 ,240,21,73,0.288,14,48,0.292,7,25,0.28,23,29,0.793,72,36,83,0.434,30,66,0.455,6,17,0.353,20,34,0.588,98,2014-01-18,UTA,MIN,2014,101.0
13653,13653,53,Home,L 72-93 ,240,29,88,0.33,20,59,0.339,9,29,0.31,5,10,0.5,72,34,82,0.415,21,53,0.396,13,29,0.448,12,20,0.6,93,2015-01-30,MIA,DAL,2015,99.5
13654,13654,54,Home,L 72-107 ,240,32,86,0.372,28,69,0.406,4,17,0.235,4,7,0.571,72,43,84,0.512,33,62,0.532,10,22,0.455,11,13,0.846,107,2015-02-07,NOP,CHI,2015,112.0
13655,13655,55,@,L 72-74 ,240,31,83,0.373,26,65,0.4,5,18,0.278,5,10,0.5,72,29,83,0.349,27,61,0.443,2,22,0.091,14,21,0.667,74,2015-03-19,NOP,PHO,2015,75.0
13656,13656,56,Home,L 72-104 ,240,28,80,0.35,23,62,0.371,5,18,0.278,11,15,0.733,72,42,85,0.494,37,65,0.569,5,20,0.25,15,23,0.652,104,2016-10-29,PHI,ATL,2017,106.5
13657,13657,57,Home,L 72-88 ,240,28,87,0.322,24,64,0.375,4,23,0.174,12,18,0.667,72,36,81,0.444,27,56,0.482,9,25,0.36,7,11,0.636,88,2017-02-13,UTA,LAC,2017,92.5
13658,13658,58,@,L 71-96 ,240,29,90,0.322,28,77,0.364,1,13,0.077,12,17,0.706,71,30,71,0.423,24,55,0.436,6,16,0.375,30,37,0.811,96,2011-12-27,UTA,LAL,2012,99.0
13659,13659,59,@,L 71-93 ,240,27,77,0.351,26,58,0.448,1,19,0.053,16,21,0.762,71,34,86,0.395,18,53,0.34,16,33,0.485,9,16,0.563,93,2012-01-05,DAL,SAS,2012,101.0
13660,13660,60,Home,L 71-79 ,240,30,74,0.405,26,64,0.406,4,10,0.4,7,9,0.778,71,31,69,0.449,26,50,0.52,5,19,0.263,12,16,0.75,79,2012-01-20,BOS,PHO,2012,81.5
13661,13661,61,@,L 71-109 ,240,29,78,0.372,25,65,0.385,4,13,0.308,9,18,0.5,71,43,91,0.473,36,71,0.507,7,20,0.35,16,19,0.842,109,2012-01-27,PHO,POR,2012,112.5
13662,13662,62,Home,L 71-74 ,240,27,71,0.38,21,57,0.368,6,14,0.429,11,18,0.611,71,30,78,0.385,28,61,0.459,2,17,0.118,12,19,0.632,74,2012-02-16,POR,LAC,2012,75.0
13663,13663,63,@,L 71-103 ,240,28,80,0.35,28,72,0.389,0,8,0.0,15,18,0.833,71,43,89,0.483,37,72,0.514,6,17,0.353,11,15,0.733,103,2012-03-07,BOS,PHI,2012,106.0
13664,13664,64,Home,L 71-73 ,240,30,78,0.385,25,66,0.379,5,12,0.417,6,7,0.857,71,34,79,0.43,34,67,0.507,0,12,0.0,5,7,0.714,73,2012-03-12,NOP,CHA,2012,73.0
13665,13665,65,@,L 71-83 ,240,31,84,0.369,28,73,0.384,3,11,0.273,6,7,0.857,71,32,75,0.427,30,63,0.476,2,12,0.167,17,21,0.81,83,2012-03-30,DET,CHI,2012,84.0
13666,13666,66,@,L 71-80 ,240,28,75,0.373,26,64,0.406,2,11,0.182,13,20,0.65,71,30,80,0.375,24,69,0.348,6,11,0.545,14,19,0.737,80,2012-12-17,CHI,MEM,2013,83.0
13667,13667,67,@,L 71-99 ,240,29,81,0.358,23,60,0.383,6,21,0.286,7,14,0.5,71,38,82,0.463,30,61,0.492,8,21,0.381,15,16,0.938,99,2013-01-06,WAS,MIA,2013,103.0
13668,13668,68,Home,W 71-69 ,240,28,76,0.368,23,61,0.377,5,15,0.333,10,12,0.833,71,27,74,0.365,24,57,0.421,3,17,0.176,12,17,0.706,69,2013-02-13,BOS,CHI,2013,70.5
13669,13669,69,Home,L 71-98 ,240,28,74,0.378,21,51,0.412,7,23,0.304,8,15,0.533,71,37,77,0.481,26,53,0.491,11,24,0.458,13,15,0.867,98,2013-03-06,PHO,TOR,2013,103.5
13670,13670,70,@,L 71-82 ,240,27,74,0.365,21,59,0.356,6,15,0.4,11,14,0.786,71,33,75,0.44,28,62,0.452,5,13,0.385,11,17,0.647,82,2014-03-22,IND,MEM,2014,84.5
13671,13671,71,@,W 71-69 ,240,29,80,0.363,26,69,0.377,3,11,0.273,10,13,0.769,71,26,72,0.361,22,58,0.379,4,14,0.286,13,18,0.722,69,2014-11-01,MEM,CHO,2015,71.0
13672,13672,72,@,L 71-88 ,240,24,74,0.324,19,48,0.396,5,26,0.192,18,28,0.643,71,30,84,0.357,26,61,0.426,4,23,0.174,24,28,0.857,88,2014-12-27,PHI,UTA,2015,90.0
13673,13673,73,@,L 71-80 (OT),265,30,84,0.357,28,63,0.444,2,21,0.095,9,13,0.692,71,31,101,0.307,29,86,0.337,2,15,0.133,16,25,0.64,80,2015-01-17,IND,CHO,2015,81.0
13674,13674,74,@,L 71-76 ,240,28,79,0.354,22,64,0.344,6,15,0.4,9,18,0.5,71,25,76,0.329,23,69,0.333,2,7,0.286,24,37,0.649,76,2015-01-24,NYK,CHO,2015,77.0
13675,13675,75,@,L 71-87 ,240,30,89,0.337,26,71,0.366,4,18,0.222,7,13,0.538,71,27,76,0.355,19,50,0.38,8,26,0.308,25,32,0.781,87,2015-02-23,MIL,CHI,2015,91.0
13676,13676,76,Home,L 71-99 ,240,19,63,0.302,13,48,0.271,6,15,0.4,27,37,0.73,71,36,88,0.409,29,75,0.387,7,13,0.538,20,25,0.8,99,2015-10-30,PHI,UTA,2016,102.5
13677,13677,77,@,L 71-93 ,240,25,64,0.391,18,42,0.429,7,22,0.318,14,22,0.636,71,29,76,0.382,27,58,0.466,2,18,0.111,33,38,0.868,93,2016-11-19,MIN,MEM,2017,94.0
13678,13678,78,Home,L 70-106 ,240,22,71,0.31,17,47,0.362,5,24,0.208,21,26,0.808,70,38,86,0.442,26,63,0.413,12,23,0.522,18,21,0.857,106,2011-12-27,BRK,ATL,2012,112.0
13679,13679,79,@,L 70-89 ,240,30,74,0.405,26,54,0.481,4,20,0.2,6,10,0.6,70,35,71,0.493,29,55,0.527,6,16,0.375,13,21,0.619,89,2012-01-04,BRK,BOS,2012,92.0
13680,13680,80,Home,L 70-82 ,240,30,88,0.341,29,75,0.387,1,13,0.077,9,11,0.818,70,32,83,0.386,26,66,0.394,6,17,0.353,12,16,0.75,82,2012-01-10,CHA,HOU,2012,85.0
13681,13681,81,@,L 70-73 ,240,28,80,0.35,24,54,0.444,4,26,0.154,10,16,0.625,70,29,76,0.382,28,66,0.424,1,10,0.1,14,19,0.737,73,2012-01-16,DAL,LAL,2012,73.5
13682,13682,82,@,L 70-86 ,240,28,83,0.337,22,63,0.349,6,20,0.3,8,10,0.8,70,34,67,0.507,26,38,0.684,8,29,0.276,10,14,0.714,86,2012-03-16,BRK,ORL,2012,90.0
13683,13683,83,@,L 70-104 ,240,24,67,0.358,20,49,0.408,4,18,0.222,18,24,0.75,70,42,76,0.553,37,66,0.561,5,10,0.5,15,24,0.625,104,2012-04-26,MIA,WAS,2012,106.5
13684,13684,84,Home,L 70-77 ,240,26,80,0.325,22,64,0.344,4,16,0.25,14,22,0.636,70,27,82,0.329,22,63,0.349,5,19,0.263,18,23,0.783,77,2012-12-11,NOP,WAS,2013,79.5
13685,13685,85,@,L 70-86 ,240,25,78,0.321,22,67,0.328,3,11,0.273,17,26,0.654,70,34,84,0.405,30,71,0.423,4,13,0.308,14,20,0.7,86,2013-04-17,UTA,MEM,2013,88.0
13686,13686,86,@,L 70-99 ,240,22,78,0.282,18,58,0.31,4,20,0.2,22,34,0.647,70,36,69,0.522,34,61,0.557,2,8,0.25,25,34,0.735,99,2014-02-03,CHI,SAC,2014,100.0
13687,13687,87,@,L 70-123 ,240,23,77,0.299,16,50,0.32,7,27,0.259,17,33,0.515,70,41,80,0.513,30,48,0.625,11,32,0.344,30,36,0.833,123,2014-11-13,PHI,DAL,2015,128.5
13688,13688,88,@,L 70-88 ,240,22,69,0.319,11,41,0.268,11,28,0.393,15,20,0.75,70,36,81,0.444,31,61,0.508,5,20,0.25,11,17,0.647,88,2014-12-12,PHI,BRK,2015,90.5
13689,13689,89,@,L 70-95 ,240,26,78,0.333,23,64,0.359,3,14,0.214,15,18,0.833,70,37,90,0.411,30,69,0.435,7,21,0.333,14,20,0.7,95,2015-12-02,MIL,SAS,2016,98.5
13690,13690,90,@,L 70-91 ,240,22,70,0.314,18,46,0.391,4,24,0.167,22,27,0.815,70,40,92,0.435,35,73,0.479,5,19,0.263,6,7,0.857,91,2016-11-27,LAC,IND,2017,93.5
13691,13691,91,@,L 69-74 ,240,26,78,0.333,19,56,0.339,7,22,0.318,10,22,0.455,69,30,80,0.375,26,65,0.4,4,15,0.267,10,19,0.526,74,2012-01-30,ORL,PHI,2012,76.0
13692,13692,92,@,L 69-114 ,240,23,79,0.291,17,57,0.298,6,22,0.273,17,22,0.773,69,40,78,0.513,27,51,0.529,13,27,0.481,21,23,0.913,114,2012-11-26,CHA,OKC,2013,120.5
13693,13693,93,@,L 69-85 ,240,29,85,0.341,27,75,0.36,2,10,0.2,9,15,0.6,69,34,78,0.436,31,71,0.437,3,7,0.429,14,20,0.7,85,2013-01-18,SAC,MEM,2013,86.5
13694,13694,94,Home,L 69-88 ,240,31,89,0.348,29,81,0.358,2,8,0.25,5,7,0.714,69,32,81,0.395,27,64,0.422,5,17,0.294,19,25,0.76,88,2013-02-06,PHI,IND,2013,90.5
13695,13695,95,Home,L 69-97 ,240,30,91,0.33,26,77,0.338,4,14,0.286,5,5,1.0,69,34,76,0.447,25,59,0.424,9,17,0.529,20,27,0.741,97,2013-02-10,PHO,OKC,2013,101.5
13696,13696,96,@,L 69-71 ,240,27,74,0.365,24,57,0.421,3,17,0.176,12,17,0.706,69,28,76,0.368,23,61,0.377,5,15,0.333,10,12,0.833,71,2013-02-13,CHI,BOS,2013,73.5
13697,13697,97,@,L 69-102 ,240,25,78,0.321,24,68,0.353,1,10,0.1,18,25,0.72,69,42,93,0.452,32,63,0.508,10,30,0.333,8,12,0.667,102,2014-04-04,SAC,GSW,2014,107.0
13698,13698,98,Home,L 69-71 ,240,26,72,0.361,22,58,0.379,4,14,0.286,13,18,0.722,69,29,80,0.363,26,69,0.377,3,11,0.273,10,13,0.769,71,2014-11-01,CHA,MEM,2015,72.5
13699,13699,99,@,W 69-65 ,240,23,80,0.288,16,45,0.356,7,35,0.2,16,30,0.533,69,20,68,0.294,17,49,0.347,3,19,0.158,22,28,0.786,65,2014-11-16,HOU,OKC,2015,66.5
13700,13700,0,@,L 69-89 ,240,28,84,0.333,25,74,0.338,3,10,0.3,10,16,0.625,69,31,80,0.388,23,63,0.365,8,17,0.471,19,23,0.826,89,2015-01-18,UTA,SAS,2015,93.0
13701,13701,1,@,L 69-89 ,240,23,75,0.307,21,55,0.382,2,20,0.1,21,23,0.913,69,37,78,0.474,30,57,0.526,7,21,0.333,8,12,0.667,89,2015-01-28,DET,PHI,2015,92.5
13702,13702,2,@,L 69-99 ,240,29,87,0.333,27,61,0.443,2,26,0.077,9,10,0.9,69,39,88,0.443,36,72,0.5,3,16,0.188,18,27,0.667,99,2015-01-29,DEN,MEM,2015,100.5
13703,13703,3,Home,L 69-95 ,240,25,77,0.325,21,55,0.382,4,22,0.182,15,20,0.75,69,44,85,0.518,42,71,0.592,2,14,0.143,5,5,1.0,95,2015-03-09,CHA,WAS,2015,96.0
13704,13704,4,@,L 69-96 ,240,26,83,0.313,22,63,0.349,4,20,0.2,13,18,0.722,69,41,83,0.494,37,58,0.638,4,25,0.16,10,14,0.714,96,2015-04-07,PHO,ATL,2015,98.0
13705,13705,5,@,L 69-119 ,240,26,96,0.271,23,73,0.315,3,23,0.13,14,20,0.7,69,43,84,0.512,32,59,0.542,11,25,0.44,22,30,0.733,119,2015-11-02,MEM,GSW,2016,124.5
13706,13706,6,@,L 69-103 ,240,28,82,0.341,22,56,0.393,6,26,0.231,7,14,0.5,69,43,88,0.489,32,63,0.508,11,25,0.44,6,9,0.667,103,2016-03-17,PHO,UTA,2016,108.5
13707,13707,7,@,L 69-88 ,240,27,84,0.321,22,59,0.373,5,25,0.2,10,13,0.769,69,35,90,0.389,27,65,0.415,8,25,0.32,10,10,1.0,88,2016-11-14,ORL,IND,2017,92.0
13708,13708,8,Home,L 69-95 ,240,28,92,0.304,23,71,0.324,5,21,0.238,8,15,0.533,69,38,82,0.463,28,57,0.491,10,25,0.4,9,13,0.692,95,2016-12-16,CHI,MIL,2017,100.0
13709,13709,9,@,L 68-92 ,240,28,71,0.394,27,67,0.403,1,4,0.25,11,14,0.786,68,34,74,0.459,31,58,0.534,3,16,0.188,21,25,0.84,92,2012-01-09,DET,CHI,2012,93.5
13710,13710,10,@,L 68-112 ,240,26,80,0.325,25,71,0.352,1,9,0.111,15,19,0.789,68,44,80,0.55,37,66,0.561,7,14,0.5,17,20,0.85,112,2012-02-01,CHA,POR,2012,115.5
13711,13711,11,Home,L 68-97 ,240,25,79,0.316,23,69,0.333,2,10,0.2,16,20,0.8,68,42,84,0.5,37,71,0.521,5,13,0.385,8,9,0.889,97,2012-02-28,DET,PHI,2012,99.5
13712,13712,12,Home,L 68-100 ,240,25,84,0.298,24,76,0.316,1,8,0.125,17,23,0.739,68,40,83,0.482,31,64,0.484,9,19,0.474,11,19,0.579,100,2012-04-18,CHA,CHI,2012,104.5
13713,13713,13,Home,L 68-107 ,240,30,70,0.429,26,59,0.441,4,11,0.364,4,8,0.5,68,41,82,0.5,32,59,0.542,9,23,0.391,16,25,0.64,107,2012-11-09,ORL,BRK,2013,111.5
13714,13714,14,@,L 68-100 ,240,28,85,0.329,26,73,0.356,2,12,0.167,10,13,0.769,68,38,90,0.422,28,66,0.424,10,24,0.417,14,21,0.667,100,2012-12-21,WAS,DET,2013,105.0
13715,13715,15,@,L 68-98 ,240,28,81,0.346,23,63,0.365,5,18,0.278,7,12,0.583,68,38,78,0.487,33,62,0.532,5,16,0.313,17,23,0.739,98,2013-03-01,CHA,UTA,2013,100.5
13716,13716,16,Home,L 68-119 ,240,26,75,0.347,22,51,0.431,4,24,0.167,12,21,0.571,68,47,76,0.618,43,65,0.662,4,11,0.364,21,25,0.84,119,2015-12-07,PHI,SAS,2016,121.0
13717,13717,17,@,L 68-95 ,240,26,83,0.313,18,58,0.31,8,25,0.32,8,12,0.667,68,35,80,0.438,25,46,0.543,10,34,0.294,15,18,0.833,95,2016-11-25,ATL,UTA,2017,100.0
13718,13718,18,@,L 67-93 ,240,24,61,0.393,18,40,0.45,6,21,0.286,13,21,0.619,67,41,81,0.506,36,67,0.537,5,14,0.357,6,16,0.375,93,2012-01-27,ORL,NOH,2012,95.5
13719,13719,19,Home,L 67-90 ,240,28,75,0.373,27,72,0.375,1,3,0.333,10,17,0.588,67,39,85,0.459,35,69,0.507,4,16,0.25,8,12,0.667,90,2012-02-08,NOP,CHI,2012,92.0
13720,13720,20,Home,L 67-75 ,240,23,76,0.303,22,60,0.367,1,16,0.063,20,30,0.667,67,26,77,0.338,25,66,0.379,1,11,0.091,22,25,0.88,75,2012-04-16,CHA,NOH,2012,75.5
13721,13721,21,@,L 67-98 ,240,25,83,0.301,19,65,0.292,6,18,0.333,11,16,0.688,67,37,88,0.42,27,69,0.391,10,19,0.526,14,18,0.778,98,2012-04-26,BRK,TOR,2012,103.0
13722,13722,22,Home,L 67-86 ,240,28,75,0.373,26,65,0.4,2,10,0.2,9,11,0.818,67,37,73,0.507,34,60,0.567,3,13,0.231,9,14,0.643,86,2013-02-21,CHI,MIA,2013,87.5
13723,13723,23,Home,L 67-88 ,240,27,79,0.342,23,65,0.354,4,14,0.286,9,14,0.643,67,32,74,0.432,25,51,0.49,7,23,0.304,17,21,0.81,88,2014-03-29,MIL,MIA,2014,91.5
13724,13724,24,@,L 66-78 ,240,28,73,0.384,22,56,0.393,6,17,0.353,4,7,0.571,66,32,74,0.432,28,62,0.452,4,12,0.333,10,16,0.625,78,2012-04-24,MIA,BOS,2012,80.0
13725,13725,25,@,L 66-93 ,240,26,81,0.321,21,67,0.313,5,14,0.357,9,23,0.391,66,37,83,0.446,31,70,0.443,6,13,0.462,13,22,0.591,93,2014-01-10,WAS,IND,2014,96.0
13726,13726,26,@,L 66-94 ,240,23,78,0.295,18,59,0.305,5,19,0.263,15,18,0.833,66,33,78,0.423,18,54,0.333,15,24,0.625,13,19,0.684,94,2015-03-16,CHA,UTA,2015,101.5
13727,13727,27,@,L 65-103 ,240,22,79,0.278,18,59,0.305,4,20,0.2,17,21,0.81,65,39,84,0.464,25,55,0.455,14,29,0.483,11,13,0.846,103,2012-04-13,WAS,NYK,2012,110.0
13728,13728,28,Home,L 65-69 ,240,20,68,0.294,17,49,0.347,3,19,0.158,22,28,0.786,65,23,80,0.288,16,45,0.356,7,35,0.2,16,30,0.533,69,2014-11-16,OKC,HOU,2015,72.5
13729,13729,29,@,L 64-104 ,240,26,84,0.31,25,75,0.333,1,9,0.111,11,14,0.786,64,39,84,0.464,34,71,0.479,5,13,0.385,21,29,0.724,104,2012-01-01,MEM,CHI,2012,106.5
13730,13730,30,@,L 64-78 ,240,26,84,0.31,23,75,0.307,3,9,0.333,9,12,0.75,64,33,90,0.367,30,78,0.385,3,12,0.25,9,16,0.563,78,2012-01-11,WAS,CHI,2012,79.5
13731,13731,31,@,L 64-77 ,240,30,86,0.349,27,76,0.355,3,10,0.3,1,7,0.143,64,33,82,0.402,29,67,0.433,4,15,0.267,7,12,0.583,77,2012-01-14,TOR,CHI,2012,79.0
13732,13732,32,@,L 64-100 ,240,25,73,0.342,19,59,0.322,6,14,0.429,8,18,0.444,64,39,75,0.52,27,51,0.529,12,24,0.5,10,12,0.833,100,2012-02-01,TOR,BOS,2012,106.0
13733,13733,33,Home,L 64-95 ,240,25,76,0.329,24,68,0.353,1,8,0.125,13,19,0.684,64,39,90,0.433,33,75,0.44,6,15,0.4,11,20,0.55,95,2012-02-10,CHA,CHI,2012,98.0
13734,13734,34,Home,L 64-80 ,240,21,73,0.288,16,48,0.333,5,25,0.2,17,22,0.773,64,31,77,0.403,22,52,0.423,9,25,0.36,9,12,0.75,80,2016-11-18,DAL,MEM,2017,84.5
13735,13735,35,@,L 63-99 ,240,24,74,0.324,22,57,0.386,2,17,0.118,13,13,1.0,63,41,87,0.471,36,75,0.48,5,12,0.417,12,18,0.667,99,2013-02-13,POR,NOH,2013,101.5
13736,13736,36,@,L 63-92 ,240,20,73,0.274,15,46,0.326,5,27,0.185,18,28,0.643,63,32,78,0.41,21,58,0.362,11,20,0.55,17,24,0.708,92,2013-03-11,NYK,GSW,2013,97.5
13737,13737,37,@,L 62-97 ,240,27,85,0.318,26,73,0.356,1,12,0.083,7,12,0.583,62,36,83,0.434,31,62,0.5,5,21,0.238,20,27,0.741,97,2012-01-07,TOR,PHI,2012,99.5
13738,13738,38,Home,L 62-77 ,240,23,69,0.333,19,50,0.38,4,19,0.211,12,16,0.75,62,35,84,0.417,31,62,0.5,4,22,0.182,3,5,0.6,77,2012-11-07,NOP,PHI,2013,79.0
13739,13739,39,@,L 61-78 ,240,27,80,0.338,26,68,0.382,1,12,0.083,6,8,0.75,61,36,79,0.456,33,59,0.559,3,20,0.15,3,5,0.6,78,2013-02-04,ORL,PHI,2013,79.5
13740,13740,40,@,L 60-99 ,240,22,86,0.256,20,65,0.308,2,21,0.095,14,18,0.778,60,37,81,0.457,30,65,0.462,7,16,0.438,18,25,0.72,99,2012-01-14,SAC,DAL,2012,102.5
13741,13741,41,Home,L 59-85 ,240,24,68,0.353,20,48,0.417,4,20,0.2,7,18,0.389,59,35,79,0.443,28,61,0.459,7,18,0.389,8,11,0.727,85,2012-03-19,ORL,CHI,2012,88.5
13742,13742,42,@,L 58-97 ,240,24,82,0.293,22,68,0.324,2,14,0.143,8,10,0.8,58,33,79,0.418,27,65,0.415,6,14,0.429,25,33,0.758,97,2013-01-14,ATL,CHI,2013,100.0
13743,13743,43,@,L 56-87 ,240,16,65,0.246,12,49,0.245,4,16,0.25,20,30,0.667,56,33,78,0.423,31,65,0.477,2,13,0.154,19,19,1.0,87,2012-01-23,ORL,BOS,2012,88.0
