,game_location,game_result,mp,fg,fga,fg_pct,fg2,fg2a,fg2_pct,fg3,fg3a,fg3_pct,ft,fta,ft_pct,pts,opp_fg,opp_fga,opp_fg_pct,opp_fg2,opp_fg2a,opp_fg2_pct,opp_fg3,opp_fg3a,opp_fg3_pct,opp_ft,opp_fta,opp_ft_pct,opp_pts,date_game,team_id,opp_id
0,Home,W 149-140 (2OT),290,60,113,.531,50,86,.581,10,27,.370,19,20,.950,149,49,100,.490,35,64,.547,14,36,.389,28,36,.778,140,2012-03-23,OKC,MIN
1,Home,W 149-106 ,240,53,86,.616,34,50,.680,19,36,.528,24,35,.686,149,40,93,.430,32,73,.438,8,20,.400,18,22,.818,106,2016-11-23,GSW,LAL
2,@,W 147-144 (4OT),340,56,124,.452,48,95,.505,8,29,.276,27,46,.587,147,50,120,.417,45,98,.459,5,22,.227,39,44,.886,144,2015-12-18,DET,CHI
3,@,W 145-130 ,240,56,97,.577,45,71,.634,11,26,.423,22,28,.786,145,44,95,.463,30,63,.476,14,32,.438,28,35,.800,130,2014-04-08,HOU,LAL
4,@,W 144-143 (2OT),290,57,109,.523,46,80,.575,11,29,.379,19,24,.792,144,53,125,.424,38,82,.463,15,43,.349,22,25,.880,143,2015-04-10,DAL,DEN
5,Home,L 144-147 (4OT),340,50,120,.417,45,98,.459,5,22,.227,39,44,.886,144,56,124,.452,48,95,.505,8,29,.276,27,46,.587,147,2015-12-18,CHI,DET
6,Home,W 144-109 ,240,56,86,.651,43,58,.741,13,28,.464,19,23,.826,144,40,92,.435,29,62,.468,11,30,.367,18,22,.818,109,2016-04-13,MIN,NOP
7,Home,W 144-98 ,240,57,92,.620,40,58,.690,17,34,.500,13,16,.813,144,36,82,.439,24,54,.444,12,28,.429,14,22,.636,98,2017-01-28,GSW,LAC
8,Home,W 143-107 ,240,51,76,.671,43,58,.741,8,18,.444,33,40,.825,143,44,102,.431,37,77,.481,7,25,.280,12,15,.800,107,2014-03-28,MIN,LAL
9,Home,L 143-144 (2OT),290,53,125,.424,38,82,.463,15,43,.349,22,25,.880,143,57,109,.523,46,80,.575,11,29,.379,19,24,.792,144,2015-04-10,DEN,DAL
10,@,W 143-114 ,240,48,83,.578,33,53,.623,15,30,.500,32,35,.914,143,43,105,.410,32,71,.451,11,34,.324,17,23,.739,114,2017-01-20,BRK,NOP
11,@,W 142-94 ,240,57,103,.553,45,77,.584,12,26,.462,16,22,.727,142,34,86,.395,26,56,.464,8,30,.267,18,26,.692,94,2014-03-06,LAC,LAL
12,Home,W 142-119 ,240,53,87,.609,44,64,.688,9,23,.391,27,34,.794,142,43,83,.518,33,54,.611,10,29,.345,23,28,.821,119,2016-01-02,SAC,PHO
13,Home,W 142-106 ,240,54,104,.519,40,67,.597,14,37,.378,20,26,.769,142,35,85,.412,32,70,.457,3,15,.200,33,35,.943,106,2016-12-05,GSW,IND
14,Home,W 142-139 (4OT),340,52,119,.437,42,88,.477,10,31,.323,28,40,.700,142,51,128,.398,33,77,.429,18,51,.353,19,23,.826,139,2017-01-29,ATL,NYK
15,Home,W 142-130 ,240,44,94,.468,22,36,.611,22,58,.379,32,42,.762,142,49,94,.521,40,68,.588,9,26,.346,23,28,.821,130,2017-02-25,HOU,MIN
16,Home,W 141-129 (2OT),290,56,101,.554,46,78,.590,10,23,.435,19,24,.792,141,48,93,.516,34,66,.515,14,27,.519,19,26,.731,129,2013-02-26,MIA,SAC
17,@,L 140-149 (2OT),290,49,100,.490,35,64,.547,14,36,.389,28,36,.778,140,60,113,.531,50,86,.581,10,27,.370,19,20,.950,149,2012-03-23,MIN,OKC
18,@,W 140-133 (3OT),315,46,93,.495,32,67,.478,14,26,.538,34,43,.791,140,51,108,.472,43,84,.512,8,24,.333,23,30,.767,133,2012-11-12,UTA,TOR
19,Home,W 140-109 ,240,46,91,.505,23,51,.451,23,40,.575,25,35,.714,140,41,86,.477,38,71,.535,3,15,.200,24,30,.800,109,2013-02-05,HOU,GSW
20,Home,W 140-106 ,240,51,82,.622,33,47,.702,18,35,.514,20,28,.714,140,44,85,.518,39,72,.542,5,13,.385,13,21,.619,106,2014-11-21,DAL,LAL
21,Home,W 140-132 (OT),265,47,91,.516,25,54,.463,22,37,.595,24,33,.727,140,44,88,.500,33,56,.589,11,32,.344,33,52,.635,132,2016-01-18,LAC,HOU
22,Home,W 140-116 ,240,45,81,.556,31,41,.756,14,40,.350,36,43,.837,140,45,96,.469,32,63,.508,13,33,.394,13,16,.813,116,2016-12-30,HOU,LAC
23,Home,W 140-112 ,240,52,91,.571,37,59,.627,15,32,.469,21,23,.913,140,44,94,.468,32,65,.492,12,29,.414,12,13,.923,112,2017-01-12,DEN,IND
24,@,W 140-135 (OT),265,49,92,.533,30,54,.556,19,38,.500,23,28,.821,140,50,99,.505,38,70,.543,12,29,.414,23,26,.885,135,2017-02-06,CLE,WAS
25,Home,W 139-133 (4OT),340,48,107,.449,42,88,.477,6,19,.316,37,47,.787,139,49,126,.389,43,105,.410,6,21,.286,29,35,.829,133,2012-03-25,ATL,UTA
26,@,W 139-105 ,240,52,93,.559,31,56,.554,21,37,.568,14,20,.700,139,39,87,.448,30,72,.417,9,15,.600,18,26,.692,105,2013-12-14,POR,PHI
27,Home,W 139-91 ,240,56,84,.667,41,64,.641,15,20,.750,12,16,.750,139,29,72,.403,26,58,.448,3,14,.214,30,41,.732,91,2014-11-14,NOP,MIN
28,@,W 139-136 (2OT),290,50,110,.455,42,83,.506,8,27,.296,31,38,.816,139,47,106,.443,35,73,.479,12,33,.364,30,38,.789,136,2015-10-30,OKC,ORL
29,Home,W 139-134 (OT),265,47,95,.495,34,62,.548,13,33,.394,32,37,.865,139,44,85,.518,32,55,.582,12,30,.400,34,50,.680,134,2016-02-10,BOS,LAC
30,Home,W 139-105 ,240,56,91,.615,42,64,.656,14,27,.519,13,19,.684,139,37,79,.468,32,65,.492,5,14,.357,26,39,.667,105,2016-03-29,ORL,BRK
31,@,L 139-142 (4OT),340,51,128,.398,33,77,.429,18,51,.353,19,23,.826,139,52,119,.437,42,88,.477,10,31,.323,28,40,.700,142,2017-01-29,NYK,ATL
32,@,W 138-113 ,240,52,95,.547,40,67,.597,12,28,.429,22,31,.710,138,39,84,.464,33,65,.508,6,19,.316,29,35,.829,113,2015-04-15,OKC,MIN
33,Home,W 138-109 ,240,49,78,.628,35,57,.614,14,21,.667,26,34,.765,138,41,91,.451,30,59,.508,11,32,.344,16,21,.762,109,2016-12-03,GSW,PHO
34,Home,W 137-97 ,240,51,86,.593,36,58,.621,15,28,.536,20,24,.833,137,32,84,.381,24,64,.375,8,20,.400,25,32,.781,97,2012-02-21,POR,SAS
35,Home,W 137-118 ,240,49,94,.521,34,56,.607,15,38,.395,24,28,.857,137,41,82,.500,34,57,.596,7,25,.280,29,43,.674,118,2013-11-04,LAC,HOU
36,@,W 137-115 ,240,53,99,.535,41,70,.586,12,29,.414,19,24,.792,137,42,89,.472,39,68,.574,3,21,.143,28,36,.778,115,2014-01-05,DEN,LAL
37,Home,W 137-107 ,240,52,92,.565,37,65,.569,15,27,.556,18,25,.720,137,35,74,.473,33,65,.508,2,9,.222,35,45,.778,107,2014-04-02,DEN,NOP
38,Home,W 137-134 (OT),265,41,99,.414,30,64,.469,11,35,.314,44,49,.898,137,46,90,.511,33,63,.524,13,27,.481,29,35,.829,134,2014-12-31,OKC,PHO
39,Home,W 137-105 ,240,52,97,.536,35,67,.522,17,30,.567,16,23,.696,137,36,92,.391,24,58,.414,12,34,.353,21,28,.750,105,2016-02-19,POR,GSW
40,Home,W 137-125 ,240,48,90,.533,27,54,.500,21,36,.583,20,27,.741,137,47,90,.522,34,61,.557,13,29,.448,18,19,.947,125,2016-11-23,CLE,POR
41,@,W 137-112 ,240,46,92,.500,25,48,.521,21,44,.477,24,32,.750,137,41,93,.441,26,49,.531,15,44,.341,15,19,.789,112,2017-01-15,HOU,BRK
42,@,W 137-112 ,240,52,82,.634,45,65,.692,7,17,.412,26,35,.743,137,38,91,.418,27,63,.429,11,28,.393,25,30,.833,112,2017-02-04,MIL,PHO
43,Home,W 137-101 ,240,49,88,.557,39,64,.609,10,24,.417,29,34,.853,137,35,93,.376,26,67,.388,9,26,.346,22,28,.786,101,2017-02-15,PHO,LAL
44,Home,W 136-103 ,240,46,80,.575,32,46,.696,14,34,.412,30,40,.750,136,38,80,.475,26,53,.491,12,27,.444,15,24,.625,103,2013-03-03,HOU,DAL
45,@,W 136-106 ,240,53,86,.616,40,65,.615,13,21,.619,17,21,.810,136,44,84,.524,38,65,.585,6,19,.316,12,15,.800,106,2013-03-08,POR,SAS
46,@,W 136-130 (2OT),290,53,108,.491,47,84,.560,6,24,.250,24,29,.828,136,40,97,.412,32,72,.444,8,25,.320,42,54,.778,130,2014-04-16,UTA,MIN
47,@,W 136-115 ,240,46,86,.535,32,58,.552,14,28,.500,30,34,.882,136,39,99,.394,36,83,.434,3,16,.188,34,43,.791,115,2014-11-16,GSW,LAL
48,Home,L 136-139 (2OT),290,47,106,.443,35,73,.479,12,33,.364,30,38,.789,136,50,110,.455,42,83,.506,8,27,.296,31,38,.816,139,2015-10-30,ORL,OKC
49,Home,W 136-111 ,240,50,88,.568,32,58,.552,18,30,.600,18,22,.818,136,38,85,.447,29,61,.475,9,24,.375,26,33,.788,111,2016-04-03,GSW,POR
50,@,W 136-130 (2OT),290,52,105,.495,41,83,.494,11,22,.500,21,31,.677,136,50,108,.463,38,78,.487,12,30,.400,18,26,.692,130,2016-12-20,ORL,MIA
51,@,W 136-106 ,240,54,95,.568,44,72,.611,10,23,.435,18,21,.857,136,43,88,.489,29,54,.537,14,34,.412,6,7,.857,106,2017-03-04,DET,PHI
52,Home,W 135-98 ,240,52,86,.605,39,58,.672,13,28,.464,18,27,.667,135,35,83,.422,29,64,.453,6,19,.316,22,31,.710,98,2013-11-16,NOP,PHI
53,Home,W 135-129 (OT),265,49,89,.551,41,73,.562,8,16,.500,29,33,.879,135,48,97,.495,42,77,.545,6,20,.300,27,32,.844,129,2014-12-27,SAC,NYK
54,@,W 135-131 ,240,56,91,.615,52,76,.684,4,15,.267,19,24,.792,135,45,93,.484,31,62,.500,14,31,.452,27,33,.818,131,2015-04-01,DAL,OKC
55,@,W 135-116 ,240,46,81,.568,24,43,.558,22,38,.579,21,31,.677,135,45,92,.489,35,66,.530,10,26,.385,16,23,.696,116,2015-11-27,GSW,PHO
56,Home,W 135-90 ,240,51,87,.586,37,59,.627,14,28,.500,19,26,.731,135,34,86,.395,26,58,.448,8,28,.286,14,20,.700,90,2016-12-17,GSW,POR
57,Home,L 135-140 (OT),265,50,99,.505,38,70,.543,12,29,.414,23,26,.885,135,49,92,.533,30,54,.556,19,38,.500,23,28,.821,140,2017-02-06,WAS,CLE
58,@,W 135-130 ,240,47,86,.547,22,40,.550,25,46,.543,16,20,.800,135,49,91,.538,39,65,.600,10,26,.385,22,30,.733,130,2017-03-03,CLE,ATL
59,@,W 134-126 (OT),265,48,92,.522,34,62,.548,14,30,.467,24,26,.923,134,41,97,.423,25,67,.373,16,30,.533,28,36,.778,126,2012-12-10,SAS,HOU
60,Home,W 134-104 ,240,54,93,.581,33,60,.550,21,33,.636,5,7,.714,134,34,79,.430,27,63,.429,7,16,.438,29,36,.806,104,2014-01-02,POR,CHA
61,@,W 134-108 ,240,52,104,.500,34,69,.493,18,35,.514,12,25,.480,134,41,84,.488,27,57,.474,14,27,.519,12,15,.800,108,2014-02-19,HOU,LAL
62,@,W 134-129 (3OT),315,51,108,.472,46,86,.535,5,22,.227,27,37,.730,134,45,100,.450,33,70,.471,12,30,.400,27,36,.750,129,2014-02-27,WAS,TOR
63,Home,W 134-126 ,240,54,99,.545,40,75,.533,14,24,.583,12,21,.571,134,45,97,.464,33,70,.471,12,27,.444,24,30,.800,126,2014-03-07,DEN,LAL
64,@,L 134-137 (OT),265,46,90,.511,33,63,.524,13,27,.481,29,35,.829,134,41,99,.414,30,64,.469,11,35,.314,44,49,.898,137,2014-12-31,PHO,OKC
65,@,W 134-120 ,240,46,84,.548,29,54,.537,17,30,.567,25,35,.714,134,46,100,.460,38,78,.487,8,22,.364,20,23,.870,120,2015-10-31,GSW,NOP
66,@,W 134-121 ,240,49,93,.527,29,52,.558,20,41,.488,16,29,.552,134,46,91,.505,38,68,.559,8,23,.348,21,30,.700,121,2016-02-03,GSW,WAS
67,@,L 134-139 (OT),265,44,85,.518,32,55,.582,12,30,.400,34,50,.680,134,47,95,.495,34,62,.548,13,33,.394,32,37,.865,139,2016-02-10,LAC,BOS
68,Home,W 134-95 ,240,51,94,.543,36,58,.621,15,36,.417,17,21,.810,134,34,87,.391,29,67,.433,5,20,.250,22,27,.815,95,2016-12-07,HOU,LAL
69,Home,W 134-94 ,240,49,81,.605,39,60,.650,10,21,.476,26,29,.897,134,35,85,.412,29,65,.446,6,20,.300,18,25,.720,94,2017-01-12,SAS,LAL
70,@,L 133-139 (4OT),340,49,126,.389,43,105,.410,6,21,.286,29,35,.829,133,48,107,.449,42,88,.477,6,19,.316,37,47,.787,139,2012-03-25,UTA,ATL
71,Home,L 133-140 (3OT),315,51,108,.472,43,84,.512,8,24,.333,23,30,.767,133,46,93,.495,32,67,.478,14,26,.538,34,43,.791,140,2012-11-12,TOR,UTA
72,@,W 133-102 ,240,55,98,.561,42,74,.568,13,24,.542,10,14,.714,133,35,87,.402,29,64,.453,6,23,.261,26,35,.743,102,2014-03-28,SAS,DEN
73,Home,W 133-132 (2OT),290,49,94,.521,42,78,.538,7,16,.438,28,34,.824,133,47,102,.461,38,80,.475,9,22,.409,29,32,.906,132,2014-12-08,WAS,BOS
74,Home,W 133-126 ,240,47,90,.522,34,62,.548,13,28,.464,26,34,.765,133,45,83,.542,39,65,.600,6,18,.333,30,36,.833,126,2015-04-15,GSW,DEN
75,Home,W 133-111 ,240,51,82,.622,42,62,.677,9,20,.450,22,30,.733,133,42,88,.477,34,64,.531,8,24,.333,19,24,.792,111,2016-03-27,SAC,DAL
76,Home,W 133-120 ,240,45,87,.517,29,54,.537,16,33,.485,27,31,.871,133,46,90,.511,38,66,.576,8,24,.333,20,26,.769,120,2016-11-13,GSW,PHO
77,Home,W 133-105 ,240,54,94,.574,37,58,.638,17,36,.472,8,9,.889,133,40,83,.482,32,64,.500,8,19,.421,17,26,.654,105,2016-12-10,LAC,NOP
78,@,W 133-120 ,240,52,99,.525,38,65,.585,14,34,.412,15,18,.833,133,40,80,.500,30,55,.545,10,25,.400,30,39,.769,120,2017-02-02,GSW,LAC
79,Home,W 133-102 ,240,42,85,.494,24,49,.490,18,36,.500,31,39,.795,133,37,94,.394,29,72,.403,8,22,.364,20,26,.769,102,2017-02-11,HOU,PHO
80,@,W 132-102 ,240,50,90,.556,31,56,.554,19,34,.559,13,15,.867,132,37,79,.468,31,64,.484,6,15,.400,22,31,.710,102,2012-12-08,SAS,CHA
81,Home,W 132-114 ,240,54,99,.545,43,74,.581,11,25,.440,13,21,.619,132,39,83,.470,25,49,.510,14,34,.412,22,32,.688,114,2013-04-06,DEN,HOU
82,@,W 132-128 ,240,38,80,.475,34,64,.531,4,16,.250,52,64,.813,132,50,95,.526,38,62,.613,12,33,.364,16,25,.640,128,2014-03-03,MIN,DEN
83,@,W 132-125 ,240,46,77,.597,39,60,.650,7,17,.412,33,40,.825,132,46,85,.541,36,63,.571,10,22,.455,23,31,.742,125,2014-03-04,NOP,LAL
84,@,W 132-129 (2OT),290,47,102,.461,32,72,.444,15,30,.500,23,27,.852,132,47,103,.456,39,77,.506,8,26,.308,27,34,.794,129,2014-12-02,DAL,CHI
85,@,L 132-133 (2OT),290,47,102,.461,38,80,.475,9,22,.409,29,32,.906,132,49,94,.521,42,78,.538,7,16,.438,28,34,.824,133,2014-12-08,BOS,WAS
86,Home,W 132-114 ,240,52,101,.515,46,79,.582,6,22,.273,22,30,.733,132,41,89,.461,30,55,.545,11,34,.324,21,27,.778,114,2015-10-30,SAC,LAL
87,@,W 132-98 ,240,46,85,.541,27,45,.600,19,40,.475,21,27,.778,132,37,77,.481,30,58,.517,7,19,.368,17,25,.680,98,2016-01-18,GSW,CLE
88,@,L 132-140 (OT),265,44,88,.500,33,56,.589,11,32,.344,33,52,.635,132,47,91,.516,25,54,.463,22,37,.595,24,33,.727,140,2016-01-18,HOU,LAC
89,Home,W 132-118 ,240,52,76,.684,42,58,.724,10,18,.556,18,22,.818,132,45,92,.489,36,66,.545,9,26,.346,19,26,.731,118,2016-03-05,MIN,BRK
90,Home,W 132-120 (OT),265,49,89,.551,34,64,.531,15,25,.600,19,23,.826,132,42,104,.404,24,58,.414,18,46,.391,18,28,.643,120,2016-03-20,DAL,POR
91,@,W 132-129 (2OT),290,51,96,.531,43,70,.614,8,26,.308,22,22,1.000,132,50,100,.500,37,71,.521,13,29,.448,16,23,.696,129,2016-03-25,MIN,WAS
92,@,W 132-129 (OT),265,48,95,.505,35,69,.507,13,26,.500,23,29,.793,132,48,101,.475,36,67,.537,12,34,.353,21,27,.778,129,2016-11-25,OKC,DEN
93,@,W 132-127 (2OT),290,48,108,.444,34,64,.531,14,44,.318,22,30,.733,132,43,104,.413,31,60,.517,12,44,.273,29,37,.784,127,2016-12-01,HOU,GSW
94,Home,W 132-98 ,240,50,85,.588,28,43,.651,22,42,.524,10,16,.625,132,39,92,.424,28,60,.467,11,32,.344,9,11,.818,98,2016-12-14,HOU,SAC
95,Home,W 132-120 ,240,43,84,.512,28,53,.528,15,31,.484,31,35,.886,132,41,88,.466,33,65,.508,8,23,.348,30,36,.833,120,2016-12-15,DEN,POR
96,Home,W 132-113 ,240,52,97,.536,41,69,.594,11,28,.393,17,21,.810,132,40,86,.465,23,50,.460,17,36,.472,16,20,.800,113,2017-01-13,TOR,BRK
97,@,W 132-117 ,240,46,84,.548,30,48,.625,16,36,.444,24,26,.923,132,41,82,.500,28,57,.491,13,25,.520,22,26,.846,117,2017-02-08,CLE,IND
98,Home,W 132-110 ,240,48,88,.545,24,47,.511,24,41,.585,12,16,.750,132,45,92,.489,37,60,.617,8,32,.250,12,13,.923,110,2017-02-13,DEN,GSW
99,@,W 131-102 ,240,56,89,.629,51,79,.646,5,10,.500,14,20,.700,131,40,89,.449,30,62,.484,10,27,.370,12,19,.632,102,2012-04-26,DEN,MIN
0,Home,W 131-103 ,240,46,89,.517,32,64,.500,14,25,.560,25,28,.893,131,37,86,.430,20,47,.426,17,39,.436,12,14,.857,103,2012-11-23,HOU,NYK
1,Home,W 131-99 ,240,45,91,.495,32,68,.471,13,23,.565,28,35,.800,131,33,82,.402,26,58,.448,7,24,.292,26,31,.839,99,2012-12-07,UTA,TOR
2,Home,W 131-127 ,240,43,86,.500,32,67,.478,11,19,.579,34,42,.810,131,46,92,.500,33,66,.500,13,26,.500,22,25,.880,127,2012-12-19,SAC,GSW
3,Home,W 131-102 ,240,51,100,.510,37,73,.507,14,27,.519,15,17,.882,131,37,73,.507,31,54,.574,6,19,.316,22,28,.786,102,2013-04-01,MIL,CHA
4,@,W 131-128 (3OT),315,50,113,.442,39,90,.433,11,23,.478,20,27,.741,131,48,101,.475,40,78,.513,8,23,.348,24,34,.706,128,2013-12-02,NOP,CHI
5,Home,W 131-102 ,240,45,89,.506,32,59,.542,13,30,.433,28,30,.933,131,37,94,.394,24,67,.358,13,27,.481,15,25,.600,102,2014-03-13,OKC,LAL
6,Home,W 131-109 ,240,42,76,.553,34,56,.607,8,20,.400,39,50,.780,131,37,82,.451,28,54,.519,9,28,.321,26,31,.839,109,2014-11-05,SAC,DEN
7,Home,W 131-117 ,240,52,94,.553,44,68,.647,8,26,.308,19,23,.826,131,43,86,.500,36,69,.522,7,17,.412,24,29,.828,117,2014-11-15,DAL,MIN
8,@,W 131-106 ,240,50,91,.549,41,69,.594,9,22,.409,22,33,.667,131,37,88,.420,30,65,.462,7,23,.304,25,34,.735,106,2015-01-17,GSW,HOU
9,Home,W 131-108 ,240,46,88,.523,38,68,.559,8,20,.400,31,38,.816,131,42,90,.467,30,58,.517,12,32,.375,12,17,.706,108,2015-02-08,OKC,LAC
10,Home,L 131-135 ,240,45,93,.484,31,62,.500,14,31,.452,27,33,.818,131,56,91,.615,52,76,.684,4,15,.267,19,24,.792,135,2015-04-01,OKC,DAL
11,Home,W 131-99 ,240,49,82,.598,32,49,.653,17,33,.515,16,19,.842,131,39,80,.488,29,57,.509,10,23,.435,11,17,.647,99,2015-04-04,ATL,BRK
12,@,W 131-123 ,240,52,95,.547,36,60,.600,16,35,.457,11,15,.733,131,44,100,.440,30,67,.448,14,33,.424,21,26,.808,123,2015-12-08,GSW,IND
13,Home,W 131-123 ,240,43,86,.500,35,64,.547,8,22,.364,37,40,.925,131,49,100,.490,39,84,.464,10,16,.625,15,22,.682,123,2015-12-29,OKC,MIL
14,@,W 131-116 ,240,47,82,.573,33,48,.688,14,34,.412,23,26,.885,131,48,107,.449,41,82,.500,7,25,.280,13,19,.684,116,2016-02-29,OKC,SAC
15,Home,W 131-114 ,240,47,90,.522,37,66,.561,10,24,.417,27,31,.871,131,41,88,.466,30,58,.517,11,30,.367,21,26,.808,114,2016-03-15,BRK,PHI
16,Home,W 131-109 ,240,51,94,.543,39,62,.629,12,32,.375,17,19,.895,131,36,72,.500,30,58,.517,6,14,.429,31,35,.886,109,2016-11-30,POR,IND
17,@,W 131-120 ,240,51,87,.586,36,53,.679,15,34,.441,14,20,.700,131,45,89,.506,34,61,.557,11,28,.393,19,21,.905,120,2016-12-13,ORL,ATL
18,Home,W 131-115 ,240,46,92,.500,31,49,.633,15,43,.349,24,30,.800,131,43,101,.426,36,71,.507,7,30,.233,22,27,.815,115,2016-12-26,HOU,PHO
19,@,W 131-123 ,240,54,95,.568,38,63,.603,16,32,.500,7,10,.700,131,52,93,.559,36,55,.655,16,38,.421,3,5,.600,123,2017-02-10,DEN,NYK
20,@,W 131-127 ,240,41,90,.456,34,72,.472,7,18,.389,42,53,.792,131,44,88,.500,31,61,.508,13,27,.481,26,33,.788,127,2017-03-07,WAS,PHO
21,Home,W 130-102 ,240,51,84,.607,42,64,.656,9,20,.450,19,23,.826,130,39,85,.459,32,64,.500,7,21,.333,17,19,.895,102,2013-03-01,SAS,SAC
22,Home,W 130-98 ,240,46,83,.554,29,60,.483,17,23,.739,21,24,.875,130,39,93,.419,35,82,.427,4,11,.364,16,19,.842,98,2013-12-06,POR,UTA
23,Home,W 130-94 ,240,47,78,.603,26,43,.605,21,35,.600,15,26,.577,130,37,90,.411,29,60,.483,8,30,.267,12,20,.600,94,2013-12-16,BRK,PHI
24,@,W 130-110 ,240,48,84,.571,36,64,.563,12,20,.600,22,29,.759,130,43,88,.489,35,64,.547,8,24,.333,16,23,.696,110,2014-02-24,MIL,PHI
25,Home,W 130-102 ,240,52,90,.578,35,57,.614,17,33,.515,9,9,1.000,130,39,86,.453,35,73,.479,4,13,.308,20,28,.714,102,2014-04-06,GSW,UTA
26,Home,W 130-125 (OT),265,45,98,.459,32,62,.516,13,36,.361,27,40,.675,130,51,107,.477,37,76,.487,14,31,.452,9,13,.692,125,2014-04-06,HOU,DEN
27,Home,L 130-145 ,240,44,95,.463,30,63,.476,14,32,.438,28,35,.800,130,56,97,.577,45,71,.634,11,26,.423,22,28,.786,145,2014-04-08,LAL,HOU
28,Home,W 130-120 ,240,49,101,.485,34,64,.531,15,37,.405,17,19,.895,130,43,81,.531,35,66,.530,8,15,.533,26,33,.788,120,2014-04-14,GSW,MIN
29,Home,L 130-136 (2OT),290,40,97,.412,32,72,.444,8,25,.320,42,54,.778,130,53,108,.491,47,84,.560,6,24,.250,24,29,.828,136,2014-04-16,MIN,UTA
30,@,W 130-113 ,240,45,88,.511,29,55,.527,16,33,.485,24,29,.828,130,39,90,.433,31,67,.463,8,23,.348,27,33,.818,113,2014-11-12,POR,DEN
31,Home,W 130-105 ,240,53,88,.602,33,52,.635,20,36,.556,4,7,.571,130,39,81,.481,31,61,.508,8,20,.400,19,20,.950,105,2015-03-09,ATL,SAC
32,Home,W 130-91 ,240,51,88,.580,38,67,.567,13,21,.619,15,19,.789,130,36,90,.400,30,72,.417,6,18,.333,13,14,.929,91,2015-03-25,SAS,OKC
33,Home,W 130-105 ,240,47,91,.516,33,68,.485,14,23,.609,22,23,.957,130,44,90,.489,30,60,.500,14,30,.467,3,8,.375,105,2015-11-03,CHO,CHI
34,@,W 130-125 ,240,44,78,.564,33,54,.611,11,24,.458,31,39,.795,130,45,96,.469,28,61,.459,17,35,.486,18,22,.818,125,2015-12-20,NOP,DEN
35,Home,W 130-99 ,240,49,81,.605,37,58,.638,12,23,.522,20,25,.800,130,41,89,.461,32,66,.485,9,23,.391,8,17,.471,99,2016-01-02,LAC,PHI
36,Home,W 130-99 ,240,50,90,.556,38,67,.567,12,23,.522,18,21,.857,130,28,73,.384,20,43,.465,8,30,.267,35,52,.673,99,2016-01-27,SAS,HOU
37,@,W 130-114 ,240,53,88,.602,40,63,.635,13,25,.520,11,16,.688,130,41,90,.456,31,64,.484,10,26,.385,22,28,.786,114,2016-02-25,GSW,ORL
38,Home,W 130-116 ,240,49,86,.570,39,70,.557,10,16,.625,22,25,.880,130,41,77,.532,36,55,.655,5,22,.227,29,37,.784,116,2016-02-28,ORL,PHI
39,Home,W 130-81 ,240,46,85,.541,30,52,.577,16,33,.485,22,34,.647,130,30,101,.297,26,84,.310,4,17,.235,17,28,.607,81,2016-03-14,HOU,MEM
40,@,W 130-109 ,240,47,96,.490,35,67,.522,12,29,.414,24,30,.800,130,40,93,.430,35,74,.473,5,19,.263,24,27,.889,109,2016-03-16,OKC,BOS
41,@,W 130-112 ,240,48,95,.505,26,57,.456,22,38,.579,12,14,.857,130,41,93,.441,32,64,.500,9,29,.310,21,22,.955,112,2016-03-18,GSW,DAL
42,Home,W 130-110 ,240,50,98,.510,33,57,.579,17,41,.415,13,18,.722,130,41,83,.494,29,55,.527,12,28,.429,16,19,.842,110,2016-04-10,HOU,LAL
43,Home,W 130-121 (OT),265,47,93,.505,37,74,.500,10,19,.526,26,34,.765,130,45,104,.433,27,56,.482,18,48,.375,13,18,.722,121,2016-10-26,IND,DAL
44,@,W 130-114 ,240,46,82,.561,29,46,.630,17,36,.472,21,28,.750,130,40,83,.482,28,50,.560,12,33,.364,22,29,.759,114,2016-11-27,HOU,POR
45,Home,W 130-101 ,240,50,94,.532,36,68,.529,14,26,.538,16,18,.889,130,36,87,.414,29,60,.483,7,27,.259,22,25,.880,101,2016-12-10,SAS,BRK
46,Home,L 130-136 (2OT),290,50,108,.463,38,78,.487,12,30,.400,18,26,.692,130,52,105,.495,41,83,.494,11,22,.500,21,31,.677,136,2016-12-20,MIA,ORL
47,@,W 130-114 ,240,46,87,.529,33,56,.589,13,31,.419,25,35,.714,130,40,83,.482,34,59,.576,6,24,.250,28,36,.778,114,2017-02-11,GSW,OKC
48,@,L 130-142 ,240,49,94,.521,40,68,.588,9,26,.346,23,28,.821,130,44,94,.468,22,36,.611,22,58,.379,32,42,.762,142,2017-02-25,MIN,HOU
49,Home,W 130-112 ,240,48,86,.558,36,61,.590,12,25,.480,22,29,.759,130,43,83,.518,36,62,.581,7,21,.333,19,24,.792,112,2017-02-28,MEM,PHO
50,Home,L 130-135 ,240,49,91,.538,39,65,.600,10,26,.385,22,30,.733,130,47,86,.547,22,40,.550,25,46,.543,16,20,.800,135,2017-03-03,ATL,CLE
51,Home,W 130-116 ,240,49,86,.570,33,61,.541,16,25,.640,16,22,.727,130,45,86,.523,31,56,.554,14,30,.467,12,17,.706,116,2017-03-04,POR,BRK
52,Home,W 129-90 ,240,48,80,.600,41,69,.594,7,11,.636,26,31,.839,129,35,92,.380,29,74,.392,6,18,.333,14,21,.667,90,2012-01-01,MIA,CHA
53,Home,W 129-91 ,240,47,84,.560,27,54,.500,20,30,.667,15,19,.789,129,34,74,.459,29,60,.483,5,14,.357,18,29,.621,91,2012-12-23,SAS,DAL
54,@,L 129-141 (2OT),290,48,93,.516,34,66,.515,14,27,.519,19,26,.731,129,56,101,.554,46,78,.590,10,23,.435,19,24,.792,141,2013-02-26,SAC,MIA
55,Home,W 129-97 ,240,50,80,.625,36,52,.692,14,28,.500,15,25,.600,129,30,64,.469,19,41,.463,11,23,.478,26,42,.619,97,2013-03-10,LAC,DET
56,Home,W 129-98 ,240,43,83,.518,29,52,.558,14,31,.452,29,38,.763,129,35,91,.385,31,73,.425,4,18,.222,24,32,.750,98,2014-01-07,DEN,BOS
57,Home,W 129-127 ,240,42,83,.506,25,49,.510,17,34,.500,28,37,.757,129,51,97,.526,39,72,.542,12,25,.480,13,21,.619,127,2014-01-15,LAC,DAL
58,Home,W 129-121 (2OT),290,49,99,.495,40,83,.482,9,16,.563,22,26,.846,129,45,95,.474,30,61,.492,15,34,.441,16,23,.696,121,2014-02-21,ORL,NYK
59,@,W 129-103 ,240,41,72,.569,30,50,.600,11,22,.500,36,42,.857,129,36,90,.400,31,72,.431,5,18,.278,26,31,.839,103,2014-02-25,HOU,SAC
60,Home,L 129-134 (3OT),315,45,100,.450,33,70,.471,12,30,.400,27,36,.750,129,51,108,.472,46,86,.535,5,22,.227,27,37,.730,134,2014-02-27,TOR,WAS
61,Home,W 129-120 ,240,44,80,.550,29,56,.518,15,24,.625,26,30,.867,129,44,84,.524,30,53,.566,14,31,.452,18,26,.692,120,2014-03-02,PHO,ATL
62,Home,W 129-106 ,240,49,85,.576,33,47,.702,16,38,.421,15,19,.789,129,38,87,.437,26,59,.441,12,28,.429,18,23,.783,106,2014-03-20,HOU,MIN
63,Home,W 129-122 (OT),265,47,96,.490,37,72,.514,10,24,.417,25,34,.735,129,45,104,.433,36,70,.514,9,34,.265,23,31,.742,122,2014-11-30,LAL,TOR
64,Home,L 129-132 (2OT),290,47,103,.456,39,77,.506,8,26,.308,27,34,.794,129,47,102,.461,32,72,.444,15,30,.500,23,27,.852,132,2014-12-02,CHI,DAL
65,@,W 129-119 (3OT),315,47,110,.427,34,75,.453,13,35,.371,22,23,.957,129,45,109,.413,37,89,.416,8,20,.400,21,26,.808,119,2014-12-19,POR,SAS
66,Home,W 129-120 ,240,40,74,.541,34,62,.548,6,12,.500,43,47,.915,129,44,100,.440,35,70,.500,9,30,.300,23,32,.719,120,2014-12-22,CHI,TOR
67,@,L 129-135 (OT),265,48,97,.495,42,77,.545,6,20,.300,27,32,.844,129,49,89,.551,41,73,.562,8,16,.500,29,33,.879,135,2014-12-27,NYK,SAC
68,Home,W 129-90 ,240,46,89,.517,31,61,.508,15,28,.536,22,28,.786,129,36,89,.404,34,73,.466,2,16,.125,16,24,.667,90,2015-01-23,CLE,CHO
69,Home,W 129-99 ,240,51,84,.607,35,56,.625,16,28,.571,11,16,.688,129,41,82,.500,29,50,.580,12,32,.375,5,12,.417,99,2015-03-13,DAL,LAC
70,Home,W 129-127 (3OT),315,46,107,.430,35,82,.427,11,25,.440,26,34,.765,129,49,129,.380,41,113,.363,8,16,.500,21,29,.724,127,2015-03-20,BRK,MIL
71,@,W 129-116 ,240,48,89,.539,30,51,.588,18,38,.474,15,16,.938,129,43,87,.494,40,78,.513,3,9,.333,27,36,.750,116,2015-11-12,GSW,MIN
72,@,W 129-118 ,240,44,77,.571,34,54,.630,10,23,.435,31,37,.838,129,42,88,.477,29,57,.509,13,31,.419,21,27,.778,118,2015-11-25,SAC,MIL
73,Home,W 129-126 ,240,46,91,.505,36,65,.554,10,26,.385,27,38,.711,129,48,82,.585,39,62,.629,9,20,.450,21,30,.700,126,2016-01-17,DEN,IND
74,@,W 129-128 (2OT),290,44,110,.400,24,66,.364,20,44,.455,21,26,.808,129,48,91,.527,41,68,.603,7,23,.304,25,32,.781,128,2016-01-25,CHO,SAC
75,Home,W 129-103 ,240,41,85,.482,28,51,.549,13,34,.382,34,36,.944,129,37,77,.481,25,49,.510,12,28,.429,17,27,.630,103,2016-02-21,DAL,PHI
76,Home,W 129-111 ,240,52,77,.675,46,65,.708,6,12,.500,19,25,.760,129,41,90,.456,30,67,.448,11,23,.478,18,26,.692,111,2016-03-01,MIA,CHI
77,Home,L 129-132 (2OT),290,50,100,.500,37,71,.521,13,29,.448,16,23,.696,129,51,96,.531,43,70,.614,8,26,.308,22,22,1.000,132,2016-03-25,WAS,MIN
78,Home,W 129-105 ,240,48,86,.558,37,59,.627,11,27,.407,22,27,.815,129,35,91,.385,21,54,.389,14,37,.378,21,26,.808,105,2016-04-10,IND,BRK
79,@,W 129-105 ,240,48,86,.558,33,56,.589,15,30,.500,18,26,.692,129,38,83,.458,33,62,.532,5,21,.238,24,33,.727,105,2016-04-11,HOU,MIN
80,@,W 129-100 ,240,47,98,.480,35,74,.473,12,24,.500,23,26,.885,129,40,85,.471,33,52,.635,7,33,.212,13,18,.722,100,2016-10-25,SAS,GSW
81,@,W 129-109 ,240,49,85,.576,34,49,.694,15,36,.417,16,21,.762,129,37,93,.398,27,58,.466,10,35,.286,25,31,.806,109,2016-11-20,POR,BRK
82,Home,L 129-132 (OT),265,48,101,.475,36,67,.537,12,34,.353,21,27,.778,129,48,95,.505,35,69,.507,13,26,.500,23,29,.793,132,2016-11-25,DEN,OKC
83,Home,W 129-122 ,240,42,92,.457,21,37,.568,21,55,.382,24,29,.828,129,47,105,.448,37,73,.507,10,32,.313,18,25,.720,122,2016-12-31,HOU,NYK
84,@,W 129-122 ,240,46,89,.517,35,51,.686,11,38,.289,26,31,.839,129,42,78,.538,31,53,.585,11,25,.440,27,30,.900,122,2017-01-08,HOU,TOR
85,Home,W 129-109 ,240,47,92,.511,38,72,.528,9,20,.450,26,32,.813,129,41,85,.482,34,64,.531,7,21,.333,20,25,.800,109,2017-01-28,MIN,BRK
86,@,W 129-125 ,240,50,88,.568,43,73,.589,7,15,.467,22,32,.688,129,46,88,.523,32,52,.615,14,36,.389,19,23,.826,125,2017-02-15,MIL,BRK
87,@,W 129-99 ,240,45,91,.495,25,40,.625,20,51,.392,19,24,.792,129,36,86,.419,30,55,.545,6,31,.194,21,26,.808,99,2017-02-23,HOU,NOP
88,Home,W 129-109 ,240,49,97,.505,35,66,.530,14,31,.452,17,24,.708,129,41,83,.494,31,53,.585,10,30,.333,17,31,.548,109,2017-02-24,DEN,BRK
89,Home,W 128-95 ,240,50,92,.543,42,76,.553,8,16,.500,20,27,.741,128,36,87,.414,30,68,.441,6,19,.316,17,22,.773,95,2012-01-21,MEM,SAC
90,Home,W 128-103 ,240,51,84,.607,42,66,.636,9,18,.500,17,21,.810,128,36,77,.468,31,65,.477,5,12,.417,26,35,.743,103,2012-04-06,SAS,NOH
91,@,W 128-99 ,240,45,80,.563,28,43,.651,17,37,.459,21,24,.875,128,38,87,.437,29,69,.420,9,18,.500,14,19,.737,99,2013-01-12,MIA,SAC
92,Home,W 128-96 ,240,50,86,.581,41,67,.612,9,19,.474,19,23,.826,128,38,91,.418,28,64,.438,10,27,.370,10,14,.714,96,2013-02-07,DEN,CHI
93,Home,L 128-131 (3OT),315,48,101,.475,40,78,.513,8,23,.348,24,34,.706,128,50,113,.442,39,90,.433,11,23,.478,20,27,.741,131,2013-12-02,CHI,NOP
94,@,W 128-125 (3OT),315,48,113,.425,36,80,.450,12,33,.364,20,23,.870,128,53,104,.510,47,78,.603,6,26,.231,13,16,.813,125,2014-01-15,CHI,ORL
95,Home,L 128-132 ,240,50,95,.526,38,62,.613,12,33,.364,16,25,.640,128,38,80,.475,34,64,.531,4,16,.250,52,64,.813,132,2014-03-03,DEN,MIN
96,Home,W 128-122 ,240,42,80,.525,27,53,.509,15,27,.556,29,39,.744,128,45,90,.500,32,57,.561,13,33,.394,19,19,1.000,122,2014-03-06,PHO,OKC
97,Home,W 128-119 (OT),265,45,90,.500,30,52,.577,15,38,.395,23,28,.821,128,46,93,.495,34,60,.567,12,33,.364,15,19,.789,119,2014-03-25,DAL,OKC
98,@,W 128-122 (OT),265,44,86,.512,33,62,.532,11,24,.458,29,35,.829,128,47,101,.465,39,74,.527,8,27,.296,20,25,.800,122,2014-12-14,GSW,NOP
99,Home,W 128-108 ,240,49,91,.538,40,66,.606,9,25,.360,21,24,.875,128,43,90,.478,35,73,.479,8,17,.471,14,21,.667,108,2014-12-22,GSW,SAC
0,Home,W 128-118 ,240,49,94,.521,39,70,.557,10,24,.417,20,24,.833,128,48,97,.495,42,82,.512,6,15,.400,16,16,1.000,118,2015-01-21,DET,ORL
1,Home,W 128-114 ,240,45,86,.523,26,48,.542,19,38,.500,19,25,.760,128,41,98,.418,31,68,.456,10,30,.333,22,28,.786,114,2015-02-04,GSW,DAL
2,@,W 128-125 (OT),265,44,91,.484,30,65,.462,14,26,.538,26,30,.867,128,49,87,.563,41,61,.672,8,26,.308,19,27,.704,125,2015-03-12,CLE,SAS
3,Home,W 128-103 ,240,46,88,.523,31,56,.554,15,32,.469,21,27,.778,128,41,91,.451,36,69,.522,5,22,.227,16,18,.889,103,2015-12-16,GSW,PHO
4,@,W 128-108 ,240,46,87,.529,28,55,.509,18,32,.563,18,21,.857,128,38,96,.396,26,63,.413,12,33,.364,20,28,.714,108,2016-01-08,GSW,POR
5,@,W 128-116 ,240,49,87,.563,30,50,.600,19,37,.514,11,15,.733,128,43,92,.467,35,69,.507,8,23,.348,22,29,.759,116,2016-01-09,GSW,SAC
6,Home,L 128-129 (2OT),290,48,91,.527,41,68,.603,7,23,.304,25,32,.781,128,44,110,.400,24,66,.364,20,44,.455,21,26,.808,129,2016-01-25,SAC,CHO
7,@,W 128-122 (OT),265,46,99,.465,35,79,.443,11,20,.550,25,29,.862,128,44,95,.463,33,72,.458,11,23,.478,23,30,.767,122,2016-01-26,OKC,NYK
8,Home,W 128-119 ,240,48,86,.558,30,58,.517,18,28,.643,14,15,.933,128,45,89,.506,37,63,.587,8,26,.308,21,22,.955,119,2016-02-05,BRK,SAC
9,Home,W 128-119 ,240,51,91,.560,38,67,.567,13,24,.542,13,15,.867,128,47,95,.495,37,69,.536,10,26,.385,15,19,.789,119,2016-02-07,BOS,SAC
10,Home,W 128-119 ,240,48,85,.565,35,58,.603,13,27,.481,19,29,.655,128,39,88,.443,22,49,.449,17,39,.436,24,33,.727,119,2016-02-24,MEM,LAL
11,Home,W 128-101 ,240,47,89,.528,34,53,.642,13,36,.361,21,21,1.000,128,34,90,.378,27,67,.403,7,23,.304,26,37,.703,101,2016-02-28,DAL,MIN
12,Home,W 128-121 ,240,48,81,.593,40,66,.606,8,15,.533,24,33,.727,128,41,87,.471,26,51,.510,15,36,.417,24,35,.686,121,2016-02-29,MIL,HOU
13,@,W 128-97 ,240,46,82,.561,30,58,.517,16,24,.667,20,24,.833,128,39,89,.438,30,60,.500,9,29,.310,10,15,.667,97,2016-03-09,NYK,PHO
14,Home,W 128-112 ,240,40,89,.449,22,49,.449,18,40,.450,30,39,.769,128,37,86,.430,18,50,.360,19,36,.528,19,23,.826,112,2016-03-11,GSW,POR
15,Home,W 128-94 ,240,49,83,.590,40,66,.606,9,17,.529,21,26,.808,128,31,91,.341,24,64,.375,7,27,.259,25,27,.926,94,2016-03-14,OKC,POR
16,Home,W 128-120 ,240,43,88,.489,22,43,.512,21,45,.467,21,23,.913,128,43,96,.448,25,61,.410,18,35,.514,16,21,.762,120,2016-03-25,GSW,DAL
17,Home,W 128-120 ,240,43,83,.518,27,51,.529,16,32,.500,26,31,.839,128,43,90,.478,26,46,.565,17,44,.386,17,25,.680,120,2016-11-01,CLE,HOU
18,Home,W 128-122 ,240,41,84,.488,27,50,.540,14,34,.412,32,37,.865,128,46,96,.479,35,64,.547,11,32,.344,19,22,.864,122,2016-11-03,CLE,BOS
19,Home,W 128-90 ,240,43,85,.506,23,42,.548,20,43,.465,22,24,.917,128,37,91,.407,29,56,.518,8,35,.229,8,12,.667,90,2016-11-25,CLE,DAL
20,@,W 128-110 ,240,45,88,.511,28,51,.549,17,37,.459,21,25,.840,128,46,104,.442,37,73,.507,9,31,.290,9,16,.563,110,2016-12-02,HOU,DEN
21,Home,W 128-84 ,240,53,92,.576,40,68,.588,13,24,.542,9,11,.818,128,35,88,.398,28,60,.467,7,28,.250,7,14,.500,84,2016-12-03,TOR,ATL
22,@,W 128-119 (OT),265,50,103,.485,37,70,.529,13,33,.394,15,19,.789,128,41,83,.494,33,53,.623,8,30,.267,29,39,.744,119,2017-01-06,MEM,GSW
23,Home,W 128-98 ,240,50,89,.562,34,55,.618,16,34,.471,12,15,.800,128,38,87,.437,29,62,.468,9,25,.360,13,18,.722,98,2017-01-27,BOS,ORL
24,@,W 128-100 ,240,49,81,.605,43,66,.652,6,15,.400,24,30,.800,128,38,100,.380,28,63,.444,10,37,.270,14,17,.824,100,2017-02-01,CHI,OKC
25,Home,W 128-104 ,240,44,89,.494,28,51,.549,16,38,.421,24,36,.667,128,42,88,.477,36,63,.571,6,25,.240,14,20,.700,104,2017-02-07,HOU,ORL
26,Home,W 128-121 (OT),265,46,98,.469,34,72,.472,12,26,.462,24,31,.774,128,49,93,.527,41,69,.594,8,24,.333,15,25,.600,121,2017-02-24,CHI,PHO
27,@,W 127-124 ,240,50,89,.562,36,67,.537,14,22,.636,13,21,.619,127,46,89,.517,37,68,.544,9,21,.429,23,29,.793,124,2012-03-12,MIN,PHO
28,@,W 127-102 ,240,47,80,.588,39,59,.661,8,21,.381,25,31,.806,127,41,92,.446,35,71,.493,6,21,.286,14,20,.700,102,2012-04-18,SAS,SAC
29,@,L 127-131 ,240,46,92,.500,33,66,.500,13,26,.500,22,25,.880,127,43,86,.500,32,67,.478,11,19,.579,34,42,.810,131,2012-12-19,GSW,SAC
30,Home,W 127-96 ,240,50,87,.575,36,66,.545,14,21,.667,13,18,.722,127,39,83,.470,32,65,.492,7,18,.389,11,15,.733,96,2013-02-08,OKC,PHO
31,Home,W 127-111 ,240,48,83,.578,39,69,.565,9,14,.643,22,22,1.000,127,41,85,.482,35,68,.515,6,17,.353,23,29,.793,111,2013-02-22,OKC,MIN
32,Home,W 127-105 ,240,48,93,.516,34,72,.472,14,21,.667,17,20,.850,127,42,88,.477,36,67,.537,6,21,.286,15,20,.750,105,2013-03-16,WAS,PHO
33,@,W 127-113 ,240,51,89,.573,38,67,.567,13,22,.591,12,14,.857,127,42,75,.560,34,54,.630,8,21,.381,21,29,.724,113,2013-03-18,DAL,ATL
34,Home,W 127-125 (2OT),290,46,102,.451,33,71,.465,13,31,.419,22,29,.759,127,47,99,.475,36,72,.500,11,27,.407,20,23,.870,125,2013-11-09,CLE,PHI
35,@,W 127-125 (2OT),290,51,103,.495,40,69,.580,11,34,.324,14,19,.737,127,49,94,.521,41,73,.562,8,21,.381,19,26,.731,125,2013-12-26,ATL,CLE
36,@,L 127-129 ,240,51,97,.526,39,72,.542,12,25,.480,13,21,.619,127,42,83,.506,25,49,.510,17,34,.500,28,37,.757,129,2014-01-15,DAL,LAC
37,@,W 127-110 ,240,53,91,.582,37,64,.578,16,27,.593,5,7,.714,127,40,81,.494,32,56,.571,8,25,.320,22,22,1.000,110,2014-01-16,BRK,ATL
38,Home,W 127-121 ,240,47,81,.580,38,59,.644,9,22,.409,24,33,.727,127,43,82,.524,27,55,.491,16,27,.593,19,34,.559,121,2014-01-17,OKC,GSW
39,@,W 127-111 ,240,46,90,.511,37,64,.578,9,26,.346,26,28,.929,127,42,90,.467,35,72,.486,7,18,.389,20,25,.800,111,2014-01-18,POR,DAL
40,@,W 127-120 ,240,46,80,.575,34,53,.642,12,27,.444,23,29,.793,127,40,91,.440,32,68,.471,8,23,.348,32,37,.865,120,2014-03-23,PHO,MIN
41,Home,W 127-96 ,240,48,83,.578,30,55,.545,18,28,.643,13,15,.867,127,36,74,.486,32,59,.542,4,15,.267,20,27,.741,96,2014-03-25,LAL,NYK
42,Home,W 127-104 ,240,46,83,.554,35,60,.583,11,23,.478,24,28,.857,127,41,88,.466,37,74,.500,4,14,.286,18,25,.720,104,2014-11-01,GSW,LAL
43,Home,W 127-94 ,240,49,90,.544,30,59,.508,19,31,.613,10,13,.769,127,40,90,.444,37,68,.544,3,22,.136,11,13,.846,94,2014-11-15,CLE,ATL
44,Home,W 127-101 ,240,41,80,.513,26,46,.565,15,34,.441,30,36,.833,127,35,82,.427,33,70,.471,2,12,.167,29,40,.725,101,2014-12-01,LAC,MIN
45,@,W 127-98 ,240,49,76,.645,33,48,.688,16,28,.571,13,16,.813,127,37,82,.451,29,52,.558,8,30,.267,16,21,.762,98,2014-12-17,ATL,CLE
46,Home,W 127-91 ,240,46,85,.541,31,48,.646,15,37,.405,20,26,.769,127,32,79,.405,23,54,.426,9,25,.360,18,26,.692,91,2015-01-03,LAC,PHI
47,Home,W 127-115 ,240,51,97,.526,41,75,.547,10,22,.455,15,19,.789,127,42,92,.457,33,68,.485,9,24,.375,22,28,.786,115,2015-01-16,OKC,GSW
48,@,W 127-99 ,240,48,83,.578,39,58,.672,9,25,.360,22,32,.688,127,35,88,.398,27,65,.415,8,23,.348,21,27,.778,99,2015-01-18,OKC,ORL
49,@,W 127-122 (OT),265,47,92,.511,40,66,.606,7,26,.269,26,30,.867,127,49,101,.485,45,82,.549,4,19,.211,20,26,.769,122,2015-01-30,TOR,BRK
50,@,W 127-118 ,240,48,95,.505,33,58,.569,15,37,.405,16,23,.696,127,41,87,.471,29,61,.475,12,26,.462,24,30,.800,118,2015-02-10,HOU,PHO
51,@,W 127-89 ,240,46,90,.511,32,57,.561,14,33,.424,21,28,.750,127,38,86,.442,37,70,.529,1,16,.063,12,16,.750,89,2015-02-20,CLE,WAS
52,@,W 127-94 ,240,44,87,.506,29,55,.527,15,32,.469,24,29,.828,127,33,81,.407,28,61,.459,5,20,.250,23,33,.697,94,2015-03-10,CLE,DAL
53,@,L 127-129 (3OT),315,49,129,.380,41,113,.363,8,16,.500,21,29,.724,127,46,107,.430,35,82,.427,11,25,.440,26,34,.765,129,2015-03-20,MIL,BRK
54,Home,W 127-117 ,240,48,86,.558,37,65,.569,11,21,.524,20,23,.870,127,44,85,.518,35,66,.530,9,19,.474,20,27,.741,117,2015-03-24,OKC,LAL
55,Home,W 127-122 (OT),265,49,98,.500,40,69,.580,9,29,.310,20,26,.769,127,52,104,.500,44,73,.603,8,31,.258,10,16,.625,122,2015-11-23,CHO,SAC
56,Home,W 127-122 (OT),265,44,87,.506,32,60,.533,12,27,.444,27,44,.614,127,47,97,.485,33,64,.516,14,33,.424,14,15,.933,122,2015-12-02,DET,PHO
57,Home,W 127-106 ,240,48,78,.615,38,57,.667,10,21,.476,21,24,.875,127,39,75,.520,27,49,.551,12,26,.462,16,24,.667,106,2015-12-16,ATL,PHI
58,Home,W 127-107 ,240,47,81,.580,33,52,.635,14,29,.483,19,21,.905,127,44,87,.506,33,56,.589,11,31,.355,8,12,.667,107,2016-01-27,GSW,DAL
59,@,W 127-104 ,240,50,89,.562,40,63,.635,10,26,.385,17,23,.739,127,37,86,.430,23,47,.489,14,39,.359,16,21,.762,104,2016-11-01,GSW,POR
60,Home,W 127-95 ,240,48,90,.533,34,65,.523,14,25,.560,17,21,.810,127,34,77,.442,24,44,.545,10,33,.303,17,22,.773,95,2016-11-14,LAC,BRK
61,@,W 127-121 ,240,44,87,.506,31,51,.608,13,36,.361,26,28,.929,127,37,82,.451,27,57,.474,10,25,.400,37,41,.902,121,2016-11-16,GSW,TOR
62,Home,W 127-122 (2OT),290,45,104,.433,32,66,.485,13,38,.342,24,36,.667,127,46,109,.422,33,69,.478,13,40,.325,17,22,.773,122,2016-11-29,BRK,LAC
63,Home,L 127-132 (2OT),290,43,104,.413,31,60,.517,12,44,.273,29,37,.784,127,48,108,.444,34,64,.531,14,44,.318,22,30,.733,132,2016-12-01,GSW,HOU
64,Home,W 127-114 ,240,50,90,.556,40,63,.635,10,27,.370,17,29,.586,127,35,80,.438,27,57,.474,8,23,.348,36,39,.923,114,2016-12-17,DEN,NYK
65,Home,W 127-119 ,240,50,95,.526,39,70,.557,11,25,.440,16,21,.762,127,48,101,.475,39,66,.591,9,35,.257,14,18,.778,119,2017-01-02,GSW,DEN
66,@,W 127-99 ,240,51,90,.567,39,66,.591,12,24,.500,13,17,.765,127,39,86,.453,32,61,.525,7,25,.280,14,17,.824,99,2017-01-05,SAS,DEN
67,Home,W 127-100 ,240,48,96,.500,38,68,.559,10,28,.357,21,29,.724,127,38,92,.413,30,60,.500,8,32,.250,16,27,.593,100,2017-01-06,LAL,MIA
68,Home,W 127-107 ,240,50,89,.562,35,60,.583,15,29,.517,12,18,.667,127,43,88,.489,37,60,.617,6,28,.214,15,20,.750,107,2017-01-12,GSW,DET
69,@,W 127-121 ,240,50,88,.568,39,62,.629,11,26,.423,16,26,.615,127,47,108,.435,36,78,.462,11,30,.367,16,18,.889,121,2017-01-17,DEN,LAL
70,@,W 127-123 (OT),265,43,92,.467,33,67,.493,10,25,.400,31,36,.861,127,42,92,.457,29,57,.509,13,35,.371,26,31,.839,123,2017-01-21,POR,BOS
71,Home,W 127-114 ,240,47,80,.588,36,57,.632,11,23,.478,22,27,.815,127,39,77,.506,25,42,.595,14,35,.400,22,28,.786,114,2017-01-23,MIL,HOU
72,Home,W 127-120 ,240,44,86,.512,35,63,.556,9,23,.391,30,35,.857,127,48,89,.539,38,65,.585,10,24,.417,14,17,.824,120,2017-01-26,DEN,PHO
73,@,W 127-94 ,240,48,88,.545,34,56,.607,14,32,.438,17,21,.810,127,35,77,.455,30,53,.566,5,24,.208,19,25,.760,94,2017-02-08,UTA,NOP
74,Home,L 127-131 ,240,44,88,.500,31,61,.508,13,27,.481,26,33,.788,127,41,90,.456,34,72,.472,7,18,.389,42,53,.792,131,2017-03-07,PHO,WAS
75,Home,W 126-99 ,240,49,80,.613,33,55,.600,16,25,.640,12,15,.800,126,39,91,.429,36,74,.486,3,17,.176,18,24,.750,99,2012-11-03,DAL,CHA
76,Home,W 126-100 ,240,47,88,.534,31,61,.508,16,27,.593,16,20,.800,126,39,78,.500,35,67,.522,4,11,.364,18,26,.692,100,2012-11-17,SAS,DEN
77,Home,L 126-134 (OT),265,41,97,.423,25,67,.373,16,30,.533,28,36,.778,126,48,92,.522,34,62,.548,14,30,.467,24,26,.923,134,2012-12-10,HOU,SAS
78,Home,W 126-119 (2OT),290,46,98,.469,35,65,.538,11,33,.333,23,31,.742,126,48,109,.440,34,82,.415,14,27,.519,9,15,.600,119,2012-12-26,ATL,DET
79,Home,W 126-114 ,240,45,94,.479,33,72,.458,12,22,.545,24,32,.750,126,41,83,.494,30,54,.556,11,29,.379,21,30,.700,114,2012-12-26,DEN,LAL
80,Home,W 126-101 ,240,52,93,.559,43,72,.597,9,21,.429,13,18,.722,126,35,77,.455,28,60,.467,7,17,.412,24,25,.960,101,2013-04-03,LAC,PHO
81,Home,W 126-115 ,240,42,85,.494,33,57,.579,9,28,.321,33,50,.660,126,40,76,.526,28,55,.509,12,21,.571,23,33,.697,115,2013-10-31,LAC,GSW
82,Home,W 126-96 ,240,46,80,.575,30,56,.536,16,24,.667,18,23,.783,126,39,83,.470,35,70,.500,4,13,.308,14,20,.700,96,2013-11-23,SAS,CLE
83,Home,W 126-125 (2OT),290,46,96,.479,35,67,.522,11,29,.379,23,33,.697,126,47,94,.500,41,68,.603,6,26,.231,25,32,.781,125,2013-12-03,PHI,ORL
84,@,W 126-95 ,240,46,100,.460,30,74,.405,16,26,.615,18,23,.783,126,38,80,.475,30,62,.484,8,18,.444,11,16,.688,95,2014-01-06,MIN,PHI
85,Home,W 126-113 ,240,45,86,.523,29,53,.547,16,33,.485,20,24,.833,126,44,97,.454,36,72,.500,8,25,.320,17,22,.773,113,2014-01-20,HOU,POR
86,@,W 126-118 ,240,46,84,.548,34,62,.548,12,22,.545,22,25,.880,126,36,74,.486,22,45,.489,14,29,.483,32,38,.842,118,2014-01-25,LAC,TOR
87,@,W 126-117 ,240,42,78,.538,30,55,.545,12,23,.522,30,32,.938,126,38,89,.427,31,70,.443,7,19,.368,34,36,.944,117,2014-01-29,PHO,MIL
88,Home,W 126-109 ,240,50,98,.510,42,78,.538,8,20,.400,18,23,.783,126,41,88,.466,26,55,.473,15,33,.455,12,22,.545,109,2014-02-08,DET,DEN
89,Home,W 126-122 ,240,48,80,.600,29,53,.547,19,27,.704,11,16,.688,126,47,93,.505,42,78,.538,5,15,.333,23,32,.719,122,2014-02-28,LAL,SAC
90,@,W 126-103 ,240,44,92,.478,30,57,.526,14,35,.400,24,31,.774,126,36,95,.379,26,70,.371,10,25,.400,21,23,.913,103,2014-02-28,GSW,NYK
91,@,L 126-134 ,240,45,97,.464,33,70,.471,12,27,.444,24,30,.800,126,54,99,.545,40,75,.533,14,24,.583,12,21,.571,134,2014-03-07,LAL,DEN
92,@,W 126-115 ,240,42,82,.512,28,53,.528,14,29,.483,28,33,.848,126,42,82,.512,32,58,.552,10,24,.417,21,24,.875,115,2014-11-26,TOR,ATL
93,Home,W 126-86 ,240,46,82,.561,34,54,.630,12,28,.429,22,27,.815,126,33,86,.384,27,66,.409,6,20,.300,14,23,.609,86,2014-12-30,GSW,PHI
94,Home,W 126-105 ,240,49,92,.533,37,64,.578,12,28,.429,16,20,.800,126,40,86,.465,30,61,.492,10,25,.400,15,20,.750,105,2015-01-02,GSW,TOR
95,@,W 126-121 ,240,46,83,.554,36,60,.600,10,23,.435,24,31,.774,126,43,91,.473,33,62,.532,10,29,.345,25,36,.694,121,2015-01-16,CLE,LAC
96,Home,W 126-113 ,240,49,98,.500,36,69,.522,13,29,.448,15,18,.833,126,37,87,.425,24,55,.436,13,32,.406,26,31,.839,113,2015-01-21,GSW,HOU
97,Home,W 126-101 ,240,45,94,.479,28,54,.519,17,40,.425,19,22,.864,126,34,82,.415,30,65,.462,4,17,.235,29,34,.853,101,2015-01-23,GSW,SAC
98,Home,W 126-99 ,240,46,95,.484,32,60,.533,14,35,.400,20,28,.714,126,30,88,.341,26,72,.361,4,16,.250,35,46,.761,99,2015-02-21,LAC,SAC
99,@,W 126-122 ,240,46,86,.535,31,58,.534,15,28,.536,19,24,.792,126,45,89,.506,32,64,.500,13,25,.520,19,25,.760,122,2015-04-01,LAC,POR
0,@,L 126-133 ,240,45,83,.542,39,65,.600,6,18,.333,30,36,.833,126,47,90,.522,34,62,.548,13,28,.464,26,34,.765,133,2015-04-15,DEN,GSW
1,Home,W 126-97 ,240,47,90,.522,32,57,.561,15,33,.455,17,28,.607,126,35,88,.398,25,56,.446,10,32,.313,17,20,.850,97,2015-12-12,HOU,LAL
2,@,W 126-98 ,240,49,92,.533,36,60,.600,13,32,.406,15,19,.789,126,39,86,.453,34,68,.500,5,18,.278,15,25,.600,98,2016-01-07,ATL,PHI
3,@,L 126-129 ,240,48,82,.585,39,62,.629,9,20,.450,21,30,.700,126,46,91,.505,36,65,.554,10,26,.385,27,38,.711,129,2016-01-17,IND,DEN
4,@,W 126-123 ,240,48,91,.527,38,71,.535,10,20,.500,20,21,.952,126,50,90,.556,45,76,.592,5,14,.357,18,28,.643,123,2016-01-27,OKC,MIN
5,Home,W 126-115 ,240,44,79,.557,31,60,.517,13,19,.684,25,26,.962,126,43,93,.462,36,72,.500,7,21,.333,22,33,.667,115,2016-02-21,CHI,LAL
6,Home,W 126-92 ,240,45,93,.484,32,66,.485,13,27,.481,23,27,.852,126,33,91,.363,27,64,.422,6,27,.222,20,27,.741,92,2016-03-01,CHO,PHO
7,@,W 126-99 ,240,52,94,.553,36,64,.563,16,30,.533,6,7,.857,126,39,90,.433,33,70,.471,6,20,.300,15,19,.789,99,2016-11-12,LAL,NOP
8,Home,W 126-109 ,240,46,95,.484,32,63,.508,14,32,.438,20,25,.800,126,41,90,.456,31,62,.500,10,28,.357,17,21,.810,109,2016-11-17,HOU,POR
9,Home,W 126-115 (OT),265,46,95,.484,34,65,.523,12,30,.400,22,31,.710,126,44,98,.449,34,70,.486,10,28,.357,17,26,.654,115,2016-11-30,OKC,WAS
10,@,W 126-94 ,240,39,80,.488,17,40,.425,22,40,.550,26,31,.839,126,35,87,.402,24,56,.429,11,31,.355,13,15,.867,94,2016-12-07,CLE,NYK
11,Home,W 126-121 ,240,40,72,.556,30,49,.612,10,23,.435,36,43,.837,126,44,86,.512,40,59,.678,4,27,.148,29,40,.725,121,2016-12-20,SAC,POR
12,Home,W 126-91 ,240,46,91,.505,31,57,.544,15,34,.441,19,24,.792,126,31,88,.352,22,54,.407,9,34,.265,20,27,.741,91,2017-01-16,GSW,CLE
13,Home,W 126-111 ,240,47,96,.490,26,48,.542,21,48,.438,11,14,.786,126,39,88,.443,30,57,.526,9,31,.290,24,26,.923,111,2017-02-01,GSW,CHO
14,@,W 126-121 ,240,47,85,.553,36,62,.581,11,23,.478,21,27,.778,126,44,85,.518,34,60,.567,10,25,.400,23,30,.767,121,2017-03-07,POR,OKC
15,@,W 125-104 ,240,43,84,.512,36,72,.500,7,12,.583,32,39,.821,125,40,91,.440,30,70,.429,10,21,.476,14,18,.778,104,2012-03-24,IND,MIL
16,@,W 125-90 ,240,48,81,.593,37,58,.638,11,23,.478,18,21,.857,125,34,82,.415,25,58,.431,9,24,.375,13,15,.867,90,2012-04-03,SAS,CLE
17,Home,W 125-105 ,240,47,94,.500,33,65,.508,14,29,.483,17,21,.810,125,47,97,.485,46,88,.523,1,9,.111,10,18,.556,105,2012-04-07,PHO,LAL
18,Home,W 125-107 ,240,51,85,.600,44,70,.629,7,15,.467,16,19,.842,125,41,89,.461,33,68,.485,8,21,.381,17,23,.739,107,2012-04-16,PHO,POR
19,Home,W 125-103 ,240,42,75,.560,31,48,.646,11,27,.407,30,36,.833,125,40,89,.449,34,72,.472,6,17,.353,17,24,.708,103,2012-12-19,HOU,PHI
20,Home,W 125-119 (OT),265,48,94,.511,40,70,.571,8,24,.333,21,24,.875,125,46,93,.495,35,63,.556,11,30,.367,16,18,.889,119,2013-01-07,POR,ORL
21,Home,W 125-112 ,240,48,87,.552,37,62,.597,11,25,.440,18,23,.783,125,43,91,.473,29,60,.483,14,31,.452,12,13,.923,112,2013-01-08,HOU,LAL
22,@,W 125-80 ,240,47,89,.528,31,55,.564,16,34,.471,15,18,.833,125,32,81,.395,27,63,.429,5,18,.278,11,19,.579,80,2013-01-28,HOU,UTA
23,@,W 125-101 ,240,46,89,.517,30,59,.508,16,30,.533,17,22,.773,125,38,75,.507,32,55,.582,6,20,.300,19,27,.704,101,2013-02-14,LAC,LAL
24,Home,W 125-91 ,240,42,79,.532,31,55,.564,11,24,.458,30,39,.769,125,29,86,.337,24,58,.414,5,28,.179,28,36,.778,91,2013-02-20,IND,NYK
25,@,W 125-101 ,240,46,84,.548,36,62,.581,10,22,.455,23,29,.793,125,37,83,.446,31,64,.484,6,19,.316,21,25,.840,101,2013-02-27,SAC,ORL
26,Home,W 125-118 ,240,47,82,.573,39,65,.600,8,17,.471,23,28,.821,125,41,94,.436,32,68,.471,9,26,.346,27,35,.771,118,2013-03-04,GSW,TOR
27,Home,W 125-98 ,240,47,87,.540,38,67,.567,9,20,.450,22,27,.815,125,33,86,.384,25,63,.397,8,23,.348,24,29,.828,98,2013-03-30,GSW,POR
28,@,W 125-120 ,240,46,93,.495,31,59,.525,15,34,.441,18,24,.750,125,45,78,.577,36,61,.590,9,17,.529,21,25,.840,120,2013-04-07,NYK,OKC
29,Home,W 125-94 ,240,46,86,.535,31,59,.525,15,27,.556,18,23,.783,125,35,89,.393,27,71,.380,8,18,.444,16,21,.762,94,2013-10-30,GSW,LAL
30,@,L 125-127 (2OT),290,47,99,.475,36,72,.500,11,27,.407,20,23,.870,125,46,102,.451,33,71,.465,13,31,.419,22,29,.759,127,2013-11-09,PHI,CLE
31,@,L 125-126 (2OT),290,47,94,.500,41,68,.603,6,26,.231,25,32,.781,125,46,96,.479,35,67,.522,11,29,.379,23,33,.697,126,2013-12-03,ORL,PHI
32,Home,L 125-127 (2OT),290,49,94,.521,41,73,.562,8,21,.381,19,26,.731,125,51,103,.495,40,69,.580,11,34,.324,14,19,.737,127,2013-12-26,CLE,ATL
33,Home,L 125-128 (3OT),315,53,104,.510,47,78,.603,6,26,.231,13,16,.813,125,48,113,.425,36,80,.450,12,33,.364,20,23,.870,128,2014-01-15,ORL,CHI
34,Home,W 125-96 ,240,50,90,.556,36,63,.571,14,27,.519,11,11,1.000,125,37,76,.487,27,52,.519,10,24,.417,12,14,.857,96,2014-01-24,NYK,CHA
35,@,W 125-117 ,240,42,81,.519,32,56,.571,10,25,.400,31,40,.775,125,42,81,.519,38,65,.585,4,16,.250,29,34,.853,117,2014-01-26,DEN,SAC
36,@,W 125-99 ,240,45,89,.506,37,73,.507,8,16,.500,27,34,.794,125,32,87,.368,26,65,.400,6,22,.273,29,37,.784,99,2014-01-31,ATL,PHI
37,@,W 125-118 (2OT),290,48,98,.490,39,70,.557,9,28,.321,20,25,.800,125,44,101,.436,39,85,.459,5,16,.313,25,32,.781,118,2014-02-05,SAS,WAS
38,@,W 125-117 ,240,42,81,.519,29,51,.569,13,30,.433,28,39,.718,125,43,93,.462,31,64,.484,12,29,.414,19,24,.792,117,2014-02-23,LAC,OKC
39,Home,L 125-132 ,240,46,85,.541,36,63,.571,10,22,.455,23,31,.742,125,46,77,.597,39,60,.650,7,17,.412,33,40,.825,132,2014-03-04,LAL,NOP
40,Home,W 125-92 ,240,43,76,.566,36,56,.643,7,20,.350,32,43,.744,125,32,94,.340,22,64,.344,10,30,.333,18,26,.692,92,2014-03-04,OKC,PHI
41,@,W 125-109 ,240,50,95,.526,38,68,.559,12,27,.444,13,16,.813,125,39,91,.429,30,65,.462,9,26,.346,22,29,.759,109,2014-03-19,SAS,LAL
42,@,L 125-130 (OT),265,51,107,.477,37,76,.487,14,31,.452,9,13,.692,125,45,98,.459,32,62,.516,13,36,.361,27,40,.675,130,2014-04-06,DEN,HOU
43,Home,W 125-114 ,240,41,82,.500,29,57,.509,12,25,.480,31,37,.838,125,44,85,.518,36,64,.563,8,21,.381,18,21,.857,114,2014-04-09,TOR,PHI
44,Home,W 125-102 ,240,49,84,.583,37,53,.698,12,31,.387,15,19,.789,125,42,84,.500,38,69,.551,4,15,.267,14,17,.824,102,2014-12-07,DAL,MIL
45,Home,W 125-118 ,240,49,77,.636,36,54,.667,13,23,.565,14,22,.636,125,43,86,.500,33,62,.532,10,24,.417,22,29,.759,118,2014-12-22,SAS,LAC
46,Home,W 125-104 ,240,44,84,.524,32,60,.533,12,24,.500,25,31,.806,125,39,88,.443,35,75,.467,4,13,.308,22,29,.759,104,2014-12-23,CLE,MIN
47,Home,W 125-109 ,240,48,89,.539,40,66,.606,8,23,.348,21,28,.750,125,38,83,.458,29,57,.509,9,26,.346,24,29,.828,109,2015-01-04,PHO,TOR
48,Home,L 125-128 (OT),265,49,87,.563,41,61,.672,8,26,.308,19,27,.704,125,44,91,.484,30,65,.462,14,26,.538,26,30,.867,128,2015-03-12,SAS,CLE
49,Home,W 125-94 ,240,45,90,.500,26,56,.464,19,34,.559,16,17,.941,125,38,96,.396,29,71,.408,9,25,.360,9,16,.563,94,2015-03-14,GSW,NYK
50,@,W 125-101 ,240,44,86,.512,29,63,.460,15,23,.652,22,29,.759,125,38,97,.392,33,73,.452,5,24,.208,20,26,.769,101,2015-11-10,OKC,WAS
51,@,W 125-88 ,240,47,84,.560,34,58,.586,13,26,.500,18,23,.783,125,33,81,.407,30,67,.448,3,14,.214,19,22,.864,88,2015-12-08,OKC,MEM
52,Home,L 125-130 ,240,45,96,.469,28,61,.459,17,35,.486,18,22,.818,125,44,78,.564,33,54,.611,11,24,.458,31,39,.795,130,2015-12-20,DEN,NOP
53,@,W 125-99 ,240,43,81,.531,30,54,.556,13,27,.481,26,29,.897,125,36,79,.456,29,63,.460,7,16,.438,20,26,.769,99,2016-01-08,CLE,MIN
54,@,W 125-94 ,240,50,95,.526,38,63,.603,12,32,.375,13,20,.650,125,37,100,.370,36,80,.450,1,20,.050,19,24,.792,94,2016-01-20,GSW,CHI
55,Home,W 125-109 ,240,48,88,.545,33,57,.579,15,31,.484,14,16,.875,125,43,93,.462,38,67,.567,5,26,.192,18,28,.643,109,2016-03-12,CHO,HOU
56,@,W 125-111 ,240,49,91,.538,40,73,.548,9,18,.500,18,22,.818,125,39,84,.464,29,59,.492,10,25,.400,23,27,.852,111,2016-03-12,DET,PHI
57,Home,W 125-107 ,240,47,81,.580,35,56,.625,12,25,.480,19,23,.826,125,35,93,.376,28,68,.412,7,25,.280,30,34,.882,107,2016-03-14,GSW,NOP
58,Home,W 125-104 ,240,46,87,.529,26,40,.650,20,47,.426,13,16,.813,125,42,98,.429,34,74,.459,8,24,.333,12,16,.750,104,2016-04-13,GSW,MEM
59,Home,W 125-107 ,240,47,82,.573,35,55,.636,12,27,.444,19,24,.792,125,38,81,.469,28,58,.483,10,23,.435,21,27,.778,107,2016-11-03,MIL,IND
60,@,W 125-101 ,240,46,85,.541,32,55,.582,14,30,.467,19,20,.950,125,38,94,.404,25,58,.431,13,36,.361,12,17,.706,101,2016-11-10,GSW,DEN
61,Home,W 125-99 ,240,42,80,.525,29,53,.547,13,27,.481,28,42,.667,125,33,71,.465,25,47,.532,8,24,.333,25,30,.833,99,2016-11-13,MIN,LAL
62,Home,W 125-118 ,240,41,92,.446,32,64,.500,9,28,.321,34,43,.791,125,45,99,.455,33,58,.569,12,41,.293,16,20,.800,118,2016-11-15,LAL,BRK
63,@,L 125-137 ,240,47,90,.522,34,61,.557,13,29,.448,18,19,.947,125,48,90,.533,27,54,.500,21,36,.583,20,27,.741,137,2016-11-23,POR,CLE
64,@,W 125-120 (OT),265,48,106,.453,38,79,.481,10,27,.370,19,22,.864,125,44,101,.436,30,65,.462,14,36,.389,18,26,.692,120,2016-12-03,MIN,CHO
65,@,W 125-121 ,240,46,86,.535,35,61,.574,11,25,.440,22,32,.688,125,47,86,.547,37,65,.569,10,21,.476,17,26,.654,121,2016-12-16,ATL,TOR
66,@,W 125-111 ,240,46,86,.535,28,48,.583,18,38,.474,15,26,.577,125,44,93,.473,35,68,.515,9,25,.360,14,20,.700,111,2016-12-21,HOU,PHO
67,Home,W 125-117 ,240,44,87,.506,31,51,.608,13,36,.361,24,29,.828,125,40,89,.449,28,63,.444,12,26,.462,25,28,.893,117,2017-01-04,GSW,POR
68,@,W 125-124 (2OT),290,54,105,.514,46,80,.575,8,25,.320,9,12,.750,125,51,98,.520,36,63,.571,15,35,.429,7,12,.583,124,2017-01-08,DET,POR
69,Home,W 125-112 ,240,52,89,.584,43,62,.694,9,27,.333,12,15,.800,125,45,88,.511,37,63,.587,8,25,.320,14,18,.778,112,2017-01-16,DEN,ORL
70,@,W 125-108 ,240,47,89,.528,32,51,.627,15,38,.395,16,21,.762,125,43,96,.448,36,61,.590,7,35,.200,15,18,.833,108,2017-01-20,GSW,HOU
71,Home,W 125-97 ,240,48,89,.539,33,52,.635,15,37,.405,14,22,.636,125,41,94,.436,34,73,.466,7,21,.333,8,10,.800,97,2017-02-01,CLE,MIN
72,Home,W 125-102 ,240,48,82,.585,36,60,.600,12,22,.545,17,23,.739,125,35,84,.417,29,61,.475,6,23,.261,26,31,.839,102,2017-02-04,MIA,PHI
73,Home,W 125-109 ,240,46,84,.548,31,54,.574,15,30,.500,18,22,.818,125,39,97,.402,27,60,.450,12,37,.324,19,22,.864,109,2017-02-11,CLE,DEN
74,Home,L 125-129 ,240,46,88,.523,32,52,.615,14,36,.389,19,23,.826,125,50,88,.568,43,73,.589,7,15,.467,22,32,.688,129,2017-02-15,BRK,MIL
75,@,W 125-107 ,240,45,80,.563,32,50,.640,13,30,.433,22,24,.917,125,44,96,.458,34,70,.486,10,26,.385,9,10,.900,107,2017-02-28,DEN,CHI
76,Home,W 125-98 ,240,49,90,.544,36,60,.600,13,30,.433,14,21,.667,125,37,85,.435,31,68,.456,6,17,.353,18,22,.818,98,2017-03-01,MIA,PHI
77,@,W 124-109 ,240,48,80,.600,39,63,.619,9,17,.529,19,23,.826,124,40,85,.471,33,62,.532,7,23,.304,22,27,.815,109,2012-02-14,WAS,POR
78,Home,W 124-118 (OT),265,46,94,.489,37,66,.561,9,28,.321,23,28,.821,124,49,101,.485,43,79,.544,6,22,.273,14,18,.778,118,2012-02-19,OKC,DEN
79,Home,L 124-127 ,240,46,89,.517,37,68,.544,9,21,.429,23,29,.793,124,50,89,.562,36,67,.537,14,22,.636,13,21,.619,127,2012-03-12,PHO,MIN
80,@,W 124-112 ,240,50,86,.581,42,73,.575,8,13,.615,16,20,.800,124,45,87,.517,40,68,.588,5,19,.263,17,24,.708,112,2012-03-14,DET,SAC
81,Home,W 124-89 ,240,48,81,.593,36,59,.610,12,22,.545,16,21,.762,124,37,96,.385,31,80,.388,6,16,.375,9,11,.818,89,2012-04-23,SAS,POR
82,Home,W 124-99 ,240,47,86,.547,32,60,.533,15,26,.577,15,19,.789,124,35,88,.398,28,67,.418,7,21,.333,22,29,.759,99,2012-11-05,MIA,PHO
83,Home,W 124-116 ,240,46,83,.554,35,61,.574,11,22,.500,21,26,.808,124,48,94,.511,37,74,.500,11,20,.550,9,11,.818,116,2012-12-01,HOU,UTA
84,@,W 124-94 ,240,45,94,.479,32,65,.492,13,29,.448,21,23,.913,124,33,83,.398,25,53,.472,8,30,.267,20,27,.741,94,2012-12-29,OKC,HOU
85,Home,W 124-118 ,240,43,84,.512,34,65,.523,9,19,.474,29,33,.879,124,44,92,.478,36,76,.474,8,16,.500,22,30,.733,118,2013-01-14,SAC,CLE
86,@,W 124-101 ,240,49,91,.538,41,69,.594,8,22,.364,18,19,.947,124,37,88,.420,30,67,.448,7,21,.333,20,22,.909,101,2013-04-10,ATL,PHI
87,Home,W 124-95 ,240,45,82,.549,34,60,.567,11,22,.500,23,26,.885,124,36,87,.414,31,71,.437,5,16,.313,18,21,.857,95,2013-11-13,MIN,CLE
88,Home,W 124-107 ,240,47,81,.580,32,56,.571,15,25,.600,15,18,.833,124,40,84,.476,34,69,.493,6,15,.400,21,25,.840,107,2013-12-18,ATL,SAC
89,Home,W 124-112 ,240,44,79,.557,36,57,.632,8,22,.364,28,35,.800,124,45,87,.517,39,67,.582,6,20,.300,16,22,.727,112,2014-01-01,MIN,NOP
90,Home,W 124-80 ,240,42,81,.519,27,51,.529,15,30,.500,25,30,.833,124,31,80,.388,24,59,.407,7,21,.333,11,23,.478,80,2014-01-12,SAC,CLE
91,Home,W 124-100 ,240,45,83,.542,34,67,.507,11,16,.688,23,32,.719,124,38,75,.507,33,60,.550,5,15,.333,19,28,.679,100,2014-01-22,PHO,IND
92,@,W 124-113 ,240,43,80,.538,34,60,.567,9,20,.450,29,35,.829,124,40,87,.460,32,67,.478,8,20,.400,25,26,.962,113,2014-01-27,PHO,PHI
93,Home,W 124-107 ,240,44,80,.550,32,54,.593,12,26,.462,24,26,.923,124,37,80,.463,29,56,.518,8,24,.333,25,33,.758,107,2014-02-03,DAL,CLE
94,@,W 124-112 ,240,48,77,.623,39,54,.722,9,23,.391,19,25,.760,124,42,94,.447,37,69,.536,5,25,.200,23,32,.719,112,2014-02-21,DAL,PHI
95,Home,W 124-80 ,240,46,86,.535,33,55,.600,13,31,.419,19,21,.905,124,32,81,.395,28,59,.475,4,22,.182,12,17,.706,80,2014-02-26,POR,BRK
96,Home,W 124-107 ,240,46,83,.554,30,55,.545,16,28,.571,16,20,.800,124,42,82,.512,33,59,.559,9,23,.391,14,21,.667,107,2014-03-03,MIA,CHA
97,Home,W 124-86 ,240,46,79,.582,33,54,.611,13,25,.520,19,26,.731,124,34,83,.410,30,65,.462,4,18,.222,14,18,.778,86,2014-03-17,HOU,UTA
98,Home,W 124-94 ,240,49,94,.521,41,75,.547,8,19,.421,18,19,.947,124,34,84,.405,25,57,.439,9,27,.333,17,22,.773,94,2014-03-22,CHA,POR
99,Home,W 124-107 ,240,44,86,.512,37,66,.561,7,20,.350,29,36,.806,124,42,85,.494,38,67,.567,4,18,.222,19,30,.633,107,2014-03-23,SAC,MIL
0,@,W 124-112 ,240,46,99,.465,33,70,.471,13,29,.448,19,21,.905,124,41,92,.446,30,67,.448,11,25,.440,19,22,.864,112,2014-04-01,POR,LAL
1,Home,W 124-82 ,240,45,86,.523,30,61,.492,15,25,.600,19,24,.792,124,27,74,.365,21,54,.389,6,20,.300,22,32,.688,82,2014-11-21,TOR,MIL
2,Home,W 124-115 ,240,44,97,.454,31,64,.484,13,33,.394,23,32,.719,124,41,88,.466,32,63,.508,9,25,.360,24,29,.828,115,2014-12-23,PHO,DAL
3,Home,W 124-116 ,240,38,77,.494,23,50,.460,15,27,.556,33,37,.892,124,47,103,.456,35,70,.500,12,33,.364,10,15,.667,116,2015-02-06,ATL,GSW
4,@,W 124-114 ,240,43,80,.538,31,56,.554,12,24,.500,26,35,.743,124,42,87,.483,33,59,.559,9,28,.321,21,29,.724,114,2015-02-09,OKC,DEN
5,@,W 124-86 ,240,41,83,.494,31,65,.477,10,18,.556,32,37,.865,124,30,82,.366,26,60,.433,4,22,.182,22,30,.733,86,2015-03-03,SAC,NYK
6,Home,W 124-103 ,240,49,94,.521,45,74,.608,4,20,.200,22,30,.733,124,38,84,.452,31,68,.456,7,16,.438,20,26,.769,103,2015-11-08,OKC,PHO
7,@,W 124-117 ,240,38,73,.521,21,43,.488,17,30,.567,31,36,.861,124,44,88,.500,31,59,.525,13,29,.448,16,24,.667,117,2015-11-19,GSW,LAC
8,@,W 124-119 (2OT),290,42,107,.393,33,76,.434,9,31,.290,31,39,.795,124,49,114,.430,37,81,.457,12,33,.364,9,16,.563,119,2015-12-11,GSW,BOS
9,Home,W 124-119 (2OT),290,41,88,.466,27,61,.443,14,27,.519,28,32,.875,124,44,104,.423,29,59,.492,15,45,.333,16,20,.800,119,2016-01-18,CHO,UTA
10,@,W 124-86 ,240,48,92,.522,38,72,.528,10,20,.500,18,25,.720,124,35,84,.417,29,57,.509,6,27,.222,10,14,.714,86,2016-02-03,ATL,PHI
11,Home,W 124-84 ,240,44,80,.550,31,56,.554,13,24,.542,23,35,.657,124,31,88,.352,24,64,.375,7,24,.292,15,20,.750,84,2016-02-22,LAC,PHO
12,Home,W 124-122 ,240,43,83,.518,35,68,.515,8,15,.533,30,40,.750,124,49,101,.485,39,73,.534,10,28,.357,14,17,.824,122,2016-02-22,MIN,BOS
13,@,W 124-115 ,240,41,85,.482,34,71,.479,7,14,.500,35,41,.854,124,43,79,.544,33,58,.569,10,21,.476,19,26,.731,115,2016-02-23,ORL,PHI
14,Home,W 124-119 ,240,47,79,.595,39,62,.629,8,17,.471,22,28,.786,124,49,93,.527,42,73,.575,7,20,.350,14,20,.700,119,2016-03-14,MIA,DEN
15,Home,W 124-81 ,240,51,90,.567,43,72,.597,8,18,.444,14,18,.778,124,32,79,.405,29,56,.518,3,23,.130,14,22,.636,81,2016-03-14,WAS,DET
16,Home,W 124-91 ,240,48,86,.558,33,55,.600,15,31,.484,13,17,.765,124,32,81,.395,24,59,.407,8,22,.364,19,25,.760,91,2016-03-21,CLE,DEN
17,@,W 124-102 ,240,46,87,.529,31,54,.574,15,33,.455,17,24,.708,124,37,88,.420,27,58,.466,10,30,.333,18,27,.667,102,2016-04-05,OKC,DEN
18,@,W 124-117 (OT),265,44,86,.512,36,69,.522,8,17,.471,28,36,.778,124,49,98,.500,37,63,.587,12,35,.343,7,8,.875,117,2016-04-05,MIN,GSW
19,@,W 124-115 ,240,44,94,.468,32,63,.508,12,31,.387,24,29,.828,124,42,74,.568,28,41,.683,14,33,.424,17,28,.607,115,2016-04-07,PHO,HOU
20,Home,W 124-109 ,240,44,78,.564,38,64,.594,6,14,.429,30,38,.789,124,41,84,.488,34,67,.507,7,17,.412,20,29,.690,109,2016-04-08,BOS,MIL
21,Home,W 124-121 ,240,45,81,.556,31,50,.620,14,31,.452,20,28,.714,124,43,86,.500,36,65,.554,7,21,.333,28,33,.848,121,2016-11-08,POR,PHO
22,Home,W 124-105 ,240,49,89,.551,42,63,.667,7,26,.269,19,24,.792,124,35,83,.422,24,54,.444,11,29,.379,24,30,.800,105,2016-11-18,OKC,BRK
23,@,W 124-121 ,240,42,95,.442,28,57,.491,14,38,.368,26,32,.813,124,46,89,.517,36,69,.522,10,20,.500,19,25,.760,121,2016-11-19,GSW,MIL
24,@,W 124-104 ,240,43,85,.506,28,53,.528,15,32,.469,23,31,.742,124,38,84,.452,27,60,.450,11,24,.458,17,18,.944,104,2016-11-23,LAC,DAL
25,@,W 124-116 ,240,43,83,.518,31,57,.544,12,26,.462,26,36,.722,124,44,93,.473,33,70,.471,11,23,.478,17,24,.708,116,2016-12-06,ORL,WAS
26,Home,W 124-110 ,240,43,87,.494,31,60,.517,12,27,.444,26,33,.788,124,45,88,.511,36,60,.600,9,28,.321,11,15,.733,110,2016-12-08,TOR,MIN
27,Home,W 124-118 ,240,43,83,.518,29,45,.644,14,38,.368,24,33,.727,124,43,85,.506,31,48,.646,12,37,.324,20,21,.952,118,2016-12-29,CLE,BOS
28,@,W 124-122 ,240,38,87,.437,22,54,.407,16,33,.485,32,40,.800,124,39,84,.464,28,57,.491,11,27,.407,33,41,.805,122,2016-12-30,PHI,DEN
29,Home,L 124-125 (2OT),290,51,98,.520,36,63,.571,15,35,.429,7,12,.583,124,54,105,.514,46,80,.575,8,25,.320,9,12,.750,125,2017-01-08,POR,DET
30,Home,W 124-122 ,240,43,87,.494,27,48,.563,16,39,.410,22,30,.733,124,43,93,.462,28,56,.500,15,37,.405,21,25,.840,122,2017-01-23,NOP,CLE
31,Home,W 124-116 ,240,49,92,.533,36,56,.643,13,36,.361,13,20,.650,124,43,87,.494,27,54,.500,16,33,.485,14,16,.875,116,2017-01-27,CLE,BRK
32,@,W 124-114 ,240,44,84,.524,39,65,.600,5,19,.263,31,38,.816,124,39,96,.406,32,76,.421,7,20,.350,29,35,.829,114,2017-02-01,LAC,PHO
33,Home,W 124-121 (OT),265,45,97,.464,35,65,.538,10,32,.313,24,34,.706,124,38,80,.475,20,40,.500,18,40,.450,27,30,.900,121,2017-02-26,LAC,CHO
34,Home,W 123-115 ,240,44,74,.595,33,56,.589,11,18,.611,24,30,.800,123,43,83,.518,23,48,.479,20,35,.571,9,12,.750,115,2012-01-11,DEN,NJN
35,Home,W 123-84 ,240,48,88,.545,39,70,.557,9,18,.500,18,24,.750,123,31,84,.369,19,59,.322,12,25,.480,10,14,.714,84,2012-04-09,DEN,GSW
36,Home,W 123-121 (3OT),315,41,95,.432,29,67,.433,12,28,.429,29,37,.784,123,42,98,.429,28,64,.438,14,34,.412,23,25,.920,121,2012-04-16,UTA,DAL
37,@,W 123-88 ,240,46,82,.561,31,55,.564,15,27,.556,16,21,.762,123,36,81,.444,31,63,.492,5,18,.278,11,22,.500,88,2012-12-29,TOR,ORL
38,Home,W 123-104 ,240,45,84,.536,29,55,.527,16,29,.552,17,22,.773,123,43,90,.478,31,67,.463,12,23,.522,6,7,.857,104,2012-12-31,HOU,ATL
39,Home,W 123-116 (OT),265,45,82,.549,36,60,.600,9,22,.409,24,38,.632,123,44,88,.500,30,57,.526,14,31,.452,14,18,.778,116,2013-01-23,MIA,TOR
40,Home,W 123-111 (2OT),290,42,94,.447,30,58,.517,12,36,.333,27,36,.750,123,42,93,.452,35,74,.473,7,19,.368,20,20,1.000,111,2013-01-25,ATL,BOS
41,Home,W 123-100 ,240,43,92,.467,30,58,.517,13,34,.382,24,26,.923,123,33,80,.413,29,64,.453,4,16,.250,30,36,.833,100,2013-02-13,DAL,SAC
42,Home,W 123-104 ,240,49,94,.521,36,67,.537,13,27,.481,12,14,.857,123,39,88,.443,27,57,.474,12,31,.387,14,20,.700,104,2013-11-05,DAL,LAL
43,Home,W 123-117 (OT),265,43,103,.417,32,78,.410,11,25,.440,26,34,.765,123,43,96,.448,28,55,.509,15,41,.366,16,25,.640,117,2013-11-13,PHI,HOU
44,Home,W 123-120 ,240,42,72,.583,31,50,.620,11,22,.500,28,33,.848,123,42,76,.553,30,45,.667,12,31,.387,24,33,.727,120,2013-11-20,DAL,HOU
45,Home,W 123-108 ,240,44,86,.512,29,56,.518,15,30,.500,20,22,.909,123,44,91,.484,41,74,.554,3,17,.176,17,23,.739,108,2013-12-21,PHO,DAL
46,@,W 123-94 ,240,45,84,.536,32,60,.533,13,24,.542,20,26,.769,123,38,90,.422,32,67,.478,6,23,.261,12,19,.632,94,2013-12-25,OKC,NYK
47,@,W 123-114 ,240,46,82,.561,31,53,.585,15,29,.517,16,19,.842,123,40,78,.513,32,60,.533,8,18,.444,26,31,.839,114,2014-01-02,GSW,MIA
48,Home,W 123-119 ,240,40,85,.471,33,70,.471,7,15,.467,36,50,.720,123,39,90,.433,29,63,.460,10,27,.370,31,36,.861,119,2014-01-07,SAC,POR
49,Home,W 123-87 ,240,45,92,.489,38,69,.551,7,23,.304,26,35,.743,123,29,84,.345,25,68,.368,4,16,.250,25,28,.893,87,2014-01-10,LAC,LAL
50,@,W 123-116 ,240,45,83,.542,33,59,.559,12,24,.500,21,29,.724,123,39,90,.433,30,62,.484,9,28,.321,29,33,.879,116,2014-01-15,DEN,GSW
51,Home,W 123-78 ,240,50,89,.562,41,61,.672,9,28,.321,14,17,.824,123,27,100,.270,24,72,.333,3,28,.107,21,25,.840,78,2014-02-09,LAC,PHI
52,Home,W 123-80 ,240,43,88,.489,31,59,.525,12,29,.414,25,30,.833,123,33,90,.367,31,73,.425,2,17,.118,12,17,.706,80,2014-02-10,GSW,PHI
53,@,W 123-110 ,240,43,83,.518,27,55,.491,16,28,.571,21,26,.808,123,37,87,.425,30,69,.435,7,18,.389,29,35,.829,110,2014-02-24,LAC,NOP
54,Home,W 123-110 ,240,44,81,.543,31,49,.633,13,32,.406,22,34,.647,123,43,84,.512,37,64,.578,6,20,.300,18,25,.720,110,2014-03-10,NYK,PHI
55,@,W 123-122 (OT),265,44,92,.478,34,63,.540,10,29,.345,25,31,.806,123,47,95,.495,38,68,.559,9,27,.333,19,25,.760,122,2014-03-19,MIN,DAL
56,Home,W 123-98 ,240,48,92,.522,36,71,.507,12,21,.571,15,19,.789,123,33,85,.388,27,64,.422,6,21,.286,26,32,.813,98,2014-03-29,PHI,DET
57,@,W 123-93 ,240,42,79,.532,30,57,.526,12,22,.545,27,35,.771,123,35,83,.422,31,65,.477,4,18,.222,19,26,.731,93,2014-04-02,CHA,PHI
58,Home,W 123-116 ,240,50,101,.495,39,73,.534,11,28,.393,12,14,.857,123,40,92,.435,25,52,.481,15,40,.375,21,25,.840,116,2014-04-09,DEN,HOU
59,Home,W 123-70 ,240,41,80,.513,30,48,.625,11,32,.344,30,36,.833,123,23,77,.299,16,50,.320,7,27,.259,17,33,.515,70,2014-11-13,DAL,PHI
60,@,W 123-104 ,240,45,79,.570,33,58,.569,12,21,.571,21,24,.875,123,42,87,.483,34,59,.576,8,28,.286,12,15,.800,104,2014-12-03,TOR,UTA
61,Home,W 123-101 ,240,47,82,.573,40,64,.625,7,18,.389,22,25,.880,123,35,83,.422,29,67,.433,6,16,.375,25,32,.781,101,2014-12-06,SAS,MIN
62,Home,W 123-84 ,240,49,83,.590,38,58,.655,11,25,.440,14,21,.667,123,33,88,.375,29,67,.433,4,21,.190,14,25,.560,84,2015-01-22,LAC,BRK
63,Home,W 123-118 (2OT),290,50,106,.472,47,97,.485,3,9,.333,20,25,.800,123,43,104,.413,37,79,.468,6,25,.240,26,32,.813,118,2015-01-29,LAL,CHI
64,Home,W 123-107 ,240,40,75,.533,27,45,.600,13,30,.433,30,37,.811,123,38,78,.487,32,55,.582,6,23,.261,25,31,.806,107,2015-02-06,TOR,LAC
65,Home,W 123-118 (OT),265,44,96,.458,37,75,.493,7,21,.333,28,34,.824,123,34,96,.354,19,61,.311,15,35,.429,35,44,.795,118,2015-03-04,OKC,PHI
66,@,W 123-108 ,240,45,76,.592,27,41,.659,18,35,.514,15,19,.789,123,42,88,.477,33,69,.478,9,19,.474,15,27,.556,108,2015-03-15,CLE,ORL
67,Home,W 123-97 ,240,49,84,.583,37,62,.597,12,22,.545,13,15,.867,123,38,86,.442,31,71,.437,7,15,.467,14,18,.778,97,2015-03-15,SAS,MIN
68,Home,W 123-115 ,240,43,84,.512,30,54,.556,13,30,.433,24,26,.923,123,41,82,.500,28,53,.528,13,29,.448,20,25,.800,115,2015-03-20,OKC,ATL
69,@,W 123-111 ,240,46,75,.613,40,63,.635,6,12,.500,25,31,.806,123,45,90,.500,37,67,.552,8,23,.348,13,18,.722,111,2015-03-21,BRK,IND
70,Home,W 123-93 ,240,47,85,.553,33,51,.647,14,34,.412,15,17,.882,123,40,87,.460,34,70,.486,6,17,.353,7,11,.636,93,2015-04-03,SAS,DEN
71,@,W 123-110 ,240,43,95,.453,29,59,.492,14,36,.389,23,32,.719,123,34,80,.425,31,64,.484,3,16,.188,39,54,.722,110,2015-04-04,GSW,DAL
72,Home,W 123-86 ,240,47,91,.516,32,61,.525,15,30,.500,14,23,.609,123,34,79,.430,29,62,.468,5,17,.294,13,19,.684,86,2015-11-21,IND,MIL
73,@,W 123-106 ,240,44,80,.550,25,54,.463,19,26,.731,16,23,.696,123,38,83,.458,25,50,.500,13,33,.394,17,24,.708,106,2015-11-24,IND,WAS
74,Home,W 123-111 ,240,44,85,.518,26,49,.531,18,36,.500,17,20,.850,123,38,88,.432,25,58,.431,13,30,.433,22,24,.917,111,2015-12-03,POR,IND
75,Home,L 123-131 ,240,44,100,.440,30,67,.448,14,33,.424,21,26,.808,123,52,95,.547,36,60,.600,16,35,.457,11,15,.733,131,2015-12-08,IND,GSW
76,Home,W 123-122 (OT),265,46,93,.495,39,74,.527,7,19,.368,24,31,.774,123,48,93,.516,39,70,.557,9,23,.391,17,27,.630,122,2015-12-09,MIN,LAL
77,@,W 123-99 ,240,39,78,.500,21,41,.512,18,37,.486,27,30,.900,123,32,80,.400,25,60,.417,7,20,.350,28,37,.757,99,2015-12-11,CHO,MEM
78,@,L 123-131 ,240,49,100,.490,39,84,.464,10,16,.625,15,22,.682,123,43,86,.500,35,64,.547,8,22,.364,37,40,.925,131,2015-12-29,MIL,OKC
79,@,W 123-98 ,240,49,90,.544,40,70,.571,9,20,.450,16,20,.800,123,37,77,.481,34,65,.523,3,12,.250,21,30,.700,98,2016-01-04,SAS,MIL
80,Home,W 123-98 ,240,52,86,.605,43,65,.662,9,21,.429,10,13,.769,123,37,79,.468,30,61,.492,7,18,.389,17,18,.944,98,2016-01-06,SAS,UTA
81,@,W 123-114 ,240,38,80,.475,26,50,.520,12,30,.400,35,59,.593,123,43,95,.453,31,71,.437,12,24,.500,16,18,.889,114,2016-01-20,DET,HOU
82,Home,L 123-126 ,240,50,90,.556,45,76,.592,5,14,.357,18,28,.643,123,48,91,.527,38,71,.535,10,20,.500,20,21,.952,126,2016-01-27,MIN,OKC
83,@,W 123-122 ,240,45,86,.523,34,54,.630,11,32,.344,22,30,.733,123,41,86,.477,24,51,.471,17,35,.486,23,33,.697,122,2016-01-30,WAS,HOU
84,Home,W 123-110 ,240,44,94,.468,32,60,.533,12,34,.353,23,26,.885,123,37,87,.425,24,54,.444,13,33,.394,23,35,.657,110,2016-02-09,GSW,HOU
85,Home,W 123-119 ,240,47,90,.522,35,70,.500,12,20,.600,17,18,.944,123,47,86,.547,39,67,.582,8,19,.421,17,22,.773,119,2016-02-25,NOP,OKC
86,Home,W 123-103 ,240,44,84,.524,32,62,.516,12,22,.545,23,28,.821,123,35,78,.449,24,47,.511,11,31,.355,22,23,.957,103,2016-03-06,DET,POR
87,Home,W 123-116 ,240,42,84,.500,31,51,.608,11,33,.333,28,33,.848,123,45,92,.489,34,63,.540,11,29,.379,15,20,.750,116,2016-03-12,GSW,PHO
88,@,W 123-108 ,240,49,90,.544,37,69,.536,12,21,.571,13,16,.813,123,42,90,.467,33,72,.458,9,18,.500,15,17,.882,108,2016-03-16,NOP,SAC
89,Home,W 123-75 ,240,46,89,.517,29,57,.509,17,32,.531,14,19,.737,123,26,85,.306,19,65,.292,7,20,.350,16,22,.727,75,2016-03-28,UTA,LAL
90,Home,W 123-109 ,240,45,80,.563,29,49,.592,16,31,.516,17,22,.773,123,35,74,.473,27,45,.600,8,29,.276,31,34,.912,109,2016-04-06,IND,CLE
91,@,W 123-116 ,240,48,90,.533,39,68,.574,9,22,.409,18,20,.900,123,41,85,.482,30,53,.566,11,32,.344,23,29,.793,116,2016-11-02,LAL,ATL
92,@,W 123-107 ,240,44,84,.524,33,61,.541,11,23,.478,24,31,.774,123,41,90,.456,33,65,.508,8,25,.320,17,21,.810,107,2016-11-06,DEN,BOS
93,@,W 123-107 ,240,45,87,.517,32,64,.500,13,23,.565,20,26,.769,123,38,85,.447,30,61,.492,8,24,.333,23,30,.767,107,2016-11-09,MIN,ORL
94,Home,W 123-115 ,240,39,74,.527,29,49,.592,10,25,.400,35,42,.833,123,40,80,.500,32,61,.525,8,19,.421,27,32,.844,115,2016-11-21,LAC,TOR
95,@,W 123-114 ,240,41,87,.471,31,58,.534,10,29,.345,31,36,.861,123,43,86,.500,34,57,.596,9,29,.310,19,25,.760,114,2016-12-14,TOR,PHI
96,Home,W 123-96 ,240,45,80,.563,36,55,.655,9,25,.360,24,27,.889,123,37,79,.468,30,55,.545,7,24,.292,15,18,.833,96,2016-12-23,MIL,WAS
97,Home,W 123-116 ,240,42,79,.532,30,53,.566,12,26,.462,27,37,.730,123,42,83,.506,29,52,.558,13,31,.419,19,22,.864,116,2016-12-23,PHO,PHI
98,@,W 123-107 ,240,41,78,.526,24,46,.522,17,32,.531,24,28,.857,123,36,87,.414,21,49,.429,15,38,.395,20,25,.800,107,2016-12-27,HOU,DAL
99,@,W 123-114 ,240,42,75,.560,32,58,.552,10,17,.588,29,32,.906,123,37,92,.402,22,60,.367,15,32,.469,25,31,.806,114,2017-01-01,TOR,LAL
0,Home,W 123-112 ,240,37,80,.463,28,56,.500,9,24,.375,40,49,.816,123,42,96,.438,33,66,.500,9,30,.300,19,23,.826,112,2017-01-04,CHO,OKC
1,Home,W 123-118 (OT),265,38,97,.392,27,69,.391,11,28,.393,36,39,.923,123,37,85,.435,29,54,.537,8,31,.258,36,43,.837,118,2017-01-07,CHI,TOR
2,Home,W 123-109 ,240,43,86,.500,32,62,.516,11,24,.458,26,28,.929,123,40,87,.460,28,56,.500,12,31,.387,17,24,.708,109,2017-01-07,IND,NYK
3,Home,L 123-127 (OT),265,42,92,.457,29,57,.509,13,35,.371,26,31,.839,123,43,92,.467,33,67,.493,10,25,.400,31,36,.861,127,2017-01-21,BOS,POR
4,Home,W 123-98 ,240,46,87,.529,36,63,.571,10,24,.417,21,26,.808,123,40,96,.417,30,64,.469,10,32,.313,8,8,1.000,98,2017-01-21,DEN,LAC
5,Home,W 123-108 ,240,48,83,.578,39,63,.619,9,20,.450,18,21,.857,123,38,84,.452,28,51,.549,10,33,.303,22,24,.917,108,2017-01-24,WAS,BOS
6,@,W 123-118 ,240,42,81,.519,30,50,.600,12,31,.387,27,28,.964,123,42,78,.538,32,53,.604,10,25,.400,24,32,.750,118,2017-01-27,HOU,PHI
7,@,W 123-112 ,240,39,80,.488,31,55,.564,8,25,.320,37,42,.881,123,41,91,.451,35,70,.500,6,21,.286,24,32,.750,112,2017-01-28,DEN,PHO
8,Home,W 123-92 ,240,48,85,.565,33,57,.579,15,28,.536,12,13,.923,123,37,92,.402,33,68,.485,4,24,.167,14,19,.737,92,2017-02-08,GSW,CHI
9,Home,L 123-131 ,240,52,93,.559,36,55,.655,16,38,.421,3,5,.600,123,54,95,.568,38,63,.603,16,32,.500,7,10,.700,131,2017-02-10,NYK,DEN
10,Home,W 123-113 ,240,43,81,.531,30,55,.545,13,26,.500,24,26,.923,123,38,93,.409,27,65,.415,11,28,.393,26,37,.703,113,2017-02-23,GSW,LAC
11,Home,W 123-108 ,240,39,78,.500,21,36,.583,18,42,.429,27,36,.750,123,43,97,.443,35,69,.507,8,28,.286,14,21,.667,108,2017-03-04,HOU,MEM
12,@,W 123-113 ,240,50,88,.568,39,62,.629,11,26,.423,12,19,.632,123,46,87,.529,33,59,.559,13,28,.464,8,17,.471,113,2017-03-08,WAS,DEN
13,@,W 122-93 ,240,50,91,.549,48,78,.615,2,13,.154,20,25,.800,122,34,78,.436,25,58,.431,9,20,.450,16,22,.727,93,2012-01-25,DEN,SAC
14,@,W 122-99 ,240,48,87,.552,34,60,.567,14,27,.519,12,18,.667,122,35,80,.438,23,59,.390,12,21,.571,17,20,.850,99,2012-01-30,DAL,PHO
15,@,W 122-110 ,240,43,80,.538,31,57,.544,12,23,.522,24,28,.857,122,40,83,.482,30,57,.526,10,26,.385,20,28,.714,110,2012-03-03,MIN,POR
16,Home,W 122-95 ,240,46,73,.630,36,50,.720,10,23,.435,20,26,.769,122,36,88,.409,29,74,.392,7,14,.500,16,19,.842,95,2012-03-10,OKC,CHA
17,Home,W 122-111 ,240,43,83,.518,30,57,.526,13,26,.500,23,27,.852,122,45,86,.523,34,59,.576,11,27,.407,10,16,.625,111,2012-03-14,SAS,ORL
18,Home,W 122-117 (OT),265,44,98,.449,36,72,.500,8,26,.308,26,32,.813,122,43,96,.448,31,72,.431,12,24,.500,19,25,.760,117,2012-04-08,NJN,CLE
19,Home,W 122-103 ,240,47,87,.540,30,54,.556,17,33,.515,11,17,.647,122,40,86,.465,32,62,.516,8,24,.333,15,22,.682,103,2012-11-30,LAL,DEN
20,@,W 122-97 ,240,46,85,.541,38,67,.567,8,18,.444,22,29,.759,122,31,91,.341,25,67,.373,6,24,.250,29,34,.853,97,2012-12-16,DEN,SAC
21,Home,W 122-116 ,240,44,77,.571,32,54,.593,12,23,.522,22,24,.917,122,45,86,.523,34,54,.630,11,32,.344,15,26,.577,116,2012-12-28,SAS,HOU
22,Home,W 122-95 ,240,52,92,.565,43,68,.632,9,24,.375,9,13,.692,122,37,79,.468,31,64,.484,6,15,.400,15,25,.600,95,2013-02-06,CLE,CHA
23,Home,W 122-119 ,240,44,92,.478,29,59,.492,15,33,.455,19,23,.826,122,42,87,.483,31,59,.525,11,28,.393,24,27,.889,119,2013-02-20,HOU,OKC
24,Home,W 122-108 ,240,49,92,.533,37,65,.569,12,27,.444,12,19,.632,122,38,88,.432,26,66,.394,12,22,.545,20,25,.800,108,2013-02-22,ATL,SAC
25,Home,W 122-114 (OT),265,46,92,.500,41,78,.526,5,14,.357,25,30,.833,122,46,100,.460,38,78,.487,8,22,.364,14,18,.778,114,2013-03-02,MIL,TOR
26,Home,W 122-105 ,240,49,82,.598,37,58,.638,12,24,.500,12,17,.706,122,45,97,.464,44,87,.506,1,10,.100,14,18,.778,105,2013-03-04,POR,CHA
27,Home,W 122-105 ,240,46,96,.479,38,73,.521,8,23,.348,22,24,.917,122,31,77,.403,19,48,.396,12,29,.414,31,40,.775,105,2013-03-05,OKC,LAL
28,Home,W 122-111 ,240,41,81,.506,32,60,.533,9,21,.429,31,44,.705,122,45,99,.455,37,75,.493,8,24,.333,13,18,.722,111,2013-11-16,HOU,DEN
29,@,W 122-101 ,240,48,89,.539,35,66,.530,13,23,.565,13,15,.867,122,35,78,.449,31,65,.477,4,13,.308,27,33,.818,101,2013-12-11,UTA,SAC
30,Home,W 122-97 ,240,47,99,.475,39,74,.527,8,25,.320,20,23,.870,122,36,87,.414,29,62,.468,7,25,.280,18,31,.581,97,2013-12-13,OKC,LAL
31,Home,W 122-103 ,240,51,83,.614,41,60,.683,10,23,.435,10,14,.714,122,43,74,.581,36,52,.692,7,22,.318,10,24,.417,103,2013-12-20,MIA,SAC
32,Home,W 122-108 ,240,39,71,.549,28,55,.509,11,16,.688,33,42,.786,122,42,90,.467,34,60,.567,8,30,.267,16,21,.762,108,2014-02-05,HOU,PHO
33,Home,W 122-109 ,240,43,80,.538,32,59,.542,11,21,.524,25,30,.833,122,41,84,.488,33,59,.559,8,25,.320,19,26,.731,109,2014-02-08,PHO,GSW
34,Home,W 122-117 ,240,46,79,.582,42,69,.609,4,10,.400,26,31,.839,122,43,84,.512,30,53,.566,13,31,.419,18,22,.818,117,2014-02-12,LAC,POR
35,@,L 122-126 ,240,47,93,.505,42,78,.538,5,15,.333,23,32,.719,122,48,80,.600,29,53,.547,19,27,.704,11,16,.688,126,2014-02-28,SAC,LAL
36,@,W 122-103 ,240,45,89,.506,33,63,.524,12,26,.462,20,28,.714,122,38,84,.452,33,62,.532,5,22,.227,22,32,.688,103,2014-03-01,WAS,PHI
37,@,W 122-101 ,240,43,90,.478,29,57,.509,14,33,.424,22,24,.917,122,38,79,.481,28,60,.467,10,19,.526,15,20,.750,101,2014-03-04,SAS,CLE
38,@,L 122-128 ,240,45,90,.500,32,57,.561,13,33,.394,19,19,1.000,122,42,80,.525,27,53,.509,15,27,.556,29,39,.744,128,2014-03-06,OKC,PHO
39,Home,W 122-104 ,240,49,78,.628,39,62,.629,10,16,.625,14,19,.737,122,42,91,.462,37,80,.463,5,11,.455,15,21,.714,104,2014-03-16,SAS,UTA
40,Home,L 122-123 (OT),265,47,95,.495,38,68,.559,9,27,.333,19,25,.760,122,44,92,.478,34,63,.540,10,29,.345,25,31,.806,123,2014-03-19,DAL,MIN
41,Home,W 122-106 ,240,48,89,.539,36,67,.537,12,22,.545,14,17,.824,122,40,81,.494,27,51,.529,13,30,.433,13,21,.619,106,2014-03-21,DAL,DEN
42,@,W 122-120 (OT),265,52,91,.571,37,60,.617,15,31,.484,3,6,.500,122,47,96,.490,33,66,.500,14,30,.467,12,16,.750,120,2014-04-01,GSW,DAL
43,@,W 122-121 (2OT),290,43,93,.462,31,61,.508,12,32,.375,24,34,.706,122,43,99,.434,32,63,.508,11,36,.306,24,30,.800,121,2014-04-04,MIN,MIA
44,Home,W 122-115 ,240,45,77,.584,34,54,.630,11,23,.478,21,31,.677,122,40,84,.476,31,52,.596,9,32,.281,26,32,.813,115,2014-04-06,PHO,OKC
45,Home,W 122-100 ,240,53,93,.570,42,67,.627,11,26,.423,5,9,.556,122,34,96,.354,25,68,.368,9,28,.321,23,32,.719,100,2014-04-09,CLE,DET
46,Home,W 122-119 (2OT),290,48,97,.495,42,76,.553,6,21,.286,20,27,.741,122,43,93,.462,30,60,.500,13,33,.394,20,26,.769,119,2014-11-07,CHO,ATL
47,@,W 122-121 ,240,43,85,.506,35,62,.565,8,23,.348,28,37,.757,122,48,88,.545,42,68,.618,6,20,.300,19,23,.826,121,2014-11-14,CLE,BOS
48,@,W 122-118 (3OT),315,48,108,.444,43,84,.512,5,24,.208,21,28,.750,122,44,92,.478,35,61,.574,9,31,.290,21,29,.724,118,2014-11-19,MIL,BRK
49,@,W 122-96 ,240,44,86,.512,31,55,.564,13,31,.419,21,23,.913,122,36,78,.462,32,55,.582,4,23,.174,20,33,.606,96,2014-11-21,PHO,PHI
50,Home,W 122-97 ,240,41,88,.466,33,67,.493,8,21,.381,32,36,.889,122,33,85,.388,25,62,.403,8,23,.348,23,29,.793,97,2014-11-28,DEN,PHO
51,@,L 122-129 (OT),265,45,104,.433,36,70,.514,9,34,.265,23,31,.742,122,47,96,.490,37,72,.514,10,24,.417,25,34,.735,129,2014-11-30,TOR,LAL
52,Home,L 122-128 (OT),265,47,101,.465,39,74,.527,8,27,.296,20,25,.800,122,44,86,.512,33,62,.532,11,24,.458,29,35,.829,128,2014-12-14,NOP,GSW
53,Home,W 122-110 (2OT),290,48,100,.480,39,79,.494,9,21,.429,17,24,.708,122,42,100,.420,34,65,.523,8,35,.229,18,23,.783,110,2015-01-11,MEM,PHO
54,Home,W 122-79 ,240,44,81,.543,31,54,.574,13,27,.481,21,27,.778,122,30,87,.345,23,63,.365,7,24,.292,12,19,.632,79,2015-01-19,GSW,DEN
55,Home,L 122-127 (OT),265,49,101,.485,45,82,.549,4,19,.211,20,26,.769,122,47,92,.511,40,66,.606,7,26,.269,26,30,.867,127,2015-01-30,BRK,TOR
56,@,W 122-106 ,240,52,90,.578,47,77,.610,5,13,.385,13,17,.765,122,41,88,.466,32,73,.438,9,15,.600,15,17,.882,106,2015-03-16,BRK,MIN
57,Home,W 122-118 ,240,42,88,.477,37,69,.536,5,19,.263,33,39,.846,122,44,84,.524,31,50,.620,13,34,.382,17,28,.607,118,2015-03-18,OKC,BOS
58,@,W 122-108 ,240,50,83,.602,38,57,.667,12,26,.462,10,11,.909,122,39,92,.424,24,58,.414,15,34,.441,15,19,.789,108,2015-03-24,GSW,POR
59,Home,L 122-126 ,240,45,89,.506,32,64,.500,13,25,.520,19,25,.760,122,46,86,.535,31,58,.534,15,28,.536,19,24,.792,126,2015-04-01,POR,LAC
60,Home,W 122-111 ,240,45,82,.549,36,56,.643,9,26,.346,23,30,.767,122,38,74,.514,33,56,.589,5,18,.278,30,42,.714,111,2015-04-12,DEN,SAC
61,@,W 122-99 ,240,46,84,.548,38,67,.567,8,17,.471,22,41,.537,122,36,94,.383,29,70,.414,7,24,.292,20,25,.800,99,2015-04-15,SAC,LAL
62,@,W 122-97 ,240,42,93,.452,33,70,.471,9,23,.391,29,35,.829,122,30,86,.349,21,68,.309,9,18,.500,28,31,.903,97,2015-10-28,NYK,MIL
63,Home,W 122-114 ,240,37,84,.440,25,67,.373,12,17,.706,36,39,.923,122,41,81,.506,31,57,.544,10,24,.417,22,31,.710,114,2015-11-16,MEM,OKC
64,Home,W 122-116 ,240,39,85,.459,28,55,.509,11,30,.367,33,40,.825,122,35,90,.389,18,54,.333,17,36,.472,29,33,.879,116,2015-11-22,NOP,PHO
65,@,L 122-127 (OT),265,52,104,.500,44,73,.603,8,31,.258,10,16,.625,122,49,98,.500,40,69,.580,9,29,.310,20,26,.769,127,2015-11-23,SAC,CHO
66,@,L 122-127 (OT),265,47,97,.485,33,64,.516,14,33,.424,14,15,.933,122,44,87,.506,32,60,.533,12,27,.444,27,44,.614,127,2015-12-02,PHO,DET
67,Home,W 122-119 (OT),265,43,92,.467,35,69,.507,8,23,.348,28,37,.757,122,40,93,.430,28,64,.438,12,29,.414,27,34,.794,119,2015-12-05,UTA,IND
68,@,L 122-123 (OT),265,48,93,.516,39,70,.557,9,23,.391,17,27,.630,122,46,93,.495,39,74,.527,7,19,.368,24,31,.774,123,2015-12-09,LAL,MIN
69,Home,W 122-112 ,240,48,83,.578,40,68,.588,8,15,.533,18,21,.857,122,46,94,.489,37,69,.536,9,25,.360,11,15,.733,112,2015-12-27,OKC,DEN
70,Home,W 122-103 ,240,43,89,.483,23,47,.489,20,42,.476,16,24,.667,122,37,95,.389,24,64,.375,13,31,.419,16,28,.571,103,2015-12-28,GSW,SAC
71,@,W 122-117 ,240,37,71,.521,22,41,.537,15,30,.500,33,41,.805,122,38,88,.432,29,58,.500,9,30,.300,32,36,.889,117,2015-12-30,LAC,CHO
72,Home,W 122-100 ,240,41,74,.554,24,41,.585,17,33,.515,23,26,.885,122,36,73,.493,28,54,.519,8,19,.421,20,29,.690,100,2016-01-04,CLE,TOR
73,Home,W 122-110 ,240,43,90,.478,29,57,.509,14,33,.424,22,25,.880,122,44,95,.463,41,78,.526,3,17,.176,19,27,.704,110,2016-01-22,GSW,IND
74,Home,L 122-128 (OT),265,44,95,.463,33,72,.458,11,23,.478,23,30,.767,122,46,99,.465,35,79,.443,11,20,.550,25,29,.862,128,2016-01-26,NYK,OKC
75,Home,L 122-123 ,240,41,86,.477,24,51,.471,17,35,.486,23,33,.697,122,45,86,.523,34,54,.630,11,32,.344,22,30,.733,123,2016-01-30,HOU,WAS
76,@,W 122-106 ,240,42,85,.494,27,52,.519,15,33,.455,23,30,.767,122,37,73,.507,36,62,.581,1,11,.091,31,39,.795,106,2016-02-08,OKC,PHO
77,@,L 122-124 ,240,49,101,.485,39,73,.534,10,28,.357,14,17,.824,122,43,83,.518,35,68,.515,8,15,.533,30,40,.750,124,2016-02-22,BOS,MIN
78,@,W 122-95 ,240,46,87,.529,35,62,.565,11,25,.440,19,25,.760,122,37,84,.440,31,64,.484,6,20,.300,15,23,.652,95,2016-02-22,TOR,NYK
79,Home,W 122-116 (OT),265,45,88,.511,34,59,.576,11,29,.379,21,27,.778,122,43,93,.462,34,64,.531,9,29,.310,21,31,.677,116,2016-02-26,DAL,DEN
80,Home,W 122-113 ,240,38,82,.463,23,47,.489,15,35,.429,31,38,.816,122,40,85,.471,30,52,.577,10,33,.303,23,28,.821,113,2016-03-09,CHO,NOP
81,@,W 122-106 ,240,43,76,.566,31,46,.674,12,30,.400,24,32,.750,122,40,82,.488,31,57,.544,9,25,.360,17,24,.708,106,2016-03-16,LAC,HOU
82,Home,W 122-101 ,240,46,84,.548,35,65,.538,11,19,.579,19,23,.826,122,40,76,.526,30,52,.577,10,24,.417,11,13,.846,101,2016-03-19,MIA,CLE
83,@,W 122-101 ,240,45,84,.536,28,42,.667,17,42,.405,15,22,.682,122,39,92,.424,27,62,.435,12,30,.400,11,12,.917,101,2016-03-23,ATL,WAS
84,Home,W 122-98 ,240,48,95,.505,38,70,.543,10,25,.400,16,19,.842,122,35,77,.455,20,42,.476,15,35,.429,13,25,.520,98,2016-04-12,TOR,PHI
85,Home,W 122-117 ,240,48,89,.539,37,57,.649,11,32,.344,15,18,.833,122,43,97,.443,28,53,.528,15,44,.341,16,20,.800,117,2016-10-26,BOS,BRK
86,@,W 122-114 ,240,44,91,.484,35,63,.556,9,28,.321,25,28,.893,122,47,100,.470,42,78,.538,5,22,.227,15,23,.652,114,2016-10-28,GSW,NOP
87,@,L 122-128 ,240,46,96,.479,35,64,.547,11,32,.344,19,22,.864,122,41,84,.488,27,50,.540,14,34,.412,32,37,.865,128,2016-11-03,BOS,CLE
88,Home,W 122-96 ,240,46,89,.517,32,59,.542,14,30,.467,16,20,.800,122,35,87,.402,25,60,.417,10,27,.370,16,28,.571,96,2016-11-03,GSW,OKC
89,Home,W 122-100 ,240,41,84,.488,29,52,.558,12,32,.375,28,32,.875,122,40,94,.426,31,61,.508,9,33,.273,11,15,.733,100,2016-11-07,CHO,IND
90,Home,W 122-115 (OT),265,49,90,.544,40,71,.563,9,19,.474,15,20,.750,122,46,95,.484,32,59,.542,14,36,.389,9,19,.474,115,2016-11-09,IND,PHI
91,Home,W 122-120 (OT),265,45,86,.523,32,53,.604,13,33,.394,19,27,.704,122,43,88,.489,37,67,.552,6,21,.286,28,35,.800,120,2016-11-11,POR,SAC
92,@,W 122-104 ,240,40,84,.476,24,47,.511,16,37,.432,26,30,.867,122,40,107,.374,32,74,.432,8,33,.242,16,21,.762,104,2016-11-12,BRK,PHO
93,@,W 122-105 ,240,46,86,.535,33,63,.524,13,23,.565,17,22,.773,122,38,87,.437,22,48,.458,16,39,.410,13,14,.929,105,2016-11-27,SAC,BRK
94,Home,W 122-95 ,240,42,77,.545,29,58,.500,13,19,.684,25,31,.806,122,36,86,.419,22,52,.423,14,34,.412,9,13,.692,95,2016-11-28,TOR,PHI
95,@,L 122-127 (2OT),290,46,109,.422,33,69,.478,13,40,.325,17,22,.773,122,45,104,.433,32,66,.485,13,38,.342,24,36,.667,127,2016-11-29,LAC,BRK
96,Home,W 122-118 ,240,42,91,.462,25,48,.521,17,43,.395,21,36,.583,122,42,80,.525,35,60,.583,7,20,.350,27,36,.750,118,2016-12-12,HOU,BRK
97,Home,W 122-100 ,240,42,81,.519,28,56,.500,14,25,.560,24,28,.857,122,42,89,.472,38,65,.585,4,24,.167,12,17,.706,100,2016-12-12,TOR,MIL
98,Home,W 122-100 ,240,42,94,.447,18,33,.545,24,61,.393,14,19,.737,122,40,98,.408,31,71,.437,9,27,.333,11,20,.550,100,2016-12-16,HOU,NOP
99,Home,W 122-108 ,240,44,77,.571,32,52,.615,12,25,.480,22,27,.815,122,42,86,.488,32,58,.552,10,28,.357,14,21,.667,108,2016-12-16,WAS,DET
0,Home,L 122-124 ,240,39,84,.464,28,57,.491,11,27,.407,33,41,.805,122,38,87,.437,22,54,.407,16,33,.485,32,40,.800,124,2016-12-30,DEN,PHI
1,@,L 122-129 ,240,47,105,.448,37,73,.507,10,32,.313,18,25,.720,122,42,92,.457,21,37,.568,21,55,.382,24,29,.828,129,2016-12-31,NYK,HOU
2,Home,L 122-129 ,240,42,78,.538,31,53,.585,11,25,.440,27,30,.900,122,46,89,.517,35,51,.686,11,38,.289,26,31,.839,129,2017-01-08,TOR,HOU
3,@,W 122-118 ,240,40,90,.444,31,62,.500,9,28,.321,33,41,.805,122,37,81,.457,28,56,.500,9,25,.360,35,40,.875,118,2017-01-15,OKC,SAC
4,Home,W 122-114 ,240,43,84,.512,35,66,.530,8,18,.444,28,35,.800,122,36,73,.493,30,60,.500,6,13,.462,36,41,.878,114,2017-01-17,SAS,MIN
5,Home,W 122-73 ,240,43,87,.494,26,48,.542,17,39,.436,19,19,1.000,122,28,73,.384,25,52,.481,3,21,.143,14,17,.824,73,2017-01-22,DAL,LAL
6,@,L 122-124 ,240,43,93,.462,28,56,.500,15,37,.405,21,25,.840,122,43,87,.494,27,48,.563,16,39,.410,22,30,.733,124,2017-01-23,CLE,NOP
7,Home,W 122-119 ,240,45,83,.542,34,52,.654,11,31,.355,21,26,.808,122,41,74,.554,28,45,.622,13,29,.448,24,29,.828,119,2017-01-30,PHI,SAC
8,@,W 122-107 ,240,39,77,.506,24,44,.545,15,33,.455,29,38,.763,122,34,87,.391,25,61,.410,9,26,.346,30,37,.811,107,2017-02-10,GSW,MEM
9,@,W 122-114 ,240,39,75,.520,24,45,.533,15,30,.500,29,35,.829,122,40,76,.526,32,48,.667,8,28,.286,26,31,.839,114,2017-02-10,LAL,MIL
10,@,W 122-106 ,240,45,75,.600,33,50,.660,12,25,.480,20,27,.741,122,38,82,.463,32,55,.582,6,27,.222,24,32,.750,106,2017-02-10,NOP,MIN
11,@,W 122-103 ,240,37,87,.425,17,35,.486,20,52,.385,28,33,.848,122,42,94,.447,30,60,.500,12,34,.353,7,13,.538,103,2017-03-01,HOU,LAC
12,@,W 122-109 ,240,39,73,.534,25,43,.581,14,30,.467,30,38,.789,122,34,77,.442,24,52,.462,10,25,.400,31,39,.795,109,2017-03-06,BRK,MEM
13,Home,W 122-111 ,240,45,83,.542,28,52,.538,17,31,.548,15,19,.789,122,42,90,.467,31,60,.517,11,30,.367,16,22,.727,111,2017-03-07,DAL,LAL
14,@,W 122-110 ,240,47,98,.480,35,71,.493,12,27,.444,16,24,.667,122,42,91,.462,36,72,.500,6,19,.316,20,25,.800,110,2017-03-09,LAL,PHO
15,Home,W 121-117 ,240,49,89,.551,40,69,.580,9,20,.450,14,18,.778,121,46,81,.568,38,65,.585,8,16,.500,17,26,.654,117,2012-01-07,SAS,DEN
16,Home,W 121-94 ,240,46,83,.554,35,59,.593,11,24,.458,18,24,.750,121,34,70,.486,27,50,.540,7,20,.350,19,27,.704,94,2012-01-21,ATL,CLE
17,Home,W 121-115 ,240,44,84,.524,35,65,.538,9,19,.474,24,26,.923,121,42,89,.472,33,72,.458,9,17,.529,22,28,.786,115,2012-02-14,CHI,SAC
18,Home,W 121-79 ,240,43,80,.538,24,42,.571,19,38,.500,16,26,.615,121,28,75,.373,23,58,.397,5,17,.294,18,23,.783,79,2012-03-14,NYK,POR
19,Home,W 121-102 ,240,48,81,.593,41,66,.621,7,15,.467,18,29,.621,121,36,78,.462,30,60,.500,6,18,.333,24,32,.750,102,2012-03-23,UTA,DEN
20,@,W 121-84 ,240,50,88,.568,40,72,.556,10,16,.625,11,18,.611,121,34,85,.400,28,63,.444,6,22,.273,10,19,.526,84,2012-03-30,MIL,CLE
21,@,L 121-123 (3OT),315,42,98,.429,28,64,.438,14,34,.412,23,25,.920,121,41,95,.432,29,67,.433,12,28,.429,29,37,.784,123,2012-04-16,DAL,UTA
22,Home,W 121-112 ,240,49,88,.557,42,75,.560,7,13,.538,16,25,.640,121,42,93,.452,37,74,.500,5,19,.263,23,27,.852,112,2012-04-18,WAS,MIL
23,Home,W 121-97 ,240,47,77,.610,37,62,.597,10,15,.667,17,18,.944,121,33,76,.434,27,62,.435,6,14,.429,25,30,.833,97,2012-04-20,SAS,LAL
24,Home,W 121-100 ,240,38,79,.481,21,46,.457,17,33,.515,28,31,.903,121,37,78,.474,28,58,.483,9,20,.450,17,22,.773,100,2012-11-25,NYK,DET
25,Home,W 121-104 ,240,47,85,.553,30,57,.526,17,28,.607,10,11,.909,121,40,86,.465,34,76,.447,6,10,.600,18,22,.818,104,2012-12-19,PHO,CHA
26,Home,W 121-96 ,240,44,82,.537,32,54,.593,12,28,.429,21,26,.808,121,42,79,.532,40,66,.606,2,13,.154,10,14,.714,96,2012-12-22,HOU,MEM
27,Home,W 121-118 (OT),265,45,93,.484,37,75,.493,8,18,.444,23,34,.676,121,35,76,.461,27,52,.519,8,24,.333,40,48,.833,118,2013-01-20,DEN,OKC
28,Home,W 121-93 ,240,47,89,.528,34,58,.586,13,31,.419,14,17,.824,121,37,88,.420,29,66,.439,8,22,.364,11,22,.500,93,2013-01-26,DEN,SAC
29,Home,W 121-112 ,240,45,82,.549,32,55,.582,13,27,.481,18,21,.857,121,43,90,.478,36,67,.537,7,23,.304,19,23,.826,112,2013-03-08,SAC,PHO
30,Home,W 121-79 ,240,45,83,.542,36,60,.600,9,23,.391,22,26,.846,121,32,83,.386,30,62,.484,2,21,.095,13,15,.867,79,2013-03-13,SAC,CHI
31,Home,W 121-110 ,240,47,85,.553,37,65,.569,10,20,.500,17,23,.739,121,38,78,.487,32,60,.533,6,18,.333,28,35,.800,110,2013-04-10,SAC,NOH
32,Home,W 121-100 ,240,45,83,.542,32,56,.571,13,27,.481,18,24,.750,121,39,100,.390,31,75,.413,8,25,.320,14,17,.824,100,2013-04-14,HOU,SAC
33,Home,W 121-82 ,240,48,82,.585,40,61,.656,8,21,.381,17,19,.895,121,32,81,.395,28,69,.406,4,12,.333,14,23,.609,82,2013-11-24,LAC,CHI
34,@,W 121-105 ,240,51,93,.548,43,73,.589,8,20,.400,11,14,.786,121,42,92,.457,30,61,.492,12,31,.387,9,21,.429,105,2013-11-29,NOP,PHI
35,Home,W 121-83 ,240,44,83,.530,27,49,.551,17,34,.500,16,19,.842,121,30,70,.429,20,45,.444,10,25,.400,13,20,.650,83,2013-12-06,NYK,ORL
36,@,W 121-94 ,240,41,85,.482,30,61,.492,11,24,.458,28,33,.848,121,39,83,.470,31,55,.564,8,28,.286,8,16,.500,94,2013-12-10,MIN,DET
37,Home,W 121-120 (OT),265,51,100,.510,42,71,.592,9,29,.310,10,15,.667,121,42,85,.494,27,52,.519,15,33,.455,21,30,.700,120,2013-12-20,PHI,BRK
38,Home,W 121-119 (OT),265,46,91,.505,36,62,.581,10,29,.345,19,29,.655,121,44,91,.484,27,57,.474,17,34,.500,14,19,.737,119,2013-12-23,MIA,ATL
39,Home,W 121-114 ,240,49,100,.490,45,81,.556,4,19,.211,19,25,.760,121,43,91,.473,37,71,.521,6,20,.300,22,24,.917,114,2014-01-15,PHO,LAL
40,@,L 121-127 ,240,43,82,.524,27,55,.491,16,27,.593,19,34,.559,121,47,81,.580,38,59,.644,9,22,.409,24,33,.727,127,2014-01-17,GSW,OKC
41,Home,W 121-114 ,240,42,81,.519,30,50,.600,12,31,.387,25,27,.926,121,38,78,.487,23,45,.511,15,33,.455,23,28,.821,114,2014-01-20,ATL,MIA
42,@,W 121-120 ,240,47,94,.500,38,72,.528,9,22,.409,18,28,.643,121,49,89,.551,40,67,.597,9,22,.409,13,15,.867,120,2014-01-24,MIN,GSW
43,@,L 121-129 (2OT),290,45,95,.474,30,61,.492,15,34,.441,16,23,.696,121,49,99,.495,40,83,.482,9,16,.563,22,26,.846,129,2014-02-21,NYK,ORL
44,@,W 121-104 ,240,43,84,.512,32,62,.516,11,22,.500,24,33,.727,121,37,79,.468,34,60,.567,3,19,.158,27,36,.750,104,2014-02-22,MIN,UTA
45,Home,W 121-112 ,240,43,81,.531,34,61,.557,9,20,.450,26,35,.743,121,46,96,.479,39,78,.500,7,18,.389,13,17,.765,112,2014-03-08,SAS,ORL
46,Home,W 121-120 (OT),265,47,94,.500,44,79,.557,3,15,.200,24,28,.857,121,45,97,.464,33,71,.465,12,26,.462,18,23,.783,120,2014-03-16,NOP,BOS
47,@,W 121-113 ,240,38,75,.507,27,52,.519,11,23,.478,34,38,.895,121,42,85,.494,35,62,.565,7,23,.304,22,25,.880,113,2014-03-16,PHO,TOR
48,Home,L 121-122 (2OT),290,43,99,.434,32,63,.508,11,36,.306,24,30,.800,121,43,93,.462,31,61,.508,12,32,.375,24,34,.706,122,2014-04-04,MIA,MIN
49,Home,W 121-105 ,240,49,88,.557,41,66,.621,8,22,.364,15,23,.652,121,39,80,.488,32,61,.525,7,19,.368,20,26,.769,105,2014-10-29,BOS,BRK
50,Home,W 121-104 ,240,43,74,.581,28,49,.571,15,25,.600,20,20,1.000,121,38,82,.463,31,63,.492,7,19,.368,21,27,.778,104,2014-11-05,GSW,LAC
51,Home,L 121-122 ,240,48,88,.545,42,68,.618,6,20,.300,19,23,.826,121,43,85,.506,35,62,.565,8,23,.348,28,37,.757,122,2014-11-14,BOS,CLE
52,@,W 121-92 ,240,46,84,.548,33,63,.524,13,21,.619,16,18,.889,121,37,90,.411,33,77,.429,4,13,.308,14,22,.636,92,2014-11-21,SAS,MIN
53,Home,W 121-120 (OT),265,44,96,.458,35,65,.538,9,31,.290,24,30,.800,121,44,91,.484,28,54,.519,16,37,.432,16,20,.800,120,2014-12-08,LAC,PHO
54,@,W 121-114 ,240,48,81,.593,41,63,.651,7,18,.389,18,29,.621,121,41,84,.488,33,57,.579,8,27,.296,24,33,.727,114,2015-01-12,ORL,CHI
55,Home,L 121-126 ,240,43,91,.473,33,62,.532,10,29,.345,25,36,.694,121,46,83,.554,36,60,.600,10,23,.435,24,31,.774,126,2015-01-16,LAC,CLE
56,@,W 121-96 ,240,46,91,.505,36,68,.529,10,23,.435,19,26,.731,121,35,79,.443,28,63,.444,7,16,.438,19,24,.792,96,2015-02-03,GSW,SAC
57,@,W 121-115 (2OT),290,45,109,.413,39,91,.429,6,18,.333,25,26,.962,121,39,97,.402,31,66,.470,8,31,.258,29,40,.725,115,2015-02-27,NYK,DET
58,Home,W 121-113 ,240,46,85,.541,42,78,.538,4,7,.571,25,31,.806,121,43,88,.489,29,61,.475,14,27,.519,13,17,.765,113,2015-03-07,MIN,POR
59,Home,W 121-114 ,240,39,73,.534,30,49,.612,9,24,.375,34,48,.708,121,44,91,.484,33,64,.516,11,27,.407,15,22,.682,114,2015-04-12,HOU,NOP
60,@,W 121-115 ,240,41,77,.532,32,56,.571,9,21,.429,30,35,.857,121,42,84,.500,32,54,.593,10,30,.333,21,24,.875,115,2015-11-06,ATL,NOP
61,Home,W 121-97 ,240,45,80,.563,33,56,.589,12,24,.500,19,22,.864,121,34,82,.415,25,61,.410,9,21,.429,20,26,.769,97,2015-11-24,ATL,BOS
62,Home,W 121-112 ,240,42,87,.483,33,61,.541,9,26,.346,28,37,.757,121,42,91,.462,38,73,.521,4,18,.222,24,28,.857,112,2015-12-18,GSW,MIL
63,@,W 121-115 ,240,43,99,.434,29,58,.500,14,41,.341,21,25,.840,121,39,72,.542,28,52,.538,11,20,.550,26,39,.667,115,2015-12-29,ATL,HOU
64,Home,W 121-103 ,240,45,86,.523,32,62,.516,13,24,.542,18,19,.947,121,37,74,.500,28,52,.538,9,22,.409,20,33,.606,103,2016-01-02,SAS,HOU
65,@,W 121-115 ,240,48,89,.539,36,60,.600,12,29,.414,13,19,.684,121,42,76,.553,28,52,.538,14,24,.583,17,27,.630,115,2016-01-06,CLE,WAS
66,Home,W 121-103 ,240,47,93,.505,37,62,.597,10,31,.323,17,22,.773,121,34,69,.493,27,52,.519,7,17,.412,28,32,.875,103,2016-01-23,POR,LAL
67,Home,W 121-117 ,240,41,79,.519,33,61,.541,8,18,.444,31,37,.838,121,38,92,.413,29,68,.426,9,24,.375,32,38,.842,117,2016-01-30,MEM,SAC
68,Home,L 121-134 ,240,46,91,.505,38,68,.559,8,23,.348,21,30,.700,121,49,93,.527,29,52,.558,20,41,.488,16,29,.552,134,2016-02-03,WAS,GSW
69,@,W 121-119 (OT),265,48,92,.522,42,66,.636,6,26,.231,19,27,.704,121,36,75,.480,25,46,.543,11,29,.379,36,41,.878,119,2016-02-09,UTA,DAL
70,Home,W 121-95 ,240,45,86,.523,33,54,.611,12,32,.375,19,23,.826,121,38,88,.432,35,72,.486,3,16,.188,16,24,.667,95,2016-02-11,OKC,NOP
71,Home,W 121-114 ,240,41,81,.506,34,64,.531,7,17,.412,32,40,.800,121,40,76,.526,28,49,.571,12,27,.444,22,26,.846,114,2016-02-19,NOP,PHI
72,@,W 121-101 ,240,47,97,.485,37,65,.569,10,32,.313,17,20,.850,121,34,73,.466,28,52,.538,6,21,.286,27,34,.794,101,2016-02-21,BOS,DEN
73,@,W 121-118 (OT),265,45,95,.474,31,63,.492,14,32,.438,17,25,.680,121,46,96,.479,37,70,.529,9,26,.346,17,26,.654,118,2016-02-27,GSW,OKC
74,@,L 121-128 ,240,41,87,.471,26,51,.510,15,36,.417,24,35,.686,121,48,81,.593,40,66,.606,8,15,.533,24,33,.727,128,2016-02-29,HOU,MIL
75,Home,W 121-108 ,240,43,77,.558,34,58,.586,9,19,.474,26,31,.839,121,41,91,.451,32,61,.525,9,30,.300,17,20,.850,108,2016-03-01,DAL,ORL
76,Home,W 121-106 ,240,47,87,.540,36,53,.679,11,34,.324,16,21,.762,121,40,86,.465,36,66,.545,4,20,.200,22,27,.815,106,2016-03-03,GSW,OKC
77,@,W 121-120 (OT),265,46,91,.505,33,69,.478,13,22,.591,16,21,.762,121,46,96,.479,40,70,.571,6,26,.231,22,25,.880,120,2016-03-04,BRK,DEN
78,Home,W 121-114 (OT),265,47,96,.490,41,82,.500,6,14,.429,21,32,.656,121,42,96,.438,35,72,.486,7,24,.292,23,34,.676,114,2016-03-11,MEM,NOP
79,Home,W 121-84 ,240,47,84,.560,30,49,.612,17,35,.486,10,11,.909,121,34,91,.374,27,65,.415,7,26,.269,9,18,.500,84,2016-03-12,POR,ORL
80,Home,W 121-85 ,240,46,91,.505,28,54,.519,18,37,.486,11,12,.917,121,36,91,.396,29,72,.403,7,19,.368,6,10,.600,85,2016-03-16,GSW,NYK
81,Home,W 121-116 ,240,41,81,.506,34,55,.618,7,26,.269,32,40,.800,121,41,84,.488,26,51,.510,15,33,.455,19,23,.826,116,2016-03-28,MIN,PHO
82,Home,W 121-103 ,240,48,95,.505,40,67,.597,8,28,.286,17,20,.850,121,39,92,.424,32,75,.427,7,17,.412,18,24,.750,103,2016-04-06,WAS,BRK
83,@,W 121-100 ,240,43,83,.518,33,58,.569,10,25,.400,25,31,.806,121,39,95,.411,32,74,.432,7,21,.333,15,20,.750,100,2016-04-09,PHO,NOP
84,@,W 121-116 ,240,44,77,.571,34,54,.630,10,23,.435,23,26,.885,121,41,80,.513,29,54,.537,12,26,.462,22,28,.786,116,2016-04-11,CHI,NOP
85,@,L 121-130 (OT),265,45,104,.433,27,56,.482,18,48,.375,13,18,.722,121,47,93,.505,37,74,.500,10,19,.526,26,34,.765,130,2016-10-26,DAL,IND
86,@,L 121-124 ,240,43,86,.500,36,65,.554,7,21,.333,28,33,.848,121,45,81,.556,31,50,.620,14,31,.452,20,28,.714,124,2016-11-08,PHO,POR
87,Home,W 121-117 ,240,44,83,.530,31,50,.620,13,33,.394,20,28,.714,121,46,96,.479,33,67,.493,13,29,.448,12,18,.667,117,2016-11-15,CLE,TOR
88,Home,L 121-127 ,240,37,82,.451,27,57,.474,10,25,.400,37,41,.902,121,44,87,.506,31,51,.608,13,36,.361,26,28,.929,127,2016-11-16,TOR,GSW
89,@,W 121-115 ,240,40,76,.526,27,47,.574,13,29,.448,28,34,.824,121,38,86,.442,28,60,.467,10,26,.385,29,35,.829,115,2016-11-18,LAC,SAC
90,Home,L 121-124 ,240,46,89,.517,36,69,.522,10,20,.500,19,25,.760,121,42,95,.442,28,57,.491,14,38,.368,26,32,.813,124,2016-11-19,MIL,GSW
91,Home,W 121-116 (OT),265,43,98,.439,29,62,.468,14,36,.389,21,25,.840,121,40,97,.412,25,54,.463,15,43,.349,21,28,.750,116,2016-11-19,NOP,CHO
92,@,W 121-114 ,240,48,87,.552,39,67,.582,9,20,.450,16,21,.762,121,40,91,.440,25,49,.510,15,42,.357,19,20,.950,114,2016-11-30,DET,BOS
93,@,W 121-85 ,240,48,89,.539,31,60,.517,17,29,.586,8,12,.667,121,32,88,.364,26,64,.406,6,24,.250,15,20,.750,85,2016-12-02,DET,ATL
94,@,W 121-113 ,240,47,83,.566,39,64,.609,8,19,.421,19,25,.760,121,43,88,.489,32,61,.525,11,27,.407,16,24,.667,113,2016-12-10,DEN,ORL
95,Home,W 121-120 ,240,42,89,.472,31,66,.470,11,23,.478,26,28,.929,121,44,87,.506,34,66,.515,10,21,.476,22,25,.880,120,2016-12-12,LAC,POR
96,Home,L 121-125 ,240,47,86,.547,37,65,.569,10,21,.476,17,26,.654,121,46,86,.535,35,61,.574,11,25,.440,22,32,.688,125,2016-12-16,TOR,ATL
97,@,L 121-126 ,240,44,86,.512,40,59,.678,4,27,.148,29,40,.725,121,40,72,.556,30,49,.612,10,23,.435,36,43,.837,126,2016-12-20,POR,SAC
98,@,W 121-110 ,240,45,88,.511,34,60,.567,11,28,.393,20,24,.833,121,42,88,.477,34,68,.500,8,20,.400,18,23,.783,110,2016-12-21,OKC,NOP
99,Home,W 121-111 ,240,46,81,.568,32,58,.552,14,23,.609,15,18,.833,121,40,103,.388,27,68,.397,13,35,.371,18,22,.818,111,2016-12-28,GSW,TOR
0,@,W 121-109 ,240,43,85,.506,29,54,.537,14,31,.452,21,25,.840,121,40,78,.513,31,54,.574,9,24,.375,20,23,.870,109,2016-12-31,CLE,CHO
1,@,W 121-116 ,240,43,74,.581,34,58,.586,9,16,.563,26,30,.867,121,48,97,.495,38,68,.559,10,29,.345,10,12,.833,116,2017-01-03,IND,DET
2,Home,W 121-109 ,240,48,93,.516,38,71,.535,10,22,.455,15,19,.789,121,41,90,.456,24,52,.462,17,38,.447,10,13,.769,109,2017-01-05,IND,BRK
3,Home,W 121-106 ,240,43,89,.483,31,53,.585,12,36,.333,23,29,.793,121,40,99,.404,31,75,.413,9,24,.375,17,24,.708,106,2017-01-07,OKC,DEN
4,Home,W 121-114 ,240,40,82,.488,23,43,.535,17,39,.436,24,33,.727,121,44,92,.478,25,49,.510,19,43,.442,7,9,.778,114,2017-01-10,HOU,CHO
5,Home,L 121-127 ,240,47,108,.435,36,78,.462,11,30,.367,16,18,.889,121,50,88,.568,39,62,.629,11,26,.423,16,26,.615,127,2017-01-17,LAL,DEN
6,Home,W 121-100 ,240,46,85,.541,36,64,.563,10,21,.476,19,27,.704,121,38,90,.422,30,62,.484,8,28,.286,16,19,.842,100,2017-01-18,GSW,OKC
7,Home,W 121-110 ,240,45,90,.500,35,61,.574,10,29,.345,21,22,.955,121,33,71,.465,15,37,.405,18,34,.529,26,41,.634,110,2017-01-24,PHI,LAC
8,Home,W 121-108 ,240,45,89,.506,37,75,.493,8,14,.571,23,28,.821,121,44,99,.444,34,71,.479,10,28,.357,10,14,.714,108,2017-01-29,CHI,PHI
9,Home,W 121-117 ,240,40,89,.449,31,61,.508,9,28,.321,32,44,.727,121,45,83,.542,36,59,.610,9,24,.375,18,23,.783,117,2017-02-03,DEN,MIL
10,Home,W 121-117 (OT),265,44,98,.449,28,55,.509,16,43,.372,17,25,.680,121,48,100,.480,40,75,.533,8,25,.320,13,18,.722,117,2017-02-03,HOU,CHI
11,Home,W 121-97 ,240,45,79,.570,35,58,.603,10,21,.476,21,26,.808,121,41,92,.446,31,66,.470,10,26,.385,5,10,.500,97,2017-02-04,SAS,DEN
12,@,W 121-107 ,240,44,102,.431,36,74,.486,8,28,.286,25,31,.806,121,37,82,.451,30,61,.492,7,21,.333,26,33,.788,107,2017-02-06,LAL,NYK
13,Home,W 121-102 ,240,51,97,.526,47,81,.580,4,16,.250,15,24,.625,121,37,86,.430,31,63,.492,6,23,.261,22,26,.846,102,2017-02-08,DET,LAL
14,@,L 121-128 (OT),265,49,93,.527,41,69,.594,8,24,.333,15,25,.600,121,46,98,.469,34,72,.472,12,26,.462,24,31,.774,128,2017-02-24,PHO,CHI
15,@,L 121-124 (OT),265,38,80,.475,20,40,.500,18,40,.450,27,30,.900,121,45,97,.464,35,65,.538,10,32,.313,24,34,.706,124,2017-02-26,CHO,LAC
16,Home,L 121-126 ,240,44,85,.518,34,60,.567,10,25,.400,23,30,.767,121,47,85,.553,36,62,.581,11,23,.478,21,27,.778,126,2017-03-07,OKC,POR
17,Home,W 120-89 ,240,47,85,.553,35,67,.522,12,18,.667,14,19,.737,120,36,81,.444,32,64,.500,4,17,.235,13,20,.650,89,2012-01-13,PHI,WAS
18,Home,W 120-98 ,240,46,79,.582,30,53,.566,16,26,.615,12,19,.632,120,38,80,.475,28,55,.509,10,25,.400,12,17,.706,98,2012-01-17,MIA,SAS
19,@,W 120-109 ,240,42,88,.477,38,71,.535,4,17,.235,32,37,.865,120,41,87,.471,29,59,.492,12,28,.429,15,19,.789,109,2012-01-27,OKC,GSW
20,@,W 120-108 ,240,43,74,.581,37,57,.649,6,17,.353,28,31,.903,120,40,85,.471,33,66,.500,7,19,.368,21,30,.700,108,2012-01-30,MIN,HOU
21,@,W 120-103 ,240,41,78,.526,35,63,.556,6,15,.400,32,39,.821,120,40,77,.519,31,61,.508,9,16,.563,14,17,.824,103,2012-02-01,PHO,NOH
22,Home,W 120-108 ,240,45,81,.556,35,58,.603,10,23,.435,20,23,.870,120,40,89,.449,27,62,.435,13,27,.481,15,19,.789,108,2012-02-21,MIA,SAC
23,Home,W 120-103 ,240,43,85,.506,37,65,.569,6,20,.300,28,42,.667,120,38,82,.463,29,62,.468,9,20,.450,18,27,.667,103,2012-02-29,NYK,CLE
24,@,W 120-100 ,240,45,83,.542,30,60,.500,15,23,.652,15,16,.938,120,36,85,.424,28,63,.444,8,22,.364,20,36,.556,100,2012-03-05,GSW,WAS
25,@,W 120-108 ,240,43,84,.512,29,57,.509,14,27,.519,20,24,.833,120,38,78,.487,26,48,.542,12,30,.400,20,32,.625,108,2012-03-09,LAC,SAS
26,Home,W 120-111 ,240,44,78,.564,35,59,.593,9,19,.474,23,32,.719,120,47,90,.522,42,77,.545,5,13,.385,12,17,.706,111,2012-03-14,PHO,UTA
27,@,W 120-98 ,240,45,93,.484,35,71,.493,10,22,.455,20,22,.909,120,35,79,.443,25,57,.439,10,22,.455,18,20,.900,98,2012-03-16,MIL,GSW
28,Home,W 120-95 ,240,46,86,.535,37,65,.569,9,21,.429,19,21,.905,120,36,80,.450,30,61,.492,6,19,.316,17,21,.810,95,2012-03-16,SAC,BOS
29,Home,W 120-112 ,240,44,82,.537,34,63,.540,10,19,.526,22,31,.710,120,44,90,.489,33,69,.478,11,21,.524,13,15,.867,112,2012-04-01,LAL,GSW
30,Home,W 120-93 ,240,47,83,.566,38,64,.594,9,19,.474,17,19,.895,120,36,79,.456,31,65,.477,5,14,.357,16,20,.800,93,2012-04-04,ATL,CHA
31,@,W 120-99 ,240,36,92,.391,24,65,.369,12,27,.444,36,43,.837,120,38,93,.409,30,73,.411,8,20,.400,15,17,.882,99,2012-04-16,SAS,GSW
32,Home,W 120-107 ,240,43,79,.544,35,63,.556,8,16,.500,26,32,.813,120,39,75,.520,33,62,.532,6,13,.462,23,28,.821,107,2012-10-30,MIA,BOS
33,Home,W 120-98 ,240,47,87,.540,38,65,.585,9,22,.409,17,22,.773,120,36,87,.414,28,66,.424,8,21,.381,18,30,.600,98,2012-11-28,OKC,HOU
34,@,W 120-97 ,240,46,82,.561,38,62,.613,8,20,.400,20,24,.833,120,37,83,.446,31,63,.492,6,20,.300,17,20,.850,97,2012-12-25,HOU,CHI
35,Home,W 120-91 ,240,46,82,.561,39,71,.549,7,11,.636,21,25,.840,120,37,87,.425,32,69,.464,5,18,.278,12,15,.800,91,2013-01-14,WAS,ORL
36,Home,W 120-81 ,240,47,86,.547,28,43,.651,19,43,.442,7,13,.538,120,32,76,.421,26,55,.473,6,21,.286,11,15,.733,81,2013-02-02,NYK,SAC
37,Home,W 120-109 ,240,44,85,.518,36,66,.545,8,19,.421,24,35,.686,120,40,82,.488,36,67,.537,4,15,.267,25,26,.962,109,2013-02-09,SAC,UTA
38,@,W 120-113 ,240,46,85,.541,38,69,.551,8,16,.500,20,32,.625,120,39,85,.459,27,54,.500,12,31,.387,23,28,.821,113,2013-03-05,DEN,SAC
39,@,W 120-117 ,240,44,82,.537,34,60,.567,10,22,.455,22,38,.579,120,45,97,.464,40,80,.500,5,17,.294,22,30,.733,117,2013-03-27,LAL,MIN
40,Home,L 120-125 ,240,45,78,.577,36,61,.590,9,17,.529,21,25,.840,120,46,93,.495,31,59,.525,15,34,.441,18,24,.750,125,2013-04-07,OKC,NYK
41,Home,W 120-99 ,240,45,80,.563,25,44,.568,20,36,.556,10,14,.714,120,35,77,.455,27,57,.474,8,20,.400,21,30,.700,99,2013-04-09,NYK,WAS
42,@,W 120-88 ,240,48,81,.593,38,65,.585,10,16,.625,14,19,.737,120,35,83,.422,30,69,.435,5,14,.357,13,15,.867,88,2013-04-13,BOS,ORL
43,Home,W 120-115 (OT),265,42,100,.420,34,75,.453,8,25,.320,28,34,.824,120,47,100,.470,37,73,.507,10,27,.370,11,18,.611,115,2013-10-30,MIN,ORL
44,@,W 120-89 ,240,41,76,.539,29,48,.604,12,28,.429,26,30,.867,120,31,82,.378,25,60,.417,6,22,.273,21,29,.724,89,2013-11-10,SAS,NYK
45,Home,W 120-105 ,240,51,85,.600,46,73,.630,5,12,.417,13,15,.867,120,39,85,.459,32,67,.478,7,18,.389,20,23,.870,105,2013-11-11,BOS,ORL
46,@,L 120-123 ,240,42,76,.553,30,45,.667,12,31,.387,24,33,.727,120,42,72,.583,31,50,.620,11,22,.500,28,33,.848,123,2013-11-20,HOU,DAL
47,@,W 120-92 ,240,38,74,.514,23,50,.460,15,24,.625,29,32,.906,120,29,71,.408,14,42,.333,15,29,.517,19,21,.905,92,2013-11-20,MIA,ORL
48,Home,W 120-106 ,240,42,81,.519,32,57,.561,10,24,.417,26,31,.839,120,39,86,.453,32,67,.478,7,19,.368,21,24,.875,106,2013-11-27,PHO,POR
49,Home,W 120-109 ,240,46,93,.495,39,74,.527,7,19,.368,21,26,.808,120,40,94,.426,26,54,.481,14,40,.350,15,19,.789,109,2013-12-18,MIN,POR
50,@,L 120-121 (OT),265,42,85,.494,27,52,.519,15,33,.455,21,30,.700,120,51,100,.510,42,71,.592,9,29,.310,10,15,.667,121,2013-12-20,BRK,PHI
51,Home,W 120-116 (OT),265,46,97,.474,39,68,.574,7,29,.241,21,27,.778,120,45,96,.469,39,74,.527,6,22,.273,20,27,.741,116,2013-12-22,LAC,MIN
52,Home,W 120-98 ,240,42,85,.494,37,70,.529,5,15,.333,31,38,.816,120,38,83,.458,30,62,.484,8,21,.381,14,17,.824,98,2013-12-27,MIN,WAS
53,Home,W 120-99 ,240,47,91,.516,39,72,.542,8,19,.421,18,25,.720,120,33,70,.471,23,48,.479,10,22,.455,23,28,.821,99,2013-12-28,MEM,DEN
54,Home,W 120-94 ,240,44,87,.506,32,59,.542,12,28,.429,20,26,.769,120,37,84,.440,33,64,.516,4,20,.200,16,23,.696,94,2014-01-11,DEN,ORL
55,@,W 120-118 ,240,41,88,.466,28,71,.394,13,17,.765,25,32,.781,120,44,84,.524,31,50,.620,13,34,.382,17,23,.739,118,2014-01-14,CLE,LAL
56,Home,L 120-121 ,240,49,89,.551,40,67,.597,9,22,.409,13,15,.867,120,47,94,.500,38,72,.528,9,22,.409,18,28,.643,121,2014-01-24,GSW,MIN
57,@,W 120-95 ,240,49,77,.636,44,62,.710,5,15,.333,17,20,.850,120,35,74,.473,24,50,.480,11,24,.458,14,17,.824,95,2014-01-31,OKC,BRK
58,Home,W 120-113 ,240,43,92,.467,34,69,.493,9,23,.391,25,30,.833,120,37,84,.440,31,68,.456,6,16,.375,33,39,.846,113,2014-02-01,ATL,MIN
59,Home,W 120-110 ,240,44,82,.537,35,63,.556,9,19,.474,23,25,.920,120,45,90,.500,40,80,.500,5,10,.500,15,17,.882,110,2014-02-26,SAS,DET
60,@,L 120-129 ,240,44,84,.524,30,53,.566,14,31,.452,18,26,.692,120,44,80,.550,29,56,.518,15,24,.625,26,30,.867,129,2014-03-02,ATL,PHO
61,@,W 120-112 ,240,47,92,.511,37,70,.529,10,22,.455,16,24,.667,120,45,93,.484,36,69,.522,9,24,.375,13,13,1.000,112,2014-03-12,DEN,ORL
62,@,L 120-121 (OT),265,45,97,.464,33,71,.465,12,26,.462,18,23,.783,120,47,94,.500,44,79,.557,3,15,.200,24,28,.857,121,2014-03-16,BOS,NOP
63,Home,W 120-115 (OT),265,42,97,.433,30,58,.517,12,39,.308,24,27,.889,120,45,98,.459,37,81,.457,8,17,.471,17,26,.654,115,2014-03-18,POR,MIL
64,Home,L 120-127 ,240,40,91,.440,32,68,.471,8,23,.348,32,37,.865,120,46,80,.575,34,53,.642,12,27,.444,23,29,.793,127,2014-03-23,MIN,PHO
65,Home,W 120-98 ,240,44,90,.489,35,64,.547,9,26,.346,23,34,.676,120,35,90,.389,21,54,.389,14,36,.389,14,22,.636,98,2014-03-27,HOU,PHI
66,Home,L 120-122 (OT),265,47,96,.490,33,66,.500,14,30,.467,12,16,.750,120,52,91,.571,37,60,.617,15,31,.484,3,6,.500,122,2014-04-01,DAL,GSW
67,Home,W 120-97 ,240,47,83,.566,37,64,.578,10,19,.526,16,26,.615,120,36,86,.419,29,55,.527,7,31,.226,18,23,.783,97,2014-04-06,LAC,LAL
68,@,L 120-130 ,240,43,81,.531,35,66,.530,8,15,.533,26,33,.788,120,49,101,.485,34,64,.531,15,37,.405,17,19,.895,130,2014-04-14,MIN,GSW
69,Home,W 120-102 ,240,47,85,.553,39,64,.609,8,21,.381,18,23,.783,120,36,83,.434,22,48,.458,14,35,.400,16,18,.889,102,2014-10-30,DAL,UTA
70,Home,W 120-88 ,240,43,76,.566,36,59,.610,7,17,.412,27,30,.900,120,33,87,.379,23,53,.434,10,34,.294,12,18,.667,88,2014-11-09,TOR,PHI
71,Home,W 120-107 ,240,36,68,.529,22,39,.564,14,29,.483,34,43,.791,120,38,99,.384,27,69,.391,11,30,.367,20,23,.870,107,2014-11-15,LAC,PHO
72,Home,W 120-112 ,240,45,88,.511,32,63,.508,13,25,.520,17,21,.810,120,39,90,.433,31,65,.477,8,25,.320,26,34,.765,112,2014-11-26,PHO,DEN
73,@,W 120-119 ,240,45,79,.570,35,61,.574,10,18,.556,20,24,.833,120,48,89,.539,40,68,.588,8,21,.381,15,22,.682,119,2014-11-28,MIN,LAL
74,Home,W 120-100 ,240,43,78,.551,26,46,.565,17,32,.531,17,24,.708,120,38,80,.475,30,57,.526,8,23,.348,16,25,.640,100,2014-12-06,LAC,NOP
75,@,L 120-121 (OT),265,44,91,.484,28,54,.519,16,37,.432,16,20,.800,120,44,96,.458,35,65,.538,9,31,.290,24,30,.800,121,2014-12-08,PHO,LAC
76,@,W 120-115 (OT),265,45,93,.484,34,67,.507,11,26,.423,19,27,.704,120,40,82,.488,29,54,.537,11,28,.393,24,34,.706,115,2014-12-13,MEM,PHI
77,@,L 120-129 ,240,44,100,.440,35,70,.500,9,30,.300,23,32,.719,120,40,74,.541,34,62,.548,6,12,.500,43,47,.915,129,2014-12-22,TOR,CHI
78,@,W 120-96 ,240,41,77,.532,25,41,.610,16,36,.444,22,32,.688,120,37,80,.463,26,54,.481,11,26,.423,11,21,.524,96,2015-01-08,HOU,NYK
79,Home,W 120-100 ,240,46,88,.523,33,57,.579,13,31,.419,15,21,.714,120,38,86,.442,26,56,.464,12,30,.400,12,17,.706,100,2015-01-10,LAC,DAL
80,Home,W 120-89 ,240,42,89,.472,26,58,.448,16,31,.516,20,24,.833,120,36,76,.474,31,56,.554,5,20,.250,12,15,.800,89,2015-01-11,ATL,WAS
81,Home,W 120-113 ,240,44,90,.489,35,64,.547,9,26,.346,23,26,.885,120,42,83,.506,33,57,.579,9,26,.346,20,23,.870,113,2015-01-14,ORL,HOU
82,@,W 120-100 ,240,43,87,.494,33,64,.516,10,23,.435,24,36,.667,120,34,80,.425,24,51,.471,10,29,.345,22,27,.815,100,2015-01-25,LAC,PHO
83,@,W 120-116 (OT),265,44,88,.500,33,62,.532,11,26,.423,21,30,.700,120,37,79,.468,27,55,.491,10,24,.417,32,41,.780,116,2015-01-31,TOR,WAS
84,Home,W 120-105 ,240,45,82,.549,27,49,.551,18,33,.545,12,20,.600,120,41,100,.410,34,77,.442,7,23,.304,16,19,.842,105,2015-02-08,CLE,LAL
85,@,W 120-112 ,240,40,78,.513,25,42,.595,15,36,.417,25,34,.735,120,43,79,.544,33,58,.569,10,21,.476,16,17,.941,112,2015-03-04,CLE,TOR
86,Home,W 120-111 ,240,43,79,.544,34,55,.618,9,24,.375,25,33,.758,120,45,86,.523,39,69,.565,6,17,.353,15,23,.652,111,2015-03-06,SAS,DEN
87,@,W 120-108 ,240,35,76,.461,20,46,.435,15,30,.500,35,47,.745,120,33,76,.434,21,51,.412,12,25,.480,30,36,.833,108,2015-03-11,LAC,OKC
88,Home,W 120-110 ,240,44,83,.530,24,39,.615,20,44,.455,12,17,.706,120,37,76,.487,31,62,.500,6,14,.429,30,34,.882,110,2015-03-27,HOU,MIN
89,Home,W 120-114 ,240,48,85,.565,40,67,.597,8,18,.444,16,18,.889,120,43,92,.467,34,68,.500,9,24,.375,19,22,.864,114,2015-03-28,POR,DEN
90,@,W 120-106 ,240,45,83,.542,35,62,.565,10,21,.476,20,26,.769,120,34,78,.436,25,54,.463,9,24,.375,29,36,.806,106,2015-04-12,DAL,LAL
91,Home,L 120-134 ,240,46,100,.460,38,78,.487,8,22,.364,20,23,.870,120,46,84,.548,29,54,.537,17,30,.567,25,35,.714,134,2015-10-31,NOP,GSW
92,@,W 120-109 ,240,43,85,.506,36,65,.554,7,20,.350,27,31,.871,120,36,86,.419,30,60,.500,6,26,.231,31,38,.816,109,2015-11-03,DEN,LAL
93,@,W 120-103 ,240,47,96,.490,36,66,.545,11,30,.367,15,22,.682,120,41,76,.539,32,51,.627,9,25,.360,12,18,.667,103,2015-11-08,DET,POR
94,Home,W 120-105 ,240,46,92,.500,32,59,.542,14,33,.424,14,18,.778,120,39,88,.443,34,68,.500,5,20,.250,22,26,.846,105,2015-11-10,NOP,DAL
95,Home,W 120-101 ,240,45,93,.484,34,63,.540,11,30,.367,19,25,.760,120,37,77,.481,28,57,.491,9,20,.450,18,20,.900,101,2015-11-16,PHO,LAL
96,Home,W 120-95 ,240,51,87,.586,41,58,.707,10,29,.345,8,10,.800,120,35,89,.393,27,70,.386,8,19,.421,17,24,.708,95,2015-11-20,BOS,BRK
97,@,W 120-114 ,240,42,81,.519,32,59,.542,10,22,.455,26,34,.765,120,44,96,.458,34,70,.486,10,26,.385,16,20,.800,114,2015-11-25,NOP,PHO
98,Home,W 120-101 ,240,39,80,.488,23,50,.460,16,30,.533,26,31,.839,120,39,100,.390,29,75,.387,10,25,.400,13,15,.867,101,2015-11-28,GSW,SAC
99,Home,W 120-113 ,240,36,78,.462,20,44,.455,16,34,.471,32,43,.744,120,46,98,.469,36,72,.500,10,26,.385,11,13,.846,113,2015-12-05,HOU,SAC
0,@,W 120-85 ,240,51,95,.537,46,76,.605,5,19,.263,13,17,.765,120,32,89,.360,25,64,.391,7,25,.280,14,22,.636,85,2015-12-23,OKC,LAL
1,@,W 120-116 ,240,45,77,.584,39,63,.619,6,14,.429,24,35,.686,120,41,82,.500,28,52,.538,13,30,.433,21,26,.808,116,2015-12-31,MIL,IND
2,Home,W 120-105 ,240,49,94,.521,39,70,.557,10,24,.417,12,15,.800,120,36,83,.434,29,65,.446,7,18,.389,26,31,.839,105,2016-01-09,ATL,CHI
3,Home,W 120-114 ,240,43,81,.531,36,61,.590,7,20,.350,27,30,.900,120,42,86,.488,33,57,.579,9,29,.310,21,26,.808,114,2016-01-12,NYK,BOS
4,@,W 120-116 (OT),265,45,101,.446,35,74,.473,10,27,.370,20,22,.909,120,45,91,.495,34,68,.500,11,23,.478,15,19,.789,116,2016-01-22,CHO,ORL
5,Home,W 120-90 ,240,44,85,.518,33,59,.559,11,26,.423,21,25,.840,120,31,74,.419,26,60,.433,5,14,.357,23,31,.742,90,2016-01-25,GSW,SAS
6,Home,W 120-93 ,240,45,84,.536,28,52,.538,17,32,.531,13,19,.684,120,40,93,.430,35,78,.449,5,15,.333,8,11,.727,93,2016-01-31,LAC,CHI
7,Home,W 120-100 ,240,45,94,.479,29,59,.492,16,35,.457,14,19,.737,120,36,82,.439,27,59,.458,9,23,.391,19,29,.655,100,2016-02-08,CLE,SAC
8,Home,W 120-111 ,240,48,94,.511,35,63,.556,13,31,.419,11,18,.611,120,38,86,.442,25,58,.431,13,28,.464,22,27,.815,111,2016-02-10,CLE,LAL
9,Home,L 120-121 (OT),265,46,96,.479,40,70,.571,6,26,.231,22,25,.880,120,46,91,.505,33,69,.478,13,22,.591,16,21,.762,121,2016-03-04,DEN,BRK
10,Home,W 120-103 ,240,42,82,.512,32,52,.615,10,30,.333,26,34,.765,120,37,80,.463,27,57,.474,10,23,.435,19,27,.704,103,2016-03-05,CLE,BOS
11,Home,W 120-108 ,240,48,91,.527,39,67,.582,9,24,.375,15,18,.833,120,41,81,.506,29,47,.617,12,34,.353,14,23,.609,108,2016-03-09,OKC,LAC
12,@,W 120-111 ,240,39,90,.433,26,46,.565,13,44,.295,29,35,.829,120,40,84,.476,32,62,.516,8,22,.364,23,32,.719,111,2016-03-09,CLE,SAC
13,@,W 120-108 ,240,45,85,.529,29,50,.580,16,35,.457,14,20,.700,120,42,80,.525,35,58,.603,7,22,.318,17,21,.810,108,2016-03-10,CLE,LAL
14,@,L 120-132 (OT),265,42,104,.404,24,58,.414,18,46,.391,18,28,.643,120,49,89,.551,34,64,.531,15,25,.600,19,23,.826,132,2016-03-20,POR,DAL
15,@,W 120-105 ,240,46,94,.489,36,69,.522,10,25,.400,18,21,.857,120,39,92,.424,31,71,.437,8,21,.381,19,27,.704,105,2016-03-20,BOS,PHI
16,@,L 120-128 ,240,43,96,.448,25,61,.410,18,35,.514,16,21,.762,120,43,88,.489,22,43,.512,21,45,.467,21,23,.913,128,2016-03-25,DAL,GSW
17,Home,W 120-110 ,240,42,77,.545,37,66,.561,5,11,.455,31,36,.861,120,37,77,.481,26,53,.491,11,24,.458,25,30,.833,110,2016-03-26,BRK,IND
18,Home,W 120-111 ,240,47,84,.560,39,66,.591,8,18,.444,18,25,.720,120,43,89,.483,34,63,.540,9,26,.346,16,20,.800,111,2016-03-30,SAC,WAS
19,Home,W 120-115 ,240,43,84,.512,28,51,.549,15,33,.455,19,24,.792,120,43,91,.473,34,69,.493,9,22,.409,20,31,.645,115,2016-04-06,POR,OKC
20,@,W 120-111 ,240,46,89,.517,37,64,.578,9,25,.360,19,24,.792,120,44,98,.449,34,67,.507,10,31,.323,13,21,.619,111,2016-04-11,WAS,BRK
21,Home,W 120-114 ,240,45,89,.506,33,54,.611,12,35,.343,18,22,.818,120,44,86,.512,37,57,.649,7,29,.241,19,27,.704,114,2016-10-26,LAL,HOU
22,@,L 120-128 ,240,43,90,.478,26,46,.565,17,44,.386,17,25,.680,120,43,83,.518,27,51,.529,16,32,.500,26,31,.839,128,2016-11-01,HOU,CLE
23,@,L 120-122 (OT),265,43,88,.489,37,67,.552,6,21,.286,28,35,.800,120,45,86,.523,32,53,.604,13,33,.394,19,27,.704,122,2016-11-11,SAC,POR
24,@,L 120-133 ,240,46,90,.511,38,66,.576,8,24,.333,20,26,.769,120,45,87,.517,29,54,.537,16,33,.485,27,31,.871,133,2016-11-13,PHO,GSW
25,Home,W 120-104 ,240,45,93,.484,37,76,.487,8,17,.471,22,24,.917,120,39,79,.494,31,59,.525,8,20,.400,18,29,.621,104,2016-11-16,DEN,PHO
26,Home,W 120-105 ,240,45,86,.523,28,51,.549,17,35,.486,13,20,.650,120,39,92,.424,33,71,.465,6,21,.286,21,34,.618,105,2016-11-19,PHI,PHO
27,@,W 120-83 ,240,40,90,.444,27,54,.500,13,36,.361,27,32,.844,120,33,103,.320,27,80,.338,6,23,.261,11,12,.917,83,2016-11-21,GSW,IND
28,@,W 120-114 ,240,39,89,.438,26,60,.433,13,29,.448,29,32,.906,120,36,89,.404,25,64,.391,11,25,.440,31,36,.861,114,2016-11-27,DEN,PHO
29,Home,W 120-101 ,240,41,74,.554,26,46,.565,15,28,.536,23,27,.852,120,37,91,.407,26,61,.426,11,30,.367,16,22,.727,101,2016-11-29,UTA,HOU
30,Home,W 120-105 ,240,38,69,.551,22,37,.595,16,32,.500,28,33,.848,120,36,81,.444,25,54,.463,11,27,.407,22,26,.846,105,2016-11-30,TOR,MEM
31,Home,L 120-125 (OT),265,44,101,.436,30,65,.462,14,36,.389,18,26,.692,120,48,106,.453,38,79,.481,10,27,.370,19,22,.864,125,2016-12-03,CHO,MIN
32,@,W 120-89 ,240,47,84,.560,37,62,.597,10,22,.455,16,21,.762,120,32,78,.410,22,48,.458,10,30,.333,15,20,.750,89,2016-12-07,SAC,DAL
33,@,W 120-119 (OT),265,38,97,.392,22,57,.386,16,40,.400,28,35,.800,120,44,96,.458,30,55,.545,14,41,.341,17,26,.654,119,2016-12-11,NOP,PHO
34,@,L 120-121 ,240,44,87,.506,34,66,.515,10,21,.476,22,25,.880,120,42,89,.472,31,66,.470,11,23,.478,26,28,.929,121,2016-12-12,POR,LAC
35,Home,L 120-131 ,240,45,89,.506,34,61,.557,11,28,.393,19,21,.905,120,51,87,.586,36,53,.679,15,34,.441,14,20,.700,131,2016-12-13,ATL,ORL
36,@,L 120-132 ,240,41,88,.466,33,65,.508,8,23,.348,30,36,.833,120,43,84,.512,28,53,.528,15,31,.484,31,35,.886,132,2016-12-15,POR,DEN
37,Home,W 120-118 ,240,40,75,.533,25,44,.568,15,31,.484,25,31,.806,120,44,94,.468,36,68,.529,8,26,.308,22,25,.880,118,2016-12-26,BRK,CHO
38,@,W 120-101 ,240,46,84,.548,36,60,.600,10,24,.417,18,19,.947,120,42,86,.488,33,52,.635,9,34,.265,8,10,.800,101,2016-12-28,CHO,ORL
39,@,W 120-113 ,240,46,88,.523,35,59,.593,11,29,.379,17,18,.944,120,41,82,.500,23,44,.523,18,38,.474,13,13,1.000,113,2017-01-03,SAC,DEN
40,@,W 120-116 ,240,44,82,.537,29,48,.604,15,34,.441,17,19,.895,120,46,87,.529,37,60,.617,9,27,.333,15,19,.789,116,2017-01-08,CLE,PHO
41,@,W 120-108 ,240,44,87,.506,29,50,.580,15,37,.405,17,22,.773,120,42,80,.525,33,55,.600,9,25,.360,15,19,.789,108,2017-01-13,CLE,SAC
42,Home,W 120-98 ,240,45,82,.549,33,54,.611,12,28,.429,18,22,.818,120,36,85,.424,26,55,.473,10,30,.333,16,19,.842,98,2017-01-16,LAC,OKC
43,Home,W 120-101 ,240,42,86,.488,29,63,.460,13,23,.565,23,25,.920,120,37,88,.420,29,62,.468,8,26,.308,19,25,.760,101,2017-01-16,WAS,POR
44,Home,W 120-109 ,240,47,91,.516,36,59,.610,11,32,.344,15,16,.938,120,36,77,.468,26,46,.565,10,31,.323,27,38,.711,109,2017-01-25,BOS,HOU
45,@,L 120-127 ,240,48,89,.539,38,65,.585,10,24,.417,14,17,.824,120,44,86,.512,35,63,.556,9,23,.391,30,35,.857,127,2017-01-26,PHO,DEN
46,Home,W 120-101 ,240,47,87,.540,42,66,.636,5,21,.238,21,26,.808,120,34,83,.410,23,44,.523,11,39,.282,22,25,.880,101,2017-01-29,IND,HOU
47,Home,W 120-116 ,240,47,89,.528,35,63,.556,12,26,.462,14,18,.778,120,41,99,.414,26,72,.361,15,27,.556,19,23,.826,116,2017-01-31,LAL,DEN
48,Home,L 120-133 ,240,40,80,.500,30,55,.545,10,25,.400,30,39,.769,120,52,99,.525,38,65,.585,14,34,.412,15,18,.833,133,2017-02-02,LAC,GSW
49,@,W 120-95 ,240,49,80,.613,39,54,.722,10,26,.385,12,18,.667,120,33,74,.446,27,57,.474,6,17,.353,23,32,.719,95,2017-02-06,UTA,ATL
50,@,W 120-111 ,240,44,91,.484,34,61,.557,10,30,.333,22,27,.815,120,39,77,.506,30,51,.588,9,26,.346,24,31,.774,111,2017-02-09,BOS,POR
51,Home,W 120-98 ,240,42,73,.575,29,53,.547,13,20,.650,23,28,.821,120,34,96,.354,27,62,.435,7,34,.206,23,30,.767,98,2017-02-13,WAS,OKC
52,Home,W 120-112 ,240,43,87,.494,33,58,.569,10,29,.345,24,30,.800,120,38,90,.422,33,66,.500,5,24,.208,31,40,.775,112,2017-02-24,PHI,WAS
53,Home,W 120-113 (OT),265,45,104,.433,38,79,.481,7,25,.280,23,31,.742,120,44,84,.524,34,59,.576,10,25,.400,15,22,.682,113,2017-02-28,DET,POR
54,Home,W 120-103 ,240,46,77,.597,39,58,.672,7,19,.368,21,25,.840,120,35,89,.393,25,55,.455,10,34,.294,23,28,.821,103,2017-03-02,PHO,CHO
55,Home,W 120-92 ,240,46,88,.523,28,54,.519,18,34,.529,10,12,.833,120,35,73,.479,24,46,.522,11,27,.407,11,18,.611,92,2017-03-04,MIA,CLE
56,@,W 119-114 (2OT),290,41,98,.418,35,74,.473,6,24,.250,31,43,.721,119,44,97,.454,33,64,.516,11,33,.333,15,21,.714,114,2012-01-21,DEN,NYK
57,Home,W 119-101 ,240,45,96,.469,37,72,.514,8,24,.333,21,25,.840,119,36,79,.456,33,67,.493,3,12,.250,26,34,.765,101,2012-02-02,GSW,UTA
58,@,W 119-116 ,240,44,84,.524,33,58,.569,11,26,.423,20,21,.952,119,44,80,.550,35,59,.593,9,21,.429,19,23,.826,116,2012-02-07,OKC,GSW
59,Home,W 119-104 ,240,42,84,.500,33,65,.508,9,19,.474,26,35,.743,119,34,70,.486,27,52,.519,7,18,.389,29,34,.853,104,2012-02-22,OKC,BOS
60,Home,W 119-118 ,240,41,91,.451,33,66,.500,8,25,.320,29,37,.784,119,42,87,.483,29,63,.460,13,24,.542,21,21,1.000,118,2012-02-28,MIL,WAS
61,Home,W 119-116 (OT),265,40,88,.455,29,61,.475,11,27,.407,28,35,.800,119,45,98,.459,33,71,.465,12,27,.444,14,21,.667,116,2012-03-05,DEN,SAC
62,Home,W 119-114 ,240,45,93,.484,32,67,.478,13,26,.500,16,21,.762,119,46,83,.554,39,66,.591,7,17,.412,15,21,.714,114,2012-03-09,MIL,NYK
63,Home,W 119-110 ,240,47,88,.534,43,71,.606,4,17,.235,21,32,.656,119,43,90,.478,39,74,.527,4,16,.250,20,25,.800,110,2012-03-20,SAC,MEM
64,Home,W 119-106 ,240,46,88,.523,37,60,.617,9,28,.321,18,20,.900,119,36,78,.462,31,57,.544,5,21,.238,29,35,.829,106,2012-04-01,POR,MIN
65,Home,W 119-89 ,240,42,80,.525,27,52,.519,15,28,.536,20,24,.833,119,30,74,.405,23,54,.426,7,20,.350,22,26,.846,89,2012-04-09,ORL,DET
66,Home,W 119-116 ,240,43,83,.518,33,58,.569,10,25,.400,23,27,.852,119,49,95,.516,44,74,.595,5,21,.238,13,20,.650,116,2012-11-03,MIA,DEN
67,Home,W 119-117 (OT),265,44,86,.512,34,61,.557,10,25,.400,21,29,.724,119,41,88,.466,32,63,.508,9,25,.360,26,31,.839,117,2012-11-16,POR,HOU
68,Home,W 119-108 ,240,46,85,.541,37,65,.569,9,20,.450,18,28,.643,119,44,90,.489,35,67,.522,9,23,.391,11,18,.611,108,2012-11-18,LAL,HOU
69,Home,W 119-109 ,240,42,83,.506,29,63,.460,13,20,.650,22,26,.846,119,43,82,.524,38,66,.576,5,16,.313,18,22,.818,109,2012-11-18,OKC,GSW
70,Home,W 119-96 ,240,48,87,.552,41,67,.612,7,20,.350,16,21,.762,119,37,84,.440,25,57,.439,12,27,.444,10,16,.625,96,2012-12-10,DAL,SAC
71,@,L 119-126 (2OT),290,48,109,.440,34,82,.415,14,27,.519,9,15,.600,119,46,98,.469,35,65,.538,11,33,.333,23,31,.742,126,2012-12-26,DET,ATL
72,Home,W 119-109 (OT),265,42,89,.472,32,63,.508,10,26,.385,25,31,.806,119,41,94,.436,31,66,.470,10,28,.357,17,20,.850,109,2013-01-02,MIA,DAL
73,@,L 119-125 (OT),265,46,93,.495,35,63,.556,11,30,.367,16,18,.889,119,48,94,.511,40,70,.571,8,24,.333,21,24,.875,125,2013-01-07,ORL,POR
74,Home,W 119-106 ,240,43,87,.494,31,59,.525,12,28,.429,21,27,.778,119,36,80,.450,20,44,.455,16,36,.444,18,21,.857,106,2013-01-26,HOU,BRK
75,Home,W 119-98 ,240,48,95,.505,40,72,.556,8,23,.348,15,20,.750,119,38,93,.409,28,73,.384,10,20,.500,12,16,.750,98,2013-02-06,OKC,GSW
76,Home,W 119-108 ,240,39,80,.488,32,66,.485,7,14,.500,34,41,.829,119,45,86,.523,37,65,.569,8,21,.381,10,13,.769,108,2013-02-08,CLE,ORL
77,Home,W 119-109 ,240,46,89,.517,36,67,.537,10,22,.455,17,20,.850,119,37,81,.457,27,57,.474,10,24,.417,25,30,.833,109,2013-02-08,DET,SAS
78,Home,W 119-108 ,240,41,75,.547,25,48,.521,16,27,.593,21,30,.700,119,42,79,.532,30,62,.484,12,17,.706,12,22,.545,108,2013-02-13,BRK,DEN
79,@,L 119-122 ,240,42,87,.483,31,59,.525,11,28,.393,24,27,.889,119,44,92,.478,29,59,.492,15,33,.455,19,23,.826,122,2013-02-20,OKC,HOU
80,Home,W 119-113 ,240,42,88,.477,31,64,.484,11,24,.458,24,33,.727,119,39,81,.481,35,59,.593,4,22,.182,31,37,.838,113,2013-02-22,WAS,DEN
81,Home,W 119-108 ,240,49,88,.557,44,70,.629,5,18,.278,16,27,.593,119,43,78,.551,35,59,.593,8,19,.421,14,31,.452,108,2013-02-25,DEN,LAL
82,Home,W 119-74 ,240,42,76,.553,34,58,.586,8,18,.444,27,28,.964,119,27,77,.351,21,56,.375,6,21,.286,14,18,.778,74,2013-02-27,OKC,NOH
83,Home,W 119-83 ,240,42,90,.467,29,57,.509,13,33,.394,22,27,.815,119,28,77,.364,22,54,.407,6,23,.261,21,27,.778,83,2013-03-03,SAC,CHA
84,Home,W 119-113 ,240,45,78,.577,39,61,.639,6,17,.353,23,29,.793,119,43,85,.506,36,70,.514,7,15,.467,20,31,.645,113,2013-03-16,SAS,CLE
85,Home,W 119-114 ,240,42,79,.532,33,57,.579,9,22,.409,26,33,.788,119,43,81,.531,37,66,.561,6,15,.400,22,29,.759,114,2013-03-18,CHA,WAS
86,@,W 119-118 (OT),265,46,100,.460,39,80,.488,7,20,.350,20,27,.741,119,47,96,.490,39,75,.520,8,21,.381,16,19,.842,118,2013-03-18,DEN,CHI
87,@,W 119-82 ,240,45,83,.542,36,62,.581,9,21,.429,20,23,.870,119,34,78,.436,33,60,.550,1,18,.056,13,15,.867,82,2013-03-18,BRK,DET
88,Home,W 119-112 ,240,47,95,.495,40,72,.556,7,23,.304,18,23,.783,119,43,92,.467,32,63,.508,11,29,.379,15,23,.652,112,2013-04-15,PHO,HOU
89,@,W 119-110 ,240,37,82,.451,31,65,.477,6,17,.353,39,44,.886,119,39,91,.429,28,60,.467,11,31,.355,21,27,.778,110,2013-11-08,OKC,DET
90,@,W 119-116 ,240,41,92,.446,26,59,.441,15,33,.455,22,25,.880,119,48,102,.471,39,85,.459,9,17,.529,11,16,.688,116,2013-12-17,POR,CLE
91,@,L 119-121 (OT),265,44,91,.484,27,57,.474,17,34,.500,14,19,.737,119,46,91,.505,36,62,.581,10,29,.345,19,29,.655,121,2013-12-23,ATL,MIA
92,@,W 119-112 ,240,40,82,.488,31,59,.525,9,23,.391,30,38,.789,119,45,88,.511,33,60,.550,12,28,.429,10,14,.714,112,2014-01-03,LAC,DAL
93,Home,W 119-96 ,240,43,83,.518,34,64,.531,9,19,.474,24,31,.774,119,35,80,.438,24,57,.421,11,23,.478,15,24,.625,96,2014-01-05,OKC,BOS
94,@,L 119-123 ,240,39,90,.433,29,63,.460,10,27,.370,31,36,.861,119,40,85,.471,33,70,.471,7,15,.467,36,50,.720,123,2014-01-07,POR,SAC
95,Home,W 119-92 ,240,48,88,.545,39,69,.565,9,19,.474,14,19,.737,119,37,84,.440,29,65,.446,8,19,.421,10,14,.714,92,2014-01-10,MIN,CHA
96,Home,W 119-98 ,240,43,90,.478,35,59,.593,8,31,.258,25,40,.625,119,34,86,.395,22,56,.393,12,30,.400,18,30,.600,98,2014-01-22,HOU,SAC
97,@,W 119-108 ,240,42,79,.532,24,42,.571,18,37,.486,17,22,.773,119,38,101,.376,33,68,.485,5,33,.152,27,37,.730,108,2014-02-05,LAL,CLE
98,Home,W 119-80 ,240,46,80,.575,42,64,.656,4,16,.250,23,26,.885,119,28,89,.315,22,63,.349,6,26,.231,18,26,.692,80,2014-02-10,IND,DEN
99,Home,W 119-85 ,240,48,98,.490,35,71,.493,13,27,.481,10,13,.769,119,31,91,.341,27,70,.386,4,21,.190,19,25,.760,85,2014-03-14,SAS,LAL
0,@,W 119-118 (2OT),290,38,98,.388,26,62,.419,12,36,.333,31,38,.816,119,41,101,.406,33,72,.458,8,29,.276,28,33,.848,118,2014-03-21,OKC,TOR
1,@,L 119-128 (OT),265,46,93,.495,34,60,.567,12,33,.364,15,19,.789,119,45,90,.500,30,52,.577,15,38,.395,23,28,.821,128,2014-03-25,OKC,DAL
2,@,W 119-98 ,240,45,78,.577,36,60,.600,9,18,.500,20,24,.833,119,35,79,.443,24,51,.471,11,28,.393,17,20,.850,98,2014-04-02,CLE,ORL
3,Home,W 119-116 ,240,44,84,.524,38,68,.559,6,16,.375,25,38,.658,119,42,85,.494,38,65,.585,4,20,.200,28,35,.800,116,2014-04-11,MIL,CLE
4,Home,W 119-117 (OT),265,43,86,.500,33,62,.532,10,24,.417,23,32,.719,119,44,91,.484,27,54,.500,17,37,.459,12,16,.750,117,2014-04-13,POR,GSW
5,@,W 119-104 ,240,45,82,.549,35,58,.603,10,24,.417,19,22,.864,119,42,81,.519,36,62,.581,6,19,.316,14,20,.700,104,2014-04-14,LAL,UTA
6,Home,W 119-99 ,240,45,82,.549,29,50,.580,16,32,.500,13,18,.722,119,37,86,.430,33,73,.452,4,13,.308,21,25,.840,99,2014-10-29,PHO,LAL
7,@,L 119-122 (2OT),290,43,93,.462,30,60,.500,13,33,.394,20,26,.769,119,48,97,.495,42,76,.553,6,21,.286,20,27,.741,122,2014-11-07,ATL,CHO
8,Home,W 119-93 ,240,46,86,.535,39,69,.565,7,17,.412,20,22,.909,119,34,78,.436,26,44,.591,8,34,.235,17,21,.810,93,2014-11-17,MEM,HOU
9,Home,L 119-120 ,240,48,89,.539,40,68,.588,8,21,.381,15,22,.682,119,45,79,.570,35,61,.574,10,18,.556,20,24,.833,120,2014-11-28,LAL,MIN
10,Home,W 119-89 ,240,45,85,.529,38,65,.585,7,20,.350,22,27,.815,119,31,82,.378,26,60,.433,5,22,.227,22,30,.733,89,2014-12-05,WAS,DEN
11,Home,W 119-114 ,240,44,79,.557,32,51,.627,12,28,.429,19,25,.760,119,44,89,.494,36,67,.537,8,22,.364,18,23,.783,114,2014-12-12,NOP,CLE
12,Home,W 119-111 ,240,47,79,.595,39,63,.619,8,16,.500,17,18,.944,119,45,90,.500,40,75,.533,5,15,.333,16,19,.842,111,2014-12-16,NOP,UTA
13,Home,L 119-129 (3OT),315,45,109,.413,37,89,.416,8,20,.400,21,26,.808,119,47,110,.427,34,75,.453,13,35,.371,22,23,.957,129,2014-12-19,SAS,POR
14,Home,W 119-109 ,240,47,86,.547,37,60,.617,10,26,.385,15,29,.517,119,42,83,.506,33,63,.524,9,20,.450,16,22,.727,109,2014-12-26,DET,IND
15,@,W 119-101 ,240,45,96,.469,32,69,.464,13,27,.481,16,17,.941,119,38,89,.427,26,55,.473,12,34,.353,13,19,.684,101,2015-01-02,DAL,BOS
16,@,W 119-103 ,240,48,89,.539,35,64,.547,13,25,.520,10,12,.833,119,42,85,.494,37,69,.536,5,16,.313,14,16,.875,103,2015-01-16,CHI,BOS
17,Home,W 119-102 ,240,43,84,.512,26,50,.520,17,34,.500,16,19,.842,119,35,73,.479,28,56,.500,7,17,.412,25,29,.862,102,2015-01-28,TOR,SAC
18,Home,W 119-115 ,240,42,77,.545,34,58,.586,8,19,.421,27,52,.519,119,43,84,.512,33,56,.589,10,28,.357,19,23,.826,115,2015-02-19,LAC,SAS
19,Home,W 119-94 ,240,48,92,.522,40,72,.556,8,20,.400,15,23,.652,119,35,97,.361,28,70,.400,7,27,.259,17,20,.850,94,2015-02-22,OKC,DEN
20,Home,W 119-108 ,240,46,83,.554,35,62,.565,11,21,.524,16,22,.727,119,40,84,.476,27,53,.509,13,31,.419,15,28,.536,108,2015-02-23,MIA,PHI
21,Home,W 119-114 ,240,48,85,.565,35,61,.574,13,24,.542,10,12,.833,119,38,85,.447,28,58,.483,10,27,.370,28,38,.737,114,2015-03-06,ORL,SAC
22,Home,W 119-115 ,240,42,89,.472,32,64,.500,10,25,.400,25,35,.714,119,40,90,.444,33,64,.516,7,26,.269,28,35,.800,115,2015-03-16,DAL,OKC
23,@,W 119-100 ,240,42,90,.467,30,62,.484,12,28,.429,23,30,.767,119,41,85,.482,37,68,.544,4,17,.235,14,17,.824,100,2015-03-22,DEN,ORL
24,@,W 119-98 ,240,44,82,.537,32,53,.604,12,29,.414,19,31,.613,119,36,86,.419,25,55,.455,11,31,.355,15,27,.556,98,2015-03-27,LAC,PHI
25,@,W 119-106 ,240,41,84,.488,28,52,.538,13,32,.406,24,40,.600,119,39,93,.419,31,62,.500,8,31,.258,20,23,.870,106,2015-03-29,LAC,BOS
26,Home,W 119-101 ,240,44,88,.500,31,58,.534,13,30,.433,18,24,.750,119,36,75,.480,31,59,.525,5,16,.313,24,35,.686,101,2015-04-08,DEN,LAL
27,@,W 119-90 ,240,47,72,.653,39,57,.684,8,15,.533,17,23,.739,119,31,89,.348,22,62,.355,9,27,.333,19,27,.704,90,2015-04-08,WAS,PHI
28,Home,W 119-69 ,240,43,84,.512,32,59,.542,11,25,.440,22,30,.733,119,26,96,.271,23,73,.315,3,23,.130,14,20,.700,69,2015-11-02,GSW,MEM
29,Home,W 119-114 (OT),265,42,88,.477,31,54,.574,11,34,.324,24,34,.706,119,46,91,.505,39,71,.549,7,20,.350,15,19,.789,114,2015-11-04,HOU,ORL
30,Home,W 119-104 ,240,46,93,.495,29,56,.518,17,37,.459,10,18,.556,119,39,92,.424,31,68,.456,8,24,.333,18,22,.818,104,2015-11-06,GSW,DEN
31,@,W 119-103 ,240,43,89,.483,38,71,.535,5,18,.278,28,31,.903,119,40,87,.460,28,58,.483,12,29,.414,11,17,.647,103,2015-11-11,TOR,PHI
32,@,L 119-122 (OT),265,40,93,.430,28,64,.438,12,29,.414,27,34,.794,119,43,92,.467,35,69,.507,8,23,.348,28,37,.757,122,2015-12-05,IND,UTA
33,@,W 119-68 ,240,47,76,.618,43,65,.662,4,11,.364,21,25,.840,119,26,75,.347,22,51,.431,4,24,.167,12,21,.571,68,2015-12-07,SAS,PHI
34,Home,L 119-124 (2OT),290,49,114,.430,37,81,.457,12,33,.364,9,16,.563,119,42,107,.393,33,76,.434,9,31,.290,31,39,.795,124,2015-12-11,BOS,GSW
35,Home,W 119-116 ,240,38,78,.487,27,57,.474,11,21,.524,32,43,.744,119,43,89,.483,33,64,.516,10,25,.400,20,24,.833,116,2015-12-16,DET,BOS
36,@,W 119-118 (OT),265,45,82,.549,29,48,.604,16,34,.471,13,15,.867,119,51,101,.505,41,82,.500,10,19,.526,6,14,.429,118,2015-12-23,DAL,BRK
37,@,L 119-142 ,240,43,83,.518,33,54,.611,10,29,.345,23,28,.821,119,53,87,.609,44,64,.688,9,23,.391,27,34,.794,142,2016-01-02,PHO,SAC
38,@,W 119-117 ,240,39,88,.443,30,59,.508,9,29,.310,32,36,.889,119,40,89,.449,34,67,.507,6,22,.273,31,36,.861,117,2016-01-16,BOS,WAS
39,@,L 119-124 (2OT),290,44,104,.423,29,59,.492,15,45,.333,16,20,.800,119,41,88,.466,27,61,.443,14,27,.519,28,32,.875,124,2016-01-18,UTA,CHO
40,Home,W 119-113 (2OT),290,43,97,.443,35,77,.455,8,20,.400,25,30,.833,119,45,102,.441,35,74,.473,10,28,.357,13,25,.520,113,2016-01-18,NYK,PHI
41,@,W 119-105 ,240,43,86,.500,34,59,.576,9,27,.333,24,26,.923,119,33,84,.393,27,64,.422,6,20,.300,33,37,.892,105,2016-01-25,ATL,DEN
42,Home,W 119-114 ,240,44,82,.537,34,58,.586,10,24,.417,21,35,.600,119,39,93,.419,23,47,.489,16,46,.348,20,25,.800,114,2016-01-31,ORL,BOS
43,Home,W 119-115 ,240,40,80,.500,28,54,.519,12,26,.462,27,35,.771,119,46,80,.575,42,63,.667,4,17,.235,19,25,.760,115,2016-02-02,LAL,MIN
44,@,L 119-128 ,240,45,89,.506,37,63,.587,8,26,.308,21,22,.955,119,48,86,.558,30,58,.517,18,28,.643,14,15,.933,128,2016-02-05,SAC,BRK
45,@,L 119-128 ,240,47,95,.495,37,69,.536,10,26,.385,15,19,.789,119,51,91,.560,38,67,.567,13,24,.542,13,15,.867,128,2016-02-07,SAC,BOS
46,Home,L 119-121 (OT),265,36,75,.480,25,46,.543,11,29,.379,36,41,.878,119,48,92,.522,42,66,.636,6,26,.231,19,27,.704,121,2016-02-09,DAL,UTA
47,@,W 119-101 ,240,47,89,.528,41,75,.547,6,14,.429,19,26,.731,119,40,70,.571,36,58,.621,4,12,.333,17,24,.708,101,2016-02-09,SAS,MIA
48,@,W 119-113 ,240,48,88,.545,42,76,.553,6,12,.500,17,18,.944,119,40,81,.494,30,59,.508,10,22,.455,23,26,.885,113,2016-02-19,SAS,LAL
49,@,L 119-128 ,240,39,88,.443,22,49,.449,17,39,.436,24,33,.727,119,48,85,.565,35,58,.603,13,27,.481,19,29,.655,128,2016-02-24,LAL,MEM
50,@,L 119-123 ,240,47,86,.547,39,67,.582,8,19,.421,17,22,.773,119,47,90,.522,35,70,.500,12,20,.600,17,18,.944,123,2016-02-25,OKC,NOP
51,@,W 119-105 ,240,44,82,.537,34,53,.642,10,29,.345,21,35,.600,119,37,80,.463,24,45,.533,13,35,.371,18,22,.818,105,2016-02-25,HOU,POR
52,@,W 119-99 ,240,40,81,.494,30,56,.536,10,25,.400,29,35,.829,119,34,85,.400,21,52,.404,13,33,.394,18,26,.692,99,2016-03-02,CHO,PHI
53,Home,W 119-113 ,240,42,84,.500,26,49,.531,16,35,.457,19,27,.704,119,40,90,.444,35,69,.507,5,21,.238,28,34,.824,113,2016-03-07,GSW,ORL
54,@,L 119-124 ,240,49,93,.527,42,73,.575,7,20,.350,14,20,.700,119,47,79,.595,39,62,.629,8,17,.471,22,28,.786,124,2016-03-14,DEN,MIA
55,Home,W 119-107 ,240,47,93,.505,34,65,.523,13,28,.464,12,20,.600,119,39,93,.419,32,66,.485,7,27,.259,22,26,.846,107,2016-03-23,PHO,LAL
56,@,W 119-100 ,240,41,86,.477,30,60,.500,11,26,.423,26,32,.813,119,38,93,.409,30,69,.435,8,24,.333,16,23,.696,100,2016-03-28,OKC,TOR
57,Home,W 119-117 ,240,45,87,.517,35,55,.636,10,32,.313,19,24,.792,119,42,76,.553,26,47,.553,16,29,.552,17,22,.773,117,2016-03-31,OKC,LAC
58,Home,W 119-107 ,240,43,90,.478,33,64,.516,10,26,.385,23,29,.793,119,41,89,.461,33,68,.485,8,21,.381,17,26,.654,107,2016-04-03,ORL,MEM
59,Home,W 119-108 ,240,41,90,.456,31,67,.463,10,23,.435,27,35,.771,119,40,91,.440,34,71,.479,6,20,.300,22,28,.786,108,2016-11-06,LAL,PHO
60,Home,W 119-110 ,240,42,76,.553,30,43,.698,12,33,.364,23,26,.885,119,39,92,.424,27,64,.422,12,28,.429,20,28,.714,110,2016-11-08,BRK,MIN
61,@,W 119-105 ,240,40,76,.526,29,52,.558,11,24,.458,28,37,.757,119,40,89,.449,32,67,.478,8,22,.364,17,21,.810,105,2016-11-12,LAC,MIN
62,@,W 119-117 ,240,46,86,.535,35,62,.565,11,24,.458,16,20,.800,119,47,92,.511,40,67,.597,7,25,.280,16,26,.615,117,2016-11-13,ORL,OKC
63,Home,W 119-112 ,240,44,81,.543,29,56,.518,15,25,.600,16,18,.889,119,41,86,.477,29,57,.509,12,29,.414,18,20,.900,112,2016-11-17,WAS,NYK
64,@,W 119-114 ,240,44,86,.512,31,55,.564,13,31,.419,18,20,.900,119,45,89,.506,34,69,.493,11,20,.550,13,18,.722,114,2016-11-23,SAS,CHO
65,Home,W 119-104 ,240,47,100,.470,35,68,.515,12,32,.375,13,17,.765,119,36,76,.474,23,53,.434,13,23,.565,19,29,.655,104,2016-11-25,POR,NOP
66,@,W 119-115 ,240,45,95,.474,32,65,.492,13,30,.433,16,21,.762,119,40,87,.460,31,61,.508,9,26,.346,26,34,.765,115,2016-12-09,PHO,LAL
67,Home,L 119-120 (OT),265,44,96,.458,30,55,.545,14,41,.341,17,26,.654,119,38,97,.392,22,57,.386,16,40,.400,28,35,.800,120,2016-12-11,PHO,NOP
68,Home,W 119-108 ,240,46,89,.517,31,56,.554,15,33,.455,12,18,.667,119,41,86,.477,25,49,.510,16,37,.432,10,13,.769,108,2016-12-17,CLE,LAL
69,Home,W 119-102 ,240,47,86,.547,31,50,.620,16,36,.444,9,13,.692,119,39,90,.433,28,51,.549,11,39,.282,13,20,.650,102,2016-12-20,LAC,DEN
70,Home,W 119-99 ,240,45,99,.455,37,64,.578,8,35,.229,21,24,.875,119,38,85,.447,30,55,.545,8,30,.267,15,18,.833,99,2016-12-23,CLE,BRK
71,@,W 119-113 ,240,43,77,.558,32,50,.640,11,27,.407,22,24,.917,119,43,85,.506,33,56,.589,10,29,.345,17,28,.607,113,2016-12-23,GSW,DET
72,@,W 119-114 ,240,45,93,.484,31,57,.544,14,36,.389,15,20,.750,119,41,87,.471,33,64,.516,8,23,.348,24,27,.889,114,2016-12-25,BOS,NYK
73,Home,W 119-100 ,240,48,85,.565,39,67,.582,9,18,.500,14,19,.737,119,39,86,.453,32,68,.471,7,18,.389,15,20,.750,100,2016-12-25,SAS,CHI
74,@,W 119-94 ,240,48,84,.571,37,62,.597,11,22,.500,12,16,.750,119,39,88,.443,33,64,.516,6,24,.250,10,16,.625,94,2016-12-28,MIL,DET
75,Home,W 119-98 ,240,47,87,.540,42,70,.600,5,17,.294,20,25,.800,119,36,74,.486,29,58,.500,7,16,.438,19,24,.792,98,2016-12-28,SAS,PHO
76,@,L 119-127 ,240,48,101,.475,39,66,.591,9,35,.257,14,18,.778,119,50,95,.526,39,70,.557,11,25,.440,16,21,.762,127,2017-01-02,DEN,GSW
77,Home,L 119-128 (OT),265,41,83,.494,33,53,.623,8,30,.267,29,39,.744,119,50,103,.485,37,70,.529,13,33,.394,15,19,.789,128,2017-01-06,GSW,MEM
78,Home,W 119-105 ,240,44,81,.543,36,58,.621,8,23,.348,23,25,.920,119,36,87,.414,21,45,.467,15,42,.357,18,22,.818,105,2017-01-11,MIN,HOU
79,@,W 119-109 ,240,48,92,.522,38,73,.521,10,19,.526,13,16,.813,119,40,89,.449,33,63,.524,7,26,.269,22,24,.917,109,2017-01-17,TOR,BRK
80,@,W 119-95 ,240,41,80,.513,25,38,.658,16,42,.381,21,25,.840,119,33,89,.371,24,55,.436,9,34,.265,20,28,.714,95,2017-01-21,HOU,MEM
81,@,W 119-114 ,240,43,83,.518,26,53,.491,17,30,.567,16,19,.842,119,43,94,.457,35,67,.522,8,27,.296,20,26,.769,114,2017-01-25,ATL,CHI
82,Home,W 119-103 ,240,48,93,.516,35,63,.556,13,30,.433,10,14,.714,119,33,85,.388,21,57,.368,12,28,.429,25,29,.862,103,2017-01-27,NOP,SAS
83,@,L 119-122 ,240,41,74,.554,28,45,.622,13,29,.448,24,29,.828,119,45,83,.542,34,52,.654,11,31,.355,21,26,.808,122,2017-01-30,SAC,PHI
84,@,W 119-99 ,240,45,92,.489,31,62,.500,14,30,.467,15,20,.750,119,32,80,.400,23,55,.418,9,25,.360,26,35,.743,99,2017-02-01,MEM,DEN
85,@,W 119-115 ,240,45,92,.489,35,67,.522,10,25,.400,19,28,.679,119,46,92,.500,38,65,.585,8,27,.296,15,18,.833,115,2017-02-08,LAC,NYK
86,Home,W 119-104 ,240,46,87,.529,31,49,.633,15,38,.395,12,15,.800,119,42,100,.420,34,74,.459,8,26,.308,12,17,.706,104,2017-02-23,CLE,NYK
87,@,W 119-98 ,240,49,94,.521,39,73,.534,10,21,.476,11,13,.846,119,40,87,.460,33,65,.508,7,22,.318,11,18,.611,98,2017-02-26,SAS,LAL
88,@,W 119-108 ,240,40,89,.449,34,60,.567,6,29,.207,33,39,.846,119,37,82,.451,27,48,.563,10,34,.294,24,27,.889,108,2017-02-27,GSW,PHI
89,@,W 119-111 ,240,41,87,.471,21,43,.488,20,44,.455,17,22,.773,119,38,82,.463,25,54,.463,13,28,.464,22,31,.710,111,2017-03-06,GSW,ATL
90,Home,W 118-83 ,240,42,80,.525,34,59,.576,8,21,.381,26,28,.929,118,24,69,.348,19,50,.380,5,19,.263,30,39,.769,83,2012-01-04,MIA,IND
91,@,W 118-110 ,240,47,85,.553,40,74,.541,7,11,.636,17,21,.810,118,42,85,.494,31,56,.554,11,29,.379,15,20,.750,110,2012-01-04,CHA,NYK
92,Home,W 118-97 ,240,47,88,.534,42,78,.538,5,10,.500,19,24,.792,118,38,74,.514,33,63,.524,5,11,.455,16,19,.842,97,2012-01-17,CHI,PHO
93,@,L 118-124 (OT),265,49,101,.485,43,79,.544,6,22,.273,14,18,.778,118,46,94,.489,37,66,.561,9,28,.321,23,28,.821,124,2012-02-19,DEN,OKC
94,@,L 118-119 ,240,42,87,.483,29,63,.460,13,24,.542,21,21,1.000,118,41,91,.451,33,66,.500,8,25,.320,29,37,.784,119,2012-02-28,WAS,MIL
95,Home,W 118-105 ,240,46,85,.541,39,66,.591,7,19,.368,19,25,.760,118,41,96,.427,31,68,.456,10,28,.357,13,17,.765,105,2012-03-07,SAS,NYK
96,Home,W 118-107 ,240,39,82,.476,28,62,.452,11,20,.550,29,36,.806,118,44,86,.512,36,69,.522,8,17,.471,11,17,.647,107,2012-03-11,CLE,HOU
97,Home,W 118-117 (OT),265,45,87,.517,38,67,.567,7,20,.350,21,26,.808,118,43,92,.467,29,63,.460,14,29,.483,17,19,.895,117,2012-03-13,DEN,ATL
98,Home,W 118-110 ,240,42,88,.477,32,65,.492,10,23,.435,24,28,.857,118,47,90,.522,39,74,.527,8,16,.500,8,11,.727,110,2012-04-11,POR,GSW
99,Home,W 118-110 ,240,42,74,.568,23,42,.548,19,32,.594,15,17,.882,118,36,66,.545,25,45,.556,11,21,.524,27,34,.794,110,2012-04-17,NYK,BOS
0,Home,W 118-109 ,240,43,91,.473,36,74,.486,7,17,.412,25,32,.781,118,37,88,.420,31,68,.456,6,20,.300,29,33,.879,109,2012-04-19,IND,MIL
1,@,W 118-107 ,240,48,87,.552,42,74,.568,6,13,.462,16,17,.941,118,44,95,.463,33,69,.478,11,26,.423,8,11,.727,107,2012-04-21,DEN,PHO
2,Home,W 118-110 ,240,38,81,.469,29,61,.475,9,20,.450,33,36,.917,118,43,82,.524,39,66,.591,4,16,.250,20,27,.741,110,2012-04-24,OKC,SAC
3,@,W 118-92 ,240,45,80,.563,32,57,.561,13,23,.565,15,20,.750,118,37,90,.411,33,76,.434,4,14,.286,14,17,.824,92,2012-11-26,SAS,WAS
4,@,W 118-117 (2OT),290,46,94,.489,37,69,.536,9,25,.360,17,21,.810,118,43,99,.434,30,64,.469,13,35,.371,18,22,.818,117,2012-12-01,POR,CLE
5,@,W 118-112 (OT),265,43,92,.467,31,57,.544,12,35,.343,20,26,.769,118,41,88,.466,28,61,.459,13,27,.481,17,22,.773,112,2012-12-03,POR,CHA
6,@,W 118-115 (OT),265,49,107,.458,40,80,.500,9,27,.333,11,14,.786,118,46,103,.447,36,74,.486,10,29,.345,13,15,.867,115,2012-12-22,LAL,GSW
7,Home,W 118-96 ,240,44,82,.537,34,62,.548,10,20,.500,20,25,.800,118,36,86,.419,29,64,.453,7,22,.318,17,19,.895,96,2012-12-30,SAC,BOS
8,Home,W 118-92 ,240,44,82,.537,34,68,.500,10,14,.714,20,24,.833,118,33,78,.423,26,64,.406,7,14,.500,19,23,.826,92,2013-01-07,CHI,CLE
9,@,L 118-124 ,240,44,92,.478,36,76,.474,8,16,.500,22,30,.733,118,43,84,.512,34,65,.523,9,19,.474,29,33,.879,124,2013-01-14,CLE,SAC
10,@,L 118-121 (OT),265,35,76,.461,27,52,.519,8,24,.333,40,48,.833,118,45,93,.484,37,75,.493,8,18,.444,23,34,.676,121,2013-01-20,OKC,DEN
11,Home,W 118-110 ,240,42,82,.512,34,54,.630,8,28,.286,26,36,.722,118,39,81,.481,31,54,.574,8,27,.296,24,35,.686,110,2013-01-30,DEN,HOU
12,Home,W 118-103 ,240,47,79,.595,35,53,.660,12,26,.462,12,16,.750,118,40,88,.455,32,62,.516,8,26,.308,15,20,.750,103,2013-02-08,HOU,POR
13,Home,W 118-114 (3OT),315,43,108,.398,30,78,.385,13,30,.433,19,24,.792,118,48,113,.425,40,87,.460,8,26,.308,10,17,.588,114,2013-02-10,BOS,DEN
14,@,W 118-94 ,240,43,87,.494,34,66,.515,9,21,.429,23,28,.821,118,38,79,.481,34,65,.523,4,14,.286,14,22,.636,94,2013-02-23,CLE,ORL
15,@,W 118-110 ,240,42,77,.545,27,45,.600,15,32,.469,19,28,.679,118,44,78,.564,35,56,.625,9,22,.409,13,16,.813,110,2013-03-01,HOU,ORL
16,@,L 118-125 ,240,41,94,.436,32,68,.471,9,26,.346,27,35,.771,118,47,82,.573,39,65,.600,8,17,.471,23,28,.821,125,2013-03-04,TOR,GSW
17,Home,W 118-116 (OT),265,39,91,.429,25,52,.481,14,39,.359,26,36,.722,118,48,93,.516,40,71,.563,8,22,.364,12,16,.750,116,2013-03-08,LAL,TOR
18,Home,L 118-119 (OT),265,47,96,.490,39,75,.520,8,21,.381,16,19,.842,118,46,100,.460,39,80,.488,7,20,.350,20,27,.741,119,2013-03-18,CHI,DEN
19,Home,W 118-107 ,240,45,83,.542,34,60,.567,11,23,.478,17,21,.810,118,40,88,.455,32,68,.471,8,20,.400,19,24,.792,107,2013-03-29,BOS,ATL
20,Home,W 118-111 (OT),265,39,87,.448,29,60,.483,10,27,.370,30,37,.811,118,42,104,.404,32,74,.432,10,30,.333,17,22,.773,111,2013-04-11,CHI,NYK
21,Home,W 118-116 ,240,34,66,.515,22,41,.537,12,25,.480,38,50,.760,118,46,97,.474,35,71,.493,11,26,.423,13,16,.813,116,2013-04-12,LAL,GSW
22,Home,W 118-109 ,240,43,81,.531,35,59,.593,8,22,.364,24,27,.889,118,38,82,.463,26,50,.520,12,32,.375,21,26,.808,109,2013-04-14,DEN,POR
23,Home,W 118-98 ,240,49,93,.527,45,77,.584,4,16,.250,16,20,.800,118,40,104,.385,33,79,.418,7,25,.280,11,17,.647,98,2013-04-17,DEN,PHO
24,Home,W 118-109 ,240,44,77,.571,33,53,.623,11,24,.458,19,24,.792,118,37,76,.487,29,52,.558,8,24,.333,27,35,.771,109,2013-10-30,DAL,ATL
25,@,L 118-137 ,240,41,82,.500,34,57,.596,7,25,.280,29,43,.674,118,49,94,.521,34,56,.607,15,38,.395,24,28,.857,137,2013-11-04,HOU,LAC
26,Home,W 118-95 ,240,46,79,.582,34,56,.607,12,23,.522,14,24,.583,118,33,79,.418,22,49,.449,11,30,.367,18,21,.857,95,2013-11-12,MIA,MIL
27,@,W 118-110 (OT),265,44,99,.444,29,67,.433,15,32,.469,15,20,.750,118,42,94,.447,39,77,.506,3,17,.176,23,31,.742,110,2013-11-17,POR,TOR
28,Home,W 118-94 ,240,47,77,.610,42,64,.656,5,13,.385,19,20,.950,118,34,85,.400,27,64,.422,7,21,.333,19,21,.905,94,2013-12-08,OKC,IND
29,Home,W 118-85 ,240,45,86,.523,35,60,.583,10,26,.385,18,24,.750,118,35,94,.372,32,76,.421,3,18,.167,12,15,.800,85,2013-12-20,ATL,UTA
30,Home,W 118-116 (OT),265,37,91,.407,21,52,.404,16,39,.410,28,34,.824,118,45,104,.433,35,78,.449,10,26,.385,16,22,.727,116,2013-12-28,ATL,CHA
31,Home,W 118-103 ,240,44,79,.557,36,61,.590,8,18,.444,22,29,.759,118,37,84,.440,30,58,.517,7,26,.269,22,35,.629,103,2014-01-13,UTA,DEN
32,Home,L 118-120 ,240,44,84,.524,31,50,.620,13,34,.382,17,23,.739,118,41,88,.466,28,71,.394,13,17,.765,25,32,.781,120,2014-01-14,LAL,CLE
33,Home,L 118-126 ,240,36,74,.486,22,45,.489,14,29,.483,32,38,.842,118,46,84,.548,34,62,.548,12,22,.545,22,25,.880,126,2014-01-25,TOR,LAC
34,Home,L 118-125 (2OT),290,44,101,.436,39,85,.459,5,16,.313,25,32,.781,118,48,98,.490,39,70,.557,9,28,.321,20,25,.800,125,2014-02-05,WAS,SAS
35,Home,W 118-113 (OT),265,42,92,.457,37,79,.468,5,13,.385,29,35,.829,118,45,104,.433,38,84,.452,7,20,.350,16,20,.800,113,2014-02-07,IND,POR
36,Home,W 118-105 ,240,36,71,.507,27,47,.574,9,24,.375,37,54,.685,118,34,85,.400,27,59,.458,7,26,.269,30,40,.750,105,2014-02-07,LAC,TOR
37,Home,W 118-98 ,240,47,101,.465,42,85,.494,5,16,.313,19,25,.760,118,39,90,.433,31,67,.463,8,23,.348,12,20,.600,98,2014-02-25,IND,LAL
38,Home,W 118-110 ,240,42,84,.500,31,51,.608,11,33,.333,23,33,.697,118,45,100,.450,41,81,.506,4,19,.211,16,19,.842,110,2014-03-01,HOU,DET
39,@,W 118-106 ,240,47,90,.522,36,63,.571,11,27,.407,13,19,.684,118,39,90,.433,32,64,.500,7,26,.269,21,24,.875,106,2014-03-05,NYK,MIN
40,Home,W 118-111 ,240,47,97,.485,37,66,.561,10,31,.323,14,21,.667,118,40,86,.465,36,71,.507,4,15,.267,27,39,.692,111,2014-03-09,BOS,DET
41,Home,W 118-113 (OT),265,38,89,.427,29,60,.483,9,29,.310,33,45,.733,118,39,96,.406,30,71,.423,9,25,.360,26,33,.788,113,2014-03-09,HOU,POR
42,Home,W 118-113 (OT),265,40,94,.426,29,60,.483,11,34,.324,27,31,.871,118,40,81,.494,33,57,.579,7,24,.292,26,29,.897,113,2014-03-18,ATL,TOR
43,Home,W 118-109 ,240,44,86,.512,33,59,.559,11,27,.407,19,27,.704,118,43,95,.453,33,69,.478,10,26,.385,13,19,.684,109,2014-03-19,DEN,DET
44,Home,L 118-119 (2OT),290,41,101,.406,33,72,.458,8,29,.276,28,33,.848,118,38,98,.388,26,62,.419,12,36,.333,31,38,.816,119,2014-03-21,TOR,OKC
45,@,W 118-111 ,240,38,79,.481,26,44,.591,12,35,.343,30,34,.882,118,46,92,.500,40,75,.533,6,17,.353,13,17,.765,111,2014-03-22,HOU,CLE
46,@,W 118-107 ,240,42,89,.472,30,48,.625,12,41,.293,22,36,.611,118,32,79,.405,25,54,.463,7,25,.280,36,45,.800,107,2014-03-29,LAC,HOU
47,Home,W 118-92 ,240,45,72,.625,35,53,.660,10,19,.526,18,21,.857,118,32,81,.395,29,57,.509,3,24,.125,25,30,.833,92,2014-04-02,WAS,BOS
48,@,W 118-102 ,240,50,88,.568,44,70,.629,6,18,.333,12,17,.706,118,39,84,.464,32,54,.593,7,30,.233,17,23,.739,102,2014-04-16,WAS,BOS
49,@,W 118-111 ,240,34,71,.479,22,38,.579,12,33,.364,38,44,.864,118,42,82,.512,35,62,.565,7,20,.350,20,28,.714,111,2014-10-31,LAC,LAL
50,Home,W 118-91 ,240,42,88,.477,35,62,.565,7,26,.269,27,33,.818,118,36,87,.414,29,56,.518,7,31,.226,12,15,.800,91,2014-11-01,UTA,PHO
51,Home,W 118-113 ,240,44,82,.537,30,57,.526,14,25,.560,16,20,.800,118,45,102,.441,34,71,.479,11,31,.355,12,16,.750,113,2014-11-03,DAL,BOS
52,@,W 118-115 ,240,40,78,.513,28,54,.519,12,24,.500,26,34,.765,118,43,91,.473,31,61,.508,12,30,.400,17,25,.680,115,2014-11-07,CHI,PHI
53,Home,W 118-111 ,240,40,81,.494,27,54,.500,13,27,.481,25,30,.833,118,41,93,.441,29,66,.439,12,27,.444,17,20,.850,111,2014-11-10,CLE,NOP
54,@,W 118-114 ,240,48,93,.516,39,72,.542,9,21,.429,13,16,.813,118,45,87,.517,41,77,.532,4,10,.400,20,31,.645,114,2014-11-17,PHO,BOS
55,Home,L 118-122 (3OT),315,44,92,.478,35,61,.574,9,31,.290,21,29,.724,118,48,108,.444,43,84,.512,5,24,.208,21,28,.750,122,2014-11-19,BRK,MIL
56,@,W 118-106 ,240,45,80,.563,32,54,.593,13,26,.500,15,17,.882,118,40,88,.455,36,69,.522,4,19,.211,22,30,.733,106,2014-12-05,PHO,DAL
57,Home,W 118-108 ,240,42,86,.488,28,53,.528,14,33,.424,20,27,.741,118,40,82,.488,35,68,.515,5,14,.357,23,26,.885,108,2014-12-21,TOR,NYK
58,@,L 118-125 ,240,43,86,.500,33,62,.532,10,24,.417,22,29,.759,118,49,77,.636,36,54,.667,13,23,.565,14,22,.636,125,2014-12-22,LAC,SAS
59,@,W 118-108 ,240,47,85,.553,42,68,.618,5,17,.294,19,28,.679,118,42,86,.488,36,67,.537,6,19,.316,18,24,.750,108,2015-01-09,DEN,SAC
60,@,L 118-128 ,240,48,97,.495,42,82,.512,6,15,.400,16,16,1.000,118,49,94,.521,39,70,.557,10,24,.417,20,24,.833,128,2015-01-21,ORL,DET
61,Home,W 118-113 ,240,47,92,.511,38,65,.585,9,27,.333,15,24,.625,118,39,87,.448,26,55,.473,13,32,.406,22,28,.786,113,2015-01-21,PHO,POR
62,@,L 118-123 (2OT),290,43,104,.413,37,79,.468,6,25,.240,26,32,.813,118,50,106,.472,47,97,.485,3,9,.333,20,25,.800,123,2015-01-29,CHI,LAL
63,Home,L 118-127 ,240,41,87,.471,29,61,.475,12,26,.462,24,30,.800,118,48,95,.505,33,58,.569,15,37,.405,16,23,.696,127,2015-02-10,PHO,HOU
64,Home,W 118-111 (OT),265,43,84,.512,36,66,.545,7,18,.389,25,38,.658,118,42,98,.429,34,65,.523,8,33,.242,19,27,.704,111,2015-02-22,LAL,BOS
65,@,L 118-123 (OT),265,34,96,.354,19,61,.311,15,35,.429,35,44,.795,118,44,96,.458,37,75,.493,7,21,.333,28,34,.824,123,2015-03-04,PHI,OKC
66,Home,W 118-86 ,240,45,85,.529,28,51,.549,17,34,.500,11,12,.917,118,34,92,.370,30,75,.400,4,17,.235,14,20,.700,86,2015-03-10,IND,ORL
67,Home,W 118-99 ,240,46,80,.575,35,59,.593,11,21,.524,15,17,.882,118,41,91,.451,34,66,.515,7,25,.280,10,12,.833,99,2015-03-13,POR,DET
68,@,W 118-111 (2OT),290,46,104,.442,36,73,.493,10,31,.323,16,20,.800,118,46,99,.465,40,77,.519,6,22,.273,13,21,.619,111,2015-03-15,DEN,NOP
69,@,L 118-122 ,240,44,84,.524,31,50,.620,13,34,.382,17,28,.607,118,42,88,.477,37,69,.536,5,19,.263,33,39,.846,122,2015-03-18,BOS,OKC
70,Home,W 118-108 ,240,37,83,.446,25,53,.472,12,30,.400,32,40,.800,118,42,93,.452,29,57,.509,13,36,.361,11,19,.579,108,2015-03-19,HOU,DEN
71,@,W 118-113 ,240,35,68,.515,23,47,.489,12,21,.571,36,44,.818,118,42,82,.512,35,58,.603,7,24,.292,22,28,.786,113,2015-10-30,WAS,MIL
72,Home,W 118-97 ,240,45,83,.542,31,60,.517,14,23,.609,14,22,.636,118,40,84,.476,29,60,.483,11,24,.458,6,12,.500,97,2015-11-04,PHO,SAC
73,Home,W 118-98 ,240,44,97,.454,32,67,.478,12,30,.400,18,23,.783,118,36,88,.409,28,63,.444,8,25,.320,18,23,.783,98,2015-11-06,BOS,WAS
74,Home,W 118-114 ,240,37,74,.500,26,50,.520,11,24,.458,33,43,.767,118,40,82,.488,30,60,.500,10,22,.455,24,28,.857,114,2015-11-10,CLE,UTA
75,Home,W 118-108 ,240,42,76,.553,31,52,.596,11,24,.458,23,30,.767,118,37,86,.430,25,59,.424,12,27,.444,22,33,.667,108,2015-11-11,DAL,LAC
76,Home,W 118-104 ,240,44,83,.530,30,53,.566,14,30,.467,16,21,.762,118,40,90,.444,31,64,.484,9,26,.346,15,28,.536,104,2015-11-12,PHO,LAC
77,@,W 118-105 ,240,47,89,.528,32,60,.533,15,29,.517,9,13,.692,118,37,86,.430,33,71,.465,4,15,.267,27,35,.771,105,2015-11-22,GSW,DEN
78,Home,L 118-129 ,240,42,88,.477,29,57,.509,13,31,.419,21,27,.778,118,44,77,.571,34,54,.630,10,23,.435,31,37,.838,129,2015-11-25,MIL,SAC
79,Home,W 118-96 ,240,45,90,.500,32,61,.525,13,29,.448,15,19,.789,118,41,82,.500,38,66,.576,3,16,.188,11,18,.611,96,2015-12-12,DET,IND
80,Home,W 118-81 ,240,42,75,.560,33,54,.611,9,21,.429,25,27,.926,118,32,79,.405,29,68,.426,3,11,.273,14,17,.824,81,2015-12-14,SAS,UTA
81,Home,W 118-78 ,240,46,84,.548,37,65,.569,9,19,.474,17,25,.680,118,30,86,.349,22,58,.379,8,28,.286,10,17,.588,78,2015-12-19,OKC,LAL
82,Home,L 118-119 (OT),265,51,101,.505,41,82,.500,10,19,.526,6,14,.429,118,45,82,.549,29,48,.604,16,34,.471,13,15,.867,119,2015-12-23,BRK,DAL
83,Home,W 118-111 ,240,40,87,.460,24,54,.444,16,33,.485,22,28,.786,118,42,78,.538,34,57,.596,8,21,.381,19,26,.731,111,2015-12-26,DAL,CHI
84,Home,W 118-115 ,240,47,85,.553,41,64,.641,6,21,.286,18,27,.667,118,41,76,.539,33,52,.635,8,24,.333,25,29,.862,115,2016-01-07,SAC,LAL
85,@,W 118-104 ,240,51,98,.520,40,73,.548,11,25,.440,5,10,.500,118,38,80,.475,35,63,.556,3,17,.176,25,32,.781,104,2016-01-15,WAS,IND
86,Home,W 118-113 (OT),265,40,93,.430,24,59,.407,16,34,.471,22,24,.917,118,40,94,.426,28,64,.438,12,30,.400,21,26,.808,113,2016-01-18,DAL,BOS
87,Home,W 118-111 (OT),265,47,90,.522,40,73,.548,7,17,.412,17,18,.944,118,37,86,.430,25,59,.424,12,27,.444,25,31,.806,111,2016-01-20,NYK,UTA
88,@,W 118-111 ,240,43,82,.524,33,66,.500,10,16,.625,22,34,.647,118,43,93,.462,34,69,.493,9,24,.375,16,22,.727,111,2016-02-21,SAS,PHO
89,@,W 118-112 ,240,42,90,.467,29,62,.468,13,28,.464,21,25,.840,118,40,86,.465,34,72,.472,6,14,.429,26,31,.839,112,2016-02-24,GSW,MIA
90,Home,L 118-121 (OT),265,46,96,.479,37,70,.529,9,26,.346,17,26,.654,118,45,95,.474,31,63,.492,14,32,.438,17,25,.680,121,2016-02-27,OKC,GSW
91,@,L 118-132 ,240,45,92,.489,36,66,.545,9,26,.346,19,26,.731,118,52,76,.684,42,58,.724,10,18,.556,18,22,.818,132,2016-03-05,BRK,MIN
92,@,W 118-104 ,240,38,86,.442,27,53,.509,11,33,.333,31,41,.756,118,35,86,.407,23,53,.434,12,33,.364,22,32,.688,104,2016-03-09,HOU,PHI
93,@,W 118-96 ,240,47,91,.516,37,73,.507,10,18,.556,14,20,.700,118,38,81,.469,30,60,.500,8,21,.381,12,15,.800,96,2016-03-11,MIA,CHI
94,Home,W 118-103 ,240,42,83,.506,32,58,.552,10,25,.400,24,29,.828,118,36,76,.474,27,46,.587,9,30,.300,22,27,.815,103,2016-03-11,CHO,DET
95,@,W 118-114 ,240,39,89,.438,27,55,.491,12,34,.353,28,34,.824,118,39,84,.464,31,59,.525,8,25,.320,28,39,.718,114,2016-03-16,ATL,DET
96,Home,W 118-102 ,240,46,94,.489,35,70,.500,11,24,.458,15,15,1.000,118,40,86,.465,34,65,.523,6,21,.286,16,20,.800,102,2016-03-17,CHI,BRK
97,Home,W 118-110 ,240,45,86,.523,37,70,.529,8,16,.500,20,22,.909,118,39,89,.438,29,67,.433,10,22,.455,22,30,.733,110,2016-03-17,SAS,POR
98,Home,W 118-102 ,240,43,80,.538,32,56,.571,11,24,.458,21,25,.840,118,39,98,.398,31,73,.425,8,25,.320,16,19,.842,102,2016-03-23,DET,ORL
99,Home,W 118-110 ,240,41,102,.402,28,60,.467,13,42,.310,23,26,.885,118,38,82,.463,31,55,.564,7,27,.259,27,32,.844,110,2016-04-03,HOU,OKC
0,Home,W 118-107 ,240,46,88,.523,29,55,.527,17,33,.515,9,11,.818,118,40,90,.444,29,62,.468,11,28,.393,16,24,.667,107,2016-04-09,ATL,BOS
1,Home,W 118-96 ,240,43,77,.558,37,57,.649,6,20,.300,26,30,.867,118,37,83,.446,30,65,.462,7,18,.389,15,19,.789,96,2016-04-10,MIA,ORL
2,Home,W 118-101 ,240,45,86,.523,36,65,.554,9,21,.429,19,21,.905,118,43,88,.489,36,70,.514,7,18,.389,8,9,.889,101,2016-10-29,CHI,IND
3,@,W 118-88 ,240,45,89,.506,34,62,.548,11,27,.407,17,18,.944,118,33,96,.344,28,65,.431,5,31,.161,17,21,.810,88,2016-10-31,CHI,BRK
4,@,W 118-99 ,240,42,89,.472,27,49,.551,15,40,.375,19,27,.704,118,37,85,.435,29,65,.446,8,20,.400,17,25,.680,99,2016-11-02,HOU,NYK
5,Home,W 118-115 (OT),265,44,103,.427,39,87,.448,5,16,.313,25,30,.833,118,42,101,.416,30,68,.441,12,33,.364,19,21,.905,115,2016-11-02,PHO,POR
6,Home,W 118-93 ,240,46,92,.500,36,71,.507,10,21,.476,16,20,.800,118,35,81,.432,25,50,.500,10,31,.323,13,22,.591,93,2016-11-09,WAS,BOS
7,Home,W 118-107 ,240,39,83,.470,32,61,.525,7,22,.318,33,38,.868,118,44,97,.454,37,74,.500,7,23,.304,12,16,.750,107,2016-11-12,TOR,NYK
8,@,L 118-125 ,240,45,99,.455,33,58,.569,12,41,.293,16,20,.800,118,41,92,.446,32,64,.500,9,28,.321,34,43,.791,125,2016-11-15,BRK,LAL
9,@,W 118-110 ,240,45,87,.517,37,65,.569,8,22,.364,20,28,.714,118,41,93,.441,28,62,.452,13,31,.419,15,21,.714,110,2016-11-20,CHI,LAL
10,Home,W 118-97 ,240,48,87,.552,37,61,.607,11,26,.423,11,16,.688,118,36,79,.456,25,45,.556,11,34,.324,14,23,.609,97,2016-11-25,IND,BRK
11,Home,W 118-101 ,240,46,86,.535,39,67,.582,7,19,.368,19,23,.826,118,32,75,.427,18,36,.500,14,39,.359,23,31,.742,101,2016-11-29,MIL,CLE
12,Home,W 118-114 ,240,41,86,.477,29,55,.527,12,31,.387,24,30,.800,118,41,88,.466,31,60,.517,10,28,.357,22,24,.917,114,2016-12-02,NYK,MIN
13,@,W 118-113 ,240,45,92,.489,31,58,.534,14,34,.412,14,18,.778,118,40,81,.494,29,54,.537,11,27,.407,22,30,.733,113,2016-12-05,WAS,BRK
14,Home,W 118-111 ,240,40,83,.482,25,54,.463,15,29,.517,23,28,.821,118,40,82,.488,24,45,.533,16,37,.432,15,16,.938,111,2016-12-10,IND,POR
15,@,W 118-112 ,240,41,84,.488,31,62,.500,10,22,.455,26,31,.839,118,42,88,.477,32,60,.533,10,28,.357,18,22,.818,112,2016-12-11,NYK,LAL
16,@,L 118-122 ,240,42,80,.525,35,60,.583,7,20,.350,27,36,.750,118,42,91,.462,25,48,.521,17,43,.395,21,36,.583,122,2016-12-12,BRK,HOU
17,Home,W 118-111 ,240,39,97,.402,32,68,.471,7,29,.241,33,42,.786,118,39,83,.470,28,56,.500,11,27,.407,22,26,.846,111,2016-12-16,ORL,BRK
18,Home,W 118-111 ,240,44,88,.500,31,65,.477,13,23,.565,17,21,.810,118,39,91,.429,33,68,.485,6,23,.261,27,33,.818,111,2016-12-20,NYK,IND
19,@,L 118-120 ,240,44,94,.468,36,68,.529,8,26,.308,22,25,.880,118,40,75,.533,25,44,.568,15,31,.484,25,31,.806,120,2016-12-26,CHO,BRK
20,@,L 118-124 ,240,43,85,.506,31,48,.646,12,37,.324,20,21,.952,118,43,83,.518,29,45,.644,14,38,.368,24,33,.727,124,2016-12-29,BOS,CLE
21,Home,W 118-95 ,240,47,83,.566,36,61,.590,11,22,.500,13,14,.929,118,32,74,.432,22,49,.449,10,25,.400,21,25,.840,95,2016-12-30,WAS,BRK
22,Home,W 118-111 ,240,42,90,.467,35,67,.522,7,23,.304,27,29,.931,118,41,83,.494,32,64,.500,9,19,.474,20,22,.909,111,2017-01-02,CHI,CHO
23,Home,W 118-116 ,240,41,86,.477,26,47,.553,15,39,.385,21,30,.700,118,41,91,.451,29,61,.475,12,30,.400,22,27,.815,116,2017-01-05,HOU,OKC
24,Home,W 118-109 ,240,43,81,.531,31,48,.646,12,33,.364,20,30,.667,118,36,86,.419,26,55,.473,10,31,.323,27,33,.818,109,2017-01-05,POR,LAL
25,@,L 118-123 (OT),265,37,85,.435,29,54,.537,8,31,.258,36,43,.837,118,38,97,.392,27,69,.391,11,28,.393,36,39,.923,123,2017-01-07,TOR,CHI
26,Home,L 118-122 ,240,37,81,.457,28,56,.500,9,25,.360,35,40,.875,118,40,90,.444,31,62,.500,9,28,.321,33,41,.805,122,2017-01-15,SAC,OKC
27,Home,W 118-95 ,240,45,91,.495,35,66,.530,10,25,.400,18,28,.643,118,30,78,.385,24,53,.453,6,25,.240,29,37,.784,95,2017-01-18,DET,ATL
28,Home,W 118-98 ,240,46,93,.495,31,57,.544,15,36,.417,11,15,.733,118,39,88,.443,28,56,.500,11,32,.344,9,11,.818,98,2017-01-18,NOP,ORL
29,Home,W 118-103 ,240,43,85,.506,24,43,.558,19,42,.452,13,19,.684,118,37,85,.435,33,66,.500,4,19,.211,25,31,.806,103,2017-01-19,CLE,PHO
30,Home,W 118-104 ,240,44,86,.512,35,64,.547,9,22,.409,21,25,.840,118,37,91,.407,27,60,.450,10,31,.323,20,26,.769,104,2017-01-19,SAS,DEN
31,@,W 118-115 (OT),265,48,96,.500,38,70,.543,10,26,.385,12,14,.857,118,45,91,.495,32,57,.561,13,34,.382,12,22,.545,115,2017-01-21,SAS,CLE
32,@,W 118-98 ,240,42,89,.472,23,47,.489,19,42,.452,15,19,.789,118,42,96,.438,35,68,.515,7,28,.250,7,16,.438,98,2017-01-22,GSW,ORL
33,Home,L 118-123 ,240,42,78,.538,32,53,.604,10,25,.400,24,32,.750,118,42,81,.519,30,50,.600,12,31,.387,27,28,.964,123,2017-01-27,PHI,HOU
34,Home,W 118-98 ,240,48,88,.545,38,62,.613,10,26,.385,12,17,.706,118,41,82,.500,36,61,.590,5,21,.238,11,14,.786,98,2017-02-01,DET,NOP
35,Home,W 118-109 ,240,41,84,.488,31,60,.517,10,24,.417,26,29,.897,118,42,90,.467,29,55,.527,13,35,.371,12,18,.667,109,2017-02-06,TOR,LAC
36,Home,W 118-109 ,240,50,106,.472,42,79,.532,8,27,.296,10,13,.769,118,38,79,.481,28,58,.483,10,21,.476,23,30,.767,109,2017-02-09,OKC,CLE
37,Home,W 118-110 ,240,42,88,.477,36,67,.537,6,21,.286,28,37,.757,118,36,80,.450,28,59,.475,8,21,.381,30,37,.811,110,2017-02-26,OKC,NOP
38,Home,W 118-111 ,240,44,89,.494,39,68,.574,5,21,.238,25,31,.806,118,37,87,.425,28,52,.538,9,35,.257,28,35,.800,111,2017-03-03,PHO,OKC
39,Home,W 117-100 ,240,46,86,.535,40,67,.597,6,19,.316,19,26,.731,117,38,79,.481,31,63,.492,7,16,.438,17,25,.680,100,2011-12-28,DEN,UTA
40,Home,W 117-89 ,240,47,82,.573,41,66,.621,6,16,.375,17,24,.708,117,35,76,.461,28,60,.467,7,16,.438,12,17,.706,89,2012-01-04,LAC,HOU
41,@,L 117-121 ,240,46,81,.568,38,65,.585,8,16,.500,17,26,.654,117,49,89,.551,40,69,.580,9,20,.450,14,18,.778,121,2012-01-07,DEN,SAS
42,@,W 117-109 ,240,35,68,.515,24,45,.533,11,23,.478,36,55,.655,117,43,82,.524,33,59,.559,10,23,.435,13,19,.684,109,2012-01-12,ORL,GSW
43,Home,W 117-104 ,240,43,78,.551,31,53,.585,12,25,.480,19,26,.731,117,38,81,.469,31,65,.477,7,16,.438,21,29,.724,104,2012-01-13,DEN,MIA
44,Home,W 117-97 ,240,46,86,.535,31,53,.585,15,33,.455,10,12,.833,117,35,79,.443,30,57,.526,5,22,.227,22,24,.917,97,2012-02-04,POR,DEN
45,Home,W 117-108 (OT),265,44,88,.500,37,69,.536,7,19,.368,22,31,.710,117,42,79,.532,33,58,.569,9,21,.429,15,23,.652,108,2012-02-21,IND,NOH
46,@,W 117-105 ,240,43,97,.443,35,75,.467,8,22,.364,23,35,.657,117,36,76,.474,26,47,.553,10,29,.345,23,29,.793,105,2012-03-02,DEN,HOU
47,@,L 117-118 (OT),265,43,92,.467,29,63,.460,14,29,.483,17,19,.895,117,45,87,.517,38,67,.567,7,20,.350,21,26,.808,118,2012-03-13,ATL,DEN
48,Home,W 117-100 ,240,45,99,.455,33,64,.516,12,35,.343,15,15,1.000,117,41,81,.506,38,66,.576,3,15,.200,15,22,.682,100,2012-03-25,MIN,DEN
49,@,W 117-101 ,240,44,81,.543,29,47,.617,15,34,.441,14,19,.737,117,35,74,.473,24,52,.462,11,22,.500,20,24,.833,101,2012-03-26,ORL,TOR
50,@,W 117-112 ,240,49,91,.538,39,71,.549,10,20,.500,9,12,.750,117,47,86,.547,39,65,.600,8,21,.381,10,13,.769,112,2012-03-28,SAS,SAC
51,@,L 117-122 (OT),265,43,96,.448,31,72,.431,12,24,.500,19,25,.760,117,44,98,.449,36,72,.500,8,26,.308,26,32,.813,122,2012-04-08,CLE,NJN
52,Home,W 117-110 ,240,41,79,.519,30,53,.566,11,26,.423,24,26,.923,117,43,86,.500,31,58,.534,12,28,.429,12,15,.800,110,2012-04-18,DAL,HOU
53,Home,W 117-107 (OT),265,47,88,.534,43,80,.538,4,8,.500,19,23,.826,117,42,96,.438,27,58,.466,15,38,.395,8,13,.615,107,2012-04-21,UTA,ORL
54,@,W 117-110 ,240,43,93,.462,31,66,.470,12,27,.444,19,28,.679,117,38,87,.437,28,65,.431,10,22,.455,24,27,.889,110,2012-11-07,PHO,CHA
55,@,L 117-119 (OT),265,41,88,.466,32,63,.508,9,25,.360,26,31,.839,117,44,86,.512,34,61,.557,10,25,.400,21,29,.724,119,2012-11-16,HOU,POR
56,Home,W 117-113 ,240,43,93,.462,30,68,.441,13,25,.520,18,24,.750,117,41,77,.532,31,56,.554,10,21,.476,21,22,.955,113,2012-11-17,MIL,NOH
57,Home,W 117-111 (OT),265,36,79,.456,25,56,.446,11,23,.478,34,39,.872,117,40,93,.430,33,73,.452,7,20,.350,24,33,.727,111,2012-11-21,OKC,LAC
58,Home,W 117-101 ,240,44,83,.530,31,57,.544,13,26,.500,16,21,.762,117,42,86,.488,34,63,.540,8,23,.348,9,12,.750,101,2012-11-27,HOU,TOR
59,Home,W 117-77 ,240,40,76,.526,28,60,.467,12,16,.750,25,35,.714,117,28,82,.341,22,61,.361,6,21,.286,15,20,.750,77,2012-11-28,DET,PHO
60,Home,L 117-118 (2OT),290,43,99,.434,30,64,.469,13,35,.371,18,22,.818,117,46,94,.489,37,69,.536,9,25,.360,17,21,.810,118,2012-12-01,CLE,POR
61,@,W 117-111 ,240,40,66,.606,33,52,.635,7,14,.500,30,34,.882,117,39,91,.429,25,57,.439,14,34,.412,19,23,.826,111,2012-12-04,OKC,BRK
62,Home,W 117-99 ,240,48,93,.516,41,70,.586,7,23,.304,14,24,.583,117,36,78,.462,27,54,.500,9,24,.375,18,20,.900,99,2012-12-08,LAC,PHO
63,@,W 117-110 ,240,45,83,.542,39,65,.600,6,18,.333,21,27,.778,117,40,85,.471,25,57,.439,15,28,.536,15,18,.833,110,2012-12-09,UTA,LAL
64,Home,W 117-115 (2OT),290,43,100,.430,37,78,.474,6,22,.273,25,30,.833,117,47,92,.511,39,69,.565,8,23,.348,13,17,.765,115,2012-12-12,BOS,DAL
65,@,W 117-110 ,240,46,89,.517,37,72,.514,9,17,.529,16,23,.696,117,43,88,.489,38,71,.535,5,17,.294,19,24,.792,110,2013-01-02,SAS,MIL
66,@,W 117-112 (OT),265,41,96,.427,36,75,.480,5,21,.238,30,35,.857,117,40,81,.494,33,54,.611,7,27,.259,25,32,.781,112,2013-01-10,DAL,SAC
67,@,W 117-109 ,240,42,78,.538,31,59,.525,11,19,.579,22,26,.846,117,41,82,.500,28,45,.622,13,37,.351,14,25,.560,109,2013-01-15,LAC,HOU
68,Home,W 117-97 ,240,44,85,.518,35,66,.530,9,19,.474,20,26,.769,117,33,73,.452,31,58,.534,2,15,.133,29,37,.784,97,2013-01-16,OKC,DEN
69,@,W 117-114 (OT),265,39,95,.411,33,75,.440,6,20,.300,33,36,.917,117,41,91,.451,34,71,.479,7,20,.350,25,30,.833,114,2013-01-18,OKC,DAL
70,@,W 117-90 ,240,46,98,.469,35,75,.467,11,23,.478,14,22,.636,117,34,84,.405,32,73,.438,2,11,.182,20,28,.714,90,2013-01-29,MIL,DET
71,Home,W 117-99 ,240,45,83,.542,41,69,.594,4,14,.286,23,43,.535,117,35,88,.398,29,68,.426,6,20,.300,23,26,.885,99,2013-02-01,DET,CLE
72,Home,W 117-111 ,240,40,87,.460,29,67,.433,11,20,.550,26,27,.963,117,44,89,.494,34,56,.607,10,33,.303,13,17,.765,111,2013-02-10,SAC,HOU
73,Home,W 117-104 ,240,43,74,.581,35,55,.636,8,19,.421,23,27,.852,117,39,73,.534,31,49,.633,8,24,.333,18,20,.900,104,2013-02-12,MIA,POR
74,Home,W 117-101 ,240,47,87,.540,35,58,.603,12,29,.414,11,14,.786,117,38,79,.481,25,50,.500,13,29,.448,12,15,.800,101,2013-03-06,LAC,MIL
75,Home,W 117-94 ,240,41,84,.488,32,63,.508,9,21,.429,26,37,.703,117,34,79,.430,23,51,.451,11,28,.393,15,22,.682,94,2013-03-13,DEN,NYK
76,Home,W 117-104 ,240,42,76,.553,38,63,.603,4,13,.308,29,43,.674,117,40,92,.435,33,65,.508,7,27,.259,17,21,.810,104,2013-03-15,OKC,ORL
77,@,W 117-86 ,240,42,79,.532,40,67,.597,2,12,.167,31,40,.775,117,36,95,.379,32,73,.438,4,22,.182,10,21,.476,86,2013-03-22,MIN,PHO
78,@,W 117-103 ,240,47,96,.490,39,75,.520,8,21,.381,15,21,.714,117,42,85,.494,33,61,.541,9,24,.375,10,12,.833,103,2013-03-24,PHI,SAC
79,Home,L 117-120 ,240,45,97,.464,40,80,.500,5,17,.294,22,30,.733,117,44,82,.537,34,60,.567,10,22,.455,22,38,.579,120,2013-03-27,MIN,LAL
80,@,W 117-103 ,240,44,83,.530,37,65,.569,7,18,.389,22,24,.917,117,42,94,.447,35,74,.473,7,20,.350,12,23,.522,103,2013-03-28,SAC,PHO
81,@,W 117-108 ,240,46,90,.511,40,70,.571,6,20,.300,19,19,1.000,117,39,87,.448,33,61,.541,6,26,.231,24,31,.774,108,2013-04-05,DAL,SAC
82,@,W 117-109 ,240,42,82,.512,30,57,.526,12,25,.480,21,26,.808,117,40,80,.500,32,61,.525,8,19,.421,21,26,.808,109,2013-04-12,BRK,IND
83,@,L 117-123 (OT),265,43,96,.448,28,55,.509,15,41,.366,16,25,.640,117,43,103,.417,32,78,.410,11,25,.440,26,34,.765,123,2013-11-13,HOU,PHI
84,Home,W 117-113 ,240,47,97,.485,40,77,.519,7,20,.350,16,21,.762,117,46,94,.489,40,72,.556,6,22,.273,15,19,.789,113,2013-11-15,DEN,MIN
85,@,W 117-110 ,240,45,88,.511,37,72,.514,8,16,.500,19,25,.760,117,40,88,.455,35,68,.515,5,20,.250,25,28,.893,110,2013-11-27,DEN,MIN
86,Home,W 117-110 ,240,48,87,.552,38,65,.585,10,22,.455,11,13,.846,117,38,88,.432,27,65,.415,11,23,.478,23,26,.885,110,2013-12-13,SAS,MIN
87,Home,W 117-94 ,240,45,71,.634,39,56,.696,6,15,.400,21,26,.808,117,39,84,.464,34,66,.515,5,18,.278,11,17,.647,94,2013-12-16,MIA,UTA
88,Home,W 117-90 ,240,42,90,.467,28,58,.483,14,32,.438,19,25,.760,117,30,81,.370,24,61,.393,6,20,.300,24,37,.649,90,2013-12-23,PHO,LAL
89,@,W 117-95 ,240,43,90,.478,32,66,.485,11,24,.458,20,29,.690,117,40,89,.449,35,67,.522,5,22,.227,10,17,.588,95,2013-12-28,MIN,MIL
90,Home,W 117-86 ,240,47,82,.573,37,60,.617,10,22,.455,13,16,.813,117,31,85,.365,24,57,.421,7,28,.250,17,31,.548,86,2013-12-29,OKC,HOU
91,Home,W 117-89 ,240,43,86,.500,33,63,.524,10,23,.435,21,23,.913,117,34,85,.400,30,66,.455,4,19,.211,17,22,.773,89,2014-01-16,IND,NYK
92,@,W 117-109 ,240,42,88,.477,37,72,.514,5,16,.313,28,35,.800,117,40,92,.435,26,55,.473,14,37,.378,15,19,.789,109,2014-01-17,CLE,DEN
93,Home,W 117-103 ,240,46,91,.505,38,72,.528,8,19,.421,17,26,.654,117,36,82,.439,27,54,.500,9,28,.321,22,30,.733,103,2014-01-19,PHO,DEN
94,Home,L 117-125 ,240,42,81,.519,38,65,.585,4,16,.250,29,34,.853,117,42,81,.519,32,56,.571,10,25,.400,31,40,.775,125,2014-01-26,SAC,DEN
95,@,W 117-115 ,240,41,74,.554,32,53,.604,9,21,.429,26,36,.722,117,40,86,.465,35,67,.522,5,19,.263,30,36,.833,115,2014-01-29,HOU,DAL
96,Home,L 117-126 ,240,38,89,.427,31,70,.443,7,19,.368,34,36,.944,117,42,78,.538,30,55,.545,12,23,.522,30,32,.938,126,2014-01-29,MIL,PHO
97,Home,W 117-86 ,240,43,76,.566,31,50,.620,12,26,.462,19,28,.679,117,31,87,.356,23,64,.359,8,23,.348,16,22,.727,86,2014-01-30,NYK,CLE
98,Home,W 117-90 ,240,48,85,.565,37,57,.649,11,28,.393,10,14,.714,117,32,76,.421,25,50,.500,7,26,.269,19,26,.731,90,2014-02-07,NYK,DEN
99,@,W 117-110 ,240,40,83,.482,32,60,.533,8,23,.348,29,38,.763,117,40,97,.412,35,80,.438,5,17,.294,25,34,.735,110,2014-02-08,POR,MIN
0,@,L 117-122 ,240,43,84,.512,30,53,.566,13,31,.419,18,22,.818,117,46,79,.582,42,69,.609,4,10,.400,26,31,.839,122,2014-02-12,POR,LAC
1,Home,W 117-90 ,240,45,86,.523,33,60,.550,12,26,.462,15,23,.652,117,33,84,.393,24,60,.400,9,24,.375,15,20,.750,90,2014-02-12,MIN,DEN
2,@,W 117-106 ,240,44,77,.571,34,51,.667,10,26,.385,19,24,.792,117,34,85,.400,25,58,.431,9,27,.333,29,32,.906,106,2014-02-18,MIA,DAL
3,Home,W 117-89 ,240,42,84,.500,32,67,.478,10,17,.588,23,27,.852,117,35,87,.402,28,72,.389,7,15,.467,12,22,.545,89,2014-02-21,CHI,DEN
4,Home,L 117-125 ,240,43,93,.462,31,64,.484,12,29,.414,19,24,.792,117,42,81,.519,29,51,.569,13,30,.433,28,39,.718,125,2014-02-23,OKC,LAC
5,Home,W 117-111 (OT),265,40,87,.460,34,69,.493,6,18,.333,31,40,.775,117,40,91,.440,29,63,.460,11,28,.393,20,30,.667,111,2014-03-18,SAC,WAS
6,@,W 117-107 ,240,42,87,.483,32,62,.516,10,25,.400,23,29,.793,117,43,91,.473,36,72,.500,7,19,.368,14,23,.609,107,2014-03-21,WAS,LAL
7,Home,W 117-96 ,240,45,89,.506,34,67,.507,11,22,.500,16,21,.762,117,30,77,.390,21,49,.429,9,28,.321,27,40,.675,96,2014-03-24,OKC,DEN
8,Home,W 117-98 ,240,48,82,.585,35,53,.660,13,29,.448,8,10,.800,117,36,91,.396,31,70,.443,5,21,.238,21,25,.840,98,2014-04-04,ATL,CLE
9,Home,W 117-95 ,240,44,81,.543,39,68,.574,5,13,.385,24,32,.750,117,39,88,.443,33,70,.471,6,18,.333,11,17,.647,95,2014-04-11,MEM,PHI
10,Home,W 117-101 ,240,41,81,.506,32,62,.516,9,19,.474,26,36,.722,117,35,82,.427,31,73,.425,4,9,.444,27,33,.818,101,2014-04-12,LAC,SAC
11,@,L 117-119 (OT),265,44,91,.484,27,54,.500,17,37,.459,12,16,.750,117,43,86,.500,33,62,.532,10,24,.417,23,32,.719,119,2014-04-13,GSW,POR
12,Home,W 117-105 ,240,44,83,.530,35,59,.593,9,24,.375,20,30,.667,117,35,82,.427,27,53,.509,8,29,.276,27,30,.900,105,2014-04-15,LAC,DEN
13,@,L 117-131 ,240,43,86,.500,36,69,.522,7,17,.412,24,29,.828,117,52,94,.553,44,68,.647,8,26,.308,19,23,.826,131,2014-11-15,MIN,DAL
14,Home,W 117-113 ,240,43,78,.551,34,61,.557,9,17,.529,22,27,.815,117,44,80,.550,33,55,.600,11,25,.440,14,19,.737,113,2014-11-18,MIL,NYK
15,Home,W 117-97 ,240,43,82,.524,32,58,.552,11,24,.458,20,25,.800,117,31,78,.397,26,62,.419,5,16,.313,30,34,.882,97,2014-11-21,DEN,NOP
16,Home,W 117-100 ,240,48,91,.527,40,75,.533,8,16,.500,13,14,.929,117,38,88,.432,29,61,.475,9,27,.333,15,21,.714,100,2014-11-21,MEM,BOS
17,@,W 117-103 ,240,44,87,.506,29,49,.592,15,38,.395,14,16,.875,117,33,74,.446,27,55,.491,6,19,.316,31,35,.886,103,2014-11-29,HOU,MIL
18,@,W 117-109 ,240,44,88,.500,34,65,.523,10,23,.435,19,21,.905,117,39,75,.520,36,65,.554,3,10,.300,28,37,.757,109,2014-12-02,TOR,SAC
19,@,W 117-106 ,240,40,79,.506,30,57,.526,10,22,.455,27,35,.771,117,40,89,.449,27,56,.482,13,33,.394,13,19,.684,106,2014-12-17,DAL,DET
20,@,W 117-116 (3OT),315,48,107,.449,38,80,.475,10,27,.370,11,14,.786,117,43,105,.410,26,70,.371,17,35,.486,13,27,.481,116,2014-12-17,MEM,SAS
21,@,W 117-111 (OT),265,41,91,.451,27,57,.474,14,34,.412,21,28,.750,117,43,104,.413,36,80,.450,7,24,.292,18,23,.783,111,2014-12-26,HOU,MEM
22,Home,W 117-91 ,240,41,88,.466,26,60,.433,15,28,.536,20,32,.625,117,30,98,.306,25,70,.357,5,28,.179,26,34,.765,91,2015-01-05,GSW,OKC
23,Home,W 117-102 ,240,45,91,.495,33,63,.524,12,28,.429,15,20,.750,117,37,81,.457,31,55,.564,6,26,.231,22,23,.957,102,2015-01-07,GSW,IND
24,@,W 117-108 ,240,44,92,.478,35,64,.547,9,28,.321,20,31,.645,117,41,89,.461,36,71,.507,5,18,.278,21,26,.808,108,2015-01-17,LAC,SAC
25,@,W 117-115 (OT),265,48,90,.533,44,76,.579,4,14,.286,17,23,.739,117,41,101,.406,29,72,.403,12,29,.414,21,28,.750,115,2015-01-25,WAS,DEN
26,Home,W 117-111 ,240,41,81,.506,26,49,.531,15,32,.469,20,29,.690,117,48,95,.505,44,78,.564,4,17,.235,11,15,.733,111,2015-02-06,HOU,MIL
27,@,W 117-105 ,240,44,86,.512,34,65,.523,10,21,.476,19,20,.950,117,42,93,.452,37,77,.481,5,16,.313,16,22,.727,105,2015-02-09,ATL,MIN
28,Home,W 117-113 (OT),265,48,97,.495,39,71,.549,9,26,.346,12,21,.571,117,39,101,.386,31,77,.403,8,24,.333,27,30,.900,113,2015-02-26,PHO,OKC
29,Home,W 117-107 ,240,41,85,.482,30,67,.448,11,18,.611,24,30,.800,117,43,97,.443,35,71,.493,8,26,.308,13,18,.722,107,2015-03-10,SAS,TOR
30,@,W 117-98 ,240,39,82,.476,27,59,.458,12,23,.522,27,33,.818,117,38,88,.432,36,69,.522,2,19,.105,20,25,.800,98,2015-03-16,TOR,IND
31,Home,W 117-92 ,240,45,82,.549,30,53,.566,15,29,.517,12,20,.600,117,36,80,.450,31,60,.517,5,20,.250,15,21,.714,92,2015-03-18,CLE,BRK
32,@,W 117-102 ,240,46,92,.500,38,77,.494,8,15,.533,17,24,.708,117,41,87,.471,31,53,.585,10,34,.294,10,12,.833,102,2015-03-21,PHO,HOU
33,@,L 117-127 ,240,44,85,.518,35,66,.530,9,19,.474,20,27,.741,117,48,86,.558,37,65,.569,11,21,.524,20,23,.870,127,2015-03-24,LAL,OKC
34,@,W 117-116 (OT),265,47,97,.485,39,71,.549,8,26,.308,15,22,.682,117,40,83,.482,34,60,.567,6,23,.261,30,38,.789,116,2015-04-04,BOS,TOR
35,Home,W 117-80 ,240,45,89,.506,33,69,.478,12,20,.600,15,23,.652,117,32,82,.390,27,67,.403,5,15,.333,11,17,.647,80,2015-04-10,BRK,WAS
36,Home,W 117-78 ,240,46,84,.548,36,60,.600,10,24,.417,15,22,.682,117,31,79,.392,28,57,.491,3,22,.136,13,19,.684,78,2015-04-12,BOS,CLE
37,Home,W 117-91 ,240,41,76,.539,29,48,.604,12,28,.429,23,34,.676,117,38,101,.376,33,74,.446,5,27,.185,10,18,.556,91,2015-04-15,HOU,UTA
38,@,W 117-110 ,240,41,86,.477,32,67,.478,9,19,.474,26,32,.813,117,38,90,.422,32,68,.471,6,22,.273,28,33,.848,110,2015-10-31,NYK,WAS
39,Home,W 117-93 ,240,45,86,.523,32,61,.525,13,25,.520,14,18,.778,117,35,92,.380,26,66,.394,9,26,.346,14,19,.737,93,2015-11-01,OKC,DEN
40,@,W 117-107 ,240,46,80,.575,39,65,.600,7,15,.467,18,22,.818,117,44,86,.512,31,55,.564,13,31,.419,6,7,.857,107,2015-11-09,MIN,ATL
41,Home,L 117-124 ,240,44,88,.500,31,59,.525,13,29,.448,16,24,.667,117,38,73,.521,21,43,.488,17,30,.567,31,36,.861,124,2015-11-19,LAC,GSW
42,Home,W 117-114 ,240,47,90,.522,38,68,.559,9,22,.409,14,18,.778,117,44,83,.530,34,64,.531,10,19,.526,16,28,.571,114,2015-11-22,OKC,DAL
43,Home,W 117-103 ,240,43,81,.531,25,46,.543,18,35,.514,13,22,.591,117,40,81,.494,30,59,.508,10,22,.455,13,21,.619,103,2015-11-23,CLE,ORL
44,Home,W 117-98 ,240,47,88,.534,39,63,.619,8,25,.320,15,18,.833,117,39,81,.481,32,57,.561,7,24,.292,13,17,.765,98,2015-12-26,ATL,NYK
45,Home,L 117-122 ,240,38,88,.432,29,58,.500,9,30,.300,32,36,.889,117,37,71,.521,22,41,.537,15,30,.500,33,41,.805,122,2015-12-30,CHO,LAC
46,Home,W 117-106 ,240,46,83,.554,41,64,.641,5,19,.263,20,20,1.000,117,46,102,.451,40,86,.465,6,16,.375,8,14,.571,106,2016-01-05,CHI,MIL
47,Home,W 117-116 (2OT),290,45,98,.459,33,69,.478,12,29,.414,15,23,.652,117,47,99,.475,35,67,.522,12,32,.375,10,14,.714,116,2016-01-05,DAL,SAC
48,@,W 117-113 ,240,45,89,.506,40,72,.556,5,17,.294,22,26,.846,117,40,84,.476,31,58,.534,9,26,.346,24,25,.960,113,2016-01-08,OKC,LAL
49,Home,W 117-103 ,240,42,96,.438,28,66,.424,14,30,.467,19,29,.655,117,35,89,.393,25,62,.403,10,27,.370,23,28,.821,103,2016-01-15,BOS,PHO
50,Home,L 117-119 ,240,40,89,.449,34,67,.507,6,22,.273,31,36,.861,117,39,88,.443,30,59,.508,9,29,.310,32,36,.889,119,2016-01-16,WAS,BOS
51,Home,W 117-87 ,240,39,69,.565,32,51,.627,7,18,.389,32,40,.800,117,35,81,.432,32,66,.485,3,15,.200,14,25,.560,87,2016-01-17,MIN,PHO
52,@,W 117-89 ,240,42,86,.488,33,72,.458,9,14,.643,24,28,.857,117,32,81,.395,26,63,.413,6,18,.333,19,23,.826,89,2016-01-21,SAS,PHO
53,@,W 117-113 ,240,41,81,.506,32,63,.508,9,18,.500,26,33,.788,117,39,88,.443,28,60,.467,11,28,.393,24,30,.800,113,2016-01-28,DEN,WAS
54,Home,W 117-103 ,240,45,82,.549,36,59,.610,9,23,.391,18,21,.857,117,40,81,.494,34,63,.540,6,18,.333,17,21,.810,103,2016-01-30,CLE,SAS
55,@,L 117-121 ,240,38,92,.413,29,68,.426,9,24,.375,32,38,.842,117,41,79,.519,33,61,.541,8,18,.444,31,37,.838,121,2016-01-30,SAC,MEM
56,Home,W 117-114 ,240,44,93,.473,35,66,.530,9,27,.333,20,25,.800,117,47,95,.495,37,72,.514,10,23,.435,10,12,.833,114,2016-02-03,OKC,ORL
57,@,W 117-110 (OT),265,46,93,.495,37,64,.578,9,29,.310,16,22,.727,117,43,92,.467,31,63,.492,12,29,.414,12,20,.600,110,2016-02-08,ORL,ATL
58,@,W 117-95 ,240,45,87,.517,33,59,.559,12,28,.429,15,19,.789,117,40,92,.435,36,74,.486,4,18,.222,11,15,.733,95,2016-02-10,CHO,IND
59,Home,W 117-112 ,240,35,76,.461,31,62,.500,4,14,.286,43,53,.811,117,39,86,.453,29,55,.527,10,31,.323,24,32,.750,112,2016-02-10,MIN,TOR
60,@,W 117-109 (2OT),290,46,104,.442,43,87,.494,3,17,.176,22,32,.688,117,44,106,.415,35,65,.538,9,41,.220,12,18,.667,109,2016-02-20,MIL,ATL
61,Home,W 117-114 (OT),265,38,74,.514,28,50,.560,10,24,.417,31,38,.816,117,36,87,.414,25,53,.472,11,34,.324,31,41,.756,114,2016-02-23,UTA,HOU
62,@,W 117-107 ,240,43,89,.483,34,60,.567,9,29,.310,22,26,.846,117,34,78,.436,22,54,.407,12,24,.500,27,37,.730,107,2016-02-26,LAC,SAC
63,Home,W 117-107 ,240,38,78,.487,26,55,.473,12,23,.522,29,38,.763,117,35,79,.443,24,48,.500,11,31,.355,26,32,.813,107,2016-03-02,DEN,LAL
64,Home,W 117-115 ,240,34,67,.507,28,55,.509,6,12,.500,43,54,.796,117,39,83,.470,28,56,.500,11,27,.407,26,35,.743,115,2016-03-04,TOR,POR
65,Home,W 117-96 ,240,43,88,.489,30,67,.448,13,21,.619,18,24,.750,117,35,87,.402,29,67,.433,6,20,.300,20,23,.870,96,2016-03-16,WAS,CHI
66,@,W 117-112 ,240,36,78,.462,27,51,.529,9,27,.333,36,40,.900,117,40,83,.482,30,62,.484,10,21,.476,22,28,.786,112,2016-03-18,POR,NOP
67,@,W 117-102 ,240,46,91,.505,33,66,.500,13,25,.520,12,20,.600,117,38,78,.487,25,45,.556,13,33,.394,13,17,.765,102,2016-03-21,WAS,ATL
68,Home,W 117-105 ,240,44,83,.530,30,50,.600,14,33,.424,15,20,.750,117,42,90,.467,32,60,.533,10,30,.333,11,12,.917,105,2016-03-27,GSW,PHI
69,@,L 117-119 ,240,42,76,.553,26,47,.553,16,29,.552,17,22,.773,117,45,87,.517,35,55,.636,10,32,.313,19,24,.792,119,2016-03-31,LAC,OKC
70,Home,L 117-124 (OT),265,49,98,.500,37,63,.587,12,35,.343,7,8,.875,117,44,86,.512,36,69,.522,8,17,.471,28,36,.778,124,2016-04-05,GSW,MIN
71,Home,W 117-103 ,240,47,86,.547,36,57,.632,11,29,.379,12,19,.632,117,42,91,.462,34,64,.531,8,27,.296,11,18,.611,103,2016-04-13,CHO,ORL
72,Home,W 117-88 ,240,45,94,.479,32,59,.542,13,35,.371,14,19,.737,117,32,87,.368,23,60,.383,9,27,.333,15,20,.750,88,2016-10-25,CLE,NYK
73,@,L 117-122 ,240,43,97,.443,28,53,.528,15,44,.341,16,20,.800,117,48,89,.539,37,57,.649,11,32,.344,15,18,.833,122,2016-10-26,BRK,BOS
74,@,W 117-113 ,240,44,91,.484,34,59,.576,10,32,.313,19,21,.905,117,36,82,.439,27,56,.482,9,26,.346,32,41,.780,113,2016-11-01,MIL,NOP
75,@,W 117-104 ,240,46,89,.517,37,68,.544,9,21,.429,16,21,.762,117,37,84,.440,29,61,.475,8,23,.348,22,27,.815,104,2016-11-04,NYK,CHI
76,Home,W 117-97 ,240,45,95,.474,37,65,.569,8,30,.267,19,21,.905,117,39,86,.453,34,54,.630,5,32,.156,14,20,.700,97,2016-11-04,LAL,GSW
77,Home,W 117-91 ,240,41,82,.500,27,49,.551,14,33,.424,21,25,.840,117,33,84,.393,23,56,.411,10,28,.357,15,19,.789,91,2016-11-05,MIL,SAC
78,Home,W 117-96 ,240,48,95,.505,35,63,.556,13,32,.406,8,14,.571,117,36,83,.434,25,54,.463,11,29,.379,13,20,.650,96,2016-11-12,ATL,PHI
79,Home,L 117-119 ,240,47,92,.511,40,67,.597,7,25,.280,16,26,.615,117,46,86,.535,35,62,.565,11,24,.458,16,20,.800,119,2016-11-13,OKC,ORL
80,@,L 117-121 ,240,46,96,.479,33,67,.493,13,29,.448,12,18,.667,117,44,83,.530,31,50,.620,13,33,.394,20,28,.714,121,2016-11-15,TOR,CLE
81,Home,W 117-96 ,240,45,83,.542,36,59,.610,9,24,.375,18,23,.783,117,33,86,.384,30,69,.435,3,17,.176,27,33,.818,96,2016-11-23,NOP,MIN
82,@,W 117-104 ,240,40,85,.471,19,35,.543,21,50,.420,16,20,.800,117,39,80,.488,30,48,.625,9,32,.281,17,21,.810,104,2016-11-25,HOU,SAC
83,@,W 117-87 ,240,43,84,.512,36,58,.621,7,26,.269,24,29,.828,117,30,81,.370,19,55,.345,11,26,.423,16,24,.667,87,2016-12-07,BOS,ORL
84,@,W 117-90 ,240,42,84,.500,28,55,.509,14,29,.483,19,23,.826,117,37,78,.474,34,62,.548,3,16,.188,13,20,.650,90,2016-12-09,DET,MIN
85,Home,W 117-110 ,240,43,81,.531,33,62,.532,10,19,.526,21,30,.700,117,43,87,.494,36,64,.563,7,23,.304,17,24,.708,110,2016-12-18,WAS,LAC
86,Home,W 117-107 ,240,45,79,.570,32,55,.582,13,24,.542,14,18,.778,117,43,81,.531,29,56,.518,14,25,.560,7,9,.778,107,2016-12-19,DEN,DAL
87,Home,W 117-113 ,240,43,94,.457,32,69,.464,11,25,.440,20,24,.833,117,44,90,.489,28,57,.491,16,33,.485,9,11,.818,113,2016-12-20,CHO,LAL
88,@,W 117-101 ,240,47,104,.452,35,67,.522,12,37,.324,11,14,.786,117,38,86,.442,25,51,.490,13,35,.371,12,16,.750,101,2016-12-22,GSW,BRK
89,@,W 117-112 ,240,41,80,.513,30,54,.556,11,26,.423,24,36,.667,117,41,93,.441,32,65,.492,9,28,.321,21,26,.808,112,2016-12-23,OKC,BOS
90,Home,W 117-114 ,240,38,74,.514,21,42,.500,17,32,.531,24,29,.828,117,48,90,.533,37,62,.597,11,28,.393,7,10,.700,114,2016-12-30,BOS,MIA
91,Home,W 117-104 ,240,43,86,.500,34,64,.531,9,22,.409,22,24,.917,117,42,97,.433,32,59,.542,10,38,.263,10,11,.909,104,2017-01-01,IND,ORL
92,@,L 117-125 ,240,40,89,.449,28,63,.444,12,26,.462,25,28,.893,117,44,87,.506,31,51,.608,13,36,.361,24,29,.828,125,2017-01-04,POR,GSW
93,Home,W 117-108 ,240,40,93,.430,22,57,.386,18,36,.500,19,21,.905,117,40,85,.471,30,54,.556,10,31,.323,18,23,.783,108,2017-01-07,BOS,NOP
94,@,W 117-106 ,240,45,89,.506,35,60,.583,10,29,.345,17,20,.850,117,36,74,.486,25,46,.543,11,28,.393,23,29,.793,106,2017-01-08,GSW,SAC
95,@,W 117-97 ,240,44,92,.478,37,69,.536,7,23,.304,22,38,.579,117,35,87,.402,25,58,.431,10,29,.345,17,23,.739,97,2017-01-10,ATL,BRK
96,Home,W 117-108 ,240,43,85,.506,26,44,.591,17,41,.415,14,18,.778,117,45,105,.429,35,79,.443,10,26,.385,8,12,.667,108,2017-01-11,BOS,WAS
97,@,W 117-106 ,240,46,91,.505,36,66,.545,10,25,.400,15,18,.833,117,35,91,.385,26,58,.448,9,33,.273,27,29,.931,106,2017-01-18,NYK,BOS
98,Home,W 117-101 ,240,49,88,.557,42,66,.636,7,22,.318,12,15,.800,117,34,93,.366,29,69,.420,5,24,.208,28,35,.800,101,2017-01-31,WAS,NYK
99,@,L 117-121 ,240,45,83,.542,36,59,.610,9,24,.375,18,23,.783,117,40,89,.449,31,61,.508,9,28,.321,32,44,.727,121,2017-02-03,MIL,DEN
0,@,L 117-121 (OT),265,48,100,.480,40,75,.533,8,25,.320,13,18,.722,117,44,98,.449,28,55,.509,16,43,.372,17,25,.680,121,2017-02-03,CHI,HOU
1,Home,W 117-106 ,240,47,93,.505,39,66,.591,8,27,.296,15,18,.833,117,40,100,.400,27,56,.482,13,44,.295,13,21,.619,106,2017-02-08,ATL,DEN
2,Home,L 117-132 ,240,41,82,.500,28,57,.491,13,25,.520,22,26,.846,117,46,84,.548,30,48,.625,16,36,.444,24,26,.923,132,2017-02-08,IND,CLE
3,Home,W 117-109 ,240,39,86,.453,30,61,.492,9,25,.360,30,38,.789,117,39,85,.459,32,62,.516,7,23,.304,24,28,.857,109,2017-02-11,PHI,MIA
4,Home,W 117-89 ,240,44,81,.543,38,57,.667,6,24,.250,23,26,.885,117,35,84,.417,25,59,.424,10,25,.400,9,13,.692,89,2017-02-12,MIN,CHI
5,@,W 117-109 ,240,44,84,.524,31,49,.633,13,35,.371,16,24,.667,117,36,87,.414,23,47,.489,13,40,.325,24,31,.774,109,2017-02-15,MIA,HOU
6,@,W 117-99 ,240,46,93,.495,31,63,.492,15,30,.500,10,16,.625,117,37,80,.463,23,43,.535,14,37,.378,11,15,.733,99,2017-02-25,CHI,CLE
7,@,W 117-108 ,240,41,91,.451,28,61,.459,13,30,.433,22,25,.880,117,32,88,.364,22,43,.512,10,45,.222,34,42,.810,108,2017-02-27,IND,HOU
8,@,W 116-109 (3OT),315,45,102,.441,37,74,.500,8,28,.286,18,23,.783,116,36,94,.383,30,72,.417,6,22,.273,31,46,.674,109,2012-01-05,MIA,ATL
9,Home,W 116-101 ,240,45,82,.549,34,63,.540,11,19,.579,15,22,.682,116,39,84,.464,34,72,.472,5,12,.417,18,22,.818,101,2012-01-27,DAL,UTA
10,Home,L 116-119 ,240,44,80,.550,35,59,.593,9,21,.429,19,23,.826,116,44,84,.524,33,58,.569,11,26,.423,20,21,.952,119,2012-02-07,GSW,OKC
11,@,L 116-119 (OT),265,45,98,.459,33,71,.465,12,27,.444,14,21,.667,116,40,88,.455,29,61,.475,11,27,.407,28,35,.800,119,2012-03-05,SAC,DEN
12,Home,W 116-98 ,240,45,76,.592,39,64,.609,6,12,.500,20,24,.833,116,29,70,.414,26,59,.441,3,11,.273,37,44,.841,98,2012-03-07,TOR,HOU
13,@,W 116-111 (2OT),290,41,83,.494,35,63,.556,6,20,.300,28,34,.824,116,52,116,.448,50,97,.515,2,19,.105,5,5,1.000,111,2012-03-13,LAL,MEM
14,@,W 116-87 ,240,48,83,.578,37,62,.597,11,21,.524,9,13,.692,116,29,82,.354,22,58,.379,7,24,.292,22,26,.846,87,2012-03-20,MIL,POR
15,Home,W 116-115 ,240,46,79,.582,37,62,.597,9,17,.529,15,22,.682,116,40,79,.506,26,61,.426,14,18,.778,21,30,.700,115,2012-03-21,DEN,DET
16,Home,W 116-100 ,240,45,95,.474,38,76,.500,7,19,.368,19,25,.760,116,39,88,.443,32,66,.485,7,22,.318,15,20,.750,100,2012-03-21,SAS,MIN
17,Home,W 116-108 ,240,43,85,.506,36,62,.581,7,23,.304,23,28,.821,116,39,81,.481,28,60,.467,11,21,.524,19,26,.731,108,2012-04-02,SAC,MIN
18,@,W 116-96 ,240,43,82,.524,34,62,.548,9,20,.450,21,23,.913,116,38,81,.469,35,74,.473,3,7,.429,17,24,.708,96,2012-04-07,ATL,CHA
19,Home,W 116-94 ,240,47,94,.500,35,69,.507,12,25,.480,10,11,.909,116,34,78,.436,28,56,.500,6,22,.273,20,23,.870,94,2012-04-07,MIL,POR
20,Home,W 116-77 ,240,45,75,.600,37,57,.649,8,18,.444,18,20,.900,116,27,78,.346,20,57,.351,7,21,.333,16,21,.762,77,2012-04-17,DET,CLE
21,Home,W 116-84 ,240,42,85,.494,34,57,.596,8,28,.286,24,29,.828,116,32,92,.348,25,67,.373,7,25,.280,13,19,.684,84,2012-04-18,ATL,DET
22,Home,W 116-106 ,240,42,83,.506,33,63,.524,9,20,.450,23,28,.821,116,36,72,.500,28,54,.519,8,18,.444,26,32,.813,106,2012-10-31,POR,LAL
23,@,L 116-119 ,240,49,95,.516,44,74,.595,5,21,.238,13,20,.650,116,43,83,.518,33,58,.569,10,25,.400,23,27,.852,119,2012-11-03,DEN,MIA
24,@,W 116-109 (OT),265,39,88,.443,33,67,.493,6,21,.286,32,37,.865,116,45,91,.495,38,71,.535,7,20,.350,12,17,.706,109,2012-11-24,OKC,PHI
25,@,W 116-110 (OT),265,47,105,.448,40,87,.460,7,18,.389,15,19,.789,116,41,90,.456,30,64,.469,11,26,.423,17,19,.895,110,2012-11-25,BOS,ORL
26,@,L 116-124 ,240,48,94,.511,37,74,.500,11,20,.550,9,11,.818,116,46,83,.554,35,61,.574,11,22,.500,21,26,.808,124,2012-12-01,UTA,HOU
27,Home,W 116-81 ,240,47,86,.547,35,62,.565,12,24,.500,10,16,.625,116,29,76,.382,20,53,.377,9,23,.391,14,18,.778,81,2012-12-01,LAC,SAC
28,@,W 116-109 ,240,43,91,.473,33,67,.493,10,24,.417,20,25,.800,116,35,72,.486,23,37,.622,12,35,.343,27,38,.711,109,2012-12-08,DAL,HOU
29,Home,W 116-107 ,240,42,79,.532,30,54,.556,12,25,.480,20,30,.667,116,35,84,.417,23,47,.489,12,37,.324,25,29,.862,107,2012-12-13,NYK,LAL
30,@,L 116-122 ,240,45,86,.523,34,54,.630,11,32,.344,15,26,.577,116,44,77,.571,32,54,.593,12,23,.522,22,24,.917,122,2012-12-28,HOU,SAS
31,@,W 116-114 ,240,38,77,.494,31,54,.574,7,23,.304,33,41,.805,116,34,71,.479,25,56,.446,9,15,.600,37,40,.925,114,2012-12-28,LAC,UTA
32,@,W 116-101 ,240,44,87,.506,35,58,.603,9,29,.310,19,28,.679,116,39,98,.398,33,70,.471,6,28,.214,17,22,.773,101,2013-01-11,OKC,LAL
33,Home,W 116-105 ,240,43,90,.478,34,63,.540,9,27,.333,21,27,.778,116,43,83,.518,30,59,.508,13,24,.542,6,8,.750,105,2013-01-13,DEN,GSW
34,@,W 116-112 ,240,38,77,.494,28,55,.509,10,22,.455,30,35,.857,116,45,79,.570,36,55,.655,9,24,.375,13,23,.565,112,2013-01-19,GSW,NOH
35,@,L 116-123 (OT),265,44,88,.500,30,57,.526,14,31,.452,14,18,.778,116,45,82,.549,36,60,.600,9,22,.409,24,38,.632,123,2013-01-23,TOR,MIA
36,Home,W 116-95 ,240,46,87,.529,41,76,.539,5,11,.455,19,25,.760,116,36,87,.414,31,64,.484,5,23,.217,18,30,.600,95,2013-02-07,BOS,LAL
37,Home,W 116-91 ,240,38,77,.494,27,57,.474,11,20,.550,29,38,.763,116,34,89,.382,28,73,.384,6,16,.375,17,24,.708,91,2013-02-09,DAL,GSW
38,@,W 116-107 ,240,43,91,.473,33,57,.579,10,34,.294,20,25,.800,116,38,84,.452,30,64,.469,8,20,.400,23,31,.742,107,2013-02-12,HOU,GSW
39,@,W 116-90 ,240,43,73,.589,35,56,.625,8,17,.471,22,28,.786,116,32,76,.421,27,60,.450,5,16,.313,21,25,.840,90,2013-02-21,SAS,LAC
40,Home,W 116-94 ,240,44,83,.530,28,51,.549,16,32,.500,12,21,.571,116,37,81,.457,30,60,.500,7,21,.333,13,15,.867,94,2013-02-28,LAL,MIN
41,@,W 116-94 ,240,46,81,.568,34,57,.596,12,24,.500,12,16,.750,116,35,85,.412,28,62,.452,7,23,.304,17,25,.680,94,2013-03-08,OKC,CHA
42,@,L 116-118 (OT),265,48,93,.516,40,71,.563,8,22,.364,12,16,.750,116,39,91,.429,25,52,.481,14,39,.359,26,36,.722,118,2013-03-08,TOR,LAL
43,Home,W 116-101 ,240,37,73,.507,23,45,.511,14,28,.500,28,34,.824,116,36,80,.450,27,54,.500,9,26,.346,20,26,.769,101,2013-03-19,SAC,LAC
44,Home,W 116-78 ,240,44,77,.571,34,48,.708,10,29,.345,18,27,.667,116,31,86,.360,27,66,.409,4,20,.200,12,15,.800,78,2013-03-22,HOU,CLE
45,Home,W 116-107 ,240,45,81,.556,35,64,.547,10,17,.588,16,24,.667,116,42,81,.519,34,58,.586,8,23,.348,15,19,.789,107,2013-03-30,UTA,BRK
46,@,W 116-98 ,240,39,76,.513,27,48,.563,12,28,.429,26,35,.743,116,38,91,.418,36,71,.507,2,20,.100,20,24,.833,98,2013-04-05,HOU,POR
47,@,W 116-97 ,240,42,83,.506,30,56,.536,12,27,.444,20,23,.870,116,37,84,.440,30,68,.441,7,16,.438,16,26,.615,97,2013-04-11,OKC,GSW
48,@,L 116-118 ,240,46,97,.474,35,71,.493,11,26,.423,13,16,.813,116,34,66,.515,22,41,.537,12,25,.480,38,50,.760,118,2013-04-12,GSW,LAL
49,Home,W 116-106 ,240,46,85,.541,37,65,.569,9,20,.450,15,18,.833,116,45,98,.459,37,74,.500,8,24,.333,8,13,.615,106,2013-04-15,GSW,SAS
50,Home,W 116-103 ,240,42,93,.452,28,64,.438,14,29,.483,18,28,.643,116,41,83,.494,33,62,.532,8,21,.381,13,23,.565,103,2013-10-29,LAL,LAC
51,@,W 116-101 ,240,41,75,.547,35,53,.660,6,22,.273,28,34,.824,116,36,87,.414,26,56,.464,10,31,.323,19,29,.655,101,2013-11-05,HOU,POR
52,@,W 116-102 ,240,43,98,.439,25,65,.385,18,33,.545,12,16,.750,116,39,83,.470,33,65,.508,6,18,.333,18,26,.692,102,2013-11-06,WAS,PHI
53,Home,W 116-108 ,240,41,89,.461,33,69,.478,8,20,.400,26,30,.867,116,44,90,.489,34,68,.500,10,22,.455,10,15,.667,108,2013-11-08,MIN,DAL
54,Home,W 116-95 ,240,44,79,.557,33,59,.559,11,20,.550,17,21,.810,116,34,84,.405,31,74,.419,3,10,.300,24,33,.727,95,2013-11-12,LAL,NOP
55,Home,W 116-115 ,240,45,94,.479,31,71,.437,14,23,.609,12,14,.857,116,41,80,.513,32,58,.552,9,22,.409,24,28,.857,115,2013-11-14,GSW,OKC
56,Home,W 116-111 ,240,46,87,.529,40,66,.606,6,21,.286,18,22,.818,116,44,83,.530,31,55,.564,13,28,.464,10,13,.769,111,2013-11-26,WAS,LAL
57,@,W 116-103 ,240,45,82,.549,32,59,.542,13,23,.565,13,16,.813,116,38,83,.458,28,60,.467,10,23,.435,17,19,.895,103,2013-12-10,SAS,TOR
58,@,W 116-100 ,240,40,71,.563,31,53,.585,9,18,.500,27,33,.818,116,34,81,.420,28,66,.424,6,15,.400,26,34,.765,100,2013-12-11,OKC,MEM
59,@,W 116-112 ,240,39,79,.494,27,50,.540,12,29,.414,26,35,.743,116,43,90,.478,37,68,.544,6,22,.273,20,24,.833,112,2013-12-13,HOU,GSW
60,Home,W 116-107 ,240,41,83,.494,29,59,.492,12,24,.500,22,29,.759,116,38,87,.437,32,68,.471,6,19,.316,25,29,.862,107,2013-12-13,PHO,SAC
61,Home,L 116-119 ,240,48,102,.471,39,85,.459,9,17,.529,11,16,.688,116,41,92,.446,26,59,.441,15,33,.455,22,25,.880,119,2013-12-17,CLE,POR
62,@,W 116-106 ,240,44,84,.524,41,74,.554,3,10,.300,25,28,.893,116,42,90,.467,30,67,.448,12,23,.522,10,17,.588,106,2013-12-20,CHA,DET
63,Home,W 116-106 ,240,43,82,.524,36,57,.632,7,25,.280,23,25,.920,116,38,93,.409,28,70,.400,10,23,.435,20,22,.909,106,2013-12-21,MIL,PHI
64,@,L 116-120 (OT),265,45,96,.469,39,74,.527,6,22,.273,20,27,.741,116,46,97,.474,39,68,.574,7,29,.241,21,27,.778,120,2013-12-22,MIN,LAC
65,@,W 116-107 ,240,37,75,.493,30,59,.508,7,16,.438,35,42,.833,116,39,85,.459,34,68,.500,5,17,.294,24,31,.774,107,2013-12-26,SAS,DAL
66,Home,W 116-112 (OT),265,42,96,.438,29,60,.483,13,36,.361,19,22,.864,116,49,110,.445,41,90,.456,8,20,.400,6,12,.500,112,2013-12-26,POR,LAC
67,@,L 116-118 (OT),265,45,104,.433,35,78,.449,10,26,.385,16,22,.727,116,37,91,.407,21,52,.404,16,39,.410,28,34,.824,118,2013-12-28,CHA,ATL
68,Home,W 116-100 ,240,41,85,.482,29,58,.500,12,27,.444,22,25,.880,116,37,68,.544,27,47,.574,10,21,.476,16,20,.800,100,2014-01-04,PHO,MIL
69,Home,W 116-92 ,240,50,90,.556,46,72,.639,4,18,.222,12,16,.750,116,37,79,.468,34,64,.531,3,15,.200,15,21,.714,92,2014-01-04,SAS,LAC
70,Home,W 116-94 ,240,40,79,.506,28,56,.500,12,23,.522,24,30,.800,116,35,83,.422,26,64,.406,9,19,.474,15,22,.682,94,2014-01-13,TOR,MIL
71,Home,W 116-92 ,240,45,82,.549,39,66,.591,6,16,.375,20,25,.800,116,39,92,.424,35,79,.443,4,13,.308,10,17,.588,92,2014-01-14,IND,SAC
72,Home,L 116-123 ,240,39,90,.433,30,62,.484,9,28,.321,29,33,.879,116,45,83,.542,33,59,.559,12,24,.500,21,29,.724,123,2014-01-15,GSW,DEN
73,@,W 116-111 (OT),265,41,95,.432,33,71,.465,8,24,.333,26,33,.788,116,39,101,.386,27,69,.391,12,32,.375,21,29,.724,111,2014-01-24,IND,SAC
74,Home,W 116-106 ,240,43,74,.581,36,53,.679,7,21,.333,23,28,.821,116,43,91,.473,39,78,.500,4,13,.308,16,28,.571,106,2014-01-26,DAL,DET
75,Home,W 116-115 ,240,40,83,.482,35,65,.538,5,18,.278,31,44,.705,116,42,84,.500,36,63,.571,6,21,.286,25,34,.735,115,2014-02-03,DEN,LAC
76,@,W 116-112 ,240,41,78,.526,28,47,.596,13,31,.419,21,26,.808,116,37,86,.430,30,61,.492,7,25,.280,31,42,.738,112,2014-02-05,MIA,LAC
77,Home,W 116-98 ,240,42,82,.512,34,62,.548,8,20,.400,24,31,.774,116,38,90,.422,30,72,.417,8,18,.444,14,20,.700,98,2014-02-19,CHA,DET
78,Home,W 116-104 ,240,40,74,.541,30,51,.588,10,23,.435,26,32,.813,116,42,78,.538,37,65,.569,5,13,.385,15,17,.882,104,2014-02-28,PHO,NOP
79,Home,W 116-99 ,240,41,82,.500,33,60,.550,8,22,.364,26,30,.867,116,30,68,.441,22,46,.478,8,22,.364,31,40,.775,99,2014-03-02,OKC,CHA
80,@,W 116-102 ,240,43,83,.518,39,69,.565,4,14,.286,26,32,.813,116,36,82,.439,30,65,.462,6,17,.353,24,29,.828,102,2014-03-05,SAC,MIL
81,@,W 116-92 ,240,42,80,.525,31,61,.508,11,19,.579,21,24,.875,116,34,81,.420,26,62,.419,8,19,.421,16,23,.696,92,2014-03-12,NYK,BOS
82,Home,W 116-103 ,240,41,81,.506,27,46,.587,14,35,.400,20,25,.800,116,38,90,.422,26,63,.413,12,27,.444,15,17,.882,103,2014-03-20,POR,WAS
83,Home,W 116-111 (OT),265,46,92,.500,38,71,.535,8,21,.381,16,23,.696,116,40,83,.482,23,46,.500,17,37,.459,14,16,.875,111,2014-03-26,CHA,BRK
84,Home,W 116-96 ,240,41,74,.554,30,56,.536,11,18,.611,23,26,.885,116,36,86,.419,30,65,.462,6,21,.286,18,24,.750,96,2014-03-30,OKC,UTA
85,Home,W 116-111 ,240,46,97,.474,37,74,.500,9,23,.391,15,21,.714,116,39,88,.443,34,71,.479,5,17,.294,28,36,.778,111,2014-03-31,DET,MIL
86,Home,W 116-104 ,240,46,76,.605,31,45,.689,15,31,.484,9,11,.818,116,41,88,.466,32,61,.525,9,27,.333,13,21,.619,104,2014-04-04,BRK,DET
87,@,L 116-123 ,240,40,92,.435,25,52,.481,15,40,.375,21,25,.840,116,50,101,.495,39,73,.534,11,28,.393,12,14,.857,123,2014-04-09,HOU,DEN
88,@,L 116-119 ,240,42,85,.494,38,65,.585,4,20,.200,28,35,.800,116,44,84,.524,38,68,.559,6,16,.375,25,38,.658,119,2014-04-11,CLE,MIL
89,Home,W 116-94 ,240,44,82,.537,39,69,.565,5,13,.385,23,27,.852,116,35,86,.407,26,68,.382,9,18,.500,15,19,.789,94,2014-04-11,OKC,NOP
90,@,W 116-107 ,240,39,81,.481,30,58,.517,9,23,.391,29,35,.829,116,35,84,.417,30,64,.469,5,20,.250,32,48,.667,107,2014-04-13,TOR,DET
91,@,W 116-112 ,240,44,90,.489,36,67,.537,8,23,.348,20,35,.571,116,37,84,.440,28,50,.560,9,34,.265,29,35,.829,112,2014-04-16,GSW,DEN
92,Home,W 116-85 ,240,44,84,.524,33,61,.541,11,23,.478,17,19,.895,116,32,82,.390,24,59,.407,8,23,.348,13,21,.619,85,2014-11-03,BRK,OKC
93,Home,W 116-100 ,240,45,100,.450,29,69,.420,16,31,.516,10,14,.714,116,36,91,.396,31,78,.397,5,13,.385,23,30,.767,100,2014-11-09,POR,DEN
94,Home,W 116-99 ,240,43,86,.500,31,61,.508,12,25,.480,18,26,.692,116,41,85,.482,37,72,.514,4,13,.308,13,17,.765,99,2014-12-02,PHO,IND
95,Home,L 116-117 (3OT),315,43,105,.410,26,70,.371,17,35,.486,13,27,.481,116,48,107,.449,38,80,.475,10,27,.370,11,14,.786,117,2014-12-17,SAS,MEM
96,@,W 116-102 ,240,43,88,.489,33,65,.508,10,23,.435,20,32,.625,116,37,87,.425,33,70,.471,4,17,.235,24,34,.706,102,2014-12-28,TOR,DEN
97,@,W 116-107 ,240,44,87,.506,35,65,.538,9,22,.409,19,24,.792,116,42,81,.519,30,61,.492,12,20,.600,11,20,.550,107,2014-12-28,PHO,LAL
98,@,W 116-105 ,240,46,91,.505,33,66,.500,13,25,.520,11,13,.846,116,39,81,.481,32,60,.533,7,21,.333,20,24,.833,105,2015-01-13,GSW,UTA
99,Home,L 116-120 (OT),265,37,79,.468,27,55,.491,10,24,.417,32,41,.780,116,44,88,.500,33,62,.532,11,26,.423,21,30,.700,120,2015-01-31,WAS,TOR
0,@,L 116-124 ,240,47,103,.456,35,70,.500,12,33,.364,10,15,.667,116,38,77,.494,23,50,.460,15,27,.556,33,37,.892,124,2015-02-06,GSW,ATL
1,@,W 116-113 ,240,40,83,.482,29,63,.460,11,20,.550,25,30,.833,116,40,89,.449,32,65,.492,8,24,.333,25,28,.893,113,2015-02-06,NOP,OKC
2,Home,W 116-105 ,240,44,90,.489,35,68,.515,9,22,.409,19,24,.792,116,37,73,.507,32,58,.552,5,15,.333,26,29,.897,105,2015-03-08,SAS,CHI
3,@,W 116-105 ,240,45,88,.511,28,51,.549,17,37,.459,9,13,.692,116,38,79,.481,35,62,.565,3,17,.176,26,32,.813,105,2015-03-18,LAC,SAC
4,@,W 116-103 ,240,45,74,.608,33,51,.647,12,23,.522,14,17,.824,116,39,83,.470,30,62,.484,9,21,.429,16,19,.842,103,2015-03-25,CHI,TOR
5,@,W 116-104 ,240,45,89,.506,36,63,.571,9,26,.346,17,23,.739,116,40,85,.471,33,59,.559,7,26,.269,17,19,.895,104,2015-03-30,BOS,CHO
6,Home,L 116-117 (OT),265,40,83,.482,34,60,.567,6,23,.261,30,38,.789,116,47,97,.485,39,71,.549,8,26,.308,15,22,.682,117,2015-04-04,TOR,BOS
7,Home,W 116-111 ,240,42,80,.525,33,56,.589,9,24,.375,23,34,.676,116,45,93,.484,39,74,.527,6,19,.316,15,21,.714,111,2015-04-07,SAC,MIN
8,Home,W 116-91 ,240,42,85,.494,30,52,.577,12,33,.364,20,23,.870,116,32,85,.376,29,74,.392,3,11,.273,24,29,.828,91,2015-04-08,POR,MIN
9,Home,W 116-105 ,240,48,90,.533,36,64,.563,12,26,.462,8,9,.889,116,46,98,.469,39,74,.527,7,24,.292,6,8,.750,105,2015-04-09,GSW,POR
10,Home,W 116-103 ,240,44,97,.454,34,66,.515,10,31,.323,18,24,.750,116,37,81,.457,28,57,.491,9,24,.375,20,28,.714,103,2015-04-10,OKC,SAC
11,Home,W 116-77 ,240,41,81,.506,25,53,.472,16,28,.571,18,23,.783,116,27,79,.342,23,64,.359,4,15,.267,19,29,.655,77,2015-04-12,DET,CHO
12,Home,W 116-104 ,240,42,79,.532,32,59,.542,10,20,.500,22,35,.629,116,41,95,.432,30,67,.448,11,28,.393,11,28,.393,104,2015-04-12,IND,OKC
13,@,W 116-110 ,240,40,82,.488,25,46,.543,15,36,.417,21,27,.778,116,40,93,.430,31,65,.477,9,28,.321,21,29,.724,110,2015-11-06,HOU,SAC
14,Home,L 116-129 ,240,43,87,.494,40,78,.513,3,9,.333,27,36,.750,116,48,89,.539,30,51,.588,18,38,.474,15,16,.938,129,2015-11-12,MIN,GSW
15,Home,W 116-111 ,240,39,80,.488,28,55,.509,11,25,.440,27,36,.750,116,44,91,.484,39,76,.513,5,15,.333,18,22,.818,111,2015-11-18,CHO,BRK
16,Home,W 116-109 ,240,42,89,.472,35,65,.538,7,24,.292,25,33,.758,116,43,84,.512,31,61,.508,12,23,.522,11,20,.550,109,2015-11-19,MIA,SAC
17,@,L 116-122 ,240,35,90,.389,18,54,.333,17,36,.472,29,33,.879,116,39,85,.459,28,55,.509,11,30,.367,33,40,.825,122,2015-11-22,PHO,NOP
18,Home,W 116-114 ,240,38,73,.521,27,53,.509,11,20,.550,29,37,.784,116,40,83,.482,24,48,.500,16,35,.457,18,26,.692,114,2015-11-27,HOU,PHI
19,@,W 116-101 ,240,35,75,.467,21,36,.583,14,39,.359,32,36,.889,116,35,80,.438,23,50,.460,12,30,.400,19,21,.905,101,2015-11-27,ATL,MEM
20,Home,L 116-135 ,240,45,92,.489,35,66,.530,10,26,.385,16,23,.696,116,46,81,.568,24,43,.558,22,38,.579,21,31,.677,135,2015-11-27,PHO,GSW
21,@,W 116-111 (OT),265,43,95,.453,36,70,.514,7,25,.280,23,36,.639,116,45,78,.577,39,60,.650,6,18,.333,15,17,.882,111,2015-11-29,HOU,NYK
22,Home,W 116-105 ,240,45,85,.529,37,62,.597,8,23,.348,18,37,.486,116,35,88,.398,24,61,.393,11,27,.407,24,28,.857,105,2015-11-30,DET,HOU
23,@,W 116-99 ,240,46,88,.523,30,54,.556,16,34,.471,8,11,.727,116,35,94,.372,26,63,.413,9,31,.290,20,30,.667,99,2015-12-02,GSW,CHO
24,@,W 116-104 ,240,38,76,.500,22,45,.489,16,31,.516,24,27,.889,116,42,89,.472,34,62,.548,8,27,.296,12,21,.571,104,2015-12-06,DAL,WAS
25,@,L 116-119 ,240,43,89,.483,33,64,.516,10,25,.400,20,24,.833,116,38,78,.487,27,57,.474,11,21,.524,32,43,.744,119,2015-12-16,BOS,DET
26,Home,W 116-109 ,240,43,75,.573,31,52,.596,12,23,.522,18,26,.692,116,39,80,.488,26,46,.565,13,34,.382,18,22,.818,109,2015-12-20,MIA,POR
27,Home,L 116-120 ,240,41,82,.500,28,52,.538,13,30,.433,21,26,.808,116,45,77,.584,39,63,.619,6,14,.429,24,35,.686,120,2015-12-31,IND,MIL
28,@,W 116-104 ,240,40,89,.449,33,72,.458,7,17,.412,29,39,.744,116,39,89,.438,29,60,.483,10,29,.345,16,23,.696,104,2016-01-04,SAC,OKC
29,@,L 116-117 (2OT),290,47,99,.475,35,67,.522,12,32,.375,10,14,.714,116,45,98,.459,33,69,.478,12,29,.414,15,23,.652,117,2016-01-05,SAC,DAL
30,Home,L 116-128 ,240,43,92,.467,35,69,.507,8,23,.348,22,29,.759,116,49,87,.563,30,50,.600,19,37,.514,11,15,.733,128,2016-01-09,SAC,GSW
31,Home,W 116-97 ,240,41,79,.519,31,55,.564,10,24,.417,24,31,.774,116,36,89,.404,28,64,.438,8,25,.320,17,27,.630,97,2016-01-12,IND,PHO
32,Home,W 116-98 ,240,43,86,.500,30,53,.566,13,33,.394,17,20,.850,116,40,90,.444,36,67,.537,4,23,.174,14,24,.583,98,2016-01-14,GSW,LAL
33,@,W 116-104 ,240,47,93,.505,32,58,.552,15,35,.429,7,11,.636,116,38,85,.447,30,66,.455,8,19,.421,20,28,.714,104,2016-01-15,POR,BRK
34,@,W 116-88 ,240,43,76,.566,30,53,.566,13,23,.565,17,24,.708,116,33,85,.388,29,67,.433,4,18,.222,18,20,.900,88,2016-01-22,LAC,NYK
35,Home,L 116-120 (OT),265,45,91,.495,34,68,.500,11,23,.478,15,19,.789,116,45,101,.446,35,74,.473,10,27,.370,20,22,.909,120,2016-01-22,ORL,CHO
36,Home,W 116-99 ,240,43,94,.457,26,63,.413,17,31,.548,13,17,.765,116,39,74,.527,33,59,.559,6,15,.400,15,18,.833,99,2016-01-23,NOP,MIL
37,Home,W 116-106 ,240,45,94,.479,37,77,.481,8,17,.471,18,25,.720,116,43,93,.462,35,67,.522,8,26,.308,12,19,.632,106,2016-01-24,BRK,OKC
38,@,W 116-91 ,240,44,90,.489,35,68,.515,9,22,.409,19,23,.826,116,32,75,.427,25,51,.490,7,24,.292,20,30,.667,91,2016-01-25,BOS,WAS
39,Home,W 116-108 ,240,41,86,.477,33,67,.493,8,19,.421,26,30,.867,116,36,95,.379,27,56,.482,9,39,.231,27,43,.628,108,2016-01-29,OKC,HOU
40,@,W 116-95 ,240,42,73,.575,26,44,.591,16,29,.552,16,23,.696,116,33,90,.367,27,72,.375,6,18,.333,23,26,.885,95,2016-01-31,GSW,NYK
41,@,W 116-90 ,240,41,80,.513,29,58,.500,12,22,.545,22,25,.880,116,33,73,.452,30,58,.517,3,15,.200,21,27,.778,90,2016-02-05,SAS,DAL
42,Home,W 116-108 ,240,48,97,.495,41,71,.577,7,26,.269,13,20,.650,116,36,85,.424,29,63,.460,7,22,.318,29,37,.784,108,2016-02-06,GSW,OKC
43,@,W 116-102 ,240,47,97,.485,37,73,.507,10,24,.417,12,20,.600,116,36,81,.444,34,69,.493,2,12,.167,28,35,.800,102,2016-02-08,NOP,MIN
44,Home,W 116-103 ,240,41,89,.461,33,61,.541,8,28,.286,26,34,.765,116,37,77,.481,26,43,.605,11,34,.324,18,34,.529,103,2016-02-10,POR,HOU
45,Home,W 116-106 ,240,48,93,.516,41,77,.532,7,16,.438,13,20,.650,116,38,88,.432,33,70,.471,5,18,.278,25,34,.735,106,2016-02-19,CHI,TOR
46,@,W 116-100 ,240,37,78,.474,30,54,.556,7,24,.292,35,56,.625,116,30,82,.366,19,47,.404,11,35,.314,29,35,.829,100,2016-02-19,HOU,PHO
47,Home,W 116-110 ,240,41,83,.494,31,62,.500,10,21,.476,24,31,.774,116,42,90,.467,34,66,.515,8,24,.333,18,26,.692,110,2016-02-19,SAC,DEN
48,@,W 116-103 ,240,43,89,.483,31,56,.554,12,33,.364,18,22,.818,116,35,86,.407,26,58,.448,9,28,.321,24,30,.800,103,2016-02-24,OKC,DAL
49,@,W 116-106 ,240,37,75,.493,29,57,.509,8,18,.444,34,42,.810,116,42,98,.429,33,71,.465,9,27,.333,13,23,.565,106,2016-02-25,BRK,PHO
50,@,L 116-122 (OT),265,43,93,.462,34,64,.531,9,29,.310,21,31,.677,116,45,88,.511,34,59,.576,11,29,.379,21,27,.778,122,2016-02-26,DEN,DAL
51,@,L 116-130 ,240,41,77,.532,36,55,.655,5,22,.227,29,37,.784,116,49,86,.570,39,70,.557,10,16,.625,22,25,.880,130,2016-02-28,PHI,ORL
52,Home,L 116-131 ,240,48,107,.449,41,82,.500,7,25,.280,13,19,.684,116,47,82,.573,33,48,.688,14,34,.412,23,26,.885,131,2016-02-29,SAC,OKC
53,Home,W 116-108 ,240,43,89,.483,37,69,.536,6,20,.300,24,31,.774,116,43,89,.483,33,57,.579,10,32,.313,12,21,.571,108,2016-02-29,WAS,PHI
54,Home,W 116-93 ,240,43,107,.402,36,81,.444,7,26,.269,23,24,.958,116,34,84,.405,23,55,.418,11,29,.379,14,20,.700,93,2016-03-02,BOS,POR
55,Home,W 116-101 ,240,43,83,.518,29,59,.492,14,24,.583,16,20,.800,116,42,87,.483,35,65,.538,7,22,.318,10,14,.714,101,2016-03-04,MIL,MIN
56,Home,W 116-114 (OT),265,44,107,.411,35,81,.432,9,26,.346,19,25,.760,116,41,93,.441,25,52,.481,16,41,.390,16,20,.800,114,2016-03-06,DEN,DAL
57,@,W 116-91 ,240,47,85,.553,43,66,.652,4,19,.211,18,19,.947,116,36,79,.456,32,64,.500,4,15,.267,15,19,.789,91,2016-03-08,SAS,MIN
58,Home,W 116-109 (OT),265,41,89,.461,31,65,.477,10,24,.417,24,31,.774,116,45,99,.455,37,79,.468,8,20,.400,11,23,.478,109,2016-03-08,POR,WAS
59,Home,W 116-96 ,240,41,87,.471,26,55,.473,15,32,.469,19,24,.792,116,32,84,.381,25,58,.431,7,26,.269,25,31,.806,96,2016-03-09,BOS,MEM
60,Home,W 116-98 ,240,44,91,.484,31,63,.492,13,28,.464,15,19,.789,116,33,89,.371,27,61,.443,6,28,.214,26,33,.788,98,2016-03-10,DEN,PHO
61,Home,W 116-100 ,240,42,80,.525,34,56,.607,8,24,.333,24,29,.828,116,36,86,.419,29,65,.446,7,21,.333,21,29,.724,100,2016-03-12,DEN,WAS
62,@,L 116-123 ,240,45,92,.489,34,63,.540,11,29,.379,15,20,.750,116,42,84,.500,31,51,.608,11,33,.333,28,33,.848,123,2016-03-12,PHO,GSW
63,Home,W 116-110 ,240,44,81,.543,36,56,.643,8,25,.320,20,25,.800,116,40,80,.500,31,56,.554,9,24,.375,21,24,.875,110,2016-03-15,ORL,DEN
64,Home,W 116-98 ,240,40,80,.500,28,54,.519,12,26,.462,24,28,.857,116,39,87,.448,33,65,.508,6,22,.273,14,17,.824,98,2016-03-17,ATL,DEN
65,Home,W 116-111 ,240,48,85,.565,37,56,.661,11,29,.379,9,14,.643,116,43,85,.506,37,69,.536,6,16,.375,19,24,.792,111,2016-03-18,HOU,MIN
66,@,W 116-105 ,240,45,94,.479,35,68,.515,10,26,.385,16,24,.667,116,37,85,.435,27,62,.435,10,23,.435,21,26,.808,105,2016-03-25,DEN,LAL
67,Home,W 116-94 ,240,40,90,.444,33,68,.485,7,22,.318,29,39,.744,116,35,94,.372,26,62,.419,9,32,.281,15,23,.652,94,2016-03-25,SAC,PHO
68,@,L 116-121 ,240,41,84,.488,26,51,.510,15,33,.455,19,23,.826,116,41,81,.506,34,55,.618,7,26,.269,32,40,.800,121,2016-03-28,PHO,MIN
69,Home,W 116-109 ,240,41,90,.456,27,56,.482,14,34,.412,20,27,.741,116,37,88,.420,28,64,.438,9,24,.375,26,34,.765,109,2016-03-31,POR,BOS
70,Home,L 116-121 ,240,41,80,.513,29,54,.537,12,26,.462,22,28,.786,116,44,77,.571,34,54,.630,10,23,.435,23,26,.885,121,2016-04-11,NOP,CHI
71,Home,W 116-81 ,240,47,97,.485,37,62,.597,10,35,.286,12,19,.632,116,32,96,.333,21,59,.356,11,37,.297,6,13,.462,81,2016-04-13,HOU,SAC
72,Home,W 116-98 ,240,40,80,.500,34,64,.531,6,16,.375,30,38,.789,116,35,84,.417,30,69,.435,5,15,.333,23,31,.742,98,2016-10-31,LAC,PHO
73,Home,W 116-80 ,240,43,78,.551,31,58,.534,12,20,.600,18,23,.783,116,27,75,.360,23,51,.451,4,24,.167,22,29,.759,80,2016-11-01,MIN,MEM
74,Home,L 116-123 ,240,41,85,.482,30,53,.566,11,32,.344,23,29,.793,116,48,90,.533,39,68,.574,9,22,.409,18,20,.900,123,2016-11-02,ATL,LAL
75,@,W 116-92 ,240,47,91,.516,38,68,.559,9,23,.391,13,14,.929,116,30,74,.405,20,49,.408,10,25,.400,22,25,.880,92,2016-11-05,LAC,SAS
76,Home,W 116-106 ,240,45,90,.500,29,55,.527,16,35,.457,10,12,.833,116,39,80,.488,32,59,.542,7,21,.333,21,27,.778,106,2016-11-07,GSW,NOP
77,Home,W 116-95 ,240,43,74,.581,26,41,.634,17,33,.515,13,22,.591,116,34,86,.395,28,58,.483,6,28,.214,21,28,.750,95,2016-11-09,GSW,DAL
78,@,W 116-96 ,240,46,97,.474,37,71,.521,9,26,.346,15,18,.833,116,36,76,.474,35,69,.507,1,7,.143,23,29,.793,96,2016-11-18,PHO,IND
79,@,W 116-107 ,240,44,78,.564,34,54,.630,10,24,.417,18,19,.947,116,39,87,.448,27,62,.435,12,25,.480,17,21,.810,107,2016-11-18,SAS,LAL
80,@,L 116-121 (OT),265,40,97,.412,25,54,.463,15,43,.349,21,28,.750,116,43,98,.439,29,62,.468,14,36,.389,21,25,.840,121,2016-11-19,CHO,NOP
81,Home,W 116-101 ,240,44,94,.468,32,66,.485,12,28,.429,16,17,.941,116,32,76,.421,25,51,.490,7,25,.280,30,38,.789,101,2016-11-23,SAC,OKC
82,@,W 116-112 ,240,40,84,.476,26,52,.500,14,32,.438,22,27,.815,116,38,88,.432,25,56,.446,13,32,.406,23,27,.852,112,2016-12-05,CLE,TOR
83,Home,L 116-124 ,240,44,93,.473,33,70,.471,11,23,.478,17,24,.708,116,43,83,.518,31,57,.544,12,26,.462,26,36,.722,124,2016-12-06,WAS,ORL
84,Home,W 116-111 ,240,41,85,.482,32,59,.542,9,26,.346,25,31,.806,116,42,105,.400,31,68,.456,11,37,.297,16,21,.762,111,2016-12-07,BRK,DEN
85,Home,W 116-105 ,240,42,73,.575,29,42,.690,13,31,.419,19,28,.679,116,39,86,.453,29,59,.492,10,27,.370,17,24,.708,105,2016-12-10,CLE,CHO
86,@,W 116-108 ,240,38,83,.458,25,51,.490,13,32,.406,27,30,.900,116,36,81,.444,27,57,.474,9,24,.375,27,36,.750,108,2016-12-11,GSW,MIN
87,Home,W 116-92 ,240,47,84,.560,37,61,.607,10,23,.435,12,21,.571,116,33,84,.393,23,61,.377,10,23,.435,16,21,.762,92,2016-12-12,SAC,LAL
88,Home,W 116-104 ,240,42,91,.462,34,73,.466,8,18,.444,24,31,.774,116,36,91,.396,26,56,.464,10,35,.286,22,28,.786,104,2016-12-20,TOR,BRK
89,@,L 116-123 ,240,42,83,.506,29,52,.558,13,31,.419,19,22,.864,116,42,79,.532,30,53,.566,12,26,.462,27,37,.730,123,2016-12-23,PHI,PHO
90,@,L 116-140 ,240,45,96,.469,32,63,.508,13,33,.394,13,16,.813,116,45,81,.556,31,41,.756,14,40,.350,36,43,.837,140,2016-12-30,LAC,HOU
91,Home,W 116-99 ,240,43,77,.558,30,52,.577,13,25,.520,17,21,.810,116,40,74,.541,32,56,.571,8,18,.444,11,17,.647,99,2016-12-30,MIN,MIL
92,@,W 116-96 ,240,43,76,.566,34,61,.557,9,15,.600,21,27,.778,116,33,83,.398,23,56,.411,10,27,.370,20,28,.714,96,2016-12-31,MIL,CHI
93,Home,L 116-121 ,240,48,97,.495,38,68,.559,10,29,.345,10,12,.833,116,43,74,.581,34,58,.586,9,16,.563,26,30,.867,121,2017-01-03,DET,IND
94,Home,W 116-102 ,240,42,82,.512,25,49,.510,17,33,.515,15,28,.536,116,30,77,.390,20,46,.435,10,31,.323,32,35,.914,102,2017-01-03,LAL,MEM
95,@,L 116-118 ,240,41,91,.451,29,61,.475,12,30,.400,22,27,.815,116,41,86,.477,26,47,.553,15,39,.385,21,30,.700,118,2017-01-05,OKC,HOU
96,@,W 116-108 ,240,38,88,.432,29,55,.527,9,33,.273,31,43,.721,116,41,91,.451,32,61,.525,9,30,.300,17,19,.895,108,2017-01-06,CLE,BRK
97,@,W 116-111 ,240,41,83,.494,28,60,.467,13,23,.565,21,27,.778,116,39,78,.500,27,56,.482,12,22,.545,21,28,.750,111,2017-01-06,NYK,MIL
98,Home,L 116-120 ,240,46,87,.529,37,60,.617,9,27,.333,15,19,.789,116,44,82,.537,29,48,.604,15,34,.441,17,19,.895,120,2017-01-08,PHO,CLE
99,Home,W 116-108 ,240,40,80,.500,31,65,.477,9,15,.600,27,31,.871,116,41,83,.494,29,51,.569,12,32,.375,14,18,.778,108,2017-01-13,MIL,MIA
0,Home,W 116-101 ,240,44,89,.494,36,67,.537,8,22,.364,20,23,.870,116,35,84,.417,23,55,.418,12,29,.414,19,27,.704,101,2017-01-15,TOR,NYK
1,@,W 116-112 (OT),265,43,95,.453,32,64,.500,11,31,.355,19,22,.864,116,40,82,.488,25,44,.568,15,38,.395,17,34,.500,112,2017-01-25,SAC,CLE
2,@,L 116-124 ,240,43,87,.494,27,54,.500,16,33,.485,14,16,.875,116,49,92,.533,36,56,.643,13,36,.361,13,20,.650,124,2017-01-27,BRK,CLE
3,Home,W 116-103 ,240,42,80,.525,28,52,.538,14,28,.500,18,23,.783,116,46,89,.517,42,77,.545,4,12,.333,7,12,.583,103,2017-01-28,MIA,DET
4,@,L 116-120 ,240,41,99,.414,26,72,.361,15,27,.556,19,23,.826,116,47,89,.528,35,63,.556,12,26,.462,14,18,.778,120,2017-01-31,DEN,LAL
5,Home,W 116-93 ,240,45,93,.484,33,61,.541,12,32,.375,14,19,.737,116,34,86,.395,27,60,.450,7,26,.269,18,21,.857,93,2017-02-01,MIA,ATL
6,Home,W 116-108 ,240,44,96,.458,32,63,.508,12,33,.364,16,21,.762,116,40,87,.460,28,48,.583,12,39,.308,16,22,.727,108,2017-02-02,WAS,LAL
7,Home,W 116-108 ,240,44,98,.449,33,72,.458,11,26,.423,17,22,.773,116,44,89,.494,39,72,.542,5,17,.294,15,19,.789,108,2017-02-03,DET,MIN
8,@,W 116-100 ,240,35,73,.479,18,42,.429,17,31,.548,29,37,.784,116,35,73,.479,25,51,.490,10,22,.455,20,24,.833,100,2017-02-11,MIL,IND
9,@,W 116-107 ,240,44,90,.489,36,76,.474,8,14,.571,20,29,.690,116,39,83,.470,33,61,.541,6,22,.273,23,27,.852,107,2017-02-13,ORL,MIA
10,@,W 116-108 ,240,44,86,.512,31,47,.660,13,39,.333,15,22,.682,116,42,86,.488,33,63,.524,9,23,.391,15,19,.789,108,2017-02-14,CLE,MIN
11,Home,W 116-108 ,240,38,80,.475,25,52,.481,13,28,.464,27,36,.750,116,44,93,.473,36,62,.581,8,31,.258,12,18,.667,108,2017-02-15,BOS,PHI
12,Home,W 116-105 ,240,41,88,.466,29,65,.446,12,23,.522,22,31,.710,116,41,86,.477,30,65,.462,11,21,.524,12,14,.857,105,2017-02-15,OKC,NYK
13,Home,W 116-100 ,240,46,88,.523,39,74,.527,7,14,.500,17,19,.895,116,39,88,.443,27,53,.509,12,35,.343,10,14,.714,100,2017-02-23,SAC,DEN
14,@,L 116-130 ,240,45,86,.523,31,56,.554,14,30,.467,12,17,.706,116,49,86,.570,33,61,.541,16,25,.640,16,22,.727,130,2017-03-04,BRK,POR
15,Home,W 116-102 ,240,39,73,.534,30,53,.566,9,20,.450,29,47,.617,116,34,83,.410,24,48,.500,10,35,.286,24,29,.828,102,2017-03-06,LAC,BOS
16,@,W 115-93 ,240,39,79,.494,29,52,.558,10,27,.370,27,34,.794,115,32,76,.421,24,49,.490,8,27,.296,21,27,.778,93,2011-12-26,DEN,DAL
17,Home,W 115-107 ,240,42,75,.560,36,65,.554,6,10,.600,25,35,.714,115,37,72,.514,25,53,.472,12,19,.632,21,27,.778,107,2011-12-27,MIA,BOS
18,Home,W 115-90 ,240,45,80,.563,35,61,.574,10,19,.526,15,15,1.000,115,29,74,.392,22,54,.407,7,20,.350,25,33,.758,90,2011-12-28,SAS,LAC
19,Home,W 115-101 ,240,45,90,.500,35,69,.507,10,21,.476,15,26,.577,115,40,90,.444,36,76,.474,4,14,.286,17,19,.895,101,2012-01-03,CLE,CHA
20,@,L 115-123 ,240,43,83,.518,23,48,.479,20,35,.571,9,12,.750,115,44,74,.595,33,56,.589,11,18,.611,24,30,.800,123,2012-01-11,NJN,DEN
21,@,L 115-121 ,240,42,89,.472,33,72,.458,9,17,.529,22,28,.786,115,44,84,.524,35,65,.538,9,19,.474,24,26,.923,121,2012-02-14,SAC,CHI
22,@,W 115-107 ,240,43,96,.448,39,79,.494,4,17,.235,25,27,.926,115,41,84,.488,32,61,.525,9,23,.391,16,27,.593,107,2012-02-22,SAC,WAS
23,Home,W 115-107 ,240,44,82,.537,38,65,.585,6,17,.353,21,26,.808,115,45,103,.437,36,78,.462,9,25,.360,8,9,.889,107,2012-03-02,LAL,SAC
24,Home,W 115-111 (OT),265,45,103,.437,38,85,.447,7,18,.389,18,22,.818,115,41,94,.436,33,76,.434,8,18,.444,21,26,.808,111,2012-03-04,BOS,NYK
25,Home,W 115-104 ,240,40,91,.440,32,65,.492,8,26,.308,27,32,.844,115,38,84,.452,35,65,.538,3,19,.158,25,34,.735,104,2012-03-07,OKC,PHO
26,@,W 115-89 ,240,46,91,.505,34,67,.507,12,24,.500,11,15,.733,115,33,82,.402,26,63,.413,7,19,.368,16,21,.762,89,2012-03-13,GSW,SAC
27,Home,W 115-105 ,240,46,86,.535,39,63,.619,7,23,.304,16,21,.762,115,38,85,.447,27,61,.443,11,24,.458,18,25,.720,105,2012-03-14,MIL,CLE
28,Home,W 115-100 ,240,41,81,.506,30,56,.536,11,25,.440,22,28,.786,115,32,81,.395,24,62,.387,8,19,.421,28,34,.824,100,2012-03-16,NYK,IND
29,Home,W 115-99 ,240,44,96,.458,36,68,.529,8,28,.286,19,21,.905,115,38,92,.413,32,67,.478,6,25,.240,17,17,1.000,99,2012-03-18,SAC,MIN
30,@,L 115-116 ,240,40,79,.506,26,61,.426,14,18,.778,21,30,.700,115,46,79,.582,37,62,.597,9,17,.529,15,22,.682,116,2012-03-21,DET,DEN
31,@,W 115-107 ,240,43,71,.606,34,57,.596,9,14,.643,20,25,.800,115,39,87,.448,31,69,.449,8,18,.444,21,27,.778,107,2012-04-10,BOS,MIA
32,Home,W 115-89 ,240,43,90,.478,38,78,.487,5,12,.417,24,32,.750,115,35,90,.389,26,65,.400,9,25,.360,10,14,.714,89,2012-04-13,OKC,SAC
33,@,W 115-110 ,240,40,91,.440,33,66,.500,7,25,.280,28,32,.875,115,42,84,.500,38,73,.521,4,11,.364,22,34,.647,110,2012-04-14,OKC,MIN
34,@,W 115-86 ,240,44,69,.638,40,59,.678,4,10,.400,23,30,.767,115,32,79,.405,24,59,.407,8,20,.400,14,27,.519,86,2012-11-02,CHI,CLE
35,Home,W 115-94 ,240,45,92,.489,36,81,.444,9,11,.818,16,19,.842,115,39,91,.429,34,72,.472,5,19,.263,11,18,.611,94,2012-11-04,ORL,PHO
36,Home,W 115-107 (OT),265,40,92,.435,25,65,.385,15,27,.556,20,28,.714,115,39,92,.424,33,82,.402,6,10,.600,23,27,.852,107,2012-11-21,IND,NOH
37,@,W 115-89 ,240,40,82,.488,28,60,.467,12,22,.545,23,34,.676,115,34,92,.370,24,64,.375,10,28,.357,11,20,.550,89,2012-11-24,LAL,DAL
38,@,L 115-117 (2OT),290,47,92,.511,39,69,.565,8,23,.348,13,17,.765,115,43,100,.430,37,78,.474,6,22,.273,25,30,.833,117,2012-12-12,DAL,BOS
39,@,W 115-93 ,240,49,99,.495,39,75,.520,10,24,.417,7,8,.875,115,31,84,.369,26,58,.448,5,26,.192,26,36,.722,93,2012-12-15,GSW,ATL
40,Home,W 115-100 ,240,44,85,.518,30,58,.517,14,27,.519,13,16,.813,115,33,90,.367,25,69,.362,8,21,.381,26,35,.743,100,2012-12-21,GSW,CHA
41,Home,L 115-118 (OT),265,46,103,.447,36,74,.486,10,29,.345,13,15,.867,115,49,107,.458,40,80,.500,9,27,.333,11,14,.786,118,2012-12-22,GSW,LAL
42,Home,W 115-94 ,240,42,84,.500,30,61,.492,12,23,.522,19,22,.864,115,29,80,.363,21,51,.412,8,29,.276,28,39,.718,94,2013-01-02,GSW,LAC
43,@,W 115-101 ,240,45,83,.542,32,50,.640,13,33,.394,12,19,.632,115,39,87,.448,33,73,.452,6,14,.429,17,23,.739,101,2013-01-04,HOU,MIL
44,@,W 115-113 (2OT),290,41,89,.461,33,65,.508,8,24,.333,25,36,.694,115,43,91,.473,34,73,.466,9,18,.500,18,31,.581,113,2013-01-04,BRK,WAS
45,Home,W 115-89 ,240,47,90,.522,37,62,.597,10,28,.357,11,15,.733,115,32,72,.444,27,52,.519,5,20,.250,20,26,.769,89,2013-01-05,LAC,GSW
46,Home,W 115-111 (OT),265,47,99,.475,38,74,.514,9,25,.360,12,19,.632,115,42,88,.477,34,61,.557,8,27,.296,19,23,.826,111,2013-01-15,DEN,POR
47,Home,W 115-110 ,240,43,90,.478,34,72,.472,9,18,.500,20,23,.870,115,41,83,.494,34,62,.548,7,21,.333,21,26,.808,110,2013-02-02,CLE,OKC
48,Home,W 115-86 ,240,45,77,.584,40,62,.645,5,15,.333,20,29,.690,115,28,70,.400,25,56,.446,3,14,.214,27,33,.818,86,2013-02-02,MIN,NOH
49,Home,W 115-101 ,240,39,78,.500,29,57,.509,10,21,.476,27,33,.818,115,39,83,.470,34,66,.515,5,17,.294,18,24,.750,101,2013-02-19,UTA,GSW
50,@,W 115-86 ,240,43,83,.518,32,64,.500,11,19,.579,18,23,.783,115,32,82,.390,27,67,.403,5,15,.333,17,19,.895,86,2013-03-08,IND,ORL
51,@,W 115-113 ,240,40,87,.460,33,68,.485,7,19,.368,28,38,.737,115,44,94,.468,38,72,.528,6,22,.273,19,25,.760,113,2013-03-10,MIL,SAC
52,@,W 115-108 ,240,41,82,.500,30,53,.566,11,29,.379,22,27,.815,115,43,89,.483,35,68,.515,8,21,.381,14,17,.824,108,2013-03-12,DAL,MIL
53,Home,W 115-109 ,240,40,90,.444,28,63,.444,12,27,.444,23,26,.885,115,47,93,.505,42,72,.583,5,21,.238,10,15,.667,109,2013-03-17,MIL,ORL
54,@,L 115-120 (OT),265,47,100,.470,37,73,.507,10,27,.370,11,18,.611,115,42,100,.420,34,75,.453,8,25,.320,28,34,.824,120,2013-10-30,ORL,MIN
55,@,L 115-126 ,240,40,76,.526,28,55,.509,12,21,.571,23,33,.697,115,42,85,.494,33,57,.579,9,28,.321,33,50,.660,126,2013-10-31,GSW,LAC
56,Home,W 115-105 ,240,45,81,.556,37,61,.607,8,20,.400,17,19,.895,115,47,94,.500,41,82,.500,6,12,.500,5,8,.625,105,2013-11-02,POR,SAS
57,Home,W 115-91 ,240,40,83,.482,30,58,.517,10,25,.400,25,29,.862,115,34,77,.442,31,59,.525,3,18,.167,20,24,.833,91,2013-11-09,TOR,UTA
58,@,L 115-116 ,240,41,80,.513,32,58,.552,9,22,.409,24,28,.857,115,45,94,.479,31,71,.437,14,23,.609,12,14,.857,116,2013-11-14,OKC,GSW
59,Home,W 115-113 ,240,38,93,.409,25,66,.379,13,27,.481,26,32,.813,115,40,83,.482,32,60,.533,8,23,.348,25,43,.581,113,2013-11-18,OKC,DEN
60,Home,W 115-107 (OT),265,45,79,.570,38,59,.644,7,20,.350,18,29,.621,115,41,93,.441,33,64,.516,8,29,.276,17,24,.708,107,2013-11-22,PHI,MIL
61,Home,W 115-100 ,240,41,89,.461,31,61,.508,10,28,.357,23,39,.590,115,38,88,.432,31,65,.477,7,23,.304,17,19,.895,100,2013-12-01,DET,PHI
62,@,W 115-113 ,240,42,82,.512,27,57,.474,15,25,.600,16,22,.727,115,40,76,.526,31,57,.544,9,19,.474,24,28,.857,113,2013-12-01,GSW,SAC
63,Home,W 115-111 ,240,43,94,.457,37,82,.451,6,12,.500,23,29,.793,115,41,90,.456,30,53,.566,11,37,.297,18,22,.818,111,2013-12-09,CHA,GSW
64,Home,W 115-92 ,240,39,76,.513,28,53,.528,11,23,.478,26,35,.743,115,37,76,.487,31,58,.534,6,18,.333,12,21,.571,92,2013-12-16,LAC,SAS
65,@,W 115-92 ,240,46,96,.479,36,72,.500,10,24,.417,13,18,.722,115,34,88,.386,26,60,.433,8,28,.286,16,24,.667,92,2013-12-23,DET,CLE
66,Home,W 115-86 ,240,45,85,.529,37,65,.569,8,20,.400,17,24,.708,115,32,89,.360,28,66,.424,4,23,.174,18,23,.783,86,2013-12-27,GSW,PHO
67,Home,W 115-101 ,240,44,95,.463,35,62,.565,9,33,.273,18,23,.783,115,37,95,.389,26,66,.394,11,29,.379,16,22,.727,101,2013-12-28,PHO,PHI
68,Home,W 115-100 ,240,36,80,.450,21,48,.438,15,32,.469,28,34,.824,115,39,80,.488,32,59,.542,7,21,.333,15,20,.750,100,2013-12-28,TOR,NYK
69,@,W 115-111 ,240,40,83,.482,32,59,.542,8,24,.333,27,28,.964,115,43,94,.457,36,74,.486,7,20,.350,18,29,.621,111,2014-01-04,OKC,MIN
70,Home,L 115-137 ,240,42,89,.472,39,68,.574,3,21,.143,28,36,.778,115,53,99,.535,41,70,.586,12,29,.414,19,24,.792,137,2014-01-05,LAL,DEN
71,Home,W 115-104 ,240,46,95,.484,42,79,.532,4,16,.250,19,24,.792,115,38,89,.427,29,67,.433,9,22,.409,19,22,.864,104,2014-01-25,POR,MIN
72,Home,L 115-117 ,240,40,86,.465,35,67,.522,5,19,.263,30,36,.833,115,41,74,.554,32,53,.604,9,21,.429,26,36,.722,117,2014-01-29,DAL,HOU
73,@,L 115-116 ,240,42,84,.500,36,63,.571,6,21,.286,25,34,.735,115,40,83,.482,35,65,.538,5,18,.278,31,44,.705,116,2014-02-03,LAC,DEN
74,@,W 115-113 ,240,40,77,.519,34,62,.548,6,15,.400,29,33,.879,115,43,85,.506,32,65,.492,11,20,.550,16,23,.696,113,2014-02-07,CLE,WAS
75,Home,W 115-107 ,240,47,87,.540,39,67,.582,8,20,.400,13,29,.448,115,40,88,.455,27,57,.474,13,31,.419,14,20,.700,107,2014-02-21,DET,ATL
76,@,W 115-112 ,240,41,78,.526,36,62,.581,5,16,.313,28,32,.875,115,42,86,.488,31,60,.517,11,26,.423,17,24,.708,112,2014-02-23,HOU,PHO
77,Home,W 115-106 ,240,42,80,.525,32,64,.500,10,16,.625,21,28,.750,115,43,86,.500,35,61,.574,8,25,.320,12,14,.857,106,2014-02-25,WAS,ORL
78,Home,W 115-104 ,240,43,90,.478,35,68,.515,8,22,.364,21,23,.913,115,38,76,.500,29,57,.509,9,19,.474,19,24,.792,104,2014-02-26,BOS,ATL
79,Home,W 115-110 ,240,37,79,.468,26,55,.473,11,24,.458,30,36,.833,115,46,87,.529,37,67,.552,9,20,.450,9,9,1.000,110,2014-03-05,DEN,DAL
80,@,W 115-98 ,240,34,74,.459,27,56,.482,7,18,.389,40,50,.800,115,33,84,.393,25,61,.410,8,23,.348,24,28,.857,98,2014-03-12,SAC,PHI
81,Home,W 115-94 ,240,42,76,.553,34,56,.607,8,20,.400,23,28,.821,115,35,81,.432,31,71,.437,4,10,.400,20,27,.741,94,2014-03-15,NYK,MIL
82,@,L 115-120 (OT),265,45,98,.459,37,81,.457,8,17,.471,17,26,.654,115,42,97,.433,30,58,.517,12,39,.308,24,27,.889,120,2014-03-18,MIL,POR
83,Home,W 115-110 ,240,43,80,.538,35,53,.660,8,27,.296,21,25,.840,115,39,80,.488,36,68,.529,3,12,.250,29,39,.744,110,2014-03-20,GSW,MIL
84,Home,W 115-99 ,240,44,83,.530,39,65,.600,5,18,.278,22,24,.917,115,35,91,.385,27,55,.491,8,36,.222,21,28,.750,99,2014-03-30,LAL,PHO
85,Home,W 115-111 ,240,38,79,.481,29,56,.518,9,23,.391,30,36,.833,115,42,88,.477,28,57,.491,14,31,.452,13,16,.813,111,2014-04-05,DET,BOS
86,@,L 115-122 ,240,40,84,.476,31,52,.596,9,32,.281,26,32,.813,115,45,77,.584,34,54,.630,11,23,.478,21,31,.677,122,2014-04-06,OKC,PHO
87,Home,W 115-111 ,240,43,77,.558,32,53,.604,11,24,.458,18,30,.600,115,38,79,.481,28,50,.560,10,29,.345,25,34,.735,111,2014-04-09,ORL,BRK
88,Home,L 115-118 ,240,43,91,.473,31,61,.508,12,30,.400,17,25,.680,115,40,78,.513,28,54,.519,12,24,.500,26,34,.765,118,2014-11-07,PHI,CHI
89,Home,L 115-136 ,240,39,99,.394,36,83,.434,3,16,.188,34,43,.791,115,46,86,.535,32,58,.552,14,28,.500,30,34,.882,136,2014-11-16,LAL,GSW
90,Home,W 115-99 ,240,44,89,.494,33,67,.493,11,22,.500,16,22,.727,115,34,69,.493,25,53,.472,9,16,.563,22,28,.786,99,2014-11-19,MIN,NYK
91,Home,L 115-126 ,240,42,82,.512,32,58,.552,10,24,.417,21,24,.875,115,42,82,.512,28,53,.528,14,29,.483,28,33,.848,126,2014-11-26,ATL,TOR
92,Home,W 115-106 ,240,44,88,.500,39,73,.534,5,15,.333,22,28,.786,115,43,88,.489,31,64,.484,12,24,.500,8,11,.727,106,2014-12-12,CHI,POR
93,Home,L 115-120 (OT),265,40,82,.488,29,54,.537,11,28,.393,24,34,.706,115,45,93,.484,34,67,.507,11,26,.423,19,27,.704,120,2014-12-13,PHI,MEM
94,@,W 115-111 (OT),265,35,85,.412,27,57,.474,8,28,.286,37,48,.771,115,40,99,.404,27,69,.391,13,30,.433,18,23,.783,111,2014-12-17,HOU,DEN
95,Home,W 115-105 ,240,46,89,.517,34,63,.540,12,26,.462,11,17,.647,115,39,84,.464,27,58,.466,12,26,.462,15,17,.882,105,2014-12-23,LAL,GSW
96,@,W 115-111 (OT),265,38,91,.418,21,60,.350,17,31,.548,22,24,.917,115,46,101,.455,40,82,.488,6,19,.316,13,15,.867,111,2014-12-23,POR,OKC
97,@,L 115-124 ,240,41,88,.466,32,63,.508,9,25,.360,24,29,.828,115,44,97,.454,31,64,.484,13,33,.394,23,32,.719,124,2014-12-23,DAL,PHO
98,@,W 115-106 ,240,46,94,.489,32,61,.525,14,33,.424,9,12,.750,115,41,93,.441,34,73,.466,7,20,.350,17,24,.708,106,2014-12-26,PHO,SAC
99,Home,W 115-79 ,240,41,83,.494,28,52,.538,13,31,.419,20,28,.714,115,30,68,.441,26,51,.510,4,17,.235,15,25,.600,79,2015-01-03,HOU,MIA
0,@,W 115-107 ,240,43,84,.512,37,67,.552,6,17,.353,23,31,.742,115,42,93,.452,29,60,.483,13,33,.394,10,12,.833,107,2015-01-03,ATL,POR
1,@,L 115-127 ,240,42,92,.457,33,68,.485,9,24,.375,22,28,.786,115,51,97,.526,41,75,.547,10,22,.455,15,19,.789,127,2015-01-16,GSW,OKC
2,Home,W 115-100 ,240,43,86,.500,30,54,.556,13,32,.406,16,22,.727,115,34,75,.453,26,58,.448,8,17,.471,24,35,.686,100,2015-01-19,PHO,LAL
3,Home,L 115-117 (OT),265,41,101,.406,29,72,.403,12,29,.414,21,28,.750,115,48,90,.533,44,76,.579,4,14,.286,17,23,.739,117,2015-01-25,DEN,WAS
4,@,W 115-100 ,240,45,87,.517,33,62,.532,12,25,.480,13,18,.722,115,37,82,.451,32,64,.500,5,18,.278,21,30,.700,100,2015-01-29,MIL,ORL
5,Home,W 115-100 ,240,43,86,.500,34,63,.540,9,23,.391,20,23,.870,115,40,89,.449,33,67,.493,7,22,.318,13,17,.765,100,2015-02-02,NOP,ATL
6,@,W 115-98 ,240,41,92,.446,32,65,.492,9,27,.333,24,29,.828,115,33,81,.407,23,47,.489,10,34,.294,22,30,.733,98,2015-02-09,LAC,DAL
7,@,L 115-119 ,240,43,84,.512,33,56,.589,10,28,.357,19,23,.826,115,42,77,.545,34,58,.586,8,19,.421,27,52,.519,119,2015-02-19,SAS,LAC
8,@,W 115-110 ,240,39,89,.438,25,60,.417,14,29,.483,23,30,.767,115,44,97,.454,35,65,.538,9,32,.281,13,16,.813,110,2015-02-23,BOS,PHO
9,Home,W 115-94 ,240,42,83,.506,28,52,.538,14,31,.452,17,20,.850,115,34,82,.415,32,61,.525,2,21,.095,24,31,.774,94,2015-02-25,BOS,NYK
10,Home,L 115-121 (2OT),290,39,97,.402,31,66,.470,8,31,.258,29,40,.725,115,45,109,.413,39,91,.429,6,18,.333,25,26,.962,121,2015-02-27,DET,NYK
11,Home,W 115-112 ,240,39,89,.438,29,63,.460,10,26,.385,27,31,.871,115,45,94,.479,41,80,.513,4,14,.286,18,22,.818,112,2015-02-27,POR,OKC
12,Home,W 115-98 ,240,43,82,.524,36,68,.529,7,14,.500,22,30,.733,115,33,78,.423,26,47,.553,7,31,.226,25,38,.658,98,2015-03-02,MIA,PHO
13,@,W 115-91 ,240,42,85,.494,34,66,.515,8,19,.421,23,28,.821,115,35,88,.398,32,72,.444,3,16,.188,18,24,.750,91,2015-03-04,CHO,BRK
14,Home,W 115-102 ,240,42,84,.500,29,53,.547,13,31,.419,18,20,.900,115,34,81,.420,25,54,.463,9,27,.333,25,27,.926,102,2015-03-11,DEN,ATL
15,@,L 115-119 ,240,40,90,.444,33,64,.516,7,26,.269,28,35,.800,115,42,89,.472,32,64,.500,10,25,.400,25,35,.714,119,2015-03-16,OKC,DAL
16,@,L 115-123 ,240,41,82,.500,28,53,.528,13,29,.448,20,25,.800,115,43,84,.512,30,54,.556,13,30,.433,24,26,.923,123,2015-03-20,ATL,OKC
17,Home,W 115-100 ,240,42,80,.525,30,54,.556,12,26,.462,19,22,.864,115,37,86,.430,22,56,.393,15,30,.500,11,14,.786,100,2015-03-28,CHO,ATL
18,Home,W 115-111 ,240,41,89,.461,23,49,.469,18,40,.450,15,25,.600,115,48,96,.500,41,82,.500,7,14,.500,8,16,.500,111,2015-04-01,HOU,SAC
19,@,W 115-112 ,240,38,81,.469,30,53,.566,8,28,.286,31,50,.620,115,40,92,.435,26,62,.419,14,30,.467,18,26,.692,112,2015-04-05,HOU,OKC
20,@,W 115-100 ,240,42,78,.538,28,50,.560,14,28,.500,17,20,.850,115,39,93,.419,39,84,.464,0,9,.000,22,28,.786,100,2015-10-28,CHI,BRK
21,Home,W 115-96 ,240,44,87,.506,29,57,.509,15,30,.500,12,20,.600,115,37,77,.481,30,57,.526,7,20,.350,15,21,.714,96,2015-11-05,POR,MEM
22,Home,L 115-121 ,240,42,84,.500,32,54,.593,10,30,.333,21,24,.875,115,41,77,.532,32,56,.571,9,21,.429,30,35,.857,121,2015-11-06,NOP,ATL
23,Home,W 115-110 ,240,43,80,.538,32,51,.627,11,29,.379,18,27,.667,115,37,79,.468,31,61,.508,6,18,.333,30,39,.769,110,2015-11-17,GSW,TOR
24,@,W 115-98 ,240,45,85,.529,30,55,.545,15,30,.500,10,13,.769,115,41,83,.494,34,60,.567,7,23,.304,9,11,.818,98,2015-11-17,DEN,NOP
25,Home,W 115-86 ,240,37,70,.529,25,48,.521,12,22,.545,29,41,.707,115,31,72,.431,21,51,.412,10,21,.476,14,24,.583,86,2015-11-17,WAS,MIL
26,Home,W 115-100 ,240,40,71,.563,29,47,.617,11,24,.458,24,30,.800,115,38,73,.521,35,65,.538,3,8,.375,21,26,.808,100,2015-11-19,CLE,MIL
27,@,W 115-112 (OT),265,43,94,.457,34,65,.523,9,29,.310,20,24,.833,115,41,100,.410,26,60,.433,15,40,.375,15,17,.882,112,2015-12-01,DAL,POR
28,Home,W 115-96 ,240,43,85,.506,35,63,.556,8,22,.364,21,26,.808,115,38,92,.413,27,61,.443,11,31,.355,9,13,.692,96,2015-12-14,CHI,PHI
29,Home,W 115-107 ,240,43,87,.494,33,68,.485,10,19,.526,19,24,.792,115,36,72,.500,26,48,.542,10,24,.417,25,40,.625,107,2015-12-18,SAS,LAC
30,Home,W 115-89 ,240,41,85,.482,28,54,.519,13,31,.419,20,23,.870,115,33,95,.347,26,67,.388,7,28,.250,16,24,.667,89,2015-12-23,NOP,POR
31,Home,L 115-121 ,240,39,72,.542,28,52,.538,11,20,.550,26,39,.667,115,43,99,.434,29,58,.500,14,41,.341,21,25,.840,121,2015-12-29,HOU,ATL
32,Home,W 115-90 ,240,41,86,.477,27,51,.529,14,35,.400,19,28,.679,115,35,86,.407,30,72,.417,5,14,.357,15,19,.789,90,2015-12-31,DET,MIN
33,@,W 115-113 ,240,42,82,.512,33,61,.541,9,21,.429,22,25,.880,115,42,92,.457,29,61,.475,13,31,.419,16,19,.842,113,2016-01-03,CHI,TOR
34,Home,W 115-89 ,240,43,88,.489,29,58,.500,14,30,.467,15,21,.714,115,36,81,.444,30,61,.492,6,20,.300,11,11,1.000,89,2016-01-04,DET,ORL
35,Home,L 115-121 ,240,42,76,.553,28,52,.538,14,24,.583,17,27,.630,115,48,89,.539,36,60,.600,12,29,.414,13,19,.684,121,2016-01-06,WAS,CLE
36,@,L 115-118 ,240,41,76,.539,33,52,.635,8,24,.333,25,29,.862,115,47,85,.553,41,64,.641,6,21,.286,18,27,.667,118,2016-01-07,LAL,SAC
37,Home,W 115-110 ,240,42,100,.420,23,56,.411,19,44,.432,12,14,.857,115,37,76,.487,27,55,.491,10,21,.476,26,36,.722,110,2016-01-10,POR,OKC
38,@,W 115-111 (OT),265,41,88,.466,34,71,.479,7,17,.412,26,31,.839,115,42,93,.452,30,66,.455,12,27,.444,15,20,.750,111,2016-01-14,CHI,PHI
39,Home,W 115-109 ,240,46,83,.554,35,54,.648,11,29,.379,12,17,.706,115,43,85,.506,31,59,.525,12,26,.462,11,15,.733,109,2016-01-20,TOR,BOS
40,Home,W 115-102 ,240,42,83,.506,29,55,.527,13,28,.464,18,24,.750,115,36,80,.450,30,55,.545,6,25,.240,24,36,.667,102,2016-01-21,CLE,LAC
41,Home,W 115-99 ,240,46,86,.535,41,74,.554,5,12,.417,18,18,1.000,115,38,91,.418,31,61,.508,7,30,.233,16,20,.800,99,2016-01-21,NOP,DET
42,Home,W 115-104 ,240,43,89,.483,28,45,.622,15,44,.341,14,21,.667,115,36,79,.456,21,49,.429,15,30,.500,17,22,.773,104,2016-01-24,HOU,DAL
43,Home,W 115-93 ,240,45,81,.556,34,53,.642,11,28,.393,14,16,.875,115,33,70,.471,25,50,.500,8,20,.400,19,25,.760,93,2016-01-27,CLE,PHO
44,Home,W 115-102 ,240,44,84,.524,28,49,.571,16,35,.457,11,16,.688,115,38,85,.447,32,68,.471,6,17,.353,20,27,.741,102,2016-02-02,HOU,MIA
45,@,L 115-119 ,240,46,80,.575,42,63,.667,4,17,.235,19,25,.760,115,40,80,.500,28,54,.519,12,26,.462,27,35,.771,119,2016-02-02,MIN,LAL
46,Home,W 115-110 ,240,39,87,.448,33,69,.478,6,18,.333,31,44,.705,115,43,93,.462,38,81,.469,5,12,.417,19,27,.704,110,2016-02-05,DEN,CHI
47,@,W 115-111 ,240,44,88,.500,36,68,.529,8,20,.400,19,28,.679,115,41,87,.471,25,51,.490,16,36,.444,13,13,1.000,111,2016-02-19,MIA,ATL
48,@,W 115-112 ,240,42,82,.512,31,51,.608,11,31,.355,20,26,.769,115,42,94,.447,29,58,.500,13,36,.361,15,18,.833,112,2016-02-20,GSW,LAC
49,@,L 115-126 ,240,43,93,.462,36,72,.500,7,21,.333,22,33,.667,115,44,79,.557,31,60,.517,13,19,.684,25,26,.962,126,2016-02-21,LAL,CHI
50,@,W 115-92 ,240,41,80,.513,31,57,.544,10,23,.435,23,27,.852,115,37,90,.411,32,69,.464,5,21,.238,13,19,.684,92,2016-02-21,CLE,OKC
51,Home,W 115-111 ,240,39,90,.433,27,58,.466,12,32,.375,25,38,.658,115,43,86,.500,35,70,.500,8,16,.500,17,23,.739,111,2016-02-21,POR,UTA
52,Home,L 115-124 ,240,43,79,.544,33,58,.569,10,21,.476,19,26,.731,115,41,85,.482,34,71,.479,7,14,.500,35,41,.854,124,2016-02-23,PHI,ORL
53,@,L 115-117 ,240,39,83,.470,28,56,.500,11,27,.407,26,35,.743,115,34,67,.507,28,55,.509,6,12,.500,43,54,.796,117,2016-03-04,POR,TOR
54,Home,W 115-112 ,240,45,94,.479,38,69,.551,7,25,.280,18,26,.692,115,41,83,.494,34,58,.586,7,25,.280,23,27,.852,112,2016-03-07,NOP,SAC
55,Home,W 115-94 ,240,48,84,.571,35,54,.648,13,30,.433,6,10,.600,115,32,79,.405,24,59,.407,8,20,.400,22,31,.710,94,2016-03-09,GSW,UTA
56,Home,W 115-108 ,240,44,92,.478,32,66,.485,12,26,.462,15,18,.833,115,40,79,.506,36,64,.563,4,15,.267,24,29,.828,108,2016-03-18,DET,SAC
57,Home,W 115-103 ,240,46,94,.489,36,70,.514,10,24,.417,13,21,.619,115,42,80,.525,37,66,.561,5,14,.357,14,21,.667,103,2016-03-19,DET,BRK
58,@,W 115-111 ,240,42,80,.525,32,52,.615,10,28,.357,21,26,.808,115,40,83,.482,31,61,.508,9,22,.409,22,30,.733,111,2016-03-19,OKC,IND
59,@,W 115-107 ,240,45,87,.517,31,62,.500,14,25,.560,11,15,.733,115,38,82,.463,23,50,.460,15,32,.469,16,21,.762,107,2016-03-23,NYK,CHI
60,@,W 115-91 ,240,41,74,.554,25,45,.556,16,29,.552,17,21,.810,115,37,84,.440,33,69,.478,4,15,.267,13,15,.867,91,2016-03-26,CHO,MIL
61,@,W 115-91 ,240,39,73,.534,27,44,.614,12,29,.414,25,28,.893,115,37,85,.435,33,70,.471,4,15,.267,13,20,.650,91,2016-03-26,TOR,NOP
62,@,W 115-106 ,240,41,88,.466,33,67,.493,8,21,.381,25,31,.806,115,40,92,.435,31,63,.492,9,29,.310,17,24,.708,106,2016-04-02,SAC,DEN
63,@,W 115-102 ,240,44,84,.524,36,61,.590,8,23,.348,19,23,.826,115,34,83,.410,18,46,.391,16,37,.432,18,26,.692,102,2016-04-02,IND,PHI
64,@,W 115-107 ,240,40,93,.430,28,62,.452,12,31,.387,23,27,.852,115,41,78,.526,30,56,.536,11,22,.500,14,21,.667,107,2016-04-05,POR,SAC
65,@,L 115-120 ,240,43,91,.473,34,69,.493,9,22,.409,20,31,.645,115,43,84,.512,28,51,.549,15,33,.455,19,24,.792,120,2016-04-06,OKC,POR
66,Home,L 115-124 ,240,42,74,.568,28,41,.683,14,33,.424,17,28,.607,115,44,94,.468,32,63,.508,12,31,.387,24,29,.828,124,2016-04-07,HOU,PHO
67,Home,W 115-105 ,240,39,83,.470,24,59,.407,15,24,.625,22,27,.815,115,37,81,.457,20,46,.435,17,35,.486,14,18,.778,105,2016-04-13,CHI,PHI
68,@,W 115-113 (OT),265,45,98,.459,35,66,.530,10,32,.313,15,21,.714,115,38,100,.380,32,77,.416,6,23,.261,31,39,.795,113,2016-10-29,POR,DEN
69,Home,W 115-108 ,240,41,87,.471,31,59,.525,10,28,.357,23,29,.793,115,40,89,.449,34,61,.557,6,28,.214,22,25,.880,108,2016-11-01,IND,LAL
70,@,L 115-118 (OT),265,42,101,.416,30,68,.441,12,33,.364,19,21,.905,115,44,103,.427,39,87,.448,5,16,.313,25,30,.833,118,2016-11-02,POR,PHO
71,Home,W 115-107 ,240,42,83,.506,33,63,.524,9,20,.450,22,27,.815,115,41,91,.451,32,64,.500,9,27,.333,16,21,.762,107,2016-11-09,ATL,CHI
72,@,L 115-122 (OT),265,46,95,.484,32,59,.542,14,36,.389,9,19,.474,115,49,90,.544,40,71,.563,9,19,.474,15,20,.750,122,2016-11-09,PHI,IND
73,Home,W 115-87 ,240,35,90,.389,24,63,.381,11,27,.407,34,43,.791,115,33,94,.351,27,71,.380,6,23,.261,15,17,.882,87,2016-11-11,BOS,NYK
74,Home,W 115-88 ,240,44,91,.484,27,51,.529,17,40,.425,10,17,.588,115,34,90,.378,29,68,.426,5,22,.227,15,17,.882,88,2016-11-14,HOU,PHI
75,@,W 115-108 ,240,43,80,.538,32,56,.571,11,24,.458,18,22,.818,115,38,89,.427,23,54,.426,15,35,.429,17,21,.810,108,2016-11-15,CHO,MIN
76,Home,L 115-121 ,240,38,86,.442,28,60,.467,10,26,.385,29,35,.829,115,40,76,.526,27,47,.574,13,29,.448,28,34,.824,121,2016-11-18,SAC,LAC
77,@,W 115-111 (OT),265,40,89,.449,29,67,.433,11,22,.500,24,31,.774,115,44,101,.436,34,65,.523,10,36,.278,13,18,.722,111,2016-11-20,IND,OKC
78,@,L 115-123 ,240,40,80,.500,32,61,.525,8,19,.421,27,32,.844,115,39,74,.527,29,49,.592,10,25,.400,35,42,.833,123,2016-11-21,TOR,LAC
79,@,W 115-102 ,240,43,88,.489,31,65,.477,12,23,.522,17,21,.810,115,38,78,.487,24,36,.667,14,42,.333,12,12,1.000,102,2016-11-23,TOR,HOU
80,Home,W 115-102 ,240,45,81,.556,34,59,.576,11,22,.500,14,17,.824,115,41,89,.461,31,54,.574,10,35,.286,10,12,.833,102,2016-11-26,GSW,MIN
81,@,L 115-126 (OT),265,44,98,.449,34,70,.486,10,28,.357,17,26,.654,115,46,95,.484,34,65,.523,12,30,.400,22,31,.710,126,2016-11-30,WAS,OKC
82,@,W 115-98 ,240,42,89,.472,35,58,.603,7,31,.226,24,29,.828,115,36,92,.391,28,66,.424,8,26,.308,18,24,.750,98,2016-12-07,GSW,LAC
83,Home,W 115-107 ,240,40,77,.519,30,53,.566,10,24,.417,25,37,.676,115,37,85,.435,20,45,.444,17,40,.425,16,19,.842,107,2016-12-07,MIL,POR
84,Home,L 115-119 ,240,40,87,.460,31,61,.508,9,26,.346,26,34,.765,115,45,95,.474,32,65,.492,13,30,.433,16,21,.762,119,2016-12-09,LAL,PHO
85,Home,W 115-108 ,240,42,86,.488,35,67,.522,7,19,.368,24,25,.960,115,37,82,.451,28,61,.459,9,21,.429,25,35,.714,108,2016-12-19,MIN,PHO
86,Home,W 115-107 ,240,45,84,.536,34,62,.548,11,22,.500,14,21,.667,115,40,90,.444,26,52,.500,14,38,.368,13,15,.867,107,2016-12-22,MIA,LAL
87,Home,W 115-109 ,240,41,81,.506,28,56,.500,13,25,.520,20,25,.800,115,38,89,.427,18,37,.486,20,52,.385,13,15,.867,109,2016-12-23,MEM,HOU
88,@,L 115-131 ,240,43,101,.426,36,71,.507,7,30,.233,22,27,.815,115,46,92,.500,31,49,.633,15,43,.349,24,30,.800,131,2016-12-26,PHO,HOU
89,@,W 115-103 ,240,45,91,.495,30,60,.500,15,31,.484,10,14,.714,115,39,83,.470,31,62,.500,8,21,.381,17,24,.708,103,2017-01-02,ORL,NYK
90,Home,W 115-104 ,240,41,74,.554,24,43,.558,17,31,.548,16,17,.941,115,38,82,.463,27,56,.482,11,26,.423,17,21,.810,104,2017-01-03,BOS,UTA
91,Home,W 115-106 ,240,37,73,.507,28,50,.560,9,23,.391,32,45,.711,115,38,88,.432,27,60,.450,11,28,.393,19,25,.760,106,2017-01-04,LAC,MEM
92,Home,W 115-114 ,240,39,97,.402,29,69,.420,10,28,.357,27,32,.844,115,37,91,.407,27,65,.415,10,26,.385,30,34,.882,114,2017-01-05,DET,CHO
93,@,W 115-109 ,240,41,83,.494,31,65,.477,10,18,.556,23,26,.885,115,39,97,.402,29,63,.460,10,34,.294,21,25,.840,109,2017-01-13,ORL,POR
94,Home,L 115-118 (OT),265,45,91,.495,32,57,.561,13,34,.382,12,22,.545,115,48,96,.500,38,70,.543,10,26,.385,12,14,.857,118,2017-01-21,CLE,SAS
95,@,W 115-103 ,240,40,79,.506,31,57,.544,9,22,.409,26,28,.929,115,33,83,.398,26,56,.464,7,27,.259,30,35,.857,103,2017-01-22,PHO,TOR
96,@,W 115-105 ,240,42,84,.500,28,60,.467,14,24,.583,17,22,.773,115,37,88,.420,28,59,.475,9,29,.310,22,26,.846,105,2017-01-23,LAC,ATL
97,Home,W 115-111 (OT),265,38,78,.487,28,50,.560,10,28,.357,29,33,.879,115,35,71,.493,22,45,.489,13,26,.500,28,36,.778,111,2017-01-27,IND,SAC
98,@,W 115-96 ,240,39,80,.488,23,52,.442,16,28,.571,21,24,.875,115,31,74,.419,26,55,.473,5,19,.263,29,39,.744,96,2017-01-30,MEM,PHO
99,Home,W 115-98 ,240,42,93,.452,31,62,.500,11,31,.355,20,23,.870,115,33,83,.398,22,52,.423,11,31,.355,21,25,.840,98,2017-01-31,POR,CHO
0,@,W 115-113 ,240,45,86,.523,30,58,.517,15,28,.536,10,14,.714,115,43,80,.538,38,69,.551,5,11,.455,22,28,.786,113,2017-02-06,MIA,MIN
1,Home,L 115-119 ,240,46,92,.500,38,65,.585,8,27,.296,15,18,.833,115,45,92,.489,35,67,.522,10,25,.400,19,28,.679,119,2017-02-08,NYK,LAC
2,Home,W 115-97 ,240,48,95,.505,40,76,.526,8,19,.421,11,13,.846,115,37,86,.430,32,67,.478,5,19,.263,18,22,.818,97,2017-02-10,PHO,CHI
3,@,W 115-95 ,240,43,84,.512,33,51,.647,10,33,.303,19,25,.760,115,37,87,.425,31,63,.492,6,24,.250,15,20,.750,95,2017-03-03,BOS,LAL
4,Home,W 115-114 ,240,39,81,.481,25,55,.455,14,26,.538,23,25,.920,115,44,89,.494,30,54,.556,14,35,.400,12,19,.632,114,2017-03-05,WAS,ORL
5,@,W 115-108 ,240,41,76,.539,29,45,.644,12,31,.387,21,24,.875,115,35,79,.443,27,47,.574,8,32,.250,30,40,.750,108,2017-03-08,UTA,HOU
6,Home,W 115-98 ,240,44,88,.500,33,65,.508,11,23,.478,16,19,.842,115,39,89,.438,32,63,.508,7,26,.269,13,22,.591,98,2017-03-08,IND,DET
7,@,W 114-101 ,240,39,78,.500,32,61,.525,7,17,.412,29,34,.853,114,41,80,.513,34,65,.523,7,15,.467,12,20,.600,101,2011-12-30,CHI,LAC
8,@,W 114-92 ,240,40,89,.449,30,61,.492,10,28,.357,24,27,.889,114,30,86,.349,24,64,.375,6,22,.273,26,41,.634,92,2011-12-31,NYK,SAC
9,@,W 114-106 ,240,42,87,.483,37,71,.521,5,16,.313,25,26,.962,114,39,80,.488,36,69,.522,3,11,.273,25,32,.781,106,2012-01-16,HOU,WAS
10,@,W 114-75 ,240,46,83,.554,40,74,.541,6,9,.667,16,17,.941,114,27,89,.303,20,75,.267,7,14,.500,14,19,.737,75,2012-01-20,CHI,CLE
11,Home,L 114-119 (2OT),290,44,97,.454,33,64,.516,11,33,.333,15,21,.714,114,41,98,.418,35,74,.473,6,24,.250,31,43,.721,119,2012-01-21,NYK,DEN
12,Home,W 114-106 (OT),265,43,98,.439,33,76,.434,10,22,.455,18,21,.857,114,39,90,.433,23,61,.377,16,29,.552,12,13,.923,106,2012-02-04,SAC,GSW
13,@,W 114-96 ,240,43,83,.518,36,69,.522,7,14,.500,21,25,.840,114,33,84,.393,24,61,.393,9,23,.391,21,25,.840,96,2012-02-13,MIA,MIL
14,Home,W 114-108 ,240,43,93,.462,37,81,.457,6,12,.500,22,25,.880,114,43,86,.500,39,75,.520,4,11,.364,18,22,.818,108,2012-02-17,DET,SAC
15,Home,W 114-100 ,240,47,89,.528,42,74,.568,5,15,.333,15,19,.789,114,38,84,.452,36,73,.493,2,11,.182,22,26,.846,100,2012-02-17,UTA,WAS
16,@,W 114-99 ,240,41,86,.477,28,59,.475,13,27,.481,19,23,.826,114,37,83,.446,30,64,.469,7,19,.368,18,21,.857,99,2012-02-23,SAS,DEN
17,Home,W 114-98 ,240,42,81,.519,28,54,.519,14,27,.519,16,27,.593,114,37,79,.468,31,63,.492,6,16,.375,18,27,.667,98,2012-03-03,ORL,MIL
18,@,L 114-119 ,240,46,83,.554,39,66,.591,7,17,.412,15,21,.714,114,45,93,.484,32,67,.478,13,26,.500,16,21,.762,119,2012-03-09,NYK,MIL
19,@,W 114-110 (OT),265,39,81,.481,32,66,.485,7,15,.467,29,38,.763,114,37,82,.451,32,66,.485,5,16,.313,31,51,.608,110,2012-03-16,TOR,MEM
20,@,W 114-105 ,240,45,87,.517,36,68,.529,9,19,.474,15,25,.600,114,39,88,.443,30,63,.476,9,25,.360,18,20,.900,105,2012-03-16,SAS,OKC
21,Home,W 114-91 ,240,42,78,.538,33,56,.589,9,22,.409,21,22,.955,114,29,79,.367,17,53,.321,12,26,.462,21,27,.778,91,2012-03-21,OKC,LAC
22,Home,W 114-104 ,240,35,69,.507,29,47,.617,6,22,.273,38,43,.884,114,41,93,.441,35,77,.455,6,16,.375,16,26,.615,104,2012-04-08,SAS,UTA
23,@,W 114-90 ,240,47,82,.573,40,62,.645,7,20,.350,13,16,.813,114,32,83,.386,26,61,.426,6,22,.273,20,23,.870,90,2012-04-09,PHO,MIN
24,@,W 114-88 ,240,48,87,.552,45,78,.577,3,9,.333,15,20,.750,114,39,89,.438,37,74,.500,2,15,.133,8,14,.571,88,2012-04-22,SAC,CHA
25,Home,W 114-106 (2OT),290,41,106,.387,36,90,.400,5,16,.313,27,40,.675,114,37,101,.366,29,77,.377,8,24,.333,24,28,.857,106,2012-04-22,LAL,OKC
26,Home,W 114-98 ,240,42,77,.545,34,57,.596,8,20,.400,22,29,.759,114,37,88,.420,32,66,.485,5,22,.227,19,28,.679,98,2012-04-22,SAS,CLE
27,@,W 114-110 ,240,41,84,.488,37,68,.544,4,16,.250,28,39,.718,114,30,70,.429,20,49,.408,10,21,.476,40,52,.769,110,2012-11-03,GSW,LAC
28,Home,W 114-91 ,240,48,78,.615,38,58,.655,10,20,.500,8,13,.615,114,36,93,.387,31,71,.437,5,22,.227,14,18,.778,91,2012-11-05,DAL,POR
29,Home,W 114-101 ,240,42,77,.545,37,55,.673,5,22,.227,25,31,.806,114,38,87,.437,35,73,.479,3,14,.214,22,26,.846,101,2012-11-13,BRK,CLE
30,Home,W 114-102 ,240,42,89,.472,34,68,.500,8,21,.381,22,28,.786,114,45,92,.489,40,78,.513,5,14,.357,7,15,.467,102,2012-11-16,LAL,PHO
31,Home,W 114-111 ,240,42,85,.494,29,56,.518,13,29,.448,17,21,.810,114,39,77,.506,24,46,.522,15,31,.484,18,22,.818,111,2012-11-21,DAL,NYK
32,Home,W 114-87 ,240,46,77,.597,39,60,.650,7,17,.412,15,18,.833,114,31,77,.403,26,58,.448,5,19,.263,20,26,.769,87,2012-11-21,PHO,POR
33,Home,W 114-69 ,240,40,78,.513,27,51,.529,13,27,.481,21,23,.913,114,23,79,.291,17,57,.298,6,22,.273,17,22,.773,69,2012-11-26,OKC,CHA
34,Home,W 114-108 ,240,41,84,.488,32,67,.478,9,17,.529,23,28,.821,114,36,84,.429,25,56,.446,11,28,.393,25,31,.806,108,2012-12-07,OKC,LAL
35,Home,W 114-92 ,240,48,87,.552,42,67,.627,6,20,.300,12,13,.923,114,37,95,.389,26,62,.419,11,33,.333,7,8,.875,92,2012-12-07,SAS,HOU
36,Home,W 114-106 (OT),265,41,94,.436,35,71,.493,6,23,.261,26,32,.813,114,39,84,.464,32,70,.457,7,14,.500,21,25,.840,106,2012-12-15,MIN,DAL
37,@,L 114-126 ,240,41,83,.494,30,54,.556,11,29,.379,21,30,.700,114,45,94,.479,33,72,.458,12,22,.545,24,32,.750,126,2012-12-26,LAL,DEN
38,Home,L 114-116 ,240,34,71,.479,25,56,.446,9,15,.600,37,40,.925,114,38,77,.494,31,54,.574,7,23,.304,33,41,.805,116,2012-12-28,UTA,LAC
39,Home,W 114-96 ,240,44,87,.506,39,72,.542,5,15,.333,21,24,.875,114,37,78,.474,29,54,.537,8,24,.333,14,17,.824,96,2012-12-31,OKC,PHO
40,@,W 114-106 ,240,42,88,.477,30,55,.545,12,33,.364,18,22,.818,114,41,85,.482,31,59,.525,10,26,.385,14,18,.778,106,2013-01-05,NYK,ORL
41,Home,L 114-117 (OT),265,41,91,.451,34,71,.479,7,20,.350,25,30,.833,114,39,95,.411,33,75,.440,6,20,.300,33,36,.917,117,2013-01-18,DAL,OKC
42,Home,W 114-105 ,240,43,89,.483,31,64,.484,12,25,.480,16,21,.762,114,38,81,.469,35,66,.530,3,15,.200,26,32,.813,105,2013-01-21,NOH,SAC
43,Home,W 114-101 ,240,48,83,.578,40,66,.606,8,17,.471,10,17,.588,114,39,88,.443,36,74,.486,3,14,.214,20,33,.606,101,2013-01-25,WAS,MIN
44,Home,W 114-110 (OT),265,44,83,.530,41,73,.562,3,10,.300,23,26,.885,114,44,82,.537,37,61,.607,7,21,.333,15,18,.833,110,2013-01-26,UTA,IND
45,@,W 114-102 ,240,46,86,.535,40,71,.563,6,15,.400,16,20,.800,114,38,87,.437,32,68,.471,6,19,.316,20,23,.870,102,2013-01-28,GSW,TOR
46,Home,W 114-103 ,240,36,75,.480,25,50,.500,11,25,.440,31,40,.775,114,36,81,.444,28,60,.467,8,21,.381,23,28,.821,103,2013-02-05,IND,ATL
47,Home,W 114-108 ,240,40,82,.488,30,59,.508,10,23,.435,24,28,.857,114,39,80,.488,30,55,.545,9,25,.360,21,25,.840,108,2013-02-06,MIA,HOU
48,@,L 114-118 (3OT),315,48,113,.425,40,87,.460,8,26,.308,10,17,.588,114,43,108,.398,30,78,.385,13,30,.433,19,24,.792,118,2013-02-10,DEN,BOS
49,Home,W 114-82 ,240,41,73,.562,31,59,.525,10,14,.714,22,33,.667,114,29,82,.354,26,63,.413,3,19,.158,21,37,.568,82,2013-02-22,IND,DET
50,@,W 114-90 ,240,45,77,.584,36,56,.643,9,21,.429,15,18,.833,114,35,78,.449,24,50,.480,11,28,.393,9,10,.900,90,2013-02-23,MIA,PHI
51,@,W 114-103 ,240,40,79,.506,26,46,.565,14,33,.424,20,24,.833,114,41,84,.488,38,70,.543,3,14,.214,18,22,.818,103,2013-02-25,ATL,DET
52,@,L 114-122 (OT),265,46,100,.460,38,78,.487,8,22,.364,14,18,.778,114,46,92,.500,41,78,.526,5,14,.357,25,30,.833,122,2013-03-02,TOR,MIL
53,Home,W 114-75 ,240,45,89,.506,36,69,.522,9,20,.450,15,20,.750,114,28,86,.326,22,67,.328,6,19,.316,13,18,.722,75,2013-03-03,SAS,DET
54,@,L 114-119 ,240,43,81,.531,37,66,.561,6,15,.400,22,29,.759,114,42,79,.532,33,57,.579,9,22,.409,26,33,.788,119,2013-03-18,WAS,CHA
55,@,W 114-104 ,240,43,96,.448,39,75,.520,4,21,.190,24,29,.828,114,37,85,.435,33,60,.550,4,25,.160,26,31,.839,104,2013-03-19,DEN,OKC
56,Home,W 114-108 ,240,44,85,.518,38,65,.585,6,20,.300,20,28,.714,114,44,84,.524,37,65,.569,7,19,.368,13,18,.722,108,2013-03-27,CHA,ORL
57,@,L 114-132 ,240,39,83,.470,25,49,.510,14,34,.412,22,32,.688,114,54,99,.545,43,74,.581,11,25,.440,13,21,.619,132,2013-04-06,HOU,DEN
58,Home,W 114-90 ,240,40,80,.500,28,59,.475,12,21,.571,22,28,.786,114,37,84,.440,30,67,.448,7,17,.412,9,13,.692,90,2013-04-17,TOR,BOS
59,Home,W 114-110 ,240,43,80,.538,35,59,.593,8,21,.381,20,24,.833,114,42,85,.494,26,45,.578,16,40,.400,10,13,.769,110,2013-10-30,PHI,MIA
60,Home,W 114-103 ,240,40,83,.482,31,63,.492,9,20,.450,25,32,.781,114,36,80,.450,28,58,.483,8,22,.364,23,28,.821,103,2013-11-08,PHO,DEN
61,Home,W 114-99 ,240,47,90,.522,37,65,.569,10,25,.400,10,10,1.000,114,42,87,.483,34,64,.531,8,23,.348,7,17,.412,99,2013-11-17,LAL,DET
62,Home,W 114-95 ,240,39,74,.527,20,42,.476,19,32,.594,17,20,.850,114,37,89,.416,31,67,.463,6,22,.273,15,23,.652,95,2013-11-29,HOU,BRK
63,@,W 114-108 ,240,38,87,.437,29,64,.453,9,23,.391,29,34,.853,114,40,87,.460,30,59,.508,10,28,.357,18,23,.783,108,2013-12-01,POR,LAL
64,@,W 114-73 ,240,39,72,.542,25,47,.532,14,25,.560,22,27,.815,114,25,73,.342,19,57,.333,6,16,.375,17,23,.739,73,2013-12-08,BOS,NYK
65,@,W 114-108 ,240,44,85,.518,37,62,.597,7,23,.304,19,21,.905,114,39,80,.488,34,61,.557,5,19,.263,25,32,.781,108,2013-12-10,PHO,LAL
66,Home,W 114-107 ,240,42,76,.553,34,55,.618,8,21,.381,22,30,.733,114,39,84,.464,29,55,.527,10,29,.345,19,25,.760,107,2013-12-14,MIA,CLE
67,Home,W 114-100 ,240,45,92,.489,34,65,.523,11,27,.407,13,15,.867,114,39,82,.476,34,61,.557,5,21,.238,17,21,.810,100,2013-12-16,ATL,LAL
68,Home,W 114-111 (OT),265,39,100,.390,28,72,.389,11,28,.393,25,27,.926,114,40,100,.400,30,71,.423,10,29,.345,21,25,.840,111,2013-12-20,CLE,MIL
69,Home,W 114-81 ,240,43,81,.531,31,55,.564,12,26,.462,16,22,.727,114,32,84,.381,28,62,.452,4,22,.182,13,24,.542,81,2013-12-20,IND,HOU
70,@,W 114-97 ,240,44,79,.557,35,56,.625,9,23,.391,17,23,.739,114,40,89,.449,39,77,.506,1,12,.083,16,26,.615,97,2013-12-21,HOU,DET
71,@,W 114-102 ,240,43,92,.467,34,69,.493,9,23,.391,19,28,.679,114,36,91,.396,31,66,.470,5,25,.200,25,35,.714,102,2014-01-01,PHI,DEN
72,Home,L 114-123 ,240,40,78,.513,32,60,.533,8,18,.444,26,31,.839,114,46,82,.561,31,53,.585,15,29,.517,16,19,.842,123,2014-01-02,MIA,GSW
73,@,W 114-104 ,240,40,94,.426,29,64,.453,11,30,.367,23,33,.697,114,41,95,.432,33,71,.465,8,24,.333,14,20,.700,104,2014-01-10,DET,PHI
74,@,W 114-107 ,240,38,73,.521,30,55,.545,8,18,.444,30,42,.714,114,40,95,.421,35,76,.461,5,19,.263,22,31,.710,107,2014-01-11,HOU,WAS
75,@,L 114-121 ,240,43,91,.473,37,71,.521,6,20,.300,22,24,.917,114,49,100,.490,45,81,.556,4,19,.211,19,25,.760,121,2014-01-15,LAL,PHO
76,Home,W 114-97 ,240,41,75,.547,31,53,.585,10,22,.455,22,26,.846,114,37,84,.440,30,59,.508,7,25,.280,16,17,.941,97,2014-01-15,WAS,MIA
77,Home,W 114-104 ,240,41,85,.482,34,58,.586,7,27,.259,25,37,.676,114,40,80,.500,29,57,.509,11,23,.478,13,21,.619,104,2014-01-18,HOU,MIL
78,@,L 114-121 ,240,38,78,.487,23,45,.511,15,33,.455,23,28,.821,114,42,81,.519,30,50,.600,12,31,.387,25,27,.926,121,2014-01-20,MIA,ATL
79,@,W 114-97 ,240,42,82,.512,33,61,.541,9,21,.429,21,31,.677,114,33,69,.478,28,58,.483,5,11,.455,26,38,.684,97,2014-01-21,SAC,NOP
80,Home,W 114-105 ,240,39,81,.481,30,64,.469,9,17,.529,27,34,.794,114,41,90,.456,29,68,.426,12,22,.545,11,17,.647,105,2014-01-24,ORL,LAL
81,@,W 114-86 ,240,43,79,.544,29,51,.569,14,28,.500,14,19,.737,114,34,89,.382,30,67,.448,4,22,.182,14,22,.636,86,2014-01-27,LAC,MIL
82,Home,W 114-88 ,240,44,82,.537,34,62,.548,10,20,.500,16,23,.696,114,32,82,.390,26,60,.433,6,22,.273,18,24,.750,88,2014-01-28,NYK,BOS
83,@,W 114-108 ,240,41,84,.488,33,65,.508,8,19,.421,24,33,.727,114,42,94,.447,35,73,.479,7,21,.333,17,20,.850,108,2014-02-05,BOS,PHI
84,Home,W 114-89 ,240,45,82,.549,33,58,.569,12,24,.500,12,15,.800,114,37,82,.451,32,68,.471,5,14,.357,10,12,.833,89,2014-02-11,CHA,DAL
85,@,W 114-85 ,240,40,87,.460,34,69,.493,6,18,.333,28,33,.848,114,31,87,.356,26,65,.400,5,22,.227,18,27,.667,85,2014-02-18,CLE,PHI
86,@,W 114-97 ,240,46,89,.517,33,65,.508,13,24,.542,9,11,.818,114,33,73,.452,27,57,.474,6,16,.375,25,30,.833,97,2014-02-19,WAS,ATL
87,@,W 114-104 ,240,40,86,.465,29,60,.483,11,26,.423,23,24,.958,114,39,80,.488,26,49,.531,13,31,.419,13,17,.765,104,2014-02-26,CLE,OKC
88,Home,W 114-88 ,240,42,74,.568,34,61,.557,8,13,.615,22,26,.846,114,31,79,.392,25,58,.431,6,21,.286,20,26,.769,88,2014-03-03,MIL,UTA
89,Home,W 114-101 ,240,41,91,.451,35,71,.493,6,20,.300,26,33,.788,114,38,94,.404,34,81,.420,4,13,.308,21,30,.700,101,2014-03-07,MIN,DET
90,@,W 114-107 ,240,43,80,.538,28,52,.538,15,28,.536,13,23,.565,114,39,87,.448,35,71,.493,4,16,.250,25,28,.893,107,2014-03-08,WAS,MIL
91,Home,W 114-110 ,240,38,81,.469,25,50,.500,13,31,.419,25,30,.833,114,42,100,.420,30,65,.462,12,35,.343,14,21,.667,110,2014-03-09,LAL,OKC
92,Home,W 114-98 ,240,44,78,.564,35,61,.574,9,17,.529,17,24,.708,114,35,83,.422,26,56,.464,9,27,.333,19,23,.826,98,2014-03-21,BRK,BOS
93,@,W 114-94 ,240,46,83,.554,37,66,.561,9,17,.529,13,18,.722,114,34,83,.410,27,56,.482,7,27,.259,19,28,.679,94,2014-03-24,DET,UTA
94,Home,W 114-99 ,240,43,86,.500,31,53,.585,12,33,.364,16,22,.727,114,39,83,.470,36,71,.507,3,12,.250,18,27,.667,99,2014-03-30,BRK,MIN
95,@,W 114-104 ,240,38,82,.463,26,52,.500,12,30,.400,26,32,.813,114,41,96,.427,31,70,.443,10,26,.385,12,14,.857,104,2014-03-31,LAC,MIN
96,@,L 114-125 ,240,44,85,.518,36,64,.563,8,21,.381,18,21,.857,114,41,82,.500,29,57,.509,12,25,.480,31,37,.838,125,2014-04-09,PHI,TOR
97,Home,W 114-93 ,240,46,78,.590,32,49,.653,14,29,.483,8,15,.533,114,36,80,.450,29,53,.547,7,27,.259,14,16,.875,93,2014-04-14,WAS,MIA
98,Home,W 114-85 ,240,46,87,.529,38,67,.567,8,20,.400,14,17,.824,114,30,79,.380,22,54,.407,8,25,.320,17,23,.739,85,2014-04-16,CLE,BRK
99,@,W 114-108 (OT),265,41,104,.394,38,89,.427,3,15,.200,29,33,.879,114,41,90,.456,28,59,.475,13,31,.419,13,17,.765,108,2014-10-31,CLE,CHI
0,@,W 114-96 ,240,41,83,.494,29,59,.492,12,24,.500,20,29,.690,114,35,67,.522,28,44,.636,7,23,.304,19,26,.731,96,2014-11-01,MIA,PHI
1,@,W 114-112 (2OT),290,39,91,.429,36,75,.480,3,16,.188,33,39,.846,114,42,98,.429,32,67,.478,10,31,.323,18,25,.720,112,2014-11-07,SAC,PHO
2,Home,W 114-103 ,240,42,75,.560,31,47,.660,11,28,.393,19,23,.826,114,35,74,.473,25,53,.472,10,21,.476,23,25,.920,103,2014-11-14,ATL,MIA
3,Home,L 114-118 ,240,45,87,.517,41,77,.532,4,10,.400,20,31,.645,114,48,93,.516,39,72,.542,9,21,.429,13,16,.813,118,2014-11-17,BOS,PHO
4,@,W 114-109 ,240,47,87,.540,41,70,.586,6,17,.353,14,22,.636,114,41,85,.482,32,58,.552,9,27,.333,18,23,.783,109,2014-11-18,LAL,ATL
5,@,W 114-90 ,240,45,84,.536,33,63,.524,12,21,.571,12,16,.750,114,34,86,.395,26,62,.419,8,24,.333,14,18,.778,90,2014-11-19,LAC,ORL
6,@,W 114-104 ,240,44,89,.494,37,62,.597,7,27,.259,19,23,.826,114,42,84,.500,42,76,.553,0,8,.000,20,24,.833,104,2014-11-24,POR,PHI
7,Home,W 114-109 ,240,43,85,.506,35,69,.507,8,16,.500,20,27,.741,114,35,82,.427,28,61,.459,7,21,.333,32,37,.865,109,2014-11-25,DEN,CHI
8,@,W 114-97 ,240,43,75,.573,30,47,.638,13,28,.464,15,23,.652,114,33,85,.388,23,62,.371,10,23,.435,21,27,.778,97,2014-11-25,GSW,MIA
9,Home,W 114-86 ,240,42,78,.538,30,47,.638,12,31,.387,18,25,.720,114,33,79,.418,26,59,.441,7,20,.350,13,25,.520,86,2014-12-03,LAC,ORL
10,@,W 114-112 (OT),265,38,78,.487,26,46,.565,12,32,.375,26,31,.839,114,45,97,.464,42,87,.483,3,10,.300,19,27,.704,112,2014-12-05,HOU,MIN
11,Home,W 114-105 ,240,41,85,.482,34,71,.479,7,14,.500,25,29,.862,114,38,85,.447,20,45,.444,18,40,.450,11,14,.786,105,2014-12-09,MEM,DAL
12,Home,W 114-101 ,240,41,82,.500,37,61,.607,4,21,.190,28,34,.824,114,34,84,.405,30,63,.476,4,21,.190,29,35,.829,101,2014-12-09,OKC,MIL
13,@,L 114-119 ,240,44,89,.494,36,67,.537,8,22,.364,18,23,.783,114,44,79,.557,32,51,.627,12,28,.429,19,25,.760,119,2014-12-12,CLE,NOP
14,@,W 114-87 ,240,42,72,.583,26,49,.531,16,23,.696,14,20,.700,114,31,79,.392,23,57,.404,8,22,.364,17,27,.630,87,2014-12-13,BRK,CHO
15,Home,W 114-109 ,240,48,94,.511,36,63,.571,12,31,.387,6,10,.600,114,41,86,.477,30,61,.492,11,25,.440,16,24,.667,109,2014-12-18,GSW,OKC
16,Home,W 114-98 ,240,48,85,.565,40,62,.645,8,23,.348,10,14,.714,114,42,93,.452,36,81,.444,6,12,.500,8,16,.500,98,2014-12-19,BOS,MIN
17,@,W 114-88 ,240,48,90,.533,39,65,.600,9,25,.360,9,15,.600,114,30,85,.353,27,70,.386,3,15,.200,25,28,.893,88,2014-12-20,POR,NOP
18,@,W 114-106 ,240,42,81,.519,33,66,.500,9,15,.600,21,38,.553,114,42,81,.519,35,58,.603,7,23,.304,15,21,.714,106,2014-12-25,OKC,SAS
19,Home,W 114-93 ,240,42,88,.477,24,45,.533,18,43,.419,12,14,.857,114,36,81,.444,33,67,.493,3,14,.214,18,33,.545,93,2014-12-26,POR,PHI
20,Home,W 114-87 ,240,43,82,.524,35,67,.522,8,15,.533,20,29,.690,114,33,74,.446,29,62,.468,4,12,.333,17,27,.630,87,2014-12-30,DAL,WAS
21,Home,W 114-85 ,240,41,79,.519,34,64,.531,7,15,.467,25,31,.806,114,37,86,.430,35,72,.486,2,14,.143,9,13,.692,85,2015-01-03,DEN,MEM
22,Home,W 114-95 ,240,45,91,.495,33,60,.550,12,31,.387,12,16,.750,114,32,75,.427,29,60,.483,3,15,.200,28,36,.778,95,2015-01-04,DET,SAC
23,Home,W 114-105 ,240,41,85,.482,36,68,.529,5,17,.294,27,30,.900,114,47,102,.461,39,77,.506,8,25,.320,3,5,.600,105,2015-01-05,CHI,HOU
24,Home,W 114-89 ,240,40,85,.471,28,52,.538,12,33,.364,22,30,.733,114,37,85,.435,32,65,.492,5,20,.250,10,17,.588,89,2015-01-07,LAC,LAL
25,Home,L 114-121 ,240,41,84,.488,33,57,.579,8,27,.296,24,33,.727,114,48,81,.593,41,63,.651,7,18,.389,18,29,.621,121,2015-01-12,CHI,ORL
26,@,W 114-111 ,240,41,96,.427,34,75,.453,7,21,.333,25,31,.806,114,47,87,.540,40,60,.667,7,27,.259,10,14,.714,111,2015-01-12,DET,TOR
27,Home,W 114-107 ,240,41,82,.500,37,63,.587,4,19,.211,28,35,.800,114,41,100,.410,32,63,.508,9,37,.243,16,20,.800,107,2015-01-14,DEN,DAL
28,Home,W 114-111 ,240,42,89,.472,34,66,.515,8,23,.348,22,25,.880,114,41,95,.432,31,67,.463,10,28,.357,19,27,.704,111,2015-01-25,GSW,BOS
29,Home,W 114-110 ,240,43,81,.531,38,66,.576,5,15,.333,23,29,.793,114,41,90,.456,29,56,.518,12,34,.353,16,23,.696,110,2015-01-25,TOR,DET
30,Home,W 114-101 ,240,41,82,.500,31,57,.544,10,25,.400,22,35,.629,114,39,87,.448,28,55,.509,11,32,.344,12,19,.632,101,2015-01-31,DET,HOU
31,@,L 114-128 ,240,41,98,.418,31,68,.456,10,30,.333,22,28,.786,114,45,86,.523,26,48,.542,19,38,.500,19,25,.760,128,2015-02-04,DAL,GSW
32,Home,W 114-109 ,240,46,77,.597,34,56,.607,12,21,.571,10,18,.556,114,43,87,.494,31,63,.492,12,24,.500,11,15,.733,109,2015-02-04,IND,DET
33,Home,W 114-77 ,240,44,87,.506,35,67,.522,9,20,.450,17,23,.739,114,26,77,.338,22,59,.373,4,18,.222,21,31,.677,77,2015-02-07,WAS,BRK
34,Home,L 114-124 ,240,42,87,.483,33,59,.559,9,28,.321,21,29,.724,114,43,80,.538,31,56,.554,12,24,.500,26,35,.743,124,2015-02-09,DEN,OKC
35,@,W 114-105 ,240,42,89,.472,32,68,.471,10,21,.476,20,24,.833,114,41,89,.461,37,66,.561,4,23,.174,19,29,.655,105,2015-02-20,BRK,LAL
36,@,W 114-107 ,240,45,90,.500,33,67,.493,12,23,.522,12,17,.706,114,42,79,.532,37,61,.607,5,18,.278,18,21,.857,107,2015-02-24,GSW,WAS
37,@,W 114-103 ,240,41,80,.513,30,53,.566,11,27,.407,21,24,.875,114,41,78,.526,33,58,.569,8,20,.400,13,19,.684,103,2015-03-02,TOR,PHI
38,@,L 114-119 ,240,38,85,.447,28,58,.483,10,27,.370,28,38,.737,114,48,85,.565,35,61,.574,13,24,.542,10,12,.833,119,2015-03-06,SAC,ORL
39,@,W 114-100 ,240,40,86,.465,30,58,.517,10,28,.357,24,32,.750,114,38,92,.413,29,62,.468,9,30,.300,15,19,.789,100,2015-03-07,HOU,DEN
40,Home,W 114-109 (OT),265,41,80,.513,34,56,.607,7,24,.292,25,33,.758,114,40,88,.455,30,63,.476,10,25,.400,19,24,.792,109,2015-03-07,MIA,SAC
41,@,W 114-103 ,240,44,75,.587,35,60,.583,9,15,.600,17,21,.810,114,37,71,.521,33,56,.589,4,15,.267,25,31,.806,103,2015-03-09,NOP,MIL
42,Home,W 114-103 ,240,41,82,.500,33,65,.508,8,17,.471,24,37,.649,114,39,92,.424,31,73,.425,8,19,.421,17,22,.773,103,2015-03-13,DEN,GSW
43,Home,W 114-107 ,240,45,95,.474,36,63,.571,9,32,.281,15,23,.652,114,35,87,.402,31,73,.425,4,14,.286,33,40,.825,107,2015-03-13,PHI,SAC
44,Home,W 114-95 ,240,44,84,.524,30,54,.556,14,30,.467,12,20,.600,114,31,87,.356,23,65,.354,8,22,.364,25,30,.833,95,2015-03-18,GSW,ATL
45,@,W 114-103 ,240,38,76,.500,30,56,.536,8,20,.400,30,38,.789,114,39,80,.488,32,66,.485,7,14,.500,18,24,.750,103,2015-03-18,SAS,MIL
46,@,W 114-95 ,240,46,82,.561,39,65,.600,7,17,.412,15,17,.882,114,38,80,.475,26,56,.464,12,24,.500,7,7,1.000,95,2015-03-22,SAS,ATL
47,@,L 114-120 ,240,43,92,.467,34,68,.500,9,24,.375,19,22,.864,114,48,85,.565,40,67,.597,8,18,.444,16,18,.889,120,2015-03-28,DEN,POR
48,Home,W 114-88 ,240,40,80,.500,25,45,.556,15,35,.429,19,25,.760,114,32,75,.427,25,54,.463,7,21,.333,17,21,.810,88,2015-04-02,CLE,MIA
49,Home,W 114-109 ,240,46,88,.523,41,72,.569,5,16,.313,17,23,.739,114,42,82,.512,34,56,.607,8,26,.308,17,23,.739,109,2015-04-03,BRK,TOR
50,@,W 114-111 ,240,43,86,.500,32,58,.552,11,28,.393,17,25,.680,114,41,87,.471,34,61,.557,7,26,.269,22,25,.880,111,2015-04-08,ATL,BRK
51,Home,W 114-107 ,240,40,90,.444,31,64,.484,9,26,.346,25,36,.694,114,37,89,.416,24,48,.500,13,41,.317,20,25,.800,107,2015-04-11,CHI,PHI
52,@,L 114-121 ,240,44,91,.484,33,64,.516,11,27,.407,15,22,.682,114,39,73,.534,30,49,.612,9,24,.375,34,48,.708,121,2015-04-12,NOP,HOU
53,Home,W 114-98 ,240,39,86,.453,30,61,.492,9,25,.360,27,34,.794,114,38,91,.418,31,66,.470,7,25,.280,15,18,.833,98,2015-04-15,DAL,POR
54,@,L 114-132 ,240,41,89,.461,30,55,.545,11,34,.324,21,27,.778,114,52,101,.515,46,79,.582,6,22,.273,22,30,.733,132,2015-10-30,LAL,SAC
55,Home,W 114-109 ,240,39,76,.513,35,59,.593,4,17,.235,32,46,.696,114,43,101,.426,37,83,.446,6,18,.333,17,25,.680,109,2015-10-31,LAC,SAC
56,@,L 114-119 (OT),265,46,91,.505,39,71,.549,7,20,.350,15,19,.789,114,42,88,.477,31,54,.574,11,34,.324,24,34,.706,119,2015-11-04,ORL,HOU
57,Home,W 114-99 ,240,43,92,.467,30,59,.508,13,33,.394,15,15,1.000,114,38,78,.487,30,54,.556,8,24,.333,15,17,.882,99,2015-11-07,ATL,WAS
58,Home,W 114-94 ,240,45,81,.556,36,60,.600,9,21,.429,15,23,.652,114,34,73,.466,28,54,.519,6,19,.316,20,31,.645,94,2015-11-07,SAS,CHO
59,@,L 114-118 ,240,40,82,.488,30,60,.500,10,22,.455,24,28,.857,114,37,74,.500,26,50,.520,11,24,.458,33,43,.767,118,2015-11-10,UTA,CLE
60,@,W 114-106 ,240,40,71,.563,31,54,.574,9,17,.529,25,27,.926,114,41,82,.500,36,66,.545,5,16,.313,19,21,.905,106,2015-11-15,MEM,MIN
61,@,L 114-122 ,240,41,81,.506,31,57,.544,10,24,.417,22,31,.710,114,37,84,.440,25,67,.373,12,17,.706,36,39,.923,122,2015-11-16,OKC,MEM
62,@,W 114-107 ,240,40,79,.506,25,52,.481,15,27,.556,19,25,.760,114,41,90,.456,36,66,.545,5,24,.208,20,26,.769,107,2015-11-20,PHO,DEN
63,@,L 114-117 ,240,44,83,.530,34,64,.531,10,19,.526,16,28,.571,114,47,90,.522,38,68,.559,9,22,.409,14,18,.778,117,2015-11-22,DAL,OKC
64,Home,L 114-120 ,240,44,96,.458,34,70,.486,10,26,.385,16,20,.800,114,42,81,.519,32,59,.542,10,22,.455,26,34,.765,120,2015-11-25,PHO,NOP
65,@,L 114-116 ,240,40,83,.482,24,48,.500,16,35,.457,18,26,.692,114,38,73,.521,27,53,.509,11,20,.550,29,37,.784,116,2015-11-27,PHI,HOU
66,Home,W 114-90 ,240,43,82,.524,31,55,.564,12,27,.444,16,22,.727,114,31,74,.419,23,48,.479,8,26,.308,20,22,.909,90,2015-11-27,ORL,MIL
67,@,W 114-97 ,240,40,84,.476,26,51,.510,14,33,.424,20,24,.833,114,29,77,.377,22,56,.393,7,21,.333,32,41,.780,97,2015-12-03,BOS,SAC
68,Home,W 114-108 (OT),265,42,85,.494,33,60,.550,9,25,.360,21,31,.677,114,39,89,.438,29,56,.518,10,33,.303,20,24,.833,108,2015-12-04,NOP,CLE
69,@,W 114-98 ,240,44,86,.512,30,53,.566,14,33,.424,12,23,.522,114,39,89,.438,34,72,.472,5,17,.294,15,23,.652,98,2015-12-06,GSW,BRK
70,@,W 114-103 ,240,46,92,.500,37,74,.500,9,18,.500,13,17,.765,114,41,69,.594,36,53,.679,5,16,.313,16,22,.727,103,2015-12-07,WAS,MIA
71,Home,W 114-106 ,240,43,77,.558,33,49,.673,10,28,.357,18,24,.750,114,38,92,.413,23,56,.411,15,36,.417,15,22,.682,106,2015-12-08,SAC,UTA
72,@,W 114-111 ,240,44,85,.518,30,56,.536,14,29,.483,12,15,.800,114,38,89,.427,24,56,.429,14,33,.424,21,24,.875,111,2015-12-12,WAS,DAL
73,Home,W 114-108 ,240,42,82,.512,34,57,.596,8,25,.320,22,25,.880,114,41,87,.471,23,47,.489,18,40,.450,8,11,.727,108,2015-12-14,DEN,HOU
74,Home,W 114-95 ,240,44,83,.530,36,61,.590,8,22,.364,18,23,.783,114,35,84,.417,32,69,.464,3,15,.200,22,25,.880,95,2015-12-16,SAS,WAS
75,Home,W 114-91 ,240,42,82,.512,28,55,.509,14,27,.519,16,20,.800,114,33,81,.407,26,62,.419,7,19,.368,18,24,.750,91,2015-12-30,DAL,GSW
76,@,W 114-110 ,240,43,84,.512,32,61,.525,11,23,.478,17,27,.630,114,36,78,.462,24,48,.500,12,30,.400,26,29,.897,110,2015-12-31,GSW,HOU
77,Home,W 114-111 (OT),265,42,89,.472,30,53,.566,12,36,.333,18,34,.529,114,40,100,.400,32,70,.457,8,30,.267,23,29,.793,111,2016-01-10,LAC,NOP
78,@,W 114-100 ,240,48,99,.485,39,75,.520,9,24,.375,9,10,.900,114,34,81,.420,25,59,.424,9,22,.409,23,27,.852,100,2016-01-11,WAS,CHI
79,@,L 114-120 ,240,42,86,.488,33,57,.579,9,29,.310,21,26,.808,114,43,81,.531,36,61,.590,7,20,.350,27,30,.900,120,2016-01-12,BOS,NYK
80,Home,W 114-86 ,240,44,79,.557,36,50,.720,8,29,.276,18,24,.750,114,34,78,.436,28,58,.483,6,20,.300,12,19,.632,86,2016-01-16,ATL,BRK
81,Home,W 114-89 ,240,42,76,.553,32,53,.604,10,23,.435,20,30,.667,114,34,87,.391,29,58,.500,5,29,.172,16,24,.667,89,2016-01-16,PHI,POR
82,Home,W 114-99 ,240,42,83,.506,32,60,.533,10,23,.435,20,23,.870,114,36,76,.474,33,62,.532,3,14,.214,24,31,.774,99,2016-01-19,NOP,MIN
83,Home,L 114-123 ,240,43,95,.453,31,71,.437,12,24,.500,16,18,.889,114,38,80,.475,26,50,.520,12,30,.400,35,59,.593,123,2016-01-20,HOU,DET
84,Home,W 114-107 ,240,45,89,.506,34,58,.586,11,31,.355,13,20,.650,114,41,84,.488,37,68,.544,4,16,.250,21,23,.913,107,2016-01-25,CLE,MIN
85,@,W 114-91 ,240,47,95,.495,41,78,.526,6,17,.353,14,16,.875,114,32,85,.376,23,60,.383,9,25,.360,18,23,.783,91,2016-01-28,CHI,LAL
86,Home,W 114-105 ,240,43,98,.439,33,72,.458,10,26,.385,18,24,.750,114,40,89,.449,30,61,.492,10,28,.357,15,20,.750,105,2016-01-28,NOP,SAC
87,@,W 114-106 ,240,39,83,.470,30,60,.500,9,23,.391,27,29,.931,114,40,84,.476,33,61,.541,7,23,.304,19,26,.731,106,2016-01-29,CLE,DET
88,@,L 114-119 ,240,39,93,.419,23,47,.489,16,46,.348,20,25,.800,114,44,82,.537,34,58,.586,10,24,.417,21,35,.600,119,2016-01-31,BOS,ORL
89,Home,W 114-98 ,240,43,83,.518,36,61,.590,7,22,.318,21,27,.778,114,40,86,.465,33,60,.550,7,26,.269,11,15,.733,98,2016-02-01,OKC,WAS
90,@,W 114-100 ,240,44,88,.500,32,64,.500,12,24,.500,14,17,.824,114,36,81,.444,29,58,.500,7,23,.304,21,31,.677,100,2016-02-03,IND,BRK
91,@,L 114-117 ,240,47,95,.495,37,72,.514,10,23,.435,10,12,.833,114,44,93,.473,35,66,.530,9,27,.333,20,25,.800,117,2016-02-03,ORL,OKC
92,@,W 114-110 (OT),265,38,88,.432,23,50,.460,15,38,.395,23,33,.697,114,44,88,.500,35,65,.538,9,23,.391,13,23,.565,110,2016-02-06,DAL,MEM
93,@,W 114-110 ,240,44,87,.506,40,71,.563,4,16,.250,22,29,.759,114,42,91,.462,27,56,.482,15,35,.429,11,17,.647,110,2016-02-10,SAC,PHI
94,@,L 114-121 ,240,40,76,.526,28,49,.571,12,27,.444,22,26,.846,114,41,81,.506,34,64,.531,7,17,.412,32,40,.800,121,2016-02-19,PHI,NOP
95,Home,W 114-94 ,240,47,96,.490,45,83,.542,2,13,.154,18,28,.643,114,40,99,.404,37,77,.481,3,22,.136,11,21,.524,94,2016-02-20,MIA,WAS
96,@,W 114-110 ,240,43,83,.518,36,66,.545,7,17,.412,21,28,.750,114,41,100,.410,31,73,.425,10,27,.370,18,22,.818,110,2016-02-23,SAC,DEN
97,@,L 114-117 (OT),265,36,87,.414,25,53,.472,11,34,.324,31,41,.756,114,38,74,.514,28,50,.560,10,24,.417,31,38,.816,117,2016-02-23,HOU,UTA
98,Home,W 114-103 ,240,45,91,.495,32,59,.542,13,32,.406,11,17,.647,114,37,76,.487,27,47,.574,10,29,.345,19,27,.704,103,2016-02-24,CLE,CHO
99,Home,W 114-105 ,240,41,85,.482,31,59,.525,10,26,.385,22,26,.846,114,37,74,.500,31,64,.484,6,10,.600,25,33,.758,105,2016-02-24,TOR,MIN
0,Home,L 114-130 ,240,41,90,.456,31,64,.484,10,26,.385,22,28,.786,114,53,88,.602,40,63,.635,13,25,.520,11,16,.688,130,2016-02-25,ORL,GSW
1,Home,W 114-101 ,240,41,71,.577,29,48,.604,12,23,.522,20,27,.741,114,39,80,.488,29,59,.492,10,21,.476,13,18,.722,101,2016-02-28,DET,TOR
2,@,L 114-116 (OT),265,41,93,.441,25,52,.481,16,41,.390,16,20,.800,114,44,107,.411,35,81,.432,9,26,.346,19,25,.760,116,2016-03-06,DAL,DEN
3,Home,W 114-108 ,240,42,80,.525,38,72,.528,4,8,.500,26,37,.703,114,42,80,.525,36,65,.554,6,15,.400,18,19,.947,108,2016-03-09,MIL,MIA
4,@,L 114-121 (OT),265,42,96,.438,35,72,.486,7,24,.292,23,34,.676,114,47,96,.490,41,82,.500,6,14,.429,21,32,.656,121,2016-03-11,NOP,MEM
5,Home,W 114-93 ,240,38,67,.567,29,51,.569,9,16,.563,29,38,.763,114,35,80,.438,28,56,.500,7,24,.292,16,22,.727,93,2016-03-11,UTA,WAS
6,@,W 114-90 ,240,41,84,.488,23,47,.489,18,37,.486,14,20,.700,114,32,79,.405,22,47,.468,10,32,.313,16,19,.842,90,2016-03-13,CLE,LAC
7,@,L 114-131 ,240,41,88,.466,30,58,.517,11,30,.367,21,26,.808,114,47,90,.522,37,66,.561,10,24,.417,27,31,.871,131,2016-03-15,PHI,BRK
8,Home,L 114-118 ,240,39,84,.464,31,59,.525,8,25,.320,28,39,.718,114,39,89,.438,27,55,.491,12,34,.353,28,34,.824,118,2016-03-16,DET,ATL
9,@,W 114-108 ,240,40,71,.563,30,50,.600,10,21,.476,24,31,.774,114,44,100,.440,40,80,.500,4,20,.200,16,21,.762,108,2016-03-16,MIN,MEM
10,Home,W 114-98 ,240,39,87,.448,24,53,.453,15,34,.441,21,28,.750,114,36,85,.424,28,57,.491,8,28,.286,18,27,.667,98,2016-03-23,GSW,LAC
11,Home,W 114-90 ,240,44,84,.524,33,59,.559,11,25,.440,15,18,.833,114,31,89,.348,24,70,.343,7,19,.368,21,27,.778,90,2016-03-28,LAC,BOS
12,@,W 114-94 ,240,48,90,.533,43,74,.581,5,16,.313,13,18,.722,114,36,86,.419,29,67,.433,7,19,.368,15,21,.714,94,2016-03-31,ORL,IND
13,Home,W 114-109 ,240,43,85,.506,35,66,.530,8,19,.421,20,33,.606,114,43,94,.457,32,64,.500,11,30,.367,12,21,.571,109,2016-04-03,LAC,WAS
14,Home,W 114-112 ,240,45,94,.479,32,62,.516,13,32,.406,11,20,.550,114,39,81,.481,26,49,.531,13,32,.406,21,28,.750,112,2016-04-09,SAC,OKC
15,@,W 114-100 ,240,41,81,.506,27,49,.551,14,32,.438,18,22,.818,114,34,89,.382,26,65,.400,8,24,.333,24,29,.828,100,2016-04-11,CHO,BOS
16,Home,W 114-105 ,240,45,99,.455,38,73,.521,7,26,.269,17,22,.773,114,43,96,.448,34,65,.523,9,31,.290,10,12,.833,105,2016-04-13,PHO,LAC
17,@,L 114-120 ,240,44,86,.512,37,57,.649,7,29,.241,19,27,.704,114,45,89,.506,33,54,.611,12,35,.343,18,22,.818,120,2016-10-26,HOU,LAL
18,Home,W 114-99 ,240,44,88,.500,32,62,.516,12,26,.462,14,18,.778,114,40,94,.426,34,74,.459,6,20,.300,13,18,.722,99,2016-10-27,ATL,WAS
19,@,W 114-106 ,240,37,91,.407,29,62,.468,8,29,.276,32,46,.696,114,39,85,.459,35,67,.522,4,18,.222,24,32,.750,106,2016-10-27,LAC,POR
20,Home,L 114-122 ,240,47,100,.470,42,78,.538,5,22,.227,15,23,.652,114,44,91,.484,35,63,.556,9,28,.321,25,28,.893,122,2016-10-28,NOP,GSW
21,@,W 114-109 ,240,38,75,.507,30,50,.600,8,25,.320,30,35,.857,114,42,83,.506,34,63,.540,8,20,.400,17,19,.895,109,2016-11-06,UTA,NYK
22,Home,W 114-82 ,240,41,76,.539,28,51,.549,13,25,.520,19,22,.864,114,30,82,.366,26,70,.371,4,12,.333,18,26,.692,82,2016-11-07,LAC,DET
23,@,W 114-106 ,240,41,79,.519,24,42,.571,17,37,.459,15,18,.833,114,39,94,.415,29,67,.433,10,27,.370,18,20,.900,106,2016-11-07,HOU,WAS
24,@,W 114-111 ,240,43,85,.506,30,58,.517,13,27,.481,15,26,.577,114,42,88,.477,31,61,.508,11,27,.407,16,22,.727,111,2016-11-19,MIA,WAS
25,Home,L 114-119 ,240,45,89,.506,34,69,.493,11,20,.550,13,18,.722,114,44,86,.512,31,55,.564,13,31,.419,18,20,.900,119,2016-11-23,CHO,SAS
26,Home,L 114-120 ,240,36,89,.404,25,64,.391,11,25,.440,31,36,.861,114,39,89,.438,26,60,.433,13,29,.448,29,32,.906,120,2016-11-27,PHO,DEN
27,Home,L 114-130 ,240,40,83,.482,28,50,.560,12,33,.364,22,29,.759,114,46,82,.561,29,46,.630,17,36,.472,21,28,.750,130,2016-11-27,POR,HOU
28,Home,L 114-121 ,240,40,91,.440,25,49,.510,15,42,.357,19,20,.950,114,48,87,.552,39,67,.582,9,20,.450,16,21,.762,121,2016-11-30,BOS,DET
29,@,W 114-96 ,240,45,88,.511,35,64,.547,10,24,.417,14,16,.875,114,39,85,.459,34,65,.523,5,20,.250,13,21,.619,96,2016-12-02,LAC,NOP
30,@,L 114-118 ,240,41,88,.466,31,60,.517,10,28,.357,22,24,.917,114,41,86,.477,29,55,.527,12,31,.387,24,30,.800,118,2016-12-02,MIN,NYK
31,@,W 114-103 ,240,48,98,.490,41,73,.562,7,25,.280,11,16,.688,114,38,89,.427,27,64,.422,11,25,.440,16,27,.593,103,2016-12-06,NYK,MIA
32,Home,W 114-84 ,240,46,83,.554,37,59,.627,9,24,.375,13,19,.684,114,31,90,.344,25,63,.397,6,27,.222,16,21,.762,84,2016-12-09,CLE,MIA
33,@,W 114-110 ,240,40,84,.476,28,50,.560,12,34,.353,22,29,.759,114,44,94,.468,32,66,.485,12,28,.429,10,14,.714,110,2016-12-09,ATL,MIL
34,Home,W 114-95 ,240,43,80,.538,35,57,.614,8,23,.348,20,27,.741,114,33,87,.379,25,60,.417,8,27,.296,21,28,.750,95,2016-12-13,POR,OKC
35,Home,L 114-123 ,240,43,86,.500,34,57,.596,9,29,.310,19,25,.760,114,41,87,.471,31,58,.534,10,29,.345,31,36,.861,123,2016-12-14,PHI,TOR
36,@,L 114-127 ,240,35,80,.438,27,57,.474,8,23,.348,36,39,.923,114,50,90,.556,40,63,.635,10,27,.370,17,29,.586,127,2016-12-17,NYK,DEN
37,Home,W 114-101 ,240,41,81,.506,34,65,.523,7,16,.438,25,34,.735,114,39,90,.433,31,68,.456,8,22,.364,15,20,.750,101,2016-12-17,OKC,PHO
38,@,W 114-108 (OT),265,37,91,.407,20,51,.392,17,40,.425,23,27,.852,114,40,87,.460,33,60,.550,7,27,.259,21,29,.724,108,2016-12-20,CLE,MIL
39,Home,L 114-119 ,240,41,87,.471,33,64,.516,8,23,.348,24,27,.889,114,45,93,.484,31,57,.544,14,36,.389,15,20,.750,119,2016-12-25,NYK,BOS
40,Home,W 114-80 ,240,43,82,.524,30,60,.500,13,22,.591,15,20,.750,114,25,74,.338,21,52,.404,4,22,.182,26,38,.684,80,2016-12-29,MEM,OKC
41,@,L 114-117 ,240,48,90,.533,37,62,.597,11,28,.393,7,10,.700,114,38,74,.514,21,42,.500,17,32,.531,24,29,.828,117,2016-12-30,MIA,BOS
42,Home,W 114-88 ,240,37,78,.474,27,49,.551,10,29,.345,30,35,.857,114,31,75,.413,23,45,.511,8,30,.267,18,21,.857,88,2016-12-31,OKC,LAC
43,Home,W 114-112 (OT),265,42,92,.457,28,64,.438,14,28,.500,16,27,.593,114,42,90,.467,33,63,.524,9,27,.333,19,22,.864,112,2017-01-01,ATL,SAS
44,Home,L 114-123 ,240,37,92,.402,22,60,.367,15,32,.469,25,31,.806,114,42,75,.560,32,58,.552,10,17,.588,29,32,.906,123,2017-01-01,LAL,TOR
45,@,L 114-115 ,240,37,91,.407,27,65,.415,10,26,.385,30,34,.882,114,39,97,.402,29,69,.420,10,28,.357,27,32,.844,115,2017-01-05,CHO,DET
46,@,L 114-121 ,240,44,92,.478,25,49,.510,19,43,.442,7,9,.778,114,40,82,.488,23,43,.535,17,39,.436,24,33,.727,121,2017-01-10,CHO,HOU
47,Home,W 114-106 ,240,41,87,.471,31,65,.477,10,22,.455,22,27,.815,114,40,85,.471,31,58,.534,9,27,.333,17,20,.850,106,2017-01-10,TOR,BOS
48,Home,W 114-107 ,240,41,83,.494,34,57,.596,7,26,.269,25,36,.694,114,38,82,.463,26,48,.542,12,34,.353,19,27,.704,107,2017-01-14,UTA,ORL
49,@,L 114-122 ,240,36,73,.493,30,60,.500,6,13,.462,36,41,.878,114,43,84,.512,35,66,.530,8,18,.444,28,35,.800,122,2017-01-17,MIN,SAS
50,Home,L 114-143 ,240,43,105,.410,32,71,.451,11,34,.324,17,23,.739,114,48,83,.578,33,53,.623,15,30,.500,32,35,.914,143,2017-01-20,NOP,BRK
51,@,L 114-127 ,240,39,77,.506,25,42,.595,14,35,.400,22,28,.786,114,47,80,.588,36,57,.632,11,23,.478,22,27,.815,127,2017-01-23,HOU,MIL
52,Home,L 114-119 ,240,43,94,.457,35,67,.522,8,27,.296,20,26,.769,114,43,83,.518,26,53,.491,17,30,.567,16,19,.842,119,2017-01-25,CHI,ATL
53,@,W 114-109 ,240,40,75,.533,28,49,.571,12,26,.462,22,25,.880,114,42,91,.462,35,63,.556,7,28,.250,18,23,.783,109,2017-01-25,PHI,MIL
54,@,W 114-105 ,240,42,91,.462,32,64,.500,10,27,.370,20,28,.714,114,41,96,.427,30,69,.435,11,27,.407,12,19,.632,105,2017-01-25,OKC,NOP
55,@,W 114-113 ,240,42,79,.532,32,56,.571,10,23,.435,20,26,.769,114,36,79,.456,24,51,.471,12,28,.429,29,36,.806,113,2017-01-29,ORL,TOR
56,Home,L 114-124 ,240,39,96,.406,32,76,.421,7,20,.350,29,35,.829,114,44,84,.524,39,65,.600,5,19,.263,31,38,.816,124,2017-02-01,PHO,LAC
57,Home,W 114-102 ,240,38,80,.475,25,54,.463,13,26,.500,25,33,.758,114,40,83,.482,37,64,.578,3,19,.158,19,22,.864,102,2017-02-03,OKC,MEM
58,@,W 114-113 ,240,42,86,.488,31,58,.534,11,28,.393,19,24,.792,114,37,75,.493,25,47,.532,12,28,.429,27,32,.844,113,2017-02-07,POR,DAL
59,@,W 114-110 (OT),265,40,97,.412,31,72,.431,9,25,.360,25,33,.758,114,38,91,.418,29,58,.500,9,33,.273,25,36,.694,110,2017-02-08,WAS,BRK
60,Home,L 114-122 ,240,40,76,.526,32,48,.667,8,28,.286,26,31,.839,114,39,75,.520,24,45,.533,15,30,.500,29,35,.829,122,2017-02-10,MIL,LAL
61,Home,L 114-130 ,240,40,83,.482,34,59,.576,6,24,.250,28,36,.778,114,46,87,.529,33,56,.589,13,31,.419,25,35,.714,130,2017-02-11,OKC,GSW
62,Home,W 114-108 (OT),265,44,107,.411,29,70,.414,15,37,.405,11,12,.917,114,38,92,.413,31,62,.500,7,30,.233,25,26,.962,108,2017-02-23,DET,CHO
63,@,W 114-98 ,240,46,95,.484,40,70,.571,6,25,.240,16,20,.800,114,34,87,.391,24,53,.453,10,34,.294,20,25,.800,98,2017-02-27,ATL,BOS
64,Home,W 114-109 ,240,39,79,.494,29,54,.537,10,25,.400,26,35,.743,114,34,86,.395,23,57,.404,11,29,.379,30,32,.938,109,2017-03-02,POR,OKC
65,@,W 114-106 ,240,41,81,.506,30,56,.536,11,25,.440,21,27,.778,114,34,92,.370,24,62,.387,10,30,.333,28,32,.875,106,2017-03-03,TOR,WAS
66,@,L 114-115 ,240,44,89,.494,30,54,.556,14,35,.400,12,19,.632,114,39,81,.481,25,55,.455,14,26,.538,23,25,.920,115,2017-03-05,ORL,WAS
67,Home,W 114-104 ,240,42,84,.500,28,55,.509,14,29,.483,16,21,.762,114,42,86,.488,35,67,.522,7,19,.368,13,16,.813,104,2017-03-08,SAS,SAC
68,@,W 114-98 ,240,40,78,.513,29,48,.604,11,30,.367,23,28,.821,114,37,83,.446,30,63,.476,7,20,.350,17,22,.773,98,2017-03-09,LAC,MEM
69,Home,W 114-108 (OT),265,40,88,.455,34,67,.507,6,21,.286,28,33,.848,114,41,94,.436,30,65,.462,11,29,.379,15,20,.750,108,2017-03-09,POR,PHI
70,Home,W 113-93 ,240,45,80,.563,45,75,.600,0,5,.000,23,33,.697,113,34,79,.430,23,50,.460,11,29,.379,14,18,.778,93,2011-12-30,MEM,HOU
71,Home,W 113-96 ,240,50,91,.549,48,83,.578,2,8,.250,11,16,.688,113,34,83,.410,25,59,.424,9,24,.375,19,23,.826,96,2012-01-03,MEM,SAC
72,Home,W 113-105 ,240,45,76,.592,42,66,.636,3,10,.300,20,29,.690,113,35,78,.449,31,58,.534,4,20,.200,31,43,.721,105,2012-01-10,UTA,CLE
73,Home,W 113-92 ,240,44,81,.543,37,65,.569,7,16,.438,18,21,.857,113,37,83,.446,29,68,.426,8,15,.533,10,15,.667,92,2012-01-21,MIA,PHI
74,Home,W 113-86 ,240,42,70,.600,33,52,.635,9,18,.500,20,25,.800,113,32,71,.451,29,62,.468,3,9,.333,19,25,.760,86,2012-01-31,NYK,DET
75,@,W 113-90 ,240,48,90,.533,34,60,.567,14,30,.467,3,4,.750,113,37,93,.398,36,81,.444,1,12,.083,15,19,.789,90,2012-02-04,CHI,MIL
76,@,W 113-112 (OT),265,40,98,.408,32,74,.432,8,24,.333,25,31,.806,113,43,88,.489,35,71,.493,8,17,.471,18,32,.563,112,2012-02-10,MIL,CLE
77,@,W 113-109 ,240,43,87,.494,38,70,.543,5,17,.294,22,33,.667,113,42,79,.532,34,57,.596,8,22,.364,17,22,.773,109,2012-02-11,DEN,IND
78,@,W 113-106 ,240,41,76,.539,33,57,.579,8,19,.421,23,25,.920,113,47,86,.547,44,75,.587,3,11,.273,9,14,.643,106,2012-02-15,SAS,TOR
79,@,W 113-111 ,240,41,84,.488,36,67,.537,5,17,.294,26,37,.703,113,42,81,.519,35,70,.500,7,11,.636,20,22,.909,111,2012-03-23,PHO,IND
80,Home,W 113-106 (OT),265,43,89,.483,39,69,.565,4,20,.200,23,27,.852,113,41,96,.427,36,78,.462,5,18,.278,19,26,.731,106,2012-03-26,HOU,SAC
81,@,W 113-101 ,240,44,77,.571,39,63,.619,5,14,.357,20,24,.833,113,39,72,.542,34,58,.586,5,14,.357,18,19,.947,101,2012-03-30,MIA,TOR
82,@,W 113-108 ,240,43,83,.518,37,67,.552,6,16,.375,21,30,.700,113,43,95,.453,34,70,.486,9,25,.360,13,20,.650,108,2012-04-04,LAL,LAC
83,@,W 113-85 ,240,40,83,.482,29,58,.500,11,25,.440,22,26,.846,113,32,82,.390,29,73,.397,3,9,.333,18,22,.818,85,2012-04-09,WAS,CHA
84,Home,W 113-107 ,240,41,82,.500,32,60,.533,9,22,.409,22,31,.710,113,42,84,.500,34,60,.567,8,24,.333,15,18,.833,107,2012-04-11,DEN,MIN
85,@,W 113-97 ,240,45,87,.517,40,72,.556,5,15,.333,18,22,.818,113,37,78,.474,34,68,.500,3,10,.300,20,24,.833,97,2012-04-13,MIL,DET
86,Home,W 113-100 ,240,48,90,.533,37,72,.514,11,18,.611,6,6,1.000,113,40,80,.500,31,62,.500,9,18,.500,11,15,.733,100,2012-04-16,ORL,PHI
87,@,W 113-112 ,240,43,79,.544,31,60,.517,12,19,.632,15,20,.750,113,41,76,.539,26,53,.491,15,23,.652,15,23,.652,112,2012-04-22,NYK,ATL
88,Home,W 113-96 ,240,47,92,.511,41,77,.532,6,15,.400,13,18,.722,113,41,91,.451,34,76,.447,7,15,.467,7,9,.778,96,2012-04-26,SAC,LAL
89,Home,W 113-94 ,240,38,89,.427,32,75,.427,6,14,.429,31,42,.738,113,32,85,.376,21,63,.333,11,22,.500,19,26,.731,94,2012-10-31,UTA,DAL
90,@,W 113-110 ,240,45,89,.506,35,68,.515,10,21,.476,13,20,.650,113,36,80,.450,24,46,.522,12,34,.353,26,33,.788,110,2012-11-12,MIA,HOU
91,@,L 113-117 ,240,41,77,.532,31,56,.554,10,21,.476,21,22,.955,113,43,93,.462,30,68,.441,13,25,.520,18,24,.750,117,2012-11-17,NOH,MIL
92,Home,W 113-106 (OT),265,41,86,.477,33,68,.485,8,18,.444,23,33,.697,113,46,109,.422,41,80,.513,5,29,.172,9,12,.750,106,2012-11-21,MIA,MIL
93,Home,W 113-97 ,240,44,81,.543,37,66,.561,7,15,.467,18,22,.818,113,29,65,.446,17,39,.436,12,26,.462,27,39,.692,97,2012-11-21,SAC,LAL
94,@,W 113-111 ,240,41,85,.482,31,62,.500,10,23,.435,21,22,.955,113,38,78,.487,26,58,.448,12,20,.600,23,32,.719,111,2012-11-30,CLE,ATL
95,@,W 113-103 ,240,43,86,.500,35,63,.556,8,23,.348,19,20,.950,113,36,86,.419,30,69,.435,6,17,.353,25,39,.641,103,2012-12-02,ORL,LAL
96,Home,W 113-110 ,240,40,85,.471,34,70,.486,6,15,.400,27,43,.628,113,42,86,.488,33,58,.569,9,28,.321,17,19,.895,110,2012-12-03,DEN,TOR
97,Home,W 113-90 ,240,43,75,.573,29,46,.630,14,29,.483,13,23,.565,113,34,79,.430,28,58,.483,6,21,.286,16,20,.800,90,2012-12-13,ATL,CHA
98,@,W 113-102 ,240,47,88,.534,40,71,.563,7,17,.412,12,17,.706,113,42,78,.538,31,54,.574,11,24,.458,7,10,.700,102,2012-12-14,MIN,NOH
99,Home,W 113-103 ,240,41,83,.494,32,62,.516,9,21,.429,22,22,1.000,113,34,75,.453,27,56,.482,7,19,.368,28,31,.903,103,2012-12-14,OKC,SAC
0,@,W 113-99 ,240,39,75,.520,27,51,.529,12,24,.500,23,27,.852,113,36,70,.514,29,54,.537,7,16,.438,20,30,.667,99,2012-12-18,TOR,CLE
1,Home,L 113-115 (2OT),290,43,91,.473,34,73,.466,9,18,.500,18,31,.581,113,41,89,.461,33,65,.508,8,24,.333,25,36,.694,115,2013-01-04,WAS,BRK
2,Home,W 113-93 ,240,44,85,.518,37,61,.607,7,24,.292,18,21,.857,113,36,90,.400,30,71,.423,6,19,.316,15,23,.652,93,2013-01-05,BRK,SAC
3,@,W 113-81 ,240,39,80,.488,28,60,.467,11,20,.550,24,27,.889,113,28,76,.368,23,55,.418,5,21,.238,20,23,.870,81,2013-01-07,MEM,SAC
4,Home,W 113-93 ,240,40,69,.580,27,44,.614,13,25,.520,20,27,.741,113,39,95,.411,35,74,.473,4,21,.190,11,12,.917,93,2013-01-13,LAL,CLE
5,Home,W 113-98 ,240,46,77,.597,40,64,.625,6,13,.462,15,16,.938,113,35,85,.412,29,65,.446,6,20,.300,22,29,.759,98,2013-01-14,DAL,MIN
6,Home,W 113-106 ,240,40,81,.494,32,60,.533,8,21,.381,25,28,.893,113,40,82,.488,33,69,.478,7,13,.538,19,23,.826,106,2013-01-15,BRK,TOR
7,Home,W 113-108 ,240,45,86,.523,39,71,.549,6,15,.400,17,22,.773,113,43,92,.467,29,64,.453,14,28,.500,8,13,.615,108,2013-01-25,CLE,MIL
8,@,W 113-107 ,240,43,89,.483,34,66,.515,9,23,.391,18,24,.750,113,42,91,.462,36,73,.493,6,18,.333,17,18,.944,107,2013-01-25,SAS,DAL
9,Home,W 113-97 ,240,47,82,.573,33,48,.688,14,34,.412,5,8,.625,113,38,77,.494,31,51,.608,7,26,.269,14,16,.875,97,2013-01-30,NYK,ORL
10,Home,W 113-98 ,240,44,84,.524,37,62,.597,7,22,.318,18,22,.818,113,38,72,.528,34,59,.576,4,13,.308,18,21,.857,98,2013-02-01,DEN,NOH
11,Home,W 113-93 ,240,45,89,.506,36,70,.514,9,19,.474,14,20,.700,113,35,86,.407,30,71,.423,5,15,.333,18,24,.750,93,2013-02-02,GSW,PHO
12,Home,W 113-111 (OT),265,43,91,.473,33,72,.458,10,19,.526,17,23,.739,113,46,96,.479,39,76,.513,7,20,.350,12,18,.667,111,2013-02-19,BRK,MIL
13,Home,W 113-99 ,240,42,83,.506,35,61,.574,7,22,.318,22,31,.710,113,39,82,.476,30,62,.484,9,20,.450,12,20,.600,99,2013-02-20,LAL,BOS
14,@,W 113-88 ,240,44,79,.557,34,57,.596,10,22,.455,15,23,.652,113,35,84,.417,31,65,.477,4,19,.211,14,23,.609,88,2013-02-22,BOS,PHO
15,@,L 113-119 ,240,39,81,.481,35,59,.593,4,22,.182,31,37,.838,113,42,88,.477,31,64,.484,11,24,.458,24,33,.727,119,2013-02-22,DEN,WAS
16,@,W 113-99 ,240,44,83,.530,37,64,.578,7,19,.368,18,22,.818,113,37,82,.451,35,71,.493,2,11,.182,23,30,.767,99,2013-02-23,DEN,CHA
17,Home,L 113-120 ,240,39,85,.459,27,54,.500,12,31,.387,23,28,.821,113,46,85,.541,38,69,.551,8,16,.500,20,32,.625,120,2013-03-05,SAC,DEN
18,Home,W 113-84 ,240,38,75,.507,25,43,.581,13,32,.406,24,30,.800,113,30,78,.385,22,52,.423,8,26,.308,16,21,.762,84,2013-03-09,NYK,UTA
19,Home,L 113-115 ,240,44,94,.468,38,72,.528,6,22,.273,19,25,.760,113,40,87,.460,33,68,.485,7,19,.368,28,38,.737,115,2013-03-10,SAC,MIL
20,@,W 113-95 ,240,43,83,.518,35,67,.522,8,16,.500,19,22,.864,113,34,76,.447,31,62,.500,3,14,.214,24,30,.800,95,2013-03-15,CHI,GSW
21,@,L 113-119 ,240,43,85,.506,36,70,.514,7,15,.467,20,31,.645,113,45,78,.577,39,61,.639,6,17,.353,23,29,.793,119,2013-03-16,CLE,SAS
22,Home,W 113-102 ,240,41,72,.569,29,44,.659,12,28,.429,19,29,.655,113,42,96,.438,32,65,.492,10,31,.323,8,8,1.000,102,2013-03-17,LAL,SAC
23,Home,L 113-127 ,240,42,75,.560,34,54,.630,8,21,.381,21,29,.724,113,51,89,.573,38,67,.567,13,22,.591,12,14,.857,127,2013-03-18,ATL,DAL
24,@,W 113-96 ,240,45,89,.506,38,68,.559,7,21,.333,16,21,.762,113,40,80,.500,33,61,.541,7,19,.368,9,15,.600,96,2013-03-20,BRK,DAL
25,Home,W 113-108 ,240,38,70,.543,29,52,.558,9,18,.500,28,33,.848,113,42,82,.512,35,65,.538,7,17,.412,17,21,.810,108,2013-03-24,DAL,UTA
26,Home,W 113-103 ,240,45,93,.484,38,74,.514,7,19,.368,16,22,.727,113,34,77,.442,29,57,.509,5,20,.250,30,39,.769,103,2013-03-28,MIL,LAL
27,@,W 113-95 ,240,43,76,.566,33,55,.600,10,21,.476,17,22,.773,113,34,89,.382,30,75,.400,4,14,.286,23,26,.885,95,2013-04-03,BRK,CLE
28,@,W 113-96 ,240,41,73,.562,34,55,.618,7,18,.389,24,32,.750,113,39,84,.464,33,64,.516,6,20,.300,12,18,.667,96,2013-04-03,DEN,UTA
29,Home,W 113-103 (OT),265,51,109,.468,43,94,.457,8,15,.533,3,8,.375,113,39,101,.386,31,73,.425,8,28,.286,17,26,.654,103,2013-04-10,ORL,MIL
30,@,W 113-106 ,240,43,73,.589,37,54,.685,6,19,.316,21,24,.875,113,38,85,.447,26,59,.441,12,26,.462,18,20,.900,106,2013-04-10,LAL,POR
31,Home,W 113-93 ,240,43,83,.518,31,65,.477,12,18,.667,15,20,.750,113,35,78,.449,26,54,.481,9,24,.375,14,17,.824,93,2013-04-12,DET,CHA
32,@,W 113-96 ,240,40,78,.513,30,51,.588,10,27,.370,23,27,.852,113,35,88,.398,26,60,.433,9,28,.321,17,23,.739,96,2013-04-16,TOR,ATL
33,Home,W 113-102 ,240,39,78,.500,30,54,.556,9,24,.375,26,33,.788,113,34,78,.436,24,53,.453,10,25,.400,24,32,.750,102,2013-10-30,DET,WAS
34,@,W 113-98 ,240,44,103,.427,30,81,.370,14,22,.636,11,15,.733,113,36,99,.364,30,81,.370,6,18,.333,20,34,.588,98,2013-11-01,POR,DEN
35,Home,W 113-105 ,240,34,73,.466,23,44,.523,11,29,.379,34,51,.667,113,38,100,.380,29,73,.397,9,27,.333,20,25,.800,105,2013-11-01,HOU,DAL
36,@,W 113-90 ,240,44,90,.489,34,70,.486,10,20,.500,15,19,.789,113,35,92,.380,25,66,.379,10,26,.385,10,18,.556,90,2013-11-10,MIN,LAL
37,Home,W 113-95 ,240,42,70,.600,34,54,.630,8,16,.500,21,26,.808,113,37,87,.425,34,69,.493,3,18,.167,18,27,.667,95,2013-11-12,GSW,DET
38,Home,W 113-103 ,240,39,81,.481,29,58,.500,10,23,.435,25,31,.806,113,40,86,.465,35,67,.522,5,19,.263,18,23,.783,103,2013-11-15,ATL,PHI
39,@,L 113-117 ,240,46,94,.489,40,72,.556,6,22,.273,15,19,.789,113,47,97,.485,40,77,.519,7,20,.350,16,21,.762,117,2013-11-15,MIN,DEN
40,@,L 113-115 ,240,40,83,.482,32,60,.533,8,23,.348,25,43,.581,113,38,93,.409,25,66,.379,13,27,.481,26,32,.813,115,2013-11-18,DEN,OKC
41,@,W 113-106 ,240,37,80,.463,30,63,.476,7,17,.412,32,38,.842,113,38,85,.447,23,52,.442,15,33,.455,15,22,.682,106,2013-11-20,SAC,PHO
42,@,W 113-101 ,240,37,86,.430,27,65,.415,10,21,.476,29,35,.829,113,36,77,.468,29,60,.483,7,17,.412,22,30,.733,101,2013-11-23,POR,GSW
43,Home,W 113-94 ,240,43,80,.538,31,51,.608,12,29,.414,15,23,.652,113,33,73,.452,27,54,.500,6,19,.316,22,26,.846,94,2013-11-25,DET,MIL
44,Home,W 113-84 ,240,43,78,.551,29,51,.569,14,27,.519,13,21,.619,113,32,75,.427,24,53,.453,8,22,.364,12,15,.800,84,2013-11-27,HOU,ATL
45,Home,W 113-112 (OT),265,36,92,.391,30,74,.405,6,18,.333,35,42,.833,113,42,95,.442,34,69,.493,8,26,.308,20,29,.690,112,2013-11-29,OKC,GSW
46,Home,W 113-103 ,240,49,87,.563,40,68,.588,9,19,.474,6,9,.667,113,37,89,.416,28,60,.467,9,29,.310,20,26,.769,103,2013-12-01,OKC,MIN
47,Home,L 113-115 ,240,40,76,.526,31,57,.544,9,19,.474,24,28,.857,113,42,82,.512,27,57,.474,15,25,.600,16,22,.727,115,2013-12-01,SAC,GSW
48,@,W 113-83 ,240,44,77,.571,28,50,.560,16,27,.593,9,11,.818,113,29,73,.397,25,57,.439,4,16,.250,21,31,.677,83,2013-12-05,NYK,BRK
49,@,W 113-97 ,240,39,69,.565,30,48,.625,9,21,.429,26,31,.839,113,40,81,.494,37,67,.552,3,14,.214,14,20,.700,97,2013-12-14,LAC,WAS
50,@,W 113-107 ,240,38,88,.432,26,68,.382,12,20,.600,25,30,.833,113,39,74,.527,30,53,.566,9,21,.429,20,24,.833,107,2013-12-18,WAS,BRK
51,@,W 113-100 ,240,43,88,.489,31,61,.508,12,27,.444,15,18,.833,113,35,82,.427,26,63,.413,9,19,.474,21,26,.808,100,2013-12-21,OKC,SAS
52,@,W 113-100 ,240,41,83,.494,33,66,.500,8,17,.471,23,27,.852,113,31,74,.419,24,57,.421,7,17,.412,31,42,.738,100,2013-12-23,NOP,SAC
53,Home,W 113-92 ,240,40,78,.513,31,58,.534,9,20,.450,24,28,.857,113,37,84,.440,32,69,.464,5,15,.333,13,15,.867,92,2013-12-31,SAS,BRK
54,@,W 113-104 ,240,42,90,.467,37,71,.521,5,19,.263,24,31,.774,113,35,83,.422,28,60,.467,7,23,.304,27,37,.730,104,2014-01-02,PHI,SAC
55,@,W 113-103 ,240,45,83,.542,36,68,.529,9,15,.600,14,23,.609,113,42,92,.457,36,75,.480,6,17,.353,13,19,.684,103,2014-01-04,CHA,SAC
56,Home,W 113-99 ,240,39,86,.453,32,58,.552,7,28,.250,28,50,.560,113,36,88,.409,29,64,.453,7,24,.292,20,25,.800,99,2014-01-08,HOU,LAL
57,@,W 113-102 ,240,45,83,.542,38,69,.551,7,14,.500,16,20,.800,113,39,81,.481,30,61,.492,9,20,.450,15,27,.556,102,2014-01-10,CLE,UTA
58,@,L 113-126 ,240,44,97,.454,36,72,.500,8,25,.320,17,22,.773,113,45,86,.523,29,53,.547,16,33,.485,20,24,.833,126,2014-01-20,POR,HOU
59,@,W 113-111 (OT),265,41,89,.461,26,55,.473,15,34,.441,16,23,.696,113,42,94,.447,35,72,.486,7,22,.318,20,27,.741,111,2014-01-22,BOS,WAS
60,Home,W 113-101 ,240,43,74,.581,35,55,.636,8,19,.421,19,20,.950,113,38,76,.500,32,54,.593,6,22,.273,19,23,.826,101,2014-01-26,MIA,SAS
61,Home,L 113-124 ,240,40,87,.460,32,67,.478,8,20,.400,25,26,.962,113,43,80,.538,34,60,.567,9,20,.450,29,35,.829,124,2014-01-27,PHI,PHO
62,Home,W 113-102 ,240,43,83,.518,36,67,.537,7,16,.438,20,25,.800,113,39,87,.448,29,66,.439,10,21,.476,14,24,.583,102,2014-01-31,ORL,MIL
63,@,L 113-120 ,240,37,84,.440,31,68,.456,6,16,.375,33,39,.846,113,43,92,.467,34,69,.493,9,23,.391,25,30,.833,120,2014-02-01,MIN,ATL
64,Home,W 113-96 ,240,41,92,.446,34,67,.507,7,25,.280,24,40,.600,113,38,89,.427,33,68,.485,5,21,.238,15,23,.652,96,2014-02-01,DET,PHI
65,@,L 113-118 (OT),265,45,104,.433,38,84,.452,7,20,.350,16,20,.800,113,42,92,.457,37,79,.468,5,13,.385,29,35,.829,118,2014-02-07,POR,IND
66,Home,L 113-115 ,240,43,85,.506,32,65,.492,11,20,.550,16,23,.696,113,40,77,.519,34,62,.548,6,15,.400,29,33,.879,115,2014-02-07,WAS,CLE
67,Home,W 113-112 ,240,34,64,.531,24,42,.571,10,22,.455,35,47,.745,113,44,97,.454,28,65,.431,16,32,.500,8,16,.500,112,2014-02-12,HOU,WAS
68,@,W 113-103 ,240,44,88,.500,35,68,.515,9,20,.450,16,21,.762,113,35,81,.432,29,60,.483,6,21,.286,27,38,.711,103,2014-02-18,SAS,LAC
69,@,W 113-102 ,240,44,90,.489,36,67,.537,8,23,.348,17,22,.773,113,40,82,.488,38,71,.535,2,11,.182,20,30,.667,102,2014-02-22,DAL,DET
70,Home,W 113-107 ,240,38,77,.494,28,55,.509,10,22,.455,27,32,.844,113,41,80,.513,31,64,.484,10,16,.625,15,20,.750,107,2014-02-28,OKC,MEM
71,Home,W 113-107 ,240,45,85,.529,35,63,.556,10,22,.455,13,21,.619,113,36,75,.480,26,54,.481,10,21,.476,25,28,.893,107,2014-03-09,GSW,PHO
72,@,L 113-118 (OT),265,39,96,.406,30,71,.423,9,25,.360,26,33,.788,113,38,89,.427,29,60,.483,9,29,.310,33,45,.733,118,2014-03-09,POR,HOU
73,Home,W 113-104 ,240,40,78,.513,31,56,.554,9,22,.409,24,29,.828,113,37,75,.493,28,52,.538,9,23,.391,21,28,.750,104,2014-03-16,MIA,HOU
74,@,W 113-112 ,240,42,88,.477,31,58,.534,11,30,.367,18,22,.818,113,37,88,.420,25,60,.417,12,28,.429,26,30,.867,112,2014-03-16,GSW,POR
75,Home,L 113-121 ,240,42,85,.494,35,62,.565,7,23,.304,22,25,.880,113,38,75,.507,27,52,.519,11,23,.478,34,38,.895,121,2014-03-16,TOR,PHO
76,@,L 113-118 (OT),265,40,81,.494,33,57,.579,7,24,.292,26,29,.897,113,40,94,.426,29,60,.483,11,34,.324,27,31,.871,118,2014-03-18,TOR,ATL
77,Home,W 113-91 ,240,44,79,.557,31,52,.596,13,27,.481,12,16,.750,113,36,88,.409,25,55,.455,11,33,.333,8,18,.444,91,2014-03-24,SAS,PHI
78,@,W 113-107 ,240,41,82,.500,27,53,.509,14,29,.483,17,20,.850,113,39,91,.429,33,64,.516,6,27,.222,23,29,.793,107,2014-04-03,DAL,LAC
79,Home,W 113-108 ,240,43,79,.544,40,67,.597,3,12,.250,24,38,.632,113,40,86,.465,31,62,.500,9,24,.375,19,26,.731,108,2014-04-14,PHI,BOS
80,@,W 113-100 ,240,45,91,.495,34,64,.531,11,27,.407,12,17,.706,113,41,99,.414,31,69,.449,10,30,.333,8,10,.800,100,2014-04-16,LAL,SAS
81,@,L 113-118 ,240,45,102,.441,34,71,.479,11,31,.355,12,16,.750,113,44,82,.537,30,57,.526,14,25,.560,16,20,.800,118,2014-11-03,BOS,DAL
82,@,W 113-100 ,240,46,93,.495,36,68,.529,10,25,.400,11,15,.733,113,38,70,.543,31,50,.620,7,20,.350,17,20,.850,100,2014-11-11,SAS,GSW
83,Home,L 113-130 ,240,39,90,.433,31,67,.463,8,23,.348,27,33,.818,113,45,88,.511,29,55,.527,16,33,.485,24,29,.828,130,2014-11-12,DEN,POR
84,@,W 113-101 ,240,43,89,.483,30,61,.492,13,28,.464,14,19,.737,113,36,81,.444,30,69,.435,6,12,.500,23,30,.767,101,2014-11-12,HOU,MIN
85,@,L 113-117 ,240,44,80,.550,33,55,.600,11,25,.440,14,19,.737,113,43,78,.551,34,61,.557,9,17,.529,22,27,.815,117,2014-11-18,NYK,MIL
86,@,W 113-101 ,240,40,81,.494,32,55,.582,8,26,.308,25,30,.833,113,37,90,.411,31,73,.425,6,17,.353,21,27,.778,101,2014-11-22,SAC,MIN
87,@,W 113-92 ,240,45,88,.511,30,56,.536,15,32,.469,8,10,.800,113,31,75,.413,29,55,.527,2,20,.100,28,35,.800,92,2014-11-24,LAC,CHO
88,Home,W 113-87 ,240,38,74,.514,32,54,.593,6,20,.300,31,38,.816,113,33,71,.465,28,58,.483,5,13,.385,16,22,.727,87,2014-11-26,CLE,WAS
89,Home,W 113-96 ,240,46,90,.511,38,70,.543,8,20,.400,13,22,.591,113,38,92,.413,32,76,.421,6,16,.375,14,19,.737,96,2014-12-05,BOS,LAL
90,@,W 113-109 (OT),265,38,95,.400,23,51,.451,15,44,.341,22,31,.710,113,39,84,.464,31,66,.470,8,18,.444,23,34,.676,109,2014-12-11,HOU,SAC
91,Home,W 113-107 (2OT),290,39,85,.459,33,72,.458,6,13,.462,29,38,.763,113,41,98,.418,35,81,.432,6,17,.353,19,27,.704,107,2014-12-12,MEM,CHO
92,Home,W 113-91 ,240,43,80,.538,31,56,.554,12,24,.500,15,20,.750,113,35,83,.422,27,56,.482,8,27,.296,13,22,.591,91,2014-12-15,LAC,DET
93,Home,W 113-93 ,240,42,86,.488,32,62,.516,10,24,.417,19,25,.760,113,36,92,.391,31,76,.408,5,16,.313,16,21,.762,93,2014-12-25,CHI,LAL
94,@,W 113-111 ,240,46,96,.479,41,70,.586,5,26,.192,16,19,.842,113,44,92,.478,37,75,.493,7,17,.412,16,19,.842,111,2015-01-07,PHO,MIN
95,@,W 113-99 ,240,41,86,.477,25,46,.543,16,40,.400,15,20,.750,113,39,84,.464,34,63,.540,5,21,.238,16,18,.889,99,2015-01-12,HOU,BRK
96,@,L 113-120 ,240,42,83,.506,33,57,.579,9,26,.346,20,23,.870,113,44,90,.489,35,64,.547,9,26,.346,23,26,.885,120,2015-01-14,HOU,ORL
97,@,W 113-105 ,240,43,80,.538,35,61,.574,8,19,.421,19,21,.905,113,38,92,.413,28,61,.459,10,31,.323,19,22,.864,105,2015-01-17,MIN,DEN
98,@,L 113-126 ,240,37,87,.425,24,55,.436,13,32,.406,26,31,.839,113,49,98,.500,36,69,.522,13,29,.448,15,18,.833,126,2015-01-21,HOU,GSW
99,@,L 113-118 ,240,39,87,.448,26,55,.473,13,32,.406,22,28,.786,113,47,92,.511,38,65,.585,9,27,.333,15,24,.625,118,2015-01-21,POR,PHO
0,Home,W 113-106 ,240,43,91,.473,33,66,.500,10,25,.400,17,21,.810,113,44,87,.506,37,60,.617,7,27,.259,11,19,.579,106,2015-01-23,NYK,ORL
1,@,W 113-111 ,240,44,84,.524,34,57,.596,10,27,.370,15,20,.750,113,42,91,.462,32,61,.525,10,30,.333,17,24,.708,111,2015-01-23,HOU,PHO
2,@,W 113-111 (OT),265,42,98,.429,34,69,.493,8,29,.276,21,23,.913,113,48,113,.425,39,80,.488,9,33,.273,6,12,.500,111,2015-01-27,CHI,GSW
3,Home,W 113-102 ,240,38,82,.463,26,49,.531,12,33,.364,25,26,.962,113,39,87,.448,30,63,.476,9,24,.375,15,18,.833,102,2015-01-28,ATL,BRK
4,Home,W 113-105 (OT),265,41,82,.500,30,56,.536,11,26,.423,20,22,.909,113,39,93,.419,30,65,.462,9,28,.321,18,25,.720,105,2015-02-04,MIL,LAL
5,Home,L 113-116 ,240,40,89,.449,32,65,.492,8,24,.333,25,28,.893,113,40,83,.482,29,63,.460,11,20,.550,25,30,.833,116,2015-02-06,OKC,NOP
6,Home,W 113-93 ,240,44,78,.564,34,53,.642,10,25,.400,15,19,.789,113,34,84,.405,25,60,.417,9,24,.375,16,20,.800,93,2015-02-11,CLE,MIA
7,Home,W 113-98 ,240,42,92,.457,33,69,.478,9,23,.391,20,26,.769,113,37,85,.435,29,54,.537,8,31,.258,16,22,.727,98,2015-02-12,CHI,CLE
8,Home,W 113-102 ,240,39,94,.415,27,56,.482,12,38,.316,23,34,.676,113,31,93,.333,26,75,.347,5,18,.278,35,39,.897,102,2015-02-23,HOU,MIN
9,@,L 113-117 (OT),265,39,101,.386,31,77,.403,8,24,.333,27,30,.900,113,48,97,.495,39,71,.549,9,26,.346,12,21,.571,117,2015-02-26,OKC,PHO
10,@,W 113-89 ,240,42,87,.483,29,59,.492,13,28,.464,16,19,.842,113,31,77,.403,27,55,.491,4,22,.182,23,28,.821,89,2015-02-27,GSW,TOR
11,@,L 113-121 ,240,43,88,.489,29,61,.475,14,27,.519,13,17,.765,113,46,85,.541,42,78,.538,4,7,.571,25,31,.806,121,2015-03-07,POR,MIN
12,@,W 113-106 ,240,40,85,.471,32,65,.492,8,20,.400,25,30,.833,113,42,93,.452,36,75,.480,6,18,.333,16,26,.615,106,2015-03-11,SAC,CHO
13,Home,W 113-99 ,240,44,101,.436,33,77,.429,11,24,.458,14,14,1.000,113,34,78,.436,31,66,.470,3,12,.250,28,31,.903,99,2015-03-13,OKC,MIN
14,Home,W 113-97 ,240,43,81,.531,30,55,.545,13,26,.500,14,17,.824,113,35,77,.455,29,58,.500,6,19,.316,21,28,.750,97,2015-03-14,WAS,SAC
15,@,W 113-97 ,240,45,86,.523,32,57,.561,13,29,.448,10,16,.625,113,37,78,.474,32,60,.533,5,18,.278,18,23,.783,97,2015-03-15,POR,TOR
16,Home,W 113-99 ,240,45,86,.523,33,63,.524,12,23,.522,11,17,.647,113,37,86,.430,31,67,.463,6,19,.316,19,23,.826,99,2015-03-20,LAC,WAS
17,@,W 113-111 (OT),265,40,82,.488,30,61,.492,10,21,.476,23,30,.767,113,39,96,.406,29,66,.439,10,30,.333,23,38,.605,111,2015-03-30,LAL,PHI
18,@,W 113-92 ,240,44,78,.564,35,62,.565,9,16,.563,16,21,.762,113,37,83,.446,32,67,.478,5,16,.313,13,21,.619,92,2015-04-01,NOP,LAL
19,@,W 113-99 ,240,42,76,.553,29,46,.630,13,30,.433,16,23,.696,113,41,77,.532,36,63,.571,5,14,.357,12,19,.632,99,2015-04-01,TOR,MIN
20,@,W 113-88 ,240,47,89,.528,37,65,.569,10,24,.417,9,13,.692,113,34,84,.405,29,65,.446,5,19,.263,15,28,.536,88,2015-04-07,SAS,OKC
21,@,W 113-103 ,240,36,80,.450,28,52,.538,8,28,.286,33,34,.971,113,45,84,.536,38,66,.576,7,18,.389,6,10,.600,103,2015-04-08,BOS,DET
22,@,W 113-86 ,240,44,88,.500,32,58,.552,12,30,.400,13,17,.765,113,32,87,.368,29,75,.387,3,12,.250,19,22,.864,86,2015-04-13,CHI,BRK
23,Home,W 113-108 (OT),265,43,91,.473,27,61,.443,16,30,.533,11,17,.647,113,42,97,.433,34,75,.453,8,22,.364,16,21,.762,108,2015-04-15,CLE,WAS
24,Home,L 113-138 ,240,39,84,.464,33,65,.508,6,19,.316,29,35,.829,113,52,95,.547,40,67,.597,12,28,.429,22,31,.710,138,2015-04-15,MIN,OKC
25,@,W 113-103 ,240,36,82,.439,25,56,.446,11,26,.423,30,35,.857,113,32,85,.376,25,59,.424,7,26,.269,32,41,.780,103,2015-10-30,TOR,BOS
26,Home,L 113-118 ,240,42,82,.512,35,58,.603,7,24,.292,22,28,.786,113,35,68,.515,23,47,.489,12,21,.571,36,44,.818,118,2015-10-30,MIL,WAS
27,@,W 113-101 ,240,46,82,.561,39,67,.582,7,15,.467,14,18,.778,113,39,88,.443,30,66,.455,9,22,.409,14,23,.609,101,2015-11-11,SAS,POR
28,Home,W 113-88 ,240,40,81,.494,28,56,.500,12,25,.480,21,22,.955,113,32,79,.405,24,53,.453,8,26,.308,16,22,.727,88,2015-11-20,CHO,PHI
29,@,W 113-104 ,240,43,90,.478,41,80,.513,2,10,.200,25,26,.962,113,35,81,.432,26,54,.481,9,27,.333,25,33,.758,104,2015-12-01,MEM,NOP
30,@,L 113-120 ,240,46,98,.469,36,72,.500,10,26,.385,11,13,.846,113,36,78,.462,20,44,.455,16,34,.471,32,43,.744,120,2015-12-05,SAC,HOU
31,Home,W 113-95 ,240,41,89,.461,31,62,.500,10,27,.370,21,25,.840,113,40,85,.471,36,72,.500,4,13,.308,11,20,.550,95,2015-12-15,LAL,MIL
32,Home,W 113-98 ,240,43,77,.558,29,53,.547,14,24,.583,13,15,.867,113,36,79,.456,22,45,.489,14,34,.412,12,15,.800,98,2015-12-16,ORL,CHO
33,Home,W 113-99 ,240,46,89,.517,34,64,.531,12,25,.480,9,16,.563,113,36,79,.456,34,66,.515,2,13,.154,25,32,.781,99,2015-12-21,BOS,MIN
34,Home,W 113-99 ,240,42,83,.506,28,59,.475,14,24,.583,15,17,.882,113,37,91,.407,30,69,.435,7,22,.318,18,22,.818,99,2015-12-21,WAS,SAC
35,Home,W 113-100 ,240,51,85,.600,46,73,.630,5,12,.417,6,8,.750,113,37,81,.457,30,61,.492,7,20,.350,19,29,.655,100,2015-12-23,MIL,PHI
36,Home,L 113-115 ,240,42,92,.457,29,61,.475,13,31,.419,16,19,.842,113,42,82,.512,33,61,.541,9,21,.429,22,25,.880,115,2016-01-03,TOR,CHI
37,Home,L 113-117 ,240,40,84,.476,31,58,.534,9,26,.346,24,25,.960,113,45,89,.506,40,72,.556,5,17,.294,22,26,.846,117,2016-01-08,LAL,OKC
38,Home,W 113-93 ,240,47,89,.528,42,66,.636,5,23,.217,14,22,.636,113,34,85,.400,29,73,.397,5,12,.417,20,23,.870,93,2016-01-15,OKC,MIN
39,Home,W 113-95 ,240,47,101,.465,39,78,.500,8,23,.348,11,20,.550,113,34,94,.362,24,69,.348,10,25,.400,17,23,.739,95,2016-01-16,DET,GSW
40,@,L 113-118 (OT),265,40,94,.426,28,64,.438,12,30,.400,21,26,.808,113,40,93,.430,24,59,.407,16,34,.471,22,24,.917,118,2016-01-18,BOS,DAL
41,@,L 113-119 (2OT),290,45,102,.441,35,74,.473,10,28,.357,13,25,.520,113,43,97,.443,35,77,.455,8,20,.400,25,30,.833,119,2016-01-18,PHI,NYK
42,Home,W 113-103 ,240,39,81,.481,28,53,.528,11,28,.393,24,36,.667,113,39,83,.470,33,64,.516,6,19,.316,19,28,.679,103,2016-01-26,PHI,PHO
43,Home,L 113-117 ,240,39,88,.443,28,60,.467,11,28,.393,24,30,.800,113,41,81,.506,32,63,.508,9,18,.500,26,33,.788,117,2016-01-28,WAS,DEN
44,Home,W 113-94 ,240,43,86,.500,33,62,.532,10,24,.417,17,21,.810,113,32,79,.405,25,59,.424,7,20,.350,23,29,.793,94,2016-01-29,BOS,ORL
45,@,W 113-90 ,240,43,90,.478,30,57,.526,13,33,.394,14,15,.933,113,38,86,.442,33,72,.458,5,14,.357,9,12,.750,90,2016-02-10,ATL,CHI
46,Home,L 113-119 ,240,40,81,.494,30,59,.508,10,22,.455,23,26,.885,113,48,88,.545,42,76,.553,6,12,.500,17,18,.944,119,2016-02-19,LAL,SAS
47,Home,W 113-99 ,240,39,79,.494,28,48,.583,11,31,.355,24,34,.706,113,32,80,.400,23,51,.451,9,29,.310,26,30,.867,99,2016-02-28,WAS,CLE
48,@,W 113-107 ,240,38,78,.487,25,49,.510,13,29,.448,24,37,.649,113,37,77,.481,25,44,.568,12,33,.364,21,27,.778,107,2016-03-06,HOU,TOR
49,@,L 113-119 ,240,40,90,.444,35,69,.507,5,21,.238,28,34,.824,113,42,84,.500,26,49,.531,16,35,.457,19,27,.704,119,2016-03-07,ORL,GSW
50,@,L 113-122 ,240,40,85,.471,30,52,.577,10,33,.303,23,28,.821,113,38,82,.463,23,47,.489,15,35,.429,31,38,.816,122,2016-03-09,NOP,CHO
51,Home,W 113-102 ,240,40,82,.488,36,67,.537,4,15,.267,29,36,.806,113,31,66,.470,19,36,.528,12,30,.400,28,39,.718,102,2016-03-19,MEM,LAC
52,@,W 113-99 ,240,44,88,.500,41,69,.594,3,19,.158,22,27,.815,113,34,87,.391,27,71,.380,7,16,.438,24,30,.800,99,2016-03-22,MIA,NOP
53,Home,W 113-104 ,240,40,83,.482,30,49,.612,10,34,.294,23,27,.852,113,43,80,.538,36,64,.563,7,16,.438,11,15,.733,104,2016-03-23,CLE,MIL
54,Home,W 113-104 ,240,45,80,.563,40,67,.597,5,13,.385,18,32,.563,113,42,91,.462,34,71,.479,8,20,.400,12,23,.522,104,2016-03-23,MIN,SAC
55,Home,W 113-91 ,240,45,83,.542,36,61,.590,9,22,.409,14,22,.636,113,35,73,.479,30,51,.588,5,22,.227,16,23,.696,91,2016-03-24,OKC,UTA
56,Home,W 113-110 ,240,47,86,.547,43,69,.623,4,17,.235,15,25,.600,113,46,86,.535,38,62,.613,8,24,.333,10,12,.833,110,2016-04-01,MIL,ORL
57,Home,W 113-99 ,240,41,83,.494,27,46,.587,14,37,.378,17,20,.850,113,39,92,.424,29,67,.433,10,25,.400,11,20,.550,99,2016-04-08,CHO,BRK
58,Home,W 113-98 ,240,42,80,.525,33,59,.559,9,21,.429,20,28,.714,113,28,81,.346,16,48,.333,12,33,.364,30,35,.857,98,2016-04-10,WAS,CHO
59,Home,W 113-104 ,240,39,75,.520,26,56,.464,13,19,.684,22,22,1.000,113,40,82,.488,32,58,.552,8,24,.333,16,16,1.000,104,2016-10-25,POR,UTA
60,@,W 113-94 ,240,44,86,.512,38,65,.585,6,21,.286,19,26,.731,113,36,77,.468,32,61,.525,4,16,.250,18,27,.667,94,2016-10-26,SAC,PHO
61,Home,W 113-110 (OT),265,40,96,.417,35,75,.467,5,21,.238,28,38,.737,113,42,94,.447,37,66,.561,5,28,.179,21,32,.656,110,2016-10-28,OKC,PHO
62,Home,L 113-115 (OT),265,38,100,.380,32,77,.416,6,23,.261,31,39,.795,113,45,98,.459,35,66,.530,10,32,.313,15,21,.714,115,2016-10-29,DEN,POR
63,Home,W 113-96 ,240,45,95,.474,36,69,.522,9,26,.346,14,17,.824,113,35,87,.402,28,55,.509,7,32,.219,19,24,.792,96,2016-10-30,OKC,LAL
64,Home,L 113-117 ,240,36,82,.439,27,56,.482,9,26,.346,32,41,.780,113,44,91,.484,34,59,.576,10,32,.313,19,21,.905,117,2016-11-01,NOP,MIL
65,@,W 113-103 ,240,43,77,.558,33,52,.635,10,25,.400,17,25,.680,113,42,72,.583,39,62,.629,3,10,.300,16,24,.667,103,2016-11-02,TOR,WAS
66,@,W 113-111 ,240,43,90,.478,37,68,.544,6,22,.273,21,22,.955,113,38,93,.409,21,52,.404,17,41,.415,18,24,.750,111,2016-11-11,TOR,CHO
67,@,W 113-88 ,240,41,98,.418,34,78,.436,7,20,.350,24,28,.857,113,34,95,.358,25,61,.410,9,34,.265,11,18,.611,88,2016-11-15,CHI,POR
68,@,W 113-111 (OT),265,43,94,.457,35,71,.493,8,23,.348,19,31,.613,113,39,83,.470,35,58,.603,4,25,.160,29,39,.744,111,2016-11-18,TOR,DEN
69,Home,W 113-101 ,240,45,82,.549,36,58,.621,9,24,.375,14,20,.700,113,33,88,.375,21,54,.389,12,34,.353,23,26,.885,101,2016-11-18,NOP,POR
70,Home,W 113-111 (OT),265,45,97,.464,34,69,.493,11,28,.393,12,13,.923,113,43,93,.462,35,64,.547,8,29,.276,17,27,.630,111,2016-11-25,NYK,CHO
71,@,W 113-94 ,240,42,89,.472,29,58,.500,13,31,.419,16,24,.667,113,28,69,.406,19,45,.422,9,24,.375,29,39,.744,94,2016-12-01,LAC,CLE
72,Home,W 113-80 ,240,45,83,.542,33,54,.611,12,29,.414,11,13,.846,113,32,93,.344,26,67,.388,6,26,.231,10,17,.588,80,2016-12-02,TOR,LAL
73,Home,L 113-118 ,240,40,81,.494,29,54,.537,11,27,.407,22,30,.733,113,45,92,.489,31,58,.534,14,34,.412,14,18,.778,118,2016-12-05,BRK,WAS
74,Home,L 113-121 ,240,43,88,.489,32,61,.525,11,27,.407,16,24,.667,113,47,83,.566,39,64,.609,8,19,.421,19,25,.760,121,2016-12-10,ORL,DEN
75,@,W 113-109 ,240,42,95,.442,28,61,.459,14,34,.412,15,19,.789,113,39,82,.476,25,47,.532,14,35,.400,17,21,.810,109,2016-12-13,GSW,NOP
76,Home,W 113-111 (OT),265,38,93,.409,29,63,.460,9,30,.300,28,33,.848,113,38,97,.392,31,77,.403,7,20,.350,28,38,.737,111,2016-12-13,PHO,NYK
77,@,W 113-108 ,240,37,74,.500,24,49,.490,13,25,.520,26,37,.703,113,42,89,.472,28,56,.500,14,33,.424,10,20,.500,108,2016-12-14,LAC,ORL
78,Home,W 113-100 ,240,42,86,.488,31,64,.484,11,22,.500,18,22,.818,113,41,89,.461,31,63,.492,10,26,.385,8,14,.571,100,2016-12-18,SAS,NOP
79,Home,W 113-82 ,240,49,82,.598,41,66,.621,8,16,.500,7,7,1.000,113,34,83,.410,31,60,.517,3,23,.130,11,13,.846,82,2016-12-19,CHI,DET
80,@,L 113-117 ,240,44,90,.489,28,57,.491,16,33,.485,9,11,.818,113,43,94,.457,32,69,.464,11,25,.440,20,24,.833,117,2016-12-20,LAL,CHO
81,Home,W 113-102 ,240,43,87,.494,28,60,.467,15,27,.556,12,19,.632,113,36,77,.468,27,55,.491,9,22,.409,21,29,.724,102,2016-12-21,CLE,MIL
82,Home,L 113-119 ,240,43,85,.506,33,56,.589,10,29,.345,17,28,.607,113,43,77,.558,32,50,.640,11,27,.407,22,24,.917,119,2016-12-23,DET,GSW
83,Home,W 113-103 ,240,41,85,.482,29,54,.537,12,31,.387,19,21,.905,113,37,88,.420,28,58,.483,9,30,.300,20,29,.690,103,2016-12-27,BOS,MEM
84,Home,W 113-105 ,240,37,78,.474,20,46,.435,17,32,.531,22,24,.917,113,41,92,.446,30,62,.484,11,30,.367,12,14,.857,105,2017-01-03,DAL,WAS
85,Home,L 113-120 ,240,41,82,.500,23,44,.523,18,38,.474,13,13,1.000,113,46,88,.523,35,59,.593,11,29,.379,17,18,.944,120,2017-01-03,DEN,SAC
86,@,W 113-108 ,240,43,89,.483,28,55,.509,15,34,.441,12,17,.706,113,38,78,.487,28,60,.467,10,18,.556,22,27,.815,108,2017-01-12,DAL,PHO
87,@,L 113-132 ,240,40,86,.465,23,50,.460,17,36,.472,16,20,.800,113,52,97,.536,41,69,.594,11,28,.393,17,21,.810,132,2017-01-13,BRK,TOR
88,Home,W 113-97 ,240,48,92,.522,38,64,.594,10,28,.357,7,8,.875,113,36,80,.450,26,59,.441,10,21,.476,15,27,.556,97,2017-01-14,LAC,LAL
89,@,W 113-104 ,240,35,78,.449,21,41,.512,14,37,.378,29,36,.806,113,42,89,.472,37,75,.493,5,14,.357,15,22,.682,104,2017-01-16,PHI,MIL
90,@,W 113-110 ,240,44,88,.500,31,56,.554,13,32,.406,12,14,.857,113,42,90,.467,35,66,.530,7,24,.292,19,22,.864,110,2017-01-19,WAS,NYK
91,Home,W 113-78 ,240,40,80,.500,28,55,.509,12,25,.480,21,25,.840,113,29,86,.337,22,56,.393,7,30,.233,13,14,.929,78,2017-01-20,CHO,TOR
92,Home,W 113-112 ,240,43,87,.494,32,59,.542,11,28,.393,16,22,.727,113,39,91,.429,31,65,.477,8,26,.308,26,33,.788,112,2017-01-21,DET,WAS
93,@,W 113-103 ,240,39,82,.476,28,54,.519,11,28,.393,24,27,.889,113,38,92,.413,31,69,.449,7,23,.304,20,21,.952,103,2017-01-25,GSW,CHO
94,@,W 113-111 ,240,36,79,.456,28,53,.528,8,26,.308,33,39,.846,113,46,93,.495,36,66,.545,10,27,.370,9,12,.750,111,2017-01-29,GSW,POR
95,Home,L 113-114 ,240,36,79,.456,24,51,.471,12,28,.429,29,36,.806,113,42,79,.532,32,56,.571,10,23,.435,20,26,.769,114,2017-01-29,TOR,ORL
96,Home,W 113-109 ,240,36,82,.439,23,50,.460,13,32,.406,28,33,.848,113,43,97,.443,40,70,.571,3,27,.111,20,29,.690,109,2017-01-30,BOS,DET
97,Home,W 113-95 ,240,40,86,.465,30,60,.500,10,26,.385,23,28,.821,113,35,77,.455,29,55,.527,6,22,.273,19,26,.731,95,2017-02-01,DAL,PHI
98,@,W 113-108 ,240,44,85,.518,36,55,.655,8,30,.267,17,23,.739,113,35,93,.376,22,42,.524,13,51,.255,25,33,.758,108,2017-02-02,ATL,HOU
99,Home,W 113-107 ,240,39,82,.476,26,47,.553,13,35,.371,22,28,.786,113,37,94,.394,23,56,.411,14,38,.368,19,26,.731,107,2017-02-03,BOS,LAL
0,Home,W 113-86 ,240,41,78,.526,31,50,.620,10,28,.357,21,27,.778,113,27,78,.346,20,51,.392,7,27,.259,25,28,.893,86,2017-02-04,ATL,ORL
1,Home,W 113-96 ,240,46,99,.465,41,77,.532,5,22,.227,16,17,.941,113,36,85,.424,31,57,.544,5,28,.179,19,28,.679,96,2017-02-06,DET,PHI
2,Home,L 113-115 ,240,43,80,.538,38,69,.551,5,11,.455,22,28,.786,113,45,86,.523,30,58,.517,15,28,.536,10,14,.714,115,2017-02-06,MIN,MIA
3,Home,L 113-114 ,240,37,75,.493,25,47,.532,12,28,.429,27,32,.844,113,42,86,.488,31,58,.534,11,28,.393,19,24,.792,114,2017-02-07,DAL,POR
4,Home,W 113-104 ,240,39,82,.476,21,43,.488,18,39,.462,17,19,.895,113,40,86,.465,28,62,.452,12,24,.500,12,14,.857,104,2017-02-15,CLE,IND
5,@,L 113-123 ,240,38,93,.409,27,65,.415,11,28,.393,26,37,.703,113,43,81,.531,30,55,.545,13,26,.500,24,26,.923,123,2017-02-23,LAC,GSW
6,Home,W 113-95 ,240,38,78,.487,25,47,.532,13,31,.419,24,31,.774,113,34,85,.400,30,73,.411,4,12,.333,23,26,.885,95,2017-02-25,MIA,IND
7,@,L 113-120 (OT),265,44,84,.524,34,59,.576,10,25,.400,15,22,.682,113,45,104,.433,38,79,.481,7,25,.280,23,31,.742,120,2017-02-28,POR,DET
8,@,W 113-105 ,240,40,86,.465,34,72,.472,6,14,.429,27,28,.964,113,40,85,.471,31,53,.585,9,32,.281,16,24,.667,105,2017-03-06,NYK,ORL
9,Home,L 113-123 ,240,46,87,.529,33,59,.559,13,28,.464,8,17,.471,113,50,88,.568,39,62,.629,11,26,.423,12,19,.632,123,2017-03-08,DEN,WAS
10,Home,W 112-85 ,240,47,83,.566,42,70,.600,5,13,.385,13,19,.684,112,34,86,.395,30,67,.448,4,19,.211,13,21,.619,85,2012-01-10,PHI,SAC
11,Home,W 112-100 ,240,38,76,.500,31,63,.492,7,13,.538,29,38,.763,112,35,84,.417,30,64,.469,5,20,.250,25,32,.781,100,2012-01-14,CHA,GSW
12,Home,W 112-100 ,240,45,80,.563,32,55,.582,13,25,.520,9,15,.600,112,38,78,.487,29,56,.518,9,22,.409,15,23,.652,100,2012-01-30,LAC,OKC
13,Home,W 112-68 ,240,44,80,.550,37,66,.561,7,14,.500,17,20,.850,112,26,80,.325,25,71,.352,1,9,.111,15,19,.789,68,2012-02-01,POR,CHA
14,@,W 112-91 ,240,39,73,.534,27,52,.519,12,21,.571,22,25,.880,112,39,85,.459,31,58,.534,8,27,.296,5,12,.417,91,2012-02-02,DEN,LAC
15,Home,L 112-113 (OT),265,43,88,.489,35,71,.493,8,17,.471,18,32,.563,112,40,98,.408,32,74,.432,8,24,.333,25,31,.806,113,2012-02-10,CLE,MIL
16,@,W 112-91 ,240,47,89,.528,37,69,.536,10,20,.500,8,12,.667,112,35,80,.438,26,58,.448,9,22,.409,12,16,.750,91,2012-03-02,CHI,CLE
17,@,W 112-106 ,240,46,82,.561,37,66,.561,9,16,.563,11,14,.786,112,43,81,.531,34,57,.596,9,24,.375,11,14,.786,106,2012-03-10,HOU,NJN
18,Home,W 112-97 ,240,47,87,.540,39,65,.600,8,22,.364,10,19,.526,112,39,87,.448,31,70,.443,8,17,.471,11,14,.786,97,2012-03-12,SAS,WAS
19,Home,L 112-124 ,240,45,87,.517,40,68,.588,5,19,.263,17,24,.708,112,50,86,.581,42,73,.575,8,13,.615,16,20,.800,124,2012-03-14,SAC,DET
20,@,W 112-95 ,240,45,84,.536,35,59,.593,10,25,.400,12,15,.800,112,36,83,.434,30,62,.484,6,21,.286,17,20,.850,95,2012-03-19,DAL,DEN
21,@,W 112-92 ,240,48,90,.533,44,77,.571,4,13,.308,12,21,.571,112,34,84,.405,33,76,.434,1,8,.125,23,26,.885,92,2012-03-23,MIL,CHA
22,Home,L 112-117 ,240,47,86,.547,39,65,.600,8,21,.381,10,13,.769,112,49,91,.538,39,71,.549,10,20,.500,9,12,.750,117,2012-03-28,SAC,SAS
23,Home,W 112-103 ,240,38,76,.500,29,57,.509,9,19,.474,27,33,.818,112,42,79,.532,37,65,.569,5,14,.357,14,18,.778,103,2012-03-31,SAS,IND
24,@,L 112-120 ,240,44,90,.489,33,69,.478,11,21,.524,13,15,.867,112,44,82,.537,34,63,.540,10,19,.526,22,31,.710,120,2012-04-01,GSW,LAL
25,@,W 112-98 ,240,43,83,.518,39,73,.534,4,10,.400,22,29,.759,112,36,81,.444,29,63,.460,7,18,.389,19,20,.950,98,2012-04-02,MIL,WAS
26,Home,W 112-104 ,240,41,86,.477,35,63,.556,6,23,.261,24,31,.774,112,38,83,.458,28,60,.467,10,23,.435,18,25,.720,104,2012-04-03,IND,NYK
27,@,W 112-107 ,240,42,88,.477,32,71,.451,10,17,.588,18,22,.818,112,36,84,.429,33,73,.452,3,11,.273,32,36,.889,107,2012-04-06,HOU,LAL
28,Home,W 112-97 ,240,46,88,.523,38,67,.567,8,21,.381,12,16,.750,112,37,80,.463,29,55,.527,8,25,.320,15,20,.750,97,2012-04-07,GSW,DEN
29,@,W 112-103 ,240,44,88,.500,35,64,.547,9,24,.375,15,20,.750,112,38,81,.469,31,63,.492,7,18,.389,20,23,.870,103,2012-04-12,DAL,GSW
30,@,W 112-105 ,240,38,77,.494,30,59,.508,8,18,.444,28,33,.848,112,36,84,.429,32,65,.492,4,19,.211,29,33,.879,105,2012-04-13,PHO,HOU
31,Home,W 112-104 ,240,44,81,.543,34,59,.576,10,22,.455,14,30,.467,112,37,80,.463,22,49,.449,15,31,.484,15,21,.714,104,2012-04-14,LAC,GSW
32,Home,W 112-108 (OT),265,42,93,.452,35,75,.467,7,18,.389,21,27,.778,112,41,88,.466,29,67,.433,12,21,.571,14,15,.933,108,2012-04-15,LAL,DAL
33,@,W 112-91 ,240,50,84,.595,43,66,.652,7,18,.389,5,11,.455,112,39,80,.488,37,70,.529,2,10,.200,11,11,1.000,91,2012-04-17,SAS,LAL
34,@,W 112-91 ,240,38,80,.475,28,63,.444,10,17,.588,26,32,.813,112,31,79,.392,25,59,.424,6,20,.300,23,29,.793,91,2012-04-18,UTA,POR
35,@,L 112-121 ,240,42,93,.452,37,74,.500,5,19,.263,23,27,.852,112,49,88,.557,42,75,.560,7,13,.538,16,25,.640,121,2012-04-18,MIL,WAS
36,Home,L 112-113 ,240,41,76,.539,26,53,.491,15,23,.652,15,23,.652,112,43,79,.544,31,60,.517,12,19,.632,15,20,.750,113,2012-04-22,ATL,NYK
37,@,W 112-109 ,240,40,70,.571,33,52,.635,7,18,.389,25,31,.806,112,42,89,.472,32,67,.478,10,22,.455,15,19,.789,109,2012-11-10,SAS,POR
38,@,W 112-106 (OT),265,44,88,.500,38,76,.500,6,12,.500,18,25,.720,112,42,105,.400,36,84,.429,6,21,.286,16,17,.941,106,2012-11-14,CHI,PHO
39,@,W 112-96 ,240,42,76,.553,34,61,.557,8,15,.533,20,27,.741,112,39,85,.459,31,65,.477,8,20,.400,10,14,.714,96,2012-11-16,ATL,SAC
40,@,W 112-100 ,240,45,77,.584,37,61,.607,8,16,.500,14,19,.737,112,41,77,.532,38,69,.551,3,8,.375,15,17,.882,100,2012-11-21,SAS,BOS
41,Home,L 112-118 (OT),265,41,88,.466,28,61,.459,13,27,.481,17,22,.773,112,43,92,.467,31,57,.544,12,35,.343,20,26,.769,118,2012-12-03,CHA,POR
42,Home,W 112-90 ,240,45,90,.500,39,70,.557,6,20,.300,16,21,.762,112,34,84,.405,29,65,.446,5,19,.263,17,19,.895,90,2012-12-05,LAC,DAL
43,@,W 112-92 ,240,41,91,.451,23,47,.489,18,44,.409,12,19,.632,112,32,76,.421,26,60,.433,6,16,.375,22,28,.786,92,2012-12-06,NYK,MIA
44,Home,W 112-106 ,240,37,86,.430,25,56,.446,12,30,.400,26,37,.703,112,40,72,.556,35,55,.636,5,17,.294,21,29,.724,106,2012-12-09,NYK,DEN
45,Home,W 112-106 ,240,38,87,.437,31,68,.456,7,19,.368,29,42,.690,112,38,95,.400,24,59,.407,14,36,.389,16,18,.889,106,2012-12-18,DEN,SAS
46,Home,W 112-100 ,240,45,93,.484,34,68,.500,11,25,.440,11,19,.579,112,40,80,.500,37,67,.552,3,13,.231,17,24,.708,100,2012-12-25,LAC,DEN
47,@,W 112-110 (OT),265,40,85,.471,34,64,.531,6,21,.286,26,35,.743,112,42,88,.477,34,65,.523,8,23,.348,18,22,.818,110,2012-12-31,MIA,ORL
48,@,W 112-104 ,240,37,79,.468,25,45,.556,12,34,.353,26,36,.722,112,36,91,.396,29,68,.426,7,23,.304,25,28,.893,104,2013-01-05,HOU,CLE
49,@,W 112-105 ,240,44,101,.436,35,77,.455,9,24,.375,15,23,.652,112,38,82,.463,28,52,.538,10,30,.333,19,27,.704,105,2013-01-06,DEN,LAL
50,@,L 112-125 ,240,43,91,.473,29,60,.483,14,31,.452,12,13,.923,112,48,87,.552,37,62,.597,11,25,.440,18,23,.783,125,2013-01-08,LAL,HOU
51,@,W 112-102 ,240,44,82,.537,34,60,.567,10,22,.455,14,21,.667,112,42,88,.477,38,80,.475,4,8,.500,14,22,.636,102,2013-01-09,UTA,CHA
52,Home,L 112-117 (OT),265,40,81,.494,33,54,.611,7,27,.259,25,32,.781,112,41,96,.427,36,75,.480,5,21,.238,30,35,.857,117,2013-01-10,SAC,DAL
53,@,W 112-108 ,240,41,80,.513,30,57,.526,11,23,.478,19,28,.679,112,41,84,.488,34,68,.500,7,16,.438,19,31,.613,108,2013-01-18,WAS,DEN
54,Home,L 112-116 ,240,45,79,.570,36,55,.655,9,24,.375,13,23,.565,112,38,77,.494,28,55,.509,10,22,.455,30,35,.857,116,2013-01-19,NOH,GSW
55,Home,W 112-91 ,240,41,87,.471,31,62,.500,10,25,.400,20,27,.741,112,36,87,.414,33,71,.465,3,16,.188,16,20,.800,91,2013-02-04,OKC,DAL
56,Home,W 112-104 ,240,40,91,.440,35,75,.467,5,16,.313,27,37,.730,112,48,100,.480,45,84,.536,3,16,.188,5,11,.455,104,2013-02-05,DEN,MIL
57,Home,W 112-108 ,240,45,83,.542,34,57,.596,11,26,.423,11,14,.786,112,35,78,.449,23,46,.500,12,32,.375,26,33,.788,108,2013-03-06,DAL,HOU
58,@,L 112-121 ,240,43,90,.478,36,67,.537,7,23,.304,19,23,.826,112,45,82,.549,32,55,.582,13,27,.481,18,21,.857,121,2013-03-08,PHO,SAC
59,Home,W 112-88 ,240,39,76,.513,33,61,.541,6,15,.400,28,35,.800,112,34,79,.430,31,66,.470,3,13,.231,17,19,.895,88,2013-03-13,BOS,TOR
60,Home,W 112-101 ,240,41,86,.477,34,67,.507,7,19,.368,23,24,.958,112,40,76,.526,35,59,.593,5,17,.294,16,24,.667,101,2013-03-16,POR,DET
61,@,W 112-104 ,240,37,80,.463,33,65,.508,4,15,.267,34,46,.739,112,40,82,.488,34,70,.486,6,12,.500,18,19,.947,104,2013-03-30,IND,PHO
62,Home,W 112-92 ,240,40,74,.541,28,53,.528,12,21,.571,20,29,.690,112,38,82,.463,31,64,.484,7,18,.389,9,12,.750,92,2013-03-31,NOH,CLE
63,Home,W 112-102 ,240,45,83,.542,36,61,.590,9,22,.409,13,18,.722,112,39,67,.582,26,44,.591,13,23,.565,11,17,.647,102,2013-04-01,UTA,POR
64,@,W 112-102 ,240,42,86,.488,32,56,.571,10,30,.333,18,21,.857,112,34,87,.391,28,66,.424,6,21,.286,28,34,.824,102,2013-04-03,HOU,SAC
65,@,W 112-111 ,240,37,85,.435,31,71,.437,6,14,.429,32,46,.696,112,42,100,.420,30,65,.462,12,35,.343,15,23,.652,111,2013-04-15,DEN,MIL
66,@,L 112-119 ,240,43,92,.467,32,63,.508,11,29,.379,15,23,.652,112,47,95,.495,40,72,.556,7,23,.304,18,23,.783,119,2013-04-15,HOU,PHO
67,@,W 112-108 ,240,44,88,.500,32,64,.500,12,24,.500,12,18,.667,112,40,89,.449,31,63,.492,9,26,.346,19,25,.760,108,2013-04-17,LAC,SAC
68,Home,W 112-108 (OT),265,41,88,.466,31,64,.484,10,24,.417,20,26,.769,112,41,88,.466,35,64,.547,6,24,.250,20,29,.690,108,2013-11-08,WAS,BRK
69,Home,W 112-101 ,240,41,79,.519,24,48,.500,17,31,.548,13,16,.813,112,40,100,.400,32,74,.432,8,26,.308,13,17,.765,101,2013-11-23,HOU,MIN
70,Home,W 112-93 ,240,44,81,.543,34,56,.607,10,25,.400,14,19,.737,112,37,97,.381,35,82,.427,2,15,.133,17,20,.850,93,2013-11-25,SAS,NOP
71,@,L 112-113 (OT),265,42,95,.442,34,69,.493,8,26,.308,20,29,.690,112,36,92,.391,30,74,.405,6,18,.333,35,42,.833,113,2013-11-29,GSW,OKC
72,@,W 112-101 ,240,41,75,.547,33,50,.660,8,25,.320,22,25,.880,112,40,83,.482,35,63,.556,5,20,.250,16,20,.800,101,2013-11-29,PHO,UTA
73,@,W 112-106 ,240,40,79,.506,29,53,.547,11,26,.423,21,30,.700,112,45,92,.489,38,68,.559,7,24,.292,9,11,.818,106,2013-11-30,MIN,DAL
74,@,W 112-104 ,240,39,76,.513,30,58,.517,9,18,.500,25,29,.862,112,37,78,.474,25,51,.490,12,27,.444,18,25,.720,104,2013-11-30,UTA,PHO
75,@,W 112-106 ,240,40,90,.444,27,60,.450,13,30,.433,19,30,.633,112,44,91,.484,35,65,.538,9,26,.346,9,13,.692,106,2013-11-30,HOU,SAS
76,@,W 112-98 ,240,44,87,.506,34,64,.531,10,23,.435,14,19,.737,112,35,87,.402,27,65,.415,8,22,.364,20,26,.769,98,2013-12-01,DEN,TOR
77,Home,W 112-103 ,240,40,79,.506,28,50,.560,12,29,.414,20,25,.800,112,40,77,.519,32,57,.561,8,20,.400,15,18,.833,103,2013-12-03,GSW,TOR
78,@,W 112-102 (OT),265,39,94,.415,36,79,.456,3,15,.200,31,38,.816,112,36,89,.404,28,70,.400,8,19,.421,22,30,.733,102,2013-12-07,SAC,UTA
79,Home,W 112-97 ,240,38,81,.469,29,56,.518,9,25,.360,27,34,.794,112,37,95,.389,32,68,.471,5,27,.185,18,20,.900,97,2013-12-09,SAC,DAL
80,Home,L 112-116 ,240,43,90,.478,37,68,.544,6,22,.273,20,24,.833,112,39,79,.494,27,50,.540,12,29,.414,26,35,.743,116,2013-12-13,GSW,HOU
81,Home,W 112-91 ,240,39,86,.453,26,53,.491,13,33,.394,21,31,.677,112,31,88,.352,25,58,.431,6,30,.200,23,29,.793,91,2013-12-21,LAC,DEN
82,Home,W 112-99 ,240,41,91,.451,32,68,.471,9,23,.391,21,27,.778,112,37,81,.457,30,60,.500,7,21,.333,18,25,.720,99,2013-12-23,SAS,TOR
83,@,L 112-116 (OT),265,49,110,.445,41,90,.456,8,20,.400,6,12,.500,112,42,96,.438,29,60,.483,13,36,.361,19,22,.864,116,2013-12-26,LAC,POR
84,Home,W 112-104 ,240,44,94,.468,36,70,.514,8,24,.333,16,19,.842,112,41,91,.451,34,77,.442,7,14,.500,15,20,.750,104,2013-12-29,SAS,SAC
85,Home,W 112-85 ,240,47,85,.553,36,51,.706,11,34,.324,7,10,.700,112,29,76,.382,23,55,.418,6,21,.286,21,22,.955,85,2014-01-01,LAC,CHA
86,@,L 112-124 ,240,45,87,.517,39,67,.582,6,20,.300,16,22,.727,112,44,79,.557,36,57,.632,8,22,.364,28,35,.800,124,2014-01-01,NOP,MIN
87,Home,L 112-119 ,240,45,88,.511,33,60,.550,12,28,.429,10,14,.714,112,40,82,.488,31,59,.525,9,23,.391,30,38,.789,119,2014-01-03,DAL,LAC
88,@,W 112-84 ,240,43,92,.467,35,77,.455,8,15,.533,18,22,.818,112,35,86,.407,31,69,.449,4,17,.235,10,20,.500,84,2014-01-05,MEM,DET
89,@,W 112-96 ,240,43,85,.506,34,63,.540,9,22,.409,17,20,.850,112,37,86,.430,31,66,.470,6,20,.300,16,16,1.000,96,2014-01-05,GSW,WAS
90,Home,W 112-101 ,240,40,68,.588,32,50,.640,8,18,.444,24,31,.774,112,35,89,.393,29,55,.527,6,34,.176,25,31,.806,101,2014-01-07,UTA,OKC
91,Home,W 112-90 ,240,40,76,.526,31,56,.554,9,20,.450,23,26,.885,112,39,93,.419,32,74,.432,7,19,.368,5,8,.625,90,2014-01-08,SAS,DAL
92,Home,W 112-91 ,240,35,86,.407,24,55,.436,11,31,.355,31,34,.912,112,34,86,.395,30,70,.429,4,16,.250,19,35,.543,91,2014-01-08,TOR,DET
93,Home,W 112-104 ,240,40,93,.430,30,72,.417,10,21,.476,22,26,.846,112,44,95,.463,40,81,.494,4,14,.286,12,17,.706,104,2014-01-11,POR,BOS
94,@,W 112-106 ,240,37,80,.463,25,58,.431,12,22,.545,26,28,.929,112,44,90,.489,35,60,.583,9,30,.300,9,11,.818,106,2014-01-19,LAL,TOR
95,@,W 112-103 ,240,40,72,.556,31,51,.608,9,21,.429,23,37,.622,112,40,79,.506,38,65,.585,2,14,.143,21,29,.724,103,2014-01-20,LAC,DET
96,@,W 112-97 ,240,41,90,.456,33,69,.478,8,21,.381,22,24,.917,112,41,87,.471,36,70,.514,5,17,.294,10,12,.833,97,2014-01-21,MIN,UTA
97,@,W 112-109 ,240,41,83,.494,32,58,.552,9,25,.360,21,24,.875,112,41,83,.494,35,71,.493,6,12,.500,21,24,.875,109,2014-01-22,ATL,ORL
98,@,W 112-95 ,240,41,76,.539,28,55,.509,13,21,.619,17,26,.654,112,40,93,.430,34,74,.459,6,19,.316,9,11,.818,95,2014-01-24,LAC,CHI
99,@,W 112-87 ,240,40,76,.526,27,50,.540,13,26,.500,19,25,.760,112,38,82,.463,33,61,.541,5,21,.238,6,13,.462,87,2014-01-25,ATL,MIL
0,@,W 112-95 ,240,41,80,.513,25,53,.472,16,27,.593,14,19,.737,112,37,72,.514,34,53,.642,3,19,.158,18,22,.818,95,2014-01-29,OKC,MIA
1,Home,L 112-116 ,240,37,86,.430,30,61,.492,7,25,.280,31,42,.738,112,41,78,.526,28,47,.596,13,31,.419,21,26,.808,116,2014-02-05,LAC,MIA
2,Home,W 112-98 ,240,44,89,.494,38,71,.535,6,18,.333,18,20,.900,112,39,85,.459,33,65,.508,6,20,.300,14,23,.609,98,2014-02-05,ORL,DET
3,@,W 112-98 ,240,45,89,.506,37,71,.521,8,18,.444,14,20,.700,112,37,87,.425,22,55,.400,15,32,.469,9,17,.529,98,2014-02-07,LAL,PHI
4,Home,W 112-100 ,240,40,73,.548,28,46,.609,12,27,.444,20,27,.741,112,38,86,.442,29,62,.468,9,24,.375,15,20,.750,100,2014-02-09,OKC,NYK
5,@,L 112-113 ,240,44,97,.454,28,65,.431,16,32,.500,8,16,.500,112,34,64,.531,24,42,.571,10,22,.455,35,47,.745,113,2014-02-12,WAS,HOU
6,@,W 112-107 (OT),265,35,93,.376,24,64,.375,11,29,.379,31,39,.795,112,38,99,.384,33,71,.465,5,28,.179,26,37,.703,107,2014-02-18,PHO,DEN
7,Home,L 112-124 ,240,42,94,.447,37,69,.536,5,25,.200,23,32,.719,112,48,77,.623,39,54,.722,9,23,.391,19,25,.760,124,2014-02-21,PHI,DAL
8,Home,L 112-115 ,240,42,86,.488,31,60,.517,11,26,.423,17,24,.708,112,41,78,.526,36,62,.581,5,16,.313,28,32,.875,115,2014-02-23,PHO,HOU
9,@,W 112-89 ,240,39,82,.476,29,51,.569,10,31,.323,24,29,.828,112,30,81,.370,24,59,.407,6,22,.273,23,33,.697,89,2014-02-27,BRK,DEN
10,Home,W 112-98 ,240,43,74,.581,37,58,.638,6,16,.375,20,24,.833,112,36,83,.434,32,65,.492,4,18,.222,22,29,.759,98,2014-03-01,MIA,ORL
11,Home,W 112-106 ,240,39,84,.464,29,57,.509,10,27,.370,24,28,.857,112,45,97,.464,38,79,.481,7,18,.389,9,14,.643,106,2014-03-02,SAS,DAL
12,Home,W 112-86 ,240,40,76,.526,27,48,.563,13,28,.464,19,25,.760,112,34,74,.459,27,58,.466,7,16,.438,11,15,.733,86,2014-03-07,HOU,IND
13,Home,W 112-104 ,240,42,84,.500,34,64,.531,8,20,.400,20,23,.870,112,40,89,.449,35,69,.507,5,20,.250,19,25,.760,104,2014-03-07,NOP,MIL
14,@,L 112-121 ,240,46,96,.479,39,78,.500,7,18,.389,13,17,.765,112,43,81,.531,34,61,.557,9,20,.450,26,35,.743,121,2014-03-08,ORL,SAS
15,Home,W 112-105 ,240,43,78,.551,39,64,.609,4,14,.286,22,31,.710,112,39,85,.459,32,65,.492,7,20,.350,20,29,.690,105,2014-03-10,LAC,PHO
16,@,W 112-110 ,240,38,78,.487,25,49,.510,13,29,.448,23,27,.852,112,40,82,.488,30,61,.492,10,21,.476,20,24,.833,110,2014-03-10,ATL,UTA
17,Home,W 112-101 ,240,41,85,.482,33,65,.508,8,20,.400,22,30,.733,112,39,74,.527,34,59,.576,5,15,.333,18,29,.621,101,2014-03-11,MIN,MIL
18,Home,L 112-120 ,240,45,93,.484,36,69,.522,9,24,.375,13,13,1.000,112,47,92,.511,37,70,.529,10,22,.455,16,24,.667,120,2014-03-12,ORL,DEN
19,@,W 112-104 (OT),265,41,104,.394,34,80,.425,7,24,.292,23,25,.920,112,37,91,.407,30,68,.441,7,23,.304,23,30,.767,104,2014-03-15,IND,DET
20,Home,L 112-113 ,240,37,88,.420,25,60,.417,12,28,.429,26,30,.867,112,42,88,.477,31,58,.534,11,30,.367,18,22,.818,113,2014-03-16,POR,GSW
21,Home,W 112-103 ,240,45,83,.542,34,54,.630,11,29,.379,11,17,.647,112,42,93,.452,30,64,.469,12,29,.414,7,13,.538,103,2014-03-22,LAC,DET
22,Home,W 112-88 ,240,40,88,.455,26,55,.473,14,33,.424,18,23,.783,112,35,87,.402,27,62,.435,8,25,.320,10,16,.625,88,2014-03-28,PHO,NYK
23,Home,L 112-124 ,240,41,92,.446,30,67,.448,11,25,.440,19,22,.864,112,46,99,.465,33,70,.471,13,29,.448,19,21,.905,124,2014-04-01,LAL,POR
24,@,W 112-108 ,240,37,79,.468,26,53,.491,11,26,.423,27,30,.900,112,36,78,.462,28,50,.560,8,28,.286,28,33,.848,108,2014-04-02,LAC,PHO
25,Home,W 112-92 ,240,43,77,.558,34,55,.618,9,22,.409,17,18,.944,112,38,86,.442,33,72,.458,5,14,.357,11,17,.647,92,2014-04-06,SAS,MEM
26,@,W 112-95 ,240,45,92,.489,32,67,.478,13,25,.520,9,13,.692,112,35,89,.393,26,61,.426,9,28,.321,16,20,.800,95,2014-04-11,GSW,LAL
27,Home,W 112-110 ,240,41,94,.436,38,82,.463,3,12,.250,27,40,.675,112,36,83,.434,25,58,.431,11,25,.440,27,36,.750,110,2014-04-11,MIN,HOU
28,Home,W 112-104 ,240,43,96,.448,30,66,.455,13,30,.433,13,16,.813,112,39,82,.476,30,56,.536,9,26,.346,17,19,.895,104,2014-04-11,SAS,PHO
29,Home,L 112-116 ,240,37,84,.440,28,50,.560,9,34,.265,29,35,.829,112,44,90,.489,36,67,.537,8,23,.348,20,35,.571,116,2014-04-16,DEN,GSW
30,Home,W 112-111 ,240,38,86,.442,33,63,.524,5,23,.217,31,41,.756,112,42,83,.506,34,64,.531,8,19,.421,19,31,.613,111,2014-04-16,OKC,DET
31,@,W 112-106 ,240,41,91,.451,35,73,.479,6,18,.333,24,31,.774,112,35,88,.398,29,72,.403,6,16,.375,30,41,.732,106,2014-11-04,PHO,LAL
32,Home,W 112-103 (OT),265,46,91,.505,41,81,.506,5,10,.500,15,19,.789,112,40,93,.430,36,75,.480,4,18,.222,19,25,.760,103,2014-11-07,ORL,MIN
33,Home,L 112-114 (2OT),290,42,98,.429,32,67,.478,10,31,.323,18,25,.720,112,39,91,.429,36,75,.480,3,16,.188,33,39,.846,114,2014-11-07,PHO,SAC
34,Home,W 112-104 ,240,39,81,.481,31,57,.544,8,24,.333,26,29,.897,112,35,74,.473,26,53,.491,9,21,.429,25,32,.781,104,2014-11-12,PHO,BRK
35,Home,W 112-87 ,240,45,87,.517,34,61,.557,11,26,.423,11,14,.786,112,32,84,.381,25,67,.373,7,17,.412,16,28,.571,87,2014-11-15,GSW,CHO
36,@,L 112-120 ,240,39,90,.433,31,65,.477,8,25,.320,26,34,.765,112,45,88,.511,32,63,.508,13,25,.520,17,21,.810,120,2014-11-26,DEN,PHO
37,@,W 112-99 ,240,45,84,.536,39,71,.549,6,13,.462,16,26,.615,112,39,97,.402,31,69,.449,8,28,.286,13,18,.722,99,2014-11-28,MEM,POR
38,Home,W 112-104 ,240,42,82,.512,30,58,.517,12,24,.500,16,20,.800,112,38,75,.507,32,65,.492,6,10,.600,22,26,.846,104,2014-11-28,SAS,SAC
39,@,W 112-96 ,240,45,80,.563,34,52,.654,11,28,.393,11,15,.733,112,34,75,.453,27,54,.500,7,21,.333,21,33,.636,96,2014-11-29,LAC,UTA
40,Home,W 112-104 ,240,39,88,.443,34,71,.479,5,17,.294,29,45,.644,112,37,84,.440,30,60,.500,7,24,.292,23,27,.852,104,2014-12-02,NOP,OKC
41,@,W 112-102 ,240,40,74,.541,28,49,.571,12,25,.480,20,23,.870,112,36,64,.563,30,48,.625,6,16,.375,24,32,.750,102,2014-12-03,ATL,MIA
42,Home,W 112-85 ,240,47,100,.470,37,78,.474,10,22,.455,8,17,.471,112,37,89,.416,34,74,.459,3,15,.200,8,13,.615,85,2014-12-04,GSW,NOP
43,Home,L 112-114 (OT),265,45,97,.464,42,87,.483,3,10,.300,19,27,.704,112,38,78,.487,26,46,.565,12,32,.375,26,31,.839,114,2014-12-05,MIN,HOU
44,@,W 112-102 ,240,40,89,.449,28,59,.475,12,30,.400,20,25,.800,112,36,83,.434,29,62,.468,7,21,.333,23,27,.852,102,2014-12-06,GSW,CHI
45,Home,W 112-107 (OT),265,41,81,.506,32,48,.667,9,33,.273,21,29,.724,112,43,104,.413,33,74,.446,10,30,.333,11,15,.733,107,2014-12-08,TOR,DEN
46,Home,W 112-107 ,240,44,83,.530,35,62,.565,9,21,.429,15,17,.882,112,40,88,.455,33,70,.471,7,18,.389,20,24,.833,107,2014-12-10,DAL,NOP
47,@,W 112-110 (OT),265,44,96,.458,32,72,.444,12,24,.500,12,15,.800,112,42,90,.467,30,59,.508,12,31,.387,14,21,.667,110,2014-12-12,LAL,SAS
48,Home,W 112-88 ,240,39,80,.488,35,62,.565,4,18,.222,30,34,.882,112,34,99,.343,27,68,.397,7,31,.226,13,18,.722,88,2014-12-14,OKC,PHO
49,Home,W 112-107 ,240,39,88,.443,29,57,.509,10,31,.323,24,28,.857,112,45,90,.500,40,76,.526,5,14,.357,12,21,.571,107,2014-12-28,DAL,OKC
50,Home,W 112-96 ,240,42,84,.500,28,52,.538,14,32,.438,14,16,.875,112,37,87,.425,30,61,.492,7,26,.269,15,25,.600,96,2015-01-02,PHO,PHI
51,Home,W 112-94 ,240,43,86,.500,33,56,.589,10,30,.333,16,17,.941,112,35,86,.407,28,63,.444,7,23,.304,17,23,.739,94,2015-01-09,GSW,CLE
52,Home,W 112-101 ,240,41,86,.477,25,50,.500,16,36,.444,14,19,.737,112,35,81,.432,24,52,.462,11,29,.379,20,28,.714,101,2015-01-15,HOU,OKC
53,Home,W 112-100 ,240,45,80,.563,35,52,.673,10,28,.357,12,18,.667,112,37,71,.521,31,55,.564,6,16,.375,20,25,.800,100,2015-01-25,ATL,MIN
54,@,W 112-101 ,240,39,76,.513,34,64,.531,5,12,.417,29,34,.853,112,37,79,.468,27,48,.563,10,31,.323,17,22,.773,101,2015-02-08,MIN,DET
55,Home,W 112-107 ,240,43,89,.483,31,65,.477,12,24,.500,14,16,.875,112,47,88,.534,37,63,.587,10,25,.400,3,8,.375,107,2015-02-21,CHI,PHO
56,@,L 112-115 ,240,45,94,.479,41,80,.513,4,14,.286,18,22,.818,112,39,89,.438,29,63,.460,10,26,.385,27,31,.871,115,2015-02-27,OKC,POR
57,Home,W 112-85 ,240,45,85,.529,35,62,.565,10,23,.435,12,16,.750,112,29,78,.372,26,69,.377,3,9,.333,24,34,.706,85,2015-03-04,SAS,SAC
58,Home,L 112-120 ,240,43,79,.544,33,58,.569,10,21,.476,16,17,.941,112,40,78,.513,25,42,.595,15,36,.417,25,34,.735,120,2015-03-04,TOR,CLE
59,@,W 112-101 ,240,41,77,.532,33,59,.559,8,18,.444,22,32,.688,112,34,76,.447,26,54,.481,8,22,.364,25,36,.694,101,2015-03-20,MEM,DAL
60,Home,W 112-96 ,240,44,88,.500,39,69,.565,5,19,.263,19,23,.826,112,33,77,.429,22,55,.400,11,22,.500,19,22,.864,96,2015-03-20,GSW,NOP
61,Home,W 112-89 ,240,37,85,.435,23,55,.418,14,30,.467,24,36,.667,112,37,82,.451,35,62,.565,2,20,.100,13,19,.684,89,2015-04-05,IND,MIA
62,Home,L 112-115 ,240,40,92,.435,26,62,.419,14,30,.467,18,26,.692,112,38,81,.469,30,53,.566,8,28,.286,31,50,.620,115,2015-04-05,OKC,HOU
63,@,W 112-108 ,240,43,77,.558,30,52,.577,13,25,.520,13,19,.684,112,39,88,.443,28,56,.500,11,32,.344,19,23,.826,108,2015-04-13,NYK,ATL
64,@,W 112-101 ,240,42,87,.483,27,49,.551,15,38,.395,13,18,.722,112,39,80,.488,28,54,.519,11,26,.423,12,20,.600,101,2015-04-14,LAC,PHO
65,@,W 112-90 ,240,41,81,.506,31,55,.564,10,26,.385,20,27,.741,112,33,77,.429,26,58,.448,7,19,.368,17,27,.630,90,2015-04-15,DET,NYK
66,Home,W 112-95 ,240,39,85,.459,31,61,.508,8,24,.333,26,27,.963,112,34,83,.410,27,61,.443,7,22,.318,20,23,.870,95,2015-10-28,BOS,PHI
67,@,W 112-111 ,240,38,83,.458,33,63,.524,5,20,.250,31,37,.838,112,35,90,.389,26,56,.464,9,34,.265,32,35,.914,111,2015-10-28,MIN,LAL
68,Home,W 112-106 ,240,42,86,.488,35,67,.522,7,19,.368,21,22,.955,112,45,93,.484,40,78,.513,5,15,.333,11,13,.846,106,2015-10-28,OKC,SAS
69,Home,W 112-94 ,240,44,88,.500,32,56,.571,12,32,.375,12,14,.857,112,36,91,.396,25,58,.431,11,33,.333,11,18,.611,94,2015-10-28,POR,NOP
70,@,W 112-103 ,240,41,82,.500,34,66,.515,7,16,.438,23,29,.793,112,37,78,.474,25,48,.521,12,30,.400,17,24,.708,103,2015-10-29,MEM,IND
71,@,W 112-101 ,240,42,83,.506,32,59,.542,10,24,.417,18,26,.692,112,38,93,.409,32,64,.500,6,29,.207,19,21,.905,101,2015-10-29,ATL,NYK
72,@,W 112-92 ,240,43,93,.462,34,67,.507,9,26,.346,17,25,.680,112,30,82,.366,25,59,.424,5,23,.217,27,36,.750,92,2015-10-30,GSW,HOU
73,Home,W 112-108 ,240,39,85,.459,29,59,.492,10,26,.385,24,31,.774,112,43,88,.489,35,66,.530,8,22,.364,14,22,.636,108,2015-11-04,GSW,LAC
74,@,W 112-85 ,240,42,92,.457,30,65,.462,12,27,.444,16,20,.800,112,35,76,.461,30,51,.588,5,25,.200,10,16,.625,85,2015-11-18,IND,PHI
75,Home,W 112-98 ,240,36,79,.456,27,48,.563,9,31,.290,31,44,.705,112,36,84,.429,27,47,.574,9,37,.243,17,22,.773,98,2015-11-30,SAC,DAL
76,Home,L 112-115 (OT),265,41,100,.410,26,60,.433,15,40,.375,15,17,.882,112,43,94,.457,34,65,.523,9,29,.310,20,24,.833,115,2015-12-01,POR,DAL
77,@,W 112-109 ,240,35,73,.479,19,43,.442,16,30,.533,26,36,.722,112,40,91,.440,32,71,.451,8,20,.400,21,26,.808,109,2015-12-05,GSW,TOR
78,@,W 112-110 ,240,39,75,.520,30,54,.556,9,21,.429,25,28,.893,112,41,89,.461,35,68,.515,6,21,.286,22,29,.759,110,2015-12-12,NYK,POR
79,Home,W 112-95 ,240,44,78,.564,34,63,.540,10,15,.667,14,15,.933,112,37,86,.430,28,62,.452,9,24,.375,12,20,.600,95,2015-12-14,MEM,WAS
80,@,W 112-100 ,240,41,73,.562,31,55,.564,10,18,.556,20,27,.741,112,36,77,.468,32,67,.478,4,10,.400,24,31,.774,100,2015-12-15,DEN,MIN
81,@,L 112-121 ,240,42,91,.462,38,73,.521,4,18,.222,24,28,.857,112,42,87,.483,33,61,.541,9,26,.346,28,37,.757,121,2015-12-18,MIL,GSW
82,Home,W 112-96 ,240,45,80,.563,39,64,.609,6,16,.375,16,22,.727,112,32,84,.381,24,55,.436,8,29,.276,24,32,.750,96,2015-12-27,MEM,LAL
83,@,L 112-122 ,240,46,94,.489,37,69,.536,9,25,.360,11,15,.733,112,48,83,.578,40,68,.588,8,15,.533,18,21,.857,122,2015-12-27,DEN,OKC
84,@,W 112-104 ,240,43,94,.457,34,75,.453,9,19,.474,17,23,.739,112,38,88,.432,31,61,.508,7,27,.259,21,25,.840,104,2015-12-30,LAL,BOS
85,Home,W 112-79 ,240,43,76,.566,37,62,.597,6,14,.429,20,33,.606,112,32,81,.395,27,63,.429,5,18,.278,10,18,.556,79,2015-12-30,SAS,PHO
86,@,W 112-106 ,240,40,78,.513,30,55,.545,10,23,.435,22,32,.688,112,34,80,.425,27,58,.466,7,22,.318,31,48,.646,106,2016-01-03,POR,DEN
87,Home,W 112-94 ,240,38,83,.458,30,66,.455,8,17,.471,28,33,.848,112,35,90,.389,28,69,.406,7,21,.333,17,24,.708,94,2016-01-06,OKC,MEM
88,Home,W 112-110 ,240,37,87,.425,32,65,.492,5,22,.227,33,37,.892,112,42,88,.477,32,62,.516,10,26,.385,16,20,.800,110,2016-01-13,DEN,GSW
89,@,W 112-95 ,240,44,91,.484,38,70,.543,6,21,.286,18,24,.750,112,37,82,.451,31,63,.492,6,19,.316,15,19,.789,95,2016-01-17,HOU,LAL
90,Home,W 112-83 ,240,42,90,.467,37,70,.529,5,20,.250,23,28,.821,112,29,81,.358,23,58,.397,6,23,.261,19,25,.760,83,2016-01-17,SAS,DAL
91,Home,W 112-100 ,240,43,85,.506,30,61,.492,13,24,.542,13,18,.722,112,39,76,.513,34,62,.548,5,14,.357,17,19,.895,100,2016-01-18,TOR,BRK
92,@,W 112-93 ,240,43,89,.483,37,69,.536,6,20,.300,20,28,.714,112,32,90,.356,28,65,.431,4,25,.160,25,31,.806,93,2016-01-20,SAC,LAL
93,@,W 112-92 ,240,43,97,.443,32,72,.444,11,25,.440,15,19,.789,112,35,89,.393,27,63,.429,8,26,.308,14,20,.700,92,2016-01-24,BOS,PHI
94,Home,W 112-94 ,240,41,83,.494,29,61,.475,12,22,.545,18,26,.692,112,34,76,.447,26,50,.520,8,26,.308,18,30,.600,94,2016-01-24,TOR,LAC
95,@,W 112-111 ,240,38,80,.475,19,40,.475,19,40,.475,17,21,.810,112,42,91,.462,29,62,.468,13,29,.448,14,25,.560,111,2016-01-25,HOU,NOP
96,Home,W 112-97 ,240,44,90,.489,35,60,.583,9,30,.300,15,19,.789,112,36,86,.419,29,67,.433,7,19,.368,18,32,.563,97,2016-01-26,POR,SAC
97,Home,W 112-97 ,240,42,80,.525,28,45,.622,14,35,.400,14,19,.737,112,31,85,.365,24,59,.407,7,26,.269,28,38,.737,97,2016-02-01,ATL,DAL
98,Home,W 112-93 ,240,45,83,.542,35,61,.574,10,22,.455,12,15,.800,112,29,78,.372,21,53,.396,8,25,.320,27,39,.692,93,2016-02-01,DEN,TOR
99,Home,W 112-104 ,240,41,76,.539,35,65,.538,6,11,.545,24,29,.828,112,38,79,.481,26,46,.565,12,33,.364,16,31,.516,104,2016-02-06,IND,DET
0,Home,W 112-105 ,240,45,87,.517,44,75,.587,1,12,.083,21,22,.955,112,40,85,.471,32,65,.492,8,20,.400,17,19,.895,105,2016-02-06,MIN,CHI
1,@,W 112-106 (OT),265,44,89,.494,34,60,.567,10,29,.345,14,20,.700,112,43,86,.500,36,67,.537,7,19,.368,13,19,.684,106,2016-02-08,POR,MEM
2,Home,W 112-111 ,240,45,88,.511,38,69,.551,7,19,.368,15,23,.652,112,39,84,.464,29,55,.527,10,29,.345,23,24,.958,111,2016-02-09,MIL,BOS
3,@,L 112-117 ,240,39,86,.453,29,55,.527,10,31,.323,24,32,.750,112,35,76,.461,31,62,.500,4,14,.286,43,53,.811,117,2016-02-10,TOR,MIN
4,@,W 112-104 ,240,37,89,.416,23,49,.469,14,40,.350,24,29,.828,112,41,93,.441,35,72,.486,6,21,.286,16,22,.727,104,2016-02-10,GSW,PHO
5,Home,L 112-115 ,240,42,94,.447,29,58,.500,13,36,.361,15,18,.833,112,42,82,.512,31,51,.608,11,31,.355,20,26,.769,115,2016-02-20,LAC,GSW
6,Home,W 112-104 ,240,40,80,.500,30,57,.526,10,23,.435,22,25,.880,112,43,90,.478,40,78,.513,3,12,.250,15,19,.789,104,2016-02-23,POR,BRK
7,Home,L 112-118 ,240,40,86,.465,34,72,.472,6,14,.429,26,31,.839,112,42,90,.467,29,62,.468,13,28,.464,21,25,.840,118,2016-02-24,MIA,GSW
8,Home,W 112-107 ,240,41,84,.488,36,61,.590,5,23,.217,25,33,.758,112,42,87,.483,38,72,.528,4,15,.267,19,25,.760,107,2016-02-25,BOS,MIL
9,@,W 112-95 ,240,43,85,.506,30,53,.566,13,32,.406,13,15,.867,112,32,78,.410,27,55,.491,5,23,.217,26,39,.667,95,2016-02-26,MEM,LAL
10,@,W 112-110 ,240,42,84,.500,37,69,.536,5,15,.333,23,30,.767,112,39,84,.464,29,57,.509,10,27,.370,22,26,.846,110,2016-02-27,MIN,NOP
11,@,W 112-102 ,240,39,88,.443,34,72,.472,5,16,.313,29,36,.806,112,36,95,.379,27,64,.422,9,31,.290,21,27,.778,102,2016-03-04,MIA,PHI
12,Home,W 112-95 ,240,41,87,.471,32,62,.516,9,25,.360,21,22,.955,112,37,92,.402,33,62,.532,4,30,.133,17,21,.810,95,2016-03-06,LAL,GSW
13,@,L 112-115 ,240,41,83,.494,34,58,.586,7,25,.280,23,27,.852,112,45,94,.479,38,69,.551,7,25,.280,18,26,.692,115,2016-03-07,SAC,NOP
14,@,L 112-128 ,240,37,86,.430,18,50,.360,19,36,.528,19,23,.826,112,40,89,.449,22,49,.449,18,40,.450,30,39,.769,128,2016-03-11,POR,GSW
15,@,W 112-105 ,240,38,81,.469,29,53,.547,9,28,.321,27,29,.931,112,41,85,.482,33,63,.524,8,22,.364,15,18,.833,105,2016-03-12,IND,DAL
16,Home,W 112-104 (OT),265,37,84,.440,31,66,.470,6,18,.333,32,38,.842,112,37,98,.378,28,73,.384,9,25,.360,21,26,.808,104,2016-03-12,TOR,MIA
17,Home,L 112-130 ,240,41,93,.441,32,64,.500,9,29,.310,21,22,.955,112,48,95,.505,26,57,.456,22,38,.579,12,14,.857,130,2016-03-18,DAL,GSW
18,Home,L 112-117 ,240,40,83,.482,30,62,.484,10,21,.476,22,28,.786,112,36,78,.462,27,51,.529,9,27,.333,36,40,.900,117,2016-03-18,NOP,POR
19,Home,W 112-88 ,240,42,81,.519,34,67,.507,8,14,.571,20,24,.833,112,37,77,.481,30,63,.476,7,14,.500,7,12,.583,88,2016-03-23,SAS,MIA
20,Home,W 112-105 ,240,42,91,.462,34,61,.557,8,30,.267,20,26,.769,112,37,93,.398,23,63,.365,14,30,.467,17,22,.773,105,2016-03-25,DET,CHO
21,Home,W 112-109 ,240,42,81,.519,30,59,.508,12,22,.545,16,35,.457,112,39,94,.415,26,63,.413,13,31,.419,18,26,.692,109,2016-03-25,HOU,TOR
22,@,W 112-95 ,240,43,95,.453,30,61,.492,13,34,.382,13,14,.929,112,34,88,.386,27,59,.458,7,29,.241,20,28,.714,95,2016-03-26,ATL,DET
23,@,W 112-106 ,240,42,82,.512,30,60,.500,12,22,.545,16,17,.941,112,38,87,.437,31,66,.470,7,21,.333,23,29,.793,106,2016-04-01,MIA,SAC
24,Home,W 112-103 ,240,45,83,.542,29,54,.537,16,29,.552,6,13,.462,112,34,76,.447,25,50,.500,9,26,.346,26,27,.963,103,2016-04-03,CLE,CHO
25,Home,W 112-101 ,240,45,83,.542,33,58,.569,12,25,.480,10,11,.909,112,39,80,.488,32,64,.500,7,16,.438,16,23,.696,101,2016-04-07,GSW,SAS
26,Home,W 112-99 ,240,36,77,.468,22,45,.489,14,32,.438,26,29,.897,112,38,86,.442,32,67,.478,6,19,.316,17,23,.739,99,2016-04-08,DET,WAS
27,Home,W 112-109 ,240,43,82,.524,38,71,.535,5,11,.455,21,28,.750,112,45,100,.450,37,78,.474,8,22,.364,11,21,.524,109,2016-04-08,ORL,MIA
28,@,L 112-114 ,240,39,81,.481,26,49,.531,13,32,.406,21,28,.750,112,45,94,.479,32,62,.516,13,32,.406,11,20,.550,114,2016-04-09,OKC,SAC
29,Home,W 112-79 ,240,42,96,.438,30,59,.508,12,37,.324,16,27,.593,112,23,81,.284,16,50,.320,7,31,.226,26,30,.867,79,2016-04-11,OKC,LAL
30,@,W 112-110 (OT),265,37,85,.435,21,52,.404,16,33,.485,22,28,.786,112,46,97,.474,39,79,.494,7,18,.389,11,15,.733,110,2016-04-13,DET,CLE
31,Home,W 112-103 (OT),265,39,88,.443,24,57,.421,15,31,.484,19,26,.731,112,38,86,.442,33,61,.541,5,25,.200,22,25,.880,103,2016-10-30,MEM,WAS
32,@,W 112-111 (OT),265,40,93,.430,32,69,.464,8,24,.333,24,28,.857,112,43,94,.457,33,64,.516,10,30,.333,15,28,.536,111,2016-11-04,PHO,NOP
33,Home,W 112-97 ,240,45,85,.529,37,65,.569,8,20,.400,14,24,.583,112,37,85,.435,25,49,.510,12,36,.333,11,13,.846,97,2016-11-05,ATL,HOU
34,Home,W 112-92 ,240,45,86,.523,38,70,.543,7,16,.438,15,24,.625,112,33,84,.393,29,65,.446,4,19,.211,22,29,.759,92,2016-11-05,OKC,MIN
35,Home,W 112-80 ,240,42,89,.472,39,70,.557,3,19,.158,25,31,.806,112,33,85,.388,24,55,.436,9,30,.300,5,6,.833,80,2016-11-07,CHI,ORL
36,@,W 112-102 ,240,43,83,.518,32,57,.561,11,26,.423,15,22,.682,112,31,74,.419,19,40,.475,12,34,.353,28,31,.903,102,2016-11-09,TOR,OKC
37,@,W 112-106 ,240,39,89,.438,30,64,.469,9,25,.360,25,27,.926,112,40,91,.440,34,73,.466,6,18,.333,20,25,.800,106,2016-11-10,NOP,MIL
38,Home,W 112-105 ,240,39,99,.394,31,70,.443,8,29,.276,26,32,.813,112,36,91,.396,25,62,.403,11,29,.379,22,29,.759,105,2016-11-13,POR,DEN
39,@,L 112-119 ,240,41,86,.477,29,57,.509,12,29,.414,18,20,.900,112,44,81,.543,29,56,.518,15,25,.600,16,18,.889,119,2016-11-17,NYK,WAS
40,@,W 112-94 ,240,45,86,.523,34,61,.557,11,25,.440,11,12,.917,112,39,85,.459,29,56,.518,10,29,.345,6,10,.600,94,2016-11-22,NOP,ATL
41,@,W 112-100 ,240,40,75,.533,31,51,.608,9,24,.375,23,29,.793,112,42,88,.477,36,66,.545,6,22,.273,10,14,.714,100,2016-11-26,SAS,WAS
42,@,W 112-108 ,240,38,92,.413,26,52,.500,12,40,.300,24,28,.857,112,43,92,.467,28,58,.483,15,34,.441,7,10,.700,108,2016-11-27,CLE,PHI
43,@,W 112-104 ,240,40,83,.482,29,56,.518,11,27,.407,21,26,.808,112,38,80,.475,32,50,.640,6,30,.200,22,32,.688,104,2016-11-28,BOS,MIA
44,@,W 112-103 ,240,40,79,.506,36,61,.590,4,18,.222,28,34,.824,112,36,81,.444,29,62,.468,7,19,.368,24,25,.960,103,2016-11-28,UTA,MIN
45,@,W 112-103 ,240,46,92,.500,38,70,.543,8,22,.364,12,18,.667,112,36,91,.396,30,72,.417,6,19,.316,25,28,.893,103,2016-11-28,OKC,NYK
46,@,W 112-89 ,240,45,92,.489,33,64,.516,12,28,.429,10,11,.909,112,31,78,.397,22,51,.431,9,27,.333,18,21,.857,89,2016-11-29,DET,CHO
47,Home,W 112-103 ,240,40,85,.471,34,61,.557,6,24,.250,26,36,.722,112,34,91,.374,23,50,.460,11,41,.268,24,33,.727,103,2016-12-03,MIL,BRK
48,@,W 112-110 ,240,45,93,.484,36,69,.522,9,24,.375,13,18,.722,112,35,83,.422,28,60,.467,7,23,.304,33,38,.868,110,2016-12-05,POR,CHI
49,Home,L 112-116 ,240,38,88,.432,25,56,.446,13,32,.406,23,27,.852,112,40,84,.476,26,52,.500,14,32,.438,22,27,.815,116,2016-12-05,TOR,CLE
50,Home,W 112-105 ,240,36,73,.493,24,46,.522,12,27,.444,28,32,.875,112,39,84,.464,33,66,.500,6,18,.333,21,25,.840,105,2016-12-06,UTA,PHO
51,Home,L 112-118 ,240,42,88,.477,32,60,.533,10,28,.357,18,22,.818,112,41,84,.488,31,62,.500,10,22,.455,26,31,.839,118,2016-12-11,LAL,NYK
52,Home,W 112-92 ,240,45,77,.584,33,51,.647,12,26,.462,10,12,.833,112,35,83,.422,28,58,.483,7,25,.280,15,18,.833,92,2016-12-12,DAL,DEN
53,Home,W 112-101 ,240,45,88,.511,36,62,.581,9,26,.346,13,19,.684,112,39,84,.464,34,61,.557,5,23,.217,18,22,.818,101,2016-12-12,MIA,WAS
54,@,W 112-109 (OT),265,33,81,.407,21,44,.477,12,37,.324,34,38,.895,112,38,94,.404,26,64,.406,12,30,.400,21,26,.808,109,2016-12-20,BOS,MEM
55,Home,L 112-117 ,240,41,93,.441,32,65,.492,9,28,.321,21,26,.808,112,41,80,.513,30,54,.556,11,26,.423,24,36,.667,117,2016-12-23,BOS,OKC
56,Home,W 112-100 ,240,42,82,.512,34,58,.586,8,24,.333,20,24,.833,112,39,83,.470,35,71,.493,4,12,.333,18,23,.783,100,2016-12-25,OKC,MIN
57,Home,W 112-102 ,240,44,86,.512,31,60,.517,13,26,.500,11,16,.688,112,35,76,.461,25,51,.490,10,25,.400,22,28,.786,102,2016-12-26,ORL,MEM
58,@,W 112-98 ,240,44,87,.506,27,52,.519,17,35,.486,7,9,.778,112,31,72,.431,20,44,.455,11,28,.393,25,28,.893,98,2016-12-31,MEM,SAC
59,@,L 112-114 (OT),265,42,90,.467,33,63,.524,9,27,.333,19,22,.864,112,42,92,.457,28,64,.438,14,28,.500,16,27,.593,114,2017-01-01,SAS,ATL
60,@,L 112-123 ,240,42,96,.438,33,66,.500,9,30,.300,19,23,.826,112,37,80,.463,28,56,.500,9,24,.375,40,49,.816,123,2017-01-04,OKC,CHO
61,Home,W 112-105 ,240,46,79,.582,34,57,.596,12,22,.545,8,9,.889,112,42,88,.477,35,70,.500,7,18,.389,14,17,.824,105,2017-01-06,WAS,MIN
62,@,L 112-140 ,240,44,94,.468,32,65,.492,12,29,.414,12,13,.923,112,52,91,.571,37,59,.627,15,32,.469,21,23,.913,140,2017-01-12,IND,DEN
63,Home,L 112-137 ,240,41,93,.441,26,49,.531,15,44,.341,15,19,.789,112,46,92,.500,25,48,.521,21,44,.477,24,32,.750,137,2017-01-15,BRK,HOU
64,@,L 112-125 ,240,45,88,.511,37,63,.587,8,25,.320,14,18,.778,112,52,89,.584,43,62,.694,9,27,.333,12,15,.800,125,2017-01-16,ORL,DEN
65,@,W 112-107 (OT),265,38,82,.463,30,59,.508,8,23,.348,28,39,.718,112,39,87,.448,31,64,.484,8,23,.348,21,28,.750,107,2017-01-20,UTA,DAL
66,Home,W 112-96 ,240,40,87,.460,32,59,.542,8,28,.286,24,31,.774,112,34,84,.405,24,59,.407,10,25,.400,18,26,.692,96,2017-01-20,ORL,MIL
67,Home,W 112-105 ,240,39,82,.476,25,53,.472,14,29,.483,20,22,.909,112,38,89,.427,21,48,.438,17,41,.415,12,15,.800,105,2017-01-21,CHO,BRK
68,@,L 112-113 ,240,39,91,.429,31,65,.477,8,26,.308,26,33,.788,112,43,87,.494,32,59,.542,11,28,.393,16,22,.727,113,2017-01-21,WAS,DET
69,@,W 112-86 ,240,45,95,.474,36,73,.493,9,22,.409,13,16,.813,112,32,81,.395,27,56,.482,5,25,.200,17,18,.944,86,2017-01-23,SAS,BRK
70,@,W 112-111 ,240,44,84,.524,38,67,.567,6,17,.353,18,24,.750,112,38,86,.442,31,67,.463,7,19,.368,28,32,.875,111,2017-01-24,MIN,PHO
71,Home,L 112-116 (OT),265,40,82,.488,25,44,.568,15,38,.395,17,34,.500,112,43,95,.453,32,64,.500,11,31,.355,19,22,.864,116,2017-01-25,CLE,SAC
72,@,W 112-86 ,240,43,89,.483,30,58,.517,13,31,.419,13,19,.684,112,30,83,.361,21,52,.404,9,31,.290,17,25,.680,86,2017-01-27,WAS,ATL
73,Home,W 112-109 ,240,38,81,.469,22,46,.478,16,35,.457,20,21,.952,112,37,77,.481,28,51,.549,9,26,.346,26,33,.788,109,2017-01-27,POR,MEM
74,@,W 112-108 (OT),265,37,89,.416,23,49,.469,14,40,.350,24,30,.800,112,37,87,.425,28,66,.424,9,21,.429,25,32,.781,108,2017-01-28,BOS,MIL
75,Home,L 112-123 ,240,41,91,.451,35,70,.500,6,21,.286,24,32,.750,112,39,80,.488,31,55,.564,8,25,.320,37,42,.881,123,2017-01-28,PHO,DEN
76,Home,L 112-137 ,240,38,91,.418,27,63,.429,11,28,.393,25,30,.833,112,52,82,.634,45,65,.692,7,17,.412,26,35,.743,137,2017-02-04,PHO,MIL
77,@,W 112-107 ,240,43,81,.531,37,62,.597,6,19,.316,20,31,.645,112,41,79,.519,30,51,.588,11,28,.393,14,16,.875,107,2017-02-06,CHI,SAC
78,Home,W 112-109 ,240,39,80,.488,32,61,.525,7,19,.368,27,30,.900,112,42,79,.532,31,51,.608,11,28,.393,14,20,.700,109,2017-02-08,MIN,TOR
79,Home,W 112-105 (OT),265,44,87,.506,39,67,.582,5,20,.250,19,25,.760,112,39,85,.459,26,56,.464,13,29,.448,14,17,.824,105,2017-02-09,DAL,UTA
80,@,W 112-111 ,240,40,95,.421,29,67,.433,11,28,.393,21,27,.778,112,41,84,.488,31,63,.492,10,21,.476,19,24,.792,111,2017-02-09,PHI,ORL
81,Home,W 112-107 ,240,41,88,.466,31,59,.525,10,29,.345,20,30,.667,112,45,92,.489,41,71,.577,4,21,.190,13,15,.867,107,2017-02-10,WAS,IND
82,Home,W 112-80 ,240,45,91,.495,28,56,.500,17,35,.486,5,6,.833,112,32,82,.390,29,59,.492,3,23,.130,13,18,.722,80,2017-02-11,DAL,ORL
83,@,W 112-104 ,240,42,71,.592,29,41,.707,13,30,.433,15,23,.652,112,35,86,.407,27,55,.491,8,31,.258,26,30,.867,104,2017-02-11,BOS,UTA
84,@,W 112-103 ,240,39,77,.506,30,55,.545,9,22,.409,25,27,.926,112,38,82,.463,26,45,.578,12,37,.324,15,18,.833,103,2017-02-13,MEM,BRK
85,@,W 112-99 ,240,41,86,.477,35,68,.515,6,18,.333,24,28,.857,112,38,94,.404,27,60,.450,11,34,.324,12,18,.667,99,2017-02-15,MIN,DEN
86,@,W 112-103 ,240,41,81,.506,32,62,.516,9,19,.474,21,27,.778,112,34,86,.395,27,64,.422,7,22,.318,28,39,.718,103,2017-02-23,POR,ORL
87,@,L 112-120 ,240,38,90,.422,33,66,.500,5,24,.208,31,40,.775,112,43,87,.494,33,58,.569,10,29,.345,24,30,.800,120,2017-02-24,WAS,PHI
88,Home,W 112-95 ,240,42,100,.420,31,69,.449,11,31,.355,17,22,.773,112,38,94,.404,30,66,.455,8,28,.286,11,17,.647,95,2017-02-25,GSW,BRK
89,Home,W 112-106 ,240,42,78,.538,35,58,.603,7,20,.350,21,27,.778,112,35,79,.443,26,58,.448,9,21,.429,27,35,.771,106,2017-02-26,TOR,POR
90,@,L 112-130 ,240,43,83,.518,36,62,.581,7,21,.333,19,24,.792,112,48,86,.558,36,61,.590,12,25,.480,22,29,.759,130,2017-02-28,PHO,MEM
91,Home,W 112-108 ,240,41,91,.451,29,63,.460,12,28,.429,18,20,.900,112,39,84,.464,31,55,.564,8,29,.276,22,27,.815,108,2017-02-28,WAS,GSW
92,Home,W 112-101 ,240,44,80,.550,34,55,.618,10,25,.400,14,15,.933,112,36,64,.563,28,45,.622,8,19,.421,21,36,.583,101,2017-03-03,MIL,LAC
93,Home,W 112-97 ,240,38,74,.514,26,48,.542,12,26,.462,24,34,.706,112,36,89,.404,29,59,.492,7,30,.233,18,24,.750,97,2017-03-03,UTA,BRK
94,@,W 112-102 ,240,41,90,.456,25,63,.397,16,27,.593,14,17,.824,112,36,80,.450,27,50,.540,9,30,.300,21,25,.840,102,2017-03-04,CHO,DEN
95,@,W 112-105 ,240,40,88,.455,27,53,.509,13,35,.371,19,23,.826,112,39,83,.470,32,61,.525,7,22,.318,20,25,.800,105,2017-03-05,GSW,NYK
96,@,W 112-98 ,240,41,83,.494,27,50,.540,14,33,.424,16,20,.800,112,39,89,.438,31,59,.525,8,30,.267,12,19,.632,98,2017-03-06,MIL,PHI
97,Home,W 112-110 ,240,40,87,.460,29,60,.483,11,27,.407,21,23,.913,112,41,88,.466,27,49,.551,14,39,.359,14,17,.824,110,2017-03-06,SAS,HOU
98,Home,W 111-102 ,240,41,79,.519,33,59,.559,8,20,.400,21,23,.913,111,35,87,.402,31,67,.463,4,20,.200,28,33,.848,102,2011-12-29,POR,DEN
99,Home,W 111-106 (OT),265,38,95,.400,29,68,.426,9,27,.333,26,30,.867,111,39,85,.459,37,74,.500,2,11,.182,26,40,.650,106,2012-01-10,GSW,MIA
0,@,W 111-100 ,240,43,81,.531,32,61,.525,11,20,.550,14,21,.667,111,33,78,.423,25,56,.446,8,22,.364,26,32,.813,100,2012-01-10,CHI,MIN
1,Home,W 111-81 ,240,42,90,.467,36,71,.507,6,19,.316,21,28,.750,111,33,78,.423,32,70,.457,1,8,.125,14,16,.875,81,2012-01-12,ATL,CHA
2,@,W 111-78 ,240,39,78,.500,32,59,.542,7,19,.368,26,33,.788,111,27,82,.329,24,71,.338,3,11,.273,21,22,.955,78,2012-01-24,NYK,CHA
3,@,W 111-106 (2OT),290,43,96,.448,33,68,.485,10,28,.357,15,19,.789,111,39,90,.433,35,72,.486,4,18,.222,24,36,.667,106,2012-01-25,TOR,UTA
4,@,W 111-107 (OT),265,43,95,.453,37,73,.507,6,22,.273,19,22,.864,111,41,97,.423,36,77,.468,5,20,.250,20,26,.769,107,2012-02-06,OKC,POR
5,Home,W 111-108 (OT),265,39,80,.488,36,71,.507,3,9,.333,30,41,.732,111,34,85,.400,21,59,.356,13,26,.500,27,34,.794,108,2012-02-06,WAS,TOR
6,@,W 111-86 ,240,41,78,.526,33,58,.569,8,20,.400,21,24,.875,111,26,74,.351,25,60,.417,1,14,.071,33,43,.767,86,2012-02-11,LAC,CHA
7,Home,W 111-85 ,240,42,77,.545,37,63,.587,5,14,.357,22,34,.647,111,32,90,.356,29,77,.377,3,13,.231,18,24,.750,85,2012-02-14,OKC,UTA
8,@,W 111-87 ,240,40,79,.506,26,58,.448,14,21,.667,17,20,.850,111,30,76,.395,24,60,.400,6,16,.375,21,31,.677,87,2012-02-17,MIA,CLE
9,@,W 111-98 ,240,43,77,.558,38,62,.613,5,15,.333,20,23,.870,111,40,85,.471,30,65,.462,10,20,.500,8,10,.800,98,2012-02-17,MIN,HOU
10,Home,W 111-99 ,240,44,83,.530,39,72,.542,5,11,.455,18,24,.750,111,41,90,.456,33,64,.516,8,26,.308,9,13,.692,99,2012-02-17,LAL,PHO
11,@,L 111-115 (OT),265,41,94,.436,33,76,.434,8,18,.444,21,26,.808,111,45,103,.437,38,85,.447,7,18,.389,18,22,.818,115,2012-03-04,NYK,BOS
12,Home,W 111-97 ,240,43,77,.558,36,59,.610,7,18,.389,18,24,.750,111,40,85,.471,40,82,.488,0,3,.000,17,22,.773,97,2012-03-10,CHI,UTA
13,Home,W 111-87 ,240,40,74,.541,30,49,.612,10,25,.400,21,25,.840,111,28,75,.373,18,52,.346,10,23,.435,21,26,.808,87,2012-03-10,GSW,DAL
14,Home,L 111-116 (2OT),290,52,116,.448,50,97,.515,2,19,.105,5,5,1.000,111,41,83,.494,35,63,.556,6,20,.300,28,34,.824,116,2012-03-13,MEM,LAL
15,Home,W 111-94 ,240,43,76,.566,36,59,.610,7,17,.412,18,22,.818,111,40,76,.526,34,63,.540,6,13,.462,8,10,.800,94,2012-03-14,IND,PHI
16,@,L 111-120 ,240,47,90,.522,42,77,.545,5,13,.385,12,17,.706,111,44,78,.564,35,59,.593,9,19,.474,23,32,.719,120,2012-03-14,UTA,PHO
17,@,L 111-122 ,240,45,86,.523,34,59,.576,11,27,.407,10,16,.625,111,43,83,.518,30,57,.526,13,26,.500,23,27,.852,122,2012-03-14,ORL,SAS
18,Home,W 111-105 (OT),265,43,103,.417,38,90,.422,5,13,.385,20,27,.741,111,36,83,.434,27,56,.482,9,27,.333,24,33,.727,105,2012-03-15,UTA,MIN
19,Home,W 111-95 ,240,41,74,.554,30,56,.536,11,18,.611,18,28,.643,111,39,84,.464,31,63,.492,8,21,.381,9,14,.643,95,2012-03-18,OKC,POR
20,Home,L 111-113 ,240,42,81,.519,35,70,.500,7,11,.636,20,22,.909,111,41,84,.488,36,67,.537,5,17,.294,26,37,.703,113,2012-03-23,IND,PHO
21,Home,W 111-108 ,240,43,88,.489,36,67,.537,7,21,.333,18,21,.857,111,43,91,.473,42,76,.553,1,15,.067,21,27,.778,108,2012-03-24,GSW,SAC
22,@,W 111-99 ,240,43,92,.467,33,64,.516,10,28,.357,15,20,.750,111,39,90,.433,36,73,.493,3,17,.176,18,23,.783,99,2012-03-31,NJN,SAC
23,@,W 111-107 ,240,41,80,.513,35,64,.547,6,16,.375,23,27,.852,111,42,85,.494,34,60,.567,8,25,.320,15,24,.625,107,2012-04-11,NYK,MIL
24,Home,W 111-88 ,240,39,88,.443,28,64,.438,11,24,.458,22,25,.880,111,32,87,.368,25,62,.403,7,25,.280,17,25,.680,88,2012-04-16,IND,MIN
25,@,L 111-114 ,240,39,77,.506,24,46,.522,15,31,.484,18,22,.818,111,42,85,.494,29,56,.518,13,29,.448,17,21,.810,114,2012-11-21,NYK,DAL
26,@,L 111-117 (OT),265,40,93,.430,33,73,.452,7,20,.350,24,33,.727,111,36,79,.456,25,56,.446,11,23,.478,34,39,.872,117,2012-11-21,LAC,OKC
27,Home,W 111-108 (OT),265,44,90,.489,33,65,.508,11,25,.440,12,19,.632,111,40,78,.513,27,52,.519,13,26,.500,15,18,.833,108,2012-11-23,PHO,NOH
28,@,W 111-106 (2OT),290,44,103,.427,36,76,.474,8,27,.296,15,19,.789,111,40,110,.364,34,86,.395,6,24,.250,20,24,.833,106,2012-11-25,SAS,TOR
29,Home,L 111-113 ,240,38,78,.487,26,58,.448,12,20,.600,23,32,.719,111,41,85,.482,31,62,.500,10,23,.435,21,22,.955,113,2012-11-30,ATL,CLE
30,Home,L 111-117 ,240,39,91,.429,25,57,.439,14,34,.412,19,23,.826,111,40,66,.606,33,52,.635,7,14,.500,30,34,.882,117,2012-12-04,BRK,OKC
31,@,W 111-85 ,240,44,82,.537,39,71,.549,5,11,.455,18,24,.750,111,30,83,.361,23,62,.371,7,21,.333,18,25,.720,85,2012-12-15,LAC,MIL
32,@,W 111-98 ,240,39,80,.488,25,46,.543,14,34,.412,19,24,.792,111,41,83,.494,31,58,.534,10,25,.400,6,11,.545,98,2012-12-16,LAL,PHI
33,Home,W 111-105 (OT),265,39,93,.419,29,68,.426,10,25,.400,23,28,.821,111,40,95,.421,29,71,.408,11,24,.458,14,16,.875,105,2012-12-27,OKC,DAL
34,Home,W 111-107 ,240,45,89,.506,40,71,.563,5,18,.278,16,26,.615,111,45,97,.464,43,80,.538,2,17,.118,15,24,.625,107,2012-12-29,MIN,PHO
35,@,W 111-86 ,240,41,81,.506,33,62,.532,8,19,.421,21,24,.875,111,38,95,.400,37,79,.468,1,16,.063,9,10,.900,86,2012-12-30,SAS,DAL
36,@,L 111-115 (OT),265,42,88,.477,34,61,.557,8,27,.296,19,23,.826,111,47,99,.475,38,74,.514,9,25,.360,12,19,.632,115,2013-01-15,POR,DEN
37,@,W 111-99 ,240,44,83,.530,34,65,.523,10,18,.556,13,18,.722,111,39,82,.476,28,61,.459,11,21,.524,10,13,.769,99,2013-01-15,NOH,PHI
38,@,W 111-105 ,240,45,90,.500,37,75,.493,8,15,.533,13,15,.867,111,40,79,.506,31,58,.534,9,21,.429,16,20,.800,105,2013-01-20,DAL,ORL
39,@,L 111-123 (2OT),290,42,93,.452,35,74,.473,7,19,.368,20,20,1.000,111,42,94,.447,30,58,.517,12,36,.333,27,36,.750,123,2013-01-25,BOS,ATL
40,Home,W 111-106 ,240,39,79,.494,27,46,.587,12,33,.364,21,33,.636,111,39,92,.424,30,73,.411,9,19,.474,19,21,.905,106,2013-01-29,LAL,NOH
41,@,W 111-100 ,240,39,92,.424,27,60,.450,12,32,.375,21,25,.840,111,41,89,.461,31,67,.463,10,22,.455,8,18,.444,100,2013-02-01,LAL,MIN
42,Home,W 111-101 ,240,39,74,.527,33,60,.550,6,14,.429,27,34,.794,111,39,88,.443,35,72,.486,4,16,.250,19,22,.864,101,2013-02-04,IND,CHI
43,@,W 111-100 ,240,45,86,.523,36,70,.514,9,16,.563,12,18,.667,111,35,74,.473,22,50,.440,13,24,.542,17,23,.739,100,2013-02-08,NOH,ATL
44,Home,W 111-89 ,240,36,68,.529,21,41,.512,15,27,.556,24,32,.750,111,34,77,.442,27,61,.443,7,16,.438,14,19,.737,89,2013-02-08,MIA,LAC
45,@,W 111-103 ,240,40,80,.500,34,63,.540,6,17,.353,25,34,.735,111,37,84,.440,28,64,.438,9,20,.450,20,26,.769,103,2013-02-09,DEN,CLE
46,@,W 111-86 ,240,43,73,.589,31,54,.574,12,19,.632,13,20,.650,111,34,72,.472,28,53,.528,6,19,.316,12,17,.706,86,2013-02-10,SAS,BRK
47,@,L 111-117 ,240,44,89,.494,34,56,.607,10,33,.303,13,17,.765,111,40,87,.460,29,67,.433,11,20,.550,26,27,.963,117,2013-02-10,HOU,SAC
48,@,L 111-113 (OT),265,46,96,.479,39,76,.513,7,20,.350,12,18,.667,111,43,91,.473,33,72,.458,10,19,.526,17,23,.739,113,2013-02-19,MIL,BRK
49,Home,W 111-96 ,240,42,88,.477,31,59,.525,11,29,.379,16,18,.889,111,39,85,.459,34,69,.493,5,16,.313,13,22,.591,96,2013-02-20,DAL,ORL
50,Home,W 111-107 ,240,40,85,.471,34,67,.507,6,18,.333,25,34,.735,111,46,94,.489,38,74,.514,8,20,.400,7,12,.583,107,2013-02-22,LAL,POR
51,@,L 111-127 ,240,41,85,.482,35,68,.515,6,17,.353,23,29,.793,111,48,83,.578,39,69,.565,9,14,.643,22,22,1.000,127,2013-02-22,MIN,OKC
52,@,W 111-109 ,240,45,87,.517,42,73,.575,3,14,.214,18,31,.581,111,38,85,.447,28,60,.467,10,25,.400,23,27,.852,109,2013-02-27,DEN,POR
53,Home,W 111-88 ,240,42,78,.538,33,61,.541,9,17,.529,18,22,.818,111,35,84,.417,30,66,.455,5,18,.278,13,19,.684,88,2013-03-09,DEN,MIN
54,Home,W 111-81 ,240,39,76,.513,29,55,.527,10,21,.476,23,30,.767,111,34,81,.420,28,60,.467,6,21,.286,7,10,.700,81,2013-03-13,HOU,PHO
55,@,W 111-90 ,240,39,88,.443,31,66,.470,8,22,.364,25,29,.862,111,35,92,.380,29,68,.426,6,24,.250,14,21,.667,90,2013-03-18,IND,CLE
56,@,W 111-93 ,240,46,95,.484,41,75,.547,5,20,.250,14,25,.560,111,36,82,.439,28,64,.438,8,18,.444,13,21,.619,93,2013-03-27,BRK,POR
57,Home,W 111-102 ,240,38,77,.494,29,58,.500,9,19,.474,26,30,.867,111,34,73,.466,24,47,.511,10,26,.385,24,31,.774,102,2013-03-29,NYK,CHA
58,Home,W 111-103 ,240,44,98,.449,35,69,.507,9,29,.310,14,22,.636,111,39,93,.419,33,78,.423,6,15,.400,19,21,.905,103,2013-04-01,HOU,ORL
59,@,W 111-107 ,240,44,86,.512,35,70,.500,9,16,.563,14,16,.875,111,44,72,.611,39,58,.672,5,14,.357,14,17,.824,107,2013-04-05,GSW,PHO
60,@,W 111-104 ,240,40,80,.500,36,64,.563,4,16,.250,27,42,.643,111,40,82,.488,37,67,.552,3,15,.200,21,26,.808,104,2013-04-10,DET,CLE
61,Home,W 111-95 ,240,44,77,.571,33,56,.589,11,21,.524,12,16,.750,111,35,90,.389,29,67,.433,6,23,.261,19,22,.864,95,2013-04-10,LAC,MIN
62,@,L 111-118 (OT),265,42,104,.404,32,74,.432,10,30,.333,17,22,.773,111,39,87,.448,29,60,.483,10,27,.370,30,37,.811,118,2013-04-11,NYK,CHI
63,Home,L 111-112 ,240,42,100,.420,30,65,.462,12,35,.343,15,23,.652,111,37,85,.435,31,71,.437,6,14,.429,32,46,.696,112,2013-04-15,MIL,DEN
64,Home,W 111-108 (OT),265,40,77,.519,34,59,.576,6,18,.333,25,30,.833,111,42,89,.472,35,68,.515,7,21,.333,17,24,.708,108,2013-11-01,MEM,DET
65,Home,W 111-99 ,240,32,80,.400,25,61,.410,7,19,.368,40,46,.870,111,37,87,.425,34,71,.479,3,16,.188,22,26,.846,99,2013-11-02,DAL,MEM
66,@,W 111-110 ,240,46,89,.517,36,68,.529,10,21,.476,9,12,.750,111,41,71,.577,36,61,.590,5,10,.500,23,34,.676,110,2013-11-09,BOS,MIA
67,Home,W 111-99 ,240,40,100,.400,34,79,.430,6,21,.286,25,37,.676,111,37,94,.394,29,73,.397,8,21,.381,17,26,.654,99,2013-11-13,DEN,LAL
68,Home,W 111-103 ,240,39,86,.453,33,58,.569,6,28,.214,27,34,.794,111,35,75,.467,29,59,.492,6,16,.375,27,33,.818,103,2013-11-13,LAC,OKC
69,Home,W 111-105 ,240,37,72,.514,28,50,.560,9,22,.409,28,39,.718,111,42,85,.494,37,73,.507,5,12,.417,16,20,.800,105,2013-11-13,UTA,NOP
70,@,L 111-122 ,240,45,99,.455,37,75,.493,8,24,.333,13,18,.722,111,41,81,.506,32,60,.533,9,21,.429,31,44,.705,122,2013-11-16,DEN,HOU
71,Home,W 111-81 ,240,40,97,.412,29,61,.475,11,36,.306,20,23,.870,111,31,78,.397,26,62,.419,5,16,.313,14,20,.700,81,2013-11-22,MIN,BRK
72,@,L 111-116 ,240,44,83,.530,31,55,.564,13,28,.464,10,13,.769,111,46,87,.529,40,66,.606,6,21,.286,18,22,.818,116,2013-11-26,LAL,WAS
73,@,W 111-87 ,240,43,85,.506,36,67,.537,7,18,.389,18,28,.643,111,30,75,.400,28,59,.475,2,16,.125,25,34,.735,87,2013-12-03,DEN,BRK
74,Home,W 111-104 ,240,44,98,.449,36,75,.480,8,23,.348,15,17,.882,111,39,89,.438,34,78,.436,5,11,.455,21,24,.875,104,2013-12-04,POR,OKC
75,@,W 111-100 ,240,38,71,.535,29,52,.558,9,19,.474,26,28,.929,111,41,91,.451,28,65,.431,13,26,.500,5,6,.833,100,2013-12-07,IND,SAS
76,@,L 111-115 ,240,41,90,.456,30,53,.566,11,37,.297,18,22,.818,111,43,94,.457,37,82,.451,6,12,.500,23,29,.793,115,2013-12-09,GSW,CHA
77,Home,W 111-106 (OT),265,38,84,.452,29,61,.475,9,23,.391,26,32,.813,111,42,96,.438,37,75,.493,5,21,.238,17,27,.630,106,2013-12-11,NOP,DET
78,Home,W 111-104 ,240,39,89,.438,31,62,.500,8,27,.296,25,30,.833,111,40,94,.426,35,74,.473,5,20,.250,19,24,.792,104,2013-12-12,POR,HOU
79,Home,W 111-106 ,240,44,87,.506,36,68,.529,8,19,.421,15,18,.833,111,40,66,.606,25,34,.735,15,32,.469,11,11,1.000,106,2013-12-14,NYK,ATL
80,@,W 111-109 (OT),265,41,99,.414,34,73,.466,7,26,.269,22,26,.846,111,44,94,.468,41,79,.519,3,15,.200,18,27,.667,109,2013-12-15,POR,DET
81,@,L 111-114 (OT),265,40,100,.400,30,71,.423,10,29,.345,21,25,.840,111,39,100,.390,28,72,.389,11,28,.393,25,27,.926,114,2013-12-20,MIL,CLE
82,Home,W 111-110 (OT),265,43,99,.434,33,82,.402,10,17,.588,15,20,.750,111,42,97,.433,32,69,.464,10,28,.357,16,17,.941,110,2013-12-23,CHA,MIL
83,@,W 111-104 ,240,40,79,.506,29,57,.509,11,22,.500,20,23,.870,111,38,70,.543,31,51,.608,7,19,.368,21,29,.724,104,2013-12-23,DAL,HOU
84,@,W 111-98 ,240,45,86,.523,33,62,.532,12,24,.500,9,18,.500,111,37,91,.407,32,71,.451,5,20,.250,19,23,.826,98,2013-12-25,HOU,SAS
85,@,W 111-104 ,240,39,95,.411,33,71,.465,6,24,.250,27,33,.818,111,31,84,.369,19,47,.404,12,37,.324,30,34,.882,104,2013-12-29,PHI,LAL
86,Home,W 111-108 ,240,43,80,.538,34,58,.586,9,22,.409,16,21,.762,111,37,76,.487,32,64,.500,5,12,.417,29,38,.763,108,2014-01-03,DEN,MEM
87,Home,L 111-115 ,240,43,94,.457,36,74,.486,7,20,.350,18,29,.621,111,40,83,.482,32,59,.542,8,24,.333,27,28,.964,115,2014-01-04,MIN,OKC
88,Home,W 111-93 ,240,44,89,.494,31,61,.508,13,28,.464,10,18,.556,111,34,86,.395,30,67,.448,4,19,.211,21,27,.778,93,2014-01-07,CLE,PHI
89,Home,W 111-105 ,240,36,79,.456,25,49,.510,11,30,.367,28,39,.718,111,39,83,.470,34,66,.515,5,17,.294,22,30,.733,105,2014-01-08,LAC,BOS
90,@,W 111-108 ,240,45,82,.549,40,70,.571,5,12,.417,16,19,.842,111,39,88,.443,31,68,.456,8,20,.400,22,29,.759,108,2014-01-15,SAC,MIN
91,@,W 111-101 ,240,39,74,.527,32,59,.542,7,15,.467,26,35,.743,111,38,82,.463,28,57,.491,10,25,.400,15,21,.714,101,2014-01-17,CHA,ORL
92,Home,L 111-127 ,240,42,90,.467,35,72,.486,7,18,.389,20,25,.800,111,46,90,.511,37,64,.578,9,26,.346,26,28,.929,127,2014-01-18,DAL,POR
93,@,W 111-105 ,240,45,83,.542,35,65,.538,10,18,.556,11,16,.688,111,40,75,.533,30,53,.566,10,22,.455,15,22,.682,105,2014-01-22,OKC,SAS
94,Home,L 111-113 (OT),265,42,94,.447,35,72,.486,7,22,.318,20,27,.741,111,41,89,.461,26,55,.473,15,34,.441,16,23,.696,113,2014-01-22,WAS,BOS
95,Home,L 111-116 (OT),265,39,101,.386,27,69,.391,12,32,.375,21,29,.724,111,41,95,.432,33,71,.465,8,24,.333,26,33,.788,116,2014-01-24,SAC,IND
96,Home,W 111-109 ,240,43,82,.524,30,57,.526,13,25,.520,12,18,.667,111,43,88,.489,31,63,.492,12,25,.480,11,12,.917,109,2014-01-27,OKC,ATL
97,Home,W 111-92 ,240,45,91,.495,39,70,.557,6,21,.286,15,20,.750,111,31,76,.408,23,52,.442,8,24,.333,22,34,.647,92,2014-01-30,GSW,LAC
98,Home,W 111-95 ,240,43,84,.512,34,67,.507,9,17,.529,16,24,.667,111,32,89,.360,20,58,.345,12,31,.387,19,29,.655,95,2014-02-07,DET,BRK
99,@,W 111-110 ,240,42,78,.538,32,56,.571,10,22,.455,17,25,.680,111,40,83,.482,31,67,.463,9,16,.563,21,26,.808,110,2014-02-12,MIA,GSW
0,@,W 111-109 ,240,43,88,.489,34,64,.531,9,24,.375,16,21,.762,111,42,93,.452,35,71,.493,7,22,.318,18,25,.720,109,2014-02-19,SAS,POR
1,Home,W 111-87 ,240,40,79,.506,31,56,.554,9,23,.391,22,26,.846,111,34,79,.430,30,66,.455,4,13,.308,15,18,.833,87,2014-03-06,SAS,MIA
2,Home,W 111-97 ,240,43,80,.538,37,61,.607,6,19,.316,19,24,.792,111,39,86,.453,31,52,.596,8,34,.235,11,13,.846,97,2014-03-07,GSW,ATL
3,Home,W 111-89 ,240,44,87,.506,37,74,.500,7,13,.538,16,22,.727,111,37,93,.398,32,72,.444,5,21,.238,10,14,.714,89,2014-03-08,MEM,CHA
4,@,L 111-118 ,240,40,86,.465,36,71,.507,4,15,.267,27,39,.692,111,47,97,.485,37,66,.561,10,31,.323,14,21,.667,118,2014-03-09,DET,BOS
5,@,W 111-104 ,240,37,76,.487,23,52,.442,14,24,.583,23,31,.742,111,41,95,.432,34,76,.447,7,19,.368,15,20,.750,104,2014-03-09,TOR,MIN
6,Home,W 111-107 (OT),265,41,90,.456,36,76,.474,5,14,.357,24,33,.727,111,40,85,.471,33,62,.532,7,23,.304,20,26,.769,107,2014-03-09,NOP,DEN
7,Home,W 111-98 ,240,43,88,.489,35,70,.500,8,18,.444,17,24,.708,111,36,82,.439,28,61,.459,8,21,.381,18,25,.720,98,2014-03-12,LAC,GSW
8,Home,W 111-87 ,240,43,86,.500,29,62,.468,14,24,.583,11,13,.846,111,28,79,.354,23,53,.434,5,26,.192,26,34,.765,87,2014-03-13,CHI,HOU
9,@,W 111-107 ,240,39,82,.476,31,61,.508,8,21,.381,25,29,.862,111,42,81,.519,35,57,.614,7,24,.292,16,21,.762,107,2014-03-14,DEN,MIA
10,@,W 111-103 ,240,38,78,.487,24,45,.533,14,33,.424,21,27,.778,111,41,86,.477,38,75,.507,3,11,.273,18,21,.857,103,2014-03-14,POR,NOP
11,@,L 111-117 (OT),265,40,91,.440,29,63,.460,11,28,.393,20,30,.667,111,40,87,.460,34,69,.493,6,18,.333,31,40,.775,117,2014-03-18,WAS,SAC
12,@,W 111-105 ,240,36,70,.514,32,57,.561,4,13,.308,35,43,.814,111,38,85,.447,30,57,.526,8,28,.286,21,27,.778,105,2014-03-21,NOP,ATL
13,Home,L 111-118 ,240,46,92,.500,40,75,.533,6,17,.353,13,17,.765,111,38,79,.481,26,44,.591,12,35,.343,30,34,.882,118,2014-03-22,CLE,HOU
14,@,L 111-116 (OT),265,40,83,.482,23,46,.500,17,37,.459,14,16,.875,111,46,92,.500,38,71,.535,8,21,.381,16,23,.696,116,2014-03-26,BRK,CHA
15,@,L 111-116 ,240,39,88,.443,34,71,.479,5,17,.294,28,36,.778,111,46,97,.474,37,74,.500,9,23,.391,15,21,.714,116,2014-03-31,MIL,DET
16,Home,W 111-90 ,240,44,83,.530,40,64,.625,4,19,.211,19,22,.864,111,36,85,.424,28,64,.438,8,21,.381,10,10,1.000,90,2014-04-02,SAS,GSW
17,@,W 111-102 ,240,39,77,.506,33,58,.569,6,19,.316,27,37,.730,111,38,87,.437,29,54,.537,9,33,.273,17,21,.810,102,2014-04-04,PHI,BOS
18,Home,W 111-107 ,240,33,78,.423,20,47,.426,13,31,.419,32,37,.865,111,38,85,.447,25,54,.463,13,31,.419,18,20,.900,107,2014-04-04,HOU,OKC
19,@,L 111-115 ,240,42,88,.477,28,57,.491,14,31,.452,13,16,.813,111,38,79,.481,29,56,.518,9,23,.391,30,36,.833,115,2014-04-05,BOS,DET
20,@,L 111-115 ,240,38,79,.481,28,50,.560,10,29,.345,25,34,.735,111,43,77,.558,32,53,.604,11,24,.458,18,30,.600,115,2014-04-09,BRK,ORL
21,@,W 111-99 ,240,40,87,.460,29,65,.446,11,22,.500,20,24,.833,111,40,86,.465,34,73,.466,6,13,.462,13,16,.813,99,2014-04-11,POR,UTA
22,Home,W 111-105 ,240,39,72,.542,32,53,.604,7,19,.368,26,41,.634,111,41,93,.441,36,68,.529,5,25,.200,18,26,.692,105,2014-04-12,CHA,PHI
23,@,W 111-99 ,240,42,90,.467,30,60,.500,12,30,.400,15,18,.833,111,37,90,.411,32,72,.444,5,18,.278,20,30,.667,99,2014-04-12,BOS,CLE
24,Home,W 111-104 ,240,35,74,.473,25,47,.532,10,27,.370,31,39,.795,111,39,88,.443,30,66,.455,9,22,.409,17,21,.810,104,2014-04-12,HOU,NOP
25,@,W 111-103 ,240,41,76,.539,33,52,.635,8,24,.333,21,26,.808,111,40,77,.519,33,59,.559,7,18,.389,16,21,.762,103,2014-04-16,ATL,MIL
26,@,L 111-112 ,240,42,83,.506,34,64,.531,8,19,.421,19,31,.613,111,38,86,.442,33,63,.524,5,23,.217,31,41,.756,112,2014-04-16,DET,OKC
27,Home,L 111-118 ,240,42,82,.512,35,62,.565,7,20,.350,20,28,.714,111,34,71,.479,22,38,.579,12,33,.364,38,44,.864,118,2014-10-31,LAL,LAC
28,@,L 111-118 ,240,41,93,.441,29,66,.439,12,27,.444,17,20,.850,111,40,81,.494,27,54,.500,13,27,.481,25,30,.833,118,2014-11-10,NOP,CLE
29,Home,W 111-110 ,240,39,77,.506,33,68,.485,6,9,.667,27,34,.794,111,37,77,.481,30,64,.469,7,13,.538,29,34,.853,110,2014-11-13,MEM,SAC
30,Home,W 111-93 ,240,43,84,.512,35,63,.556,8,21,.381,17,23,.739,111,33,75,.440,28,59,.475,5,16,.313,22,30,.733,93,2014-11-15,TOR,UTA
31,@,W 111-100 ,240,43,93,.462,35,75,.467,8,18,.444,17,22,.773,111,36,84,.429,31,69,.449,5,15,.333,23,26,.885,100,2014-11-22,WAS,MIL
32,@,W 111-100 ,240,37,77,.481,24,51,.471,13,26,.500,24,36,.667,111,40,80,.500,32,56,.571,8,24,.333,12,21,.571,100,2014-11-24,IND,DAL
33,@,W 111-96 ,240,44,85,.518,32,59,.542,12,26,.462,11,19,.579,111,36,87,.414,30,67,.448,6,20,.300,18,24,.750,96,2014-11-26,GSW,ORL
34,@,W 111-89 ,240,41,85,.482,30,59,.508,11,26,.423,18,20,.900,111,36,87,.414,30,69,.435,6,18,.333,11,15,.733,89,2014-11-30,SAS,BOS
35,Home,W 111-108 ,240,39,73,.534,33,52,.635,6,21,.286,27,38,.711,111,45,92,.489,38,72,.528,7,20,.350,11,13,.846,108,2014-12-02,CLE,MIL
36,Home,W 111-95 ,240,45,93,.484,39,74,.527,6,19,.316,15,19,.789,111,33,85,.388,21,56,.375,12,29,.414,17,21,.810,95,2014-12-03,WAS,LAL
37,@,W 111-92 ,240,45,88,.511,39,64,.609,6,24,.250,15,20,.750,111,36,78,.462,35,71,.493,1,7,.143,19,29,.655,92,2014-12-12,OKC,MIN
38,Home,W 111-106 ,240,43,76,.566,36,65,.554,7,11,.636,18,24,.750,111,39,91,.429,25,62,.403,14,29,.483,14,19,.737,106,2014-12-13,MIL,LAC
39,@,L 111-119 ,240,45,90,.500,40,75,.533,5,15,.333,16,19,.842,111,47,79,.595,39,63,.619,8,16,.500,17,18,.944,119,2014-12-16,UTA,NOP
40,@,W 111-106 ,240,43,82,.524,34,57,.596,9,25,.360,16,21,.762,111,40,86,.465,30,62,.484,10,24,.417,16,22,.727,106,2014-12-17,PHO,CHO
41,Home,L 111-115 (OT),265,40,99,.404,27,69,.391,13,30,.433,18,23,.783,111,35,85,.412,27,57,.474,8,28,.286,37,48,.771,115,2014-12-17,DEN,HOU
42,Home,L 111-115 (OT),265,46,101,.455,40,82,.488,6,19,.316,13,15,.867,111,38,91,.418,21,60,.350,17,31,.548,22,24,.917,115,2014-12-23,OKC,POR
43,Home,L 111-117 (OT),265,43,104,.413,36,80,.450,7,24,.292,18,23,.783,111,41,91,.451,27,57,.474,14,34,.412,21,28,.750,117,2014-12-26,MEM,HOU
44,@,W 111-103 ,240,40,76,.526,26,51,.510,14,25,.560,17,26,.654,111,39,87,.448,31,61,.508,8,26,.308,17,27,.630,103,2014-12-30,LAL,DEN
45,Home,W 111-83 ,240,44,83,.530,37,68,.544,7,15,.467,16,20,.800,111,35,88,.398,29,59,.492,6,29,.207,7,11,.636,83,2015-01-02,NOP,HOU
46,Home,L 111-113 ,240,44,92,.478,37,75,.493,7,17,.412,16,19,.842,111,46,96,.479,41,70,.586,5,26,.192,16,19,.842,113,2015-01-07,MIN,PHO
47,Home,L 111-114 ,240,47,87,.540,40,60,.667,7,27,.259,10,14,.714,111,41,96,.427,34,75,.453,7,21,.333,25,31,.806,114,2015-01-12,TOR,DET
48,Home,W 111-76 ,240,45,81,.556,38,68,.559,7,13,.538,14,18,.778,111,28,85,.329,22,61,.361,6,24,.250,14,23,.609,76,2015-01-19,WAS,PHI
49,Home,L 111-113 ,240,42,91,.462,32,61,.525,10,30,.333,17,24,.708,111,44,84,.524,34,57,.596,10,27,.370,15,20,.750,113,2015-01-23,PHO,HOU
50,@,L 111-114 ,240,41,95,.432,31,67,.463,10,28,.357,19,27,.704,111,42,89,.472,34,66,.515,8,23,.348,22,25,.880,114,2015-01-25,BOS,GSW
51,Home,L 111-113 (OT),265,48,113,.425,39,80,.488,9,33,.273,6,12,.500,111,42,98,.429,34,69,.493,8,29,.276,21,23,.913,113,2015-01-27,GSW,CHI
52,@,L 111-117 ,240,48,95,.505,44,78,.564,4,17,.235,11,15,.733,111,41,81,.506,26,49,.531,15,32,.469,20,29,.690,117,2015-02-06,MIL,HOU
53,Home,W 111-101 (OT),265,43,105,.410,29,69,.420,14,36,.389,11,16,.688,111,37,89,.416,27,57,.474,10,32,.313,17,24,.708,101,2015-02-07,DAL,POR
54,Home,W 111-103 ,240,39,80,.488,32,65,.492,7,15,.467,26,32,.813,111,36,84,.429,28,62,.452,8,22,.364,23,30,.767,103,2015-02-11,MIL,SAC
55,Home,W 111-100 ,240,44,93,.473,35,69,.507,9,24,.375,14,18,.778,111,36,87,.414,24,50,.480,12,37,.324,16,26,.615,100,2015-02-20,DAL,HOU
56,Home,W 111-109 ,240,40,86,.465,36,71,.507,4,15,.267,27,38,.711,111,40,89,.449,33,72,.458,7,17,.412,22,31,.710,109,2015-02-20,MIN,PHO
57,@,W 111-87 ,240,38,79,.481,29,59,.492,9,20,.450,26,35,.743,111,35,82,.427,29,64,.453,6,18,.333,11,16,.688,87,2015-02-20,MIA,NYK
58,@,L 111-118 (OT),265,42,98,.429,34,65,.523,8,33,.242,19,27,.704,111,43,84,.512,36,66,.545,7,18,.389,25,38,.658,118,2015-02-22,BOS,LAL
59,Home,W 111-95 ,240,43,85,.506,30,59,.508,13,26,.500,12,15,.800,111,37,85,.435,29,64,.453,8,21,.381,13,14,.929,95,2015-02-25,POR,SAS
60,@,L 111-120 ,240,45,86,.523,39,69,.565,6,17,.353,15,23,.652,111,43,79,.544,34,55,.618,9,24,.375,25,33,.758,120,2015-03-06,DEN,SAS
61,@,W 111-91 ,240,45,87,.517,33,66,.500,12,21,.571,9,11,.818,111,35,84,.417,29,68,.426,6,16,.375,15,23,.652,91,2015-03-10,NOP,BRK
62,Home,L 111-118 (2OT),290,46,99,.465,40,77,.519,6,22,.273,13,21,.619,111,46,104,.442,36,73,.493,10,31,.323,16,20,.800,118,2015-03-15,NOP,DEN
63,Home,W 111-104 ,240,43,94,.457,38,82,.463,5,12,.417,20,24,.833,111,38,80,.475,31,56,.554,7,24,.292,21,24,.875,104,2015-03-20,ORL,POR
64,Home,L 111-123 ,240,45,90,.500,37,67,.552,8,23,.348,13,18,.722,111,46,75,.613,40,63,.635,6,12,.500,25,31,.806,123,2015-03-21,IND,BRK
65,@,W 111-89 ,240,43,84,.512,29,50,.580,14,34,.412,11,13,.846,111,37,85,.435,33,68,.485,4,17,.235,11,16,.688,89,2015-03-25,CLE,MEM
66,@,W 111-80 ,240,44,78,.564,33,50,.660,11,28,.393,12,18,.667,111,29,82,.354,24,59,.407,5,23,.217,17,19,.895,80,2015-03-25,LAC,NYK
67,Home,W 111-107 ,240,39,73,.534,30,54,.556,9,19,.474,24,34,.706,111,30,71,.423,16,41,.390,14,30,.467,33,43,.767,107,2015-03-26,MIL,IND
68,@,W 111-97 ,240,42,90,.467,35,72,.486,7,18,.389,20,27,.741,111,43,82,.524,40,67,.597,3,15,.200,8,8,1.000,97,2015-03-27,DET,ORL
69,Home,W 111-80 ,240,43,84,.512,37,67,.552,6,17,.353,19,22,.864,111,30,79,.380,26,62,.419,4,17,.235,16,19,.842,80,2015-03-28,CHI,NYK
70,Home,L 111-113 (OT),265,39,96,.406,29,66,.439,10,30,.333,23,38,.605,111,40,82,.488,30,61,.492,10,21,.476,23,30,.767,113,2015-03-30,PHI,LAL
71,Home,W 111-106 ,240,40,80,.500,31,62,.500,9,18,.500,22,28,.786,111,37,82,.451,25,59,.424,12,23,.522,20,24,.833,106,2015-03-31,BRK,IND
72,@,L 111-115 ,240,48,96,.500,41,82,.500,7,14,.500,8,16,.500,111,41,89,.461,23,49,.469,18,40,.450,15,25,.600,115,2015-04-01,SAC,HOU
73,@,L 111-116 ,240,45,93,.484,39,74,.527,6,19,.316,15,21,.714,111,42,80,.525,33,56,.589,9,24,.375,23,34,.676,116,2015-04-07,MIN,SAC
74,Home,L 111-114 ,240,41,87,.471,34,61,.557,7,26,.269,22,25,.880,111,43,86,.500,32,58,.552,11,28,.393,17,25,.680,114,2015-04-08,BRK,ATL
75,@,W 111-105 ,240,36,79,.456,30,62,.484,6,17,.353,33,42,.786,111,41,87,.471,35,57,.614,6,30,.200,17,22,.773,105,2015-04-11,UTA,POR
76,@,L 111-122 ,240,38,74,.514,33,56,.589,5,18,.278,30,42,.714,111,45,82,.549,36,56,.643,9,26,.346,23,30,.767,122,2015-04-12,SAC,DEN
77,Home,W 111-107 ,240,39,74,.527,26,50,.520,13,24,.542,20,27,.741,111,41,98,.418,36,83,.434,5,15,.333,20,25,.800,107,2015-04-13,GSW,MEM
78,Home,W 111-95 ,240,41,96,.427,32,66,.485,9,30,.300,20,22,.909,111,35,83,.422,29,65,.446,6,18,.333,19,27,.704,95,2015-10-27,GSW,NOP
79,Home,L 111-112 ,240,35,90,.389,26,56,.464,9,34,.265,32,35,.914,111,38,83,.458,33,63,.524,5,20,.250,31,37,.838,112,2015-10-28,LAL,MIN
80,@,W 111-95 ,240,40,85,.471,30,64,.469,10,21,.476,21,31,.677,111,34,87,.391,28,63,.444,6,24,.250,21,33,.636,95,2015-10-28,DAL,PHO
81,@,W 111-104 ,240,42,80,.525,36,61,.590,6,19,.316,21,31,.677,111,41,94,.436,30,70,.429,11,24,.458,11,18,.611,104,2015-10-28,LAC,SAC
82,@,W 111-88 ,240,41,96,.427,31,71,.437,10,25,.400,19,23,.826,111,35,100,.350,30,75,.400,5,25,.200,13,23,.565,88,2015-11-09,CHI,PHI
83,@,W 111-109 ,240,42,95,.442,31,72,.431,11,23,.478,16,18,.889,111,37,84,.440,33,67,.493,4,17,.235,31,39,.795,109,2015-11-10,NYK,TOR
84,Home,W 111-109 ,240,40,94,.426,29,67,.433,11,27,.407,20,26,.769,111,42,89,.472,34,68,.500,8,21,.381,17,21,.810,109,2015-11-13,SAC,BRK
85,@,W 111-95 ,240,44,93,.473,33,57,.579,11,36,.306,12,17,.706,111,36,85,.424,25,53,.472,11,32,.344,12,23,.522,95,2015-11-16,BOS,HOU
86,@,L 111-116 ,240,44,91,.484,39,76,.513,5,15,.333,18,22,.818,111,39,80,.488,28,55,.509,11,25,.440,27,36,.750,116,2015-11-18,BRK,CHO
87,Home,W 111-101 ,240,40,79,.506,35,64,.547,5,15,.333,26,33,.788,111,35,82,.427,21,45,.467,14,37,.378,17,21,.810,101,2015-11-22,BRK,BOS
88,@,W 111-89 ,240,42,77,.545,31,50,.620,11,27,.407,16,18,.889,111,28,73,.384,23,54,.426,5,19,.263,28,40,.700,89,2015-11-23,OKC,UTA
89,@,W 111-94 ,240,37,79,.468,29,59,.492,8,20,.400,29,47,.617,111,31,78,.397,23,53,.434,8,25,.320,24,29,.828,94,2015-11-24,LAC,DEN
90,Home,W 111-77 ,240,45,92,.489,33,57,.579,12,35,.343,9,15,.600,111,31,83,.373,28,62,.452,3,21,.143,12,16,.750,77,2015-11-24,GSW,LAL
91,Home,W 111-78 ,240,42,97,.433,30,64,.469,12,33,.364,15,19,.789,111,27,84,.321,22,66,.333,5,18,.278,19,22,.864,78,2015-11-27,BOS,WAS
92,Home,W 111-90 ,240,40,83,.482,33,64,.516,7,19,.368,24,30,.800,111,34,94,.362,29,74,.392,5,20,.250,17,23,.739,90,2015-11-27,LAC,NOP
93,Home,L 111-116 (OT),265,45,78,.577,39,60,.650,6,18,.333,15,17,.882,111,43,95,.453,36,70,.514,7,25,.280,23,36,.639,116,2015-11-29,NYK,HOU
94,@,L 111-123 ,240,38,88,.432,25,58,.431,13,30,.433,22,24,.917,111,44,85,.518,26,49,.531,18,36,.500,17,20,.850,123,2015-12-03,IND,POR
95,Home,W 111-91 ,240,41,93,.441,32,69,.464,9,24,.375,20,26,.769,111,32,80,.400,27,62,.435,5,18,.278,22,29,.759,91,2015-12-06,DET,LAL
96,@,W 111-93 ,240,40,81,.494,28,53,.528,12,28,.429,19,24,.792,111,37,90,.411,33,77,.429,4,13,.308,15,18,.833,93,2015-12-07,BOS,NOP
97,Home,W 111-108 (OT),265,38,86,.442,27,58,.466,11,28,.393,24,33,.727,111,38,87,.437,31,68,.456,7,19,.368,25,29,.862,108,2015-12-11,DEN,MIN
98,@,W 111-76 ,240,41,72,.569,30,51,.588,11,21,.524,18,27,.667,111,28,72,.389,22,50,.440,6,22,.273,14,20,.700,76,2015-12-11,CLE,ORL
99,Home,L 111-114 ,240,38,89,.427,24,56,.429,14,33,.424,21,24,.875,111,44,85,.518,30,56,.536,14,29,.483,12,15,.800,114,2015-12-12,DAL,WAS
0,@,W 111-107 ,240,40,84,.476,33,58,.569,7,26,.269,24,32,.750,111,41,90,.456,32,65,.492,9,25,.360,16,19,.842,107,2015-12-22,LAL,DEN
1,@,W 111-96 ,240,42,84,.500,30,57,.526,12,27,.444,15,22,.682,111,43,89,.483,38,72,.528,5,17,.294,5,16,.313,96,2015-12-26,WAS,BRK
2,@,L 111-118 ,240,42,78,.538,34,57,.596,8,21,.381,19,26,.731,111,40,87,.460,24,54,.444,16,33,.485,22,28,.786,118,2015-12-26,CHI,DAL
3,@,W 111-90 ,240,42,81,.519,29,52,.558,13,29,.448,14,19,.737,111,34,81,.420,28,67,.418,6,14,.429,16,18,.889,90,2015-12-26,TOR,MIL
4,@,W 111-104 ,240,38,79,.481,26,52,.500,12,27,.444,23,27,.852,111,34,88,.386,24,61,.393,10,27,.370,26,34,.765,104,2015-12-26,PHI,PHO
5,@,W 111-105 ,240,36,82,.439,24,59,.407,12,23,.522,27,36,.750,111,36,78,.462,26,54,.481,10,24,.417,23,30,.767,105,2015-12-28,BRK,MIA
6,Home,W 111-108 (OT),265,43,86,.500,33,58,.569,10,28,.357,15,23,.652,111,44,105,.419,39,75,.520,5,30,.167,15,23,.652,108,2016-01-02,GSW,DEN
7,Home,W 111-97 ,240,44,88,.500,33,62,.532,11,26,.423,12,14,.857,111,37,84,.440,29,58,.500,8,26,.308,15,20,.750,97,2016-01-03,NYK,ATL
8,Home,W 111-101 ,240,45,87,.517,30,53,.566,15,34,.441,6,6,1.000,111,38,86,.442,31,65,.477,7,21,.333,18,19,.947,101,2016-01-04,GSW,CHO
9,Home,W 111-102 ,240,41,84,.488,22,51,.431,19,33,.576,10,13,.769,111,38,87,.437,27,59,.458,11,28,.393,15,22,.682,102,2016-01-06,PHO,CHO
10,@,L 111-114 (OT),265,40,100,.400,32,70,.457,8,30,.267,23,29,.793,111,42,89,.472,30,53,.566,12,36,.333,18,34,.529,114,2016-01-10,NOP,LAC
11,Home,W 111-103 ,240,41,86,.477,34,63,.540,7,23,.304,22,30,.733,111,41,91,.451,34,72,.472,7,19,.368,14,16,.875,103,2016-01-11,GSW,MIA
12,Home,L 111-115 (OT),265,42,93,.452,30,66,.455,12,27,.444,15,20,.750,111,41,88,.466,34,71,.479,7,17,.412,26,31,.839,115,2016-01-14,PHI,CHI
13,@,W 111-101 ,240,44,84,.524,35,63,.556,9,21,.429,14,20,.700,111,42,95,.442,37,69,.536,5,26,.192,12,20,.600,101,2016-01-18,CHI,DET
14,@,L 111-118 (OT),265,37,86,.430,25,59,.424,12,27,.444,25,31,.806,111,47,90,.522,40,73,.548,7,17,.412,17,18,.944,118,2016-01-20,UTA,NYK
15,Home,L 111-112 ,240,42,91,.462,29,62,.468,13,29,.448,14,25,.560,111,38,80,.475,19,40,.475,19,40,.475,17,21,.810,112,2016-01-25,NOP,HOU
16,Home,W 111-103 ,240,41,96,.427,32,68,.471,9,28,.321,20,24,.833,111,36,84,.429,29,63,.460,7,21,.333,24,32,.750,103,2016-01-27,BOS,DEN
17,Home,W 111-92 ,240,38,78,.487,29,63,.460,9,15,.600,26,30,.867,111,33,83,.398,26,55,.473,7,28,.250,19,21,.905,92,2016-01-28,IND,ATL
18,Home,W 111-107 ,240,36,78,.462,32,64,.500,4,14,.286,35,47,.745,111,39,87,.448,30,58,.517,9,29,.310,20,34,.588,107,2016-01-30,TOR,DET
19,@,W 111-106 (OT),265,44,88,.500,37,66,.561,7,22,.318,16,23,.696,111,43,101,.426,35,74,.473,8,27,.296,12,14,.857,106,2016-02-01,CLE,IND
20,Home,W 111-104 ,240,39,86,.453,30,60,.500,9,26,.346,24,30,.800,111,42,84,.500,34,64,.531,8,20,.400,12,17,.706,104,2016-02-01,SAC,MIL
21,Home,W 111-105 ,240,40,79,.506,31,62,.500,9,17,.529,22,33,.667,111,36,84,.429,30,62,.484,6,22,.273,27,34,.794,105,2016-02-04,DET,NYK
22,@,W 111-105 ,240,37,86,.430,22,44,.500,15,42,.357,22,32,.688,111,32,83,.386,21,54,.389,11,29,.379,30,32,.938,105,2016-02-04,HOU,PHO
23,@,L 111-112 ,240,39,84,.464,29,55,.527,10,29,.345,23,24,.958,111,45,88,.511,38,69,.551,7,19,.368,15,23,.652,112,2016-02-09,BOS,MIL
24,@,W 111-108 ,240,39,78,.500,23,52,.442,16,26,.615,17,25,.680,111,44,83,.530,36,57,.632,8,26,.308,12,14,.857,108,2016-02-09,WAS,NYK
25,@,L 111-120 ,240,38,86,.442,25,58,.431,13,28,.464,22,27,.815,111,48,94,.511,35,63,.556,13,31,.419,11,18,.611,120,2016-02-10,LAL,CLE
26,Home,L 111-115 ,240,41,87,.471,25,51,.490,16,36,.444,13,13,1.000,111,44,88,.500,36,68,.529,8,20,.400,19,28,.679,115,2016-02-19,ATL,MIA
27,Home,W 111-93 ,240,37,68,.544,27,45,.600,10,23,.435,27,44,.614,111,30,81,.370,23,56,.411,7,25,.280,26,36,.722,93,2016-02-19,UTA,BOS
28,@,W 111-106 ,240,41,86,.477,37,66,.561,4,20,.200,25,29,.862,111,37,89,.416,25,56,.446,12,33,.364,20,32,.625,106,2016-02-21,NOP,DET
29,Home,L 111-118 ,240,43,93,.462,34,69,.493,9,24,.375,16,22,.727,111,43,82,.524,33,66,.500,10,16,.625,22,34,.647,118,2016-02-21,PHO,SAS
30,@,L 111-115 ,240,43,86,.500,35,70,.500,8,16,.500,17,23,.739,111,39,90,.433,27,58,.466,12,32,.375,25,38,.658,115,2016-02-21,UTA,POR
31,Home,W 111-91 ,240,39,83,.470,28,55,.509,11,28,.393,22,34,.647,111,33,83,.398,26,60,.433,7,23,.304,18,26,.692,91,2016-02-24,DET,PHI
32,Home,W 111-106 ,240,37,80,.463,25,48,.521,12,32,.375,25,35,.714,111,32,80,.400,26,60,.433,6,20,.300,36,42,.857,106,2016-02-27,PHO,MEM
33,@,W 111-102 ,240,41,81,.506,27,57,.474,14,24,.583,15,21,.714,111,40,93,.430,37,79,.468,3,14,.214,19,25,.760,102,2016-02-28,POR,IND
34,@,L 111-129 ,240,41,90,.456,30,67,.448,11,23,.478,18,26,.692,111,52,77,.675,46,65,.708,6,12,.500,19,25,.760,129,2016-03-01,CHI,MIA
35,Home,L 111-120 ,240,40,84,.476,32,62,.516,8,22,.364,23,32,.719,111,39,90,.433,26,46,.565,13,44,.295,29,35,.829,120,2016-03-09,SAC,CLE
36,Home,L 111-125 ,240,39,84,.464,29,59,.492,10,25,.400,23,27,.852,111,49,91,.538,40,73,.548,9,18,.500,18,22,.818,125,2016-03-12,PHI,DET
37,@,L 111-116 ,240,43,85,.506,37,69,.536,6,16,.375,19,24,.792,111,48,85,.565,37,56,.661,11,29,.379,9,14,.643,116,2016-03-18,MIN,HOU
38,@,W 111-97 ,240,45,89,.506,38,67,.567,7,22,.318,14,18,.778,111,35,89,.393,25,60,.417,10,29,.345,17,27,.630,97,2016-03-18,OKC,PHI
39,Home,L 111-115 ,240,40,83,.482,31,61,.508,9,22,.409,22,30,.733,111,42,80,.525,32,52,.615,10,28,.357,21,26,.808,115,2016-03-19,IND,OKC
40,Home,W 111-107 ,240,41,91,.451,33,56,.589,8,35,.229,21,29,.724,111,40,92,.435,27,55,.491,13,37,.351,14,17,.824,107,2016-03-22,OKC,HOU
41,Home,W 111-92 ,240,44,85,.518,37,65,.569,7,20,.350,16,18,.889,111,37,86,.430,33,71,.465,4,15,.267,14,17,.824,92,2016-03-26,OKC,SAS
42,Home,W 111-89 ,240,48,89,.539,41,70,.586,7,19,.368,8,12,.667,111,36,88,.409,30,64,.469,6,24,.250,11,17,.647,89,2016-03-26,ORL,CHI
43,@,L 111-133 ,240,42,88,.477,34,64,.531,8,24,.333,19,24,.792,111,51,82,.622,42,62,.677,9,20,.450,22,30,.733,133,2016-03-27,DAL,SAC
44,@,L 111-120 ,240,43,89,.483,34,63,.540,9,26,.346,16,20,.800,111,47,84,.560,39,66,.591,8,18,.444,18,25,.720,120,2016-03-30,WAS,SAC
45,@,L 111-136 ,240,38,85,.447,29,61,.475,9,24,.375,26,33,.788,111,50,88,.568,32,58,.552,18,30,.600,18,22,.818,136,2016-04-03,POR,GSW
46,@,W 111-97 ,240,42,90,.467,30,64,.469,12,26,.462,15,17,.882,111,37,78,.474,27,52,.519,10,26,.385,13,15,.867,97,2016-04-06,CHO,NYK
47,Home,W 111-98 ,240,37,68,.544,27,46,.587,10,22,.455,27,38,.711,111,37,83,.446,29,56,.518,8,27,.296,16,20,.800,98,2016-04-08,TOR,IND
48,Home,L 111-120 ,240,44,98,.449,34,67,.507,10,31,.323,13,21,.619,111,46,89,.517,37,64,.578,9,25,.360,19,24,.792,120,2016-04-11,BRK,WAS
49,Home,W 111-104 ,240,40,76,.526,34,55,.618,6,21,.286,25,39,.641,111,37,86,.430,28,61,.459,9,25,.360,21,26,.808,104,2016-10-29,NYK,MEM
50,Home,L 111-112 (OT),265,43,94,.457,33,64,.516,10,30,.333,15,28,.536,111,40,93,.430,32,69,.464,8,24,.333,24,28,.857,112,2016-11-04,NOP,PHO
51,Home,W 111-94 ,240,46,86,.535,34,60,.567,12,26,.462,7,12,.583,111,34,79,.430,28,61,.459,6,18,.333,20,25,.800,94,2016-11-05,IND,CHI
52,Home,W 111-80 ,240,38,87,.437,27,55,.491,11,32,.344,24,33,.727,111,31,88,.352,25,58,.431,6,30,.200,12,14,.857,80,2016-11-09,LAC,POR
53,Home,L 111-113 ,240,38,93,.409,21,52,.404,17,41,.415,18,24,.750,111,43,90,.478,37,68,.544,6,22,.273,21,22,.955,113,2016-11-11,CHO,TOR
54,@,W 111-107 ,240,40,82,.488,25,56,.446,15,26,.577,16,19,.842,111,37,81,.457,28,56,.500,9,25,.360,24,34,.706,107,2016-11-16,MEM,LAC
55,Home,L 111-113 (OT),265,39,83,.470,35,58,.603,4,25,.160,29,39,.744,111,43,94,.457,35,71,.493,8,23,.348,19,31,.613,113,2016-11-18,DEN,TOR
56,Home,W 111-102 ,240,42,94,.447,30,62,.484,12,32,.375,15,20,.750,111,39,76,.513,27,49,.551,12,27,.444,12,17,.706,102,2016-11-19,HOU,UTA
57,Home,L 111-114 ,240,42,88,.477,31,61,.508,11,27,.407,16,22,.727,111,43,85,.506,30,58,.517,13,27,.481,15,26,.577,114,2016-11-19,WAS,MIA
58,Home,L 111-115 (OT),265,44,101,.436,34,65,.523,10,36,.278,13,18,.722,111,40,89,.449,29,67,.433,11,22,.500,24,31,.774,115,2016-11-20,OKC,IND
59,Home,W 111-109 ,240,42,83,.506,28,56,.500,14,27,.519,13,16,.813,111,45,92,.489,34,65,.523,11,27,.407,8,11,.727,109,2016-11-22,LAL,OKC
60,@,W 111-92 ,240,45,98,.459,30,60,.500,15,38,.395,6,8,.750,111,34,86,.395,24,55,.436,10,31,.323,14,22,.636,92,2016-11-23,BOS,BRK
61,@,L 111-113 (OT),265,43,93,.462,35,64,.547,8,29,.276,17,27,.630,111,45,97,.464,34,69,.493,11,28,.393,12,13,.923,113,2016-11-25,CHO,NYK
62,@,W 111-93 ,240,36,80,.450,21,46,.457,15,34,.441,24,29,.828,111,34,89,.382,22,49,.449,12,40,.300,13,16,.813,93,2016-12-01,MIL,BRK
63,@,W 111-110 ,240,44,86,.512,36,67,.537,8,19,.421,15,19,.789,111,40,73,.548,23,43,.535,17,30,.567,13,17,.765,110,2016-12-01,MIA,UTA
64,Home,W 111-105 ,240,47,96,.490,44,78,.564,3,18,.167,14,17,.824,111,45,83,.542,35,57,.614,10,26,.385,5,10,.500,105,2016-12-02,CHI,CLE
65,@,W 111-102 ,240,39,79,.494,34,65,.523,5,14,.357,28,35,.800,111,36,81,.444,26,51,.510,10,30,.333,20,28,.714,102,2016-12-04,IND,LAC
66,@,L 111-116 ,240,42,105,.400,31,68,.456,11,37,.297,16,21,.762,111,41,85,.482,32,59,.542,9,26,.346,25,31,.806,116,2016-12-07,DEN,BRK
67,Home,W 111-103 ,240,39,80,.488,24,48,.500,15,32,.469,18,24,.750,111,32,69,.464,18,44,.409,14,25,.560,25,26,.962,103,2016-12-09,DAL,IND
68,@,L 111-118 ,240,40,82,.488,24,45,.533,16,37,.432,15,16,.938,111,40,83,.482,25,54,.463,15,29,.517,23,28,.821,118,2016-12-10,POR,IND
69,@,L 111-113 (OT),265,38,97,.392,31,77,.403,7,20,.350,28,38,.737,111,38,93,.409,29,63,.460,9,30,.300,28,33,.848,113,2016-12-13,NYK,PHO
70,@,L 111-118 ,240,39,83,.470,28,56,.500,11,27,.407,22,26,.846,111,39,97,.402,32,68,.471,7,29,.241,33,42,.786,118,2016-12-16,BRK,ORL
71,@,W 111-109 (OT),265,39,96,.406,22,45,.489,17,51,.333,16,20,.800,111,41,92,.446,34,71,.479,7,21,.333,20,27,.741,109,2016-12-17,HOU,MIN
72,@,L 111-118 ,240,39,91,.429,33,68,.485,6,23,.261,27,33,.818,111,44,88,.500,31,65,.477,13,23,.565,17,21,.810,118,2016-12-20,IND,NYK
73,Home,L 111-125 ,240,44,93,.473,35,68,.515,9,25,.360,14,20,.700,111,46,86,.535,28,48,.583,18,38,.474,15,26,.577,125,2016-12-21,PHO,HOU
74,Home,W 111-102 ,240,40,84,.476,32,59,.542,8,25,.320,23,30,.767,111,37,85,.435,27,56,.482,10,29,.345,18,22,.818,102,2016-12-25,LAL,LAC
75,Home,W 111-104 ,240,37,70,.529,25,45,.556,12,25,.480,25,30,.833,111,37,75,.493,24,43,.558,13,32,.406,17,22,.773,104,2016-12-26,NOP,DAL
76,@,L 111-121 ,240,40,103,.388,27,68,.397,13,35,.371,18,22,.818,111,46,81,.568,32,58,.552,14,23,.609,15,18,.833,121,2016-12-28,TOR,GSW
77,Home,W 111-105 ,240,38,78,.487,30,56,.536,8,22,.364,27,37,.730,111,35,79,.443,24,51,.471,11,28,.393,24,29,.828,105,2016-12-28,WAS,IND
78,Home,W 111-101 ,240,39,81,.481,32,62,.516,7,19,.368,26,30,.867,111,35,84,.417,29,61,.475,6,23,.261,25,31,.806,101,2016-12-30,IND,CHI
79,@,L 111-118 ,240,41,83,.494,32,64,.500,9,19,.474,20,22,.909,111,42,90,.467,35,67,.522,7,23,.304,27,29,.931,118,2017-01-02,CHO,CHI
80,@,W 111-92 ,240,44,81,.543,34,62,.548,10,19,.526,13,18,.722,111,37,86,.430,28,58,.483,9,28,.321,9,10,.900,92,2017-01-04,ATL,ORL
81,Home,L 111-116 ,240,39,78,.500,27,56,.482,12,22,.545,21,28,.750,111,41,83,.494,28,60,.467,13,23,.565,21,27,.778,116,2017-01-06,MIL,NYK
82,Home,W 111-95 ,240,42,87,.483,34,55,.618,8,32,.250,19,24,.792,111,34,90,.378,27,64,.422,7,26,.269,20,29,.690,95,2017-01-08,LAL,ORL
83,Home,W 111-98 ,240,42,80,.525,29,54,.537,13,26,.500,14,18,.778,111,39,79,.494,33,60,.550,6,19,.316,14,18,.778,98,2017-01-15,ATL,MIL
84,Home,W 111-92 ,240,43,95,.453,29,51,.569,14,44,.318,11,15,.733,111,37,93,.398,30,65,.462,7,28,.250,11,14,.786,92,2017-01-18,HOU,MIL
85,Home,W 111-108 ,240,45,85,.529,39,70,.557,6,15,.400,15,21,.714,111,42,82,.512,35,58,.603,7,24,.292,17,21,.810,108,2017-01-22,MIN,DEN
86,Home,L 111-112 ,240,38,86,.442,31,67,.463,7,19,.368,28,32,.875,111,44,84,.524,38,67,.567,6,17,.353,18,24,.750,112,2017-01-24,PHO,MIN
87,@,L 111-115 (OT),265,35,71,.493,22,45,.489,13,26,.500,28,36,.778,111,38,78,.487,28,50,.560,10,28,.357,29,33,.879,115,2017-01-27,SAC,IND
88,Home,L 111-113 ,240,46,93,.495,36,66,.545,10,27,.370,9,12,.750,111,36,79,.456,28,53,.528,8,26,.308,33,39,.846,113,2017-01-29,POR,GSW
89,Home,W 111-105 (OT),265,40,92,.435,28,63,.444,12,29,.414,19,26,.731,111,41,96,.427,31,61,.508,10,35,.286,13,19,.684,105,2017-01-30,MIN,ORL
90,@,L 111-126 ,240,39,88,.443,30,57,.526,9,31,.290,24,26,.923,111,47,96,.490,26,48,.542,21,48,.438,11,14,.786,126,2017-02-01,CHO,GSW
91,@,W 111-104 ,240,41,84,.488,25,44,.568,16,40,.400,13,18,.722,111,39,86,.453,27,55,.491,12,31,.387,14,28,.500,104,2017-02-04,CLE,NYK
92,Home,W 111-106 ,240,42,92,.457,33,66,.500,9,26,.346,18,22,.818,111,40,93,.430,35,66,.530,5,27,.185,21,25,.840,106,2017-02-06,NOP,PHO
93,Home,W 111-107 ,240,40,102,.392,33,76,.434,7,26,.269,24,29,.828,111,39,86,.453,27,50,.540,12,36,.333,17,21,.810,107,2017-02-07,CHO,BRK
94,@,W 111-103 ,240,39,74,.527,28,52,.538,11,22,.500,22,25,.880,111,34,84,.405,21,50,.420,13,34,.382,22,29,.759,103,2017-02-08,SAS,PHI
95,Home,L 111-112 ,240,41,84,.488,31,63,.492,10,21,.476,19,24,.792,111,40,95,.421,29,67,.433,11,28,.393,21,27,.778,112,2017-02-09,ORL,PHI
96,Home,L 111-120 ,240,39,77,.506,30,51,.588,9,26,.346,24,31,.774,111,44,91,.484,34,61,.557,10,30,.333,22,27,.815,120,2017-02-09,POR,BOS
97,@,W 111-98 ,240,40,81,.494,24,47,.511,16,34,.471,15,18,.833,111,35,77,.455,26,50,.520,9,27,.333,19,25,.760,98,2017-02-13,BOS,DAL
98,Home,W 111-88 ,240,42,81,.519,31,59,.525,11,22,.500,16,23,.696,111,32,79,.405,23,57,.404,9,22,.409,15,20,.750,88,2017-02-15,UTA,POR
99,@,W 111-98 ,240,43,83,.518,28,54,.519,15,29,.517,10,15,.667,111,40,81,.494,36,63,.571,4,18,.222,14,18,.778,98,2017-02-16,WAS,IND
0,@,L 111-118 ,240,37,87,.425,28,52,.538,9,35,.257,28,35,.800,111,44,89,.494,39,68,.574,5,21,.238,25,31,.806,118,2017-03-03,OKC,PHO
1,Home,L 111-119 ,240,38,82,.463,25,54,.463,13,28,.464,22,31,.710,111,41,87,.471,21,43,.488,20,44,.455,17,22,.773,119,2017-03-06,ATL,GSW
2,@,L 111-122 ,240,42,90,.467,31,60,.517,11,30,.367,16,22,.727,111,45,83,.542,28,52,.538,17,31,.548,15,19,.789,122,2017-03-07,LAL,DAL
3,Home,W 110-83 ,240,46,76,.605,43,67,.642,3,9,.333,15,22,.682,110,30,93,.323,28,72,.389,2,21,.095,21,24,.875,83,2012-01-04,DEN,SAC
4,Home,L 110-118 ,240,42,85,.494,31,56,.554,11,29,.379,15,20,.750,110,47,85,.553,40,74,.541,7,11,.636,17,21,.810,118,2012-01-04,NYK,CHA
5,@,W 110-103 ,240,40,80,.500,25,48,.521,15,32,.469,15,19,.789,110,41,79,.519,33,57,.579,8,22,.364,13,16,.813,103,2012-01-13,NJN,PHO
6,Home,W 110-95 ,240,43,75,.573,36,56,.643,7,19,.368,17,23,.739,110,37,77,.481,30,58,.517,7,19,.368,14,21,.667,95,2012-01-23,CHI,NJN
7,Home,W 110-87 ,240,39,74,.527,29,50,.580,10,24,.417,22,27,.815,110,31,89,.348,24,66,.364,7,23,.304,18,21,.857,87,2012-02-17,OKC,GSW
8,Home,W 110-91 ,240,43,79,.544,37,66,.561,6,13,.462,18,24,.750,110,37,88,.420,35,75,.467,2,13,.154,15,19,.789,91,2012-02-22,CHI,MIL
9,Home,L 110-122 ,240,40,83,.482,30,57,.526,10,26,.385,20,28,.714,110,43,80,.538,31,57,.544,12,23,.522,24,28,.857,122,2012-03-03,POR,MIN
10,@,W 110-92 ,240,42,80,.525,35,61,.574,7,19,.368,19,21,.905,110,35,79,.443,27,61,.443,8,18,.444,14,23,.609,92,2012-03-07,MEM,GSW
11,Home,W 110-97 ,240,41,73,.562,35,50,.700,6,23,.261,22,32,.688,110,33,72,.458,29,61,.475,4,11,.364,27,32,.844,97,2012-03-09,DEN,NOH
12,Home,W 110-97 ,240,43,85,.506,32,58,.552,11,27,.407,13,13,1.000,110,39,86,.453,33,64,.516,6,22,.273,13,18,.722,97,2012-03-09,SAC,DAL
13,@,W 110-99 ,240,40,78,.513,36,61,.590,4,17,.235,26,27,.963,110,39,82,.476,34,66,.515,5,16,.313,16,25,.640,99,2012-03-10,POR,WAS
14,Home,L 110-114 (OT),265,37,82,.451,32,66,.485,5,16,.313,31,51,.608,110,39,81,.481,32,66,.485,7,15,.467,29,38,.763,114,2012-03-16,MEM,TOR
15,@,L 110-119 ,240,43,90,.478,39,74,.527,4,16,.250,20,25,.800,110,47,88,.534,43,71,.606,4,17,.235,21,32,.656,119,2012-03-20,MEM,SAC
16,Home,W 110-107 (OT),265,45,87,.517,41,77,.532,4,10,.400,16,22,.727,110,40,86,.465,32,64,.500,8,22,.364,19,22,.864,107,2012-03-31,DET,CHA
17,Home,W 110-98 ,240,45,80,.563,38,62,.613,7,18,.389,13,19,.684,110,38,84,.452,33,72,.458,5,12,.417,17,22,.773,98,2012-04-06,NJN,WAS
18,Home,W 110-100 ,240,41,92,.446,34,78,.436,7,14,.500,21,28,.750,110,41,92,.446,32,67,.478,9,25,.360,9,17,.529,100,2012-04-10,DAL,SAC
19,@,L 110-118 ,240,47,90,.522,39,74,.527,8,16,.500,8,11,.727,110,42,88,.477,32,65,.492,10,23,.435,24,28,.857,118,2012-04-11,GSW,POR
20,Home,L 110-115 ,240,42,84,.500,38,73,.521,4,11,.364,22,34,.647,110,40,91,.440,33,66,.500,7,25,.280,28,32,.875,115,2012-04-14,MIN,OKC
21,@,L 110-118 ,240,36,66,.545,25,45,.556,11,21,.524,27,34,.794,110,42,74,.568,23,42,.548,19,32,.594,15,17,.882,118,2012-04-17,BOS,NYK
22,@,L 110-117 ,240,43,86,.500,31,58,.534,12,28,.429,12,15,.800,110,41,79,.519,30,53,.566,11,26,.423,24,26,.923,117,2012-04-18,HOU,DAL
23,@,L 110-118 ,240,43,82,.524,39,66,.591,4,16,.250,20,27,.741,110,38,81,.469,29,61,.475,9,20,.450,33,36,.917,118,2012-04-24,SAC,OKC
24,@,W 110-106 ,240,41,88,.466,33,66,.500,8,22,.364,20,23,.870,110,45,94,.479,40,81,.494,5,13,.385,11,13,.846,106,2012-04-25,SAS,PHO
25,Home,L 110-114 ,240,30,70,.429,20,49,.408,10,21,.476,40,52,.769,110,41,84,.488,37,68,.544,4,16,.250,28,39,.718,114,2012-11-03,LAC,GSW
26,Home,W 110-100 ,240,42,74,.568,35,61,.574,7,13,.538,19,23,.826,110,38,77,.494,33,64,.516,5,13,.385,19,22,.864,100,2012-11-03,SAS,UTA
27,@,W 110-88 ,240,39,84,.464,26,52,.500,13,32,.406,19,19,1.000,110,29,86,.337,21,64,.328,8,22,.364,22,26,.846,88,2012-11-05,NYK,PHI
28,Home,L 110-117 ,240,38,87,.437,28,65,.431,10,22,.455,24,27,.889,110,43,93,.462,31,66,.470,12,27,.444,19,28,.679,117,2012-11-07,CHA,PHO
29,Home,L 110-113 ,240,36,80,.450,24,46,.522,12,34,.353,26,33,.788,110,45,89,.506,35,68,.515,10,21,.476,13,20,.650,113,2012-11-12,HOU,MIA
30,Home,W 110-100 ,240,43,94,.457,36,82,.439,7,12,.583,17,21,.810,110,41,76,.539,34,60,.567,7,16,.438,11,18,.611,100,2012-11-12,PHO,DEN
31,@,W 110-106 ,240,44,89,.494,37,72,.514,7,17,.412,15,17,.882,110,44,82,.537,42,74,.568,2,8,.250,16,20,.800,106,2012-11-16,ORL,DET
32,@,W 110-95 ,240,40,74,.541,26,45,.578,14,29,.483,16,20,.800,110,33,78,.423,26,66,.394,7,12,.583,22,28,.786,95,2012-11-16,OKC,NOH
33,Home,W 110-108 ,240,36,69,.522,27,50,.540,9,19,.474,29,37,.784,110,35,79,.443,21,48,.438,14,31,.452,24,33,.727,108,2012-11-24,MIA,CLE
34,Home,L 110-116 (OT),265,41,90,.456,30,64,.469,11,26,.423,17,19,.895,110,47,105,.448,40,87,.460,7,18,.389,15,19,.789,116,2012-11-25,ORL,BOS
35,@,W 110-89 ,240,44,84,.524,33,59,.559,11,25,.440,11,15,.733,110,41,95,.432,39,80,.488,2,15,.133,5,8,.625,89,2012-11-28,SAS,ORL
36,@,L 110-113 ,240,42,86,.488,33,58,.569,9,28,.321,17,19,.895,110,40,85,.471,34,70,.486,6,15,.400,27,43,.628,113,2012-12-03,TOR,DEN
37,Home,W 110-99 ,240,40,85,.471,34,64,.531,6,21,.286,24,28,.857,110,35,84,.417,30,72,.417,5,12,.417,24,29,.828,99,2012-12-05,SAS,MIL
38,Home,L 110-117 ,240,40,85,.471,25,57,.439,15,28,.536,15,18,.833,110,45,83,.542,39,65,.600,6,18,.333,21,27,.778,117,2012-12-09,LAL,UTA
39,@,W 110-95 ,240,42,78,.538,32,50,.640,10,28,.357,16,18,.889,110,37,96,.385,34,74,.459,3,22,.136,18,21,.857,95,2012-12-20,MIA,DAL
40,@,W 110-106 ,240,37,83,.446,29,65,.446,8,18,.444,28,33,.848,110,38,91,.418,30,65,.462,8,26,.308,22,25,.880,106,2012-12-21,CHI,NYK
41,Home,W 110-88 ,240,47,92,.511,41,72,.569,6,20,.300,10,15,.667,110,33,87,.379,30,67,.448,3,20,.150,19,30,.633,88,2012-12-22,DEN,CHA
42,Home,L 110-112 (OT),265,42,88,.477,34,65,.523,8,23,.348,18,22,.818,110,40,85,.471,34,64,.531,6,21,.286,26,35,.743,112,2012-12-31,ORL,MIA
43,Home,L 110-117 ,240,43,88,.489,38,71,.535,5,17,.294,19,24,.792,110,46,89,.517,37,72,.514,9,17,.529,16,23,.696,117,2013-01-02,MIL,SAS
44,@,W 110-93 ,240,38,76,.500,29,59,.492,9,17,.529,25,29,.862,110,36,73,.493,28,54,.519,8,19,.421,13,17,.765,93,2013-01-02,BRK,OKC
45,Home,W 110-91 ,240,39,76,.513,35,65,.538,4,11,.364,28,39,.718,110,28,78,.359,19,53,.358,9,25,.360,26,35,.743,91,2013-01-05,DEN,UTA
46,@,W 110-104 ,240,39,88,.443,33,70,.471,6,18,.333,26,32,.813,110,34,81,.420,26,53,.491,8,28,.286,28,32,.875,104,2013-01-19,MIL,POR
47,Home,W 110-102 ,240,41,79,.519,34,63,.540,7,16,.438,21,33,.636,110,42,95,.442,34,79,.430,8,16,.500,10,13,.769,102,2013-01-22,MIL,PHI
48,Home,W 110-88 ,240,43,77,.558,38,60,.633,5,17,.294,19,23,.826,110,34,72,.472,30,60,.500,4,12,.333,16,23,.696,88,2013-01-25,MIA,DET
49,@,L 110-114 (OT),265,44,82,.537,37,61,.607,7,21,.333,15,18,.833,110,44,83,.530,41,73,.562,3,10,.300,23,26,.885,114,2013-01-26,IND,UTA
50,Home,W 110-95 ,240,45,88,.511,40,77,.519,5,11,.455,15,18,.833,110,34,77,.442,30,60,.500,4,17,.235,23,28,.821,95,2013-01-27,DAL,PHO
51,@,L 110-118 ,240,39,81,.481,31,54,.574,8,27,.296,24,35,.686,110,42,82,.512,34,54,.630,8,28,.286,26,36,.722,118,2013-01-30,HOU,DEN
52,@,L 110-115 ,240,41,83,.494,34,62,.548,7,21,.333,21,26,.808,110,43,90,.478,34,72,.472,9,18,.500,20,23,.870,115,2013-02-02,OKC,CLE
53,Home,W 110-104 ,240,47,93,.505,42,78,.538,5,15,.333,11,18,.611,110,42,83,.506,32,56,.571,10,27,.370,10,12,.833,104,2013-02-10,ORL,POR
54,@,W 110-100 ,240,41,88,.466,30,59,.508,11,29,.379,17,22,.773,110,32,73,.438,29,60,.483,3,13,.231,33,34,.971,100,2013-02-14,MIA,OKC
55,Home,W 110-95 ,240,45,89,.506,39,73,.534,6,16,.375,14,15,.933,110,35,83,.422,23,64,.359,12,19,.632,13,13,1.000,95,2013-02-24,NOH,SAC
56,@,W 110-107 (OT),265,41,86,.477,31,59,.525,10,27,.370,18,20,.900,110,39,88,.443,31,71,.437,8,17,.471,21,24,.875,107,2013-02-25,BOS,UTA
57,@,W 110-107 ,240,43,89,.483,34,65,.523,9,24,.375,15,20,.750,110,42,89,.472,35,66,.530,7,23,.304,16,25,.640,107,2013-02-27,MIL,HOU
58,Home,L 110-118 ,240,44,78,.564,35,56,.625,9,22,.409,13,16,.813,110,42,77,.545,27,45,.600,15,32,.469,19,28,.679,118,2013-03-01,ORL,HOU
59,Home,W 110-87 ,240,37,69,.536,30,53,.566,7,16,.438,29,33,.879,110,28,80,.350,23,65,.354,5,15,.333,26,33,.788,87,2013-03-13,OKC,UTA
60,Home,W 110-106 ,240,43,94,.457,39,83,.470,4,11,.364,20,24,.833,110,38,74,.514,29,54,.537,9,20,.450,21,28,.750,106,2013-03-23,MEM,BOS
61,Home,W 110-84 ,240,41,79,.519,34,60,.567,7,19,.368,21,23,.913,110,34,76,.447,30,53,.566,4,23,.174,12,18,.667,84,2013-03-23,NYK,TOR
62,Home,W 110-86 ,240,41,85,.482,27,60,.450,14,25,.560,14,15,.933,110,25,66,.379,20,50,.400,5,16,.313,31,39,.795,86,2013-03-25,NOH,DEN
63,Home,W 110-100 ,240,40,83,.482,35,65,.538,5,18,.278,25,27,.926,110,42,81,.519,35,65,.538,7,16,.438,9,14,.643,100,2013-04-01,MIN,BOS
64,@,L 110-121 ,240,38,78,.487,32,60,.533,6,18,.333,28,35,.800,110,47,85,.553,37,65,.569,10,20,.500,17,23,.739,121,2013-04-10,NOH,SAC
65,@,L 110-114 ,240,42,85,.494,26,45,.578,16,40,.400,10,13,.769,110,43,80,.538,35,59,.593,8,21,.381,20,24,.833,114,2013-10-30,MIA,PHI
66,Home,W 110-90 ,240,39,70,.557,28,48,.583,11,22,.500,21,27,.778,110,32,92,.348,26,80,.325,6,12,.500,20,26,.769,90,2013-11-01,ORL,NOP
67,@,W 110-101 ,240,35,70,.500,23,46,.500,12,24,.500,28,34,.824,110,36,79,.456,30,62,.484,6,17,.353,23,32,.719,101,2013-11-01,LAC,SAC
68,@,W 110-90 ,240,41,92,.446,26,54,.481,15,38,.395,13,20,.650,110,31,88,.352,26,63,.413,5,25,.200,23,37,.622,90,2013-11-04,GSW,PHI
69,Home,L 110-119 ,240,39,91,.429,28,60,.467,11,31,.355,21,27,.778,110,37,82,.451,31,65,.477,6,17,.353,39,44,.886,119,2013-11-08,DET,OKC
70,Home,L 110-111 ,240,41,71,.577,36,61,.590,5,10,.500,23,34,.676,110,46,89,.517,36,68,.529,10,21,.476,9,12,.750,111,2013-11-09,MIA,BOS
71,Home,W 110-104 (2OT),290,37,84,.440,30,58,.517,7,26,.269,29,47,.617,110,38,114,.333,30,89,.337,8,25,.320,20,27,.741,104,2013-11-11,HOU,TOR
72,Home,W 110-104 ,240,40,74,.541,35,61,.574,5,13,.385,25,30,.833,110,37,74,.500,25,46,.543,12,28,.429,18,21,.857,104,2013-11-15,MIA,DAL
73,Home,W 110-94 ,240,40,79,.506,29,60,.483,11,19,.579,19,24,.792,110,34,85,.400,30,69,.435,4,16,.250,22,28,.786,94,2013-11-16,CHI,IND
74,Home,W 110-103 ,240,40,77,.519,30,54,.556,10,23,.435,20,30,.667,110,36,85,.424,27,62,.435,9,23,.391,22,33,.667,103,2013-11-16,LAC,BRK
75,@,W 110-90 ,240,44,78,.564,35,56,.625,9,22,.409,13,17,.765,110,34,90,.378,24,60,.400,10,30,.333,12,16,.750,90,2013-11-16,ATL,NYK
76,Home,L 110-118 (OT),265,42,94,.447,39,77,.506,3,17,.176,23,31,.742,110,44,99,.444,29,67,.433,15,32,.469,15,20,.750,118,2013-11-17,TOR,POR
77,@,W 110-96 ,240,41,75,.547,33,55,.600,8,20,.400,20,28,.714,110,38,82,.463,33,63,.524,5,19,.263,15,19,.789,96,2013-11-25,DEN,DAL
78,Home,L 110-117 ,240,40,88,.455,35,68,.515,5,20,.250,25,28,.893,110,45,88,.511,37,72,.514,8,16,.500,19,25,.760,117,2013-11-27,MIN,DEN
79,Home,W 110-91 ,240,46,84,.548,41,70,.586,5,14,.357,13,21,.619,110,37,87,.425,30,58,.517,7,29,.241,10,15,.667,91,2013-12-03,MEM,PHO
80,@,W 110-95 ,240,40,72,.556,29,44,.659,11,28,.393,19,21,.905,110,36,85,.424,29,65,.446,7,20,.350,16,22,.727,95,2013-12-08,MIA,DET
81,@,L 110-117 ,240,38,88,.432,27,65,.415,11,23,.478,23,26,.885,110,48,87,.552,38,65,.585,10,22,.455,11,13,.846,117,2013-12-13,MIN,SAS
82,Home,W 110-107 ,240,43,98,.439,35,69,.507,8,29,.276,16,18,.889,110,44,94,.468,38,77,.494,6,17,.353,13,19,.684,107,2013-12-21,POR,NOP
83,@,L 110-111 (OT),265,42,97,.433,32,69,.464,10,28,.357,16,17,.941,110,43,99,.434,33,82,.402,10,17,.588,15,20,.750,111,2013-12-23,MIL,CHA
84,Home,W 110-108 ,240,48,89,.539,46,78,.590,2,11,.182,12,15,.800,110,39,88,.443,27,56,.482,12,32,.375,18,24,.750,108,2013-12-30,NOP,POR
85,@,W 110-106 ,240,42,85,.494,35,63,.556,7,22,.318,19,23,.826,110,39,81,.481,32,53,.604,7,28,.250,21,33,.636,106,2013-12-31,SAC,HOU
86,Home,W 110-99 ,240,42,81,.519,32,57,.561,10,24,.417,16,21,.762,110,38,86,.442,30,60,.500,8,26,.308,15,23,.652,99,2014-01-03,LAL,UTA
87,@,W 110-94 ,240,40,74,.541,34,58,.586,6,16,.375,24,31,.774,110,33,80,.413,25,54,.463,8,26,.308,20,24,.833,94,2014-01-04,MIA,ORL
88,Home,W 110-97 ,240,48,90,.533,43,73,.589,5,17,.294,9,15,.600,110,34,81,.420,23,50,.460,11,31,.355,18,26,.692,97,2014-01-07,DAL,LAL
89,@,W 110-108 (OT),265,43,83,.518,36,59,.610,7,24,.292,17,25,.680,110,46,99,.465,40,82,.488,6,17,.353,10,15,.667,108,2014-01-07,SAS,MEM
90,Home,W 110-94 ,240,45,95,.474,36,65,.554,9,30,.300,11,13,.846,110,33,83,.398,26,63,.413,7,20,.350,21,27,.778,94,2014-01-08,POR,ORL
91,Home,W 110-107 ,240,30,67,.448,19,40,.475,11,27,.407,39,45,.867,110,37,77,.481,29,58,.500,8,19,.421,25,31,.806,107,2014-01-11,DAL,NOP
92,Home,W 110-108 ,240,44,94,.468,41,77,.532,3,17,.176,19,27,.704,110,37,94,.394,24,59,.407,13,35,.371,21,25,.840,108,2014-01-11,DET,PHO
93,Home,L 110-127 ,240,40,81,.494,32,56,.571,8,25,.320,22,22,1.000,110,53,91,.582,37,64,.578,16,27,.593,5,7,.714,127,2014-01-16,ATL,BRK
94,@,W 110-89 ,240,43,79,.544,34,57,.596,9,22,.409,15,19,.789,110,32,74,.432,28,58,.483,4,16,.250,21,31,.677,89,2014-01-17,UTA,DET
95,@,W 110-107 ,240,44,83,.530,35,59,.593,9,24,.375,13,19,.684,110,42,93,.452,35,71,.493,7,22,.318,16,21,.762,107,2014-01-17,DAL,PHO
96,Home,W 110-82 ,240,43,76,.566,32,58,.552,11,18,.611,13,21,.619,110,33,88,.375,27,67,.403,6,21,.286,10,17,.588,82,2014-01-19,SAS,MIL
97,@,W 110-106 ,240,42,88,.477,33,74,.446,9,14,.643,17,24,.708,110,37,82,.451,22,49,.449,15,33,.455,17,24,.708,106,2014-01-22,PHI,NYK
98,Home,W 110-105 ,240,38,88,.432,34,70,.486,4,18,.222,30,34,.882,110,39,79,.494,29,56,.518,10,23,.435,17,20,.850,105,2014-01-23,POR,DEN
99,Home,W 110-103 ,240,43,90,.478,32,64,.500,11,26,.423,13,18,.722,110,39,75,.520,28,52,.538,11,23,.478,14,18,.778,103,2014-01-26,NYK,LAL
0,Home,W 110-103 ,240,36,73,.493,30,58,.517,6,15,.400,32,42,.762,110,45,88,.511,42,66,.636,3,22,.136,10,17,.588,103,2014-01-29,LAC,WAS
1,@,W 110-100 ,240,46,88,.523,44,77,.571,2,11,.182,16,22,.727,110,36,93,.387,30,67,.448,6,26,.231,22,27,.815,100,2014-01-31,CHA,LAL
2,Home,W 110-100 ,240,39,84,.464,29,61,.475,10,23,.435,22,26,.846,110,36,95,.379,29,79,.367,7,16,.438,21,31,.677,100,2014-02-05,DEN,MIL
3,@,W 110-96 ,240,42,78,.538,34,60,.567,8,18,.444,18,25,.720,110,37,69,.536,31,53,.585,6,16,.375,16,22,.727,96,2014-02-05,DAL,MEM
4,Home,L 110-117 ,240,40,97,.412,35,80,.438,5,17,.294,25,34,.735,110,40,83,.482,32,60,.533,8,23,.348,29,38,.763,117,2014-02-08,MIN,POR
5,Home,L 110-111 ,240,40,83,.482,31,67,.463,9,16,.563,21,26,.808,110,42,78,.538,32,56,.571,10,22,.455,17,25,.680,111,2014-02-12,GSW,MIA
6,@,W 110-100 ,240,36,80,.450,27,62,.435,9,18,.500,29,40,.725,110,35,83,.422,26,56,.464,9,27,.333,21,32,.656,100,2014-02-22,IND,MIL
7,Home,L 110-123 ,240,37,87,.425,30,69,.435,7,18,.389,29,35,.829,110,43,83,.518,27,55,.491,16,28,.571,21,26,.808,123,2014-02-24,NOP,LAC
8,@,W 110-108 ,240,41,86,.477,26,50,.520,15,36,.417,13,16,.813,110,40,76,.526,26,43,.605,14,33,.424,14,16,.875,108,2014-02-24,DAL,NYK
9,Home,L 110-130 ,240,43,88,.489,35,64,.547,8,24,.333,16,23,.696,110,48,84,.571,36,64,.563,12,20,.600,22,29,.759,130,2014-02-24,PHI,MIL
10,Home,W 110-98 ,240,44,80,.550,38,63,.603,6,17,.353,16,21,.762,110,37,84,.440,33,69,.478,4,15,.267,20,21,.952,98,2014-02-24,UTA,BOS
11,@,W 110-101 ,240,42,87,.483,37,69,.536,5,18,.278,21,32,.656,110,42,95,.442,39,80,.488,3,15,.200,14,18,.778,101,2014-02-25,MIN,PHO
12,@,L 110-120 ,240,45,90,.500,40,80,.500,5,10,.500,15,17,.882,110,44,82,.537,35,63,.556,9,19,.474,23,25,.920,120,2014-02-26,DET,SAS
13,@,L 110-118 ,240,45,100,.450,41,81,.506,4,19,.211,16,19,.842,110,42,84,.500,31,51,.608,11,33,.333,23,33,.697,118,2014-03-01,DET,HOU
14,Home,W 110-96 ,240,44,81,.543,35,62,.565,9,19,.474,13,18,.722,110,39,79,.494,32,61,.525,7,18,.389,11,15,.733,96,2014-03-01,MEM,CLE
15,@,W 110-104 ,240,43,79,.544,37,66,.561,6,13,.462,18,21,.857,110,39,81,.481,30,62,.484,9,19,.474,17,21,.810,104,2014-03-03,MEM,WAS
16,@,L 110-115 ,240,46,87,.529,37,67,.552,9,20,.450,9,9,1.000,110,37,79,.468,26,55,.473,11,24,.458,30,36,.833,115,2014-03-05,DAL,DEN
17,@,L 110-114 ,240,42,100,.420,30,65,.462,12,35,.343,14,21,.667,110,38,81,.469,25,50,.500,13,31,.419,25,30,.833,114,2014-03-09,OKC,LAL
18,@,L 110-123 ,240,43,84,.512,37,64,.578,6,20,.300,18,25,.720,110,44,81,.543,31,49,.633,13,32,.406,22,34,.647,123,2014-03-10,PHI,NYK
19,Home,L 110-112 ,240,40,82,.488,30,61,.492,10,21,.476,20,24,.833,110,38,78,.487,25,49,.510,13,29,.448,23,27,.852,112,2014-03-10,UTA,ATL
20,@,W 110-101 ,240,38,81,.469,26,57,.456,12,24,.500,22,27,.815,110,39,90,.433,29,54,.537,10,36,.278,13,22,.591,101,2014-03-12,CLE,PHO
21,Home,W 110-100 ,240,38,93,.409,32,68,.471,6,25,.240,28,33,.848,110,36,92,.391,31,71,.437,5,21,.238,23,25,.920,100,2014-03-17,DEN,LAC
22,@,L 110-115 ,240,39,80,.488,36,68,.529,3,12,.250,29,39,.744,110,43,80,.538,35,53,.660,8,27,.296,21,25,.840,115,2014-03-20,MIL,GSW
23,@,W 110-78 ,240,43,79,.544,35,60,.583,8,19,.421,16,22,.727,110,30,79,.380,27,55,.491,3,24,.125,15,21,.714,78,2014-03-28,MIA,DET
24,Home,W 110-105 (OT),265,39,87,.448,33,69,.478,6,18,.333,26,35,.743,110,43,97,.443,35,75,.467,8,22,.364,11,14,.786,105,2014-03-28,ORL,CHA
25,Home,W 110-81 ,240,42,70,.600,31,45,.689,11,25,.440,15,20,.750,110,26,65,.400,18,39,.462,8,26,.308,21,28,.750,81,2014-04-02,NYK,BRK
26,Home,W 110-91 ,240,42,91,.462,37,76,.487,5,15,.333,21,26,.808,110,36,81,.444,32,64,.500,4,17,.235,15,25,.600,91,2014-04-08,MIN,SAS
27,@,L 110-112 ,240,36,83,.434,25,58,.431,11,25,.440,27,36,.750,110,41,94,.436,38,82,.463,3,12,.250,27,40,.675,112,2014-04-11,HOU,MIN
28,Home,W 110-100 ,240,38,81,.469,24,49,.490,14,32,.438,20,26,.769,110,38,73,.521,32,63,.508,6,10,.600,18,26,.692,100,2014-04-14,TOR,MIL
29,Home,W 110-104 ,240,42,101,.416,32,75,.427,10,26,.385,16,22,.727,110,34,84,.405,26,50,.520,8,34,.235,28,33,.848,104,2014-04-16,POR,LAC
30,@,W 110-105 ,240,34,81,.420,32,72,.444,2,9,.222,40,47,.851,110,36,93,.387,31,69,.449,5,24,.208,28,33,.848,105,2014-11-03,SAC,DEN
31,@,W 110-107 ,240,42,87,.483,35,71,.493,7,16,.438,19,23,.826,110,40,78,.513,30,52,.577,10,26,.385,17,18,.944,107,2014-11-05,TOR,BOS
32,Home,W 110-99 ,240,38,74,.514,24,50,.480,14,24,.583,20,26,.769,110,37,90,.411,29,71,.408,8,19,.421,17,21,.810,99,2014-11-07,BRK,NYK
33,@,W 110-101 ,240,40,84,.476,34,61,.557,6,23,.261,24,33,.727,110,40,85,.471,29,56,.518,11,29,.379,10,15,.667,101,2014-11-07,CLE,DEN
34,@,L 110-111 ,240,37,77,.481,30,64,.469,7,13,.538,29,34,.853,110,39,77,.506,33,68,.485,6,9,.667,27,34,.794,111,2014-11-13,SAC,MEM
35,@,W 110-93 ,240,43,77,.558,30,46,.652,13,31,.419,11,17,.647,110,30,67,.448,24,41,.585,6,26,.231,27,31,.871,93,2014-11-20,LAC,MIA
36,@,W 110-93 ,240,32,80,.400,24,56,.429,8,24,.333,38,42,.905,110,35,81,.432,32,65,.492,3,16,.188,20,29,.690,93,2014-11-22,TOR,CLE
37,@,W 110-103 ,240,40,89,.449,32,59,.542,8,30,.267,22,30,.733,110,36,85,.424,30,64,.469,6,21,.286,25,31,.806,103,2014-11-29,DAL,PHI
38,@,W 110-88 ,240,43,90,.478,34,65,.523,9,25,.360,15,22,.682,110,36,81,.444,32,62,.516,4,19,.211,12,19,.632,88,2014-12-08,CLE,BRK
39,Home,L 110-112 (OT),265,42,90,.467,30,59,.508,12,31,.387,14,21,.667,110,44,96,.458,32,72,.444,12,24,.500,12,15,.800,112,2014-12-12,SAS,LAL
40,Home,W 110-91 ,240,40,83,.482,33,66,.500,7,17,.412,23,27,.852,110,29,88,.330,19,62,.306,10,26,.385,23,29,.793,91,2014-12-15,IND,LAL
41,@,W 110-100 ,240,42,88,.477,34,61,.557,8,27,.296,18,24,.750,110,41,94,.436,33,69,.478,8,25,.320,10,15,.667,100,2014-12-19,TOR,DET
42,Home,W 110-105 ,240,40,76,.526,32,56,.571,8,20,.400,22,29,.759,110,40,91,.440,31,64,.484,9,27,.333,16,26,.615,105,2014-12-21,BRK,DET
43,Home,W 110-82 ,240,43,80,.538,35,61,.574,8,19,.421,16,24,.667,110,31,82,.378,29,64,.453,2,18,.111,18,24,.750,82,2014-12-22,CHO,DEN
44,Home,W 110-95 ,240,41,87,.471,28,51,.549,13,36,.361,15,20,.750,110,34,76,.447,24,49,.490,10,27,.370,17,18,.944,95,2014-12-22,HOU,POR
45,@,W 110-85 ,240,44,86,.512,35,68,.515,9,18,.500,13,18,.722,110,28,77,.364,21,52,.404,7,25,.280,22,27,.815,85,2014-12-27,IND,BRK
46,Home,W 110-97 ,240,41,88,.466,30,60,.500,11,28,.393,17,21,.810,110,34,77,.442,26,58,.448,8,19,.421,21,36,.583,97,2014-12-27,GSW,MIN
47,@,W 110-98 ,240,41,86,.477,28,52,.538,13,34,.382,15,19,.789,110,37,81,.457,25,56,.446,12,25,.480,12,15,.800,98,2014-12-27,TOR,LAC
48,Home,W 110-106 ,240,39,83,.470,28,53,.528,11,30,.367,21,24,.875,110,38,77,.494,26,44,.591,12,33,.364,18,31,.581,106,2014-12-28,SAS,HOU
49,Home,W 110-106 ,240,42,81,.519,34,63,.540,8,18,.444,18,29,.621,110,41,86,.477,32,65,.492,9,21,.429,15,19,.789,106,2014-12-30,NOP,PHO
50,@,W 110-107 ,240,40,74,.541,35,62,.565,5,12,.417,25,29,.862,110,42,91,.462,35,67,.522,7,24,.292,16,22,.727,107,2015-01-01,SAC,MIN
51,@,W 110-101 ,240,46,84,.548,39,65,.600,7,19,.368,11,16,.688,110,38,89,.427,28,65,.431,10,24,.417,15,18,.833,101,2015-01-05,DEN,MIN
52,@,W 110-82 ,240,39,78,.500,32,62,.516,7,16,.438,25,33,.758,110,33,85,.388,25,56,.446,8,29,.276,8,9,.889,82,2015-01-10,CHO,NYK
53,@,L 110-122 (2OT),290,42,100,.420,34,65,.523,8,35,.229,18,23,.783,110,48,100,.480,39,79,.494,9,21,.429,17,24,.708,122,2015-01-11,PHO,MEM
54,@,W 110-101 ,240,41,87,.471,31,67,.463,10,20,.500,18,19,.947,110,39,80,.488,34,62,.548,5,18,.278,18,30,.600,101,2015-01-13,MIN,IND
55,Home,W 110-99 ,240,48,87,.552,43,72,.597,5,15,.333,9,11,.818,110,42,91,.462,34,69,.493,8,22,.364,7,12,.583,99,2015-01-16,PHO,MIN
56,Home,W 110-96 ,240,42,94,.447,31,65,.477,11,29,.379,15,17,.882,110,37,74,.500,31,55,.564,6,19,.316,16,20,.800,96,2015-01-16,SAS,POR
57,@,W 110-89 ,240,42,69,.609,30,46,.652,12,23,.522,14,16,.875,110,35,82,.427,29,57,.509,6,25,.240,13,17,.765,89,2015-01-16,ATL,TOR
58,Home,W 110-98 ,240,37,72,.514,25,41,.610,12,31,.387,24,33,.727,110,39,85,.459,33,58,.569,6,27,.222,14,18,.778,98,2015-01-19,HOU,IND
59,Home,W 110-91 ,240,39,78,.500,26,49,.531,13,29,.448,19,26,.731,110,31,78,.397,26,53,.491,5,25,.200,24,26,.923,91,2015-01-21,ATL,IND
60,@,L 110-114 ,240,41,90,.456,29,56,.518,12,34,.353,16,23,.696,110,43,81,.531,38,66,.576,5,15,.333,23,29,.793,114,2015-01-25,DET,TOR
61,Home,W 110-98 ,240,38,77,.494,32,61,.525,6,16,.375,28,32,.875,110,42,91,.462,35,68,.515,7,23,.304,7,9,.778,98,2015-01-28,MIN,BOS
62,Home,W 110-100 ,240,42,94,.447,33,69,.478,9,25,.360,17,28,.607,110,37,86,.430,29,59,.492,8,27,.296,18,25,.720,100,2015-01-30,UTA,GSW
63,Home,W 110-103 ,240,44,84,.524,30,52,.577,14,32,.438,8,14,.571,110,42,84,.500,32,63,.508,10,21,.476,9,14,.643,103,2015-02-04,SAS,ORL
64,Home,W 110-95 ,240,39,81,.481,35,59,.593,4,22,.182,28,45,.622,110,34,87,.391,25,42,.595,9,45,.200,18,22,.818,95,2015-02-11,LAC,HOU
65,Home,W 110-99 ,240,41,84,.488,24,51,.471,17,33,.515,11,18,.611,110,39,81,.481,33,62,.532,6,19,.316,15,20,.750,99,2015-02-20,GSW,SAS
66,@,W 110-103 ,240,42,95,.442,37,77,.481,5,18,.278,21,26,.808,110,40,93,.430,33,69,.478,7,24,.292,16,20,.800,103,2015-02-21,OKC,CHO
67,@,W 110-82 ,240,43,92,.467,39,71,.549,4,21,.190,20,23,.870,110,31,94,.330,24,67,.358,7,27,.259,13,22,.591,82,2015-02-23,BRK,DEN
68,Home,L 110-115 ,240,44,97,.454,35,65,.538,9,32,.281,13,16,.813,110,39,89,.438,25,60,.417,14,29,.483,23,30,.767,115,2015-02-23,PHO,BOS
69,@,W 110-96 ,240,39,91,.429,31,67,.463,8,24,.333,24,32,.750,110,31,81,.383,19,47,.404,12,34,.353,22,33,.667,96,2015-02-25,PHO,DEN
70,Home,W 110-105 ,240,36,88,.409,19,44,.432,17,44,.386,21,30,.700,110,40,91,.440,29,59,.492,11,32,.344,14,19,.737,105,2015-02-25,HOU,LAC
71,Home,W 110-99 ,240,36,77,.468,27,49,.551,9,28,.321,29,35,.829,110,39,92,.424,28,63,.444,11,29,.379,10,19,.526,99,2015-02-26,CLE,GSW
72,@,W 110-99 ,240,41,83,.494,31,59,.525,10,24,.417,18,20,.900,110,39,86,.453,36,74,.486,3,12,.250,18,23,.783,99,2015-03-01,POR,SAC
73,Home,W 110-108 ,240,44,89,.494,34,68,.500,10,21,.476,12,16,.750,110,42,90,.467,31,60,.517,11,30,.367,13,18,.722,108,2015-03-02,BRK,GSW
74,@,W 110-105 ,240,44,92,.478,32,59,.542,12,33,.364,10,19,.526,110,36,82,.439,32,67,.478,4,15,.267,29,35,.829,105,2015-03-02,LAC,MIN
75,Home,W 110-79 ,240,43,89,.483,33,61,.541,10,28,.357,14,14,1.000,110,31,88,.352,24,60,.400,7,28,.250,10,13,.769,79,2015-03-03,CLE,BOS
76,@,W 110-103 ,240,38,84,.452,26,53,.491,12,31,.387,22,30,.733,110,38,81,.469,31,61,.508,7,20,.350,20,25,.800,103,2015-03-16,ATL,SAC
77,@,W 110-91 ,240,47,92,.511,41,70,.586,6,22,.273,10,14,.714,110,32,89,.360,31,72,.431,1,17,.059,26,30,.867,91,2015-03-23,BOS,BRK
78,@,W 110-100 ,240,31,65,.477,18,41,.439,13,24,.542,35,37,.946,110,40,90,.444,32,66,.485,8,24,.333,12,19,.632,100,2015-03-23,HOU,IND
79,@,L 110-120 ,240,37,76,.487,31,62,.500,6,14,.429,30,34,.882,110,44,83,.530,24,39,.615,20,44,.455,12,17,.706,120,2015-03-27,MIN,HOU
80,Home,W 110-107 (2OT),290,44,113,.389,35,88,.398,9,25,.360,13,22,.591,110,36,104,.346,28,79,.354,8,25,.320,27,35,.771,107,2015-03-27,WAS,CHO
81,Home,W 110-88 ,240,43,75,.573,37,62,.597,6,13,.462,18,24,.750,110,32,75,.427,30,63,.476,2,12,.167,22,24,.917,88,2015-03-29,NOP,MIN
82,@,W 110-106 ,240,38,85,.447,30,64,.469,8,21,.381,26,34,.765,110,36,82,.439,30,60,.500,6,22,.273,28,33,.848,106,2015-03-31,GSW,LAC
83,@,W 110-101 ,240,45,85,.529,36,61,.590,9,24,.375,11,18,.611,110,39,88,.443,31,64,.484,8,24,.333,15,16,.938,101,2015-04-03,MIL,BOS
84,Home,L 110-123 ,240,34,80,.425,31,64,.484,3,16,.188,39,54,.722,110,43,95,.453,29,59,.492,14,36,.389,23,32,.719,123,2015-04-04,DAL,GSW
85,Home,W 110-74 ,240,45,88,.511,37,71,.521,8,17,.471,12,14,.857,110,28,80,.350,22,59,.373,6,21,.286,12,18,.667,74,2015-04-08,MEM,NOP
86,Home,W 110-98 ,240,48,95,.505,41,74,.554,7,21,.333,7,9,.778,110,39,84,.464,29,59,.492,10,25,.400,10,16,.625,98,2015-04-08,SAS,HOU
87,Home,W 110-101 ,240,42,93,.452,31,62,.500,11,31,.355,15,21,.714,110,35,79,.443,24,55,.436,11,24,.458,20,26,.769,101,2015-04-11,GSW,MIN
88,Home,W 110-103 ,240,37,82,.451,30,61,.492,7,21,.333,29,37,.784,110,38,101,.376,26,68,.382,12,33,.364,15,22,.682,103,2015-04-13,LAC,DEN
89,Home,W 110-92 ,240,37,83,.446,33,65,.508,4,18,.222,32,42,.762,110,34,86,.395,25,62,.403,9,24,.375,15,19,.789,92,2015-10-30,PHO,POR
90,Home,L 110-117 ,240,38,90,.422,32,68,.471,6,22,.273,28,33,.848,110,41,86,.477,32,67,.478,9,19,.474,26,32,.813,117,2015-10-31,WAS,NYK
91,Home,W 110-105 ,240,41,89,.461,32,60,.533,9,29,.310,19,29,.655,110,40,84,.476,30,61,.492,10,23,.435,15,22,.682,105,2015-11-02,HOU,OKC
92,Home,L 110-116 ,240,40,93,.430,31,65,.477,9,28,.321,21,29,.724,110,40,82,.488,25,46,.543,15,36,.417,21,27,.778,116,2015-11-06,SAC,HOU
93,@,W 110-98 ,240,43,89,.483,35,61,.574,8,28,.286,16,21,.762,110,32,84,.381,23,50,.460,9,34,.265,25,32,.781,98,2015-11-14,DAL,HOU
94,@,L 110-115 ,240,37,79,.468,31,61,.508,6,18,.333,30,39,.769,110,43,80,.538,32,51,.627,11,29,.379,18,27,.667,115,2015-11-17,TOR,GSW
95,Home,W 110-103 ,240,38,85,.447,31,68,.456,7,17,.412,27,40,.675,110,43,95,.453,35,63,.556,8,32,.250,9,9,1.000,103,2015-11-18,OKC,NOP
96,Home,W 110-96 ,240,37,86,.430,30,65,.462,7,21,.333,29,37,.784,110,30,77,.390,19,43,.442,11,34,.324,25,28,.893,96,2015-11-24,MEM,DAL
97,Home,W 110-99 ,240,41,78,.526,31,54,.574,10,24,.417,18,21,.857,110,43,94,.457,40,81,.494,3,13,.231,10,12,.833,99,2015-11-25,OKC,BRK
98,Home,W 110-91 ,240,45,93,.484,36,68,.529,9,25,.360,11,16,.688,110,36,88,.409,31,61,.508,5,27,.185,14,20,.700,91,2015-11-29,ORL,BOS
99,@,W 110-106 ,240,38,86,.442,30,61,.492,8,25,.320,26,29,.897,110,36,82,.439,29,64,.453,7,18,.389,27,35,.771,106,2015-12-07,LAC,MIN
0,Home,W 110-105 ,240,45,81,.556,38,63,.603,7,18,.389,13,16,.813,110,39,82,.476,24,47,.511,15,35,.429,12,17,.706,105,2015-12-08,BRK,HOU
1,Home,L 110-112 ,240,41,89,.461,35,68,.515,6,21,.286,22,29,.759,110,39,75,.520,30,54,.556,9,21,.429,25,28,.893,112,2015-12-12,POR,NYK
2,Home,W 110-89 ,240,36,79,.456,27,54,.500,9,25,.360,29,37,.784,110,31,79,.392,24,55,.436,7,24,.292,20,22,.909,89,2015-12-21,UTA,PHO
3,Home,W 110-108 ,240,38,75,.507,25,51,.490,13,24,.542,21,26,.808,110,38,84,.452,23,51,.451,15,33,.455,17,20,.850,108,2015-12-26,NOP,HOU
4,Home,W 110-103 ,240,41,87,.471,29,55,.527,12,32,.375,16,20,.800,110,37,87,.425,25,60,.417,12,27,.444,17,19,.895,103,2015-12-30,POR,DEN
5,@,W 110-105 ,240,40,94,.426,31,63,.492,9,31,.290,21,34,.618,110,36,74,.486,28,49,.571,8,25,.320,25,41,.610,105,2015-12-30,PHI,SAC
6,Home,L 110-114 ,240,36,78,.462,24,48,.500,12,30,.400,26,29,.897,110,43,84,.512,32,61,.525,11,23,.478,17,27,.630,114,2015-12-31,HOU,GSW
7,Home,W 110-106 ,240,42,80,.525,35,59,.593,7,21,.333,19,24,.792,110,43,82,.524,35,62,.565,8,20,.400,12,13,.923,106,2015-12-31,OKC,PHO
8,@,L 110-115 ,240,37,76,.487,27,55,.491,10,21,.476,26,36,.722,110,42,100,.420,23,56,.411,19,44,.432,12,14,.857,115,2016-01-10,OKC,POR
9,@,W 110-107 (OT),265,40,97,.412,23,53,.434,17,44,.386,13,16,.813,110,39,79,.494,28,51,.549,11,28,.393,18,22,.818,107,2016-01-12,CLE,DAL
10,Home,W 110-104 ,240,45,86,.523,36,69,.522,9,17,.529,11,14,.786,110,41,91,.451,34,69,.493,7,22,.318,15,23,.652,104,2016-01-13,BRK,NYK
11,@,L 110-112 ,240,42,88,.477,32,62,.516,10,26,.385,16,20,.800,110,37,87,.425,32,65,.492,5,22,.227,33,37,.892,112,2016-01-13,GSW,DEN
12,@,W 110-103 ,240,36,76,.474,23,51,.451,13,25,.520,25,33,.758,110,38,96,.396,25,57,.439,13,39,.333,14,19,.737,103,2016-01-16,SAC,LAC
13,@,W 110-104 ,240,41,97,.423,35,69,.507,6,28,.214,22,30,.733,110,35,83,.422,28,63,.444,7,20,.350,27,36,.750,104,2016-01-19,OKC,DEN
14,Home,W 110-101 ,240,43,96,.448,35,73,.479,8,23,.348,16,21,.762,110,38,89,.427,35,76,.461,3,13,.231,22,26,.846,101,2016-01-22,BOS,CHI
15,@,L 110-122 ,240,44,95,.463,41,78,.526,3,17,.176,19,27,.704,110,43,90,.478,29,57,.509,14,33,.424,22,25,.880,122,2016-01-22,IND,GSW
16,Home,W 110-97 ,240,39,91,.429,34,70,.486,5,21,.238,27,38,.711,110,39,82,.476,32,63,.508,7,19,.368,12,17,.706,97,2016-01-27,DET,PHI
17,@,W 110-95 ,240,43,71,.606,34,55,.618,9,16,.563,15,18,.833,110,36,88,.409,26,62,.419,10,26,.385,13,21,.619,95,2016-02-01,MEM,NOP
18,Home,W 110-97 ,240,42,81,.519,33,66,.500,9,15,.600,17,18,.944,110,41,90,.456,38,71,.535,3,19,.158,12,14,.857,97,2016-02-03,SAS,NOP
19,@,W 110-103 ,240,40,85,.471,28,66,.424,12,19,.632,18,25,.720,110,38,81,.469,28,56,.500,10,25,.400,17,23,.739,103,2016-02-04,TOR,POR
20,@,L 110-115 ,240,43,93,.462,38,81,.469,5,12,.417,19,27,.704,110,39,87,.448,33,69,.478,6,18,.333,31,44,.705,115,2016-02-05,CHI,DEN
21,Home,L 110-114 (OT),265,44,88,.500,35,65,.538,9,23,.391,13,23,.565,110,38,88,.432,23,50,.460,15,38,.395,23,33,.697,114,2016-02-06,MEM,DAL
22,Home,L 110-117 (OT),265,43,92,.467,31,63,.492,12,29,.414,12,20,.600,110,46,93,.495,37,64,.578,9,29,.310,16,22,.727,117,2016-02-08,ATL,ORL
23,@,L 110-123 ,240,37,87,.425,24,54,.444,13,33,.394,23,35,.657,110,44,94,.468,32,60,.533,12,34,.353,23,26,.885,123,2016-02-09,HOU,GSW
24,Home,L 110-114 ,240,42,91,.462,27,56,.482,15,35,.429,11,17,.647,110,44,87,.506,40,71,.563,4,16,.250,22,29,.759,114,2016-02-10,PHI,SAC
25,Home,W 110-104 (OT),265,41,102,.402,28,67,.418,13,35,.371,15,17,.882,110,37,89,.416,18,48,.375,19,41,.463,11,18,.611,104,2016-02-19,ORL,DAL
26,@,L 110-116 ,240,42,90,.467,34,66,.515,8,24,.333,18,26,.692,110,41,83,.494,31,62,.500,10,21,.476,24,31,.774,116,2016-02-19,DEN,SAC
27,Home,L 110-114 ,240,41,100,.410,31,73,.425,10,27,.370,18,22,.818,110,43,83,.518,36,66,.545,7,17,.412,21,28,.750,114,2016-02-23,DEN,SAC
28,Home,L 110-112 ,240,39,84,.464,29,57,.509,10,27,.370,22,26,.846,110,42,84,.500,37,69,.536,5,15,.333,23,30,.767,112,2016-02-27,NOP,MIN
29,Home,W 110-94 ,240,45,99,.455,39,78,.500,6,21,.286,14,19,.737,110,33,75,.440,27,57,.474,6,18,.333,22,26,.846,94,2016-03-08,DEN,NYK
30,@,L 110-116 ,240,40,80,.500,31,56,.554,9,24,.375,21,24,.875,110,44,81,.543,36,56,.643,8,25,.320,20,25,.800,116,2016-03-15,DEN,ORL
31,@,L 110-118 ,240,39,89,.438,29,67,.433,10,22,.455,22,30,.733,110,45,86,.523,37,70,.529,8,16,.500,20,22,.909,118,2016-03-17,POR,SAS
32,Home,W 110-104 ,240,44,77,.571,37,59,.627,7,18,.389,15,18,.833,110,44,83,.530,37,65,.569,7,18,.389,9,13,.692,104,2016-03-25,SAS,MEM
33,@,L 110-120 ,240,37,77,.481,26,53,.491,11,24,.458,25,30,.833,110,42,77,.545,37,66,.561,5,11,.455,31,36,.861,120,2016-03-26,IND,BRK
34,Home,W 110-99 ,240,48,84,.571,43,68,.632,5,16,.313,9,12,.750,110,41,77,.532,38,66,.576,3,11,.273,14,18,.778,99,2016-03-28,MIA,BRK
35,@,W 110-108 (OT),265,39,98,.398,27,60,.450,12,38,.316,20,31,.645,110,38,95,.400,29,65,.446,9,30,.300,23,26,.885,108,2016-04-01,CLE,ATL
36,@,L 110-113 ,240,46,86,.535,38,62,.613,8,24,.333,10,12,.833,110,47,86,.547,43,69,.623,4,17,.235,15,25,.600,113,2016-04-01,ORL,MIL
37,Home,W 110-93 ,240,41,79,.519,31,64,.484,10,15,.667,18,23,.783,110,34,88,.386,28,69,.406,6,19,.316,19,27,.704,93,2016-04-02,POR,MIA
38,@,L 110-118 ,240,38,82,.463,31,55,.564,7,27,.259,27,32,.844,110,41,102,.402,28,60,.467,13,42,.310,23,26,.885,118,2016-04-03,OKC,HOU
39,Home,W 110-102 ,240,42,79,.532,32,57,.561,10,22,.455,16,21,.762,110,34,81,.420,23,57,.404,11,24,.458,23,27,.852,102,2016-04-08,NOP,LAL
40,@,L 110-130 ,240,41,83,.494,29,55,.527,12,28,.429,16,19,.842,110,50,98,.510,33,57,.579,17,41,.415,13,18,.722,130,2016-04-10,LAL,HOU
41,Home,W 110-84 ,240,41,75,.547,29,50,.580,12,25,.480,16,21,.762,110,35,86,.407,30,66,.455,5,20,.250,9,14,.643,84,2016-04-12,LAC,MEM
42,Home,L 110-112 (OT),265,46,97,.474,39,79,.494,7,18,.389,11,15,.733,110,37,85,.435,21,52,.404,16,33,.485,22,28,.786,112,2016-04-13,CLE,DET
43,@,L 110-113 (OT),265,42,94,.447,37,66,.561,5,28,.179,21,32,.656,110,40,96,.417,35,75,.467,5,21,.238,28,38,.737,113,2016-10-28,PHO,OKC
44,Home,W 110-108 ,240,41,88,.466,33,66,.500,8,22,.364,20,24,.833,110,37,84,.440,26,50,.520,11,34,.324,23,28,.821,108,2016-10-29,MIL,BRK
45,@,L 110-119 ,240,39,92,.424,27,64,.422,12,28,.429,20,28,.714,110,42,76,.553,30,43,.698,12,33,.364,23,26,.885,119,2016-11-08,MIN,BRK
46,@,W 110-106 ,240,41,81,.506,30,52,.577,11,29,.379,17,24,.708,110,37,99,.374,26,57,.456,11,42,.262,21,25,.840,106,2016-11-08,ATL,CLE
47,Home,W 110-96 ,240,44,92,.478,34,62,.548,10,30,.333,12,17,.706,110,33,79,.418,22,46,.478,11,33,.333,19,27,.704,96,2016-11-09,NYK,BRK
48,@,W 110-108 ,240,39,86,.453,28,59,.475,11,27,.407,21,35,.600,110,38,88,.432,22,60,.367,16,28,.571,16,19,.842,108,2016-11-11,LAC,OKC
49,@,W 110-105 ,240,43,88,.489,32,58,.552,11,30,.367,13,17,.765,110,36,76,.474,27,56,.482,9,20,.450,24,31,.774,105,2016-11-16,SAS,SAC
50,Home,W 110-86 ,240,43,84,.512,37,59,.627,6,25,.240,18,20,.900,110,31,83,.373,22,51,.431,9,32,.281,15,19,.789,86,2016-11-17,MIN,PHI
51,Home,L 110-118 ,240,41,93,.441,28,62,.452,13,31,.419,15,21,.714,110,45,87,.517,37,65,.569,8,22,.364,20,28,.714,118,2016-11-20,LAL,CHI
52,Home,W 110-107 ,240,43,100,.430,33,78,.423,10,22,.455,14,17,.824,110,43,95,.453,37,77,.481,6,18,.333,15,18,.833,107,2016-11-22,DEN,CHI
53,@,W 110-107 ,240,37,73,.507,28,48,.583,9,25,.360,27,33,.818,110,40,81,.494,29,50,.580,11,31,.355,16,24,.667,107,2016-11-26,MEM,MIA
54,Home,L 110-111 ,240,40,73,.548,23,43,.535,17,30,.567,13,17,.765,110,44,86,.512,36,67,.537,8,19,.421,15,19,.789,111,2016-12-01,UTA,MIA
55,Home,L 110-128 ,240,46,104,.442,37,73,.507,9,31,.290,9,16,.563,110,45,88,.511,28,51,.549,17,37,.459,21,25,.840,128,2016-12-02,DEN,HOU
56,Home,L 110-112 ,240,35,83,.422,28,60,.467,7,23,.304,33,38,.868,110,45,93,.484,36,69,.522,9,24,.375,13,18,.722,112,2016-12-05,CHI,POR
57,@,W 110-108 (2OT),290,42,104,.404,29,70,.414,13,34,.382,13,21,.619,110,39,99,.394,29,67,.433,10,32,.313,20,21,.952,108,2016-12-05,MEM,NOP
58,@,L 110-124 ,240,45,88,.511,36,60,.600,9,28,.321,11,15,.733,110,43,87,.494,31,60,.517,12,27,.444,26,33,.788,124,2016-12-08,MIN,TOR
59,Home,L 110-114 ,240,44,94,.468,32,66,.485,12,28,.429,10,14,.714,110,40,84,.476,28,50,.560,12,34,.353,22,29,.759,114,2016-12-09,MIL,ATL
60,Home,W 110-89 ,240,38,87,.437,30,61,.492,8,26,.308,26,29,.897,110,34,77,.442,25,50,.500,9,27,.333,12,20,.600,89,2016-12-10,MEM,GSW
61,Home,W 110-105 ,240,40,88,.455,32,67,.478,8,21,.381,22,28,.786,110,40,79,.506,27,54,.500,13,25,.520,12,15,.800,105,2016-12-10,WAS,MIL
62,Home,W 110-94 ,240,43,88,.489,26,52,.500,17,36,.472,7,10,.700,110,28,84,.333,18,58,.310,10,26,.385,28,32,.875,94,2016-12-12,IND,CHO
63,@,L 110-117 ,240,43,87,.494,36,64,.563,7,23,.304,17,24,.708,110,43,81,.531,33,62,.532,10,19,.526,21,30,.700,117,2016-12-18,LAC,WAS
64,@,W 110-108 ,240,41,75,.547,32,52,.615,9,23,.391,19,24,.792,110,39,87,.448,29,52,.558,10,35,.286,20,26,.769,108,2016-12-19,ATL,OKC
65,Home,L 110-121 ,240,42,88,.477,34,68,.500,8,20,.400,18,23,.783,110,45,88,.511,34,60,.567,11,28,.393,20,24,.833,121,2016-12-21,NOP,OKC
66,@,W 110-90 ,240,39,78,.500,27,58,.466,12,20,.600,20,21,.952,110,35,79,.443,23,49,.469,12,30,.400,8,16,.500,90,2016-12-23,SAS,POR
67,Home,W 110-94 ,240,39,78,.500,28,56,.500,11,22,.500,21,25,.840,110,35,77,.455,29,57,.509,6,20,.300,18,21,.857,94,2016-12-30,SAS,POR
68,Home,W 110-82 ,240,43,78,.551,30,54,.556,13,24,.542,11,15,.733,110,31,83,.373,27,65,.415,4,18,.222,16,22,.727,82,2017-01-03,SAS,TOR
69,Home,W 110-106 ,240,35,87,.402,16,47,.340,19,40,.475,21,25,.840,110,37,79,.468,28,51,.549,9,28,.321,23,26,.885,106,2017-01-06,BOS,PHI
70,@,W 110-96 ,240,41,84,.488,29,57,.509,12,27,.444,16,19,.842,110,36,85,.424,25,56,.446,11,29,.379,13,16,.813,96,2017-01-09,NOP,NYK
71,@,W 110-105 ,240,41,76,.539,31,49,.633,10,27,.370,18,27,.667,110,33,82,.402,23,41,.561,10,41,.244,29,36,.806,105,2017-01-13,MEM,HOU
72,Home,W 110-77 ,240,43,80,.538,27,49,.551,16,31,.516,8,13,.615,110,30,76,.395,24,59,.407,6,17,.353,11,16,.688,77,2017-01-13,UTA,DET
73,Home,L 110-113 ,240,42,90,.467,35,66,.530,7,24,.292,19,22,.864,110,44,88,.500,31,56,.554,13,32,.406,12,14,.857,113,2017-01-19,NYK,WAS
74,Home,W 110-93 ,240,45,91,.495,38,71,.535,7,20,.350,13,23,.565,110,33,78,.423,21,49,.429,12,29,.414,15,18,.833,93,2017-01-21,ATL,PHI
75,@,L 110-121 ,240,33,71,.465,15,37,.405,18,34,.529,26,41,.634,110,45,90,.500,35,61,.574,10,29,.345,21,22,.955,121,2017-01-24,LAC,PHI
76,Home,W 110-107 ,240,46,96,.479,37,69,.536,9,27,.333,9,13,.692,110,40,90,.444,27,53,.509,13,37,.351,14,15,.933,107,2017-01-27,NYK,CHO
77,Home,W 110-87 ,240,42,84,.500,31,56,.554,11,28,.393,15,16,.938,110,34,79,.430,26,53,.491,8,26,.308,11,17,.647,87,2017-02-06,DEN,DAL
78,Home,L 110-114 (OT),265,38,91,.418,29,58,.500,9,33,.273,25,36,.694,110,40,97,.412,31,72,.431,9,25,.360,25,33,.758,114,2017-02-08,BRK,WAS
79,Home,W 110-91 ,240,35,72,.486,21,48,.438,14,24,.583,26,34,.765,110,29,87,.333,24,64,.375,5,23,.217,28,34,.824,91,2017-02-08,MEM,PHO
80,@,L 110-132 ,240,45,92,.489,37,60,.617,8,32,.250,12,13,.923,110,48,88,.545,24,47,.511,24,41,.585,12,16,.750,132,2017-02-13,GSW,DEN
81,@,W 110-106 ,240,40,87,.460,33,72,.458,7,15,.467,23,27,.852,110,38,78,.487,29,58,.500,9,20,.450,21,30,.700,106,2017-02-13,SAS,IND
82,@,W 110-108 ,240,37,78,.474,29,50,.580,8,28,.286,28,35,.800,110,40,93,.430,32,70,.457,8,23,.348,20,24,.833,108,2017-02-13,NOP,PHO
83,Home,W 110-93 ,240,44,97,.454,34,73,.466,10,24,.417,12,17,.706,110,40,101,.396,33,66,.500,7,35,.200,6,14,.429,93,2017-02-24,OKC,LAL
84,Home,W 110-109 ,240,43,91,.473,37,70,.529,6,21,.286,18,23,.783,110,40,95,.421,33,64,.516,7,31,.226,22,27,.815,109,2017-02-25,NYK,PHI
85,@,L 110-118 ,240,36,80,.450,28,59,.475,8,21,.381,30,37,.811,110,42,88,.477,36,67,.537,6,21,.286,28,37,.757,118,2017-02-26,NOP,OKC
86,@,W 110-98 ,240,41,84,.488,31,51,.608,10,33,.303,18,20,.900,110,38,83,.458,29,65,.446,9,18,.500,13,15,.867,98,2017-03-01,DEN,MIL
87,Home,W 110-99 ,240,45,90,.500,40,73,.548,5,17,.294,15,19,.789,110,35,91,.385,27,63,.429,8,28,.286,21,25,.840,99,2017-03-03,ORL,MIA
88,@,W 110-109 (OT),265,41,90,.456,31,57,.544,10,33,.303,18,27,.667,110,43,83,.518,35,66,.530,8,17,.471,15,20,.750,109,2017-03-05,UTA,SAC
89,@,L 110-112 ,240,41,88,.466,27,49,.551,14,39,.359,14,17,.824,110,40,87,.460,29,60,.483,11,27,.407,21,23,.913,112,2017-03-06,HOU,SAS
90,Home,W 110-105 ,240,41,95,.432,37,75,.493,4,20,.200,24,32,.750,110,37,80,.463,26,46,.565,11,34,.324,20,25,.800,105,2017-03-08,ATL,BRK
91,Home,L 110-122 ,240,42,91,.462,36,72,.500,6,19,.316,20,25,.800,110,47,98,.480,35,71,.493,12,27,.444,16,24,.667,122,2017-03-09,PHO,LAL
92,Home,L 109-116 (3OT),315,36,94,.383,30,72,.417,6,22,.273,31,46,.674,109,45,102,.441,37,74,.500,8,28,.286,18,23,.783,116,2012-01-05,ATL,MIA
93,Home,W 109-94 ,240,42,80,.525,36,66,.545,6,14,.429,19,25,.760,109,36,78,.462,33,65,.508,3,13,.231,19,27,.704,94,2012-01-06,OKC,HOU
94,Home,W 109-94 ,240,47,83,.566,38,71,.535,9,12,.750,6,6,1.000,109,36,82,.439,30,68,.441,6,14,.429,16,20,.800,94,2012-01-07,ATL,CHI
95,Home,W 109-93 ,240,43,77,.558,33,55,.600,10,22,.455,13,17,.765,109,37,86,.430,34,71,.479,3,15,.200,16,24,.667,93,2012-01-08,PHO,MIL
96,Home,L 109-117 ,240,43,82,.524,33,59,.559,10,23,.435,13,19,.684,109,35,68,.515,24,45,.533,11,23,.478,36,55,.655,117,2012-01-12,GSW,ORL
97,Home,L 109-120 ,240,41,87,.471,29,59,.492,12,28,.429,15,19,.789,109,42,88,.477,38,71,.535,4,17,.235,32,37,.865,120,2012-01-27,GSW,OKC
98,Home,W 109-71 ,240,43,91,.473,36,71,.507,7,20,.350,16,19,.842,109,29,78,.372,25,65,.385,4,13,.308,9,18,.500,71,2012-01-27,POR,PHO
99,@,W 109-105 ,240,39,86,.453,25,56,.446,14,30,.467,17,26,.654,109,42,85,.494,36,67,.537,6,18,.333,15,20,.750,105,2012-01-29,LAC,DEN
0,Home,W 109-95 ,240,43,78,.551,37,63,.587,6,15,.400,17,21,.810,109,40,75,.533,36,62,.581,4,13,.308,11,19,.579,95,2012-01-30,MIA,NOH
1,@,W 109-99 ,240,38,84,.452,31,69,.449,7,15,.467,26,34,.765,109,34,91,.374,31,74,.419,3,17,.176,28,37,.757,99,2012-02-01,IND,MIN
2,Home,W 109-103 ,240,33,73,.452,20,43,.465,13,30,.433,30,39,.769,109,42,92,.457,30,69,.435,12,23,.522,7,9,.778,103,2012-02-01,ORL,WAS
3,@,W 109-101 ,240,41,79,.519,28,54,.519,13,25,.520,14,22,.636,109,37,85,.435,28,61,.459,9,24,.375,18,27,.667,101,2012-02-09,GSW,DEN
4,Home,W 109-92 ,240,43,79,.544,39,69,.565,4,10,.400,19,25,.760,109,31,74,.419,26,55,.473,5,19,.263,25,31,.806,92,2012-02-10,DET,NJN
5,Home,L 109-113 ,240,42,79,.532,34,57,.596,8,22,.364,17,22,.773,109,43,87,.494,38,70,.543,5,17,.294,22,33,.667,113,2012-02-11,IND,DEN
6,Home,W 109-92 ,240,40,78,.513,36,64,.563,4,14,.286,25,34,.735,109,33,99,.333,24,75,.320,9,24,.375,17,19,.895,92,2012-02-14,DEN,PHO
7,Home,L 109-124 ,240,40,85,.471,33,62,.532,7,23,.304,22,27,.815,109,48,80,.600,39,63,.619,9,17,.529,19,23,.826,124,2012-02-14,POR,WAS
8,@,W 109-97 ,240,40,78,.513,30,56,.536,10,22,.455,19,27,.704,109,40,85,.471,38,74,.514,2,11,.182,15,22,.682,97,2012-02-28,MIN,LAC
9,Home,W 109-94 ,240,42,84,.500,41,74,.554,1,10,.100,24,32,.750,109,36,82,.439,33,73,.452,3,9,.333,19,29,.655,94,2012-02-29,DET,CHA
10,@,W 109-100 ,240,40,80,.500,35,71,.493,5,9,.556,24,29,.828,109,37,81,.457,28,58,.483,9,23,.391,17,27,.630,100,2012-03-05,UTA,CLE
11,Home,W 109-101 ,240,41,83,.494,31,63,.492,10,20,.500,17,22,.773,109,40,78,.513,32,63,.508,8,15,.533,13,18,.722,101,2012-03-16,PHO,DET
12,@,W 109-93 ,240,45,77,.584,36,59,.610,9,18,.500,10,13,.769,109,35,82,.427,27,56,.482,8,26,.308,15,22,.682,93,2012-03-21,LAL,DAL
13,Home,W 109-83 ,240,40,85,.471,34,68,.500,6,17,.353,23,27,.852,109,34,82,.415,28,66,.424,6,16,.375,9,10,.900,83,2012-03-22,HOU,GSW
14,@,W 109-95 ,240,45,79,.570,39,62,.629,6,17,.353,13,16,.813,109,34,79,.430,27,63,.429,7,16,.438,20,25,.800,95,2012-03-27,OKC,POR
15,@,W 109-100 ,240,40,90,.444,35,68,.515,5,22,.227,24,28,.857,109,39,85,.459,38,75,.507,1,10,.100,21,32,.656,100,2012-04-03,PHO,SAC
16,@,W 109-96 ,240,44,76,.579,40,65,.615,4,11,.364,17,19,.895,109,39,84,.464,33,66,.500,6,18,.333,12,19,.632,96,2012-04-04,IND,WAS
17,Home,W 109-94 ,240,44,89,.494,33,62,.532,11,27,.407,10,19,.526,109,34,82,.415,27,60,.450,7,22,.318,19,28,.679,94,2012-04-07,LAC,SAC
18,@,W 109-89 ,240,39,81,.481,31,61,.508,8,20,.400,23,25,.920,109,37,87,.425,31,68,.456,6,19,.316,9,13,.692,89,2012-04-09,OKC,MIL
19,@,W 109-85 ,240,43,82,.524,38,69,.551,5,13,.385,18,21,.857,109,31,70,.443,25,59,.424,6,11,.545,17,23,.739,85,2012-04-12,DET,CHA
20,@,W 109-81 ,240,40,79,.506,26,44,.591,14,35,.400,15,16,.938,109,33,85,.388,27,57,.474,6,28,.214,9,14,.643,81,2012-04-13,ATL,ORL
21,@,W 109-87 ,240,39,80,.488,33,59,.559,6,21,.286,25,36,.694,109,35,79,.443,31,70,.443,4,9,.444,13,16,.813,87,2012-04-16,ATL,TOR
22,@,W 109-97 ,240,36,80,.450,30,64,.469,6,16,.375,31,34,.912,109,34,83,.410,28,63,.444,6,20,.300,23,32,.719,97,2012-04-18,OKC,PHO
23,@,L 109-118 ,240,37,88,.420,31,68,.456,6,20,.300,29,33,.879,109,43,91,.473,36,74,.486,7,17,.412,25,32,.781,118,2012-04-19,MIL,IND
24,@,W 109-106 (OT),265,40,89,.449,34,71,.479,6,18,.333,23,33,.697,109,42,97,.433,39,85,.459,3,12,.250,19,25,.760,106,2012-04-21,PHI,IND
25,Home,W 109-101 ,240,38,81,.469,33,68,.485,5,13,.385,28,36,.778,109,37,80,.463,26,56,.464,11,24,.458,16,22,.727,101,2012-04-23,MEM,CLE
26,Home,W 109-102 ,240,43,86,.500,32,62,.516,11,24,.458,12,14,.857,109,40,80,.500,32,61,.525,8,19,.421,14,20,.700,102,2012-04-24,ATL,LAC
27,@,W 109-102 ,240,38,90,.422,30,60,.500,8,30,.267,25,29,.862,109,40,85,.471,33,63,.524,7,22,.318,15,17,.882,102,2012-11-02,HOU,ATL
28,Home,W 109-97 ,240,41,92,.446,31,62,.500,10,30,.333,17,22,.773,109,35,78,.449,29,66,.439,6,12,.500,21,25,.840,97,2012-11-06,DEN,DET
29,Home,W 109-104 ,240,39,84,.464,31,63,.492,8,21,.381,23,35,.657,109,36,81,.444,31,59,.525,5,22,.227,27,31,.871,104,2012-11-07,DAL,TOR
30,Home,L 109-112 ,240,42,89,.472,32,67,.478,10,22,.455,15,19,.789,109,40,70,.571,33,52,.635,7,18,.389,25,31,.806,112,2012-11-10,POR,SAS
31,@,L 109-119 ,240,43,82,.524,38,66,.576,5,16,.313,18,22,.818,109,42,83,.506,29,63,.460,13,20,.650,22,26,.846,119,2012-11-18,GSW,OKC
32,Home,L 109-116 (OT),265,45,91,.495,38,71,.535,7,20,.350,12,17,.706,109,39,88,.443,33,67,.493,6,21,.286,32,37,.865,116,2012-11-24,PHI,OKC
33,@,W 109-102 ,240,46,90,.511,37,71,.521,9,19,.474,8,10,.800,109,37,87,.425,26,54,.481,11,33,.333,17,23,.739,102,2012-12-07,GSW,BRK
34,Home,L 109-116 ,240,35,72,.486,23,37,.622,12,35,.343,27,38,.711,109,43,91,.473,33,67,.493,10,24,.417,20,25,.800,116,2012-12-08,HOU,DAL
35,@,W 109-96 ,240,40,78,.513,30,49,.612,10,29,.345,19,24,.792,109,39,90,.433,30,59,.508,9,31,.290,9,16,.563,96,2012-12-17,HOU,NYK
36,Home,W 109-91 ,240,44,87,.506,38,66,.576,6,21,.286,15,20,.750,109,35,86,.407,26,62,.419,9,24,.375,12,16,.750,91,2012-12-26,POR,SAC
37,Home,W 109-99 ,240,43,74,.581,31,55,.564,12,19,.632,11,17,.647,109,39,77,.506,30,48,.625,9,29,.310,12,16,.750,99,2012-12-28,DET,MIA
38,Home,W 109-100 ,240,44,80,.550,34,60,.567,10,20,.500,11,14,.786,109,38,80,.475,33,65,.508,5,15,.333,19,22,.864,100,2012-12-29,ATL,IND
39,@,L 109-119 (OT),265,41,94,.436,31,66,.470,10,28,.357,17,20,.850,109,42,89,.472,32,63,.508,10,26,.385,25,31,.806,119,2013-01-02,DAL,MIA
40,Home,W 109-85 ,240,39,75,.520,29,58,.500,10,17,.588,21,27,.778,109,34,84,.405,23,60,.383,11,24,.458,6,8,.750,85,2013-01-04,OKC,PHI
41,Home,W 109-86 ,240,41,85,.482,33,60,.550,8,25,.320,19,23,.826,109,35,84,.417,32,67,.478,3,17,.176,13,20,.650,86,2013-01-05,SAS,PHI
42,@,W 109-89 ,240,40,83,.482,30,59,.508,10,24,.417,19,22,.864,109,38,79,.481,31,62,.500,7,17,.412,6,10,.600,89,2013-01-08,BRK,PHI
43,Home,L 109-117 ,240,41,82,.500,28,45,.622,13,37,.351,14,25,.560,109,42,78,.538,31,59,.525,11,19,.579,22,26,.846,117,2013-01-15,HOU,LAC
44,Home,W 109-95 ,240,45,78,.577,37,57,.649,8,21,.381,11,17,.647,109,37,87,.425,33,61,.541,4,26,.154,17,17,1.000,95,2013-01-16,ATL,BRK
45,Home,W 109-98 ,240,45,90,.500,39,74,.527,6,16,.375,13,17,.765,109,34,83,.410,28,62,.452,6,21,.286,24,30,.800,98,2013-01-19,UTA,CLE
46,@,W 109-97 ,240,41,78,.526,26,51,.510,15,27,.556,12,14,.857,109,39,84,.464,35,68,.515,4,16,.250,15,21,.714,97,2013-01-22,OKC,LAC
47,Home,W 109-102 ,240,41,101,.406,28,71,.394,13,30,.433,14,20,.700,109,39,93,.419,26,65,.400,13,28,.464,11,11,1.000,102,2013-01-26,MIL,GSW
48,@,W 109-99 ,240,40,88,.455,32,67,.478,8,21,.381,21,25,.840,109,38,89,.427,34,74,.459,4,15,.267,19,25,.760,99,2013-02-01,DAL,PHO
49,Home,W 109-95 ,240,42,82,.512,35,62,.565,7,20,.350,18,23,.783,109,33,79,.418,25,60,.417,8,19,.421,21,24,.875,95,2013-02-02,HOU,CHA
50,@,L 109-140 ,240,41,86,.477,38,71,.535,3,15,.200,24,30,.800,109,46,91,.505,23,51,.451,23,40,.575,25,35,.714,140,2013-02-05,GSW,HOU
51,@,L 109-119 ,240,37,81,.457,27,57,.474,10,24,.417,25,30,.833,109,46,89,.517,36,67,.537,10,22,.455,17,20,.850,119,2013-02-08,SAS,DET
52,@,L 109-120 ,240,40,82,.488,36,67,.537,4,15,.267,25,26,.962,109,44,85,.518,36,66,.545,8,19,.421,24,35,.686,120,2013-02-09,UTA,SAC
53,Home,W 109-108 ,240,39,83,.470,29,62,.468,10,21,.476,21,23,.913,109,44,85,.518,38,69,.551,6,16,.375,14,20,.700,108,2013-02-12,TOR,DEN
54,Home,W 109-94 ,240,42,87,.483,35,68,.515,7,19,.368,18,22,.818,109,38,68,.559,33,53,.623,5,15,.333,13,23,.565,94,2013-02-12,UTA,OKC
55,Home,W 109-105 ,240,39,75,.520,27,56,.482,12,19,.632,19,24,.792,109,39,78,.500,31,58,.534,8,20,.400,19,24,.792,105,2013-02-24,MIA,CLE
56,Home,W 109-105 ,240,36,87,.414,25,53,.472,11,34,.324,26,33,.788,109,36,72,.500,21,45,.467,15,27,.556,18,21,.857,105,2013-02-27,NYK,GSW
57,Home,L 109-111 ,240,38,85,.447,28,60,.467,10,25,.400,23,27,.852,109,45,87,.517,42,73,.575,3,14,.214,18,31,.581,111,2013-02-27,POR,DEN
58,Home,W 109-94 ,240,44,90,.489,37,70,.529,7,20,.350,14,22,.636,109,34,87,.391,33,75,.440,1,12,.083,25,36,.694,94,2013-03-02,POR,MIN
59,Home,W 109-108 (OT),265,45,95,.474,35,71,.493,10,24,.417,9,13,.692,109,40,99,.404,36,86,.419,4,13,.308,24,31,.774,108,2013-03-04,MIL,UTA
60,@,W 109-101 ,240,42,83,.506,31,64,.484,11,19,.579,14,16,.875,109,41,100,.410,36,79,.456,5,21,.238,14,18,.778,101,2013-03-05,BOS,PHI
61,@,L 109-115 ,240,47,93,.505,42,72,.583,5,21,.238,10,15,.667,109,40,90,.444,28,63,.444,12,27,.444,23,26,.885,115,2013-03-17,ORL,MIL
62,Home,W 109-77 ,240,38,76,.500,25,46,.543,13,30,.433,20,23,.870,109,30,89,.337,25,64,.391,5,25,.200,12,18,.667,77,2013-03-24,MIA,CHA
63,Home,W 109-103 ,240,43,90,.478,33,67,.493,10,23,.435,13,19,.684,109,36,91,.396,30,65,.462,6,26,.231,25,36,.694,103,2013-03-25,GSW,LAL
64,Home,W 109-102 (OT),265,40,82,.488,34,59,.576,6,23,.261,23,27,.852,109,38,85,.447,28,52,.538,10,33,.303,16,25,.640,102,2013-03-26,DAL,LAC
65,Home,W 109-87 ,240,42,74,.568,38,60,.633,4,14,.286,21,31,.677,109,32,79,.405,27,59,.458,5,20,.250,18,36,.500,87,2013-03-29,DEN,BRK
66,@,W 109-99 ,240,40,75,.533,36,59,.610,4,16,.250,25,32,.781,109,37,98,.378,25,69,.362,12,29,.414,13,15,.867,99,2013-03-30,OKC,MIL
67,Home,W 109-92 ,240,41,85,.482,32,68,.471,9,17,.529,18,28,.643,109,32,81,.395,25,62,.403,7,19,.368,21,26,.808,92,2013-03-31,WAS,TOR
68,@,W 109-106 ,240,39,71,.549,29,48,.604,10,23,.435,21,28,.750,109,39,80,.488,34,64,.531,5,16,.313,23,26,.885,106,2013-04-01,IND,LAC
69,Home,W 109-95 ,240,42,84,.500,34,63,.540,8,21,.381,17,21,.810,109,33,76,.434,26,52,.500,7,24,.292,22,30,.733,95,2013-04-07,LAC,LAL
70,Home,W 109-104 ,240,43,85,.506,37,65,.569,6,20,.300,17,25,.680,109,38,92,.413,21,59,.356,17,33,.515,11,16,.688,104,2013-04-12,ATL,MIL
71,Home,L 109-117 ,240,40,80,.500,32,61,.525,8,19,.421,21,26,.808,109,42,82,.512,30,57,.526,12,25,.480,21,26,.808,117,2013-04-12,IND,BRK
72,Home,W 109-101 ,240,39,71,.549,27,48,.563,12,23,.522,19,28,.679,109,41,85,.482,35,62,.565,6,23,.261,13,13,1.000,101,2013-04-12,MIA,BOS
73,@,L 109-118 ,240,38,82,.463,26,50,.520,12,32,.375,21,26,.808,109,43,81,.531,35,59,.593,8,22,.364,24,27,.889,118,2013-04-14,POR,DEN
74,Home,W 109-101 ,240,41,83,.494,32,58,.552,9,25,.360,18,22,.818,109,39,87,.448,33,65,.508,6,22,.273,17,21,.810,101,2013-04-15,DET,PHI
75,@,L 109-118 ,240,37,76,.487,29,52,.558,8,24,.333,27,35,.771,109,44,77,.571,33,53,.623,11,24,.458,19,24,.792,118,2013-10-30,ATL,DAL
76,@,W 109-102 ,240,48,94,.511,42,71,.592,6,23,.261,7,14,.500,109,41,94,.436,32,68,.471,9,26,.346,11,17,.647,102,2013-11-01,PHI,WAS
77,@,W 109-100 ,240,35,79,.443,25,52,.481,10,27,.370,29,38,.763,109,40,89,.449,31,57,.544,9,32,.281,11,13,.846,100,2013-11-03,MIN,NYK
78,Home,W 109-104 ,240,36,72,.500,23,49,.469,13,23,.565,24,26,.923,109,38,85,.447,26,57,.456,12,28,.429,16,22,.727,104,2013-11-06,MIL,CLE
79,Home,W 109-107 ,240,42,86,.488,28,61,.459,14,25,.560,11,17,.647,109,43,94,.457,35,68,.515,8,26,.308,13,19,.684,107,2013-11-07,DEN,ATL
80,Home,W 109-107 ,240,44,80,.550,40,64,.625,4,16,.250,17,28,.607,109,40,96,.417,29,67,.433,11,29,.379,16,18,.889,107,2013-11-11,LAC,MIN
81,@,W 109-85 ,240,44,89,.494,31,61,.508,13,28,.464,8,11,.727,109,34,82,.415,29,63,.460,5,19,.263,12,16,.750,85,2013-11-11,SAS,PHI
82,Home,W 109-103 ,240,42,82,.512,31,59,.525,11,23,.478,14,15,.933,109,42,91,.462,39,77,.506,3,14,.214,16,21,.762,103,2013-11-11,POR,DET
83,@,W 109-106 ,240,31,68,.456,22,40,.550,9,28,.321,38,44,.864,109,38,87,.437,30,67,.448,8,20,.400,22,27,.815,106,2013-11-14,HOU,NYK
84,@,W 109-96 ,240,40,82,.488,31,56,.554,9,26,.346,20,22,.909,109,37,81,.457,30,63,.476,7,18,.389,15,19,.789,96,2013-11-15,POR,BOS
85,Home,W 109-85 ,240,41,72,.569,32,51,.627,9,21,.429,18,24,.750,109,32,99,.323,25,79,.316,7,20,.350,14,20,.700,85,2013-11-19,HOU,BOS
86,@,W 109-97 ,240,38,80,.475,33,63,.524,5,17,.294,28,40,.700,109,35,77,.455,21,51,.412,14,26,.538,13,18,.722,97,2013-11-24,DET,BRK
87,@,W 109-92 ,240,42,83,.506,34,61,.557,8,22,.364,17,20,.850,109,30,73,.411,21,51,.412,9,22,.409,23,27,.852,92,2013-11-26,ORL,ATL
88,@,W 109-91 ,240,42,76,.553,34,59,.576,8,17,.471,17,17,1.000,109,34,78,.436,25,59,.424,9,19,.474,14,15,.933,91,2013-11-29,SAS,ORL
89,Home,W 109-103 ,240,43,79,.544,33,62,.532,10,17,.588,13,16,.813,109,40,83,.482,31,55,.564,9,28,.321,14,20,.700,103,2013-12-02,UTA,HOU
90,@,W 109-95 ,240,39,77,.506,32,56,.571,7,21,.333,24,30,.800,109,33,88,.375,30,72,.417,3,16,.188,26,34,.765,95,2013-12-06,OKC,NOP
91,@,W 109-105 (OT),265,42,92,.457,36,72,.500,6,20,.300,19,26,.731,109,33,83,.398,25,56,.446,8,27,.296,31,41,.756,105,2013-12-06,MIL,WAS
92,Home,W 109-94 ,240,42,74,.568,33,55,.600,9,19,.474,16,22,.727,109,40,87,.460,30,56,.536,10,31,.323,4,5,.800,94,2013-12-10,CLE,NYK
93,@,W 109-77 ,240,46,88,.523,42,71,.592,4,17,.235,13,17,.765,109,29,84,.345,27,69,.391,2,15,.133,17,23,.739,77,2013-12-11,SAS,MIL
94,@,W 109-100 ,240,42,87,.483,34,66,.515,8,21,.381,17,20,.850,109,37,85,.435,26,55,.473,11,30,.367,15,16,.938,100,2013-12-13,CLE,ORL
95,Home,L 109-111 (OT),265,44,94,.468,41,79,.519,3,15,.200,18,27,.667,109,41,99,.414,34,73,.466,7,26,.269,22,26,.846,111,2013-12-15,DET,POR
96,Home,W 109-94 ,240,44,82,.537,36,60,.600,8,22,.364,13,16,.813,109,38,79,.481,33,67,.493,5,12,.417,13,23,.565,94,2013-12-18,HOU,CHI
97,@,L 109-120 ,240,40,94,.426,26,54,.481,14,40,.350,15,19,.789,109,46,93,.495,39,74,.527,7,19,.368,21,26,.808,120,2013-12-18,POR,MIN
98,@,W 109-108 (OT),265,42,91,.462,31,70,.443,11,21,.524,14,18,.778,109,46,91,.505,36,70,.514,10,21,.476,6,10,.600,108,2013-12-20,TOR,DAL
99,Home,W 109-92 ,240,45,85,.529,41,71,.577,4,14,.286,15,23,.652,109,39,95,.411,34,77,.442,5,18,.278,9,18,.500,92,2013-12-27,ORL,DET
0,Home,W 109-102 ,240,41,74,.554,33,53,.623,8,21,.381,19,24,.792,109,36,81,.444,21,42,.500,15,39,.385,15,21,.714,102,2013-12-29,ORL,ATL
1,Home,W 109-105 ,240,43,80,.538,36,64,.563,7,16,.438,16,18,.889,109,44,89,.494,40,81,.494,4,8,.500,13,19,.684,105,2014-01-15,SAS,UTA
2,Home,L 109-117 ,240,40,92,.435,26,55,.473,14,37,.378,15,19,.789,109,42,88,.477,37,72,.514,5,16,.313,28,35,.800,117,2014-01-17,DEN,CLE
3,@,W 109-95 ,240,33,78,.423,25,48,.521,8,30,.267,35,42,.833,109,29,83,.349,22,60,.367,7,23,.304,30,36,.833,95,2014-01-17,LAC,NYK
4,@,W 109-100 ,240,41,86,.477,33,70,.471,8,16,.500,19,20,.950,109,38,84,.452,30,64,.469,8,20,.400,16,20,.800,100,2014-01-17,POR,SAS
5,Home,L 109-112 ,240,41,83,.494,35,71,.493,6,12,.500,21,24,.875,109,41,83,.494,32,58,.552,9,25,.360,21,24,.875,112,2014-01-22,ORL,ATL
6,Home,W 109-102 ,240,45,78,.577,37,58,.638,8,20,.400,11,23,.478,109,40,88,.455,31,63,.492,9,25,.360,13,21,.619,102,2014-01-23,MIA,LAL
7,Home,W 109-96 ,240,40,83,.482,32,63,.508,8,20,.400,21,37,.568,109,37,88,.420,32,76,.421,5,12,.417,17,27,.630,96,2014-01-25,DEN,IND
8,@,L 109-111 ,240,43,88,.489,31,63,.492,12,25,.480,11,12,.917,109,43,82,.524,30,57,.526,13,25,.520,12,18,.667,111,2014-01-27,ATL,OKC
9,Home,W 109-99 ,240,37,83,.446,29,66,.439,8,17,.471,27,38,.711,109,33,79,.418,23,58,.397,10,21,.476,23,26,.885,99,2014-02-04,MIN,LAL
10,Home,W 109-101 ,240,32,81,.395,28,69,.406,4,12,.333,41,51,.804,109,36,84,.429,26,59,.441,10,25,.400,19,24,.792,101,2014-02-05,SAC,TOR
11,@,L 109-126 ,240,41,88,.466,26,55,.473,15,33,.455,12,22,.545,109,50,98,.510,42,78,.538,8,20,.400,18,23,.783,126,2014-02-08,DEN,DET
12,@,L 109-122 ,240,41,84,.488,33,59,.559,8,25,.320,19,26,.731,109,43,80,.538,32,59,.542,11,21,.524,25,30,.833,122,2014-02-08,GSW,PHO
13,Home,W 109-100 ,240,43,90,.478,38,74,.514,5,16,.313,18,26,.692,109,43,82,.524,38,65,.585,5,17,.294,9,11,.818,100,2014-02-10,DET,SAS
14,Home,W 109-99 ,240,41,86,.477,29,65,.446,12,21,.571,15,23,.652,109,34,74,.459,26,48,.542,8,26,.308,23,33,.697,99,2014-02-11,CLE,SAC
15,Home,L 109-111 ,240,42,93,.452,35,71,.493,7,22,.318,18,25,.720,109,43,88,.489,34,64,.531,9,24,.375,16,21,.762,111,2014-02-19,POR,SAS
16,@,W 109-95 ,240,37,78,.474,32,65,.492,5,13,.385,30,36,.833,109,33,88,.375,18,56,.321,15,32,.469,14,21,.667,95,2014-02-23,SAC,DEN
17,Home,W 109-86 ,240,42,74,.568,33,56,.589,9,18,.500,16,24,.667,109,31,80,.388,25,61,.410,6,19,.316,18,29,.621,86,2014-02-26,UTA,PHO
18,Home,W 109-90 ,240,39,84,.464,31,62,.500,8,22,.364,23,33,.697,109,35,79,.443,30,61,.492,5,18,.278,15,18,.833,90,2014-03-02,CHI,NYK
19,Home,W 109-87 ,240,43,84,.512,34,66,.515,9,18,.500,14,20,.700,109,31,76,.408,21,53,.396,10,23,.435,15,20,.750,87,2014-03-05,CHA,IND
20,Home,W 109-108 ,240,42,79,.532,35,57,.614,7,22,.318,18,24,.750,109,38,76,.500,26,48,.542,12,28,.429,20,26,.769,108,2014-03-08,LAC,ATL
21,Home,W 109-99 ,240,47,84,.560,41,72,.569,6,12,.500,9,13,.692,109,35,86,.407,28,69,.406,7,17,.412,22,29,.759,99,2014-03-11,MEM,POR
22,@,W 109-86 ,240,40,75,.533,27,51,.529,13,24,.542,16,20,.800,109,29,79,.367,20,50,.400,9,29,.310,19,27,.704,86,2014-03-16,DAL,OKC
23,@,L 109-118 ,240,43,95,.453,33,69,.478,10,26,.385,13,19,.684,109,44,86,.512,33,59,.559,11,27,.407,19,27,.704,118,2014-03-19,DET,DEN
24,Home,L 109-125 ,240,39,91,.429,30,65,.462,9,26,.346,22,29,.759,109,50,95,.526,38,68,.559,12,27,.444,13,16,.813,125,2014-03-19,LAL,SAS
25,Home,W 109-93 ,240,45,89,.506,34,64,.531,11,25,.440,8,12,.667,109,32,80,.400,26,67,.388,6,13,.462,23,30,.767,93,2014-03-19,PHO,ORL
26,Home,W 109-92 ,240,48,91,.527,42,79,.532,6,12,.500,7,13,.538,109,34,90,.378,27,66,.409,7,24,.292,17,20,.850,92,2014-03-24,MEM,MIN
27,Home,W 109-104 (OT),265,40,85,.471,31,65,.477,9,20,.450,20,27,.741,109,33,90,.367,23,50,.460,10,40,.250,28,32,.875,104,2014-03-24,NOP,BRK
28,@,W 109-103 ,240,38,82,.463,27,56,.482,11,26,.423,22,25,.880,109,37,79,.468,27,59,.458,10,20,.500,19,27,.704,103,2014-03-27,LAC,DAL
29,@,W 109-93 ,240,39,97,.402,33,76,.434,6,21,.286,25,31,.806,109,35,81,.432,29,60,.483,6,21,.286,17,27,.630,93,2014-04-04,PHO,POR
30,@,W 109-100 ,240,38,88,.432,22,54,.407,16,34,.471,17,22,.773,109,39,83,.470,34,71,.479,5,12,.417,17,21,.810,100,2014-04-10,SAS,DAL
31,@,W 109-98 ,240,32,67,.478,21,46,.457,11,21,.524,34,40,.850,109,33,75,.440,23,50,.460,10,25,.400,22,31,.710,98,2014-04-15,NYK,BRK
32,Home,W 109-102 ,240,37,90,.411,29,64,.453,8,26,.308,27,33,.818,109,40,80,.500,27,58,.466,13,22,.591,9,17,.529,102,2014-10-29,TOR,ATL
33,@,W 109-104 ,240,46,89,.517,40,64,.625,6,25,.240,11,19,.579,109,38,89,.427,31,70,.443,7,19,.368,21,28,.750,104,2014-11-01,DAL,NOP
34,@,L 109-131 ,240,37,82,.451,28,54,.519,9,28,.321,26,31,.839,109,42,76,.553,34,56,.607,8,20,.400,39,50,.780,131,2014-11-05,DEN,SAC
35,@,W 109-94 ,240,40,82,.488,30,58,.517,10,24,.417,19,22,.864,109,37,83,.446,28,50,.560,9,33,.273,11,13,.846,94,2014-11-12,OKC,BOS
36,Home,W 109-102 ,240,45,82,.549,37,63,.587,8,19,.421,11,18,.611,109,35,84,.417,28,63,.444,7,21,.333,25,32,.781,102,2014-11-12,NOP,LAL
37,Home,W 109-93 ,240,41,76,.539,35,62,.565,6,14,.429,21,27,.778,109,32,82,.390,19,48,.396,13,34,.382,16,26,.615,93,2014-11-16,NYK,DEN
38,Home,L 109-114 ,240,41,85,.482,32,58,.552,9,27,.333,18,23,.783,109,47,87,.540,41,70,.586,6,17,.353,14,22,.636,114,2014-11-18,ATL,LAL
39,@,L 109-114 ,240,35,82,.427,28,61,.459,7,21,.333,32,37,.865,109,43,85,.506,35,69,.507,8,16,.500,20,27,.741,114,2014-11-25,CHI,DEN
40,Home,W 109-102 (OT),265,38,95,.400,34,64,.531,4,31,.129,29,38,.763,109,39,92,.424,25,64,.391,14,28,.500,10,16,.625,102,2014-11-26,DAL,NYK
41,@,W 109-102 ,240,37,90,.411,32,73,.438,5,17,.294,30,37,.811,109,37,92,.402,31,70,.443,6,22,.273,22,29,.759,102,2014-11-28,CHI,BOS
42,Home,W 109-97 ,240,41,78,.526,34,62,.548,7,16,.438,20,32,.625,109,35,89,.393,28,67,.418,7,22,.318,20,26,.769,97,2014-11-29,CLE,IND
43,@,W 109-103 ,240,36,83,.434,27,57,.474,9,26,.346,28,35,.800,109,38,89,.427,26,60,.433,12,29,.414,15,25,.600,103,2014-12-01,SAS,PHI
44,Home,W 109-105 ,240,43,82,.524,32,58,.552,11,24,.458,12,14,.857,109,41,84,.488,29,61,.475,12,23,.522,11,13,.846,105,2014-12-02,ATL,BOS
45,Home,L 109-117 ,240,39,75,.520,36,65,.554,3,10,.300,28,37,.757,109,44,88,.500,34,65,.523,10,23,.435,19,21,.905,117,2014-12-02,SAC,TOR
46,Home,W 109-102 (OT),265,37,93,.398,24,63,.381,13,30,.433,22,27,.815,109,37,102,.363,29,75,.387,8,27,.296,20,29,.690,102,2014-12-03,BOS,DET
47,Home,W 109-85 ,240,39,69,.565,30,53,.566,9,16,.563,22,26,.846,109,30,68,.441,23,50,.460,7,18,.389,18,27,.667,85,2014-12-05,MIL,MIA
48,Home,W 109-95 ,240,37,73,.507,27,54,.500,10,19,.526,25,30,.833,109,37,76,.487,31,61,.508,6,15,.400,15,17,.882,95,2014-12-10,SAS,NYK
49,Home,L 109-113 (OT),265,39,84,.464,31,66,.470,8,18,.444,23,34,.676,109,38,95,.400,23,51,.451,15,44,.341,22,31,.710,113,2014-12-11,SAC,HOU
50,Home,W 109-95 ,240,43,86,.500,33,69,.478,10,17,.588,13,18,.722,109,36,81,.444,33,73,.452,3,8,.375,20,35,.571,95,2014-12-16,WAS,MIN
51,Home,W 109-92 ,240,44,80,.550,37,61,.607,7,19,.368,14,18,.778,109,37,85,.435,32,66,.485,5,19,.263,13,15,.867,92,2014-12-17,BOS,ORL
52,@,L 109-114 ,240,41,86,.477,30,61,.492,11,25,.440,16,24,.667,109,48,94,.511,36,63,.571,12,31,.387,6,10,.600,114,2014-12-18,OKC,GSW
53,Home,W 109-106 ,240,38,80,.475,27,51,.529,11,29,.379,22,30,.733,109,39,85,.459,36,67,.537,3,18,.167,25,33,.758,106,2014-12-19,DEN,LAC
54,@,W 109-91 ,240,43,98,.439,33,74,.446,10,24,.417,13,17,.765,109,32,71,.451,20,45,.444,12,26,.462,15,17,.882,91,2014-12-19,CHO,PHI
55,@,W 109-107 ,240,41,83,.494,34,62,.548,7,21,.333,20,28,.714,109,45,87,.517,36,63,.571,9,24,.375,8,11,.727,107,2014-12-26,BRK,BOS
56,@,L 109-119 ,240,42,83,.506,33,63,.524,9,20,.450,16,22,.727,109,47,86,.547,37,60,.617,10,26,.385,15,29,.517,119,2014-12-26,IND,DET
57,Home,W 109-101 ,240,40,79,.506,30,50,.600,10,29,.345,19,26,.731,109,37,84,.440,24,53,.453,13,31,.419,14,21,.667,101,2014-12-30,ATL,CLE
58,@,W 109-86 ,240,40,86,.465,26,53,.491,14,33,.424,15,29,.517,109,38,85,.447,34,65,.523,4,20,.200,6,10,.600,86,2014-12-30,DET,ORL
59,@,W 109-106 ,240,41,84,.488,35,70,.500,6,14,.429,21,31,.677,109,43,81,.531,37,62,.597,6,19,.316,14,19,.737,106,2015-01-02,MEM,LAL
60,Home,W 109-102 ,240,44,83,.530,36,64,.563,8,19,.421,13,19,.684,109,39,84,.464,28,63,.444,11,21,.524,13,15,.867,102,2015-01-02,OKC,WAS
61,Home,W 109-104 (OT),265,37,100,.370,31,72,.431,6,28,.214,29,40,.725,109,45,100,.450,40,83,.482,5,17,.294,9,11,.818,104,2015-01-03,CHI,BOS
62,@,W 109-90 ,240,44,78,.564,32,52,.615,12,26,.462,9,11,.818,109,35,86,.407,27,61,.443,8,25,.320,12,17,.706,90,2015-01-04,DAL,CLE
63,@,L 109-125 ,240,38,83,.458,29,57,.509,9,26,.346,24,29,.828,109,48,89,.539,40,66,.606,8,23,.348,21,28,.750,125,2015-01-04,TOR,PHO
64,Home,W 109-96 ,240,41,91,.451,28,61,.459,13,30,.433,14,19,.737,109,39,83,.470,33,65,.508,6,18,.333,12,20,.600,96,2015-01-10,TOR,BOS
65,@,W 109-102 ,240,37,78,.474,28,48,.583,9,30,.300,26,36,.722,109,39,76,.513,31,52,.596,8,24,.333,16,23,.696,102,2015-01-15,CLE,LAL
66,@,W 109-99 ,240,38,84,.452,27,57,.474,11,27,.407,22,27,.815,109,37,79,.468,32,65,.492,5,14,.357,20,29,.690,99,2015-01-20,SAS,DEN
67,Home,W 109-106 ,240,40,79,.506,32,62,.516,8,17,.471,21,25,.840,109,39,81,.481,30,57,.526,9,24,.375,19,25,.760,106,2015-01-25,NOP,DAL
68,@,W 109-90 ,240,42,79,.532,32,58,.552,10,21,.476,15,20,.750,109,38,78,.487,31,52,.596,7,26,.269,7,10,.700,90,2015-01-27,MEM,DAL
69,@,W 109-102 ,240,39,71,.549,30,55,.545,9,16,.563,22,30,.733,109,38,75,.507,31,55,.564,7,20,.350,19,26,.731,102,2015-01-27,MIL,MIA
70,@,L 109-114 ,240,43,87,.494,31,63,.492,12,24,.500,11,15,.733,109,46,77,.597,34,56,.607,12,21,.571,10,18,.556,114,2015-02-04,DET,IND
71,@,W 109-93 ,240,40,81,.494,31,62,.500,9,19,.474,20,23,.870,109,35,79,.443,25,46,.543,10,33,.303,13,18,.722,93,2015-02-04,BRK,TOR
72,@,W 109-98 ,240,40,76,.526,31,47,.660,9,29,.310,20,23,.870,109,31,82,.378,18,47,.383,13,35,.371,23,34,.676,98,2015-02-08,POR,HOU
73,Home,W 109-95 ,240,36,74,.486,24,52,.462,12,22,.545,25,29,.862,109,36,84,.429,29,64,.453,7,20,.350,16,19,.842,95,2015-02-09,MIA,NYK
74,@,L 109-111 ,240,40,89,.449,33,72,.458,7,17,.412,22,31,.710,109,40,86,.465,36,71,.507,4,15,.267,27,38,.711,111,2015-02-20,PHO,MIN
75,Home,W 109-101 ,240,40,83,.482,32,61,.525,8,22,.364,21,26,.808,109,40,100,.400,34,78,.436,6,22,.273,15,26,.577,101,2015-02-20,SAC,BOS
76,@,L 109-114 (OT),265,40,88,.455,30,63,.476,10,25,.400,19,24,.792,109,41,80,.513,34,56,.607,7,24,.292,25,33,.758,114,2015-03-07,SAC,MIA
77,Home,W 109-103 (OT),265,39,79,.494,30,57,.526,9,22,.409,22,28,.786,109,35,91,.385,31,77,.403,4,14,.286,29,36,.806,103,2015-03-12,IND,MIL
78,Home,W 109-91 ,240,44,92,.478,33,59,.559,11,33,.333,10,17,.588,109,34,79,.430,27,47,.574,7,32,.219,16,24,.667,91,2015-03-12,UTA,HOU
79,Home,W 109-100 ,240,40,87,.460,32,66,.485,8,21,.381,21,30,.700,109,37,83,.446,28,54,.519,9,29,.310,17,24,.708,100,2015-03-15,OKC,CHI
80,@,W 109-98 ,240,45,89,.506,39,71,.549,6,18,.333,13,16,.813,109,41,74,.554,37,63,.587,4,11,.364,12,16,.750,98,2015-03-22,CHO,MIN
81,Home,W 109-86 ,240,40,79,.506,32,62,.516,8,17,.471,21,23,.913,109,35,87,.402,32,70,.457,3,17,.176,13,18,.722,86,2015-03-22,SAC,WAS
82,Home,W 109-102 ,240,39,82,.476,32,64,.500,7,18,.389,24,29,.828,109,40,83,.482,32,58,.552,8,25,.320,14,22,.636,102,2015-03-29,MIA,DET
83,@,W 109-97 ,240,40,86,.465,30,60,.500,10,26,.385,19,26,.731,109,37,82,.451,32,60,.533,5,22,.227,18,24,.750,97,2015-03-29,OKC,PHO
84,Home,W 109-86 ,240,44,86,.512,32,59,.542,12,27,.444,9,10,.900,109,38,87,.437,35,71,.493,3,16,.188,7,10,.700,86,2015-03-30,POR,PHO
85,@,L 109-114 ,240,42,82,.512,34,56,.607,8,26,.308,17,23,.739,109,46,88,.523,41,72,.569,5,16,.313,17,23,.739,114,2015-04-03,TOR,BRK
86,Home,W 109-97 ,240,43,85,.506,26,53,.491,17,32,.531,6,12,.500,109,38,83,.458,29,58,.500,9,25,.360,12,20,.600,97,2015-04-13,CLE,DET
87,Home,W 109-92 ,240,41,82,.500,30,54,.556,11,28,.393,16,26,.615,109,34,82,.415,25,62,.403,9,20,.450,15,23,.652,92,2015-04-13,UTA,DAL
88,@,L 109-114 ,240,43,101,.426,37,83,.446,6,18,.333,17,25,.680,109,39,76,.513,35,59,.593,4,17,.235,32,46,.696,114,2015-10-31,SAC,LAC
89,Home,W 109-89 ,240,42,86,.488,33,64,.516,9,22,.409,16,21,.762,109,32,79,.405,22,43,.512,10,36,.278,15,18,.833,89,2015-11-01,MIA,HOU
90,Home,L 109-120 ,240,36,86,.419,30,60,.500,6,26,.231,31,38,.816,109,43,85,.506,36,65,.554,7,20,.350,27,31,.871,120,2015-11-03,LAL,DEN
91,@,W 109-105 ,240,38,86,.442,31,56,.554,7,30,.233,26,29,.897,109,42,88,.477,38,66,.576,4,22,.182,17,25,.680,105,2015-11-07,HOU,LAC
92,Home,W 109-95 ,240,43,91,.473,31,70,.443,12,21,.571,11,13,.846,109,40,85,.471,34,66,.515,6,19,.316,9,15,.600,95,2015-11-09,GSW,DET
93,Home,L 109-111 ,240,37,84,.440,33,67,.493,4,17,.235,31,39,.795,109,42,95,.442,31,72,.431,11,23,.478,16,18,.889,111,2015-11-10,TOR,NYK
94,@,L 109-111 ,240,42,89,.472,34,68,.500,8,21,.381,17,21,.810,109,40,94,.426,29,67,.433,11,27,.407,20,26,.769,111,2015-11-13,BRK,SAC
95,Home,W 109-98 ,240,42,86,.488,33,68,.485,9,18,.500,16,20,.800,109,38,98,.388,33,83,.398,5,15,.333,17,18,.944,98,2015-11-18,SAS,DEN
96,@,L 109-116 ,240,43,84,.512,31,61,.508,12,23,.522,11,20,.550,109,42,89,.472,35,65,.538,7,24,.292,25,33,.758,116,2015-11-19,SAC,MIA
97,Home,W 109-97 ,240,41,85,.482,30,56,.536,11,29,.379,16,19,.842,109,32,86,.372,21,58,.362,11,28,.393,22,25,.880,97,2015-11-21,CLE,ATL
98,Home,W 109-88 ,240,43,83,.518,34,70,.486,9,13,.692,14,17,.824,109,31,91,.341,25,63,.397,6,28,.214,20,24,.833,88,2015-11-23,MIL,DET
99,Home,W 109-106 ,240,40,82,.488,30,56,.536,10,26,.385,19,25,.760,109,43,84,.512,33,61,.541,10,23,.435,10,16,.625,106,2015-12-04,WAS,PHO
0,@,W 109-103 ,240,39,77,.506,29,57,.509,10,20,.500,21,30,.700,109,38,83,.458,33,68,.485,5,15,.333,22,26,.846,103,2015-12-05,POR,MIN
1,Home,L 109-112 ,240,40,91,.440,32,71,.451,8,20,.400,21,26,.808,109,35,73,.479,19,43,.442,16,30,.533,26,36,.722,112,2015-12-05,TOR,GSW
2,@,W 109-95 ,240,38,81,.469,26,53,.491,12,28,.429,21,36,.583,109,42,90,.467,40,80,.500,2,10,.200,9,12,.750,95,2015-12-09,LAC,MIL
3,@,W 109-103 ,240,40,83,.482,28,50,.560,12,33,.364,17,25,.680,109,39,89,.438,34,64,.531,5,25,.200,20,24,.833,103,2015-12-09,HOU,WAS
4,Home,W 109-87 ,240,44,82,.537,38,68,.559,6,14,.429,15,25,.600,109,36,88,.409,27,63,.429,9,25,.360,6,10,.600,87,2015-12-11,SAS,LAL
5,Home,W 109-99 (OT),265,37,85,.435,27,56,.482,10,29,.345,25,31,.806,109,35,97,.361,26,58,.448,9,39,.231,20,28,.714,99,2015-12-17,CHO,TOR
6,@,W 109-101 ,240,41,88,.466,37,68,.544,4,20,.200,23,29,.793,109,34,77,.442,24,54,.444,10,23,.435,23,31,.742,101,2015-12-18,ATL,BOS
7,Home,W 109-101 ,240,40,79,.506,31,59,.525,9,20,.450,20,23,.870,109,39,93,.419,29,60,.483,10,33,.303,13,16,.813,101,2015-12-19,WAS,CHO
8,@,L 109-116 ,240,39,80,.488,26,46,.565,13,34,.382,18,22,.818,109,43,75,.573,31,52,.596,12,23,.522,18,26,.692,116,2015-12-20,POR,MIA
9,@,W 109-104 ,240,38,79,.481,25,53,.472,13,26,.500,20,24,.833,109,36,74,.486,26,47,.553,10,27,.370,22,27,.815,104,2015-12-26,LAC,UTA
10,Home,W 109-96 ,240,43,86,.500,28,53,.528,15,33,.455,8,11,.727,109,35,78,.449,19,42,.452,16,36,.444,10,14,.714,96,2015-12-31,UTA,POR
11,@,W 109-90 ,240,35,79,.443,26,56,.464,9,23,.391,30,37,.811,109,29,84,.345,23,62,.371,6,22,.273,26,34,.765,90,2016-01-02,OKC,CHO
12,Home,W 109-99 ,240,48,87,.552,44,67,.657,4,20,.200,9,14,.643,109,39,73,.534,37,68,.544,2,5,.400,19,24,.792,99,2016-01-04,PHI,MIN
13,@,W 109-88 ,240,40,86,.465,27,55,.491,13,31,.419,16,21,.762,109,29,91,.319,24,70,.343,5,21,.238,25,30,.833,88,2016-01-05,GSW,LAL
14,@,W 109-98 ,240,42,83,.506,31,60,.517,11,23,.478,14,17,.824,109,38,86,.442,29,60,.483,9,26,.346,13,23,.565,98,2016-01-06,LAC,POR
15,@,W 109-99 ,240,41,85,.482,36,71,.507,5,14,.357,22,27,.815,109,38,91,.418,32,68,.471,6,23,.261,17,26,.654,99,2016-01-12,SAS,DET
16,@,W 109-97 ,240,42,100,.420,26,67,.388,16,33,.485,9,11,.818,109,41,84,.488,35,61,.574,6,23,.261,9,14,.643,97,2016-01-13,NOP,SAC
17,Home,W 109-107 ,240,43,87,.494,31,60,.517,12,27,.444,11,13,.846,109,42,86,.488,28,51,.549,14,35,.400,9,12,.750,107,2016-01-15,NOP,CHO
18,Home,W 109-82 ,240,41,83,.494,29,59,.492,12,24,.500,15,18,.833,109,31,90,.344,22,67,.328,9,23,.391,11,18,.611,82,2016-01-16,UTA,LAL
19,Home,W 109-95 ,240,39,83,.470,30,59,.508,9,24,.375,22,30,.733,109,34,81,.420,25,54,.463,9,27,.333,18,21,.857,95,2016-01-20,OKC,CHO
20,@,L 109-115 ,240,43,85,.506,31,59,.525,12,26,.462,11,15,.733,109,46,83,.554,35,54,.648,11,29,.379,12,17,.706,115,2016-01-20,BOS,TOR
21,@,W 109-106 ,240,45,91,.495,37,61,.607,8,30,.267,11,15,.733,109,40,87,.460,30,54,.556,10,33,.303,16,18,.889,106,2016-01-22,OKC,DAL
22,Home,W 109-91 ,240,45,92,.489,38,72,.528,7,20,.350,12,16,.750,109,31,80,.388,21,51,.412,10,29,.345,19,28,.679,91,2016-01-29,POR,CHO
23,Home,W 109-105 (OT),265,44,100,.440,35,73,.479,9,27,.333,12,16,.750,109,40,87,.460,36,69,.522,4,18,.222,21,25,.840,105,2016-01-30,IND,DEN
24,@,W 109-90 ,240,45,86,.523,36,66,.545,9,20,.450,10,12,.833,109,33,71,.465,22,49,.449,11,22,.500,13,19,.684,90,2016-02-10,MEM,BRK
25,Home,W 109-98 ,240,42,86,.488,34,69,.493,8,17,.471,17,20,.850,109,36,82,.439,26,56,.464,10,26,.385,16,18,.889,98,2016-02-19,BRK,NYK
26,Home,W 109-104 ,240,40,82,.488,33,61,.541,7,21,.333,22,28,.786,109,31,75,.413,20,49,.408,11,26,.423,31,31,1.000,104,2016-02-19,MEM,MIN
27,Home,L 109-117 (2OT),290,44,106,.415,35,65,.538,9,41,.220,12,18,.667,109,46,104,.442,43,87,.494,3,17,.176,22,32,.688,117,2016-02-20,ATL,MIL
28,Home,W 109-89 ,240,43,94,.457,31,68,.456,12,26,.462,11,17,.647,109,29,83,.349,23,60,.383,6,23,.261,25,33,.758,89,2016-02-23,WAS,NOP
29,Home,W 109-104 ,240,44,88,.500,36,65,.554,8,23,.348,13,16,.813,109,38,90,.422,29,62,.468,9,28,.321,19,26,.731,104,2016-02-24,CHI,WAS
30,Home,W 109-105 (OT),265,41,103,.398,29,67,.433,12,36,.333,15,17,.882,109,37,80,.463,25,47,.532,12,33,.364,19,24,.792,105,2016-03-01,GSW,ATL
31,@,W 109-100 ,240,37,71,.521,25,43,.581,12,28,.429,23,30,.767,109,32,80,.400,22,58,.379,10,22,.455,26,33,.788,100,2016-03-06,PHO,MEM
32,@,W 109-90 ,240,39,83,.470,27,51,.529,12,32,.375,19,29,.655,109,30,81,.370,26,56,.464,4,25,.160,26,32,.813,90,2016-03-07,LAC,DAL
33,@,L 109-116 (OT),265,45,99,.455,37,79,.468,8,20,.400,11,23,.478,109,41,89,.461,31,65,.477,10,24,.417,24,31,.774,116,2016-03-08,WAS,POR
34,Home,W 109-101 ,240,44,93,.473,38,76,.500,6,17,.353,15,19,.789,109,39,86,.453,28,64,.438,11,22,.500,12,13,.923,101,2016-03-10,SAS,CHI
35,@,L 109-125 ,240,43,93,.462,38,67,.567,5,26,.192,18,28,.643,109,48,88,.545,33,57,.579,15,31,.484,14,16,.875,125,2016-03-12,HOU,CHO
36,@,W 109-100 ,240,45,89,.506,39,75,.520,6,14,.429,13,21,.619,109,39,70,.557,27,43,.628,12,27,.444,10,13,.769,100,2016-03-13,MIL,BRK
37,@,W 109-107 ,240,41,83,.494,32,58,.552,9,25,.360,18,20,.900,109,37,83,.446,31,63,.492,6,20,.300,27,31,.871,107,2016-03-14,CHI,TOR
38,Home,L 109-130 ,240,40,93,.430,35,74,.473,5,19,.263,24,27,.889,109,47,96,.490,35,67,.522,12,29,.414,24,30,.800,130,2016-03-16,BOS,OKC
39,@,W 109-106 ,240,40,86,.465,27,60,.450,13,26,.500,16,21,.762,109,40,75,.533,33,58,.569,7,17,.412,19,24,.792,106,2016-03-17,CHO,MIA
40,@,W 109-103 ,240,38,76,.500,25,48,.521,13,28,.464,20,27,.741,109,37,82,.451,26,60,.433,11,22,.500,18,22,.818,103,2016-03-18,CLE,ORL
41,Home,W 109-97 ,240,44,88,.500,30,50,.600,14,38,.368,7,12,.583,109,33,84,.393,28,61,.459,5,23,.217,26,31,.839,97,2016-03-19,ATL,HOU
42,Home,W 109-105 ,240,35,71,.493,28,50,.560,7,21,.333,32,40,.800,109,33,82,.402,23,43,.535,10,39,.256,29,42,.690,105,2016-03-20,NOP,LAC
43,Home,W 109-102 ,240,41,91,.451,29,67,.433,12,24,.500,15,23,.652,109,40,88,.455,31,59,.525,9,29,.310,13,16,.813,102,2016-03-21,CHI,SAC
44,@,W 109-104 ,240,43,87,.494,35,63,.556,8,24,.333,15,24,.625,109,36,82,.439,29,63,.460,7,19,.368,25,30,.833,104,2016-03-21,GSW,MIN
45,Home,W 109-103 ,240,40,89,.449,33,62,.532,7,27,.259,22,25,.880,109,42,96,.438,33,66,.500,9,30,.300,10,11,.909,103,2016-03-23,POR,DAL
46,@,L 109-112 ,240,39,94,.415,26,63,.413,13,31,.419,18,26,.692,109,42,81,.519,30,59,.508,12,22,.545,16,35,.457,112,2016-03-25,TOR,HOU
47,@,W 109-105 ,240,38,78,.487,25,49,.510,13,29,.448,20,24,.833,109,41,95,.432,35,76,.461,6,19,.316,17,27,.630,105,2016-03-30,DEN,MEM
48,@,L 109-116 ,240,37,88,.420,28,64,.438,9,24,.375,26,34,.765,109,41,90,.456,27,56,.482,14,34,.412,20,27,.741,116,2016-03-31,BOS,POR
49,@,W 109-106 ,240,41,87,.471,33,64,.516,8,23,.348,19,30,.633,109,38,83,.458,18,40,.450,20,43,.465,10,13,.769,106,2016-04-01,BOS,GSW
50,@,L 109-114 ,240,43,94,.457,32,64,.500,11,30,.367,12,21,.571,109,43,85,.506,35,66,.530,8,19,.421,20,33,.606,114,2016-04-03,WAS,LAC
51,@,W 109-80 ,240,41,75,.547,23,39,.590,18,36,.500,9,10,.900,109,35,88,.398,31,72,.431,4,16,.250,6,12,.500,80,2016-04-05,CLE,MIL
52,@,L 109-123 ,240,35,74,.473,27,45,.600,8,29,.276,31,34,.912,109,45,80,.563,29,49,.592,16,31,.516,17,22,.773,123,2016-04-06,CLE,IND
53,@,L 109-124 ,240,41,84,.488,34,67,.507,7,17,.412,20,29,.690,109,44,78,.564,38,64,.594,6,14,.429,30,38,.789,124,2016-04-08,MIL,BOS
54,@,L 109-112 ,240,45,100,.450,37,78,.474,8,22,.364,11,21,.524,109,43,82,.524,38,71,.535,5,11,.455,21,28,.750,112,2016-04-08,MIA,ORL
55,@,W 109-102 ,240,43,91,.473,39,75,.520,4,16,.250,19,30,.633,109,32,91,.352,18,54,.333,14,37,.378,24,36,.667,102,2016-04-08,NYK,PHI
56,@,W 109-108 (OT),265,40,87,.460,33,64,.516,7,23,.304,22,24,.917,109,39,96,.406,26,50,.520,13,46,.283,17,25,.680,108,2016-04-10,MIL,PHI
57,Home,W 109-94 ,240,40,83,.482,29,54,.537,11,29,.379,18,20,.900,109,39,87,.448,31,57,.544,8,30,.267,8,15,.533,94,2016-04-11,CLE,ATL
58,@,L 109-144 ,240,40,92,.435,29,62,.468,11,30,.367,18,22,.818,109,56,86,.651,43,58,.741,13,28,.464,19,23,.826,144,2016-04-13,NOP,MIN
59,Home,W 109-98 ,240,42,88,.477,33,60,.550,9,28,.321,16,30,.533,109,32,81,.395,21,52,.404,11,29,.379,23,31,.742,98,2016-04-13,WAS,ATL
60,Home,W 109-91 ,240,41,86,.477,38,68,.559,3,18,.167,24,29,.828,109,35,84,.417,31,62,.500,4,22,.182,17,22,.773,91,2016-10-26,TOR,DET
61,Home,W 109-101 ,240,41,76,.539,28,49,.571,13,27,.481,14,17,.824,109,37,88,.420,28,63,.444,9,25,.360,18,21,.857,101,2016-11-02,BRK,DET
62,Home,W 109-93 ,240,39,79,.494,26,45,.578,13,34,.382,18,26,.692,109,34,86,.395,22,48,.458,12,38,.316,13,15,.867,93,2016-11-02,CHO,PHI
63,Home,L 109-114 ,240,42,83,.506,34,63,.540,8,20,.400,17,19,.895,109,38,75,.507,30,50,.600,8,25,.320,30,35,.857,114,2016-11-06,NYK,UTA
64,@,W 109-84 ,240,43,85,.506,32,66,.485,11,19,.579,12,20,.600,109,31,77,.403,24,56,.429,7,21,.333,15,22,.682,84,2016-11-07,UTA,PHI
65,@,W 109-97 ,240,43,82,.524,33,59,.559,10,23,.435,13,15,.867,109,38,78,.487,28,52,.538,10,26,.385,11,14,.786,97,2016-11-08,DAL,LAL
66,Home,W 109-105 (OT),265,36,86,.419,25,54,.463,11,32,.344,26,31,.839,109,39,88,.443,34,69,.493,5,19,.263,22,23,.957,105,2016-11-11,PHI,IND
67,Home,W 109-102 ,240,42,77,.545,32,49,.653,10,28,.357,15,22,.682,109,38,91,.418,30,68,.441,8,23,.348,18,25,.720,102,2016-11-16,PHI,WAS
68,@,L 109-126 ,240,41,90,.456,31,62,.500,10,28,.357,17,21,.810,109,46,95,.484,32,63,.508,14,32,.438,20,25,.800,126,2016-11-17,POR,HOU
69,Home,L 109-129 ,240,37,93,.398,27,58,.466,10,35,.286,25,31,.806,109,49,85,.576,34,49,.694,15,36,.417,16,21,.762,129,2016-11-20,BRK,POR
70,@,L 109-111 ,240,45,92,.489,34,65,.523,11,27,.407,8,11,.727,109,42,83,.506,28,56,.500,14,27,.519,13,16,.813,111,2016-11-22,OKC,LAL
71,@,W 109-103 ,240,38,81,.469,27,57,.474,11,24,.458,22,25,.880,109,42,91,.462,30,57,.526,12,34,.353,7,9,.778,103,2016-11-25,SAS,BOS
72,@,W 109-85 ,240,43,83,.518,32,55,.582,11,28,.393,12,17,.706,109,32,90,.356,27,68,.397,5,22,.227,16,23,.696,85,2016-11-25,GSW,LAL
73,Home,W 109-94 ,240,42,95,.442,34,75,.453,8,20,.400,17,20,.850,109,39,88,.443,27,53,.509,12,35,.343,4,10,.400,94,2016-11-27,LAL,ATL
74,Home,W 109-107 ,240,40,89,.449,30,68,.441,10,21,.476,19,25,.760,109,45,89,.506,36,64,.563,9,25,.360,8,10,.800,107,2016-11-30,PHO,ATL
75,@,L 109-131 ,240,36,72,.500,30,58,.517,6,14,.429,31,35,.886,109,51,94,.543,39,62,.629,12,32,.375,17,19,.895,131,2016-11-30,IND,POR
76,@,L 109-138 ,240,41,91,.451,30,59,.508,11,32,.344,16,21,.762,109,49,78,.628,35,57,.614,14,21,.667,26,34,.765,138,2016-12-03,PHO,GSW
77,@,W 109-101 ,240,40,79,.506,37,61,.607,3,18,.167,26,28,.929,109,37,89,.416,24,53,.453,13,36,.361,14,18,.778,101,2016-12-05,CHO,DAL
78,@,W 109-94 ,240,35,78,.449,28,55,.509,7,23,.304,32,41,.780,109,34,85,.400,25,52,.481,9,33,.273,17,18,.944,94,2016-12-07,IND,PHO
79,Home,W 109-88 ,240,41,85,.482,32,63,.508,9,22,.409,18,23,.783,109,34,91,.374,25,57,.439,9,34,.265,11,14,.786,88,2016-12-09,CHO,ORL
80,Home,W 109-87 ,240,37,74,.500,18,37,.486,19,37,.514,16,22,.727,109,32,79,.405,21,45,.467,11,34,.324,12,14,.857,87,2016-12-10,HOU,DAL
81,Home,L 109-113 ,240,39,82,.476,25,47,.532,14,35,.400,17,21,.810,109,42,95,.442,28,61,.459,14,34,.412,15,19,.789,113,2016-12-13,NOP,GSW
82,Home,W 109-89 ,240,42,72,.583,29,49,.592,13,23,.565,12,15,.800,109,30,82,.366,24,63,.381,6,19,.316,23,27,.852,89,2016-12-14,UTA,OKC
83,Home,W 109-106 ,240,45,87,.517,40,69,.580,5,18,.278,14,17,.824,109,38,74,.514,24,41,.585,14,33,.424,16,21,.762,106,2016-12-14,WAS,CHO
84,Home,L 109-111 (OT),265,41,92,.446,34,71,.479,7,21,.333,20,27,.741,109,39,96,.406,22,45,.489,17,51,.333,16,20,.800,111,2016-12-17,MIN,HOU
85,@,W 109-79 ,240,43,87,.494,36,60,.600,7,27,.259,16,21,.762,109,34,83,.410,31,62,.500,3,21,.143,8,9,.889,79,2016-12-18,TOR,ORL
86,Home,L 109-112 (OT),265,38,94,.404,26,64,.406,12,30,.400,21,26,.808,109,33,81,.407,21,44,.477,12,37,.324,34,38,.895,112,2016-12-20,MEM,BOS
87,@,W 109-102 ,240,38,92,.413,28,53,.528,10,39,.256,23,27,.852,109,35,82,.427,28,59,.475,7,23,.304,25,29,.862,102,2016-12-22,BOS,IND
88,@,W 109-108 ,240,37,86,.430,29,61,.475,8,25,.320,27,33,.818,109,37,78,.474,29,53,.547,8,25,.320,26,35,.743,108,2016-12-23,ATL,DEN
89,@,L 109-115 ,240,38,89,.427,18,37,.486,20,52,.385,13,15,.867,109,41,81,.506,28,56,.500,13,25,.520,20,25,.800,115,2016-12-23,HOU,MEM
90,@,W 109-105 ,240,42,80,.525,27,51,.529,15,29,.517,10,14,.714,109,36,79,.456,24,47,.511,12,32,.375,21,26,.808,105,2016-12-23,SAC,MIN
91,Home,W 109-90 ,240,45,89,.506,34,62,.548,11,27,.407,8,14,.571,109,31,87,.356,23,64,.359,8,23,.348,20,24,.833,90,2016-12-23,ORL,LAL
92,Home,W 109-108 ,240,37,95,.389,25,60,.417,12,35,.343,23,32,.719,109,37,77,.481,28,47,.596,9,30,.300,25,29,.862,108,2016-12-25,CLE,GSW
93,Home,L 109-121 ,240,40,78,.513,31,54,.574,9,24,.375,20,23,.870,109,43,85,.506,29,54,.537,14,31,.452,21,25,.840,121,2016-12-31,CHO,CLE
94,Home,W 109-98 ,240,37,80,.463,30,64,.469,7,16,.438,28,38,.737,109,39,102,.382,37,87,.425,2,15,.133,18,22,.818,98,2017-01-02,LAC,PHO
95,@,L 109-121 ,240,41,90,.456,24,52,.462,17,38,.447,10,13,.769,109,48,93,.516,38,71,.535,10,22,.455,15,19,.789,121,2017-01-05,BRK,IND
96,@,L 109-118 ,240,36,86,.419,26,55,.473,10,31,.323,27,33,.818,109,43,81,.531,31,48,.646,12,33,.364,20,30,.667,118,2017-01-05,LAL,POR
97,@,L 109-123 ,240,40,87,.460,28,56,.500,12,31,.387,17,24,.708,109,43,86,.500,32,62,.516,11,24,.458,26,28,.929,123,2017-01-07,NYK,IND
98,@,W 109-94 ,240,47,83,.566,40,59,.678,7,24,.292,8,11,.727,109,34,83,.410,27,64,.422,7,19,.368,19,22,.864,94,2017-01-09,OKC,CHI
99,@,W 109-107 ,240,44,84,.524,34,65,.523,10,19,.526,11,13,.846,109,42,88,.477,30,58,.517,12,30,.400,11,14,.786,107,2017-01-10,MIL,SAS
0,Home,L 109-115 ,240,39,97,.402,29,63,.460,10,34,.294,21,25,.840,109,41,83,.494,31,65,.477,10,18,.556,23,26,.885,115,2017-01-13,POR,ORL
1,Home,W 109-93 ,240,44,91,.484,36,74,.486,8,17,.471,13,18,.722,109,36,87,.414,26,56,.464,10,31,.323,11,21,.524,93,2017-01-14,WAS,PHI
2,Home,L 109-119 ,240,40,89,.449,33,63,.524,7,26,.269,22,24,.917,109,48,92,.522,38,73,.521,10,19,.526,13,16,.813,119,2017-01-17,BRK,TOR
3,Home,W 109-103 ,240,42,90,.467,33,61,.541,9,29,.310,16,24,.667,109,36,90,.400,27,51,.529,9,39,.231,22,28,.786,103,2017-01-17,MIA,HOU
4,Home,W 109-97 ,240,41,77,.532,28,47,.596,13,30,.433,14,22,.636,109,33,79,.418,27,61,.443,6,18,.333,25,32,.781,97,2017-01-21,MIA,MIL
5,Home,W 109-100 ,240,39,84,.464,33,60,.550,6,24,.250,25,32,.781,109,39,77,.506,29,57,.509,10,20,.500,12,17,.706,100,2017-01-21,UTA,IND
6,@,W 109-99 ,240,43,80,.538,33,55,.600,10,25,.400,13,17,.765,109,35,90,.389,27,58,.466,8,32,.250,21,25,.840,99,2017-01-23,WAS,CHO
7,@,W 109-104 ,240,40,82,.488,31,61,.508,9,21,.429,20,26,.769,109,41,82,.500,31,54,.574,10,28,.357,12,17,.706,104,2017-01-23,SAC,DET
8,@,W 109-103 ,240,35,76,.461,27,54,.500,8,22,.364,31,35,.886,109,38,86,.442,31,60,.517,7,26,.269,20,25,.800,103,2017-01-23,NYK,IND
9,@,L 109-120 ,240,36,77,.468,26,46,.565,10,31,.323,27,38,.711,109,47,91,.516,36,59,.610,11,32,.344,15,16,.938,120,2017-01-25,HOU,BOS
10,@,W 109-106 ,240,40,83,.482,29,60,.483,11,23,.478,18,25,.720,109,35,80,.438,22,45,.489,13,35,.371,23,26,.885,106,2017-01-25,MIA,BRK
11,Home,L 109-114 ,240,42,91,.462,35,63,.556,7,28,.250,18,23,.783,109,40,75,.533,28,49,.571,12,26,.462,22,25,.880,114,2017-01-25,MIL,PHI
12,@,W 109-103 ,240,42,81,.519,32,63,.508,10,18,.556,15,17,.882,109,36,81,.444,26,54,.481,10,27,.370,21,27,.778,103,2017-01-26,IND,MIN
13,Home,W 109-98 ,240,37,72,.514,28,50,.560,9,22,.409,26,36,.722,109,38,84,.452,27,58,.466,11,26,.423,11,13,.846,98,2017-01-26,OKC,DAL
14,@,L 109-112 ,240,37,77,.481,28,51,.549,9,26,.346,26,33,.788,109,38,81,.469,22,46,.478,16,35,.457,20,21,.952,112,2017-01-27,MEM,POR
15,@,W 109-106 ,240,41,79,.519,30,52,.577,11,27,.407,16,26,.615,109,36,75,.480,24,38,.632,12,37,.324,22,24,.917,106,2017-01-28,SAC,CHO
16,@,L 109-129 ,240,41,85,.482,34,64,.531,7,21,.333,20,25,.800,109,47,92,.511,38,72,.528,9,20,.450,26,32,.813,129,2017-01-28,BRK,MIN
17,@,L 109-113 ,240,43,97,.443,40,70,.571,3,27,.111,20,29,.690,109,36,82,.439,23,50,.460,13,32,.406,28,33,.848,113,2017-01-30,DET,BOS
18,Home,W 109-104 ,240,36,87,.414,24,51,.471,12,36,.333,25,30,.833,109,41,78,.526,33,47,.702,8,31,.258,14,25,.560,104,2017-02-01,BOS,TOR
19,Home,W 109-106 (OT),265,43,88,.489,36,65,.554,7,23,.304,16,19,.842,109,36,87,.414,21,43,.488,15,44,.341,19,24,.792,106,2017-02-04,SAC,GSW
20,@,L 109-118 ,240,42,90,.467,29,55,.527,13,35,.371,12,18,.667,109,41,84,.488,31,60,.517,10,24,.417,26,29,.897,118,2017-02-06,LAC,TOR
21,@,L 109-112 ,240,42,79,.532,31,51,.608,11,28,.393,14,20,.700,109,39,80,.488,32,61,.525,7,19,.368,27,30,.900,112,2017-02-08,TOR,MIN
22,@,L 109-118 ,240,38,79,.481,28,58,.483,10,21,.476,23,30,.767,109,50,106,.472,42,79,.532,8,27,.296,10,13,.769,118,2017-02-09,CLE,OKC
23,@,L 109-125 ,240,39,97,.402,27,60,.450,12,37,.324,19,22,.864,109,46,84,.548,31,54,.574,15,30,.500,18,22,.818,125,2017-02-11,DEN,CLE
24,@,L 109-117 ,240,39,85,.459,32,62,.516,7,23,.304,24,28,.857,109,39,86,.453,30,61,.492,9,25,.360,30,38,.789,117,2017-02-11,MIA,PHI
25,@,W 109-104 (OT),265,32,83,.386,24,55,.436,8,28,.286,37,48,.771,109,37,103,.359,21,61,.344,16,42,.381,14,25,.560,104,2017-02-13,ATL,POR
26,Home,W 109-86 ,240,41,84,.488,28,48,.583,13,36,.361,14,21,.667,109,33,89,.371,26,65,.400,7,24,.292,13,17,.765,86,2017-02-15,GSW,SAC
27,Home,L 109-117 ,240,36,87,.414,23,47,.489,13,40,.325,24,31,.774,109,44,84,.524,31,49,.633,13,35,.371,16,24,.667,117,2017-02-15,HOU,MIA
28,@,L 109-129 ,240,41,83,.494,31,53,.585,10,30,.333,17,31,.548,109,49,97,.505,35,66,.530,14,31,.452,17,24,.708,129,2017-02-24,BRK,DEN
29,@,W 109-95 ,240,37,74,.500,29,51,.569,8,23,.348,27,30,.900,109,32,74,.432,25,56,.446,7,18,.389,24,29,.828,95,2017-02-24,UTA,MIL
30,@,L 109-110 ,240,40,95,.421,33,64,.516,7,31,.226,22,27,.815,109,43,91,.473,37,70,.529,6,21,.286,18,23,.783,110,2017-02-25,PHI,NYK
31,@,W 109-104 ,240,38,85,.447,22,46,.478,16,39,.410,17,24,.708,109,41,84,.488,29,52,.558,12,32,.375,10,13,.769,104,2017-02-28,CHO,LAL
32,Home,W 109-106 ,240,39,76,.513,24,54,.444,15,22,.682,16,23,.696,109,43,93,.462,34,71,.479,9,22,.409,11,13,.846,106,2017-02-28,OKC,UTA
33,Home,W 109-86 ,240,39,78,.500,30,53,.566,9,25,.360,22,23,.957,109,40,103,.388,37,80,.463,3,23,.130,3,17,.176,86,2017-03-01,NOP,DET
34,@,W 109-100 ,240,34,74,.459,23,46,.500,11,28,.393,30,36,.833,109,35,81,.432,24,59,.407,11,22,.500,19,22,.864,100,2017-03-01,BRK,SAC
35,@,L 109-114 ,240,34,86,.395,23,57,.404,11,29,.379,30,32,.938,109,39,79,.494,29,54,.537,10,25,.400,26,35,.743,114,2017-03-02,OKC,POR
36,Home,W 109-106 ,240,42,94,.447,38,74,.514,4,20,.200,21,26,.808,109,32,85,.376,19,48,.396,13,37,.351,29,40,.725,106,2017-03-05,PHO,BOS
37,Home,L 109-110 (OT),265,43,83,.518,35,66,.530,8,17,.471,15,20,.750,109,41,90,.456,31,57,.544,10,33,.303,18,27,.667,110,2017-03-05,SAC,UTA
38,Home,W 109-95 ,240,45,92,.489,39,71,.549,6,21,.286,13,20,.650,109,34,83,.410,26,55,.473,8,28,.286,19,21,.905,95,2017-03-06,DET,CHI
39,Home,L 109-122 ,240,34,77,.442,24,52,.462,10,25,.400,31,39,.795,109,39,73,.534,25,43,.581,14,30,.467,30,38,.789,122,2017-03-06,MEM,BRK
40,@,W 108-98 ,240,43,80,.538,37,68,.544,6,12,.500,16,21,.762,108,35,83,.422,27,66,.409,8,17,.471,20,34,.588,98,2011-12-29,CHI,SAC
41,@,W 108-94 ,240,41,78,.526,28,57,.491,13,21,.619,13,18,.722,108,33,89,.371,26,61,.426,7,28,.250,21,26,.808,94,2012-01-02,IND,NJN
42,Home,W 108-99 ,240,41,78,.526,36,64,.563,5,14,.357,21,27,.778,108,41,96,.427,30,65,.462,11,31,.355,6,7,.857,99,2012-01-03,LAL,HOU
43,Home,W 108-96 ,240,38,75,.507,31,56,.554,7,19,.368,25,29,.862,108,35,84,.417,28,72,.389,7,12,.583,19,25,.760,96,2012-01-08,OKC,SAS
44,Home,W 108-99 ,240,35,78,.449,30,68,.441,5,10,.500,33,41,.805,108,35,75,.467,31,65,.477,4,10,.400,25,31,.806,99,2012-01-14,MEM,NOH
45,Home,W 108-79 ,240,39,82,.476,36,74,.486,3,8,.375,27,31,.871,108,31,85,.365,27,65,.415,4,20,.200,13,21,.619,79,2012-01-17,UTA,LAC
46,@,W 108-104 (OT),265,43,89,.483,36,71,.507,7,18,.389,15,22,.682,108,43,98,.439,39,84,.464,4,14,.286,14,19,.737,104,2012-01-18,DEN,PHI
47,@,W 108-104 ,240,39,79,.494,29,58,.500,10,21,.476,20,30,.667,108,40,95,.421,29,69,.420,11,26,.423,13,17,.765,104,2012-01-20,DEN,WAS
48,Home,W 108-98 ,240,41,79,.519,36,64,.563,5,15,.333,21,29,.724,108,37,83,.446,29,62,.468,8,21,.381,16,21,.762,98,2012-01-21,UTA,MIN
49,Home,L 108-120 ,240,40,85,.471,33,66,.500,7,19,.368,21,30,.700,108,43,74,.581,37,57,.649,6,17,.353,28,31,.903,120,2012-01-30,HOU,MIN
50,@,W 108-105 ,240,36,82,.439,29,66,.439,7,16,.438,29,32,.906,108,38,86,.442,28,65,.431,10,21,.476,19,24,.792,105,2012-02-03,MIN,NJN
51,@,W 108-87 ,240,40,72,.556,31,57,.544,9,15,.600,19,23,.826,108,32,79,.405,29,62,.468,3,17,.176,20,26,.769,87,2012-02-06,CHI,NJN
52,@,L 108-111 (OT),265,34,85,.400,21,59,.356,13,26,.500,27,34,.794,108,39,80,.488,36,71,.507,3,9,.333,30,41,.732,111,2012-02-06,TOR,WAS
53,@,L 108-114 ,240,43,86,.500,39,75,.520,4,11,.364,18,22,.818,108,43,93,.462,37,81,.457,6,12,.500,22,25,.880,114,2012-02-17,SAC,DET
54,Home,W 108-73 ,240,39,78,.500,33,62,.532,6,16,.375,24,32,.750,108,28,75,.373,24,58,.414,4,17,.235,13,22,.591,73,2012-02-19,IND,CHA
55,@,L 108-117 (OT),265,42,79,.532,33,58,.569,9,21,.429,15,23,.652,108,44,88,.500,37,69,.536,7,19,.368,22,31,.710,117,2012-02-21,NOH,IND
56,@,L 108-120 ,240,40,89,.449,27,62,.435,13,27,.481,15,19,.789,108,45,81,.556,35,58,.603,10,23,.435,20,23,.870,120,2012-02-21,SAC,MIA
57,@,W 108-91 ,240,45,84,.536,32,55,.582,13,29,.448,5,15,.333,108,38,81,.469,29,57,.509,9,24,.375,6,9,.667,91,2012-02-22,ORL,NJN
58,@,W 108-100 ,240,44,92,.478,32,69,.464,12,23,.522,8,8,1.000,108,37,79,.468,28,59,.475,9,20,.450,17,23,.739,100,2012-03-01,LAC,SAC
59,Home,W 108-78 ,240,45,77,.584,35,60,.583,10,17,.588,8,9,.889,108,31,83,.373,23,61,.377,8,22,.364,8,12,.667,78,2012-03-06,MIA,NJN
60,Home,L 108-120 ,240,38,78,.487,26,48,.542,12,30,.400,20,32,.625,108,43,84,.512,29,57,.509,14,27,.519,20,24,.833,120,2012-03-09,SAS,LAC
61,@,W 108-89 ,240,40,83,.482,34,66,.515,6,17,.353,22,29,.759,108,31,84,.369,25,64,.391,6,20,.300,21,27,.778,89,2012-03-21,WAS,NJN
62,@,L 108-111 ,240,43,91,.473,42,76,.553,1,15,.067,21,27,.778,108,43,88,.489,36,67,.537,7,21,.333,18,21,.857,111,2012-03-24,SAC,GSW
63,@,W 108-83 ,240,42,82,.512,36,65,.554,6,17,.353,18,26,.692,108,27,70,.386,23,54,.426,4,16,.250,25,30,.833,83,2012-03-25,PHO,CLE
64,@,W 108-91 ,240,44,88,.500,36,72,.500,8,16,.500,12,16,.750,108,35,74,.473,22,54,.407,13,20,.650,8,11,.727,91,2012-03-26,DEN,CHI
65,Home,W 108-101 ,240,44,88,.500,39,77,.506,5,11,.455,15,16,.938,108,42,84,.500,35,61,.574,7,23,.304,10,17,.588,101,2012-03-27,MIL,ATL
66,Home,W 108-86 ,240,43,85,.506,31,51,.608,12,34,.353,10,12,.833,108,31,69,.449,22,43,.512,9,26,.346,15,26,.577,86,2012-03-28,NYK,ORL
67,@,L 108-116 ,240,39,81,.481,28,60,.467,11,21,.524,19,26,.731,108,43,85,.506,36,62,.581,7,23,.304,23,28,.821,116,2012-04-02,MIN,SAC
68,Home,L 108-113 ,240,43,95,.453,34,70,.486,9,25,.360,13,20,.650,108,43,83,.518,37,67,.552,6,16,.375,21,30,.700,113,2012-04-04,LAC,LAL
69,@,L 108-112 (OT),265,41,88,.466,29,67,.433,12,21,.571,14,15,.933,108,42,93,.452,35,75,.467,7,18,.389,21,27,.778,112,2012-04-15,DAL,LAL
70,Home,W 108-86 ,240,41,81,.506,27,49,.551,14,32,.438,12,16,.750,108,34,87,.391,29,72,.403,5,15,.333,13,16,.813,86,2012-04-26,DET,PHI
71,Home,W 108-79 ,240,40,77,.519,30,55,.545,10,22,.455,18,26,.692,108,28,79,.354,24,66,.364,4,13,.308,19,23,.826,79,2012-11-04,LAL,DET
72,@,W 108-101 ,240,40,92,.435,26,63,.413,14,29,.483,14,22,.636,108,39,74,.527,30,49,.612,9,25,.360,14,16,.875,101,2012-11-05,CLE,LAC
73,Home,W 108-88 ,240,35,74,.473,26,49,.531,9,25,.360,29,34,.853,108,30,84,.357,23,54,.426,7,30,.233,21,25,.840,88,2012-11-06,OKC,TOR
74,@,W 108-90 ,240,44,83,.530,38,67,.567,6,16,.375,14,19,.737,108,35,91,.385,29,76,.382,6,15,.400,14,21,.667,90,2012-11-07,MEM,MIL
75,@,L 108-119 ,240,44,90,.489,35,67,.522,9,23,.391,11,18,.611,108,46,85,.541,37,65,.569,9,20,.450,18,28,.643,119,2012-11-18,HOU,LAL
76,Home,W 108-100 ,240,39,80,.488,30,63,.476,9,17,.529,21,24,.875,108,37,79,.468,31,55,.564,6,24,.250,20,24,.833,100,2012-11-23,BOS,OKC
77,Home,W 108-104 ,240,40,80,.500,29,59,.492,11,21,.524,17,20,.850,108,37,87,.425,29,61,.475,8,26,.308,22,30,.733,104,2012-11-23,ORL,CLE
78,@,L 108-111 (OT),265,40,78,.513,27,52,.519,13,26,.500,15,18,.833,108,44,90,.489,33,65,.508,11,25,.440,12,19,.632,111,2012-11-23,NOH,PHO
79,@,L 108-110 ,240,35,79,.443,21,48,.438,14,31,.452,24,33,.727,108,36,69,.522,27,50,.540,9,19,.474,29,37,.784,110,2012-11-24,CLE,MIA
80,Home,W 108-97 ,240,40,74,.541,34,58,.586,6,16,.375,22,32,.688,108,32,79,.405,21,54,.389,11,25,.440,22,30,.733,97,2012-11-24,SAC,UTA
81,@,W 108-106 (2OT),290,34,83,.410,22,55,.400,12,28,.429,28,36,.778,108,34,93,.366,28,66,.424,6,27,.222,32,39,.821,106,2012-11-24,CHA,WAS
82,Home,W 108-101 ,240,42,80,.525,33,65,.508,9,15,.600,15,22,.682,108,36,85,.424,30,66,.455,6,19,.316,23,31,.742,101,2012-11-26,DET,POR
83,Home,W 108-87 ,240,43,81,.531,31,52,.596,12,29,.414,10,15,.667,108,35,78,.449,30,60,.500,5,18,.278,12,21,.571,87,2012-11-30,NYK,WAS
84,Home,W 108-98 (OT),265,40,85,.471,36,66,.545,4,19,.211,24,31,.774,108,38,82,.463,32,68,.471,6,14,.429,16,22,.727,98,2012-12-04,MEM,PHO
85,Home,W 108-104 ,240,42,95,.442,34,73,.466,8,22,.364,16,19,.842,108,38,79,.481,31,62,.500,7,17,.412,21,25,.840,104,2012-12-05,ATL,DEN
86,@,W 108-104 ,240,43,82,.524,38,68,.559,5,14,.357,17,21,.810,108,36,70,.514,28,56,.500,8,14,.571,24,31,.774,104,2012-12-07,CHI,DET
87,Home,W 108-93 ,240,38,94,.404,32,80,.400,6,14,.429,26,32,.813,108,36,81,.444,33,68,.485,3,13,.231,18,32,.563,93,2012-12-07,MIL,CHA
88,@,L 108-114 ,240,36,84,.429,25,56,.446,11,28,.393,25,31,.806,108,41,84,.488,32,67,.478,9,17,.529,23,28,.821,114,2012-12-07,LAL,OKC
89,Home,W 108-105 ,240,38,87,.437,36,73,.493,2,14,.143,30,37,.811,108,42,83,.506,35,67,.522,7,16,.438,14,24,.583,105,2012-12-12,MIN,DEN
90,Home,W 108-96 ,240,45,81,.556,36,62,.581,9,19,.474,9,11,.818,108,37,85,.435,30,61,.492,7,24,.292,15,17,.882,96,2012-12-23,SAC,POR
91,Home,W 108-93 ,240,40,84,.476,30,67,.448,10,17,.588,18,19,.947,108,34,88,.386,30,67,.448,4,21,.190,21,24,.875,93,2012-12-26,MIL,BRK
92,@,W 108-101 (OT),265,40,92,.435,37,79,.468,3,13,.231,25,29,.862,108,40,80,.500,32,54,.593,8,26,.308,13,19,.684,101,2013-01-06,CHA,DET
93,Home,W 108-99 ,240,42,91,.462,33,74,.446,9,17,.529,15,19,.789,108,37,90,.411,33,70,.471,4,20,.200,21,26,.808,99,2013-01-08,MIL,PHO
94,Home,W 108-103 ,240,40,87,.460,32,72,.444,8,15,.533,20,26,.769,108,38,77,.494,28,55,.509,10,22,.455,17,21,.810,103,2013-01-08,MIN,ATL
95,Home,W 108-105 ,240,41,94,.436,37,82,.451,4,12,.333,22,36,.611,108,44,93,.473,36,69,.522,8,24,.333,9,10,.900,105,2013-01-09,DEN,ORL
96,Home,W 108-105 ,240,41,84,.488,29,59,.492,12,25,.480,14,16,.875,108,44,95,.463,36,68,.529,8,27,.296,9,15,.600,105,2013-01-09,SAS,LAL
97,@,W 108-101 ,240,39,68,.574,34,57,.596,5,11,.455,25,34,.735,108,37,90,.411,26,68,.382,11,22,.500,16,23,.696,101,2013-01-11,CHI,NYK
98,Home,L 108-112 ,240,41,84,.488,34,68,.500,7,16,.438,19,31,.613,108,41,80,.513,30,57,.526,11,23,.478,19,28,.679,112,2013-01-18,DEN,WAS
99,Home,W 108-101 (OT),265,47,91,.516,43,72,.597,4,19,.211,10,14,.714,108,40,88,.455,29,63,.460,11,25,.440,10,13,.769,101,2013-01-18,PHI,TOR
0,Home,W 108-103 ,240,46,84,.548,40,64,.625,6,20,.300,10,17,.588,108,38,88,.432,29,61,.475,9,27,.333,18,21,.857,103,2013-01-20,TOR,LAL
1,@,L 108-113 ,240,43,92,.467,29,64,.453,14,28,.500,8,13,.615,108,45,86,.523,39,71,.549,6,15,.400,17,22,.773,113,2013-01-25,MIL,CLE
2,Home,W 108-99 ,240,41,83,.494,34,59,.576,7,24,.292,19,23,.826,108,41,81,.506,35,69,.507,6,12,.500,11,14,.786,99,2013-01-26,SAS,PHO
3,@,W 108-95 ,240,45,84,.536,34,68,.500,11,16,.688,7,10,.700,108,36,84,.429,32,66,.485,4,18,.222,19,25,.760,95,2013-01-29,GSW,CLE
4,@,L 108-114 ,240,39,80,.488,30,55,.545,9,25,.360,21,25,.840,108,40,82,.488,30,59,.508,10,23,.435,24,28,.857,114,2013-02-06,HOU,MIA
5,@,L 108-119 ,240,45,86,.523,37,65,.569,8,21,.381,10,13,.769,108,39,80,.488,32,66,.485,7,14,.500,34,41,.829,119,2013-02-08,ORL,CLE
6,Home,W 108-101 ,240,41,75,.547,35,62,.565,6,13,.462,20,24,.833,108,40,86,.465,36,70,.514,4,16,.250,17,24,.708,101,2013-02-12,MEM,SAC
7,@,L 108-109 ,240,44,85,.518,38,69,.551,6,16,.375,14,20,.700,108,39,83,.470,29,62,.468,10,21,.476,21,23,.913,109,2013-02-12,DEN,TOR
8,@,L 108-119 ,240,42,79,.532,30,62,.484,12,17,.706,12,22,.545,108,41,75,.547,25,48,.521,16,27,.593,21,30,.700,119,2013-02-13,DEN,BRK
9,@,W 108-76 ,240,41,92,.446,31,58,.534,10,34,.294,16,23,.696,108,34,82,.415,31,68,.456,3,14,.214,5,9,.556,76,2013-02-13,ATL,ORL
10,@,W 108-102 ,240,35,75,.467,25,45,.556,10,30,.333,28,35,.800,108,34,90,.378,25,65,.385,9,25,.360,25,29,.862,102,2013-02-19,SAS,SAC
11,Home,W 108-98 ,240,42,87,.483,32,67,.478,10,20,.500,14,17,.824,108,40,84,.476,31,67,.463,9,17,.529,9,14,.643,98,2013-02-20,GSW,PHO
12,@,L 108-122 ,240,38,88,.432,26,66,.394,12,22,.545,20,25,.800,108,49,92,.533,37,65,.569,12,27,.444,12,19,.632,122,2013-02-22,SAC,ATL
13,@,L 108-119 ,240,43,78,.551,35,59,.593,8,19,.421,14,31,.452,108,49,88,.557,44,70,.629,5,18,.278,16,27,.593,119,2013-02-25,LAL,DEN
14,Home,W 108-97 ,240,41,84,.488,35,63,.556,6,21,.286,20,27,.741,108,33,76,.434,21,55,.382,12,21,.571,19,24,.792,97,2013-02-26,IND,GSW
15,@,W 108-104 ,240,38,80,.475,31,59,.525,7,21,.333,25,34,.735,108,38,82,.463,29,58,.500,9,24,.375,19,22,.864,104,2013-03-03,OKC,LAC
16,@,W 108-82 ,240,44,83,.530,33,59,.559,11,24,.458,9,15,.600,108,29,73,.397,27,58,.466,2,15,.133,22,26,.846,82,2013-03-03,MEM,ORL
17,@,L 108-109 (OT),265,40,99,.404,36,86,.419,4,13,.308,24,31,.774,108,45,95,.474,35,71,.493,10,24,.417,9,13,.692,109,2013-03-04,UTA,MIL
18,@,L 108-112 ,240,35,78,.449,23,46,.500,12,32,.375,26,33,.788,108,45,83,.542,34,57,.596,11,26,.423,11,14,.786,112,2013-03-06,HOU,DAL
19,@,W 108-102 ,240,38,78,.487,27,50,.540,11,28,.393,21,29,.724,108,38,88,.432,29,64,.453,9,24,.375,17,20,.850,102,2013-03-06,LAL,NOH
20,@,W 108-93 ,240,44,86,.512,41,74,.554,3,12,.250,17,25,.680,108,35,84,.417,29,64,.453,6,20,.300,17,22,.773,93,2013-03-11,DEN,PHO
21,Home,W 108-98 ,240,40,80,.500,35,64,.547,5,16,.313,23,31,.742,108,40,78,.513,35,62,.565,5,16,.313,13,15,.867,98,2013-03-12,BRK,NOH
22,Home,L 108-115 ,240,43,89,.483,35,68,.515,8,21,.381,14,17,.824,108,41,82,.500,30,53,.566,11,29,.379,22,27,.815,115,2013-03-12,MIL,DAL
23,Home,W 108-100 ,240,36,74,.486,25,43,.581,11,31,.355,25,31,.806,108,39,81,.481,33,57,.579,6,24,.250,16,20,.800,100,2013-03-15,HOU,MIN
24,@,W 108-78 ,240,44,96,.458,31,70,.443,13,26,.500,7,9,.778,108,28,86,.326,19,51,.373,9,35,.257,13,16,.813,78,2013-03-17,GSW,HOU
25,@,W 108-91 ,240,39,67,.582,29,45,.644,10,22,.455,20,29,.690,108,39,94,.415,37,74,.500,2,20,.100,11,12,.917,91,2013-03-17,MIA,TOR
26,@,L 108-113 ,240,42,82,.512,35,65,.538,7,17,.412,17,21,.810,108,38,70,.543,29,52,.558,9,18,.500,28,33,.848,113,2013-03-24,UTA,DAL
27,@,W 108-94 ,240,37,78,.474,22,50,.440,15,28,.536,19,29,.655,108,37,86,.430,28,62,.452,9,24,.375,11,18,.611,94,2013-03-25,MIA,ORL
28,@,L 108-114 ,240,44,84,.524,37,65,.569,7,19,.368,13,18,.722,108,44,85,.518,38,65,.585,6,20,.300,20,28,.714,114,2013-03-27,ORL,CHA
29,Home,W 108-101 ,240,38,74,.514,25,43,.581,13,31,.419,19,22,.864,108,33,70,.471,27,49,.551,6,21,.286,29,35,.829,101,2013-03-27,NYK,MEM
30,@,W 108-89 ,240,42,69,.609,28,42,.667,14,27,.519,10,16,.625,108,34,74,.459,29,56,.518,5,18,.278,16,18,.889,89,2013-03-29,MIA,NOH
31,Home,W 108-89 ,240,35,72,.486,21,45,.467,14,27,.519,24,31,.774,108,32,74,.432,25,49,.510,7,25,.280,18,23,.783,89,2013-03-31,NYK,BOS
32,@,W 108-98 ,240,43,77,.558,36,62,.581,7,15,.467,15,21,.714,108,41,81,.506,33,60,.550,8,21,.381,8,10,.800,98,2013-04-01,DET,TOR
33,Home,L 108-117 ,240,39,87,.448,33,61,.541,6,26,.231,24,31,.774,108,46,90,.511,40,70,.571,6,20,.300,19,19,1.000,117,2013-04-05,SAC,DAL
34,Home,W 108-105 (OT),265,43,95,.453,32,72,.444,11,23,.478,11,19,.579,108,41,93,.441,33,69,.478,8,24,.333,15,21,.714,105,2013-04-12,DAL,DEN
35,Home,W 108-101 ,240,42,77,.545,36,60,.600,6,17,.353,18,21,.857,108,39,89,.438,28,69,.406,11,20,.550,12,15,.800,101,2013-04-12,SAS,SAC
36,Home,L 108-112 ,240,40,89,.449,31,63,.492,9,26,.346,19,25,.760,108,44,88,.500,32,64,.500,12,24,.500,12,18,.667,112,2013-04-17,SAC,LAC
37,@,W 108-95 ,240,42,91,.462,30,62,.484,12,29,.414,12,16,.750,108,33,79,.418,26,61,.426,7,18,.389,22,22,1.000,95,2013-04-17,MIN,SAS
38,@,L 108-111 (OT),265,42,89,.472,35,68,.515,7,21,.333,17,24,.708,108,40,77,.519,34,59,.576,6,18,.333,25,30,.833,111,2013-11-01,DET,MEM
39,@,L 108-116 ,240,44,90,.489,34,68,.500,10,22,.455,10,15,.667,108,41,89,.461,33,69,.478,8,20,.400,26,30,.867,116,2013-11-08,DAL,MIN
40,@,L 108-112 (OT),265,41,88,.466,35,64,.547,6,24,.250,20,29,.690,108,41,88,.466,31,64,.484,10,24,.417,20,26,.769,112,2013-11-08,BRK,WAS
41,Home,W 108-90 ,240,42,79,.532,37,66,.561,5,13,.385,19,25,.760,108,33,78,.423,23,48,.479,10,30,.333,14,26,.538,90,2013-11-09,MEM,GSW
42,@,W 108-100 ,240,43,84,.512,33,57,.579,10,27,.370,12,18,.667,108,37,70,.529,33,55,.600,4,15,.267,22,28,.786,100,2013-11-16,DAL,ORL
43,@,W 108-98 ,240,41,76,.539,33,58,.569,8,18,.444,18,21,.857,108,31,85,.365,28,72,.389,3,13,.231,33,35,.943,98,2013-11-18,POR,BRK
44,@,W 108-98 ,240,36,86,.419,22,57,.386,14,29,.483,22,28,.786,108,34,76,.447,27,56,.482,7,20,.350,23,31,.742,98,2013-11-20,TOR,PHI
45,Home,W 108-101 ,240,38,78,.487,26,54,.481,12,24,.500,20,30,.667,108,36,81,.444,29,64,.453,7,17,.412,22,26,.846,101,2013-11-30,WAS,ATL
46,Home,L 108-114 ,240,40,87,.460,30,59,.508,10,28,.357,18,23,.783,108,38,87,.437,29,64,.453,9,23,.391,29,34,.853,114,2013-12-01,LAL,POR
47,Home,W 108-100 ,240,38,77,.494,27,53,.509,11,24,.458,21,27,.778,108,37,78,.474,29,60,.483,8,18,.444,18,21,.857,100,2013-12-03,BOS,MIL
48,Home,W 108-89 ,240,47,91,.516,39,68,.574,8,23,.348,6,11,.545,108,38,94,.404,33,74,.446,5,20,.250,8,17,.471,89,2013-12-06,ATL,CLE
49,@,W 108-82 ,240,44,88,.500,36,70,.514,8,18,.444,12,14,.857,108,31,85,.365,29,75,.387,2,10,.200,18,22,.818,82,2013-12-07,GSW,MEM
50,@,W 108-106 ,240,46,87,.529,38,71,.535,8,16,.500,8,11,.727,108,39,87,.448,30,57,.526,9,30,.300,19,24,.792,106,2013-12-07,DAL,POR
51,Home,L 108-114 ,240,39,80,.488,34,61,.557,5,19,.263,25,32,.781,108,44,85,.518,37,62,.597,7,23,.304,19,21,.905,114,2013-12-10,LAL,PHO
52,Home,W 108-100 ,240,39,82,.476,29,57,.509,10,25,.400,20,24,.833,108,37,84,.440,28,61,.459,9,23,.391,17,21,.810,100,2013-12-13,TOR,PHI
53,Home,W 108-95 ,240,33,78,.423,22,49,.449,11,29,.379,31,36,.861,108,37,93,.398,30,73,.411,7,20,.350,14,20,.700,95,2013-12-18,LAC,NOP
54,@,W 108-101 ,240,41,87,.471,34,69,.493,7,18,.389,19,24,.792,108,38,82,.463,31,67,.463,7,15,.467,18,24,.750,101,2013-12-18,SAS,PHO
55,Home,L 108-109 (OT),265,46,91,.505,36,70,.514,10,21,.476,6,10,.600,108,42,91,.462,31,70,.443,11,21,.524,14,18,.778,109,2013-12-20,DAL,TOR
56,@,L 108-123 ,240,44,91,.484,41,74,.554,3,17,.176,17,23,.739,108,44,86,.512,29,56,.518,15,30,.500,20,22,.909,123,2013-12-21,DAL,PHO
57,Home,W 108-103 (OT),265,41,83,.494,36,63,.571,5,20,.250,21,25,.840,108,38,86,.442,27,54,.500,11,32,.344,16,21,.762,103,2013-12-27,SAC,MIA
58,@,W 108-107 ,240,45,88,.511,37,74,.500,8,14,.571,10,11,.909,108,39,77,.506,28,51,.549,11,26,.423,18,21,.857,107,2013-12-28,MIA,POR
59,@,W 108-104 (OT),265,42,95,.442,32,62,.516,10,33,.303,14,19,.737,108,38,92,.413,28,76,.368,10,16,.625,18,21,.857,104,2013-12-29,GSW,CLE
60,@,L 108-110 ,240,39,88,.443,27,56,.482,12,32,.375,18,24,.750,108,48,89,.539,46,78,.590,2,11,.182,12,15,.800,110,2013-12-30,POR,NOP
61,@,L 108-111 ,240,37,76,.487,32,64,.500,5,12,.417,29,38,.763,108,43,80,.538,34,58,.586,9,22,.409,16,21,.762,111,2014-01-03,MEM,DEN
62,Home,L 108-110 (OT),265,46,99,.465,40,82,.488,6,17,.353,10,15,.667,108,43,83,.518,36,59,.610,7,24,.292,17,25,.680,110,2014-01-07,MEM,SAS
63,@,L 108-110 ,240,37,94,.394,24,59,.407,13,35,.371,21,25,.840,108,44,94,.468,41,77,.532,3,17,.176,19,27,.704,110,2014-01-11,PHO,DET
64,Home,W 108-101 ,240,43,83,.518,37,68,.544,6,15,.400,16,20,.800,108,38,80,.475,29,53,.547,9,27,.333,16,24,.667,101,2014-01-12,MEM,ATL
65,Home,W 108-98 ,240,38,75,.507,32,61,.525,6,14,.429,26,33,.788,108,39,81,.481,33,64,.516,6,17,.353,14,18,.778,98,2014-01-14,CHA,NYK
66,Home,L 108-111 ,240,39,88,.443,31,68,.456,8,20,.400,22,29,.759,108,45,82,.549,40,70,.571,5,12,.417,16,19,.842,111,2014-01-15,MIN,SAC
67,Home,W 108-96 ,240,42,88,.477,31,61,.508,11,27,.407,13,17,.765,108,39,89,.438,33,66,.500,6,23,.261,12,18,.667,96,2014-01-15,POR,CLE
68,Home,W 108-93 ,240,39,86,.453,30,65,.462,9,21,.429,21,30,.700,108,33,77,.429,28,60,.467,5,17,.294,22,28,.786,93,2014-01-19,OKC,SAC
69,Home,W 108-102 ,240,32,72,.444,22,47,.468,10,25,.400,34,39,.872,108,37,71,.521,29,51,.569,8,20,.400,20,28,.714,102,2014-02-03,BRK,PHI
70,Home,L 108-119 ,240,38,101,.376,33,68,.485,5,33,.152,27,37,.730,108,42,79,.532,24,42,.571,18,37,.486,17,22,.773,119,2014-02-05,CLE,LAL
71,@,L 108-122 ,240,42,90,.467,34,60,.567,8,30,.267,16,21,.762,108,39,71,.549,28,55,.509,11,16,.688,33,42,.786,122,2014-02-05,PHO,HOU
72,Home,L 108-114 ,240,42,94,.447,35,73,.479,7,21,.333,17,20,.850,108,41,84,.488,33,65,.508,8,19,.421,24,33,.727,114,2014-02-05,PHI,BOS
73,Home,W 108-101 ,240,36,76,.474,26,52,.500,10,24,.417,26,33,.788,108,39,77,.506,33,65,.508,6,12,.500,17,26,.654,101,2014-02-10,TOR,NOP
74,@,W 108-96 ,240,39,75,.520,32,58,.552,7,17,.412,23,37,.622,108,39,98,.398,34,82,.415,5,16,.313,13,23,.565,96,2014-02-18,CHA,DET
75,Home,W 108-98 ,240,39,79,.494,30,56,.536,9,23,.391,21,26,.808,108,37,77,.481,25,51,.490,12,26,.462,12,19,.632,98,2014-02-18,IND,ATL
76,Home,L 108-134 ,240,41,84,.488,27,57,.474,14,27,.519,12,15,.800,108,52,104,.500,34,69,.493,18,35,.514,12,25,.480,134,2014-02-19,LAL,HOU
77,@,W 108-102 ,240,36,76,.474,24,51,.471,12,25,.480,24,32,.750,108,39,76,.513,32,59,.542,7,17,.412,17,26,.654,102,2014-02-23,BRK,LAL
78,Home,W 108-97 ,240,40,83,.482,27,55,.491,13,28,.464,15,16,.938,108,37,94,.394,28,66,.424,9,28,.321,14,20,.700,97,2014-02-23,POR,MIN
79,Home,L 108-110 ,240,40,76,.526,26,43,.605,14,33,.424,14,16,.875,108,41,86,.477,26,50,.520,15,36,.417,13,16,.813,110,2014-02-24,NYK,DAL
80,Home,W 108-89 ,240,41,79,.519,31,57,.544,10,22,.455,16,17,.941,108,36,71,.507,27,51,.529,9,20,.450,8,19,.421,89,2014-02-26,DAL,NOP
81,Home,W 108-103 ,240,45,92,.489,41,79,.519,4,13,.308,14,21,.667,108,38,77,.494,23,49,.469,15,28,.536,12,18,.667,103,2014-02-26,MEM,LAL
82,Home,W 108-82 ,240,45,74,.608,39,59,.661,6,15,.400,12,18,.667,108,31,83,.373,27,60,.450,4,23,.174,16,22,.727,82,2014-02-27,MIA,NYK
83,Home,W 108-76 ,240,38,81,.469,29,56,.518,9,25,.360,23,32,.719,108,28,85,.329,25,63,.397,3,22,.136,17,19,.895,76,2014-03-01,LAC,NOP
84,@,W 108-97 ,240,37,81,.457,32,60,.533,5,21,.238,29,38,.763,108,37,82,.451,30,60,.500,7,22,.318,16,21,.762,97,2014-03-01,MIN,SAC
85,@,W 108-88 ,240,46,98,.469,41,70,.586,5,28,.179,11,12,.917,108,30,76,.395,23,50,.460,7,26,.269,21,26,.808,88,2014-03-05,GSW,BOS
86,Home,W 108-81 ,240,42,85,.494,30,54,.556,12,31,.387,12,18,.667,108,30,73,.411,24,46,.522,6,27,.222,15,20,.750,81,2014-03-07,NYK,UTA
87,@,L 108-109 ,240,38,76,.500,26,48,.542,12,28,.429,20,26,.769,108,42,79,.532,35,57,.614,7,22,.318,18,24,.750,109,2014-03-08,ATL,LAC
88,Home,W 108-85 ,240,41,80,.513,29,55,.527,12,25,.480,14,17,.824,108,30,82,.366,25,64,.391,5,18,.278,20,31,.645,85,2014-03-11,GSW,DAL
89,@,W 108-101 ,240,42,79,.532,29,58,.500,13,21,.619,11,12,.917,108,40,85,.471,35,59,.593,5,26,.192,16,21,.762,101,2014-03-12,DAL,UTA
90,Home,W 108-95 ,240,41,70,.586,32,49,.653,9,21,.429,17,27,.630,108,37,80,.463,31,58,.534,6,22,.273,15,28,.536,95,2014-03-17,BRK,PHO
91,Home,W 108-103 ,240,43,88,.489,35,68,.515,8,20,.400,14,20,.700,108,38,83,.458,31,64,.484,7,19,.368,20,25,.800,103,2014-03-26,SAS,DEN
92,Home,W 108-105 ,240,39,70,.557,33,60,.550,6,10,.600,24,34,.706,108,42,85,.494,35,64,.547,7,21,.333,14,18,.778,105,2014-03-27,MIL,LAL
93,Home,W 108-97 ,240,39,71,.549,25,42,.595,14,29,.483,16,21,.762,108,37,87,.425,27,63,.429,10,24,.417,13,16,.813,97,2014-03-28,BRK,CLE
94,Home,L 108-112 ,240,36,78,.462,28,50,.560,8,28,.286,28,33,.848,108,37,79,.468,26,53,.491,11,26,.423,27,30,.900,112,2014-04-02,PHO,LAC
95,@,W 108-100 ,240,35,73,.479,29,49,.592,6,24,.250,32,36,.889,108,30,76,.395,15,43,.349,15,33,.455,25,31,.806,100,2014-04-11,NYK,TOR
96,Home,W 108-95 ,240,39,77,.506,34,64,.531,5,13,.385,25,32,.781,108,36,72,.500,29,57,.509,7,15,.467,16,19,.842,95,2014-04-14,CHI,ORL
97,@,L 108-113 ,240,40,86,.465,31,62,.500,9,24,.375,19,26,.731,108,43,79,.544,40,67,.597,3,12,.250,24,38,.632,113,2014-04-14,BOS,PHI
98,@,W 108-90 ,240,31,73,.425,19,44,.432,12,29,.414,34,50,.680,108,28,79,.354,25,69,.362,3,10,.300,31,39,.795,90,2014-10-28,HOU,LAL
99,Home,W 108-106 (OT),265,41,101,.406,35,80,.438,6,21,.286,20,29,.690,108,39,80,.488,32,66,.485,7,14,.500,21,24,.875,106,2014-10-29,CHO,MIL
0,Home,L 108-114 (OT),265,41,90,.456,28,59,.475,13,31,.419,13,17,.765,108,41,104,.394,38,89,.427,3,15,.200,29,33,.879,114,2014-10-31,CHI,CLE
1,@,W 108-95 ,240,33,83,.398,29,62,.468,4,21,.190,38,48,.792,108,38,81,.469,31,61,.508,7,20,.350,12,24,.500,95,2014-11-01,TOR,ORL
2,Home,W 108-97 ,240,40,73,.548,36,60,.600,4,13,.308,24,33,.727,108,34,80,.425,25,58,.431,9,22,.409,20,24,.833,97,2014-11-01,WAS,MIL
3,@,W 108-91 ,240,35,68,.515,18,31,.581,17,37,.459,21,27,.778,108,31,74,.419,19,46,.413,12,28,.429,17,27,.630,91,2014-11-04,HOU,MIA
4,Home,W 108-87 ,240,40,77,.519,28,47,.596,12,30,.400,16,19,.842,108,33,90,.367,28,67,.418,5,23,.217,16,16,1.000,87,2014-11-06,POR,DAL
5,@,W 108-87 ,240,43,87,.494,35,64,.547,8,23,.348,14,25,.560,108,34,84,.405,26,62,.419,8,22,.364,11,22,.500,87,2014-11-14,DEN,IND
6,@,L 108-111 ,240,45,92,.489,38,72,.528,7,20,.350,11,13,.846,108,39,73,.534,33,52,.635,6,21,.286,27,38,.711,111,2014-12-02,MIL,CLE
7,@,W 108-101 (OT),265,40,87,.460,33,64,.516,7,23,.304,21,30,.700,108,34,87,.391,28,64,.438,6,23,.261,27,35,.771,101,2014-12-06,PHI,DET
8,@,W 108-92 ,240,40,77,.519,31,56,.554,9,21,.429,19,27,.704,108,37,84,.440,28,57,.491,9,27,.333,9,17,.529,92,2014-12-08,ATL,IND
9,Home,W 108-96 ,240,39,88,.443,29,54,.537,10,34,.294,20,34,.588,108,36,96,.375,29,68,.426,7,28,.250,17,26,.654,96,2014-12-13,HOU,DEN
10,Home,W 108-95 ,240,41,89,.461,34,71,.479,7,18,.389,19,22,.864,108,38,78,.487,34,67,.507,4,11,.364,15,22,.682,95,2014-12-15,POR,SAS
11,@,W 108-107 ,240,37,75,.493,24,52,.462,13,23,.565,21,27,.778,108,38,67,.567,32,53,.604,6,14,.429,25,33,.758,107,2014-12-18,MIL,SAC
12,Home,W 108-101 ,240,38,79,.481,31,56,.554,7,23,.304,25,36,.694,108,33,87,.379,23,61,.377,10,26,.385,25,30,.833,101,2014-12-21,SAC,LAL
13,@,L 108-118 ,240,40,82,.488,35,68,.515,5,14,.357,23,26,.885,108,42,86,.488,28,53,.528,14,33,.424,20,27,.741,118,2014-12-21,NYK,TOR
14,@,L 108-128 ,240,43,90,.478,35,73,.479,8,17,.471,14,21,.667,108,49,91,.538,40,66,.606,9,25,.360,21,24,.875,128,2014-12-22,SAC,GSW
15,@,W 108-101 ,240,36,82,.439,28,61,.459,8,21,.381,28,36,.778,108,39,82,.476,31,61,.508,8,21,.381,15,20,.750,101,2014-12-23,CHO,MIL
16,@,W 108-95 ,240,43,97,.443,33,76,.434,10,21,.476,12,14,.857,108,38,87,.437,32,65,.492,6,22,.273,13,18,.722,95,2015-01-07,DET,DAL
17,Home,L 108-118 ,240,42,86,.488,36,67,.537,6,19,.316,18,24,.750,108,47,85,.553,42,68,.618,5,17,.294,19,28,.679,118,2015-01-09,SAC,DEN
18,@,W 108-93 ,240,41,84,.488,32,60,.533,9,24,.375,17,20,.850,108,32,81,.395,29,66,.439,3,15,.200,26,26,1.000,93,2015-01-10,SAS,MIN
19,Home,W 108-100 ,240,37,88,.420,29,64,.453,8,24,.333,26,31,.839,108,31,75,.413,25,60,.417,6,15,.400,32,37,.865,100,2015-01-12,BOS,NOP
20,@,W 108-104 (OT),265,43,100,.430,37,76,.487,6,24,.250,16,23,.696,108,38,86,.442,37,68,.544,1,18,.056,27,34,.794,104,2015-01-13,DAL,SAC
21,Home,L 108-117 ,240,41,89,.461,36,71,.507,5,18,.278,21,26,.808,108,44,92,.478,35,64,.547,9,28,.321,20,31,.645,117,2015-01-17,SAC,LAC
22,Home,W 108-94 ,240,41,90,.456,33,72,.458,8,18,.444,18,25,.720,108,30,80,.375,22,64,.344,8,16,.500,26,32,.813,94,2015-01-19,CLE,CHI
23,Home,W 108-73 ,240,42,79,.532,29,50,.580,13,29,.448,11,14,.786,108,29,75,.387,24,60,.400,5,15,.333,10,16,.625,73,2015-01-24,UTA,BRK
24,Home,W 108-98 ,240,36,82,.439,20,46,.435,16,36,.444,20,29,.690,108,37,94,.394,27,64,.422,10,30,.333,14,18,.778,98,2015-01-25,CLE,OKC
25,Home,W 108-103 ,240,36,86,.419,23,61,.377,13,25,.520,23,26,.885,108,42,92,.457,35,64,.547,7,28,.250,12,17,.706,103,2015-01-30,NOP,LAC
26,@,W 108-93 ,240,42,74,.568,31,53,.585,11,21,.524,13,22,.591,108,33,78,.423,25,54,.463,8,24,.333,19,24,.792,93,2015-01-31,DAL,ORL
27,Home,W 108-91 ,240,42,88,.477,33,68,.485,9,20,.450,15,18,.833,108,35,74,.473,29,60,.483,6,14,.429,15,23,.652,91,2015-02-03,DET,MIA
28,@,W 108-97 ,240,42,77,.545,36,53,.679,6,24,.250,18,23,.783,108,41,83,.494,34,63,.540,7,20,.350,8,11,.727,97,2015-02-03,BOS,NYK
29,Home,W 108-87 ,240,40,90,.444,32,59,.542,8,31,.258,20,23,.870,108,34,88,.386,28,65,.431,6,23,.261,13,17,.765,87,2015-02-05,POR,PHO
30,@,L 108-131 ,240,42,90,.467,30,58,.517,12,32,.375,12,17,.706,108,46,88,.523,38,68,.559,8,20,.400,31,38,.816,131,2015-02-08,LAC,OKC
31,@,L 108-119 ,240,40,84,.476,27,53,.509,13,31,.419,15,28,.536,108,46,83,.554,35,62,.565,11,21,.524,16,22,.727,119,2015-02-23,PHI,MIA
32,@,W 108-101 ,240,40,97,.412,29,65,.446,11,32,.344,17,23,.739,108,40,90,.444,31,65,.477,9,25,.360,12,18,.667,101,2015-03-01,OKC,LAL
33,@,L 108-110 ,240,42,90,.467,31,60,.517,11,30,.367,13,18,.722,108,44,89,.494,34,68,.500,10,21,.476,12,16,.750,110,2015-03-02,GSW,BRK
34,Home,W 108-105 ,240,40,87,.460,33,62,.532,7,25,.280,21,26,.808,108,41,88,.466,33,68,.485,8,20,.400,15,19,.789,105,2015-03-05,CHI,OKC
35,@,W 108-100 (OT),265,39,91,.429,36,65,.554,3,26,.115,27,35,.771,108,34,97,.351,26,75,.347,8,22,.364,24,29,.828,100,2015-03-06,PHO,BRK
36,@,W 108-101 ,240,41,79,.519,35,62,.565,6,17,.353,20,23,.870,108,39,89,.438,36,75,.480,3,14,.214,20,25,.800,101,2015-03-08,CHO,DET
37,Home,W 108-104 ,240,42,82,.512,36,61,.590,6,21,.286,18,25,.720,108,42,98,.429,31,71,.437,11,27,.407,9,9,1.000,104,2015-03-08,OKC,TOR
38,Home,L 108-120 ,240,33,76,.434,21,51,.412,12,25,.480,30,36,.833,108,35,76,.461,20,46,.435,15,30,.500,35,47,.745,120,2015-03-11,OKC,LAC
39,Home,L 108-123 ,240,42,88,.477,33,69,.478,9,19,.474,15,27,.556,108,45,76,.592,27,41,.659,18,35,.514,15,19,.789,123,2015-03-15,ORL,CLE
40,Home,W 108-89 ,240,44,88,.500,36,68,.529,8,20,.400,12,15,.800,108,34,84,.405,26,60,.433,8,24,.333,13,24,.542,89,2015-03-16,BOS,PHI
41,Home,W 108-105 ,240,40,84,.476,33,57,.579,7,27,.259,21,23,.913,108,39,85,.459,31,70,.443,8,15,.533,19,21,.905,105,2015-03-16,GSW,LAL
42,Home,W 108-104 ,240,46,87,.529,39,77,.506,7,10,.700,9,14,.643,108,41,81,.506,31,55,.564,10,26,.385,12,21,.571,104,2015-03-18,MIA,POR
43,@,L 108-118 ,240,42,93,.452,29,57,.509,13,36,.361,11,19,.579,108,37,83,.446,25,53,.472,12,30,.400,32,40,.800,118,2015-03-19,DEN,HOU
44,Home,W 108-92 ,240,42,79,.532,33,51,.647,9,28,.321,15,17,.882,108,30,79,.380,20,54,.370,10,25,.400,22,26,.846,92,2015-03-20,CHI,TOR
45,Home,W 108-91 ,240,43,81,.531,36,65,.554,7,16,.438,15,19,.789,108,37,79,.468,30,52,.577,7,27,.259,10,19,.526,91,2015-03-20,MIA,DEN
46,@,W 108-90 ,240,42,84,.500,29,53,.547,13,31,.419,11,16,.688,108,38,70,.543,35,58,.603,3,12,.250,11,14,.786,90,2015-03-22,CLE,MIL
47,Home,W 108-104 ,240,40,93,.430,28,64,.438,12,29,.414,16,24,.667,108,35,75,.467,28,52,.538,7,23,.304,27,29,.931,104,2015-03-24,DET,TOR
48,Home,L 108-122 ,240,39,92,.424,24,58,.414,15,34,.441,15,19,.789,108,50,83,.602,38,57,.667,12,26,.462,10,11,.909,122,2015-03-24,POR,GSW
49,@,W 108-99 ,240,40,81,.494,32,60,.533,8,21,.381,20,23,.870,108,38,87,.437,32,62,.516,6,25,.240,17,26,.654,99,2015-03-25,SAC,PHO
50,@,W 108-95 ,240,42,82,.512,30,57,.526,12,25,.480,12,14,.857,108,33,87,.379,31,72,.431,2,15,.133,27,32,.844,95,2015-03-28,GSW,MIL
51,@,W 108-101 ,240,34,77,.442,23,46,.500,11,31,.355,29,40,.725,108,37,84,.440,29,58,.500,8,26,.308,19,27,.704,101,2015-04-02,HOU,DAL
52,Home,W 108-99 ,240,39,85,.459,30,64,.469,9,21,.429,21,27,.778,108,36,87,.414,27,58,.466,9,29,.310,18,24,.750,99,2015-04-12,WAS,ATL
53,Home,L 108-112 ,240,39,88,.443,28,56,.500,11,32,.344,19,23,.826,108,43,77,.558,30,52,.577,13,25,.520,13,19,.684,112,2015-04-13,ATL,NYK
54,@,L 108-113 (OT),265,42,97,.433,34,75,.453,8,22,.364,16,21,.762,108,43,91,.473,27,61,.443,16,30,.533,11,17,.647,113,2015-04-15,WAS,CLE
55,Home,W 108-103 ,240,43,83,.518,38,73,.521,5,10,.500,17,25,.680,108,45,79,.570,42,69,.609,3,10,.300,10,13,.769,103,2015-04-15,NOP,SAS
56,@,L 108-112 ,240,43,88,.489,35,66,.530,8,22,.364,14,22,.636,108,39,85,.459,29,59,.492,10,26,.385,24,31,.774,112,2015-11-04,LAC,GSW
57,@,W 108-92 ,240,41,77,.532,30,52,.577,11,25,.440,15,32,.469,108,33,88,.375,28,64,.438,5,24,.208,21,33,.636,92,2015-11-04,POR,UTA
58,@,W 108-94 ,240,44,89,.494,38,62,.613,6,27,.222,14,17,.824,108,32,82,.390,26,53,.491,6,29,.207,24,27,.889,94,2015-11-05,CHO,DAL
59,Home,W 108-102 ,240,45,88,.511,35,62,.565,10,26,.385,8,12,.667,108,41,79,.519,31,56,.554,10,23,.435,10,15,.667,102,2015-11-06,CLE,PHI
60,Home,W 108-104 ,240,40,77,.519,33,58,.569,7,19,.368,21,32,.656,108,36,91,.396,26,62,.419,10,29,.345,22,27,.815,104,2015-11-09,DEN,POR
61,@,L 108-118 ,240,37,86,.430,25,59,.424,12,27,.444,22,33,.667,108,42,76,.553,31,52,.596,11,24,.458,23,30,.767,118,2015-11-11,LAC,DAL
62,Home,W 108-105 (2OT),290,43,102,.422,37,86,.430,6,16,.375,16,22,.727,108,37,91,.407,23,53,.434,14,38,.368,17,27,.630,105,2015-11-14,MIL,CLE
63,Home,W 108-99 ,240,39,83,.470,27,54,.500,12,29,.414,18,26,.692,108,38,87,.437,34,69,.493,4,18,.222,19,24,.792,99,2015-11-14,WAS,ORL
64,Home,W 108-103 (OT),265,32,92,.348,18,48,.375,14,44,.318,30,35,.857,108,35,88,.398,26,58,.448,9,30,.300,24,29,.828,103,2015-11-18,HOU,POR
65,Home,W 108-96 ,240,38,78,.487,26,48,.542,12,30,.400,20,26,.769,108,36,82,.439,29,59,.492,7,23,.304,17,23,.739,96,2015-11-28,POR,LAL
66,Home,W 108-88 ,240,40,85,.471,31,68,.456,9,17,.529,19,20,.950,108,37,87,.425,31,61,.508,6,26,.231,8,13,.615,88,2015-11-28,SAS,ATL
67,Home,W 108-101 ,240,36,87,.414,28,60,.467,8,27,.296,28,39,.718,108,36,88,.409,29,63,.460,7,25,.280,22,25,.880,101,2015-12-02,HOU,NOP
68,@,W 108-104 ,240,41,96,.427,33,71,.465,8,25,.320,18,20,.900,108,37,79,.468,30,58,.517,7,21,.333,23,31,.742,104,2015-12-02,LAL,WAS
69,@,L 108-114 (OT),265,39,89,.438,29,56,.518,10,33,.303,20,24,.833,108,42,85,.494,33,60,.550,9,25,.360,21,31,.677,114,2015-12-04,CLE,NOP
70,Home,W 108-91 ,240,39,87,.448,27,60,.450,12,27,.444,18,21,.857,108,39,91,.429,36,80,.450,3,11,.273,10,15,.667,91,2015-12-04,NYK,BRK
71,@,W 108-105 ,240,37,81,.457,26,50,.520,11,31,.355,23,38,.605,108,37,74,.500,22,43,.512,15,31,.484,16,26,.615,105,2015-12-05,DEN,PHI
72,Home,W 108-105 ,240,44,83,.530,39,66,.591,5,17,.294,15,22,.682,108,39,86,.453,27,57,.474,12,29,.414,15,22,.682,105,2015-12-05,SAS,BOS
73,@,L 108-111 (OT),265,38,87,.437,31,68,.456,7,19,.368,25,29,.862,108,38,86,.442,27,58,.466,11,28,.393,24,33,.727,111,2015-12-11,MIN,DEN
74,Home,W 108-95 ,240,44,90,.489,38,76,.500,6,14,.429,14,18,.778,108,36,89,.404,30,62,.484,6,27,.222,17,25,.680,95,2015-12-12,MIL,GSW
75,Home,W 108-101 ,240,39,87,.448,29,57,.509,10,30,.333,20,24,.833,108,33,73,.452,25,54,.463,8,19,.421,27,34,.794,101,2015-12-13,PHO,MIN
76,@,L 108-114 ,240,41,87,.471,23,47,.489,18,40,.450,8,11,.727,108,42,82,.512,34,57,.596,8,25,.320,22,25,.880,114,2015-12-14,HOU,DEN
77,@,W 108-94 ,240,41,80,.513,33,59,.559,8,21,.381,18,22,.818,108,35,74,.473,26,49,.531,9,25,.360,15,17,.882,94,2015-12-18,TOR,MIA
78,Home,W 108-86 ,240,40,85,.471,29,60,.483,11,25,.440,17,21,.810,108,30,86,.349,25,62,.403,5,24,.208,21,30,.700,86,2015-12-20,CLE,PHI
79,@,W 108-106 ,240,46,89,.517,42,66,.636,4,23,.174,12,16,.750,108,41,89,.461,29,57,.509,12,32,.375,12,20,.600,106,2015-12-23,SAC,IND
80,@,W 108-83 ,240,44,82,.537,34,58,.586,10,24,.417,10,14,.714,108,30,72,.417,27,62,.435,3,10,.300,20,25,.800,83,2015-12-23,SAS,MIN
81,@,L 108-110 ,240,38,84,.452,23,51,.451,15,33,.455,17,20,.850,108,38,75,.507,25,51,.490,13,24,.542,21,26,.808,110,2015-12-26,HOU,NOP
82,@,W 108-101 ,240,38,77,.494,28,57,.491,10,20,.500,22,23,.957,108,43,79,.544,34,60,.567,9,19,.474,6,13,.462,101,2015-12-26,MIA,ORL
83,Home,W 108-98 ,240,43,89,.483,37,64,.578,6,25,.240,16,22,.727,108,35,85,.412,26,56,.464,9,29,.310,19,23,.826,98,2015-12-28,CHO,LAL
84,@,W 108-91 ,240,41,78,.526,34,55,.618,7,23,.304,19,25,.760,108,34,87,.391,27,63,.429,7,24,.292,16,24,.667,91,2015-12-28,LAC,WAS
85,Home,W 108-96 ,240,43,79,.544,35,63,.556,8,16,.500,14,17,.824,108,37,89,.416,27,62,.435,10,27,.370,12,17,.706,96,2015-12-29,NYK,DET
86,Home,W 108-81 ,240,39,85,.459,29,69,.420,10,16,.625,20,25,.800,108,31,84,.369,25,65,.385,6,19,.316,13,17,.765,81,2016-01-01,CHI,NYK
87,@,L 108-111 (OT),265,44,105,.419,39,75,.520,5,30,.167,15,23,.652,108,43,86,.500,33,58,.569,10,28,.357,15,23,.652,111,2016-01-02,DEN,GSW
88,Home,L 108-128 ,240,38,96,.396,26,63,.413,12,33,.364,20,28,.714,108,46,87,.529,28,55,.509,18,32,.563,18,21,.857,128,2016-01-08,POR,GSW
89,@,W 108-95 ,240,41,75,.547,36,58,.621,5,17,.294,21,27,.778,108,39,80,.488,28,63,.444,11,17,.647,6,14,.429,95,2016-01-09,TOR,PHI
90,Home,W 108-89 ,240,38,82,.463,23,49,.469,15,33,.455,17,29,.586,108,32,82,.390,26,51,.510,6,31,.194,19,25,.760,89,2016-01-13,OKC,DAL
91,Home,W 108-101 (OT),265,40,96,.417,37,86,.430,3,10,.300,25,37,.676,108,43,100,.430,34,70,.486,9,30,.300,6,6,1.000,101,2016-01-15,MIL,ATL
92,@,W 108-98 ,240,43,84,.512,26,53,.491,17,31,.548,5,11,.455,108,37,77,.481,28,56,.500,9,21,.429,15,20,.750,98,2016-01-18,POR,WAS
93,@,W 108-86 ,240,43,75,.573,34,59,.576,9,16,.563,13,15,.867,108,33,75,.440,27,59,.458,6,16,.375,14,18,.778,86,2016-01-22,UTA,BRK
94,@,W 108-95 ,240,43,85,.506,32,64,.500,11,21,.524,11,13,.846,108,38,84,.452,32,68,.471,6,16,.375,13,18,.722,95,2016-01-22,SAS,LAL
95,Home,W 108-97 ,240,38,85,.447,33,69,.478,5,16,.313,27,36,.750,108,36,86,.419,29,67,.433,7,19,.368,18,25,.720,97,2016-01-23,SAC,IND
96,Home,W 108-102 (OT),265,43,100,.430,37,82,.451,6,18,.333,16,25,.640,108,40,86,.465,30,58,.517,10,28,.357,12,14,.857,102,2016-01-25,MEM,ORL
97,@,L 108-116 ,240,36,95,.379,27,56,.482,9,39,.231,27,43,.628,108,41,86,.477,33,67,.493,8,19,.421,26,30,.867,116,2016-01-29,HOU,OKC
98,@,W 108-105 ,240,47,95,.495,34,65,.523,13,30,.433,1,2,.500,108,42,92,.457,32,63,.508,10,29,.345,11,21,.524,105,2016-01-30,GSW,PHI
99,@,W 108-102 ,240,39,77,.506,31,60,.517,8,17,.471,22,26,.846,108,33,75,.440,22,43,.512,11,32,.344,25,34,.735,102,2016-02-03,MIN,LAC
0,Home,W 108-104 ,240,38,81,.469,26,54,.481,12,27,.444,20,25,.800,108,38,86,.442,29,61,.475,9,25,.360,19,24,.792,104,2016-02-06,CHO,WAS
1,@,L 108-116 ,240,36,85,.424,29,63,.460,7,22,.318,29,37,.784,108,48,97,.495,41,71,.577,7,26,.269,13,20,.650,116,2016-02-06,OKC,GSW
2,Home,W 108-91 ,240,35,80,.438,21,44,.477,14,36,.389,24,31,.774,108,35,90,.389,25,65,.385,10,25,.400,11,14,.786,91,2016-02-08,CHO,CHI
3,Home,L 108-111 ,240,44,83,.530,36,57,.632,8,26,.308,12,14,.857,108,39,78,.500,23,52,.442,16,26,.615,17,25,.680,111,2016-02-09,NYK,WAS
4,Home,W 108-101 ,240,44,86,.512,39,70,.557,5,16,.313,15,25,.600,108,28,76,.368,16,47,.340,12,29,.414,33,43,.767,101,2016-02-22,MIL,LAL
5,Home,W 108-105 ,240,46,91,.505,43,76,.566,3,15,.200,13,16,.813,108,35,77,.455,22,51,.431,13,26,.500,22,25,.880,105,2016-02-24,IND,NYK
6,@,W 108-92 ,240,44,85,.518,36,66,.545,8,19,.421,12,15,.800,108,39,96,.406,33,78,.423,6,18,.333,8,15,.533,92,2016-02-24,SAS,SAC
7,Home,W 108-95 ,240,37,80,.463,33,64,.516,4,16,.250,30,36,.833,108,39,93,.419,33,66,.500,6,27,.222,11,16,.688,95,2016-02-26,NYK,ORL
8,@,L 108-116 ,240,43,89,.483,33,57,.579,10,32,.313,12,21,.571,108,43,89,.483,37,69,.536,6,20,.300,24,31,.774,116,2016-02-29,PHI,WAS
9,@,L 108-121 ,240,41,91,.451,32,61,.525,9,30,.300,17,20,.850,108,43,77,.558,34,58,.586,9,19,.474,26,31,.839,121,2016-03-01,ORL,DAL
10,Home,W 108-92 ,240,40,83,.482,31,66,.470,9,17,.529,19,25,.760,108,33,82,.402,28,60,.467,5,22,.227,21,27,.778,92,2016-03-03,MIA,PHO
11,Home,W 108-101 ,240,38,79,.481,25,48,.521,13,31,.419,19,23,.826,108,37,90,.411,28,62,.452,9,28,.321,18,21,.857,101,2016-03-04,CHO,IND
12,Home,W 108-83 ,240,42,90,.467,30,63,.476,12,27,.444,12,16,.750,108,32,81,.395,29,61,.475,3,20,.150,16,24,.667,83,2016-03-04,CLE,WAS
13,Home,W 108-100 ,240,36,79,.456,27,58,.466,9,21,.429,27,34,.794,108,35,87,.402,26,52,.500,9,35,.257,21,30,.700,100,2016-03-05,CHI,HOU
14,Home,W 108-103 ,240,41,90,.456,29,60,.483,12,30,.400,14,17,.824,108,39,80,.488,35,65,.538,4,15,.267,21,24,.875,103,2016-03-07,CHO,MIN
15,@,L 108-114 ,240,42,80,.525,36,65,.554,6,15,.400,18,19,.947,108,42,80,.525,38,72,.528,4,8,.500,26,37,.703,114,2016-03-09,MIA,MIL
16,@,L 108-120 ,240,41,81,.506,29,47,.617,12,34,.353,14,23,.609,108,48,91,.527,39,67,.582,9,24,.375,15,18,.833,120,2016-03-09,LAC,OKC
17,Home,L 108-120 ,240,42,80,.525,35,58,.603,7,22,.318,17,21,.810,108,45,85,.529,29,50,.580,16,35,.457,14,20,.700,120,2016-03-10,LAL,CLE
18,@,W 108-99 ,240,39,82,.476,27,54,.500,12,28,.429,18,22,.818,108,38,81,.469,29,60,.483,9,21,.429,14,21,.667,99,2016-03-13,UTA,SAC
19,Home,W 108-87 ,240,44,82,.537,36,62,.581,8,20,.400,12,16,.750,108,32,69,.464,24,50,.480,8,19,.421,15,22,.682,87,2016-03-15,SAS,LAC
20,Home,L 108-114 ,240,44,100,.440,40,80,.500,4,20,.200,16,21,.762,108,40,71,.563,30,50,.600,10,21,.476,24,31,.774,114,2016-03-16,MEM,MIN
21,Home,L 108-123 ,240,42,90,.467,33,72,.458,9,18,.500,15,17,.882,108,49,90,.544,37,69,.536,12,21,.571,13,16,.813,123,2016-03-16,SAC,NOP
22,@,L 108-115 ,240,40,79,.506,36,64,.563,4,15,.267,24,29,.828,108,44,92,.478,32,66,.485,12,26,.462,15,18,.833,115,2016-03-18,SAC,DET
23,Home,W 108-97 ,240,40,80,.500,35,65,.538,5,15,.333,23,33,.697,108,36,84,.429,30,66,.455,6,18,.333,19,28,.679,97,2016-03-25,MIA,ORL
24,Home,W 108-105 ,240,38,91,.418,30,66,.455,8,25,.320,24,30,.800,108,39,93,.419,29,55,.527,10,38,.263,17,24,.708,105,2016-03-26,POR,PHI
25,Home,L 108-110 (OT),265,38,95,.400,29,65,.446,9,30,.300,23,26,.885,108,39,98,.398,27,60,.450,12,38,.316,20,31,.645,110,2016-04-01,ATL,CLE
26,Home,W 108-92 ,240,39,87,.448,32,68,.471,7,19,.368,23,26,.885,108,34,77,.442,23,48,.479,11,29,.379,13,19,.684,92,2016-04-05,MEM,CHI
27,@,W 108-104 ,240,39,86,.453,28,59,.475,11,27,.407,19,31,.613,108,43,90,.478,39,75,.520,4,15,.267,14,19,.737,104,2016-04-06,DET,ORL
28,Home,L 108-109 (OT),265,39,96,.406,26,50,.520,13,46,.283,17,25,.680,108,40,87,.460,33,64,.516,7,23,.304,22,24,.917,109,2016-04-10,PHI,MIL
29,@,W 108-96 ,240,47,97,.485,43,81,.531,4,16,.250,10,16,.625,108,34,89,.382,28,71,.394,6,18,.333,22,28,.786,96,2016-10-26,MIA,ORL
30,Home,W 108-82 ,240,48,95,.505,41,76,.539,7,19,.368,5,6,.833,108,33,95,.347,25,69,.362,8,26,.308,8,12,.667,82,2016-10-28,DET,ORL
31,@,L 108-110 ,240,37,84,.440,26,50,.520,11,34,.324,23,28,.821,108,41,88,.466,33,66,.500,8,22,.364,20,24,.833,110,2016-10-29,BRK,MIL
32,@,L 108-115 ,240,40,89,.449,34,61,.557,6,28,.214,22,25,.880,108,41,87,.471,31,59,.525,10,28,.357,23,29,.793,115,2016-11-01,LAL,IND
33,Home,W 108-96 (OT),265,37,86,.430,24,57,.421,13,29,.448,21,29,.724,108,34,89,.382,29,66,.439,5,23,.217,23,27,.852,96,2016-11-01,MIA,SAC
34,@,L 108-119 ,240,40,91,.440,34,71,.479,6,20,.300,22,28,.786,108,41,90,.456,31,67,.463,10,23,.435,27,35,.771,119,2016-11-06,PHO,LAL
35,Home,W 108-107 ,240,44,86,.512,37,62,.597,7,24,.292,13,19,.684,108,35,70,.500,25,46,.543,10,24,.417,27,34,.794,107,2016-11-08,MEM,DEN
36,Home,L 108-110 ,240,38,88,.432,22,60,.367,16,28,.571,16,19,.842,108,39,86,.453,28,59,.475,11,27,.407,21,35,.600,110,2016-11-11,OKC,LAC
37,Home,L 108-115 ,240,38,89,.427,23,54,.426,15,35,.429,17,21,.810,108,43,80,.538,32,56,.571,11,24,.458,18,22,.818,115,2016-11-15,MIN,CHO
38,Home,W 108-83 ,240,39,79,.494,31,53,.585,8,26,.308,22,31,.710,108,28,88,.318,19,61,.311,9,27,.333,18,31,.581,83,2016-11-23,UTA,DEN
39,Home,W 108-97 ,240,47,90,.522,38,71,.535,9,19,.474,5,7,.714,108,35,73,.479,28,52,.538,7,21,.333,20,26,.769,97,2016-11-25,DET,LAC
40,Home,L 108-112 ,240,43,92,.467,28,58,.483,15,34,.441,7,10,.700,108,38,92,.413,26,52,.500,12,40,.300,24,28,.857,112,2016-11-27,PHI,CLE
41,Home,L 108-110 (2OT),290,39,99,.394,29,67,.433,10,32,.313,20,21,.952,108,42,104,.404,29,70,.414,13,34,.382,13,21,.619,110,2016-12-05,NOP,MEM
42,Home,L 108-116 ,240,36,81,.444,27,57,.474,9,24,.375,27,36,.750,108,38,83,.458,25,51,.490,13,32,.406,27,30,.900,116,2016-12-11,MIN,GSW
43,Home,L 108-113 ,240,42,89,.472,28,56,.500,14,33,.424,10,20,.500,108,37,74,.500,24,49,.490,13,25,.520,26,37,.703,113,2016-12-14,ORL,LAC
44,Home,W 108-101 ,240,44,80,.550,36,58,.621,8,22,.364,12,14,.857,108,37,84,.440,27,53,.509,10,31,.323,17,20,.850,101,2016-12-14,SAS,BOS
45,Home,W 108-97 ,240,45,95,.474,34,75,.453,11,20,.550,7,13,.538,108,35,74,.473,30,55,.545,5,19,.263,22,29,.759,97,2016-12-15,MIL,CHI
46,@,L 108-122 ,240,42,86,.488,32,58,.552,10,28,.357,14,21,.667,108,44,77,.571,32,52,.615,12,25,.480,22,27,.815,122,2016-12-16,DET,WAS
47,@,L 108-119 ,240,41,86,.477,25,49,.510,16,37,.432,10,13,.769,108,46,89,.517,31,56,.554,15,33,.455,12,18,.667,119,2016-12-17,LAL,CLE
48,Home,W 108-107 ,240,38,88,.432,26,60,.433,12,28,.429,20,23,.870,108,36,81,.444,24,47,.511,12,34,.353,23,31,.742,107,2016-12-18,PHI,BRK
49,@,L 108-115 ,240,37,82,.451,28,61,.459,9,21,.429,25,35,.714,108,42,86,.488,35,67,.522,7,19,.368,24,25,.960,115,2016-12-19,PHO,MIN
50,Home,L 108-110 ,240,39,87,.448,29,52,.558,10,35,.286,20,26,.769,108,41,75,.547,32,52,.615,9,23,.391,19,24,.792,110,2016-12-19,OKC,ATL
51,Home,L 108-114 (OT),265,40,87,.460,33,60,.550,7,27,.259,21,29,.724,108,37,91,.407,20,51,.392,17,40,.425,23,27,.852,114,2016-12-20,MIL,CLE
52,@,W 108-93 ,240,40,93,.430,30,76,.395,10,17,.588,18,26,.692,108,33,82,.402,22,49,.449,11,33,.333,16,21,.762,93,2016-12-20,NOP,PHI
53,Home,L 108-109 ,240,37,78,.474,29,53,.547,8,25,.320,26,35,.743,108,37,86,.430,29,61,.475,8,25,.320,27,33,.818,109,2016-12-23,DEN,ATL
54,@,L 108-109 ,240,37,77,.481,28,47,.596,9,30,.300,25,29,.862,108,37,95,.389,25,60,.417,12,35,.343,23,32,.719,109,2016-12-25,GSW,CLE
55,Home,W 108-99 ,240,42,84,.500,31,51,.608,11,33,.333,13,15,.867,108,39,93,.419,31,61,.508,8,32,.250,13,15,.867,99,2016-12-30,GSW,DAL
56,Home,L 108-116 ,240,41,91,.451,32,61,.525,9,30,.300,17,19,.895,108,38,88,.432,29,55,.527,9,33,.273,31,43,.721,116,2017-01-06,BRK,CLE
57,@,L 108-117 ,240,40,85,.471,30,54,.556,10,31,.323,18,23,.783,108,40,93,.430,22,57,.386,18,36,.500,19,21,.905,117,2017-01-07,NOP,BOS
58,@,W 108-87 ,240,43,85,.506,36,64,.563,7,21,.333,15,20,.750,108,32,83,.386,23,59,.390,9,24,.375,14,26,.538,87,2017-01-10,POR,LAL
59,@,L 108-117 ,240,45,105,.429,35,79,.443,10,26,.385,8,12,.667,108,43,85,.506,26,44,.591,17,41,.415,14,18,.778,117,2017-01-11,WAS,BOS
60,Home,L 108-113 ,240,38,78,.487,28,60,.467,10,18,.556,22,27,.815,108,43,89,.483,28,55,.509,15,34,.441,12,17,.706,113,2017-01-12,PHO,DAL
61,@,L 108-116 ,240,41,83,.494,29,51,.569,12,32,.375,14,18,.778,108,40,80,.500,31,65,.477,9,15,.600,27,31,.871,116,2017-01-13,MIA,MIL
62,Home,L 108-120 ,240,42,80,.525,33,55,.600,9,25,.360,15,19,.789,108,44,87,.506,29,50,.580,15,37,.405,17,22,.773,120,2017-01-13,SAC,CLE
63,Home,W 108-105 ,240,39,85,.459,31,64,.484,8,21,.381,22,24,.917,108,36,71,.507,27,51,.529,9,20,.450,24,34,.706,105,2017-01-14,PHO,SAS
64,@,W 108-104 ,240,40,78,.513,36,61,.590,4,17,.235,24,35,.686,108,40,95,.421,29,63,.460,11,32,.344,13,13,1.000,104,2017-01-15,CHI,MEM
65,Home,W 108-98 ,240,42,84,.500,27,45,.600,15,39,.385,9,10,.900,108,38,86,.442,30,61,.492,8,25,.320,14,17,.824,98,2017-01-16,BOS,CHO
66,@,W 108-107 ,240,40,87,.460,28,55,.509,12,32,.375,16,23,.696,108,42,85,.494,34,59,.576,8,26,.308,15,23,.652,107,2017-01-16,ATL,NYK
67,Home,L 108-125 ,240,43,96,.448,36,61,.590,7,35,.200,15,18,.833,108,47,89,.528,32,51,.627,15,38,.395,16,21,.762,125,2017-01-20,HOU,GSW
68,Home,W 108-95 ,240,41,87,.471,27,54,.500,14,33,.424,12,15,.800,108,34,80,.425,25,57,.439,9,23,.391,18,25,.720,95,2017-01-20,LAL,IND
69,@,L 108-111 ,240,42,82,.512,35,58,.603,7,24,.292,17,21,.810,108,45,85,.529,39,70,.557,6,15,.400,15,21,.714,111,2017-01-22,DEN,MIN
70,@,W 108-106 ,240,38,85,.447,31,61,.508,7,24,.292,25,33,.758,108,38,84,.452,32,59,.542,6,25,.240,24,28,.857,106,2017-01-24,SAS,TOR
71,@,L 108-123 ,240,38,84,.452,28,51,.549,10,33,.303,22,24,.917,108,48,83,.578,39,63,.619,9,20,.450,18,21,.857,123,2017-01-24,BOS,WAS
72,Home,L 108-112 (OT),265,37,87,.425,28,66,.424,9,21,.429,25,32,.781,108,37,89,.416,23,49,.469,14,40,.350,24,30,.800,112,2017-01-28,MIL,BOS
73,@,L 108-121 ,240,44,99,.444,34,71,.479,10,28,.357,10,14,.714,108,45,89,.506,37,75,.493,8,14,.571,23,28,.821,121,2017-01-29,PHI,CHI
74,Home,W 108-94 ,240,37,86,.430,30,65,.462,7,21,.333,27,38,.711,108,30,85,.353,23,57,.404,7,28,.250,27,32,.844,94,2017-01-31,SAS,OKC
75,Home,W 108-106 (OT),265,43,94,.457,33,63,.524,10,31,.323,12,15,.800,108,40,94,.426,28,64,.438,12,30,.400,14,19,.737,106,2017-01-31,TOR,NOP
76,Home,L 108-113 ,240,35,93,.376,22,42,.524,13,51,.255,25,33,.758,108,44,85,.518,36,55,.655,8,30,.267,17,23,.739,113,2017-02-02,HOU,ATL
77,@,L 108-116 ,240,40,87,.460,28,48,.583,12,39,.308,16,22,.727,108,44,96,.458,32,63,.508,12,33,.364,16,21,.762,116,2017-02-02,LAL,WAS
78,@,L 108-116 ,240,44,89,.494,39,72,.542,5,17,.294,15,19,.789,108,44,98,.449,33,72,.458,11,26,.423,17,22,.773,116,2017-02-03,MIN,DET
79,@,W 108-104 ,240,36,76,.474,19,45,.422,17,31,.548,19,23,.826,108,40,88,.455,31,58,.534,9,30,.300,15,20,.750,104,2017-02-03,DAL,POR
80,Home,W 108-92 ,240,42,84,.500,32,59,.542,10,25,.400,14,15,.933,108,29,73,.397,19,41,.463,10,32,.313,24,27,.889,92,2017-02-08,SAC,BOS
81,@,W 108-99 ,240,41,92,.446,34,69,.493,7,23,.304,19,21,.905,108,35,81,.432,27,61,.443,8,20,.400,21,28,.750,99,2017-02-10,MIA,BRK
82,Home,W 108-107 ,240,38,80,.475,20,44,.455,18,36,.500,14,21,.667,108,36,71,.507,25,41,.610,11,30,.367,24,31,.774,107,2017-02-10,SAC,ATL
83,Home,L 108-110 ,240,40,93,.430,32,70,.457,8,23,.348,20,24,.833,108,37,78,.474,29,50,.580,8,28,.286,28,35,.800,110,2017-02-13,PHO,NOP
84,Home,L 108-116 ,240,42,86,.488,33,63,.524,9,23,.391,15,19,.789,108,44,86,.512,31,47,.660,13,39,.333,15,22,.682,116,2017-02-14,MIN,CLE
85,@,L 108-116 ,240,44,93,.473,36,62,.581,8,31,.258,12,18,.667,108,38,80,.475,25,52,.481,13,28,.464,27,36,.750,116,2017-02-15,PHI,BOS
86,@,L 108-114 (OT),265,38,92,.413,31,62,.500,7,30,.233,25,26,.962,108,44,107,.411,29,70,.414,15,37,.405,11,12,.917,114,2017-02-23,CHO,DET
87,@,W 108-90 ,240,40,99,.404,23,62,.371,17,37,.459,11,13,.846,108,30,79,.380,24,59,.407,6,20,.300,24,36,.667,90,2017-02-24,MIA,ATL
88,Home,L 108-117 ,240,32,88,.364,22,43,.512,10,45,.222,34,42,.810,108,41,91,.451,28,61,.459,13,30,.433,22,25,.880,117,2017-02-27,HOU,IND
89,Home,L 108-119 ,240,37,82,.451,27,48,.563,10,34,.294,24,27,.889,108,40,89,.449,34,60,.567,6,29,.207,33,39,.846,119,2017-02-27,PHI,GSW
90,@,L 108-112 ,240,39,84,.464,31,55,.564,8,29,.276,22,27,.815,108,41,91,.451,29,63,.460,12,28,.429,18,20,.900,112,2017-02-28,GSW,WAS
91,@,L 108-123 ,240,43,97,.443,35,69,.507,8,28,.286,14,21,.667,108,39,78,.500,21,36,.583,18,42,.429,27,36,.750,123,2017-03-04,MEM,HOU
92,Home,W 108-96 ,240,37,75,.493,24,45,.533,13,30,.433,21,28,.750,108,36,83,.434,30,67,.448,6,16,.375,18,21,.857,96,2017-03-06,DEN,SAC
93,Home,L 108-115 ,240,35,79,.443,27,47,.574,8,32,.250,30,40,.750,108,41,76,.539,29,45,.644,12,31,.387,21,24,.875,115,2017-03-08,HOU,UTA
94,Home,W 108-101 ,240,37,85,.435,20,44,.455,17,41,.415,17,24,.708,108,37,80,.463,30,59,.508,7,21,.333,20,21,.952,101,2017-03-08,MIA,CHO
95,@,L 108-114 (OT),265,41,94,.436,30,65,.462,11,29,.379,15,20,.750,108,40,88,.455,34,67,.507,6,21,.286,28,33,.848,114,2017-03-09,PHI,POR
96,Home,W 107-103 ,240,40,97,.412,31,78,.397,9,19,.474,18,23,.783,107,40,83,.482,32,64,.500,8,19,.421,15,19,.789,103,2011-12-26,POR,PHI
97,@,L 107-115 ,240,37,72,.514,25,53,.472,12,19,.632,21,27,.778,107,42,75,.560,36,65,.554,6,10,.600,25,35,.714,115,2011-12-27,BOS,MIA
98,@,W 107-79 ,240,39,79,.494,28,59,.475,11,20,.550,18,31,.581,107,34,89,.382,30,72,.417,4,17,.235,7,12,.583,79,2011-12-31,PHI,GSW
99,Home,W 107-97 ,240,41,77,.532,32,55,.582,9,22,.409,16,18,.889,107,35,88,.398,27,62,.435,8,26,.308,19,23,.826,97,2011-12-31,OKC,PHO
0,Home,W 107-96 ,240,41,89,.461,36,77,.468,5,12,.417,20,26,.769,107,37,79,.468,37,68,.544,0,11,.000,22,27,.815,96,2012-01-05,POR,LAL
1,@,W 107-104 ,240,41,70,.586,25,43,.581,16,27,.593,9,19,.474,107,41,86,.477,31,61,.508,10,25,.400,12,13,.923,104,2012-01-11,ORL,POR
2,Home,W 107-105 (OT),265,39,93,.419,34,75,.453,5,18,.278,24,28,.857,107,37,90,.411,28,64,.438,9,26,.346,22,31,.710,105,2012-01-14,HOU,POR
3,Home,W 107-94 ,240,42,81,.519,39,73,.534,3,8,.375,20,26,.769,107,32,74,.432,23,47,.489,9,27,.333,21,27,.778,94,2012-01-14,UTA,NJN
4,Home,W 107-100 ,240,37,75,.493,26,46,.565,11,29,.379,22,25,.880,107,37,72,.514,29,56,.518,8,16,.500,18,27,.667,100,2012-01-18,NJN,GSW
5,@,W 107-92 ,240,39,86,.453,32,65,.492,7,21,.333,22,28,.786,107,33,80,.413,28,68,.412,5,12,.417,21,27,.778,92,2012-01-23,HOU,MIN
6,Home,W 107-100 ,240,41,90,.456,36,73,.493,5,17,.294,20,33,.606,107,39,92,.424,32,68,.471,7,24,.292,15,16,.938,100,2012-01-27,CHI,MIL
7,@,W 107-101 (OT),265,40,82,.488,30,66,.455,10,16,.625,17,25,.680,107,38,93,.409,31,77,.403,7,16,.438,18,22,.818,101,2012-01-27,ATL,DET
8,@,W 107-105 ,240,42,87,.483,37,65,.569,5,22,.227,18,23,.783,107,38,81,.469,35,70,.500,3,11,.273,26,36,.722,105,2012-02-01,LAC,UTA
9,Home,W 107-96 ,240,37,88,.420,25,65,.385,12,23,.522,21,25,.840,107,36,77,.468,29,56,.518,7,21,.333,17,28,.607,96,2012-02-04,SAS,OKC
10,@,W 107-81 ,240,45,83,.542,34,60,.567,11,23,.478,6,17,.353,107,30,80,.375,23,62,.371,7,18,.389,14,23,.609,81,2012-02-04,LAC,WAS
11,@,W 107-102 (OT),265,36,82,.439,23,51,.451,13,31,.419,22,25,.880,107,40,86,.465,29,56,.518,11,30,.367,11,16,.688,102,2012-02-06,LAC,ORL
12,Home,L 107-111 (OT),265,41,97,.423,36,77,.468,5,20,.250,20,26,.769,107,43,95,.453,37,73,.507,6,22,.273,19,22,.864,111,2012-02-06,POR,OKC
13,Home,W 107-91 ,240,39,84,.464,33,67,.493,6,17,.353,23,26,.885,107,32,82,.390,25,63,.397,7,19,.368,20,30,.667,91,2012-02-07,MIA,CLE
14,@,W 107-105 ,240,45,94,.479,36,69,.522,9,25,.360,8,8,1.000,107,39,81,.481,30,61,.492,9,20,.450,18,20,.900,105,2012-02-07,PHO,MIL
15,@,W 107-93 ,240,37,81,.457,30,53,.566,7,28,.250,26,33,.788,107,38,83,.458,36,66,.545,2,17,.118,15,19,.789,93,2012-02-08,NYK,WAS
16,@,W 107-87 ,240,38,83,.458,33,71,.465,5,12,.417,26,31,.839,107,35,90,.389,24,63,.381,11,27,.407,6,7,.857,87,2012-02-12,MIA,ATL
17,Home,L 107-115 ,240,41,84,.488,32,61,.525,9,23,.391,16,27,.593,107,43,96,.448,39,79,.494,4,17,.235,25,27,.926,115,2012-02-22,WAS,SAC
18,@,W 107-93 ,240,39,82,.476,33,71,.465,6,11,.545,23,29,.793,107,36,76,.474,31,60,.517,5,16,.313,16,19,.842,93,2012-03-01,MIA,POR
19,Home,W 107-94 ,240,45,87,.517,41,71,.577,4,16,.250,13,17,.765,107,34,76,.447,29,57,.509,5,19,.263,21,28,.750,94,2012-03-02,BOS,NJN
20,@,L 107-115 ,240,45,103,.437,36,78,.462,9,25,.360,8,9,.889,107,44,82,.537,38,65,.585,6,17,.353,21,26,.808,115,2012-03-02,SAC,LAL
21,@,L 107-118 ,240,44,86,.512,36,69,.522,8,17,.471,11,17,.647,107,39,82,.476,28,62,.452,11,20,.550,29,36,.806,118,2012-03-11,HOU,CLE
22,Home,W 107-94 ,240,37,79,.468,27,52,.519,10,27,.370,23,30,.767,107,39,82,.476,38,70,.543,1,12,.083,15,18,.833,94,2012-03-11,ORL,IND
23,Home,W 107-98 ,240,44,87,.506,38,65,.585,6,22,.273,13,15,.867,107,35,80,.438,33,68,.485,2,12,.167,26,38,.684,98,2012-03-13,DAL,WAS
24,Home,W 107-87 ,240,45,84,.536,39,75,.520,6,9,.667,11,17,.647,107,33,81,.407,29,69,.420,4,12,.333,17,19,.895,87,2012-03-14,HOU,CHA
25,@,W 107-101 (OT),265,37,82,.451,32,63,.508,5,19,.263,28,35,.800,107,44,85,.518,41,75,.547,3,10,.300,10,13,.769,101,2012-03-14,LAL,NOH
26,Home,W 107-103 ,240,36,71,.507,32,62,.516,4,9,.444,31,34,.912,107,38,73,.521,30,55,.545,8,18,.444,19,24,.792,103,2012-03-17,CHA,TOR
27,Home,W 107-104 ,240,39,80,.488,30,60,.500,9,20,.450,20,27,.741,107,42,83,.506,36,67,.537,6,16,.375,14,16,.875,104,2012-03-20,HOU,LAL
28,@,W 107-100 ,240,45,92,.489,39,65,.600,6,27,.222,11,13,.846,107,41,87,.471,34,68,.500,7,19,.368,11,12,.917,100,2012-03-27,SAS,PHO
29,@,L 107-110 (OT),265,40,86,.465,32,64,.500,8,22,.364,19,22,.864,107,45,87,.517,41,77,.532,4,10,.400,16,22,.727,110,2012-03-31,CHA,DET
30,Home,W 107-98 ,240,48,84,.571,46,73,.630,2,11,.182,9,17,.529,107,39,95,.411,31,69,.449,8,26,.308,12,13,.923,98,2012-04-04,MIL,CLE
31,@,W 107-105 ,240,41,91,.451,28,60,.467,13,31,.419,12,22,.545,107,40,79,.506,37,70,.529,3,9,.333,22,28,.786,105,2012-04-04,PHO,UTA
32,Home,L 107-112 ,240,36,84,.429,33,73,.452,3,11,.273,32,36,.889,107,42,88,.477,32,71,.451,10,17,.588,18,22,.818,112,2012-04-06,LAL,HOU
33,Home,L 107-115 ,240,39,87,.448,31,69,.449,8,18,.444,21,27,.778,107,43,71,.606,34,57,.596,9,14,.643,20,25,.800,115,2012-04-10,MIA,BOS
34,@,W 107-88 ,240,39,85,.459,33,68,.485,6,17,.353,23,26,.885,107,34,88,.386,32,77,.416,2,11,.182,18,21,.857,88,2012-04-10,PHI,NJN
35,@,L 107-113 ,240,42,84,.500,34,60,.567,8,24,.333,15,18,.833,107,41,82,.500,32,60,.533,9,22,.409,22,31,.710,113,2012-04-11,MIN,DEN
36,Home,L 107-111 ,240,42,85,.494,34,60,.567,8,25,.320,15,24,.625,107,41,80,.513,35,64,.547,6,16,.375,23,27,.852,111,2012-04-11,MIL,NYK
37,Home,W 107-97 ,240,37,76,.487,30,56,.536,7,20,.350,26,31,.839,107,36,85,.424,32,66,.485,4,19,.211,21,27,.778,97,2012-04-12,SAS,MEM
38,@,L 107-125 ,240,41,89,.461,33,68,.485,8,21,.381,17,23,.739,107,51,85,.600,44,70,.629,7,15,.467,16,19,.842,125,2012-04-16,POR,PHO
39,Home,L 107-118 ,240,44,95,.463,33,69,.478,11,26,.423,8,11,.727,107,48,87,.552,42,74,.568,6,13,.462,16,17,.941,118,2012-04-21,PHO,DEN
40,@,L 107-117 (OT),265,42,96,.438,27,58,.466,15,38,.395,8,13,.615,107,47,88,.534,43,80,.538,4,8,.500,19,23,.826,117,2012-04-21,ORL,UTA
41,Home,W 107-98 ,240,33,77,.429,26,49,.531,7,28,.250,34,43,.791,107,35,71,.493,32,59,.542,3,12,.250,25,34,.735,98,2012-04-22,LAC,NOH
42,Home,W 107-75 ,240,45,85,.529,40,69,.580,5,16,.313,12,17,.706,107,28,87,.322,26,74,.351,2,13,.154,17,26,.654,75,2012-04-26,CHI,CLE
43,@,W 107-101 ,240,42,96,.438,33,65,.508,9,31,.290,14,17,.824,107,45,87,.517,43,79,.544,2,8,.250,9,12,.750,101,2012-04-26,SAS,GSW
44,@,L 107-120 ,240,39,75,.520,33,62,.532,6,13,.462,23,28,.821,107,43,79,.544,35,63,.556,8,16,.500,26,32,.813,120,2012-10-30,BOS,MIA
45,Home,W 107-100 ,240,37,81,.457,31,66,.470,6,15,.400,27,37,.730,107,37,82,.451,30,64,.469,7,18,.389,19,25,.760,100,2012-11-03,BRK,TOR
46,@,W 107-96 ,240,44,88,.500,37,68,.544,7,20,.350,12,15,.800,107,35,73,.479,22,50,.440,13,23,.565,13,18,.722,96,2012-11-05,MIN,BRK
47,Home,W 107-99 ,240,43,83,.518,35,61,.574,8,22,.364,13,21,.619,107,40,83,.482,33,62,.532,7,21,.333,12,18,.667,99,2012-11-09,NOH,CHA
48,@,W 107-68 ,240,41,82,.500,32,59,.542,9,23,.391,16,25,.640,107,30,70,.429,26,59,.441,4,11,.364,4,8,.500,68,2012-11-09,BRK,ORL
49,Home,W 107-105 ,240,38,81,.469,32,64,.500,6,17,.353,25,33,.758,107,37,77,.481,28,56,.500,9,21,.429,22,27,.815,105,2012-11-09,PHO,CLE
50,@,W 107-101 (2OT),290,43,113,.381,38,89,.427,5,24,.208,16,27,.593,107,39,102,.382,30,77,.390,9,25,.360,14,23,.609,101,2012-11-10,DEN,GSW
51,Home,W 107-101 ,240,39,78,.500,36,67,.537,3,11,.273,26,33,.788,107,39,81,.481,26,54,.481,13,27,.481,10,11,.909,101,2012-11-14,DAL,WAS
52,Home,W 107-100 ,240,35,72,.486,25,51,.490,10,21,.476,27,32,.844,107,35,77,.455,26,56,.464,9,21,.429,21,29,.724,100,2012-11-14,LAC,MIA
53,@,W 107-97 ,240,44,93,.473,37,76,.487,7,17,.412,12,14,.857,107,35,72,.486,29,59,.492,6,13,.462,21,26,.808,97,2012-11-14,MEM,OKC
54,Home,W 107-89 ,240,43,76,.566,37,61,.607,6,15,.400,15,19,.789,107,30,70,.429,22,48,.458,8,22,.364,21,31,.677,89,2012-11-17,BOS,TOR
55,@,L 107-115 (OT),265,39,92,.424,33,82,.402,6,10,.600,23,27,.852,107,40,92,.435,25,65,.385,15,27,.556,20,28,.714,115,2012-11-21,NOH,IND
56,Home,W 107-105 ,240,38,101,.376,31,67,.463,7,34,.206,24,31,.774,107,38,83,.458,31,62,.500,7,21,.333,22,34,.647,105,2012-12-04,HOU,LAL
57,Home,W 107-100 ,240,38,82,.463,32,67,.478,6,15,.400,25,34,.735,107,35,86,.407,29,63,.460,6,23,.261,24,28,.857,100,2012-12-05,SAC,TOR
58,@,L 107-116 ,240,35,84,.417,23,47,.489,12,37,.324,25,29,.862,107,42,79,.532,30,54,.556,12,25,.480,20,30,.667,116,2012-12-13,LAL,NYK
59,Home,W 107-105 (2OT),290,42,93,.452,32,67,.478,10,26,.385,13,16,.813,107,40,99,.404,35,83,.422,5,16,.313,20,26,.769,105,2012-12-14,BRK,DET
60,@,W 107-98 ,240,43,79,.544,38,62,.613,5,17,.294,16,19,.842,107,36,78,.462,32,66,.485,4,12,.333,22,29,.759,98,2012-12-15,ORL,CHA
61,Home,W 107-93 ,240,38,85,.447,34,71,.479,4,14,.286,27,30,.900,107,36,79,.456,30,59,.508,6,20,.300,15,21,.714,93,2012-12-17,OKC,SAS
62,Home,W 107-100 ,240,39,72,.542,35,61,.574,4,11,.364,25,29,.862,107,37,86,.430,24,51,.471,13,35,.371,13,15,.867,100,2012-12-18,DAL,PHI
63,@,L 107-111 ,240,45,97,.464,43,80,.538,2,17,.118,15,24,.625,107,45,89,.506,40,71,.563,5,18,.278,16,26,.615,111,2012-12-29,PHO,MIN
64,Home,W 107-96 ,240,39,78,.500,31,60,.517,8,18,.444,21,29,.724,107,33,80,.413,28,67,.418,5,13,.385,25,34,.735,96,2012-12-30,LAC,UTA
65,Home,W 107-102 ,240,41,82,.500,35,68,.515,6,14,.429,19,25,.760,107,35,76,.461,29,51,.569,6,25,.240,26,36,.722,102,2013-01-04,LAC,LAL
66,Home,W 107-100 ,240,43,87,.494,37,69,.536,6,18,.333,15,19,.789,107,37,84,.440,29,52,.558,8,32,.250,18,22,.818,100,2013-01-12,PHI,HOU
67,@,W 107-96 ,240,40,77,.519,32,58,.552,8,19,.421,19,23,.826,107,36,85,.424,33,72,.458,3,13,.231,21,27,.778,96,2013-01-13,MIL,TOR
68,@,W 107-105 (OT),265,39,86,.453,36,75,.480,3,11,.273,26,36,.722,107,38,85,.447,32,69,.464,6,16,.375,23,32,.719,105,2013-01-16,CHI,TOR
69,Home,L 107-113 ,240,42,91,.462,36,73,.493,6,18,.333,17,18,.944,107,43,89,.483,34,66,.515,9,23,.391,18,24,.750,113,2013-01-25,DAL,SAS
70,Home,W 107-98 ,240,42,90,.467,33,66,.500,9,24,.375,14,20,.700,107,41,94,.436,36,75,.480,5,19,.263,11,22,.500,98,2013-02-02,MIL,ORL
71,Home,W 107-97 ,240,44,80,.550,38,64,.594,6,16,.375,13,14,.929,107,35,70,.500,28,58,.483,7,12,.583,20,26,.769,97,2013-02-10,MIA,LAL
72,@,W 107-90 ,240,44,75,.587,36,56,.643,8,19,.421,11,22,.500,107,35,84,.417,26,66,.394,9,18,.500,11,16,.688,90,2013-02-11,LAC,PHI
73,Home,L 107-116 ,240,38,84,.452,30,64,.469,8,20,.400,23,31,.742,107,43,91,.473,33,57,.579,10,34,.294,20,25,.800,116,2013-02-12,GSW,HOU
74,Home,W 107-101 (OT),265,39,94,.415,34,73,.466,5,21,.238,24,30,.800,107,37,95,.389,33,73,.452,4,22,.182,23,32,.719,101,2013-02-22,GSW,SAS
75,@,L 107-111 ,240,46,94,.489,38,74,.514,8,20,.400,7,12,.583,107,40,85,.471,34,67,.507,6,18,.333,25,34,.735,111,2013-02-22,POR,LAL
76,Home,W 107-94 ,240,40,78,.513,32,58,.552,8,20,.400,19,24,.792,107,35,84,.417,34,69,.493,1,15,.067,23,28,.821,94,2013-02-23,LAC,UTA
77,Home,L 107-110 (OT),265,39,88,.443,31,71,.437,8,17,.471,21,24,.875,107,41,86,.477,31,59,.525,10,27,.370,18,20,.900,110,2013-02-25,UTA,BOS
78,Home,L 107-110 ,240,42,89,.472,35,66,.530,7,23,.304,16,25,.640,107,43,89,.483,34,65,.523,9,24,.375,15,20,.750,110,2013-02-27,HOU,MIL
79,Home,W 107-96 ,240,43,80,.538,32,56,.571,11,24,.458,10,17,.588,107,37,86,.430,31,69,.449,6,17,.353,16,21,.762,96,2013-03-06,ATL,PHI
80,Home,W 107-92 ,240,43,77,.558,32,54,.593,11,23,.478,10,12,.833,107,36,85,.424,29,63,.460,7,22,.318,13,16,.813,92,2013-03-07,DEN,LAC
81,Home,W 107-102 (OT),265,40,78,.513,30,58,.517,10,20,.500,17,20,.850,107,40,88,.455,31,61,.508,9,27,.333,13,17,.765,102,2013-03-08,BOS,ATL
82,Home,W 107-105 ,240,37,82,.451,29,64,.453,8,18,.444,25,39,.641,107,37,86,.430,18,45,.400,19,41,.463,12,18,.667,105,2013-03-09,PHO,HOU
83,Home,W 107-83 ,240,44,82,.537,32,62,.516,12,20,.600,7,18,.389,107,29,82,.354,20,53,.377,9,29,.310,16,18,.889,83,2013-03-12,MIN,SAS
84,Home,W 107-91 ,240,41,82,.500,32,57,.561,9,25,.360,16,26,.615,107,35,80,.438,29,61,.475,6,19,.316,15,18,.833,91,2013-03-13,IND,MIN
85,Home,W 107-94 ,240,41,84,.488,29,61,.475,12,23,.522,13,16,.813,107,35,79,.443,32,60,.533,3,19,.158,21,31,.677,94,2013-03-15,ATL,PHO
86,@,W 107-94 ,240,41,79,.519,34,64,.531,7,15,.467,18,22,.818,107,33,89,.371,24,64,.375,9,25,.360,19,21,.905,94,2013-03-15,MIA,MIL
87,@,W 107-101 ,240,39,80,.488,34,59,.576,5,21,.238,24,30,.800,107,38,83,.458,29,62,.468,9,21,.429,16,16,1.000,101,2013-03-17,OKC,DAL
88,Home,W 107-101 ,240,35,75,.467,27,59,.458,8,16,.500,29,40,.725,107,35,83,.422,30,61,.492,5,22,.227,26,26,1.000,101,2013-03-20,CHA,TOR
89,Home,W 107-91 ,240,41,84,.488,34,70,.486,7,14,.500,18,21,.857,107,32,83,.386,28,69,.406,4,14,.286,23,28,.821,91,2013-03-25,UTA,PHI
90,Home,W 107-94 ,240,36,72,.500,31,59,.525,5,13,.385,30,44,.682,107,34,77,.442,28,61,.459,6,16,.375,20,22,.909,94,2013-03-25,WAS,MEM
91,@,W 107-88 ,240,40,81,.494,30,60,.500,10,21,.476,17,20,.850,107,35,78,.449,31,61,.508,4,17,.235,14,20,.700,88,2013-03-27,ATL,TOR
92,@,L 107-118 ,240,40,88,.455,32,68,.471,8,20,.400,19,24,.792,107,45,83,.542,34,60,.567,11,23,.478,17,21,.810,118,2013-03-29,ATL,BOS
93,@,L 107-116 ,240,42,81,.519,34,58,.586,8,23,.348,15,19,.789,107,45,81,.556,35,64,.547,10,17,.588,16,24,.667,116,2013-03-30,BRK,UTA
94,@,W 107-98 ,240,44,84,.524,36,71,.507,8,13,.615,11,16,.688,107,42,96,.438,34,73,.466,8,23,.348,6,9,.667,98,2013-04-03,MIN,MIL
95,Home,L 107-111 ,240,44,72,.611,39,58,.672,5,14,.357,14,17,.824,107,44,86,.512,35,70,.500,9,16,.563,14,16,.875,111,2013-04-05,PHO,GSW
96,Home,W 107-101 ,240,36,83,.434,30,69,.435,6,14,.429,29,38,.763,107,40,75,.533,34,60,.567,6,15,.400,15,21,.714,101,2013-04-06,MIN,DET
97,Home,W 107-96 ,240,43,77,.558,39,66,.591,4,11,.364,17,21,.810,107,39,88,.443,29,62,.468,10,26,.385,8,12,.667,96,2013-04-07,BOS,WAS
98,Home,W 107-100 ,240,42,72,.583,34,59,.576,8,13,.615,15,17,.882,107,36,78,.462,28,56,.500,8,22,.364,20,21,.952,100,2013-04-12,UTA,MIN
99,@,W 107-89 ,240,45,86,.523,36,65,.554,9,21,.429,8,8,1.000,107,33,87,.379,24,65,.369,9,22,.409,14,18,.778,89,2013-04-14,DAL,NOH
0,Home,W 107-95 ,240,37,72,.514,26,52,.500,11,20,.550,22,29,.759,107,35,83,.422,28,57,.491,7,26,.269,18,23,.783,95,2013-10-29,MIA,CHI
1,Home,W 107-104 ,240,42,86,.488,31,64,.484,11,22,.500,12,18,.667,107,42,93,.452,39,79,.494,3,14,.214,17,19,.895,104,2013-11-02,PHI,CHI
2,Home,W 107-86 ,240,42,89,.472,35,72,.486,7,17,.412,16,22,.727,107,34,89,.382,30,72,.417,4,17,.235,14,15,.933,86,2013-11-03,ORL,BRK
3,Home,W 107-93 ,240,43,79,.544,38,66,.576,5,13,.385,16,23,.696,107,36,85,.424,27,62,.435,9,23,.391,12,14,.857,93,2013-11-06,OKC,DAL
4,@,L 107-109 ,240,43,94,.457,35,68,.515,8,26,.308,13,19,.684,107,42,86,.488,28,61,.459,14,25,.560,11,17,.647,109,2013-11-07,ATL,DEN
5,@,W 107-94 ,240,42,88,.477,33,64,.516,9,24,.375,14,23,.609,107,35,78,.449,28,52,.538,7,26,.269,17,27,.630,94,2013-11-09,LAC,HOU
6,@,L 107-109 ,240,40,96,.417,29,67,.433,11,29,.379,16,18,.889,107,44,80,.550,40,64,.625,4,16,.250,17,28,.607,109,2013-11-11,MIN,LAC
7,Home,W 107-86 ,240,41,94,.436,33,70,.471,8,24,.333,17,23,.739,107,31,82,.378,28,69,.406,3,13,.231,21,27,.778,86,2013-11-13,SAC,BRK
8,Home,W 107-104 ,240,39,83,.470,31,61,.508,8,22,.364,21,28,.750,107,37,79,.468,27,50,.540,10,29,.345,20,28,.714,104,2013-11-19,SAC,PHO
9,@,L 107-115 (OT),265,41,93,.441,33,64,.516,8,29,.276,17,24,.708,107,45,79,.570,38,59,.644,7,20,.350,18,29,.621,115,2013-11-22,MIL,PHI
10,Home,W 107-92 ,240,39,79,.494,32,57,.561,7,22,.318,22,24,.917,107,33,83,.398,25,51,.490,8,32,.250,18,24,.750,92,2013-11-25,MIA,PHO
11,@,W 107-97 ,240,41,80,.513,34,64,.531,7,16,.438,18,26,.692,107,36,82,.439,27,54,.500,9,28,.321,16,23,.696,97,2013-12-03,DET,MIA
12,Home,W 107-97 ,240,42,82,.512,30,59,.508,12,23,.522,11,16,.688,107,39,83,.470,35,64,.547,4,19,.211,15,20,.750,97,2013-12-04,ATL,LAC
13,Home,W 107-87 ,240,37,74,.500,27,55,.491,10,19,.526,23,32,.719,107,32,77,.416,26,55,.473,6,22,.273,17,24,.708,87,2013-12-05,CHI,MIA
14,@,L 107-116 ,240,38,87,.437,32,68,.471,6,19,.316,25,29,.862,107,41,83,.494,29,59,.492,12,24,.500,22,29,.759,116,2013-12-13,SAC,PHO
15,@,L 107-114 ,240,39,84,.464,29,55,.527,10,29,.345,19,25,.760,107,42,76,.553,34,55,.618,8,21,.381,22,30,.733,114,2013-12-14,CLE,MIA
16,@,L 107-124 ,240,40,84,.476,34,69,.493,6,15,.400,21,25,.840,107,47,81,.580,32,56,.571,15,25,.600,15,18,.833,124,2013-12-18,SAC,ATL
17,@,W 107-106 ,240,41,88,.466,31,61,.508,10,27,.370,15,20,.750,107,40,81,.494,34,63,.540,6,18,.333,20,22,.909,106,2013-12-18,DET,BOS
18,Home,L 107-113 ,240,39,74,.527,30,53,.566,9,21,.429,20,24,.833,107,38,88,.432,26,68,.382,12,20,.600,25,30,.833,113,2013-12-18,BRK,WAS
19,@,W 107-101 (2OT),290,38,101,.376,21,60,.350,17,41,.415,14,19,.737,107,34,82,.415,26,60,.433,8,22,.364,25,35,.714,101,2013-12-18,NYK,MIL
20,Home,W 107-95 ,240,43,84,.512,34,69,.493,9,15,.600,12,14,.857,107,29,77,.377,21,48,.438,8,29,.276,29,39,.744,95,2013-12-19,OKC,CHI
21,@,L 107-110 ,240,44,94,.468,38,77,.494,6,17,.353,13,19,.684,107,43,98,.439,35,69,.507,8,29,.276,16,18,.889,110,2013-12-21,NOP,POR
22,Home,L 107-116 ,240,39,85,.459,34,68,.500,5,17,.294,24,31,.774,107,37,75,.493,30,59,.508,7,16,.438,35,42,.833,116,2013-12-26,DAL,SAS
23,Home,W 107-98 ,240,38,77,.494,32,51,.627,6,26,.231,25,32,.781,107,41,93,.441,31,71,.437,10,22,.455,6,8,.750,98,2013-12-28,HOU,NOP
24,Home,L 107-108 ,240,39,77,.506,28,51,.549,11,26,.423,18,21,.857,107,45,88,.511,37,74,.500,8,14,.571,10,11,.909,108,2013-12-28,POR,MIA
25,@,W 107-88 ,240,41,85,.482,29,54,.537,12,31,.387,13,22,.591,107,31,85,.365,24,65,.369,7,20,.350,19,26,.731,88,2013-12-30,PHO,LAC
26,Home,W 107-88 ,240,40,78,.513,31,51,.608,9,27,.333,18,23,.783,107,36,77,.468,33,68,.485,3,9,.333,13,17,.765,88,2014-01-07,MIA,NOP
27,@,W 107-90 ,240,41,78,.526,27,50,.540,14,28,.500,11,16,.688,107,36,80,.450,33,73,.452,3,7,.429,15,19,.789,90,2014-01-10,DAL,NOP
28,@,L 107-110 ,240,37,77,.481,29,58,.500,8,19,.421,25,31,.806,107,30,67,.448,19,40,.475,11,27,.407,39,45,.867,110,2014-01-11,NOP,DAL
29,Home,L 107-114 ,240,40,95,.421,35,76,.461,5,19,.263,22,31,.710,107,38,73,.521,30,55,.545,8,18,.444,30,42,.714,114,2014-01-11,WAS,HOU
30,Home,W 107-88 ,240,40,79,.506,27,52,.519,13,27,.481,14,15,.933,107,34,76,.447,27,52,.519,7,24,.292,13,16,.813,88,2014-01-13,DAL,ORL
31,@,W 107-104 ,240,37,74,.500,25,54,.463,12,20,.600,21,28,.750,107,44,99,.444,37,76,.487,7,23,.304,9,11,.818,104,2014-01-17,LAL,BOS
32,Home,L 107-110 ,240,42,93,.452,35,71,.493,7,22,.318,16,21,.762,107,44,83,.530,35,59,.593,9,24,.375,13,19,.684,110,2014-01-17,PHO,DAL
33,Home,W 107-99 ,240,37,84,.440,32,66,.485,5,18,.278,28,35,.800,107,37,88,.420,33,70,.471,4,18,.222,21,31,.677,99,2014-01-20,WAS,PHI
34,Home,W 107-106 ,240,37,73,.507,27,46,.587,10,27,.370,23,28,.821,107,34,78,.436,24,58,.414,10,20,.500,28,33,.848,106,2014-01-24,BRK,DAL
35,Home,W 107-103 ,240,38,80,.475,36,61,.590,2,19,.105,29,36,.806,107,38,75,.507,31,54,.574,7,21,.333,20,23,.870,103,2014-01-31,DAL,SAC
36,@,L 107-124 ,240,37,80,.463,29,56,.518,8,24,.333,25,33,.758,107,44,80,.550,32,54,.593,12,26,.462,24,26,.923,124,2014-02-03,CLE,DAL
37,@,W 107-89 ,240,39,82,.476,28,55,.509,11,27,.407,18,20,.900,107,31,87,.356,25,62,.403,6,25,.240,21,21,1.000,89,2014-02-10,HOU,MIN
38,@,W 107-103 ,240,39,88,.443,31,60,.517,8,28,.286,21,24,.875,107,40,83,.482,30,55,.545,10,28,.357,13,22,.591,103,2014-02-13,OKC,LAL
39,Home,L 107-112 (OT),265,38,99,.384,33,71,.465,5,28,.179,26,37,.703,107,35,93,.376,24,64,.375,11,29,.379,31,39,.795,112,2014-02-18,DEN,PHO
40,@,L 107-115 ,240,40,88,.455,27,57,.474,13,31,.419,14,20,.700,107,47,87,.540,39,67,.582,8,20,.400,13,29,.448,115,2014-02-21,ATL,DET
41,Home,W 107-98 ,240,32,74,.432,16,43,.372,16,31,.516,27,33,.818,107,39,89,.438,29,61,.475,10,28,.357,10,16,.625,98,2014-02-22,ATL,NYK
42,@,W 107-103 ,240,37,88,.420,29,64,.453,8,24,.333,25,29,.862,107,38,84,.452,24,51,.471,14,33,.424,13,16,.813,103,2014-02-25,CHI,ATL
43,@,L 107-113 ,240,41,80,.513,31,64,.484,10,16,.625,15,20,.750,107,38,77,.494,28,55,.509,10,22,.455,27,32,.844,113,2014-02-28,MEM,OKC
44,@,W 107-98 ,240,37,83,.446,27,58,.466,10,25,.400,23,31,.742,107,34,74,.459,29,62,.468,5,12,.417,25,31,.806,98,2014-03-01,BRK,MIL
45,@,L 107-124 ,240,42,82,.512,33,59,.559,9,23,.391,14,21,.667,107,46,83,.554,30,55,.545,16,28,.571,16,20,.800,124,2014-03-03,CHA,MIA
46,@,W 107-106 ,240,43,94,.457,35,76,.461,8,18,.444,13,15,.867,107,43,96,.448,34,67,.507,9,29,.310,11,19,.579,106,2014-03-03,LAL,POR
47,@,W 107-97 ,240,38,88,.432,24,57,.421,14,31,.452,17,23,.739,107,36,87,.414,27,64,.422,9,23,.391,16,18,.889,97,2014-03-08,NYK,CLE
48,Home,L 107-114 ,240,39,87,.448,35,71,.493,4,16,.250,25,28,.893,107,43,80,.538,28,52,.538,15,28,.536,13,23,.565,114,2014-03-08,MIL,WAS
49,@,L 107-113 ,240,36,75,.480,26,54,.481,10,21,.476,25,28,.893,107,45,85,.529,35,63,.556,10,22,.455,13,21,.619,113,2014-03-09,PHO,GSW
50,@,L 107-111 (OT),265,40,85,.471,33,62,.532,7,23,.304,20,26,.769,107,41,90,.456,36,76,.474,5,14,.357,24,33,.727,111,2014-03-09,DEN,NOP
51,Home,L 107-111 ,240,42,81,.519,35,57,.614,7,24,.292,16,21,.762,107,39,82,.476,31,61,.508,8,21,.381,25,29,.862,111,2014-03-14,MIA,DEN
52,@,W 107-100 ,240,36,86,.419,27,64,.422,9,22,.409,26,32,.813,107,36,67,.537,32,54,.593,4,13,.308,24,32,.750,100,2014-03-19,TOR,NOP
53,Home,L 107-117 ,240,43,91,.473,36,72,.500,7,19,.368,14,23,.609,107,42,87,.483,32,62,.516,10,25,.400,23,29,.793,117,2014-03-21,LAL,WAS
54,@,W 107-104 (OT),265,34,84,.405,23,54,.426,11,30,.367,28,33,.848,107,35,91,.385,25,60,.417,10,31,.323,24,31,.774,104,2014-03-23,BRK,DAL
55,@,L 107-124 ,240,42,85,.494,38,67,.567,4,18,.222,19,30,.633,107,44,86,.512,37,66,.561,7,20,.350,29,36,.806,124,2014-03-23,MIL,SAC
56,Home,W 107-83 ,240,43,86,.500,34,64,.531,9,22,.409,12,16,.750,107,31,82,.378,24,54,.444,7,28,.250,14,16,.875,83,2014-03-26,MIN,ATL
57,@,W 107-99 ,240,40,73,.548,25,47,.532,15,26,.577,12,13,.923,107,33,69,.478,27,52,.519,6,17,.353,27,35,.771,99,2014-03-26,NYK,SAC
58,@,L 107-143 ,240,44,102,.431,37,77,.481,7,25,.280,12,15,.800,107,51,76,.671,43,58,.741,8,18,.444,33,40,.825,143,2014-03-28,LAL,MIN
59,Home,L 107-118 ,240,32,79,.405,25,54,.463,7,25,.280,36,45,.800,107,42,89,.472,30,48,.625,12,41,.293,22,36,.611,118,2014-03-29,HOU,LAC
60,@,W 107-102 ,240,37,70,.529,29,54,.537,8,16,.500,25,31,.806,107,40,87,.460,30,58,.517,10,29,.345,12,16,.750,102,2014-03-30,CHI,BOS
61,@,L 107-137 ,240,35,74,.473,33,65,.508,2,9,.222,35,45,.778,107,52,92,.565,37,65,.569,15,27,.556,18,25,.720,137,2014-04-02,NOP,DEN
62,Home,W 107-102 ,240,42,86,.488,37,71,.521,5,15,.333,18,27,.667,107,37,96,.385,25,68,.368,12,28,.429,16,20,.800,102,2014-04-02,SAC,LAL
63,Home,W 107-103 ,240,34,75,.453,24,50,.480,10,25,.400,29,39,.744,107,36,87,.414,27,61,.443,9,26,.346,22,30,.733,103,2014-04-02,TOR,HOU
64,Home,L 107-113 ,240,39,91,.429,33,64,.516,6,27,.222,23,29,.793,107,41,82,.500,27,53,.509,14,29,.483,17,20,.850,113,2014-04-03,LAC,DAL
65,@,L 107-111 ,240,38,85,.447,25,54,.463,13,31,.419,18,20,.900,107,33,78,.423,20,47,.426,13,31,.419,32,37,.865,111,2014-04-04,OKC,HOU
66,@,W 107-95 ,240,44,92,.478,39,71,.549,5,21,.238,14,15,.933,107,35,83,.422,28,55,.509,7,28,.250,18,24,.750,95,2014-04-04,DAL,LAL
67,@,W 107-88 ,240,41,73,.562,29,46,.630,12,27,.444,13,17,.765,107,32,78,.410,27,58,.466,5,20,.250,19,30,.633,88,2014-04-06,ATL,IND
68,@,W 107-92 ,240,38,80,.475,26,58,.448,12,22,.545,19,27,.704,107,34,82,.415,31,68,.456,3,14,.214,21,28,.750,92,2014-04-08,OKC,SAC
69,@,W 107-101 ,240,38,90,.422,33,69,.478,5,21,.238,26,32,.813,107,36,86,.419,28,59,.475,8,27,.296,21,34,.618,101,2014-04-09,OKC,LAC
70,Home,W 107-102 ,240,43,78,.551,36,58,.621,7,20,.350,14,21,.667,107,38,73,.521,23,48,.479,15,25,.600,11,12,.917,102,2014-04-09,MEM,MIA
71,Home,L 107-116 ,240,35,84,.417,30,64,.469,5,20,.250,32,48,.667,107,39,81,.481,30,58,.517,9,23,.391,29,35,.829,116,2014-04-13,DET,TOR
72,Home,W 107-95 ,240,39,81,.481,30,53,.566,9,28,.321,20,23,.870,107,36,75,.480,30,56,.536,6,19,.316,17,24,.708,95,2014-10-29,MIA,WAS
73,Home,W 107-102 ,240,35,70,.500,26,46,.565,9,24,.375,28,38,.737,107,37,79,.468,33,63,.524,4,16,.250,24,39,.615,102,2014-11-02,MIA,TOR
74,Home,W 107-101 ,240,41,81,.506,31,58,.534,10,23,.435,15,17,.882,107,36,77,.468,26,50,.520,10,27,.370,19,24,.792,101,2014-11-03,LAC,UTA
75,Home,L 107-110 ,240,40,78,.513,30,52,.577,10,26,.385,17,18,.944,107,42,87,.483,35,71,.493,7,16,.438,19,23,.826,110,2014-11-05,BOS,TOR
76,Home,W 107-92 ,240,42,82,.512,36,65,.554,6,17,.353,17,22,.773,107,35,79,.443,32,65,.492,3,14,.214,19,27,.704,92,2014-11-09,LAL,CHO
77,Home,W 107-95 ,240,34,79,.430,22,49,.449,12,30,.400,27,33,.818,107,33,69,.478,22,45,.489,11,24,.458,18,21,.857,95,2014-11-09,PHO,GSW
78,Home,W 107-102 ,240,41,78,.526,37,67,.552,4,11,.364,21,26,.808,107,41,87,.471,34,65,.523,7,22,.318,13,17,.765,102,2014-11-11,MEM,LAL
79,Home,W 107-103 ,240,40,83,.482,37,72,.514,3,11,.273,24,33,.727,107,38,81,.469,29,59,.492,9,22,.409,18,22,.818,103,2014-11-12,WAS,DET
80,Home,W 107-99 ,240,41,90,.456,30,56,.536,11,34,.324,14,21,.667,107,39,89,.438,36,73,.493,3,16,.188,18,20,.900,99,2014-11-13,GSW,BRK
81,@,L 107-120 ,240,38,99,.384,27,69,.391,11,30,.367,20,23,.870,107,36,68,.529,22,39,.564,14,29,.483,34,43,.791,120,2014-11-15,PHO,LAC
82,@,W 107-80 ,240,43,84,.512,33,56,.589,10,28,.357,11,16,.688,107,32,80,.400,22,58,.379,10,22,.455,6,13,.462,80,2014-11-17,DAL,CHO
83,@,W 107-93 ,240,41,79,.519,28,53,.528,13,26,.500,12,15,.800,107,32,80,.400,21,56,.375,11,24,.458,18,24,.750,93,2014-11-17,ORL,DET
84,Home,W 107-100 ,240,40,82,.488,30,53,.566,10,29,.345,17,22,.773,107,36,79,.456,26,56,.464,10,23,.435,18,25,.720,100,2014-11-19,DEN,OKC
85,Home,W 107-91 ,240,42,85,.494,35,64,.547,7,21,.333,16,23,.696,107,32,77,.416,25,52,.481,7,25,.280,20,28,.714,91,2014-11-23,MEM,LAC
86,Home,W 107-93 ,240,39,86,.453,27,53,.509,12,33,.364,17,25,.680,107,39,90,.433,37,81,.457,2,9,.222,13,20,.650,93,2014-11-30,POR,MIN
87,Home,W 107-86 ,240,39,72,.542,29,53,.547,10,19,.526,19,24,.792,107,33,72,.458,31,50,.620,2,22,.091,18,30,.600,86,2014-12-01,WAS,MIA
88,@,W 107-105 ,240,42,92,.457,34,65,.523,8,27,.296,15,22,.682,107,38,73,.521,31,62,.500,7,11,.636,22,32,.688,105,2014-12-03,DAL,MIL
89,@,W 107-101 ,240,40,84,.476,26,59,.441,14,25,.560,13,16,.813,107,37,80,.463,32,68,.471,5,12,.417,22,26,.846,101,2014-12-05,SAS,MEM
90,@,L 107-112 (OT),265,43,104,.413,33,74,.446,10,30,.333,11,15,.733,107,41,81,.506,32,48,.667,9,33,.273,21,29,.724,112,2014-12-08,DEN,TOR
91,@,L 107-112 ,240,40,88,.455,33,70,.471,7,18,.389,20,24,.833,107,44,83,.530,35,62,.565,9,21,.429,15,17,.882,112,2014-12-10,NOP,DAL
92,@,L 107-113 (2OT),290,41,98,.418,35,81,.432,6,17,.353,19,27,.704,107,39,85,.459,33,72,.458,6,13,.462,29,38,.763,113,2014-12-12,CHO,MEM
93,@,W 107-87 ,240,42,83,.506,27,50,.540,15,33,.455,8,8,1.000,107,37,84,.440,32,63,.508,5,21,.238,8,10,.800,87,2014-12-16,DAL,NYK
94,Home,L 107-108 ,240,38,67,.567,32,53,.604,6,14,.429,25,33,.758,107,37,75,.493,24,52,.462,13,23,.565,21,27,.778,108,2014-12-18,SAC,MIL
95,Home,W 107-104 ,240,34,76,.447,22,53,.415,12,23,.522,27,35,.771,107,37,92,.402,26,63,.413,11,29,.379,19,28,.679,104,2014-12-23,ATL,LAC
96,@,W 107-77 ,240,40,79,.506,32,60,.533,8,19,.421,19,23,.826,107,31,76,.408,27,53,.509,4,23,.174,11,14,.786,77,2014-12-26,MIL,ATL
97,Home,L 107-109 ,240,45,87,.517,36,63,.571,9,24,.375,8,11,.727,107,41,83,.494,34,62,.548,7,21,.333,20,28,.714,109,2014-12-26,BOS,BRK
98,Home,W 107-100 ,240,41,89,.461,35,69,.507,6,20,.300,19,22,.864,107,41,88,.466,37,74,.500,4,14,.286,14,16,.875,100,2014-12-27,CHI,NOP
99,@,L 107-112 ,240,45,90,.500,40,76,.526,5,14,.357,12,21,.571,107,39,88,.443,29,57,.509,10,31,.323,24,28,.857,112,2014-12-28,OKC,DAL
0,Home,L 107-116 ,240,42,81,.519,30,61,.492,12,20,.600,11,20,.550,107,44,87,.506,35,65,.538,9,22,.409,19,24,.792,116,2014-12-28,LAL,PHO
1,Home,W 107-99 ,240,36,80,.450,28,59,.475,8,21,.381,27,39,.692,107,37,76,.487,28,56,.500,9,20,.450,16,20,.800,99,2014-12-29,BRK,SAC
2,Home,L 107-110 ,240,42,91,.462,35,67,.522,7,24,.292,16,22,.727,107,40,74,.541,35,62,.565,5,12,.417,25,29,.862,110,2015-01-01,MIN,SAC
3,Home,L 107-115 ,240,42,93,.452,29,60,.483,13,33,.394,10,12,.833,107,43,84,.512,37,67,.552,6,17,.353,23,31,.742,115,2015-01-03,POR,ATL
4,@,W 107-98 ,240,36,81,.444,23,54,.426,13,27,.481,22,33,.667,107,33,74,.446,26,49,.531,7,25,.280,25,33,.758,98,2015-01-05,ATL,LAC
5,Home,W 107-103 (OT),265,34,92,.370,25,69,.362,9,23,.391,30,34,.882,107,41,103,.398,31,69,.449,10,34,.294,11,16,.688,103,2015-01-09,IND,BOS
6,Home,W 107-100 ,240,40,76,.526,33,56,.589,7,20,.350,20,27,.741,107,36,82,.439,23,47,.489,13,35,.371,15,20,.750,100,2015-01-13,PHO,CLE
7,@,L 107-114 ,240,41,100,.410,32,63,.508,9,37,.243,16,20,.800,107,41,82,.500,37,63,.587,4,19,.211,28,35,.800,114,2015-01-14,DAL,DEN
8,@,W 107-99 ,240,40,84,.476,29,58,.500,11,26,.423,16,21,.762,107,37,80,.463,28,54,.519,9,26,.346,16,20,.800,99,2015-01-17,ATL,CHI
9,Home,W 107-89 ,240,38,88,.432,23,53,.434,15,35,.429,16,19,.842,107,38,82,.463,31,54,.574,7,28,.250,6,7,.857,89,2015-01-17,DET,PHI
10,Home,W 107-96 ,240,39,86,.453,29,59,.492,10,27,.370,19,25,.760,107,35,79,.443,24,54,.444,11,25,.440,15,31,.484,96,2015-02-06,BOS,PHI
11,@,L 107-123 ,240,38,78,.487,32,55,.582,6,23,.261,25,31,.806,107,40,75,.533,27,45,.600,13,30,.433,30,37,.811,123,2015-02-06,LAC,TOR
12,@,W 107-72 ,240,43,84,.512,33,62,.532,10,22,.455,11,13,.846,107,32,86,.372,28,69,.406,4,17,.235,4,7,.571,72,2015-02-07,CHI,NOP
13,@,L 107-112 ,240,47,88,.534,37,63,.587,10,25,.400,3,8,.375,107,43,89,.483,31,65,.477,12,24,.500,14,16,.875,112,2015-02-21,PHO,CHI
14,Home,L 107-114 ,240,42,79,.532,37,61,.607,5,18,.278,18,21,.857,107,45,90,.500,33,67,.493,12,23,.522,12,17,.706,114,2015-02-24,WAS,GSW
15,@,W 107-96 ,240,35,88,.398,27,65,.415,8,23,.348,29,32,.906,107,38,79,.481,37,75,.493,1,4,.250,19,23,.826,96,2015-02-27,SAS,SAC
16,@,L 107-117 ,240,43,97,.443,35,71,.493,8,26,.308,13,18,.722,107,41,85,.482,30,67,.448,11,18,.611,24,30,.800,117,2015-03-10,TOR,SAS
17,Home,W 107-87 ,240,40,80,.500,35,63,.556,5,17,.294,22,31,.710,107,31,80,.388,28,61,.459,3,19,.158,22,30,.733,87,2015-03-12,WAS,MEM
18,@,L 107-114 ,240,35,87,.402,31,73,.425,4,14,.286,33,40,.825,107,45,95,.474,36,63,.571,9,32,.281,15,23,.652,114,2015-03-13,SAC,PHI
19,Home,W 107-94 ,240,39,78,.500,28,51,.549,11,27,.407,18,27,.667,107,38,89,.427,32,67,.478,6,22,.273,12,17,.706,94,2015-03-17,HOU,ORL
20,Home,W 107-102 ,240,39,80,.488,26,49,.531,13,31,.419,16,24,.667,107,40,87,.460,31,59,.525,9,28,.321,13,14,.929,102,2015-03-18,DAL,ORL
21,Home,W 107-91 ,240,44,90,.489,33,64,.516,11,26,.423,8,10,.800,107,33,77,.429,27,56,.482,6,21,.286,19,24,.792,91,2015-03-21,DET,CHI
22,Home,W 107-100 ,240,42,91,.462,35,68,.515,7,23,.304,16,23,.696,107,38,75,.507,26,53,.491,12,22,.545,12,16,.750,100,2015-03-22,LAC,NOP
23,Home,W 107-76 ,240,39,95,.411,26,62,.419,13,33,.394,16,21,.762,107,27,81,.333,24,70,.343,3,11,.273,19,26,.731,76,2015-03-23,GSW,WAS
24,Home,W 107-106 ,240,35,97,.361,28,77,.364,7,20,.350,30,38,.789,107,40,81,.494,27,53,.509,13,28,.464,13,21,.619,106,2015-03-24,SAC,PHI
25,@,L 107-111 ,240,30,71,.423,16,41,.390,14,30,.467,33,43,.767,107,39,73,.534,30,54,.556,9,19,.474,24,34,.706,111,2015-03-26,IND,MIL
26,Home,W 107-91 ,240,39,76,.513,26,52,.500,13,24,.542,16,23,.696,107,32,81,.395,27,54,.500,5,27,.185,22,31,.710,91,2015-03-27,DEN,UTA
27,@,W 107-84 ,240,39,90,.433,23,59,.390,16,31,.516,13,17,.765,107,34,76,.447,29,63,.460,5,13,.385,11,15,.733,84,2015-03-27,GSW,MEM
28,@,L 107-110 (2OT),290,36,104,.346,28,79,.354,8,25,.320,27,35,.771,107,44,113,.389,35,88,.398,9,25,.360,13,22,.591,110,2015-03-27,CHO,WAS
29,Home,W 107-99 ,240,42,87,.483,34,59,.576,8,28,.286,15,21,.714,107,42,91,.462,36,73,.493,6,18,.333,9,11,.818,99,2015-03-29,BRK,LAL
30,Home,W 107-106 ,240,43,93,.462,33,67,.493,10,26,.385,11,17,.647,107,42,90,.467,37,71,.521,5,19,.263,17,26,.654,106,2015-04-02,GSW,PHO
31,@,W 107-77 ,240,43,88,.489,33,62,.532,10,26,.385,11,11,1.000,107,31,82,.378,26,68,.382,5,14,.357,10,17,.588,77,2015-04-03,POR,LAL
32,@,W 107-92 ,240,34,79,.430,21,45,.467,13,34,.382,26,42,.619,107,32,85,.376,26,63,.413,6,22,.273,22,31,.710,92,2015-04-04,LAC,DEN
33,Home,W 107-92 ,240,44,83,.530,37,62,.597,7,21,.333,12,15,.800,107,39,91,.429,30,63,.476,9,28,.321,5,10,.500,92,2015-04-05,SAS,GSW
34,Home,W 107-104 ,240,45,94,.479,41,76,.539,4,18,.222,13,16,.813,107,40,82,.488,32,57,.561,8,25,.320,16,19,.842,104,2015-04-08,DAL,PHO
35,@,W 107-103 ,240,38,79,.481,27,60,.450,11,19,.579,20,22,.909,107,40,89,.449,29,66,.439,11,23,.478,12,23,.522,103,2015-04-10,IND,DET
36,@,L 107-114 ,240,37,89,.416,24,48,.500,13,41,.317,20,25,.800,107,40,90,.444,31,64,.484,9,26,.346,25,36,.694,114,2015-04-11,PHI,CHI
37,@,W 107-104 ,240,35,83,.422,26,57,.456,9,26,.346,28,37,.757,107,37,81,.457,31,61,.508,6,20,.300,24,44,.545,104,2015-04-11,TOR,MIA
38,Home,W 107-91 ,240,35,69,.507,27,50,.540,8,19,.421,29,34,.853,107,35,85,.412,31,69,.449,4,16,.250,17,23,.739,91,2015-04-12,SAS,PHO
39,@,L 107-111 ,240,41,98,.418,36,83,.434,5,15,.333,20,25,.800,107,39,74,.527,26,50,.520,13,24,.542,20,27,.741,111,2015-04-13,MEM,GSW
40,@,W 107-97 ,240,40,81,.494,36,72,.500,4,9,.444,23,36,.639,107,32,81,.395,26,53,.491,6,28,.214,27,34,.794,97,2015-04-13,MIL,PHI
41,@,W 107-100 ,240,42,81,.519,34,59,.576,8,22,.364,15,20,.750,107,38,85,.447,31,61,.508,7,24,.292,17,23,.739,100,2015-11-02,CLE,PHI
42,Home,W 107-98 ,240,40,84,.476,31,60,.517,9,24,.375,18,22,.818,107,39,86,.453,30,58,.517,9,28,.321,11,13,.846,98,2015-11-07,DAL,NOP
43,Home,L 107-117 ,240,44,86,.512,31,55,.564,13,31,.419,6,7,.857,107,46,80,.575,39,65,.600,7,15,.467,18,22,.818,117,2015-11-09,ATL,MIN
44,Home,W 107-98 ,240,37,81,.457,28,61,.459,9,20,.450,24,32,.750,107,33,77,.429,24,48,.500,9,29,.310,23,31,.742,98,2015-11-13,DEN,HOU
45,Home,W 107-103 ,240,41,86,.477,31,61,.508,10,25,.400,15,23,.652,107,42,83,.506,35,63,.556,7,20,.350,12,13,.923,103,2015-11-13,IND,MIN
46,Home,W 107-99 (OT),265,43,97,.443,31,63,.492,12,34,.353,9,10,.900,107,41,98,.418,39,80,.488,2,18,.111,15,16,.938,99,2015-11-14,GSW,BRK
47,Home,W 107-101 ,240,39,76,.513,29,51,.569,10,25,.400,19,24,.792,107,38,87,.437,23,56,.411,15,31,.484,10,14,.714,101,2015-11-15,SAC,TOR
48,Home,L 107-114 ,240,41,90,.456,36,66,.545,5,24,.208,20,26,.769,107,40,79,.506,25,52,.481,15,27,.556,19,25,.760,114,2015-11-20,DEN,PHO
49,@,W 107-102 ,240,34,80,.425,22,55,.400,12,25,.480,27,34,.794,107,35,81,.432,23,53,.434,12,28,.429,20,28,.714,102,2015-11-21,NYK,HOU
50,@,W 107-93 ,240,43,87,.494,35,62,.565,8,25,.320,13,17,.765,107,32,88,.364,26,70,.371,6,18,.333,23,27,.852,93,2015-11-22,POR,LAL
51,Home,W 107-99 ,240,39,75,.520,31,53,.585,8,22,.364,21,33,.636,107,37,82,.451,29,66,.439,8,16,.500,17,21,.810,99,2015-11-29,LAC,MIN
52,@,W 107-103 ,240,34,83,.410,25,56,.446,9,27,.333,30,37,.811,107,38,99,.384,27,66,.409,11,33,.333,16,22,.727,103,2015-11-29,IND,LAL
53,@,W 107-102 ,240,40,94,.426,29,67,.433,11,27,.407,16,20,.800,107,38,86,.442,26,57,.456,12,29,.414,14,17,.824,102,2015-11-29,PHO,TOR
54,Home,W 107-104 ,240,41,80,.513,35,56,.625,6,24,.250,19,27,.704,107,40,85,.471,28,60,.467,12,25,.480,12,16,.750,104,2015-12-09,PHO,ORL
55,Home,W 107-94 ,240,39,80,.488,30,63,.476,9,17,.529,20,26,.769,107,35,78,.449,25,50,.500,10,28,.357,14,23,.609,94,2015-12-10,OKC,ATL
56,Home,W 107-105 ,240,39,79,.494,23,52,.442,16,27,.593,13,18,.722,107,40,80,.500,28,53,.528,12,27,.444,13,21,.619,105,2015-12-11,NOP,WAS
57,@,W 107-95 ,240,43,93,.462,33,66,.500,10,27,.370,11,16,.688,107,36,80,.450,30,62,.484,6,18,.333,17,24,.708,95,2015-12-11,DET,PHI
58,Home,W 107-97 ,240,38,75,.507,27,51,.529,11,24,.458,20,29,.690,107,34,82,.415,22,43,.512,12,39,.308,17,23,.739,97,2015-12-15,SAC,HOU
59,Home,W 107-81 ,240,43,89,.483,32,60,.533,11,29,.379,10,17,.588,107,33,90,.367,25,57,.439,8,33,.242,7,10,.700,81,2015-12-16,IND,DAL
60,Home,W 107-102 ,240,37,85,.435,29,64,.453,8,21,.381,25,30,.833,107,42,101,.416,38,80,.475,4,21,.190,14,14,1.000,102,2015-12-16,NYK,MIN
61,@,W 107-87 ,240,34,88,.386,22,57,.386,12,31,.387,27,42,.643,107,36,84,.429,31,60,.517,5,24,.208,10,18,.556,87,2015-12-17,HOU,LAL
62,@,W 107-97 ,240,40,85,.471,34,66,.515,6,19,.316,21,28,.750,107,37,77,.481,31,53,.585,6,24,.250,17,30,.567,97,2015-12-18,NYK,PHI
63,@,L 107-115 ,240,36,72,.500,26,48,.542,10,24,.417,25,40,.625,107,43,87,.494,33,68,.485,10,19,.526,19,24,.792,115,2015-12-18,LAC,SAS
64,Home,W 107-97 ,240,34,76,.447,26,51,.510,8,25,.320,31,49,.633,107,34,86,.395,23,48,.479,11,38,.289,18,29,.621,97,2015-12-19,HOU,LAC
65,Home,W 107-91 ,240,41,82,.500,36,62,.581,5,20,.250,20,24,.833,107,37,94,.394,32,73,.438,5,21,.238,12,17,.706,91,2015-12-19,NYK,CHI
66,@,W 107-99 ,240,44,86,.512,34,64,.531,10,22,.455,9,11,.818,107,39,76,.513,32,52,.615,7,24,.292,14,16,.875,99,2015-12-21,ORL,NYK
67,Home,L 107-111 ,240,41,90,.456,32,65,.492,9,25,.360,16,19,.842,107,40,84,.476,33,58,.569,7,26,.269,24,32,.750,111,2015-12-22,DEN,LAL
68,Home,W 107-100 ,240,43,89,.483,37,69,.536,6,20,.300,15,20,.750,107,38,89,.427,31,68,.456,7,21,.333,17,33,.515,100,2015-12-23,ATL,DET
69,@,W 107-101 ,240,40,84,.476,35,66,.530,5,18,.278,22,24,.917,107,37,87,.425,22,48,.458,15,39,.385,12,19,.632,101,2016-01-05,NYK,ATL
70,Home,W 107-103 (OT),265,39,89,.438,25,51,.490,14,38,.368,15,23,.652,107,43,90,.478,34,59,.576,9,31,.290,8,10,.800,103,2016-01-10,HOU,IND
71,Home,L 107-110 (OT),265,39,79,.494,28,51,.549,11,28,.393,18,22,.818,107,40,97,.412,23,53,.434,17,44,.386,13,16,.813,110,2016-01-12,DAL,CLE
72,@,W 107-91 ,240,33,77,.429,15,42,.357,18,35,.514,23,27,.852,107,33,72,.458,26,54,.481,7,18,.389,18,24,.750,91,2016-01-12,HOU,MEM
73,Home,W 107-84 ,240,36,82,.439,23,43,.535,13,39,.333,22,26,.846,107,30,81,.370,23,56,.411,7,25,.280,17,21,.810,84,2016-01-13,CHO,ATL
74,Home,W 107-104 ,240,37,75,.493,30,45,.667,7,30,.233,26,38,.684,107,36,78,.462,28,61,.459,8,17,.471,24,30,.800,104,2016-01-13,HOU,MIN
75,@,L 107-109 ,240,42,86,.488,28,51,.549,14,35,.400,9,12,.750,107,43,87,.494,31,60,.517,12,27,.444,11,13,.846,109,2016-01-15,CHO,NOP
76,@,L 107-114 ,240,41,84,.488,37,68,.544,4,16,.250,21,23,.913,107,45,89,.506,34,58,.586,11,31,.355,13,20,.650,114,2016-01-25,MIN,CLE
77,Home,W 107-100 ,240,38,77,.494,33,64,.516,5,13,.385,26,31,.839,107,33,80,.413,20,56,.357,13,24,.542,21,29,.724,100,2016-01-26,MIL,ORL
78,@,L 107-127 ,240,44,87,.506,33,56,.589,11,31,.355,8,12,.667,107,47,81,.580,33,52,.635,14,29,.483,19,21,.905,127,2016-01-27,DAL,GSW
79,@,W 107-103 ,240,37,74,.500,30,56,.536,7,18,.389,26,32,.813,107,38,80,.475,36,68,.529,2,12,.167,25,28,.893,103,2016-01-29,MIA,MIL
80,@,L 107-111 ,240,39,87,.448,30,58,.517,9,29,.310,20,34,.588,107,36,78,.462,32,64,.500,4,14,.286,35,47,.745,111,2016-01-30,DET,TOR
81,Home,W 107-92 ,240,40,78,.513,31,54,.574,9,24,.375,18,21,.857,107,39,96,.406,34,79,.430,5,17,.294,9,11,.818,92,2016-02-01,SAS,ORL
82,Home,W 107-95 ,240,39,85,.459,28,54,.519,11,31,.355,18,25,.720,107,38,86,.442,33,72,.458,5,14,.357,14,24,.583,95,2016-02-02,POR,MIL
83,@,W 107-102 ,240,40,88,.455,29,67,.433,11,21,.524,16,21,.762,107,42,88,.477,36,68,.529,6,20,.300,12,19,.632,102,2016-02-03,CHI,SAC
84,@,W 107-93 ,240,40,74,.541,32,47,.681,8,27,.296,19,23,.826,107,34,81,.420,30,61,.492,4,20,.200,21,28,.750,93,2016-02-05,LAC,ORL
85,@,L 107-112 ,240,42,87,.483,38,72,.528,4,15,.267,19,25,.760,107,41,84,.488,36,61,.590,5,23,.217,25,33,.758,112,2016-02-25,MIL,BOS
86,Home,L 107-117 ,240,34,78,.436,22,54,.407,12,24,.500,27,37,.730,107,43,89,.483,34,60,.567,9,29,.310,22,26,.846,117,2016-02-26,SAC,LAC
87,Home,W 107-101 ,240,41,83,.494,30,57,.526,11,26,.423,14,21,.667,107,39,89,.438,34,71,.479,5,18,.278,18,27,.667,101,2016-03-01,LAL,BRK
88,@,L 107-117 ,240,35,79,.443,24,48,.500,11,31,.355,26,32,.813,107,38,78,.487,26,55,.473,12,23,.522,29,38,.763,117,2016-03-02,LAL,DEN
89,@,W 107-97 ,240,40,89,.449,30,62,.484,10,27,.370,17,20,.850,107,34,79,.430,22,47,.468,12,32,.375,17,28,.607,97,2016-03-05,ATL,LAC
90,Home,L 107-113 ,240,37,77,.481,25,44,.568,12,33,.364,21,27,.778,107,38,78,.487,25,49,.510,13,29,.448,24,37,.649,113,2016-03-06,TOR,HOU
91,Home,W 107-98 ,240,40,81,.494,31,54,.574,9,27,.333,18,23,.783,107,37,76,.487,32,57,.561,5,19,.263,19,27,.704,98,2016-03-08,LAL,ORL
92,@,W 107-100 ,240,41,79,.519,37,64,.578,4,15,.267,21,34,.618,107,35,88,.398,27,63,.429,8,25,.320,22,25,.880,100,2016-03-11,ORL,SAC
93,@,W 107-96 ,240,42,87,.483,33,57,.579,9,30,.300,14,18,.778,107,32,76,.421,22,46,.478,10,30,.333,22,34,.647,96,2016-03-14,DAL,CHO
94,@,L 107-125 ,240,35,93,.376,28,68,.412,7,25,.280,30,34,.882,107,47,81,.580,35,56,.625,12,25,.480,19,23,.826,125,2016-03-14,NOP,GSW
95,Home,W 107-104 ,240,40,95,.421,29,60,.483,11,35,.314,16,20,.800,107,37,84,.440,33,68,.485,4,16,.250,26,30,.867,104,2016-03-14,PHO,MIN
96,Home,L 107-109 ,240,37,83,.446,31,63,.492,6,20,.300,27,31,.871,107,41,83,.494,32,58,.552,9,25,.360,18,20,.900,109,2016-03-14,TOR,CHI
97,@,W 107-89 ,240,39,83,.470,25,53,.472,14,30,.467,15,17,.882,107,34,77,.442,32,64,.500,2,13,.154,19,26,.731,89,2016-03-15,TOR,MIL
98,Home,W 107-99 ,240,40,100,.400,29,63,.460,11,37,.297,16,21,.762,107,35,83,.422,24,58,.414,11,25,.440,18,21,.857,99,2016-03-16,CHO,ORL
99,Home,W 107-96 ,240,40,85,.471,33,63,.524,7,22,.318,20,24,.833,107,39,93,.419,34,74,.459,5,19,.263,13,19,.684,96,2016-03-21,BOS,ORL
0,Home,W 107-100 ,240,39,77,.506,33,58,.569,6,19,.316,23,24,.958,107,40,80,.500,36,65,.554,4,15,.267,16,23,.696,100,2016-03-22,LAL,MEM
1,@,L 107-111 ,240,40,92,.435,27,55,.491,13,37,.351,14,17,.824,107,41,91,.451,33,56,.589,8,35,.229,21,29,.724,111,2016-03-22,HOU,OKC
2,Home,L 107-115 ,240,38,82,.463,23,50,.460,15,32,.469,16,21,.762,107,45,87,.517,31,62,.500,14,25,.560,11,15,.733,115,2016-03-23,CHI,NYK
3,@,L 107-119 ,240,39,93,.419,32,66,.485,7,27,.259,22,26,.846,107,47,93,.505,34,65,.523,13,28,.464,12,20,.600,119,2016-03-23,LAL,PHO
4,@,W 107-93 ,240,37,83,.446,23,49,.469,14,34,.412,19,25,.760,107,33,79,.418,25,56,.446,8,23,.348,19,28,.679,93,2016-03-26,CLE,NYK
5,Home,W 107-87 ,240,38,87,.437,26,49,.531,12,38,.316,19,24,.792,107,35,94,.372,31,73,.425,4,21,.190,13,21,.619,87,2016-03-31,CLE,BRK
6,@,W 107-100 ,240,41,91,.451,33,61,.541,8,30,.267,17,22,.773,107,37,90,.411,31,69,.449,6,21,.286,20,29,.690,100,2016-04-03,BOS,LAL
7,@,L 107-119 ,240,41,89,.461,33,68,.485,8,21,.381,17,26,.654,107,43,90,.478,33,64,.516,10,26,.385,23,29,.793,119,2016-04-03,MEM,ORL
8,Home,W 107-89 ,240,44,84,.524,35,70,.500,9,14,.643,10,14,.714,107,32,80,.400,27,58,.466,5,22,.227,20,25,.800,89,2016-04-05,MIA,DET
9,Home,W 107-93 ,240,40,88,.455,27,54,.500,13,34,.382,14,17,.824,107,37,82,.451,30,64,.469,7,18,.389,12,16,.750,93,2016-04-05,PHI,NOP
10,Home,L 107-115 ,240,41,78,.526,30,56,.536,11,22,.500,14,21,.667,107,40,93,.430,28,62,.452,12,31,.387,23,27,.852,115,2016-04-05,SAC,POR
11,@,L 107-118 ,240,40,90,.444,29,62,.468,11,28,.393,16,24,.667,107,46,88,.523,29,55,.527,17,33,.515,9,11,.818,118,2016-04-09,BOS,ATL
12,Home,W 107-98 ,240,41,84,.488,34,61,.557,7,23,.304,18,28,.643,107,41,78,.526,38,63,.603,3,15,.200,13,19,.684,98,2016-04-11,ORL,MIL
13,Home,W 107-99 ,240,39,89,.438,28,53,.528,11,36,.306,18,22,.818,107,40,94,.426,33,69,.478,7,25,.280,12,18,.667,99,2016-04-13,POR,DEN
14,@,W 107-96 ,240,40,89,.449,33,66,.500,7,23,.304,20,24,.833,107,39,92,.424,36,76,.474,3,16,.188,15,20,.750,96,2016-10-26,CHO,MIL
15,@,W 107-102 ,240,37,83,.446,29,59,.492,8,24,.333,25,33,.758,107,38,92,.413,35,73,.479,3,19,.158,23,26,.885,102,2016-10-26,DEN,NOP
16,Home,W 107-100 ,240,41,87,.471,27,55,.491,14,32,.438,11,17,.647,107,35,81,.432,28,61,.459,7,20,.350,23,31,.742,100,2016-11-02,BOS,CHI
17,@,L 107-125 ,240,38,81,.469,28,58,.483,10,23,.435,21,27,.778,107,47,82,.573,35,55,.636,12,27,.444,19,24,.792,125,2016-11-03,IND,MIL
18,Home,L 107-123 ,240,41,90,.456,33,65,.508,8,25,.320,17,21,.810,107,44,84,.524,33,61,.541,11,23,.478,24,31,.774,123,2016-11-06,BOS,DEN
19,@,L 107-108 ,240,35,70,.500,25,46,.543,10,24,.417,27,34,.794,107,44,86,.512,37,62,.597,7,24,.292,13,19,.684,108,2016-11-08,DEN,MEM
20,@,L 107-115 ,240,41,91,.451,32,64,.500,9,27,.333,16,21,.762,107,42,83,.506,33,63,.524,9,20,.450,22,27,.815,115,2016-11-09,CHI,ATL
21,Home,L 107-123 ,240,38,85,.447,30,61,.492,8,24,.333,23,30,.767,107,45,87,.517,32,64,.500,13,23,.565,20,26,.769,123,2016-11-09,ORL,MIN
22,Home,W 107-100 ,240,38,84,.452,30,62,.484,8,22,.364,23,30,.767,107,32,89,.360,23,67,.343,9,22,.409,27,32,.844,100,2016-11-09,PHO,DET
23,@,L 107-118 ,240,44,97,.454,37,74,.500,7,23,.304,12,16,.750,107,39,83,.470,32,61,.525,7,22,.318,33,38,.868,118,2016-11-12,NYK,TOR
24,Home,W 107-100 ,240,35,72,.486,25,40,.625,10,32,.313,27,31,.871,107,39,98,.398,31,66,.470,8,32,.250,14,18,.778,100,2016-11-16,ATL,MIL
25,Home,L 107-111 ,240,37,81,.457,28,56,.500,9,25,.360,24,34,.706,107,40,82,.488,25,56,.446,15,26,.577,16,19,.842,111,2016-11-16,LAC,MEM
26,Home,L 107-116 ,240,39,87,.448,27,62,.435,12,25,.480,17,21,.810,107,44,78,.564,34,54,.630,10,24,.417,18,19,.947,116,2016-11-18,LAL,SAS
27,@,L 107-110 ,240,43,95,.453,37,77,.481,6,18,.333,15,18,.833,107,43,100,.430,33,78,.423,10,22,.455,14,17,.824,110,2016-11-22,CHI,DEN
28,Home,W 107-103 ,240,45,96,.469,36,67,.537,9,29,.310,8,8,1.000,107,38,86,.442,32,64,.500,6,22,.273,21,26,.808,103,2016-11-22,NYK,POR
29,Home,W 107-84 ,240,40,81,.494,34,62,.548,6,19,.316,21,25,.840,107,27,75,.360,20,49,.408,7,26,.269,23,30,.767,84,2016-11-23,DET,MIA
30,Home,W 107-102 ,240,35,80,.438,27,58,.466,8,22,.364,29,42,.690,107,37,98,.378,25,66,.379,12,32,.375,16,20,.800,102,2016-11-26,CHO,NYK
31,Home,L 107-110 ,240,40,81,.494,29,50,.580,11,31,.355,16,24,.667,107,37,73,.507,28,48,.583,9,25,.360,27,33,.818,110,2016-11-26,MIA,MEM
32,@,L 107-109 ,240,45,89,.506,36,64,.563,9,25,.360,8,10,.800,107,40,89,.449,30,68,.441,10,21,.476,19,25,.760,109,2016-11-30,ATL,PHO
33,Home,W 107-105 ,240,39,80,.488,31,60,.517,8,20,.400,21,33,.636,107,41,81,.506,34,70,.486,7,11,.636,16,18,.889,105,2016-12-02,SAS,WAS
34,Home,W 107-82 ,240,40,87,.460,27,56,.482,13,31,.419,14,18,.778,107,32,71,.451,29,58,.500,3,13,.231,15,21,.714,82,2016-12-03,DAL,CHI
35,@,W 107-106 ,240,38,76,.500,30,50,.600,8,26,.308,23,29,.793,107,35,76,.461,20,43,.465,15,33,.455,21,26,.808,106,2016-12-03,BOS,PHI
36,Home,W 107-106 ,240,34,76,.447,22,38,.579,12,38,.316,27,31,.871,107,42,99,.424,31,67,.463,11,32,.344,11,12,.917,106,2016-12-05,HOU,BOS
37,@,W 107-101 ,240,38,80,.475,25,48,.521,13,32,.406,18,29,.621,107,39,87,.448,34,73,.466,5,14,.357,18,23,.783,101,2016-12-05,UTA,LAL
38,@,L 107-115 ,240,37,85,.435,20,45,.444,17,40,.425,16,19,.842,107,40,77,.519,30,53,.566,10,24,.417,25,37,.676,115,2016-12-07,POR,MIL
39,Home,W 107-97 ,240,33,86,.384,22,51,.431,11,35,.314,30,40,.750,107,35,91,.385,29,64,.453,6,27,.222,21,34,.618,97,2016-12-14,BRK,LAL
40,@,W 107-92 ,240,39,74,.527,34,58,.586,5,16,.313,24,26,.923,107,34,85,.400,24,58,.414,10,27,.370,14,18,.778,92,2016-12-15,SAS,PHO
41,@,W 107-99 ,240,43,88,.489,31,61,.508,12,27,.444,9,13,.692,107,40,86,.465,30,60,.500,10,26,.385,9,16,.563,99,2016-12-17,CHO,ATL
42,@,L 107-108 ,240,36,81,.444,24,47,.511,12,34,.353,23,31,.742,107,38,88,.432,26,60,.433,12,28,.429,20,23,.870,108,2016-12-18,BRK,PHI
43,@,L 107-117 ,240,43,81,.531,29,56,.518,14,25,.560,7,9,.778,107,45,79,.570,32,55,.582,13,24,.542,14,18,.778,117,2016-12-19,DAL,DEN
44,Home,W 107-105 ,240,41,87,.471,34,66,.515,7,21,.333,18,21,.857,107,38,88,.432,30,55,.545,8,33,.242,21,26,.808,105,2016-12-19,IND,WAS
45,@,W 107-97 ,240,43,82,.524,40,64,.625,3,18,.167,18,25,.720,107,38,95,.400,32,74,.432,6,21,.286,15,19,.789,97,2016-12-21,WAS,CHI
46,@,L 107-115 ,240,40,90,.444,26,52,.500,14,38,.368,13,15,.867,107,45,84,.536,34,62,.548,11,22,.500,14,21,.667,115,2016-12-22,LAL,MIA
47,Home,W 107-102 ,240,40,79,.506,28,50,.560,12,29,.414,15,20,.750,107,40,85,.471,34,64,.531,6,21,.286,16,23,.696,102,2016-12-26,WAS,MIL
48,Home,L 107-123 ,240,36,87,.414,21,49,.429,15,38,.395,20,25,.800,107,41,78,.526,24,46,.522,17,32,.531,24,28,.857,123,2016-12-27,DAL,HOU
49,@,W 107-98 ,240,42,86,.488,33,64,.516,9,22,.409,14,22,.636,107,35,77,.455,21,51,.412,14,26,.538,14,18,.778,98,2017-01-01,DET,MIA
50,@,W 107-102 ,240,35,72,.486,23,44,.523,12,28,.429,25,29,.862,107,40,78,.513,32,58,.552,8,20,.400,14,17,.824,102,2017-01-04,MIA,SAC
51,@,W 107-101 ,240,41,84,.488,31,52,.596,10,32,.313,15,18,.833,107,37,80,.463,28,57,.491,9,23,.391,18,20,.900,101,2017-01-08,WAS,MIL
52,Home,W 107-95 ,240,39,86,.453,28,59,.475,11,27,.407,18,22,.818,107,38,90,.422,32,60,.533,6,30,.200,13,17,.765,95,2017-01-10,GSW,MIA
53,Home,L 107-109 ,240,42,88,.477,30,58,.517,12,30,.400,11,14,.786,107,44,84,.524,34,65,.523,10,19,.526,11,13,.846,109,2017-01-10,SAS,MIL
54,@,L 107-127 ,240,43,88,.489,37,60,.617,6,28,.214,15,20,.750,107,50,89,.562,35,60,.583,15,29,.517,12,18,.667,127,2017-01-12,DET,GSW
55,Home,W 107-99 ,240,43,101,.426,35,81,.432,8,20,.400,13,23,.565,107,39,84,.464,32,61,.525,7,23,.304,14,21,.667,99,2017-01-14,CHI,NOP
56,@,L 107-114 ,240,38,82,.463,26,48,.542,12,34,.353,19,27,.704,107,41,83,.494,34,57,.596,7,26,.269,25,36,.694,114,2017-01-14,ORL,UTA
57,Home,L 107-108 ,240,42,85,.494,34,59,.576,8,26,.308,15,23,.652,107,40,87,.460,28,55,.509,12,32,.375,16,23,.696,108,2017-01-16,NYK,ATL
58,Home,W 107-85 ,240,41,87,.471,30,61,.492,11,26,.423,14,17,.824,107,33,94,.351,25,63,.397,8,31,.258,11,11,1.000,85,2017-01-18,CHO,POR
59,Home,L 107-112 (OT),265,39,87,.448,31,64,.484,8,23,.348,21,28,.750,107,38,82,.463,30,59,.508,8,23,.348,28,39,.718,112,2017-01-20,DAL,UTA
60,Home,W 107-91 ,240,38,83,.458,27,55,.491,11,28,.393,20,25,.800,107,31,76,.408,25,47,.532,6,29,.207,23,32,.719,91,2017-01-20,MEM,SAC
61,@,W 107-105 ,240,37,85,.435,28,61,.459,9,24,.375,24,27,.889,107,40,89,.449,29,68,.426,11,21,.524,14,16,.875,105,2017-01-21,PHO,NYK
62,@,L 107-110 ,240,40,90,.444,27,53,.509,13,37,.351,14,15,.933,107,46,96,.479,37,69,.536,9,27,.333,9,13,.692,110,2017-01-27,CHO,NYK
63,Home,W 107-91 ,240,41,92,.446,33,63,.524,8,29,.276,17,22,.773,107,37,100,.370,31,74,.419,6,26,.231,11,16,.688,91,2017-01-29,CLE,OKC
64,@,W 107-94 ,240,45,89,.506,35,68,.515,10,21,.476,7,10,.700,107,38,84,.452,28,52,.538,10,32,.313,8,15,.533,94,2017-01-29,WAS,NOP
65,@,L 107-113 ,240,37,94,.394,23,56,.411,14,38,.368,19,26,.731,107,39,82,.476,26,47,.553,13,35,.371,22,28,.786,113,2017-02-03,LAL,BOS
66,@,W 107-99 ,240,32,77,.416,22,49,.449,10,28,.357,33,39,.846,107,35,84,.417,25,58,.431,10,26,.385,19,24,.792,99,2017-02-04,MEM,MIN
67,Home,W 107-102 ,240,37,88,.420,21,36,.583,16,52,.308,17,20,.850,107,35,84,.417,25,55,.455,10,29,.345,22,28,.786,102,2017-02-05,BOS,LAC
68,Home,L 107-121 ,240,37,82,.451,30,61,.492,7,21,.333,26,33,.788,107,44,102,.431,36,74,.486,8,28,.286,25,31,.806,121,2017-02-06,NYK,LAL
69,Home,L 107-112 ,240,41,79,.519,30,51,.588,11,28,.393,14,16,.875,107,43,81,.531,37,62,.597,6,19,.316,20,31,.645,112,2017-02-06,SAC,CHI
70,@,L 107-111 ,240,39,86,.453,27,50,.540,12,36,.333,17,21,.810,107,40,102,.392,33,76,.434,7,26,.269,24,29,.828,111,2017-02-07,BRK,CHO
71,@,W 107-95 ,240,39,87,.448,26,47,.553,13,40,.325,16,20,.800,107,37,85,.435,29,59,.492,8,26,.308,13,14,.929,95,2017-02-09,HOU,CHO
72,Home,L 107-122 ,240,34,87,.391,25,61,.410,9,26,.346,30,37,.811,107,39,77,.506,24,44,.545,15,33,.455,29,38,.763,122,2017-02-10,MEM,GSW
73,@,L 107-108 ,240,36,71,.507,25,41,.610,11,30,.367,24,31,.774,107,38,80,.475,20,44,.455,18,36,.500,14,21,.667,108,2017-02-10,ATL,SAC
74,@,L 107-112 ,240,45,92,.489,41,71,.577,4,21,.190,13,15,.867,107,41,88,.466,31,59,.525,10,29,.345,20,30,.667,112,2017-02-10,IND,WAS
75,@,W 107-102 ,240,40,85,.471,26,51,.510,14,34,.412,13,20,.650,107,37,85,.435,24,48,.500,13,37,.351,15,20,.750,102,2017-02-11,LAC,CHO
76,Home,L 107-116 ,240,39,83,.470,33,61,.541,6,22,.273,23,27,.852,107,44,90,.489,36,76,.474,8,14,.571,20,29,.690,116,2017-02-13,MIA,ORL
77,@,W 107-79 ,240,42,89,.472,34,58,.586,8,31,.258,15,19,.789,107,30,76,.395,26,58,.448,4,18,.222,15,19,.789,79,2017-02-15,SAS,ORL
78,Home,W 107-97 ,240,40,81,.494,35,66,.530,5,15,.333,22,29,.759,107,33,78,.423,21,40,.525,12,38,.316,19,22,.864,97,2017-02-24,TOR,BOS
79,Home,L 107-125 ,240,44,96,.458,34,70,.486,10,26,.385,9,10,.900,107,45,80,.563,32,50,.640,13,30,.433,22,24,.917,125,2017-02-28,CHI,DEN
80,@,W 107-80 ,240,39,78,.500,31,62,.500,8,16,.500,21,26,.808,107,35,90,.389,31,71,.437,4,19,.211,6,11,.545,80,2017-03-01,MIN,UTA
81,Home,W 107-91 ,240,42,86,.488,37,66,.561,5,20,.250,18,20,.900,107,35,83,.422,26,59,.441,9,24,.375,12,18,.667,91,2017-03-08,MIN,LAC
82,Home,W 106-104 ,240,35,74,.473,26,54,.481,9,20,.450,27,34,.794,106,39,76,.513,37,71,.521,2,5,.400,24,31,.774,104,2011-12-25,NYK,BOS
83,@,W 106-70 ,240,38,86,.442,26,63,.413,12,23,.522,18,21,.857,106,22,71,.310,17,47,.362,5,24,.208,21,26,.808,70,2011-12-27,ATL,NJN
84,Home,W 106-96 ,240,41,71,.577,29,50,.580,12,21,.571,12,15,.800,106,36,82,.439,29,62,.468,7,20,.350,17,21,.810,96,2012-01-02,MIN,SAS
85,@,W 106-101 ,240,42,78,.538,33,57,.579,9,21,.429,13,19,.684,106,36,77,.468,25,55,.455,11,22,.500,18,21,.857,101,2012-01-09,ATL,NJN
86,@,L 106-111 (OT),265,39,85,.459,37,74,.500,2,11,.182,26,40,.650,106,38,95,.400,29,68,.426,9,27,.333,26,30,.867,111,2012-01-10,MIA,GSW
87,Home,W 106-103 ,240,44,85,.518,35,71,.493,9,14,.643,9,10,.900,106,45,75,.600,41,61,.672,4,14,.286,9,16,.563,103,2012-01-10,MIL,SAS
88,@,W 106-96 ,240,44,85,.518,40,73,.548,4,12,.333,14,20,.700,106,32,75,.427,26,59,.441,6,16,.375,26,39,.667,96,2012-01-15,UTA,DEN
89,Home,L 106-114 ,240,39,80,.488,36,69,.522,3,11,.273,25,32,.781,106,42,87,.483,37,71,.521,5,16,.313,25,26,.962,114,2012-01-16,WAS,HOU
90,Home,L 106-111 (2OT),290,39,90,.433,35,72,.486,4,18,.222,24,36,.667,106,43,96,.448,33,68,.485,10,28,.357,15,19,.789,111,2012-01-25,UTA,TOR
91,@,W 106-101 ,240,40,79,.506,32,60,.533,8,19,.421,18,23,.783,106,40,104,.385,35,83,.422,5,21,.238,16,23,.696,101,2012-01-29,LAL,MIN
92,@,W 106-85 ,240,45,88,.511,37,71,.521,8,17,.471,8,11,.727,106,31,64,.484,21,41,.512,10,23,.435,13,29,.448,85,2012-01-29,IND,ORL
93,Home,W 106-99 ,240,38,73,.521,34,62,.548,4,11,.364,26,36,.722,106,35,74,.473,23,45,.511,12,29,.414,17,23,.739,99,2012-01-31,IND,NJN
94,Home,W 106-73 ,240,42,76,.553,30,50,.600,12,26,.462,10,11,.909,106,31,89,.348,29,80,.363,2,9,.222,9,13,.692,73,2012-01-31,LAL,CHA
95,Home,W 106-89 ,240,42,93,.452,39,80,.488,3,13,.231,19,28,.679,106,33,87,.379,28,68,.412,5,19,.263,18,25,.720,89,2012-02-03,TOR,WAS
96,@,L 106-114 (OT),265,39,90,.433,23,61,.377,16,29,.552,12,13,.923,106,43,98,.439,33,76,.434,10,22,.455,18,21,.857,114,2012-02-04,GSW,SAC
97,Home,W 106-101 ,240,40,99,.404,33,79,.418,7,20,.350,19,26,.731,106,37,77,.481,30,59,.508,7,18,.389,20,26,.769,101,2012-02-09,SAC,OKC
98,@,W 106-89 ,240,40,81,.494,35,66,.530,5,15,.333,21,23,.913,106,34,89,.382,30,68,.441,4,21,.190,17,28,.607,89,2012-02-10,MIA,WAS
99,Home,W 106-97 ,240,40,79,.506,27,55,.491,13,24,.542,13,18,.722,106,31,75,.413,20,46,.435,11,29,.379,24,33,.727,97,2012-02-12,GSW,HOU
0,Home,L 106-113 ,240,47,86,.547,44,75,.587,3,11,.273,9,14,.643,106,41,76,.539,33,57,.579,8,19,.421,23,25,.920,113,2012-02-15,TOR,SAS
1,@,W 106-102 ,240,36,78,.462,26,57,.456,10,21,.476,24,30,.800,106,40,84,.476,37,76,.487,3,8,.375,19,23,.826,102,2012-02-20,SAS,UTA
2,@,W 106-104 ,240,39,84,.464,30,64,.469,9,20,.450,19,22,.864,106,43,90,.478,39,71,.549,4,19,.211,14,20,.700,104,2012-02-22,GSW,PHO
3,@,W 106-104 ,240,43,83,.518,38,67,.567,5,16,.313,15,17,.882,106,42,88,.477,37,73,.507,5,15,.333,15,19,.789,104,2012-03-07,CHI,MIL
4,Home,W 106-94 ,240,37,78,.474,24,55,.436,13,23,.565,19,26,.731,106,44,93,.473,41,70,.586,3,23,.130,3,4,.750,94,2012-03-07,MIN,POR
5,Home,W 106-101 ,240,43,92,.467,36,66,.545,7,26,.269,13,19,.684,106,32,81,.395,24,60,.400,8,21,.381,29,37,.784,101,2012-03-07,WAS,LAL
6,Home,L 106-112 ,240,43,81,.531,34,57,.596,9,24,.375,11,14,.786,106,46,82,.561,37,66,.561,9,16,.563,11,14,.786,112,2012-03-10,NJN,HOU
7,@,W 106-94 ,240,40,79,.506,35,70,.500,5,9,.556,21,26,.808,106,33,80,.413,26,63,.413,7,17,.412,21,26,.808,94,2012-03-11,PHI,NYK
8,@,W 106-99 ,240,42,82,.512,35,61,.574,7,21,.333,15,23,.652,106,38,82,.463,28,53,.528,10,29,.345,13,17,.765,99,2012-03-11,ATL,SAC
9,Home,W 106-102 ,240,36,77,.468,26,58,.448,10,19,.526,24,26,.923,106,38,85,.447,32,73,.438,6,12,.500,20,23,.870,102,2012-03-14,CHI,MIA
10,Home,W 106-99 ,240,37,79,.468,26,55,.473,11,24,.458,21,25,.840,106,39,79,.494,28,55,.509,11,24,.458,10,18,.556,99,2012-03-17,DAL,SAS
11,Home,W 106-87 ,240,39,81,.481,34,65,.523,5,16,.313,23,33,.697,106,33,69,.478,31,56,.554,2,13,.154,19,22,.864,87,2012-03-20,NYK,TOR
12,@,L 106-113 (OT),265,41,96,.427,36,78,.462,5,18,.278,19,26,.731,106,43,89,.483,39,69,.565,4,20,.200,23,27,.852,113,2012-03-26,SAC,HOU
13,Home,W 106-85 ,240,39,80,.488,34,63,.540,5,17,.294,23,27,.852,106,33,78,.423,24,54,.444,9,24,.375,10,13,.769,85,2012-03-29,MIA,DAL
14,@,L 106-119 ,240,36,78,.462,31,57,.544,5,21,.238,29,35,.829,106,46,88,.523,37,60,.617,9,28,.321,18,20,.900,119,2012-04-01,MIN,POR
15,Home,L 106-109 (OT),265,42,97,.433,39,85,.459,3,12,.250,19,25,.760,106,40,89,.449,34,71,.479,6,18,.333,23,33,.697,109,2012-04-21,IND,PHI
16,Home,W 106-95 ,240,38,84,.452,34,71,.479,4,13,.308,26,37,.703,106,40,86,.465,36,74,.486,4,12,.333,11,15,.733,95,2012-04-21,MIL,NJN
17,@,L 106-114 (2OT),290,37,101,.366,29,77,.377,8,24,.333,24,28,.857,106,41,106,.387,36,90,.400,5,16,.313,27,40,.675,114,2012-04-22,OKC,LAL
18,@,W 106-101 ,240,40,90,.444,32,67,.478,8,23,.348,18,30,.600,106,39,79,.494,29,55,.527,10,24,.417,13,15,.867,101,2012-04-25,DEN,OKC
19,Home,L 106-110 ,240,45,94,.479,40,81,.494,5,13,.385,11,13,.846,106,41,88,.466,33,66,.500,8,22,.364,20,23,.870,110,2012-04-25,PHO,SAS
20,Home,W 106-89 ,240,45,85,.529,36,58,.621,9,27,.333,7,9,.778,106,33,78,.423,28,63,.444,5,15,.333,18,23,.783,89,2012-04-26,ATL,DAL
21,@,L 106-116 ,240,36,72,.500,28,54,.519,8,18,.444,26,32,.813,106,42,83,.506,33,63,.524,9,20,.450,23,28,.821,116,2012-10-31,LAL,POR
22,Home,W 106-92 ,240,39,76,.513,34,67,.507,5,9,.556,23,32,.719,106,32,89,.360,23,63,.365,9,26,.346,19,24,.792,92,2012-11-02,OKC,POR
23,Home,W 106-98 (2OT),290,39,99,.394,35,77,.455,4,22,.182,24,27,.889,106,37,102,.363,29,80,.363,8,22,.364,16,20,.800,98,2012-11-03,IND,SAC
24,Home,W 106-96 ,240,42,78,.538,37,60,.617,5,18,.278,17,23,.739,106,36,86,.419,25,54,.463,11,32,.344,13,21,.619,96,2012-11-07,GSW,CLE
25,Home,W 106-84 ,240,46,83,.554,40,66,.606,6,17,.353,8,9,.889,106,30,73,.411,22,50,.440,8,23,.348,16,24,.667,84,2012-11-07,LAC,SAS
26,@,W 106-100 ,240,40,82,.488,33,69,.478,7,13,.538,19,23,.826,106,37,76,.487,33,66,.500,4,10,.400,22,31,.710,100,2012-11-09,PHI,BOS
27,Home,W 106-91 ,240,40,73,.548,33,58,.569,7,15,.467,19,22,.864,106,34,83,.410,27,60,.450,7,23,.304,16,23,.696,91,2012-11-11,OKC,CLE
28,Home,L 106-112 (OT),265,42,105,.400,36,84,.429,6,21,.286,16,17,.941,106,44,88,.500,38,76,.500,6,12,.500,18,25,.720,112,2012-11-14,PHO,CHI
29,Home,L 106-110 ,240,44,82,.537,42,74,.568,2,8,.250,16,20,.800,106,44,89,.494,37,72,.514,7,17,.412,15,17,.882,110,2012-11-16,DET,ORL
30,@,W 106-98 ,240,43,85,.506,41,70,.586,2,15,.133,18,26,.692,106,34,79,.430,27,61,.443,7,18,.389,23,29,.793,98,2012-11-16,GSW,MIN
31,Home,W 106-98 ,240,40,85,.471,31,61,.508,9,24,.375,17,19,.895,106,37,82,.451,33,66,.500,4,16,.250,20,29,.690,98,2012-11-20,PHI,TOR
32,@,L 106-113 (OT),265,46,109,.422,41,80,.513,5,29,.172,9,12,.750,106,41,86,.477,33,68,.485,8,18,.444,23,33,.697,113,2012-11-21,MIL,MIA
33,Home,W 106-98 ,240,38,75,.507,32,64,.500,6,11,.545,24,30,.800,106,33,74,.446,21,47,.447,12,27,.444,20,24,.833,98,2012-11-23,MEM,LAL
34,Home,L 106-108 (2OT),290,34,93,.366,28,66,.424,6,27,.222,32,39,.821,106,34,83,.410,22,55,.400,12,28,.429,28,36,.778,108,2012-11-24,WAS,CHA
35,Home,L 106-111 (2OT),290,40,110,.364,34,86,.395,6,24,.250,20,24,.833,106,44,103,.427,36,76,.474,8,27,.296,15,19,.789,111,2012-11-25,TOR,SAS
36,Home,W 106-105 ,240,44,86,.512,36,68,.529,8,18,.444,10,13,.769,106,38,84,.452,28,63,.444,10,21,.476,19,24,.792,105,2012-11-29,GSW,DEN
37,Home,W 106-94 ,240,39,75,.520,35,66,.530,4,9,.444,24,33,.727,106,38,92,.413,31,69,.449,7,23,.304,11,12,.917,94,2012-11-30,OKC,UTA
38,Home,W 106-99 ,240,40,90,.444,28,61,.459,12,29,.414,14,17,.824,106,39,80,.488,31,57,.544,8,23,.348,13,19,.684,99,2012-12-02,NYK,PHO
39,Home,W 106-90 ,240,40,69,.580,33,58,.569,7,11,.636,19,24,.792,106,35,78,.449,27,60,.450,8,18,.444,12,13,.923,90,2012-12-08,MIA,NOH
40,@,L 106-112 ,240,40,72,.556,35,55,.636,5,17,.294,21,29,.724,106,37,86,.430,25,56,.446,12,30,.400,26,37,.703,112,2012-12-09,DEN,NYK
41,@,L 106-114 (OT),265,39,84,.464,32,70,.457,7,14,.500,21,25,.840,106,41,94,.436,35,71,.493,6,23,.261,26,32,.813,114,2012-12-15,DAL,MIN
42,@,L 106-112 ,240,38,95,.400,24,59,.407,14,36,.389,16,18,.889,106,38,87,.437,31,68,.456,7,19,.368,29,42,.690,112,2012-12-18,SAS,DEN
43,Home,L 106-110 ,240,38,91,.418,30,65,.462,8,26,.308,22,25,.880,106,37,83,.446,29,65,.446,8,18,.444,28,33,.848,110,2012-12-21,NYK,CHI
44,Home,W 106-77 ,240,41,85,.482,29,55,.527,12,30,.400,12,24,.500,106,29,72,.403,23,56,.411,6,16,.375,13,15,.867,77,2012-12-27,LAC,BOS
45,@,W 106-85 ,240,43,94,.457,31,66,.470,12,28,.429,8,14,.571,106,33,88,.375,28,63,.444,5,25,.200,14,21,.667,85,2012-12-28,DEN,DAL
46,Home,W 106-105 ,240,39,86,.453,24,56,.429,15,30,.500,13,17,.765,106,41,83,.494,30,53,.566,11,30,.367,12,20,.600,105,2012-12-28,SAC,NYK
47,Home,W 106-84 ,240,43,87,.494,39,75,.520,4,12,.333,16,19,.842,106,29,84,.345,27,67,.403,2,17,.118,24,30,.800,84,2013-01-02,UTA,MIN
48,@,W 106-104 ,240,39,78,.500,32,62,.516,7,16,.438,21,29,.724,106,37,82,.451,29,65,.446,8,17,.471,22,28,.786,104,2013-01-04,CLE,CHA
49,Home,L 106-114 ,240,41,85,.482,31,59,.525,10,26,.385,14,18,.778,106,42,88,.477,30,55,.545,12,33,.364,18,22,.818,114,2013-01-05,ORL,NYK
50,Home,W 106-84 ,240,36,76,.474,25,56,.446,11,20,.550,23,27,.852,106,31,72,.431,28,60,.467,3,12,.250,19,24,.792,84,2013-01-09,OKC,MIN
51,Home,W 106-88 ,240,45,80,.563,37,59,.627,8,21,.381,8,11,.727,106,33,89,.371,29,73,.397,4,16,.250,18,23,.783,88,2013-01-13,SAS,MIN
52,@,L 106-113 ,240,40,82,.488,33,69,.478,7,13,.538,19,23,.826,106,40,81,.494,32,60,.533,8,21,.381,25,28,.893,113,2013-01-15,TOR,BRK
53,@,W 106-100 ,240,37,79,.468,33,67,.493,4,12,.333,28,38,.737,106,37,79,.468,26,48,.542,11,31,.355,15,21,.714,100,2013-01-18,CHA,ORL
54,Home,W 106-99 ,240,39,75,.520,27,53,.509,12,22,.545,16,18,.889,106,38,83,.458,27,53,.509,11,30,.367,12,22,.545,99,2013-01-21,GSW,LAC
55,Home,W 106-93 ,240,47,96,.490,43,83,.518,4,13,.308,8,10,.800,106,31,73,.425,24,56,.429,7,17,.412,24,32,.750,93,2013-01-23,MEM,LAL
56,@,W 106-96 ,240,43,90,.478,37,71,.521,6,19,.316,14,16,.875,106,38,79,.481,33,68,.485,5,11,.455,15,24,.625,96,2013-01-23,PHO,SAC
57,Home,W 106-102 ,240,43,80,.538,35,55,.636,8,25,.320,12,23,.522,106,38,81,.469,28,64,.438,10,17,.588,16,23,.696,102,2013-01-23,SAS,NOH
58,@,L 106-119 ,240,36,80,.450,20,44,.455,16,36,.444,18,21,.857,106,43,87,.494,31,59,.525,12,28,.429,21,27,.778,119,2013-01-26,BRK,HOU
59,Home,W 106-104 ,240,39,72,.542,23,45,.511,16,27,.593,12,17,.706,106,39,65,.600,29,42,.690,10,23,.435,16,20,.800,104,2013-01-27,NYK,ATL
60,@,L 106-111 ,240,39,92,.424,30,73,.411,9,19,.474,19,21,.905,106,39,79,.494,27,46,.587,12,33,.364,21,33,.636,111,2013-01-29,NOH,LAL
61,Home,W 106-104 ,240,39,86,.453,29,58,.500,10,28,.357,18,23,.783,106,42,84,.500,34,69,.493,8,15,.533,12,15,.800,104,2013-01-29,POR,DAL
62,Home,W 106-89 ,240,40,72,.556,35,58,.603,5,14,.357,21,25,.840,106,34,98,.347,28,73,.384,6,25,.240,15,19,.789,89,2013-01-31,OKC,MEM
63,Home,W 106-104 ,240,36,72,.500,25,54,.463,11,18,.611,23,27,.852,106,40,79,.506,31,58,.534,9,21,.429,15,21,.714,104,2013-02-03,BOS,LAC
64,Home,W 106-96 ,240,42,79,.532,31,59,.525,11,20,.550,11,14,.786,106,34,84,.405,25,56,.446,9,28,.321,19,23,.826,96,2013-02-06,WAS,NYK
65,Home,W 106-96 ,240,37,75,.493,24,43,.558,13,32,.406,19,26,.731,106,36,82,.439,31,58,.534,5,24,.208,19,22,.864,96,2013-02-13,LAC,HOU
66,@,W 106-96 ,240,41,77,.532,25,47,.532,16,30,.533,8,12,.667,106,40,91,.440,30,61,.492,10,30,.333,6,11,.545,96,2013-02-22,HOU,BRK
67,Home,W 106-84 ,240,41,76,.539,29,54,.537,12,22,.545,12,26,.462,106,33,81,.407,27,65,.415,6,16,.375,12,14,.857,84,2013-02-26,LAC,CHA
68,Home,L 106-136 ,240,44,84,.524,38,65,.585,6,19,.316,12,15,.800,106,53,86,.616,40,65,.615,13,21,.619,17,21,.810,136,2013-03-08,SAS,POR
69,Home,W 106-97 ,240,40,76,.526,32,61,.525,8,15,.533,18,27,.667,106,40,81,.494,34,62,.548,6,19,.316,11,16,.688,97,2013-03-11,PHI,BRK
70,@,W 106-97 ,240,34,73,.466,25,48,.521,9,25,.360,29,47,.617,106,37,93,.398,27,61,.443,10,32,.313,13,17,.765,97,2013-03-12,LAL,ORL
71,Home,W 106-93 ,240,43,86,.500,35,70,.500,8,16,.500,12,24,.500,106,39,85,.459,33,67,.493,6,18,.333,9,12,.750,93,2013-03-13,WAS,MIL
72,Home,W 106-94 ,240,40,76,.526,25,42,.595,15,34,.441,11,16,.688,106,38,79,.481,33,62,.532,5,17,.294,13,18,.722,94,2013-03-20,NYK,ORL
73,@,L 106-110 ,240,38,74,.514,29,54,.537,9,20,.450,21,28,.750,106,43,94,.457,39,83,.470,4,11,.364,20,24,.833,110,2013-03-23,BOS,MEM
74,Home,L 106-109 ,240,39,80,.488,34,64,.531,5,16,.313,23,26,.885,106,39,71,.549,29,48,.604,10,23,.435,21,28,.750,109,2013-04-01,LAC,IND
75,Home,W 106-87 ,240,40,83,.482,26,58,.448,14,25,.560,12,14,.857,106,33,82,.402,27,62,.435,6,20,.300,15,20,.750,87,2013-04-06,MIA,PHI
76,Home,L 106-113 ,240,38,85,.447,26,59,.441,12,26,.462,18,20,.900,106,43,73,.589,37,54,.685,6,19,.316,21,24,.875,113,2013-04-10,POR,LAL
77,@,W 106-90 ,240,40,77,.519,31,55,.564,9,22,.409,17,21,.810,106,36,88,.409,30,68,.441,6,20,.300,12,18,.667,90,2013-04-12,OKC,POR
78,Home,W 106-101 ,240,43,92,.467,36,77,.468,7,15,.467,13,27,.481,106,41,77,.532,37,66,.561,4,11,.364,15,20,.750,101,2013-04-15,BRK,WAS
79,Home,W 106-95 ,240,43,74,.581,36,56,.643,7,18,.389,13,14,.929,106,34,79,.430,20,42,.476,14,37,.378,13,13,1.000,95,2013-04-15,CHA,NYK
80,@,L 106-116 ,240,45,98,.459,37,74,.500,8,24,.333,8,13,.615,106,46,85,.541,37,65,.569,9,20,.450,15,18,.833,116,2013-04-15,SAS,GSW
81,@,W 106-93 ,240,42,84,.500,34,64,.531,8,20,.400,14,20,.700,106,34,90,.378,30,74,.405,4,16,.250,21,27,.778,93,2013-11-06,GSW,MIN
82,Home,W 106-105 (OT),265,41,92,.446,35,72,.486,6,20,.300,18,22,.818,106,40,88,.455,28,59,.475,12,29,.414,13,26,.500,105,2013-11-10,OKC,WAS
83,Home,L 106-109 ,240,38,87,.437,30,67,.448,8,20,.400,22,27,.815,106,31,68,.456,22,40,.550,9,28,.321,38,44,.864,109,2013-11-14,NYK,HOU
84,Home,W 106-88 ,240,40,94,.426,33,71,.465,7,23,.304,19,22,.864,106,34,86,.395,29,68,.426,5,18,.278,15,18,.833,88,2013-11-16,MIN,BOS
85,@,W 106-102 ,240,39,81,.481,34,69,.493,5,12,.417,23,30,.767,106,34,86,.395,27,63,.429,7,23,.304,27,32,.844,102,2013-11-18,MEM,LAC
86,Home,L 106-113 ,240,38,85,.447,23,52,.442,15,33,.455,15,22,.682,106,37,80,.463,30,63,.476,7,17,.412,32,38,.842,113,2013-11-20,PHO,SAC
87,Home,W 106-98 ,240,35,76,.461,30,58,.517,5,18,.278,31,38,.816,106,35,102,.343,31,77,.403,4,25,.160,24,32,.750,98,2013-11-23,IND,PHI
88,@,L 106-120 ,240,39,86,.453,32,67,.478,7,19,.368,21,24,.875,106,42,81,.519,32,57,.561,10,24,.417,26,31,.839,120,2013-11-27,POR,PHO
89,@,W 106-102 ,240,36,80,.450,22,49,.449,14,31,.452,20,30,.667,106,44,100,.440,43,92,.467,1,8,.125,13,25,.520,102,2013-11-29,LAL,DET
90,Home,L 106-112 ,240,45,92,.489,38,68,.559,7,24,.292,9,11,.818,106,40,79,.506,29,53,.547,11,26,.423,21,30,.700,112,2013-11-30,DAL,MIN
91,Home,L 106-112 ,240,44,91,.484,35,65,.538,9,26,.346,9,13,.692,106,40,90,.444,27,60,.450,13,30,.433,19,30,.633,112,2013-11-30,SAS,HOU
92,Home,W 106-102 ,240,36,76,.474,31,63,.492,5,13,.385,29,33,.879,106,39,88,.443,30,66,.455,9,22,.409,15,17,.882,102,2013-12-02,POR,IND
93,Home,W 106-98 ,240,43,83,.518,37,63,.587,6,20,.300,14,18,.778,106,34,77,.442,28,60,.467,6,17,.353,24,29,.828,98,2013-12-06,BOS,DEN
94,Home,W 106-97 ,240,37,82,.451,28,59,.475,9,23,.391,23,32,.719,106,35,87,.402,30,68,.441,5,19,.263,22,25,.880,97,2013-12-06,PHO,TOR
95,@,W 106-100 ,240,41,86,.477,29,54,.537,12,32,.375,12,18,.667,106,37,86,.430,27,64,.422,10,22,.455,16,22,.727,100,2013-12-06,LAL,SAC
96,Home,L 106-108 ,240,39,87,.448,30,57,.526,9,30,.300,19,24,.792,106,46,87,.529,38,71,.535,8,16,.500,8,11,.727,108,2013-12-07,POR,DAL
97,@,W 106-94 ,240,40,82,.488,36,56,.643,4,26,.154,22,25,.880,106,34,79,.430,25,51,.490,9,28,.321,17,20,.850,94,2013-12-08,TOR,LAL
98,Home,W 106-99 ,240,37,96,.385,30,76,.395,7,20,.350,25,29,.862,106,39,74,.527,30,54,.556,9,20,.450,12,14,.857,99,2013-12-11,MIN,PHI
99,@,L 106-111 (OT),265,42,96,.438,37,75,.493,5,21,.238,17,27,.630,106,38,84,.452,29,61,.475,9,23,.391,26,32,.813,111,2013-12-11,DET,NOP
0,Home,W 106-93 ,240,42,88,.477,32,64,.500,10,24,.417,12,18,.667,106,36,81,.444,31,64,.484,5,17,.294,16,19,.842,93,2013-12-14,DAL,MIL
1,@,L 106-111 ,240,40,66,.606,25,34,.735,15,32,.469,11,11,1.000,106,44,87,.506,36,68,.529,8,19,.421,15,18,.833,111,2013-12-14,ATL,NYK
2,Home,W 106-102 ,240,35,79,.443,22,52,.423,13,27,.481,23,34,.676,106,34,80,.425,23,58,.397,11,22,.500,23,33,.697,102,2013-12-15,PHO,GSW
3,Home,W 106-91 ,240,39,81,.481,36,68,.529,3,13,.231,25,30,.833,106,31,75,.413,24,48,.500,7,27,.259,22,38,.579,91,2013-12-15,SAC,HOU
4,Home,L 106-107 ,240,40,81,.494,34,63,.540,6,18,.333,20,22,.909,106,41,88,.466,31,61,.508,10,27,.370,15,20,.750,107,2013-12-18,BOS,DET
5,Home,L 106-116 ,240,42,90,.467,30,67,.448,12,23,.522,10,17,.588,106,44,84,.524,41,74,.554,3,10,.300,25,28,.893,116,2013-12-20,DET,CHA
6,@,W 106-99 ,240,41,87,.471,33,66,.500,8,21,.381,16,22,.727,106,42,87,.483,38,67,.567,4,20,.200,11,18,.611,99,2013-12-21,WAS,BOS
7,@,L 106-116 ,240,38,93,.409,28,70,.400,10,23,.435,20,22,.909,106,43,82,.524,36,57,.632,7,25,.280,23,25,.920,116,2013-12-21,PHI,MIL
8,Home,W 106-79 ,240,41,83,.494,32,64,.500,9,19,.474,15,22,.682,106,32,84,.381,26,70,.371,6,14,.429,9,13,.692,79,2013-12-22,IND,BOS
9,Home,W 106-82 ,240,43,86,.500,34,67,.507,9,19,.474,11,17,.647,106,31,77,.403,24,56,.429,7,21,.333,13,17,.765,82,2013-12-28,WAS,DET
10,@,W 106-99 ,240,39,78,.500,32,59,.542,7,19,.368,21,27,.778,106,36,82,.439,30,62,.484,6,20,.300,21,35,.600,99,2013-12-30,WAS,DET
11,Home,L 106-110 ,240,39,81,.481,32,53,.604,7,28,.250,21,33,.636,106,42,85,.494,35,63,.556,7,22,.318,19,23,.826,110,2013-12-31,HOU,SAC
12,Home,W 106-92 ,240,38,83,.458,29,64,.453,9,19,.474,21,22,.955,106,33,83,.398,28,63,.444,5,20,.250,21,24,.875,92,2014-01-18,IND,LAC
13,Home,L 106-112 ,240,44,90,.489,35,60,.583,9,30,.300,9,11,.818,106,37,80,.463,25,58,.431,12,22,.545,26,28,.929,112,2014-01-19,TOR,LAL
14,Home,L 106-110 ,240,37,82,.451,22,49,.449,15,33,.455,17,24,.708,106,42,88,.477,33,74,.446,9,14,.643,17,24,.708,110,2014-01-22,NYK,PHI
15,@,L 106-107 ,240,34,78,.436,24,58,.414,10,20,.500,28,33,.848,106,37,73,.507,27,46,.587,10,27,.370,23,28,.821,107,2014-01-24,DAL,BRK
16,@,L 106-116 ,240,43,91,.473,39,78,.500,4,13,.308,16,28,.571,106,43,74,.581,36,53,.679,7,21,.333,23,28,.821,116,2014-01-26,DET,DAL
17,Home,W 106-99 ,240,32,80,.400,25,60,.417,7,20,.350,35,53,.660,106,37,90,.411,32,68,.471,5,22,.227,20,26,.769,99,2014-01-27,UTA,SAC
18,Home,W 106-92 ,240,41,80,.513,34,54,.630,7,26,.269,17,24,.708,106,38,87,.437,30,57,.526,8,30,.267,8,10,.800,92,2014-02-01,HOU,CLE
19,@,W 106-91 ,240,41,76,.539,33,53,.623,8,23,.348,16,24,.667,106,33,67,.493,22,41,.537,11,26,.423,14,23,.609,91,2014-02-01,MIA,NYK
20,Home,W 106-103 ,240,35,76,.461,27,58,.466,8,18,.444,28,35,.800,106,40,87,.460,34,67,.507,6,20,.300,17,25,.680,103,2014-02-01,POR,TOR
21,Home,W 106-97 ,240,44,91,.484,34,64,.531,10,27,.370,8,11,.727,106,37,78,.474,31,58,.534,6,20,.300,17,23,.739,97,2014-02-05,OKC,MIN
22,@,W 106-101 (OT),265,40,85,.471,30,62,.484,10,23,.435,16,19,.842,106,41,90,.456,32,66,.485,9,24,.375,10,14,.714,101,2014-02-12,SAC,NYK
23,Home,L 106-117 ,240,34,85,.400,25,58,.431,9,27,.333,29,32,.906,106,44,77,.571,34,51,.667,10,26,.385,19,24,.792,117,2014-02-18,DAL,MIA
24,Home,W 106-85 ,240,42,82,.512,37,57,.649,5,25,.200,17,25,.680,106,29,83,.349,27,62,.435,2,21,.095,25,27,.926,85,2014-02-21,PHO,SAS
25,@,L 106-115 ,240,43,86,.500,35,61,.574,8,25,.320,12,14,.857,106,42,80,.525,32,64,.500,10,16,.625,21,28,.750,115,2014-02-25,ORL,WAS
26,@,L 106-112 ,240,45,97,.464,38,79,.481,7,18,.389,9,14,.643,106,39,84,.464,29,57,.509,10,27,.370,24,28,.857,112,2014-03-02,DAL,SAS
27,Home,L 106-107 ,240,43,96,.448,34,67,.507,9,29,.310,11,19,.579,106,43,94,.457,35,76,.461,8,18,.444,13,15,.867,107,2014-03-03,POR,LAL
28,Home,W 106-103 ,240,40,78,.513,32,55,.582,8,23,.348,18,27,.667,106,38,80,.475,31,53,.585,7,27,.259,20,29,.690,103,2014-03-04,HOU,MIA
29,Home,L 106-118 ,240,39,90,.433,32,64,.500,7,26,.269,21,24,.875,106,47,90,.522,36,63,.571,11,27,.407,13,19,.684,118,2014-03-05,MIN,NYK
30,Home,W 106-98 ,240,34,80,.425,23,51,.451,11,29,.379,27,34,.794,106,33,79,.418,24,54,.444,9,25,.360,23,34,.676,98,2014-03-11,OKC,HOU
31,@,L 106-129 ,240,38,87,.437,26,59,.441,12,28,.429,18,23,.783,106,49,85,.576,33,47,.702,16,38,.421,15,19,.789,129,2014-03-20,MIN,HOU
32,@,L 106-122 ,240,40,81,.494,27,51,.529,13,30,.433,13,21,.619,106,48,89,.539,36,67,.537,12,22,.545,14,17,.824,122,2014-03-21,DEN,DAL
33,@,W 106-100 ,240,42,69,.609,33,51,.647,9,18,.500,13,17,.765,106,35,77,.455,23,50,.460,12,27,.444,18,19,.947,100,2014-03-23,CLE,NYK
34,Home,W 106-98 ,240,38,78,.487,30,60,.500,8,18,.444,22,27,.815,106,41,85,.482,36,72,.500,5,13,.385,11,16,.688,98,2014-03-24,LAC,MIL
35,Home,W 106-94 ,240,40,81,.494,34,63,.540,6,18,.333,20,23,.870,106,38,88,.432,29,66,.439,9,22,.409,9,12,.750,94,2014-04-03,OKC,SAS
36,Home,W 106-103 ,240,41,79,.519,30,56,.536,11,23,.478,13,13,1.000,106,44,87,.506,37,69,.536,7,18,.389,8,12,.667,103,2014-04-11,BOS,CHA
37,Home,W 106-98 ,240,40,81,.494,35,62,.565,5,19,.263,21,23,.913,106,40,86,.465,35,69,.507,5,17,.294,13,23,.565,98,2014-04-11,CHI,DET
38,Home,W 106-103 ,240,41,82,.500,35,65,.538,6,17,.353,18,27,.667,106,35,88,.398,28,66,.424,7,22,.318,26,30,.867,103,2014-04-13,SAC,MIN
39,Home,W 106-105 (OT),265,43,88,.489,38,68,.559,5,20,.250,15,25,.600,106,44,92,.478,36,62,.581,8,30,.267,9,11,.818,105,2014-04-16,MEM,DAL
40,@,L 106-108 (OT),265,39,80,.488,32,66,.485,7,14,.500,21,24,.875,106,41,101,.406,35,80,.438,6,21,.286,20,29,.690,108,2014-10-29,MIL,CHO
41,Home,W 106-89 ,240,39,87,.448,28,58,.483,11,29,.379,17,22,.773,106,33,81,.407,31,65,.477,2,16,.125,21,26,.808,89,2014-10-29,POR,OKC
42,@,W 106-105 ,240,33,69,.478,24,46,.522,9,23,.391,31,40,.775,106,38,85,.447,34,73,.466,4,12,.333,25,31,.806,105,2014-11-01,CHI,MIN
43,Home,L 106-112 ,240,35,88,.398,29,72,.403,6,16,.375,30,41,.732,106,41,91,.451,35,73,.479,6,18,.333,24,31,.774,112,2014-11-04,LAL,PHO
44,@,W 106-101 ,240,42,81,.519,35,62,.565,7,19,.368,15,20,.750,106,42,92,.457,34,74,.459,8,18,.444,9,15,.600,101,2014-11-08,BOS,CHI
45,Home,W 106-102 ,240,40,81,.494,35,69,.507,5,12,.417,21,30,.700,106,36,80,.450,26,55,.473,10,25,.400,20,25,.800,102,2014-11-08,LAC,POR
46,Home,W 106-98 ,240,38,80,.475,28,53,.528,10,27,.370,20,24,.833,106,32,72,.444,23,53,.434,9,19,.474,25,32,.781,98,2014-11-11,DAL,SAC
47,@,W 106-97 ,240,41,85,.482,29,54,.537,12,31,.387,12,15,.800,106,34,79,.430,24,50,.480,10,29,.345,19,23,.826,97,2014-11-17,DEN,CLE
48,@,W 106-100 ,240,39,79,.494,30,55,.545,9,24,.375,19,24,.792,106,38,86,.442,34,75,.453,4,11,.364,20,29,.690,100,2014-11-18,NOP,SAC
49,@,L 106-140 ,240,44,85,.518,39,72,.542,5,13,.385,13,21,.619,106,51,82,.622,33,47,.702,18,35,.514,20,28,.714,140,2014-11-21,LAL,DAL
50,@,W 106-83 ,240,38,85,.447,26,54,.481,12,31,.387,18,20,.900,106,31,84,.369,24,61,.393,7,23,.304,14,20,.700,83,2014-11-22,PHO,IND
51,@,W 106-94 ,240,42,93,.452,38,76,.500,4,17,.235,18,22,.818,106,33,71,.465,28,57,.491,5,14,.357,23,29,.793,94,2014-11-22,NOP,UTA
52,Home,W 106-74 ,240,42,81,.519,36,65,.554,6,16,.375,16,22,.727,106,29,80,.363,24,63,.381,5,17,.294,11,15,.733,74,2014-11-24,CLE,ORL
53,@,W 106-102 ,240,36,85,.424,29,60,.483,7,25,.280,27,34,.794,106,36,84,.429,27,64,.422,9,20,.450,21,29,.724,102,2014-11-25,ATL,WAS
54,Home,W 106-100 ,240,41,74,.554,36,59,.610,5,15,.333,19,29,.655,106,40,87,.460,30,66,.455,10,21,.476,10,18,.556,100,2014-11-26,SAS,IND
55,@,W 106-101 ,240,42,99,.424,35,73,.479,7,26,.269,15,16,.938,106,38,87,.437,32,68,.471,6,19,.316,19,23,.826,101,2014-11-28,GSW,CHO
56,@,W 106-102 ,240,40,86,.465,29,60,.483,11,26,.423,15,22,.682,106,38,91,.418,24,58,.414,14,33,.424,12,16,.750,102,2014-11-28,DAL,TOR
57,@,W 106-96 ,240,39,81,.481,29,64,.453,10,17,.588,18,24,.750,106,33,90,.367,27,69,.391,6,21,.286,24,31,.774,96,2014-12-02,LAL,DET
58,Home,L 106-118 ,240,40,88,.455,36,69,.522,4,19,.211,22,30,.733,106,45,80,.563,32,54,.593,13,26,.500,15,17,.882,118,2014-12-05,DAL,PHO
59,@,L 106-115 ,240,43,88,.489,31,64,.484,12,24,.500,8,11,.727,106,44,88,.500,39,73,.534,5,15,.333,22,28,.786,115,2014-12-12,POR,CHI
60,Home,W 106-94 ,240,38,91,.418,28,65,.431,10,26,.385,20,22,.909,106,33,80,.413,25,58,.431,8,22,.364,20,23,.870,94,2014-12-12,TOR,IND
61,@,L 106-111 ,240,39,91,.429,25,62,.403,14,29,.483,14,19,.737,106,43,76,.566,36,65,.554,7,11,.636,18,24,.750,111,2014-12-13,LAC,MIL
62,Home,L 106-111 ,240,40,86,.465,30,62,.484,10,24,.417,16,22,.727,106,43,82,.524,34,57,.596,9,25,.360,16,21,.762,111,2014-12-17,CHO,PHO
63,Home,L 106-117 ,240,40,89,.449,27,56,.482,13,33,.394,13,19,.684,106,40,79,.506,30,57,.526,10,22,.455,27,35,.771,117,2014-12-17,DET,DAL
64,@,L 106-109 ,240,39,85,.459,36,67,.537,3,18,.167,25,33,.758,106,38,80,.475,27,51,.529,11,29,.379,22,30,.733,109,2014-12-19,LAC,DEN
65,Home,W 106-102 ,240,37,81,.457,25,55,.455,12,26,.462,20,27,.741,106,43,81,.531,35,57,.614,8,24,.333,8,15,.533,102,2014-12-20,LAC,MIL
66,Home,L 106-114 ,240,42,81,.519,35,58,.603,7,23,.304,15,21,.714,106,42,81,.519,33,66,.500,9,15,.600,21,38,.553,114,2014-12-25,SAS,OKC
67,Home,W 106-102 ,240,39,95,.411,36,76,.474,3,19,.158,25,32,.781,106,41,103,.398,38,88,.432,3,15,.200,17,24,.708,102,2014-12-26,DEN,MIN
68,Home,L 106-115 ,240,41,93,.441,34,73,.466,7,20,.350,17,24,.708,106,46,94,.489,32,61,.525,14,33,.424,9,12,.750,115,2014-12-26,SAC,PHO
69,@,L 106-110 ,240,38,77,.494,26,44,.591,12,33,.364,18,31,.581,106,39,83,.470,28,53,.528,11,30,.367,21,24,.875,110,2014-12-28,HOU,SAS
70,@,L 106-110 ,240,41,86,.477,32,65,.492,9,21,.429,15,19,.789,106,42,81,.519,34,63,.540,8,18,.444,18,29,.621,110,2014-12-30,PHO,NOP
71,Home,W 106-84 ,240,44,94,.468,39,73,.534,5,21,.238,13,15,.867,106,32,87,.368,30,72,.417,2,15,.133,18,28,.643,84,2014-12-31,BOS,SAC
72,Home,W 106-95 ,240,35,79,.443,25,61,.410,10,18,.556,26,30,.867,106,38,77,.494,33,61,.541,5,16,.313,14,18,.778,95,2014-12-31,IND,MIA
73,Home,W 106-101 ,240,38,91,.418,30,76,.395,8,15,.533,22,25,.880,106,37,92,.402,32,78,.410,5,14,.357,22,27,.815,101,2015-01-01,CHI,DEN
74,Home,L 106-109 ,240,43,81,.531,37,62,.597,6,19,.316,14,19,.737,106,41,84,.488,35,70,.500,6,14,.429,21,31,.677,109,2015-01-02,LAL,MEM
75,@,W 106-103 ,240,40,82,.488,30,59,.508,10,23,.435,16,24,.667,106,38,96,.396,25,53,.472,13,43,.302,14,18,.778,103,2015-01-09,ATL,DET
76,Home,W 106-95 ,240,37,81,.457,27,61,.443,10,20,.500,22,26,.846,106,36,82,.439,30,65,.462,6,17,.353,17,22,.773,95,2015-01-09,NOP,MEM
77,@,W 106-94 ,240,41,86,.477,28,55,.509,13,31,.419,11,17,.647,106,36,81,.444,29,59,.492,7,22,.318,15,19,.789,94,2015-01-11,POR,LAL
78,@,W 106-96 ,240,40,87,.460,37,73,.507,3,14,.214,23,29,.793,106,36,79,.456,27,55,.491,9,24,.375,15,20,.750,96,2015-01-16,MEM,ORL
79,Home,L 106-131 ,240,37,88,.420,30,65,.462,7,23,.304,25,34,.735,106,50,91,.549,41,69,.594,9,22,.409,22,33,.667,131,2015-01-17,HOU,GSW
80,Home,W 106-92 ,240,42,81,.519,37,57,.649,5,24,.208,17,25,.680,106,35,84,.417,27,62,.435,8,22,.364,14,18,.778,92,2015-01-21,CLE,UTA
81,@,L 106-113 ,240,44,87,.506,37,60,.617,7,27,.259,11,19,.579,106,43,91,.473,33,66,.500,10,25,.400,17,21,.810,113,2015-01-23,ORL,NYK
82,@,L 106-109 ,240,39,81,.481,30,57,.526,9,24,.375,19,25,.760,106,40,79,.506,32,62,.516,8,17,.471,21,25,.840,109,2015-01-25,DAL,NOP
83,@,W 106-99 ,240,43,83,.518,35,63,.556,8,20,.400,12,18,.667,106,38,78,.487,32,61,.525,6,17,.353,17,23,.739,99,2015-01-25,IND,ORL
84,Home,W 106-98 ,240,40,88,.455,29,59,.492,11,29,.379,15,18,.833,106,37,88,.420,29,70,.414,8,18,.444,16,23,.696,98,2015-01-28,PHO,WAS
85,Home,W 106-87 ,240,40,87,.460,28,55,.509,12,32,.375,14,18,.778,106,33,91,.363,24,65,.369,9,26,.346,12,17,.706,87,2015-01-31,GSW,PHO
86,@,W 106-90 ,240,42,87,.483,32,55,.582,10,32,.313,12,19,.632,106,34,82,.415,28,69,.406,6,13,.462,16,21,.762,90,2015-01-31,CLE,MIN
87,@,W 106-92 ,240,37,81,.457,25,56,.446,12,25,.480,20,24,.833,106,35,87,.402,27,69,.391,8,18,.444,14,17,.824,92,2015-02-07,GSW,NYK
88,@,W 106-78 ,240,37,83,.446,32,64,.500,5,19,.263,27,30,.900,106,29,81,.358,20,57,.351,9,24,.375,11,14,.786,78,2015-02-10,DET,CHO
89,@,W 106-96 ,240,43,79,.544,39,63,.619,4,16,.250,16,23,.696,106,37,85,.435,31,67,.463,6,18,.333,16,27,.593,96,2015-02-10,DEN,LAL
90,@,W 106-93 ,240,40,75,.533,31,55,.564,9,20,.450,17,18,.944,106,34,74,.459,27,59,.458,7,15,.467,18,25,.720,93,2015-02-11,IND,NOP
91,@,W 106-95 ,240,40,83,.482,32,61,.525,8,22,.364,18,22,.818,106,34,84,.405,26,59,.441,8,25,.320,19,29,.655,95,2015-02-20,IND,PHI
92,Home,W 106-89 ,240,37,89,.416,24,57,.421,13,32,.406,19,25,.760,106,37,85,.435,31,68,.456,6,17,.353,9,14,.643,89,2015-02-22,DET,WAS
93,Home,W 106-98 ,240,40,96,.417,26,61,.426,14,35,.400,12,15,.800,106,37,82,.451,27,61,.443,10,21,.476,14,17,.824,98,2015-02-27,BOS,CHO
94,@,W 106-101 ,240,40,95,.421,28,61,.459,12,34,.353,14,17,.824,106,40,109,.367,32,78,.410,8,31,.258,13,17,.765,101,2015-03-01,GSW,BOS
95,Home,W 106-95 ,240,39,86,.453,27,52,.519,12,34,.353,16,20,.800,106,35,86,.407,25,62,.403,10,24,.417,15,22,.682,95,2015-03-03,DEN,MIL
96,Home,W 106-97 ,240,43,84,.512,37,63,.587,6,21,.286,14,17,.824,106,29,69,.420,16,31,.516,13,38,.342,26,33,.788,97,2015-03-06,ATL,CLE
97,Home,W 106-98 ,240,40,80,.500,30,58,.517,10,22,.455,16,23,.696,106,40,83,.482,32,58,.552,8,25,.320,10,14,.714,98,2015-03-08,GSW,LAC
98,Home,W 106-78 ,240,38,87,.437,30,63,.476,8,24,.333,22,29,.759,106,29,75,.387,24,62,.387,5,13,.385,15,25,.600,78,2015-03-09,DEN,NYK
99,Home,L 106-113 ,240,42,93,.452,36,75,.480,6,18,.333,16,26,.615,106,40,85,.471,32,65,.492,8,20,.400,25,30,.833,113,2015-03-11,CHO,SAC
0,Home,W 106-97 ,240,45,90,.500,39,66,.591,6,24,.250,10,13,.769,106,36,81,.444,35,68,.515,1,13,.077,24,26,.923,97,2015-03-11,PHO,MIN
1,Home,W 106-92 ,240,42,76,.553,38,61,.623,4,15,.267,18,22,.818,106,30,79,.380,19,46,.413,11,33,.333,21,27,.778,92,2015-03-16,MIA,CLE
2,Home,L 106-122 ,240,41,88,.466,32,73,.438,9,15,.600,15,17,.882,106,52,90,.578,47,77,.610,5,13,.385,13,17,.765,122,2015-03-16,MIN,BRK
3,Home,W 106-91 ,240,38,78,.487,30,60,.500,8,18,.444,22,26,.846,106,32,73,.438,22,51,.431,10,22,.455,17,21,.810,91,2015-03-21,GSW,UTA
4,Home,W 106-89 ,240,39,75,.520,35,64,.547,4,11,.364,24,29,.828,106,35,84,.417,27,65,.415,8,19,.421,11,16,.688,89,2015-03-22,TOR,NYK
5,@,W 106-104 (OT),265,37,78,.474,25,59,.424,12,19,.632,20,25,.800,106,38,87,.437,29,59,.492,9,28,.321,19,31,.613,104,2015-03-23,MIN,UTA
6,@,L 106-107 ,240,40,81,.494,27,53,.509,13,28,.464,13,21,.619,106,35,97,.361,28,77,.364,7,20,.350,30,38,.789,107,2015-03-24,PHI,SAC
7,Home,W 106-98 ,240,40,86,.465,31,63,.492,9,23,.391,17,19,.895,106,37,81,.457,29,51,.569,8,30,.267,16,20,.800,98,2015-03-27,BRK,CLE
8,Home,L 106-119 ,240,39,93,.419,31,62,.500,8,31,.258,20,23,.870,106,41,84,.488,28,52,.538,13,32,.406,24,40,.600,119,2015-03-29,BOS,LAC
9,@,L 106-111 ,240,37,82,.451,25,59,.424,12,23,.522,20,24,.833,106,40,80,.500,31,62,.500,9,18,.500,22,28,.786,111,2015-03-31,IND,BRK
10,Home,L 106-110 ,240,36,82,.439,30,60,.500,6,22,.273,28,33,.848,106,38,85,.447,30,64,.469,8,21,.381,26,34,.765,110,2015-03-31,LAC,GSW
11,Home,W 106-93 ,240,44,76,.579,40,64,.625,4,12,.333,14,22,.636,106,36,91,.396,26,57,.456,10,34,.294,11,17,.647,93,2015-04-01,WAS,PHI
12,@,L 106-107 ,240,42,90,.467,37,71,.521,5,19,.263,17,26,.654,106,43,93,.462,33,67,.493,10,26,.385,11,17,.647,107,2015-04-02,PHO,GSW
13,@,W 106-78 ,240,40,75,.533,25,48,.521,15,27,.556,11,18,.611,106,29,75,.387,22,58,.379,7,17,.412,13,22,.591,78,2015-04-05,LAC,LAL
14,Home,W 106-96 ,240,41,91,.451,35,77,.455,6,14,.429,18,23,.783,106,39,87,.448,28,61,.459,11,26,.423,7,9,.778,96,2015-04-06,BRK,POR
15,Home,W 106-98 ,240,41,83,.494,32,60,.533,9,23,.391,15,24,.625,106,32,74,.432,29,59,.492,3,15,.200,31,34,.912,98,2015-04-10,LAL,MIN
16,Home,L 106-120 ,240,34,78,.436,25,54,.463,9,24,.375,29,36,.806,106,45,83,.542,35,62,.565,10,21,.476,20,26,.769,120,2015-04-12,LAL,DAL
17,@,W 106-94 ,240,37,96,.385,25,67,.373,12,29,.414,20,26,.769,106,37,82,.451,29,55,.527,8,27,.296,12,15,.800,94,2015-10-27,DET,ATL
18,@,W 106-76 ,240,41,84,.488,28,55,.509,13,29,.448,11,17,.647,106,29,82,.354,27,66,.409,2,16,.125,16,22,.727,76,2015-10-28,CLE,MEM
19,@,L 106-112 ,240,45,93,.484,40,78,.513,5,15,.333,11,13,.846,106,42,86,.488,35,67,.522,7,19,.368,21,22,.955,112,2015-10-28,SAS,OKC
20,Home,W 106-99 ,240,36,80,.450,29,62,.468,7,18,.389,27,39,.692,106,32,86,.372,23,63,.365,9,23,.391,26,31,.839,99,2015-10-28,TOR,IND
21,Home,W 106-87 ,240,41,90,.456,30,65,.462,11,25,.440,13,20,.650,106,29,69,.420,24,50,.480,5,19,.263,24,24,1.000,87,2015-11-01,TOR,MIL
22,@,W 106-101 ,240,41,89,.461,32,59,.542,9,30,.300,15,20,.750,106,34,79,.430,31,66,.470,3,13,.231,30,39,.769,101,2015-11-02,POR,MIN
23,@,W 106-88 ,240,46,87,.529,40,64,.625,6,23,.261,8,11,.727,106,34,84,.405,27,65,.415,7,19,.368,13,19,.684,88,2015-11-09,SAS,SAC
24,Home,W 106-98 ,240,42,86,.488,32,60,.533,10,26,.385,12,16,.750,106,37,83,.446,23,54,.426,14,29,.483,10,15,.667,98,2015-11-11,ATL,NOP
25,@,W 106-98 ,240,42,98,.429,34,81,.420,8,17,.471,14,17,.824,106,42,98,.429,34,64,.531,8,34,.235,6,12,.500,98,2015-11-11,BRK,HOU
26,Home,W 106-93 ,240,42,103,.408,31,70,.443,11,33,.333,11,12,.917,106,36,76,.474,30,56,.536,6,20,.300,15,20,.750,93,2015-11-13,BOS,ATL
27,Home,W 106-94 ,240,41,83,.494,32,52,.615,9,31,.290,15,19,.789,106,35,89,.393,30,68,.441,5,21,.238,19,21,.905,94,2015-11-15,CHO,POR
28,Home,L 106-114 ,240,41,82,.500,36,66,.545,5,16,.313,19,21,.905,106,40,71,.563,31,54,.574,9,17,.529,25,27,.926,114,2015-11-15,MIN,MEM
29,@,W 106-102 ,240,37,72,.514,30,52,.577,7,20,.350,25,35,.714,106,38,92,.413,30,66,.455,8,26,.308,18,24,.750,102,2015-11-18,DAL,BOS
30,Home,W 106-94 ,240,39,79,.494,29,50,.580,10,29,.345,18,24,.750,106,35,88,.398,28,66,.424,7,22,.318,17,23,.739,94,2015-11-20,GSW,CHI
31,Home,L 106-123 ,240,38,83,.458,25,50,.500,13,33,.394,17,24,.708,106,44,80,.550,25,54,.463,19,26,.731,16,23,.696,123,2015-11-24,WAS,IND
32,Home,W 106-100 ,240,39,90,.433,29,62,.468,10,28,.357,18,20,.900,106,37,93,.398,30,74,.405,7,19,.368,19,22,.864,100,2015-11-30,ATL,OKC
33,@,W 106-103 ,240,40,82,.488,26,53,.491,14,29,.483,12,15,.800,106,40,89,.449,34,70,.486,6,19,.316,17,22,.773,103,2015-11-30,GSW,UTA
34,@,W 106-105 ,240,38,81,.469,26,54,.481,12,27,.444,18,18,1.000,106,39,92,.424,31,65,.477,8,27,.296,19,22,.864,105,2015-12-03,DEN,TOR
35,@,L 106-109 ,240,43,84,.512,33,61,.541,10,23,.435,10,16,.625,106,40,82,.488,30,56,.536,10,26,.385,19,25,.760,109,2015-12-04,PHO,WAS
36,Home,W 106-91 ,240,44,89,.494,42,85,.494,2,4,.500,16,24,.667,106,32,76,.421,26,51,.510,6,25,.240,21,28,.750,91,2015-12-05,MIL,NYK
37,Home,L 106-110 ,240,36,82,.439,29,64,.453,7,18,.389,27,35,.771,106,38,86,.442,30,61,.492,8,25,.320,26,29,.897,110,2015-12-07,MIN,LAC
38,@,L 106-114 ,240,38,92,.413,23,56,.411,15,36,.417,15,22,.682,106,43,77,.558,33,49,.673,10,28,.357,18,24,.750,114,2015-12-08,UTA,SAC
39,Home,W 106-85 ,240,39,80,.488,30,59,.508,9,21,.429,19,23,.826,106,31,78,.397,23,57,.404,8,21,.381,15,27,.556,85,2015-12-09,UTA,NYK
40,@,W 106-96 ,240,45,96,.469,33,62,.532,12,34,.353,4,7,.571,106,36,83,.434,23,48,.479,13,35,.371,11,18,.611,96,2015-12-11,POR,PHO
41,Home,W 106-90 ,240,41,86,.477,31,64,.484,10,22,.455,14,16,.875,106,29,79,.367,19,51,.373,10,28,.357,22,26,.846,90,2015-12-14,IND,TOR
42,@,L 106-127 ,240,39,75,.520,27,49,.551,12,26,.462,16,24,.667,106,48,78,.615,38,57,.667,10,21,.476,21,24,.875,127,2015-12-16,PHI,ATL
43,Home,W 106-90 ,240,38,79,.481,36,65,.554,2,14,.143,28,37,.757,106,32,92,.348,21,66,.318,11,26,.423,15,18,.833,90,2015-12-16,OKC,POR
44,Home,W 106-97 ,240,37,77,.481,28,48,.583,9,29,.310,23,28,.821,106,38,81,.469,33,57,.579,5,24,.208,16,22,.727,97,2015-12-21,ATL,POR
45,Home,W 106-92 ,240,46,89,.517,40,69,.580,6,20,.300,8,9,.889,106,38,90,.422,31,71,.437,7,19,.368,9,15,.600,92,2015-12-21,SAS,IND
46,Home,L 106-108 ,240,41,89,.461,29,57,.509,12,32,.375,12,20,.600,106,46,89,.517,42,66,.636,4,23,.174,12,16,.750,108,2015-12-23,IND,SAC
47,@,L 106-110 ,240,43,82,.524,35,62,.565,8,20,.400,12,13,.923,106,42,80,.525,35,59,.593,7,21,.333,19,24,.792,110,2015-12-31,PHO,OKC
48,Home,W 106-82 ,240,46,82,.561,38,64,.594,8,18,.444,6,9,.667,106,32,88,.364,25,57,.439,7,31,.226,11,14,.786,82,2016-01-01,MIA,DAL
49,Home,L 106-112 ,240,34,80,.425,27,58,.466,7,22,.318,31,48,.646,106,40,78,.513,30,55,.545,10,23,.435,22,32,.688,112,2016-01-03,DEN,POR
50,@,L 106-117 ,240,46,102,.451,40,86,.465,6,16,.375,8,14,.571,106,46,83,.554,41,64,.641,5,19,.263,20,20,1.000,117,2016-01-05,MIL,CHI
51,@,W 106-79 ,240,44,82,.537,40,69,.580,4,13,.308,14,19,.737,106,33,73,.452,31,61,.508,2,12,.167,11,13,.846,79,2016-01-11,SAS,BRK
52,Home,W 106-101 ,240,43,93,.462,40,80,.500,3,13,.231,17,28,.607,106,35,85,.412,23,56,.411,12,29,.414,19,24,.792,101,2016-01-12,MIL,CHI
53,Home,W 106-101 ,240,38,84,.452,26,57,.456,12,27,.444,18,24,.750,106,38,72,.528,37,64,.578,1,8,.125,24,34,.706,101,2016-01-13,WAS,MIL
54,@,W 106-103 (OT),265,37,90,.411,29,66,.439,8,24,.333,24,31,.774,106,44,97,.454,35,74,.473,9,23,.391,6,8,.750,103,2016-01-14,TOR,ORL
55,Home,W 106-94 (OT),265,42,97,.433,37,72,.514,5,25,.200,17,22,.773,106,40,91,.440,35,68,.515,5,23,.217,9,11,.818,94,2016-01-20,DAL,MIN
56,Home,W 106-87 ,240,45,86,.523,40,70,.571,5,16,.313,11,13,.846,106,33,68,.485,26,53,.491,7,15,.467,14,18,.778,87,2016-01-20,WAS,MIA
57,Home,L 106-109 ,240,40,87,.460,30,54,.556,10,33,.303,16,18,.889,106,45,91,.495,37,61,.607,8,30,.267,11,15,.733,109,2016-01-22,DAL,OKC
58,Home,W 106-101 ,240,34,68,.500,29,51,.569,5,17,.294,33,36,.917,106,37,79,.468,28,60,.467,9,19,.474,18,22,.818,101,2016-01-23,MIN,MEM
59,@,L 106-116 ,240,43,93,.462,35,67,.522,8,26,.308,12,19,.632,106,45,94,.479,37,77,.481,8,17,.471,18,25,.720,116,2016-01-24,OKC,BRK
60,Home,W 106-89 ,240,35,79,.443,24,50,.480,11,29,.379,25,32,.781,106,32,78,.410,28,63,.444,4,15,.267,21,28,.750,89,2016-01-26,TOR,WAS
61,Home,L 106-114 ,240,40,84,.476,33,61,.541,7,23,.304,19,26,.731,106,39,83,.470,30,60,.500,9,23,.391,27,29,.931,114,2016-01-29,DET,CLE
62,Home,L 106-111 (OT),265,43,101,.426,35,74,.473,8,27,.296,12,14,.857,106,44,88,.500,37,66,.561,7,22,.318,16,23,.696,111,2016-02-01,IND,CLE
63,Home,W 106-97 ,240,39,79,.494,30,52,.577,9,27,.333,19,23,.826,106,38,83,.458,28,55,.509,10,28,.357,11,14,.786,97,2016-02-03,CHO,CLE
64,Home,W 106-94 ,240,44,84,.524,38,62,.613,6,22,.273,12,20,.600,106,37,87,.425,28,61,.459,9,26,.346,11,14,.786,94,2016-02-05,WAS,PHI
65,Home,W 106-102 ,240,39,88,.443,31,64,.484,8,24,.333,20,25,.800,106,34,86,.395,24,56,.429,10,30,.333,24,27,.889,102,2016-02-06,SAS,LAL
66,Home,L 106-112 (OT),265,43,86,.500,36,67,.537,7,19,.368,13,19,.684,106,44,89,.494,34,60,.567,10,29,.345,14,20,.700,112,2016-02-08,MEM,POR
67,Home,L 106-122 ,240,37,73,.507,36,62,.581,1,11,.091,31,39,.795,106,42,85,.494,27,52,.519,15,33,.455,23,30,.767,122,2016-02-08,PHO,OKC
68,Home,W 106-95 ,240,42,91,.462,35,67,.522,7,24,.292,15,17,.882,106,37,93,.398,29,72,.403,8,21,.381,13,22,.591,95,2016-02-18,CLE,CHI
69,@,L 106-116 ,240,38,88,.432,33,70,.471,5,18,.278,25,34,.735,106,48,93,.516,41,77,.532,7,16,.438,13,20,.650,116,2016-02-19,TOR,CHI
70,Home,L 106-111 ,240,37,89,.416,25,56,.446,12,33,.364,20,32,.625,106,41,86,.477,37,66,.561,4,20,.200,25,29,.862,111,2016-02-21,DET,NOP
71,Home,L 106-116 ,240,42,98,.429,33,71,.465,9,27,.333,13,23,.565,106,37,75,.493,29,57,.509,8,18,.444,34,42,.810,116,2016-02-25,PHO,BRK
72,@,L 106-111 ,240,32,80,.400,26,60,.433,6,20,.300,36,42,.857,106,37,80,.463,25,48,.521,12,32,.375,25,35,.714,111,2016-02-27,MEM,PHO
73,@,L 106-121 ,240,40,86,.465,36,66,.545,4,20,.200,22,27,.815,106,47,87,.540,36,53,.679,11,34,.324,16,21,.762,121,2016-03-03,OKC,GSW
74,@,W 106-77 ,240,37,68,.544,24,40,.600,13,28,.464,19,26,.731,106,29,85,.341,24,58,.414,5,27,.185,14,20,.700,77,2016-03-04,ATL,LAL
75,@,W 106-94 ,240,37,78,.474,31,58,.534,6,20,.300,26,27,.963,106,38,92,.413,29,73,.397,9,19,.474,9,11,.818,94,2016-03-05,UTA,NOP
76,@,W 106-103 ,240,41,86,.477,35,66,.530,6,20,.300,18,22,.818,106,36,80,.450,29,51,.569,7,29,.241,24,29,.828,103,2016-03-07,MEM,CLE
77,@,W 106-98 ,240,38,79,.481,34,61,.557,4,18,.222,26,33,.788,106,37,84,.440,32,58,.552,5,26,.192,19,26,.731,98,2016-03-15,SAC,LAL
78,Home,L 106-122 ,240,40,82,.488,31,57,.544,9,25,.360,17,24,.708,106,43,76,.566,31,46,.674,12,30,.400,24,32,.750,122,2016-03-16,HOU,LAC
79,Home,L 106-109 ,240,40,75,.533,33,58,.569,7,17,.412,19,24,.792,106,40,86,.465,27,60,.450,13,26,.500,16,21,.762,109,2016-03-17,MIA,CHO
80,Home,W 106-94 ,240,39,76,.513,26,46,.565,13,30,.433,15,16,.938,106,37,89,.416,31,64,.484,6,25,.240,14,18,.778,94,2016-03-24,NYK,CHI
81,@,W 106-100 ,240,38,79,.481,29,54,.537,9,25,.360,21,42,.500,106,31,86,.360,17,46,.370,14,40,.350,24,28,.857,100,2016-03-29,HOU,CLE
82,Home,L 106-109 ,240,38,83,.458,18,40,.450,20,43,.465,10,13,.769,106,41,87,.471,33,64,.516,8,23,.348,19,30,.633,109,2016-04-01,GSW,BOS
83,@,W 106-99 ,240,38,86,.442,28,60,.467,10,26,.385,20,25,.800,106,36,93,.387,29,70,.414,7,23,.304,20,26,.769,99,2016-04-01,WAS,PHO
84,Home,L 106-112 ,240,38,87,.437,31,66,.470,7,21,.333,23,29,.793,106,42,82,.512,30,60,.500,12,22,.545,16,17,.941,112,2016-04-01,SAC,MIA
85,Home,L 106-115 ,240,40,92,.435,31,63,.492,9,29,.310,17,24,.708,106,41,88,.466,33,67,.493,8,21,.381,25,31,.806,115,2016-04-02,DEN,SAC
86,@,W 106-87 ,240,42,76,.553,34,54,.630,8,22,.364,14,23,.609,106,33,85,.388,25,62,.403,8,23,.348,13,21,.619,87,2016-04-03,NOP,BRK
87,Home,W 106-98 ,240,44,92,.478,40,78,.513,4,14,.286,14,17,.824,106,35,78,.449,32,64,.500,3,14,.214,25,28,.893,98,2016-04-07,MIA,CHI
88,@,W 106-105 ,240,41,84,.488,36,71,.507,5,13,.385,19,25,.760,106,40,80,.500,31,56,.554,9,24,.375,16,18,.889,105,2016-04-09,MIN,POR
89,Home,L 106-114 ,240,39,85,.459,35,67,.522,4,18,.222,24,32,.750,106,37,91,.407,29,62,.468,8,29,.276,32,46,.696,114,2016-10-27,POR,LAC
90,@,W 106-98 ,240,33,70,.471,18,38,.474,15,32,.469,25,31,.806,106,35,80,.438,27,51,.529,8,29,.276,20,24,.833,98,2016-10-28,HOU,DAL
91,Home,W 106-103 ,240,39,85,.459,30,59,.508,9,26,.346,19,25,.760,106,37,70,.529,30,48,.625,7,22,.318,22,31,.710,103,2016-10-29,SAC,MIN
92,@,W 106-99 ,240,37,82,.451,27,64,.422,10,18,.556,22,26,.846,106,37,80,.463,30,60,.500,7,20,.350,18,26,.692,99,2016-10-30,SAS,MIA
93,@,W 106-100 ,240,35,83,.422,27,54,.500,8,29,.276,28,33,.848,106,37,90,.411,29,67,.433,8,23,.348,18,25,.720,100,2016-10-30,GSW,PHO
94,Home,W 106-95 ,240,33,79,.418,22,49,.449,11,30,.367,29,47,.617,106,36,75,.480,26,52,.500,10,23,.435,13,19,.684,95,2016-10-31,ATL,SAC
95,@,W 106-91 ,240,38,76,.500,23,45,.511,15,31,.484,15,18,.833,106,33,76,.434,27,56,.482,6,20,.300,19,21,.905,91,2016-11-01,UTA,SAS
96,@,L 106-116 ,240,39,80,.488,32,59,.542,7,21,.333,21,27,.778,106,45,90,.500,29,55,.527,16,35,.457,10,12,.833,116,2016-11-07,NOP,GSW
97,Home,L 106-114 ,240,39,94,.415,29,67,.433,10,27,.370,18,20,.900,106,41,79,.519,24,42,.571,17,37,.459,15,18,.833,114,2016-11-07,WAS,HOU
98,Home,L 106-110 ,240,37,99,.374,26,57,.456,11,42,.262,21,25,.840,106,41,81,.506,30,52,.577,11,29,.379,17,24,.708,110,2016-11-08,CLE,ATL
99,Home,L 106-112 ,240,40,91,.440,34,73,.466,6,18,.333,20,25,.800,106,39,89,.438,30,64,.469,9,25,.360,25,27,.926,112,2016-11-10,MIL,NOP
0,Home,W 106-95 ,240,39,97,.402,34,82,.415,5,15,.333,23,25,.920,106,38,91,.418,34,78,.436,4,13,.308,15,18,.833,95,2016-11-12,CHI,WAS
1,@,W 106-95 ,240,46,90,.511,42,72,.583,4,18,.222,10,14,.714,106,36,84,.429,27,59,.458,9,25,.360,14,19,.737,95,2016-11-12,DET,DEN
2,@,W 106-100 ,240,41,76,.539,36,58,.621,5,18,.278,19,24,.792,106,34,89,.382,19,42,.452,15,47,.319,17,21,.810,100,2016-11-12,SAS,HOU
3,Home,W 106-96 ,240,36,68,.529,29,50,.580,7,18,.389,27,36,.750,106,35,78,.449,29,48,.604,6,30,.200,20,21,.952,96,2016-11-12,MIL,MEM
4,Home,W 106-105 ,240,35,79,.443,29,58,.500,6,21,.286,30,36,.833,106,38,95,.400,26,54,.481,12,41,.293,17,20,.850,105,2016-11-14,NOP,BOS
5,Home,W 106-101 ,240,37,91,.407,27,63,.429,10,28,.357,22,34,.647,106,39,91,.429,28,64,.438,11,27,.407,12,15,.800,101,2016-11-21,WAS,PHO
6,@,L 106-149 ,240,40,93,.430,32,73,.438,8,20,.400,18,22,.818,106,53,86,.616,34,50,.680,19,36,.528,24,35,.686,149,2016-11-23,LAL,GSW
7,Home,W 106-88 ,240,42,83,.506,34,60,.567,8,23,.348,14,26,.538,106,37,82,.451,36,63,.571,1,19,.053,13,17,.765,88,2016-11-26,OKC,DET
8,@,W 106-98 ,240,41,93,.441,32,69,.464,9,24,.375,15,26,.577,106,38,91,.418,31,69,.449,7,22,.318,15,24,.625,98,2016-11-30,MIA,DEN
9,@,W 106-104 ,240,41,91,.451,28,59,.475,13,32,.406,11,15,.733,106,34,77,.442,30,58,.517,4,19,.211,32,39,.821,104,2016-11-30,NYK,MIN
10,Home,L 106-107 ,240,35,76,.461,20,43,.465,15,33,.455,21,26,.808,106,38,76,.500,30,50,.600,8,26,.308,23,29,.793,107,2016-12-03,PHI,BOS
11,Home,W 106-98 ,240,39,88,.443,28,59,.475,11,29,.379,17,24,.708,106,31,97,.320,22,69,.319,9,28,.321,27,31,.871,98,2016-12-04,NYK,SAC
12,@,L 106-142 ,240,35,85,.412,32,70,.457,3,15,.200,33,35,.943,106,54,104,.519,40,67,.597,14,37,.378,20,26,.769,142,2016-12-05,IND,GSW
13,@,L 106-107 ,240,42,99,.424,31,67,.463,11,32,.344,11,12,.917,106,34,76,.447,22,38,.579,12,38,.316,27,31,.871,107,2016-12-05,BOS,HOU
14,@,W 106-98 ,240,35,76,.461,25,49,.510,10,27,.370,26,34,.765,106,35,86,.407,24,55,.436,11,31,.355,17,23,.739,98,2016-12-05,DEN,PHI
15,@,W 106-99 ,240,39,80,.488,27,51,.529,12,29,.414,16,23,.696,106,37,89,.416,27,51,.529,10,38,.263,15,21,.714,99,2016-12-08,GSW,UTA
16,@,L 106-109 ,240,38,74,.514,24,41,.585,14,33,.424,16,21,.762,106,45,87,.517,40,69,.580,5,18,.278,14,17,.824,109,2016-12-14,CHO,WAS
17,Home,W 106-101 ,240,39,83,.470,28,55,.509,11,28,.393,17,22,.773,106,37,92,.402,31,73,.425,6,19,.316,21,25,.840,101,2016-12-22,LAC,SAS
18,Home,W 106-95 ,240,41,96,.427,32,76,.421,9,20,.450,15,17,.882,106,39,90,.433,34,63,.540,5,27,.185,12,16,.750,95,2016-12-22,NYK,ORL
19,Home,W 106-90 ,240,41,92,.446,25,64,.391,16,28,.571,8,15,.533,106,30,79,.380,19,51,.373,11,28,.393,19,23,.826,90,2016-12-26,DET,CLE
20,@,W 106-102 ,240,36,82,.439,25,51,.490,11,31,.355,23,28,.821,106,39,84,.464,30,59,.508,9,25,.360,15,20,.750,102,2016-12-26,DEN,LAC
21,@,W 106-94 ,240,42,82,.512,37,63,.587,5,19,.263,17,25,.680,106,36,82,.439,29,59,.492,7,23,.304,15,21,.714,94,2016-12-27,OKC,MIA
22,@,W 106-94 ,240,41,85,.482,28,55,.509,13,30,.433,11,15,.733,106,34,83,.410,26,58,.448,8,25,.320,18,24,.750,94,2017-01-04,CHI,CLE
23,@,L 106-115 ,240,38,88,.432,27,60,.450,11,28,.393,19,25,.760,106,37,73,.507,28,50,.560,9,23,.391,32,45,.711,115,2017-01-04,MEM,LAC
24,@,L 106-110 ,240,37,79,.468,28,51,.549,9,28,.321,23,26,.885,106,35,87,.402,16,47,.340,19,40,.475,21,25,.840,110,2017-01-06,PHI,BOS
25,@,W 106-98 ,240,39,84,.464,26,53,.491,13,31,.419,15,21,.714,106,36,87,.414,27,57,.474,9,30,.300,17,22,.773,98,2017-01-06,LAC,SAC
26,@,L 106-121 ,240,40,99,.404,31,75,.413,9,24,.375,17,24,.708,106,43,89,.483,31,53,.585,12,36,.333,23,29,.793,121,2017-01-07,DEN,OKC
27,Home,L 106-117 ,240,36,74,.486,25,46,.543,11,28,.393,23,29,.793,106,45,89,.506,35,60,.583,10,29,.345,17,20,.850,117,2017-01-08,SAC,GSW
28,@,L 106-114 ,240,40,85,.471,31,58,.534,9,27,.333,17,20,.850,106,41,87,.471,31,65,.477,10,22,.455,22,27,.815,114,2017-01-10,BOS,TOR
29,@,W 106-101 ,240,41,89,.461,33,66,.500,8,23,.348,16,24,.667,106,40,81,.494,35,59,.593,5,22,.227,16,17,.941,101,2017-01-16,UTA,PHO
30,Home,L 106-117 ,240,35,91,.385,26,58,.448,9,33,.273,27,29,.931,106,46,91,.505,36,66,.545,10,25,.400,15,18,.833,117,2017-01-18,BOS,NYK
31,@,W 106-100 ,240,39,75,.520,32,54,.593,7,21,.333,21,25,.840,106,35,72,.486,26,51,.510,9,21,.429,21,27,.778,100,2017-01-18,IND,SAC
32,Home,L 106-108 ,240,38,84,.452,32,59,.542,6,25,.240,24,28,.857,106,38,85,.447,31,61,.508,7,24,.292,25,33,.758,108,2017-01-24,TOR,SAS
33,Home,L 106-109 ,240,35,80,.438,22,45,.489,13,35,.371,23,26,.885,106,40,83,.482,29,60,.483,11,23,.478,18,25,.720,109,2017-01-25,BRK,MIA
34,Home,L 106-109 ,240,36,75,.480,24,38,.632,12,37,.324,22,24,.917,106,41,79,.519,30,52,.577,11,27,.407,16,26,.615,109,2017-01-28,CHO,SAC
35,@,L 106-108 (OT),265,40,94,.426,28,64,.438,12,30,.400,14,19,.737,106,43,94,.457,33,63,.524,10,31,.323,12,15,.800,108,2017-01-31,NOP,TOR
36,@,W 106-97 ,240,37,86,.430,29,66,.439,8,20,.400,24,31,.774,106,32,86,.372,21,58,.362,11,28,.393,22,23,.957,97,2017-02-03,IND,BRK
37,@,L 106-109 (OT),265,36,87,.414,21,43,.488,15,44,.341,19,24,.792,106,43,88,.489,36,65,.554,7,23,.304,16,19,.842,109,2017-02-04,GSW,SAC
38,@,L 106-111 ,240,40,93,.430,35,66,.530,5,27,.185,21,25,.840,106,42,92,.457,33,66,.500,9,26,.346,18,22,.818,111,2017-02-06,PHO,NOP
39,@,L 106-117 ,240,40,100,.400,27,56,.482,13,44,.295,13,21,.619,106,47,93,.505,39,66,.591,8,27,.296,15,18,.833,117,2017-02-08,DEN,ATL
40,@,W 106-88 ,240,41,86,.477,30,53,.566,11,33,.333,13,18,.722,106,33,71,.465,27,56,.482,6,15,.400,16,28,.571,88,2017-02-08,MIA,MIL
41,Home,L 106-122 ,240,38,82,.463,32,55,.582,6,27,.222,24,32,.750,106,45,75,.600,33,50,.660,12,25,.480,20,27,.741,122,2017-02-10,MIN,NOP
42,Home,L 106-110 ,240,38,78,.487,29,58,.500,9,20,.450,21,30,.700,106,40,87,.460,33,72,.458,7,15,.467,23,27,.852,110,2017-02-13,IND,SAS
43,@,L 106-112 ,240,35,79,.443,26,58,.448,9,21,.429,27,35,.771,106,42,78,.538,35,58,.603,7,20,.350,21,27,.778,112,2017-02-26,POR,TOR
44,@,L 106-109 ,240,43,93,.462,34,71,.479,9,22,.409,11,13,.846,106,39,76,.513,24,54,.444,15,22,.682,16,23,.696,109,2017-02-28,UTA,OKC
45,Home,L 106-114 ,240,34,92,.370,24,62,.387,10,30,.333,28,32,.875,106,41,81,.506,30,56,.536,11,25,.440,21,27,.778,114,2017-03-03,WAS,TOR
46,Home,L 106-136 ,240,43,88,.489,29,54,.537,14,34,.412,6,7,.857,106,54,95,.568,44,72,.611,10,23,.435,18,21,.857,136,2017-03-04,PHI,DET
47,@,L 106-109 ,240,32,85,.376,19,48,.396,13,37,.351,29,40,.725,106,42,94,.447,38,74,.514,4,20,.200,21,26,.808,109,2017-03-05,BOS,PHO
48,@,W 106-98 ,240,39,91,.429,23,56,.411,16,35,.457,12,14,.857,106,35,78,.449,26,51,.510,9,27,.333,19,29,.655,98,2017-03-06,MIA,CLE
49,Home,W 106-101 ,240,41,87,.471,32,61,.525,9,26,.346,15,19,.789,106,39,84,.464,28,45,.622,11,39,.282,12,19,.632,101,2017-03-09,DET,CLE
50,@,W 105-94 ,240,38,78,.487,34,71,.479,4,7,.571,25,36,.694,105,31,82,.378,22,54,.407,9,28,.321,23,30,.767,94,2011-12-25,MIA,DAL
51,@,W 105-86 ,240,37,81,.457,29,58,.500,8,23,.348,23,38,.605,105,32,82,.390,27,61,.443,5,21,.238,17,24,.708,86,2011-12-25,LAC,GSW
52,@,W 105-89 ,240,40,70,.571,33,58,.569,7,12,.583,18,22,.818,105,36,81,.444,27,60,.450,9,21,.429,8,11,.727,89,2011-12-28,CLE,DET
53,Home,W 105-85 ,240,43,85,.506,34,59,.576,9,26,.346,10,13,.769,105,35,93,.376,33,76,.434,2,17,.118,13,20,.650,85,2011-12-29,HOU,SAS
54,Home,W 105-98 ,240,37,77,.481,33,62,.532,4,15,.267,27,38,.711,105,38,82,.463,29,62,.468,9,20,.450,13,14,.929,98,2011-12-30,ATL,NJN
55,Home,W 105-97 ,240,37,72,.514,32,58,.552,5,14,.357,26,32,.813,105,37,83,.446,31,60,.517,6,23,.261,17,24,.708,97,2012-01-10,POR,LAC
56,@,L 105-113 ,240,35,78,.449,31,58,.534,4,20,.200,31,43,.721,105,45,76,.592,42,66,.636,3,10,.300,20,29,.690,113,2012-01-10,CLE,UTA
57,@,L 105-107 (OT),265,37,90,.411,28,64,.438,9,26,.346,22,31,.710,105,39,93,.419,34,75,.453,5,18,.278,24,28,.857,107,2012-01-14,POR,HOU
58,@,W 105-95 ,240,41,94,.436,32,75,.427,9,19,.474,14,19,.737,105,35,82,.427,30,67,.448,5,15,.333,20,28,.714,95,2012-01-17,GSW,CLE
59,@,W 105-95 ,240,32,75,.427,20,50,.400,12,25,.480,29,37,.784,105,38,91,.418,31,68,.456,7,23,.304,12,14,.857,95,2012-01-17,DEN,MIL
60,Home,W 105-102 ,240,33,86,.384,25,65,.385,8,21,.381,31,43,.721,105,37,77,.481,33,58,.569,4,19,.211,24,30,.800,102,2012-01-18,WAS,OKC
61,Home,W 105-102 ,240,44,79,.557,38,57,.667,6,22,.273,11,12,.917,105,42,94,.447,35,72,.486,7,22,.318,11,15,.733,102,2012-01-21,HOU,SAS
62,@,W 105-90 ,240,34,77,.442,25,56,.446,9,21,.429,28,33,.848,105,39,95,.411,33,73,.452,6,22,.273,6,10,.600,90,2012-01-25,MIN,DAL
63,@,W 105-99 ,240,39,91,.429,25,62,.403,14,29,.483,13,17,.765,105,38,93,.409,30,62,.484,8,31,.258,15,20,.750,99,2012-01-25,MIL,HOU
64,Home,W 105-83 ,240,42,82,.512,31,59,.525,11,23,.478,10,15,.667,105,35,80,.438,29,63,.460,6,17,.353,7,10,.700,83,2012-01-25,SAS,ATL
65,Home,L 105-109 ,240,42,85,.494,36,67,.537,6,18,.333,15,20,.750,105,39,86,.453,25,56,.446,14,30,.467,17,26,.654,109,2012-01-29,DEN,LAC
66,Home,W 105-97 ,240,39,88,.443,29,65,.446,10,23,.435,17,25,.680,105,34,73,.466,25,53,.472,9,20,.450,20,24,.833,97,2012-02-01,MIL,MIA
67,Home,L 105-107 ,240,38,81,.469,35,70,.500,3,11,.273,26,36,.722,105,42,87,.483,37,65,.569,5,22,.227,18,23,.783,107,2012-02-01,UTA,LAC
68,@,W 105-102 ,240,39,74,.527,33,62,.532,6,12,.500,21,29,.724,105,44,90,.489,40,74,.541,4,16,.250,10,14,.714,102,2012-02-02,CHI,NYK
69,Home,L 105-108 ,240,38,86,.442,28,65,.431,10,21,.476,19,24,.792,105,36,82,.439,29,66,.439,7,16,.438,29,32,.906,108,2012-02-03,NJN,MIN
70,Home,L 105-107 ,240,39,81,.481,30,61,.492,9,20,.450,18,20,.900,105,45,94,.479,36,69,.522,9,25,.360,8,8,1.000,107,2012-02-07,MIL,PHO
71,@,W 105-95 ,240,44,90,.489,35,62,.565,9,28,.321,8,9,.889,105,33,72,.458,24,46,.522,9,26,.346,20,27,.741,95,2012-02-08,DAL,DEN
72,@,W 105-99 ,240,33,72,.458,21,47,.447,12,25,.480,27,37,.730,105,37,90,.411,28,66,.424,9,24,.375,16,17,.941,99,2012-02-08,MIL,TOR
73,@,W 105-90 ,240,35,70,.500,30,57,.526,5,13,.385,30,35,.857,105,33,76,.434,31,61,.508,2,15,.133,22,29,.759,90,2012-02-14,MIA,IND
74,@,W 105-100 ,240,41,88,.466,35,73,.479,6,15,.400,17,20,.850,105,37,72,.514,26,45,.578,11,27,.407,15,15,1.000,100,2012-02-15,MEM,NJN
75,@,W 105-102 ,240,38,74,.514,30,56,.536,8,18,.444,21,27,.778,105,40,84,.476,31,59,.525,9,25,.360,13,19,.684,102,2012-03-01,OKC,ORL
76,Home,L 105-117 ,240,36,76,.474,26,47,.553,10,29,.345,23,29,.793,105,43,97,.443,35,75,.467,8,22,.364,23,35,.657,117,2012-03-02,HOU,DEN
77,Home,W 105-83 ,240,42,89,.472,34,72,.472,8,17,.471,13,16,.813,105,33,82,.402,28,64,.438,5,18,.278,12,14,.857,83,2012-03-02,PHI,GSW
78,@,W 105-103 (OT),265,40,86,.465,34,72,.472,6,14,.429,19,25,.760,105,37,86,.430,27,66,.409,10,20,.500,19,24,.792,103,2012-03-04,LAC,HOU
79,@,L 105-118 ,240,41,96,.427,31,68,.456,10,28,.357,13,17,.765,105,46,85,.541,39,66,.591,7,19,.368,19,25,.760,118,2012-03-07,NYK,SAS
80,@,W 105-102 ,240,39,82,.476,33,64,.516,6,18,.333,21,27,.778,105,37,81,.457,29,61,.475,8,20,.400,20,26,.769,102,2012-03-09,LAL,MIN
81,Home,W 105-86 ,240,39,74,.527,32,53,.604,7,21,.333,20,25,.800,105,29,73,.397,24,52,.462,5,21,.238,23,25,.920,86,2012-03-10,DET,TOR
82,@,W 105-99 ,240,35,73,.479,29,55,.527,6,18,.333,29,35,.829,105,40,86,.465,36,73,.493,4,13,.308,15,19,.789,99,2012-03-11,MIL,TOR
83,@,W 105-99 ,240,43,92,.467,33,67,.493,10,25,.400,9,11,.818,105,37,76,.487,33,59,.559,4,17,.235,21,29,.724,99,2012-03-12,MIL,NJN
84,Home,W 105-90 ,240,39,72,.542,32,61,.525,7,11,.636,20,26,.769,105,34,71,.479,31,59,.525,3,12,.250,19,28,.679,90,2012-03-12,UTA,DET
85,@,W 105-103 ,240,40,78,.513,34,65,.523,6,13,.462,19,21,.905,105,41,78,.526,36,57,.632,5,21,.238,16,19,.842,103,2012-03-14,BOS,GSW
86,@,L 105-115 ,240,38,85,.447,27,61,.443,11,24,.458,18,25,.720,105,46,86,.535,39,63,.619,7,23,.304,16,21,.762,115,2012-03-14,CLE,MIL
87,@,L 105-111 (OT),265,36,83,.434,27,56,.482,9,27,.333,24,33,.727,105,43,103,.417,38,90,.422,5,13,.385,20,27,.741,111,2012-03-15,MIN,UTA
88,Home,L 105-114 ,240,39,88,.443,30,63,.476,9,25,.360,18,20,.900,105,45,87,.517,36,68,.529,9,19,.474,15,25,.600,114,2012-03-16,OKC,SAS
89,@,W 105-80 ,240,46,86,.535,41,75,.547,5,11,.455,8,9,.889,105,29,75,.387,27,67,.403,2,8,.250,20,28,.714,80,2012-03-19,PHI,CHA
90,@,W 105-100 ,240,41,89,.461,36,74,.486,5,15,.333,18,27,.667,105,34,81,.420,28,58,.483,6,23,.261,26,31,.839,100,2012-03-19,CLE,NJN
91,Home,W 105-90 ,240,37,81,.457,27,63,.429,10,18,.556,21,28,.750,105,29,69,.420,21,49,.429,8,20,.400,24,37,.649,90,2012-03-26,IND,MIA
92,@,W 105-84 ,240,42,81,.519,37,67,.552,5,14,.357,16,18,.889,105,29,81,.358,24,60,.400,5,21,.238,21,35,.600,84,2012-03-26,UTA,NJN
93,Home,W 105-96 ,240,35,86,.407,23,64,.359,12,22,.545,23,33,.697,105,33,80,.413,28,60,.467,5,20,.250,25,30,.833,96,2012-03-28,TOR,DEN
94,Home,W 105-96 ,240,39,72,.542,29,51,.569,10,21,.476,17,24,.708,105,35,77,.455,31,65,.477,4,12,.333,22,31,.710,96,2012-03-31,LAC,UTA
95,Home,L 105-107 ,240,40,79,.506,37,70,.529,3,9,.333,22,28,.786,105,41,91,.451,28,60,.467,13,31,.419,12,22,.545,107,2012-04-04,UTA,PHO
96,Home,W 105-99 ,240,37,92,.402,26,65,.400,11,27,.407,20,31,.645,105,34,82,.415,26,60,.433,8,22,.364,23,29,.793,99,2012-04-06,DEN,PHO
97,@,L 105-125 ,240,47,97,.485,46,88,.523,1,9,.111,10,18,.556,105,47,94,.500,33,65,.508,14,29,.483,17,21,.810,125,2012-04-07,LAL,PHO
98,Home,W 105-96 ,240,38,68,.559,34,59,.576,4,9,.444,25,36,.694,105,36,83,.434,29,61,.475,7,22,.318,17,23,.739,96,2012-04-11,NOH,SAC
99,Home,L 105-112 ,240,36,84,.429,32,65,.492,4,19,.211,29,33,.879,105,38,77,.494,30,59,.508,8,18,.444,28,33,.848,112,2012-04-13,HOU,PHO
0,Home,W 105-82 ,240,44,85,.518,42,71,.592,2,14,.143,15,17,.882,105,33,74,.446,28,57,.491,5,17,.294,11,19,.579,82,2012-04-13,MIA,CHA
1,@,W 105-99 ,240,37,92,.402,30,73,.411,7,19,.368,24,26,.923,105,37,84,.440,28,61,.459,9,23,.391,16,26,.615,99,2012-04-14,IND,MIL
2,Home,W 105-91 ,240,40,76,.526,31,58,.534,9,18,.500,16,19,.842,105,38,96,.396,36,80,.450,2,16,.125,13,18,.722,91,2012-04-14,SAS,PHO
3,@,W 105-102 ,240,38,80,.475,29,62,.468,9,18,.500,20,29,.690,105,40,94,.426,32,65,.492,8,29,.276,14,17,.824,102,2012-04-16,DEN,HOU
4,Home,W 105-99 (OT),265,41,87,.471,37,67,.552,4,20,.200,19,24,.792,105,37,89,.416,26,58,.448,11,31,.355,14,25,.560,99,2012-04-19,NOH,HOU
5,@,W 105-87 ,240,43,80,.538,38,66,.576,5,14,.357,14,17,.824,105,31,72,.431,27,58,.466,4,14,.286,21,23,.913,87,2012-04-23,PHI,NJN
6,@,W 105-96 ,240,39,79,.494,29,52,.558,10,27,.370,17,23,.739,105,35,79,.443,29,63,.460,6,16,.375,20,26,.769,96,2012-10-31,HOU,DET
7,@,W 105-95 ,240,38,84,.452,30,62,.484,8,22,.364,21,27,.778,105,34,68,.500,27,52,.519,7,16,.438,20,28,.714,95,2012-11-02,LAC,LAL
8,Home,W 105-102 ,240,41,79,.519,32,55,.582,9,24,.375,14,21,.667,105,39,83,.470,33,67,.493,6,16,.375,18,29,.621,102,2012-11-03,MIL,CLE
9,Home,W 105-86 ,240,40,90,.444,30,69,.435,10,21,.476,15,17,.882,105,29,64,.453,23,48,.479,6,16,.375,22,31,.710,86,2012-11-04,TOR,MIN
10,Home,W 105-103 ,240,40,82,.488,33,66,.500,7,16,.438,18,24,.750,105,36,73,.493,28,51,.549,8,22,.364,23,31,.742,103,2012-11-07,SAC,DET
11,Home,W 105-94 ,240,38,71,.535,30,51,.588,8,20,.400,21,26,.808,105,36,87,.414,30,68,.441,6,19,.316,16,22,.727,94,2012-11-09,OKC,DET
12,@,L 105-107 ,240,37,77,.481,28,56,.500,9,21,.429,22,27,.815,105,38,81,.469,32,64,.500,6,17,.353,25,33,.758,107,2012-11-09,CLE,PHO
13,@,W 105-96 ,240,41,80,.513,34,60,.567,7,20,.350,16,18,.889,105,37,85,.435,27,61,.443,10,24,.417,12,16,.750,96,2012-11-12,MIL,PHI
14,Home,W 105-95 ,240,37,76,.487,32,61,.525,5,15,.333,26,32,.813,105,37,72,.514,32,53,.604,5,19,.263,16,21,.762,95,2012-11-16,MEM,NYK
15,@,W 105-101 (OT),265,37,91,.407,28,67,.418,9,24,.375,22,30,.733,105,37,86,.430,27,65,.415,10,21,.476,17,24,.708,101,2012-11-19,GSW,DAL
16,@,W 105-98 ,240,36,71,.507,21,46,.457,15,25,.600,18,23,.783,105,37,79,.468,19,42,.452,18,37,.486,6,11,.545,98,2012-11-26,NOH,LAC
17,Home,W 105-103 ,240,36,78,.462,28,56,.500,8,22,.364,25,34,.735,105,40,73,.548,35,59,.593,5,14,.357,18,32,.563,103,2012-11-26,UTA,DEN
18,@,L 105-106 ,240,38,84,.452,28,63,.444,10,21,.476,19,24,.792,105,44,86,.512,36,68,.529,8,18,.444,10,13,.769,106,2012-11-29,DEN,GSW
19,Home,W 105-100 ,240,42,86,.488,37,73,.507,5,13,.385,16,19,.842,105,36,80,.450,26,50,.520,10,30,.333,18,24,.750,100,2012-11-29,MIA,SAS
20,@,W 105-104 ,240,42,89,.472,38,68,.559,4,21,.190,17,24,.708,105,42,74,.568,33,54,.611,9,20,.450,11,15,.733,104,2012-12-03,LAC,UTA
21,@,L 105-107 ,240,38,83,.458,31,62,.500,7,21,.333,22,34,.647,105,38,101,.376,31,67,.463,7,34,.206,24,31,.774,107,2012-12-04,LAL,HOU
22,@,W 105-88 ,240,41,77,.532,28,52,.538,13,25,.520,10,17,.588,105,35,83,.422,30,63,.476,5,20,.250,13,23,.565,88,2012-12-04,MIN,PHI
23,Home,W 105-101 ,240,38,79,.481,31,60,.517,7,19,.368,22,29,.759,105,41,89,.461,33,61,.541,8,28,.286,11,16,.688,101,2012-12-04,WAS,MIA
24,@,L 105-108 ,240,42,83,.506,35,67,.522,7,16,.438,14,24,.583,105,38,87,.437,36,73,.493,2,14,.143,30,37,.811,108,2012-12-12,DEN,MIN
25,@,L 105-107 (2OT),290,40,99,.404,35,83,.422,5,16,.313,20,26,.769,105,42,93,.452,32,67,.478,10,26,.385,13,16,.813,107,2012-12-14,DET,BRK
26,Home,W 105-89 ,240,38,73,.521,27,49,.551,11,24,.458,18,22,.818,105,30,73,.411,23,57,.404,7,16,.438,22,26,.846,89,2012-12-22,MIA,UTA
27,@,W 105-92 ,240,37,81,.457,25,58,.431,12,23,.522,19,25,.760,105,34,78,.436,29,64,.453,5,14,.357,19,28,.679,92,2012-12-26,MIA,CHA
28,@,L 105-111 (OT),265,40,95,.421,29,71,.408,11,24,.458,14,16,.875,105,39,93,.419,29,68,.426,10,25,.400,23,28,.821,111,2012-12-27,DAL,OKC
29,@,L 105-106 ,240,41,83,.494,30,53,.566,11,30,.367,12,20,.600,105,39,86,.453,24,56,.429,15,30,.500,13,17,.765,106,2012-12-28,NYK,SAC
30,Home,W 105-97 ,240,42,88,.477,36,68,.529,6,20,.300,15,17,.882,105,39,86,.453,29,58,.500,10,28,.357,9,11,.818,97,2012-12-28,WAS,ORL
31,@,W 105-100 ,240,41,81,.506,30,48,.625,11,33,.333,12,18,.667,105,36,84,.429,26,47,.553,10,37,.270,18,24,.750,100,2013-01-01,POR,NYK
32,@,W 105-96 ,240,40,76,.526,36,64,.563,4,12,.333,21,30,.700,105,30,79,.380,19,46,.413,11,33,.333,25,37,.676,96,2013-01-04,SAC,TOR
33,Home,L 105-112 ,240,38,82,.463,28,52,.538,10,30,.333,19,27,.704,105,44,101,.436,35,77,.455,9,24,.375,15,23,.652,112,2013-01-06,LAL,DEN
34,@,L 105-108 ,240,44,93,.473,36,69,.522,8,24,.333,9,10,.900,105,41,94,.436,37,82,.451,4,12,.333,22,36,.611,108,2013-01-09,ORL,DEN
35,@,L 105-108 ,240,44,95,.463,36,68,.529,8,27,.296,9,15,.600,105,41,84,.488,29,59,.492,12,25,.480,14,16,.875,108,2013-01-09,LAL,SAS
36,@,L 105-116 ,240,43,83,.518,30,59,.508,13,24,.542,6,8,.750,105,43,90,.478,34,63,.540,9,27,.333,21,27,.778,116,2013-01-13,GSW,DEN
37,Home,W 105-100 ,240,33,86,.384,28,64,.438,5,22,.227,34,43,.791,105,33,84,.393,22,57,.386,11,27,.407,23,30,.767,100,2013-01-16,DAL,HOU
38,Home,L 105-107 (OT),265,38,85,.447,32,69,.464,6,16,.375,23,32,.719,105,39,86,.453,36,75,.480,3,11,.273,26,36,.722,107,2013-01-16,TOR,CHI
39,Home,W 105-95 ,240,40,87,.460,29,68,.426,11,19,.579,14,17,.824,105,34,83,.410,21,53,.396,13,30,.433,14,16,.875,95,2013-01-18,IND,HOU
40,Home,L 105-111 ,240,40,79,.506,31,58,.534,9,21,.429,16,20,.800,105,45,90,.500,37,75,.493,8,15,.533,13,15,.867,111,2013-01-20,ORL,DAL
41,@,L 105-114 ,240,38,81,.469,35,66,.530,3,15,.200,26,32,.813,105,43,89,.483,31,64,.484,12,25,.480,16,21,.762,114,2013-01-21,SAC,NOH
42,Home,W 105-90 ,240,42,91,.462,35,68,.515,7,23,.304,14,21,.667,105,38,84,.452,30,64,.469,8,20,.400,6,8,.750,90,2013-01-22,DET,ORL
43,@,W 105-95 ,240,40,86,.465,32,65,.492,8,21,.381,17,25,.680,105,37,83,.446,26,49,.531,11,34,.324,10,13,.769,95,2013-01-23,DEN,HOU
44,@,W 105-95 ,240,37,76,.487,31,53,.585,6,23,.261,25,30,.833,105,36,86,.419,28,71,.394,8,15,.533,15,21,.714,95,2013-01-25,OKC,SAC
45,Home,W 105-96 ,240,41,74,.554,34,57,.596,7,17,.412,16,29,.552,105,36,81,.444,32,65,.492,4,16,.250,20,26,.769,96,2013-01-27,LAL,OKC
46,@,W 105-85 ,240,43,83,.518,32,64,.500,11,19,.579,8,14,.571,105,31,69,.449,26,52,.500,5,17,.294,18,24,.750,85,2013-01-30,MIA,BRK
47,Home,W 105-99 ,240,38,75,.507,28,57,.491,10,18,.556,19,28,.679,105,39,90,.433,31,71,.437,8,19,.421,13,16,.813,99,2013-02-02,POR,UTA
48,Home,W 105-99 ,240,41,86,.477,31,66,.470,10,20,.500,13,19,.684,105,36,84,.429,26,54,.481,10,30,.333,17,19,.895,99,2013-02-06,DAL,POR
49,@,W 105-100 ,240,41,83,.494,33,66,.500,8,17,.471,15,19,.789,105,34,86,.395,27,69,.391,7,17,.412,25,28,.893,100,2013-02-09,DET,MIL
50,Home,W 105-88 ,240,41,79,.519,35,66,.530,6,13,.462,17,22,.773,105,34,69,.493,30,53,.566,4,16,.250,16,25,.640,88,2013-02-10,MEM,MIN
51,@,W 105-101 ,240,40,77,.519,31,51,.608,9,26,.346,16,23,.696,105,38,89,.427,29,68,.426,9,21,.429,16,20,.800,101,2013-02-11,ATL,DAL
52,@,W 105-86 ,240,41,83,.494,31,62,.500,10,21,.476,13,14,.929,105,29,81,.358,24,62,.387,5,19,.263,23,33,.697,86,2013-02-11,NOH,DET
53,@,W 105-91 ,240,45,80,.563,42,71,.592,3,9,.333,12,20,.600,105,38,82,.463,29,62,.468,9,20,.450,6,10,.600,91,2013-02-19,MEM,DET
54,@,W 105-92 ,240,38,81,.469,29,57,.509,9,24,.375,20,27,.741,105,37,89,.416,33,64,.516,4,25,.160,14,17,.824,92,2013-02-19,CHA,ORL
55,@,W 105-99 ,240,40,81,.494,32,64,.500,8,17,.471,17,23,.739,105,36,89,.404,25,64,.391,11,25,.440,16,21,.762,99,2013-02-20,DET,CHA
56,Home,W 105-100 ,240,38,77,.494,33,63,.524,5,14,.357,24,34,.706,105,37,76,.487,30,61,.492,7,15,.467,19,22,.864,100,2013-02-20,CLE,NOH
57,@,W 105-75 ,240,42,83,.506,37,69,.536,5,14,.357,16,20,.800,105,25,75,.333,21,59,.356,4,16,.250,21,35,.600,75,2013-02-22,CHI,CHA
58,Home,W 105-103 ,240,41,80,.513,34,64,.531,7,16,.438,16,19,.842,105,38,84,.452,19,38,.500,19,46,.413,8,14,.571,103,2013-02-23,WAS,HOU
59,@,L 105-109 ,240,39,78,.500,31,58,.534,8,20,.400,19,24,.792,105,39,75,.520,27,56,.482,12,19,.632,19,24,.792,109,2013-02-24,CLE,MIA
60,@,L 105-109 ,240,36,72,.500,21,45,.467,15,27,.556,18,21,.857,105,36,87,.414,25,53,.472,11,34,.324,26,33,.788,109,2013-02-27,GSW,NYK
61,@,W 105-101 (OT),265,44,95,.463,41,83,.494,3,12,.250,14,21,.667,105,35,81,.432,29,64,.453,6,17,.353,25,35,.714,101,2013-02-27,PHO,SAS
62,@,W 105-89 ,240,43,83,.518,36,58,.621,7,25,.280,12,20,.600,105,33,74,.446,28,58,.483,5,16,.313,18,28,.643,89,2013-03-01,LAC,CLE
63,Home,W 105-103 ,240,43,95,.453,36,74,.486,7,21,.333,12,17,.706,105,36,83,.434,29,63,.460,7,20,.350,24,34,.706,103,2013-03-01,DEN,OKC
64,@,W 105-102 ,240,43,87,.494,36,66,.545,7,21,.333,12,16,.750,105,37,80,.463,29,59,.492,8,21,.381,20,26,.769,102,2013-03-04,ORL,NOH
65,@,L 105-122 ,240,45,97,.464,44,87,.506,1,10,.100,14,18,.778,105,49,82,.598,37,58,.638,12,24,.500,12,17,.706,122,2013-03-04,CHA,POR
66,@,L 105-122 ,240,31,77,.403,19,48,.396,12,29,.414,31,40,.775,105,46,96,.479,38,73,.521,8,23,.348,22,24,.917,122,2013-03-05,LAL,OKC
67,@,L 105-107 ,240,37,86,.430,18,45,.400,19,41,.463,12,18,.667,105,37,82,.451,29,64,.453,8,18,.444,25,39,.641,107,2013-03-09,HOU,PHO
68,Home,W 105-91 ,240,38,68,.559,31,54,.574,7,14,.500,22,31,.710,105,26,63,.413,16,36,.444,10,27,.370,29,34,.853,91,2013-03-10,MIA,IND
69,Home,W 105-93 ,240,43,82,.524,35,61,.574,8,21,.381,11,14,.786,105,33,77,.429,27,60,.450,6,17,.353,21,24,.875,93,2013-03-11,SAS,OKC
70,Home,W 105-97 ,240,41,72,.569,33,54,.611,8,18,.444,15,25,.600,105,40,89,.449,35,72,.486,5,17,.294,12,14,.857,97,2013-03-13,GSW,DET
71,Home,W 105-90 ,240,40,78,.513,30,50,.600,10,28,.357,15,21,.714,105,36,82,.439,29,57,.509,7,25,.280,11,17,.647,90,2013-03-14,POR,NYK
72,Home,W 105-88 ,240,41,79,.519,31,64,.484,10,15,.667,13,20,.650,105,34,76,.447,27,56,.482,7,20,.350,13,21,.619,88,2013-03-16,BOS,CHA
73,@,L 105-127 ,240,42,88,.477,36,67,.537,6,21,.286,15,20,.750,105,48,93,.516,34,72,.472,14,21,.667,17,20,.850,127,2013-03-16,PHO,WAS
74,@,W 105-93 ,240,44,84,.524,36,63,.571,8,21,.381,9,13,.692,105,36,86,.419,28,63,.444,8,23,.348,13,16,.813,93,2013-03-17,ATL,BRK
75,@,W 105-103 ,240,42,85,.494,35,65,.538,7,20,.350,14,21,.667,105,39,72,.542,29,51,.569,10,21,.476,15,24,.625,103,2013-03-18,MIA,BOS
76,@,W 105-82 ,240,42,79,.532,28,53,.528,14,26,.538,7,8,.875,105,32,79,.405,25,59,.424,7,20,.350,11,13,.846,82,2013-03-26,MIN,DET
77,@,W 105-98 ,240,41,90,.456,30,62,.484,11,28,.393,12,21,.571,105,41,90,.456,36,66,.545,5,24,.208,11,13,.846,98,2013-03-27,SAC,GSW
78,@,W 105-91 ,240,34,73,.466,21,44,.477,13,29,.448,24,28,.857,105,35,71,.493,31,57,.544,4,14,.286,17,24,.708,91,2013-03-27,LAC,NOH
79,@,W 105-95 ,240,43,86,.500,39,67,.582,4,19,.211,15,18,.833,105,33,67,.493,27,54,.500,6,13,.462,23,32,.719,95,2013-03-29,UTA,POR
80,Home,W 105-96 ,240,39,80,.488,34,59,.576,5,21,.238,22,30,.733,105,36,80,.450,29,59,.492,7,21,.333,17,23,.739,96,2013-04-06,BRK,CHA
81,Home,W 105-89 ,240,39,91,.429,29,67,.433,10,24,.417,17,22,.773,105,33,90,.367,26,71,.366,7,19,.368,16,20,.800,89,2013-04-09,GSW,MIN
82,@,L 105-108 (OT),265,41,93,.441,33,69,.478,8,24,.333,15,21,.714,105,43,95,.453,32,72,.444,11,23,.478,11,19,.579,108,2013-04-12,DEN,DAL
83,Home,W 105-93 ,240,41,83,.494,35,68,.515,6,15,.400,17,19,.895,105,37,73,.507,28,53,.528,9,20,.450,10,14,.714,93,2013-04-13,MIN,PHO
84,Home,W 105-93 ,240,36,70,.514,30,53,.566,6,17,.353,27,41,.659,105,29,82,.354,18,56,.321,11,26,.423,24,31,.774,93,2013-04-14,MIA,CHI
85,Home,W 105-98 ,240,37,73,.507,29,53,.547,8,20,.400,23,30,.767,105,39,80,.488,31,57,.544,8,23,.348,12,18,.667,98,2013-04-17,CHA,CLE
86,@,W 105-95 ,240,43,85,.506,35,66,.530,8,19,.421,11,14,.786,105,36,80,.450,30,54,.556,6,26,.231,17,27,.630,95,2013-04-17,PHI,IND
87,Home,W 105-93 ,240,42,78,.538,30,49,.612,12,29,.414,9,19,.474,105,40,77,.519,38,63,.603,2,14,.143,11,25,.440,93,2013-04-17,MIA,ORL
88,@,W 105-98 ,240,35,84,.417,29,69,.420,6,15,.400,29,34,.853,105,34,76,.447,30,60,.500,4,16,.250,26,38,.684,98,2013-11-01,MIL,BOS
89,@,L 105-113 ,240,38,100,.380,29,73,.397,9,27,.333,20,25,.800,105,34,73,.466,23,44,.523,11,29,.379,34,51,.667,113,2013-11-01,DAL,HOU
90,Home,W 105-84 ,240,37,75,.493,30,62,.484,7,13,.538,24,28,.857,105,30,80,.375,27,59,.458,3,21,.143,21,36,.583,84,2013-11-02,NOP,CHA
91,@,L 105-115 ,240,47,94,.500,41,82,.500,6,12,.500,5,8,.625,105,45,81,.556,37,61,.607,8,20,.400,17,19,.895,115,2013-11-02,SAS,POR
92,Home,W 105-103 ,240,38,89,.427,29,64,.453,9,25,.360,20,24,.833,105,40,90,.444,31,68,.456,9,22,.409,14,26,.538,103,2013-11-03,LAL,ATL
93,@,W 105-100 ,240,39,81,.481,31,59,.525,8,22,.364,19,26,.731,105,35,80,.438,25,49,.510,10,31,.323,20,21,.952,100,2013-11-05,ATL,SAC
94,@,L 105-106 (OT),265,40,88,.455,28,59,.475,12,29,.414,13,26,.500,105,41,92,.446,35,72,.486,6,20,.300,18,22,.818,106,2013-11-10,WAS,OKC
95,@,L 105-120 ,240,39,85,.459,32,67,.478,7,18,.389,20,23,.870,105,51,85,.600,46,73,.630,5,12,.417,13,15,.867,120,2013-11-11,ORL,BOS
96,Home,W 105-95 ,240,41,84,.488,31,58,.534,10,26,.385,13,19,.684,105,33,75,.440,24,49,.490,9,26,.346,20,29,.690,95,2013-11-12,DAL,WAS
97,@,L 105-111 ,240,42,85,.494,37,73,.507,5,12,.417,16,20,.800,105,37,72,.514,28,50,.560,9,22,.409,28,39,.718,111,2013-11-13,NOP,UTA
98,Home,W 105-98 ,240,40,79,.506,35,64,.547,5,15,.333,20,33,.606,105,37,83,.446,29,59,.492,8,24,.333,16,20,.800,98,2013-11-20,NOP,UTA
99,Home,W 105-91 ,240,41,79,.519,37,60,.617,4,19,.211,19,29,.655,105,38,92,.413,30,64,.469,8,28,.286,7,15,.467,91,2013-11-21,OKC,LAC
0,Home,W 105-94 ,240,43,82,.524,39,63,.619,4,19,.211,15,21,.714,105,38,85,.447,31,63,.492,7,22,.318,11,17,.647,94,2013-11-27,ORL,PHI
1,Home,L 105-121 ,240,42,92,.457,30,61,.492,12,31,.387,9,21,.429,105,51,93,.548,43,73,.589,8,20,.400,11,14,.786,121,2013-11-29,PHI,NOP
2,@,W 105-100 ,240,39,89,.438,31,63,.492,8,26,.308,19,26,.731,105,36,82,.439,32,67,.478,4,15,.267,24,31,.774,100,2013-12-01,IND,LAC
3,@,W 105-98 ,240,33,86,.384,26,65,.400,7,21,.333,32,42,.762,105,36,91,.396,27,64,.422,9,27,.333,17,22,.773,98,2013-12-04,DET,MIL
4,Home,W 105-88 ,240,42,91,.462,38,70,.543,4,21,.190,17,25,.680,105,37,92,.402,31,65,.477,6,27,.222,8,13,.615,88,2013-12-06,CHA,PHI
5,Home,W 105-83 ,240,37,83,.446,31,55,.564,6,28,.214,25,39,.641,105,27,76,.355,25,60,.417,2,16,.125,27,34,.794,83,2013-12-06,HOU,GSW
6,Home,L 105-109 (OT),265,33,83,.398,25,56,.446,8,27,.296,31,41,.756,105,42,92,.457,36,72,.500,6,20,.300,19,26,.731,109,2013-12-06,WAS,MIL
7,@,W 105-94 ,240,40,85,.471,34,66,.515,6,19,.316,19,20,.950,105,36,82,.439,35,75,.467,1,7,.143,21,23,.913,94,2013-12-09,POR,UTA
8,Home,L 105-139 ,240,39,87,.448,30,72,.417,9,15,.600,18,26,.692,105,52,93,.559,31,56,.554,21,37,.568,14,20,.700,139,2013-12-14,PHI,POR
9,@,W 105-93 ,240,43,88,.489,38,66,.576,5,22,.227,14,20,.700,105,36,87,.414,31,68,.456,5,19,.263,16,22,.727,93,2013-12-17,OKC,DEN
10,Home,W 105-91 ,240,40,73,.548,35,58,.603,5,15,.333,20,23,.870,105,37,93,.398,29,75,.387,8,18,.444,9,14,.643,91,2013-12-18,DAL,MEM
11,@,W 105-100 ,240,39,79,.494,27,56,.482,12,23,.522,15,23,.652,105,39,82,.476,31,62,.500,8,20,.400,14,23,.609,100,2013-12-21,SAC,ORL
12,Home,W 105-103 ,240,40,95,.421,30,71,.423,10,24,.417,15,22,.682,105,40,81,.494,36,63,.571,4,18,.222,19,23,.826,103,2013-12-25,GSW,LAC
13,Home,W 105-89 ,240,42,89,.472,31,65,.477,11,24,.458,10,15,.667,105,33,82,.402,27,59,.458,6,23,.261,17,24,.708,89,2013-12-27,NOP,DEN
14,Home,W 105-103 ,240,40,88,.455,31,65,.477,9,23,.391,16,20,.800,105,40,80,.500,33,57,.579,7,23,.304,16,23,.696,103,2013-12-27,UTA,LAL
15,@,W 105-83 ,240,41,78,.526,28,52,.538,13,26,.500,10,11,.909,105,32,74,.432,29,57,.509,3,17,.176,16,19,.842,83,2013-12-28,DAL,CHI
16,Home,W 105-91 ,240,38,71,.535,30,52,.577,8,19,.421,21,25,.840,105,36,77,.468,28,56,.500,8,21,.381,11,16,.688,91,2013-12-28,IND,BRK
17,@,W 105-101 ,240,39,76,.513,30,59,.508,9,17,.529,18,20,.900,105,37,77,.481,23,45,.511,14,32,.438,13,19,.684,101,2014-01-02,NYK,SAS
18,@,L 105-111 ,240,39,83,.470,34,66,.515,5,17,.294,22,30,.733,105,36,79,.456,25,49,.510,11,30,.367,28,39,.718,111,2014-01-08,BOS,LAC
19,@,L 105-109 ,240,44,89,.494,40,81,.494,4,8,.500,13,19,.684,105,43,80,.538,36,64,.563,7,16,.438,16,18,.889,109,2014-01-15,UTA,SAS
20,Home,W 105-97 ,240,42,87,.483,32,72,.444,10,15,.667,11,17,.647,105,40,86,.465,33,67,.493,7,19,.368,10,16,.625,97,2014-01-21,OKC,POR
21,Home,L 105-111 ,240,40,75,.533,30,53,.566,10,22,.455,15,22,.682,105,45,83,.542,35,65,.538,10,18,.556,11,16,.688,111,2014-01-22,SAS,OKC
22,@,L 105-110 ,240,39,79,.494,29,56,.518,10,23,.435,17,20,.850,105,38,88,.432,34,70,.486,4,18,.222,30,34,.882,110,2014-01-23,DEN,POR
23,@,W 105-79 ,240,41,84,.488,30,66,.455,11,18,.611,12,17,.706,105,29,76,.382,27,63,.429,2,13,.154,19,27,.704,79,2014-01-24,SAS,ATL
24,@,L 105-114 ,240,41,90,.456,29,68,.426,12,22,.545,11,17,.647,105,39,81,.481,30,64,.469,9,17,.529,27,34,.794,114,2014-01-24,LAL,ORL
25,Home,W 105-95 ,240,39,80,.488,32,59,.542,7,21,.333,20,23,.870,105,33,79,.418,25,56,.446,8,23,.348,21,29,.724,95,2014-02-01,PHO,CHA
26,Home,W 105-100 ,240,40,86,.465,35,72,.486,5,14,.357,20,22,.909,105,38,84,.452,24,54,.444,14,30,.467,10,14,.714,100,2014-02-05,NOP,ATL
27,@,L 105-118 ,240,34,85,.400,27,59,.458,7,26,.269,30,40,.750,105,36,71,.507,27,47,.574,9,24,.375,37,54,.685,118,2014-02-07,TOR,LAC
28,Home,W 105-89 ,240,40,80,.500,27,49,.551,13,31,.419,12,15,.800,105,36,87,.414,26,60,.433,10,27,.370,7,15,.467,89,2014-02-12,BRK,CHA
29,Home,W 105-100 ,240,37,87,.425,34,71,.479,3,16,.188,28,32,.875,105,37,80,.463,29,61,.475,8,19,.421,18,23,.783,100,2014-02-12,UTA,PHI
30,@,W 105-99 ,240,41,82,.500,32,59,.542,9,23,.391,14,20,.700,105,37,82,.451,28,58,.483,9,24,.375,16,17,.941,99,2014-02-19,BRK,UTA
31,Home,W 105-98 ,240,38,73,.521,33,64,.516,5,9,.556,24,28,.857,105,34,87,.391,28,66,.424,6,21,.286,24,36,.667,98,2014-02-22,SAC,BOS
32,Home,W 105-90 ,240,34,65,.523,25,48,.521,9,17,.529,28,36,.778,105,36,87,.414,31,73,.425,5,14,.357,13,17,.765,90,2014-02-23,TOR,ORL
33,@,W 105-94 ,240,43,80,.538,38,61,.623,5,19,.263,14,17,.824,105,39,87,.448,37,76,.487,2,11,.182,14,17,.824,94,2014-03-05,CHI,DET
34,Home,W 105-94 ,240,36,81,.444,28,61,.459,8,20,.400,25,31,.806,105,32,67,.478,25,51,.490,7,16,.438,23,29,.793,94,2014-03-09,DAL,IND
35,Home,W 105-98 ,240,37,81,.457,29,61,.475,8,20,.400,23,28,.821,105,36,83,.434,31,59,.525,5,24,.208,21,31,.677,98,2014-03-10,CHA,DEN
36,@,L 105-112 ,240,39,85,.459,32,65,.492,7,20,.350,20,29,.690,105,43,78,.551,39,64,.609,4,14,.286,22,31,.710,112,2014-03-10,PHO,LAC
37,Home,W 105-98 ,240,38,84,.452,30,57,.526,8,27,.296,21,25,.840,105,42,88,.477,33,65,.508,9,23,.391,5,8,.625,98,2014-03-10,MIL,ORL
38,Home,W 105-93 ,240,44,91,.484,36,72,.500,8,19,.421,9,14,.643,105,35,82,.427,29,67,.433,6,15,.400,17,21,.810,93,2014-03-14,CHA,MIN
39,@,W 105-101 (OT),265,36,90,.400,26,67,.388,10,23,.435,23,29,.793,105,43,97,.443,36,72,.500,7,25,.280,8,10,.800,101,2014-03-14,WAS,ORL
40,Home,L 105-111 ,240,38,85,.447,30,57,.526,8,28,.286,21,27,.778,105,36,70,.514,32,57,.561,4,13,.308,35,43,.814,111,2014-03-21,ATL,NOP
41,Home,W 105-95 ,240,43,84,.512,36,67,.537,7,17,.412,12,17,.706,105,37,73,.507,29,47,.617,8,26,.308,13,17,.765,95,2014-03-22,NOP,MIA
42,Home,W 105-102 ,240,40,91,.440,29,64,.453,11,27,.407,14,18,.778,105,41,85,.482,36,70,.514,5,15,.333,15,18,.833,102,2014-03-23,DEN,WAS
43,@,L 105-108 ,240,42,85,.494,35,64,.547,7,21,.333,14,18,.778,105,39,70,.557,33,60,.550,6,10,.600,24,34,.706,108,2014-03-27,LAL,MIL
44,@,L 105-110 (OT),265,43,97,.443,35,75,.467,8,22,.364,11,14,.786,105,39,87,.448,33,69,.478,6,18,.333,26,35,.743,110,2014-03-28,CHA,ORL
45,Home,W 105-103 ,240,40,86,.465,35,66,.530,5,20,.250,20,22,.909,105,40,76,.526,34,58,.586,6,18,.333,17,20,.850,103,2014-03-28,TOR,BOS
46,Home,W 105-98 ,240,39,75,.520,34,60,.567,5,15,.333,22,25,.880,105,41,89,.461,36,72,.500,5,17,.294,11,18,.611,98,2014-03-30,POR,MEM
47,Home,W 105-96 ,240,44,83,.530,38,58,.655,6,25,.240,11,17,.647,105,32,84,.381,22,49,.449,10,35,.286,22,28,.786,96,2014-04-01,BRK,HOU
48,@,W 105-92 ,240,40,78,.513,28,53,.528,12,25,.480,13,15,.867,105,32,72,.444,24,48,.500,8,24,.333,20,26,.769,92,2014-04-02,CHI,ATL
49,@,W 105-101 ,240,41,80,.513,35,59,.593,6,21,.286,17,23,.739,105,36,79,.456,26,56,.464,10,23,.435,19,27,.704,101,2014-04-05,BRK,PHI
50,Home,W 105-97 ,240,40,76,.526,31,53,.585,9,23,.391,16,22,.727,105,37,84,.440,25,58,.431,12,26,.462,11,14,.786,97,2014-04-09,ATL,BOS
51,@,L 105-111 ,240,41,93,.441,36,68,.529,5,25,.200,18,26,.692,105,39,72,.542,32,53,.604,7,19,.368,26,41,.634,111,2014-04-12,PHI,CHA
52,@,L 105-117 ,240,35,82,.427,27,53,.509,8,29,.276,27,30,.900,105,44,83,.530,35,59,.593,9,24,.375,20,30,.667,117,2014-04-15,DEN,LAC
53,@,L 105-106 (OT),265,44,92,.478,36,62,.581,8,30,.267,9,11,.818,105,43,88,.489,38,68,.559,5,20,.250,15,25,.600,106,2014-04-16,DAL,MEM
54,Home,W 105-100 ,240,43,82,.524,37,70,.529,6,12,.500,13,20,.650,105,35,81,.432,21,51,.412,14,30,.467,16,24,.667,100,2014-04-16,NOP,HOU
55,@,L 105-121 ,240,39,80,.488,32,61,.525,7,19,.368,20,26,.769,105,49,88,.557,41,66,.621,8,22,.364,15,23,.652,121,2014-10-29,BRK,BOS
56,Home,W 105-101 ,240,43,82,.524,39,67,.582,4,15,.267,15,20,.750,105,39,86,.453,33,74,.446,6,12,.500,17,23,.739,101,2014-10-29,MEM,MIN
57,@,W 105-98 ,240,39,80,.488,32,67,.478,7,13,.538,20,26,.769,105,37,72,.514,31,57,.544,6,15,.400,18,24,.750,98,2014-10-30,WAS,ORL
58,Home,L 105-106 ,240,38,85,.447,34,73,.466,4,12,.333,25,31,.806,105,33,69,.478,24,46,.522,9,23,.391,31,40,.775,106,2014-11-01,MIN,CHI
59,Home,L 105-110 ,240,36,93,.387,31,69,.449,5,24,.208,28,33,.848,105,34,81,.420,32,72,.444,2,9,.222,40,47,.851,110,2014-11-03,DEN,SAC
60,@,W 105-82 ,240,42,88,.477,33,64,.516,9,24,.375,12,14,.857,105,29,68,.426,20,40,.500,9,28,.321,15,19,.789,82,2014-11-07,DAL,UTA
61,@,W 105-96 ,240,42,76,.553,33,53,.623,9,23,.391,12,20,.600,105,35,83,.422,26,54,.481,9,29,.310,17,24,.708,96,2014-11-09,MIA,DAL
62,@,W 105-89 ,240,39,80,.488,29,54,.537,10,26,.385,17,25,.680,105,36,81,.444,29,58,.500,7,23,.304,10,22,.455,89,2014-11-17,CHI,LAC
63,@,W 105-102 ,240,34,82,.415,22,54,.407,12,28,.429,25,29,.862,105,37,84,.440,27,62,.435,10,22,.455,18,21,.857,102,2014-11-19,DAL,WAS
64,@,W 105-100 ,240,39,82,.476,35,66,.530,4,16,.250,23,32,.719,105,42,91,.462,35,71,.493,7,20,.350,9,15,.600,100,2014-11-21,ORL,CHO
65,Home,W 105-87 ,240,39,79,.494,30,63,.476,9,16,.563,18,22,.818,105,30,83,.361,22,61,.361,8,22,.364,19,28,.679,87,2014-11-21,POR,CHI
66,@,W 105-97 ,240,39,92,.424,27,65,.415,12,27,.444,15,20,.750,105,41,94,.436,36,79,.456,5,15,.333,10,15,.667,97,2014-11-26,POR,CHO
67,Home,W 105-78 ,240,38,86,.442,28,62,.452,10,24,.417,19,23,.826,105,29,75,.387,27,56,.482,2,19,.105,18,24,.750,78,2014-11-28,OKC,NYK
68,Home,W 105-75 ,240,40,75,.533,28,52,.538,12,23,.522,13,16,.813,105,29,88,.330,24,65,.369,5,23,.217,12,16,.750,75,2014-11-29,ATL,CHO
69,@,L 105-109 ,240,41,84,.488,29,61,.475,12,23,.522,11,13,.846,105,43,82,.524,32,58,.552,11,24,.458,12,14,.857,109,2014-12-02,BOS,ATL
70,@,W 105-103 ,240,43,86,.500,38,64,.594,5,22,.227,14,17,.824,105,41,81,.506,34,61,.557,7,20,.350,14,19,.737,103,2014-12-02,POR,DEN
71,Home,W 105-96 ,240,41,93,.441,31,65,.477,10,28,.357,13,20,.650,105,39,76,.513,37,63,.587,2,13,.154,16,27,.593,96,2014-12-03,HOU,MEM
72,Home,L 105-107 ,240,38,73,.521,31,62,.500,7,11,.636,22,32,.688,105,42,92,.457,34,65,.523,8,27,.296,15,22,.682,107,2014-12-03,MIL,DAL
73,@,W 105-91 ,240,41,84,.488,32,64,.500,9,20,.450,14,21,.667,105,35,86,.407,27,62,.435,8,24,.333,13,20,.650,91,2014-12-05,CLE,TOR
74,@,W 105-96 ,240,42,83,.506,33,57,.579,9,26,.346,12,14,.857,105,35,79,.443,31,64,.484,4,15,.267,22,28,.786,96,2014-12-06,ORL,SAC
75,Home,W 105-101 ,240,39,79,.494,30,53,.566,9,26,.346,18,21,.857,105,42,82,.512,35,59,.593,7,23,.304,10,10,1.000,101,2014-12-09,CLE,TOR
76,@,L 105-114 ,240,38,85,.447,20,45,.444,18,40,.450,11,14,.786,105,41,85,.482,34,71,.479,7,14,.500,25,29,.862,114,2014-12-09,DAL,MEM
77,Home,W 105-80 ,240,37,79,.468,29,57,.509,8,22,.364,23,32,.719,105,29,88,.330,26,74,.351,3,14,.214,19,24,.792,80,2014-12-10,CHI,BRK
78,Home,W 105-93 ,240,40,81,.494,32,58,.552,8,23,.348,17,20,.850,105,37,90,.411,28,55,.509,9,35,.257,10,15,.667,93,2014-12-10,GSW,HOU
79,@,W 105-103 ,240,40,84,.476,36,69,.522,4,15,.267,21,27,.778,105,39,83,.470,29,52,.558,10,31,.323,15,19,.789,103,2014-12-12,DET,PHO
80,@,W 105-98 ,240,37,83,.446,27,51,.529,10,32,.313,21,27,.778,105,36,89,.404,31,64,.484,5,25,.200,21,30,.700,98,2014-12-13,GSW,DAL
81,@,W 105-87 ,240,38,86,.442,32,61,.525,6,25,.240,23,35,.657,105,33,93,.355,29,65,.446,4,28,.143,17,21,.810,87,2014-12-15,BOS,PHI
82,Home,W 105-98 ,240,42,92,.457,37,78,.474,5,14,.357,16,19,.842,105,39,95,.411,30,64,.469,9,31,.290,11,12,.917,98,2014-12-16,MEM,GSW
83,@,W 105-87 ,240,35,66,.530,21,41,.512,14,25,.560,21,24,.875,105,27,70,.386,23,53,.434,4,17,.235,29,40,.725,87,2014-12-17,UTA,MIA
84,Home,W 105-89 ,240,41,80,.513,31,60,.517,10,20,.500,13,19,.684,105,35,81,.432,26,54,.481,9,27,.333,10,22,.455,89,2014-12-17,TOR,BRK
85,@,W 105-103 ,240,39,79,.494,36,65,.554,3,14,.214,24,33,.727,105,40,75,.533,31,56,.554,9,19,.474,14,19,.737,103,2014-12-19,WAS,MIA
86,@,L 105-110 ,240,40,91,.440,31,64,.484,9,27,.333,16,26,.615,105,40,76,.526,32,56,.571,8,20,.400,22,29,.759,110,2014-12-21,DET,BRK
87,Home,W 105-91 ,240,46,76,.605,39,62,.629,7,14,.500,6,10,.600,105,39,86,.453,38,70,.543,1,16,.063,12,15,.800,91,2014-12-21,CLE,MEM
88,@,W 105-102 ,240,40,81,.494,33,62,.532,7,19,.368,18,27,.667,105,39,90,.433,28,62,.452,11,28,.393,13,20,.650,102,2014-12-22,ATL,DAL
89,@,L 105-115 ,240,39,84,.464,27,58,.466,12,26,.462,15,17,.882,105,46,89,.517,34,63,.540,12,26,.462,11,17,.647,115,2014-12-23,GSW,LAL
90,@,L 105-126 ,240,40,86,.465,30,61,.492,10,25,.400,15,20,.750,105,49,92,.533,37,64,.578,12,28,.429,16,20,.800,126,2015-01-02,TOR,GSW
91,@,L 105-114 ,240,47,102,.461,39,77,.506,8,25,.320,3,5,.600,105,41,85,.482,36,68,.529,5,17,.294,27,30,.900,114,2015-01-05,HOU,CHI
92,Home,W 105-83 ,240,43,82,.524,36,67,.537,7,15,.467,12,19,.632,105,33,76,.434,25,50,.500,8,26,.308,9,13,.692,83,2015-01-05,MEM,NYK
93,@,W 105-101 ,240,35,74,.473,28,61,.459,7,13,.538,28,30,.933,105,35,81,.432,31,58,.534,4,23,.174,27,34,.794,101,2015-01-05,IND,UTA
94,@,W 105-104 ,240,41,87,.471,38,68,.559,3,19,.158,20,28,.714,105,36,79,.456,27,58,.466,9,21,.429,23,34,.676,104,2015-01-06,DET,SAS
95,@,W 105-93 ,240,39,86,.453,27,52,.519,12,34,.353,15,24,.625,105,34,82,.415,24,53,.453,10,29,.345,15,19,.789,93,2015-01-07,HOU,CLE
96,@,W 105-87 ,240,42,87,.483,30,64,.469,12,23,.522,9,16,.563,105,31,76,.408,22,51,.431,9,25,.360,16,25,.640,87,2015-01-13,ATL,PHI
97,Home,L 105-116 ,240,39,81,.481,32,60,.533,7,21,.333,20,24,.833,105,46,91,.505,33,66,.500,13,25,.520,11,13,.846,116,2015-01-13,UTA,GSW
98,@,W 105-91 ,240,36,73,.493,26,44,.591,10,29,.345,23,27,.852,105,34,83,.410,23,50,.460,11,33,.333,12,14,.857,91,2015-01-14,ATL,BOS
99,@,W 105-99 ,240,40,78,.513,35,63,.556,5,15,.333,20,25,.800,105,34,79,.430,21,52,.404,13,27,.481,18,24,.750,99,2015-01-14,WAS,CHI
0,@,W 105-94 ,240,39,80,.488,31,59,.525,8,21,.381,19,23,.826,105,34,73,.466,26,51,.510,8,22,.364,18,23,.783,94,2015-01-14,NOP,DET
1,Home,L 105-113 ,240,38,92,.413,28,61,.459,10,31,.323,19,22,.864,105,43,80,.538,35,61,.574,8,19,.421,19,21,.905,113,2015-01-17,DEN,MIN
2,Home,W 105-80 ,240,40,89,.449,28,67,.418,12,22,.545,13,19,.684,105,29,80,.363,23,61,.377,6,19,.316,16,20,.800,80,2015-01-19,CHO,MIN
3,@,W 105-103 (OT),265,40,102,.392,34,73,.466,6,29,.207,19,23,.826,105,38,100,.380,31,70,.443,7,30,.233,20,26,.769,103,2015-01-21,OKC,WAS
4,Home,W 105-99 ,240,40,84,.476,29,61,.475,11,23,.478,14,22,.636,105,39,87,.448,28,57,.491,11,30,.367,10,11,.909,99,2015-01-30,ATL,POR
5,@,W 105-85 ,240,40,91,.440,32,69,.464,8,22,.364,17,18,.944,105,28,75,.373,18,45,.400,10,30,.333,19,28,.679,85,2015-01-31,LAC,SAS
6,Home,W 105-98 ,240,31,70,.443,20,43,.465,11,27,.407,32,42,.762,105,33,85,.388,21,54,.389,12,31,.387,20,28,.714,98,2015-02-03,PHI,DEN
7,Home,W 105-96 ,240,38,80,.475,27,55,.491,11,25,.440,18,27,.667,105,34,77,.442,30,61,.492,4,16,.250,24,30,.800,96,2015-02-04,ATL,WAS
8,@,L 105-113 (OT),265,39,93,.419,30,65,.462,9,28,.321,18,25,.720,105,41,82,.500,30,56,.536,11,26,.423,20,22,.909,113,2015-02-04,LAL,MIL
9,Home,W 105-94 ,240,31,72,.431,23,42,.548,8,30,.267,35,44,.795,105,38,91,.418,33,69,.478,5,22,.227,13,20,.650,94,2015-02-05,CLE,LAC
10,@,L 105-120 ,240,41,100,.410,34,77,.442,7,23,.304,16,19,.842,105,45,82,.549,27,49,.551,18,33,.545,12,20,.600,120,2015-02-08,LAL,CLE
11,Home,L 105-117 ,240,42,93,.452,37,77,.481,5,16,.313,16,22,.727,105,44,86,.512,34,65,.523,10,21,.476,19,20,.950,117,2015-02-09,MIN,ATL
12,Home,W 105-89 ,240,37,83,.446,30,63,.476,7,20,.350,24,25,.960,105,32,86,.372,30,74,.405,2,12,.167,23,30,.767,89,2015-02-11,OKC,MEM
13,@,W 105-80 ,240,43,96,.448,30,66,.455,13,30,.433,6,8,.750,105,29,88,.330,21,50,.420,8,38,.211,14,21,.667,80,2015-02-20,TOR,ATL
14,Home,L 105-114 ,240,41,89,.461,37,66,.561,4,23,.174,19,29,.655,105,42,89,.472,32,68,.471,10,21,.476,20,24,.833,114,2015-02-20,LAL,BRK
15,@,W 105-91 ,240,35,83,.422,27,62,.435,8,21,.381,27,31,.871,105,33,79,.418,28,62,.452,5,17,.294,20,27,.741,91,2015-02-21,NOP,MIA
16,Home,W 105-92 ,240,40,96,.417,31,72,.431,9,24,.375,16,18,.889,105,38,88,.432,29,62,.468,9,26,.346,7,11,.636,92,2015-02-24,OKC,IND
17,@,L 105-110 ,240,40,91,.440,29,59,.492,11,32,.344,14,19,.737,105,36,88,.409,19,44,.432,17,44,.386,21,30,.700,110,2015-02-25,LAC,HOU
18,Home,W 105-103 (OT),265,34,74,.459,23,44,.523,11,30,.367,26,33,.788,105,40,98,.408,28,58,.483,12,40,.300,11,21,.524,103,2015-03-01,HOU,CLE
19,Home,L 105-110 ,240,36,82,.439,32,67,.478,4,15,.267,29,35,.829,105,44,92,.478,32,59,.542,12,33,.364,10,19,.526,110,2015-03-02,MIN,LAC
20,Home,W 105-82 ,240,38,80,.475,28,58,.483,10,22,.455,19,24,.792,105,30,76,.395,24,60,.400,6,16,.375,16,23,.696,82,2015-03-04,IND,NYK
21,@,W 105-100 ,240,37,79,.468,29,58,.500,8,21,.381,23,27,.852,105,41,87,.471,36,67,.537,5,20,.250,13,15,.867,100,2015-03-04,PHO,ORL
22,@,L 105-108 ,240,41,88,.466,33,68,.485,8,20,.400,15,19,.789,105,40,87,.460,33,62,.532,7,25,.280,21,26,.808,108,2015-03-05,OKC,CHI
23,@,L 105-116 ,240,37,73,.507,32,58,.552,5,15,.333,26,29,.897,105,44,90,.489,35,68,.515,9,22,.409,19,24,.792,116,2015-03-08,CHI,SAS
24,@,L 105-130 ,240,39,81,.481,31,61,.508,8,20,.400,19,20,.950,105,53,88,.602,33,52,.635,20,36,.556,4,7,.571,130,2015-03-09,SAC,ATL
25,Home,W 105-98 ,240,44,84,.524,37,64,.578,7,20,.350,10,13,.769,105,42,98,.429,38,86,.442,4,12,.333,10,12,.833,98,2015-03-11,GSW,DET
26,Home,W 105-100 ,240,42,92,.457,32,59,.542,10,33,.303,11,14,.786,105,38,91,.418,27,60,.450,11,31,.355,13,23,.565,100,2015-03-11,POR,HOU
27,@,L 105-108 ,240,39,85,.459,31,70,.443,8,15,.533,19,21,.905,105,40,84,.476,33,57,.579,7,27,.259,21,23,.913,108,2015-03-16,LAL,GSW
28,Home,W 105-97 ,240,41,82,.500,34,70,.486,7,12,.583,16,26,.615,105,36,89,.404,28,61,.459,8,28,.286,17,20,.850,97,2015-03-16,WAS,POR
29,Home,W 105-95 ,240,39,83,.470,27,50,.540,12,33,.364,15,22,.682,105,35,80,.438,25,62,.403,10,18,.556,15,17,.882,95,2015-03-17,DET,MEM
30,Home,L 105-116 ,240,38,79,.481,35,62,.565,3,17,.176,26,32,.813,105,45,88,.511,28,51,.549,17,37,.459,9,13,.692,116,2015-03-18,SAC,LAC
31,Home,W 105-100 ,240,35,79,.443,23,50,.460,12,29,.414,23,27,.852,105,42,87,.483,36,70,.514,6,17,.353,10,15,.667,100,2015-03-18,TOR,MIN
32,@,W 105-97 (OT),265,39,89,.438,30,63,.476,9,26,.346,18,30,.600,105,38,105,.362,30,78,.385,8,27,.296,13,17,.765,97,2015-03-22,DET,BOS
33,Home,W 105-95 ,240,41,83,.494,30,54,.556,11,29,.379,12,17,.706,105,40,84,.476,32,59,.542,8,25,.320,7,10,.700,95,2015-03-31,DET,ATL
34,Home,W 105-100 ,240,39,81,.481,32,57,.561,7,24,.292,20,30,.667,105,35,84,.417,26,59,.441,9,25,.360,21,27,.778,100,2015-04-07,LAC,LAL
35,Home,W 105-100 ,240,40,81,.494,37,66,.561,3,15,.200,22,28,.786,105,39,91,.429,34,73,.466,5,18,.278,17,21,.810,100,2015-04-07,MIA,CHO
36,Home,W 105-103 ,240,38,82,.463,30,59,.508,8,23,.348,21,24,.875,105,34,79,.430,22,53,.415,12,26,.462,23,31,.742,103,2015-04-08,ORL,CHI
37,@,L 105-116 ,240,46,98,.469,39,74,.527,7,24,.292,6,8,.750,105,48,90,.533,36,64,.563,12,26,.462,8,9,.889,116,2015-04-09,POR,GSW
38,Home,L 105-111 ,240,41,87,.471,35,57,.614,6,30,.200,17,22,.773,105,36,79,.456,30,62,.484,6,17,.353,33,42,.786,111,2015-04-11,POR,UTA
39,@,W 105-100 ,240,42,85,.494,29,55,.527,13,30,.433,8,14,.571,105,41,89,.461,34,68,.500,7,21,.333,11,16,.688,100,2015-04-15,BOS,MIL
40,@,W 105-101 ,240,39,89,.438,27,58,.466,12,31,.387,15,20,.750,105,38,83,.458,33,54,.611,5,29,.172,20,25,.800,101,2015-04-15,MIA,PHI
41,@,W 105-85 ,240,40,79,.506,27,52,.519,13,27,.481,12,18,.667,105,30,87,.345,22,52,.423,8,35,.229,17,26,.654,85,2015-10-28,DEN,HOU
42,@,L 105-110 ,240,40,84,.476,30,61,.492,10,23,.435,15,22,.682,105,41,89,.461,32,60,.533,9,29,.310,19,29,.655,110,2015-11-02,OKC,HOU
43,@,L 105-130 ,240,44,90,.489,30,60,.500,14,30,.467,3,8,.375,105,47,91,.516,33,68,.485,14,23,.609,22,23,.957,130,2015-11-03,CHI,CHO
44,Home,L 105-109 ,240,42,88,.477,38,66,.576,4,22,.182,17,25,.680,105,38,86,.442,31,56,.554,7,30,.233,26,29,.897,109,2015-11-07,LAC,HOU
45,@,W 105-97 ,240,39,83,.470,33,70,.471,6,13,.462,21,24,.875,105,36,80,.450,25,47,.532,11,33,.333,14,26,.538,97,2015-11-07,ORL,PHI
46,@,L 105-120 ,240,39,88,.443,34,68,.500,5,20,.250,22,26,.846,105,46,92,.500,32,59,.542,14,33,.424,14,18,.778,120,2015-11-10,DAL,NOP
47,@,L 105-108 (2OT),290,37,91,.407,23,53,.434,14,38,.368,17,27,.630,105,43,102,.422,37,86,.430,6,16,.375,16,22,.727,108,2015-11-14,CLE,MIL
48,Home,W 105-81 ,240,37,84,.440,26,60,.433,11,24,.458,20,26,.769,105,34,98,.347,28,63,.444,6,35,.171,7,8,.875,81,2015-11-14,PHO,DEN
49,Home,L 105-118 ,240,37,86,.430,33,71,.465,4,15,.267,27,35,.771,105,47,89,.528,32,60,.533,15,29,.517,9,13,.692,118,2015-11-22,DEN,GSW
50,@,L 105-116 ,240,35,88,.398,24,61,.393,11,27,.407,24,28,.857,105,45,85,.529,37,62,.597,8,23,.348,18,37,.486,116,2015-11-30,HOU,DET
51,@,W 105-95 ,240,38,80,.475,30,60,.500,8,20,.400,21,25,.840,105,36,75,.480,31,58,.534,5,17,.294,18,24,.750,95,2015-11-30,BOS,MIA
52,Home,L 105-106 ,240,39,92,.424,31,65,.477,8,27,.296,19,22,.864,105,38,81,.469,26,54,.481,12,27,.444,18,18,1.000,106,2015-12-03,TOR,DEN
53,Home,L 105-108 ,240,37,74,.500,22,43,.512,15,31,.484,16,26,.615,105,37,81,.457,26,50,.520,11,31,.355,23,38,.605,108,2015-12-05,PHI,DEN
54,@,L 105-108 ,240,39,86,.453,27,57,.474,12,29,.414,15,22,.682,105,44,83,.530,39,66,.591,5,17,.294,15,22,.682,108,2015-12-05,BOS,SAS
55,@,L 105-110 ,240,39,82,.476,24,47,.511,15,35,.429,12,17,.706,105,45,81,.556,38,63,.603,7,18,.389,13,16,.813,110,2015-12-08,HOU,BRK
56,Home,W 105-100 ,240,40,79,.506,31,58,.534,9,21,.429,16,20,.800,105,40,79,.506,29,53,.547,11,26,.423,9,16,.563,100,2015-12-08,CLE,POR
57,Home,W 105-100 ,240,38,92,.413,33,69,.478,5,23,.217,24,28,.857,105,39,91,.429,33,70,.471,6,21,.286,16,23,.696,100,2015-12-09,BOS,CHI
58,@,L 105-107 ,240,40,80,.500,28,53,.528,12,27,.444,13,21,.619,105,39,79,.494,23,52,.442,16,27,.593,13,18,.722,107,2015-12-11,WAS,NOP
59,@,W 105-100 ,240,43,86,.500,35,62,.565,8,24,.333,11,18,.611,105,35,79,.443,30,60,.500,5,19,.263,25,30,.833,100,2015-12-12,LAC,BRK
60,@,W 105-82 ,240,41,76,.539,32,55,.582,9,21,.429,14,20,.700,105,31,80,.388,24,61,.393,7,19,.368,13,16,.813,82,2015-12-14,ORL,BRK
61,@,W 105-103 (OT),265,44,97,.454,38,78,.487,6,19,.316,11,15,.733,105,37,89,.416,31,70,.443,6,19,.316,23,31,.742,103,2015-12-14,LAC,DET
62,Home,W 105-101 ,240,35,81,.432,22,49,.449,13,32,.406,22,29,.759,105,36,82,.439,28,57,.491,8,25,.320,21,27,.778,101,2015-12-14,POR,NOP
63,@,W 105-102 ,240,43,94,.457,36,74,.486,7,20,.350,12,14,.857,105,43,95,.453,34,69,.493,9,26,.346,7,13,.538,102,2015-12-21,BRK,CHI
64,@,W 105-96 ,240,40,92,.435,33,74,.446,7,18,.389,18,20,.900,105,37,96,.385,31,72,.431,6,24,.250,16,23,.696,96,2015-12-25,CHI,OKC
65,Home,W 105-76 ,240,41,89,.461,32,67,.478,9,22,.409,14,19,.737,105,28,77,.364,17,46,.370,11,31,.355,9,15,.600,76,2015-12-26,POR,CLE
66,Home,L 105-111 ,240,36,78,.462,26,54,.481,10,24,.417,23,30,.767,105,36,82,.439,24,59,.407,12,23,.522,27,36,.750,111,2015-12-28,MIA,BRK
67,Home,L 105-110 ,240,36,74,.486,28,49,.571,8,25,.320,25,41,.610,105,40,94,.426,31,63,.492,9,31,.290,21,34,.618,110,2015-12-30,SAC,PHI
68,@,W 105-98 ,240,40,83,.482,34,63,.540,6,20,.300,19,24,.792,105,36,83,.434,26,57,.456,10,26,.385,16,19,.842,98,2016-01-02,NOP,DAL
69,@,L 105-120 ,240,36,83,.434,29,65,.446,7,18,.389,26,31,.839,105,49,94,.521,39,70,.557,10,24,.417,12,15,.800,120,2016-01-09,CHI,ATL
70,@,W 105-99 ,240,42,76,.553,29,53,.547,13,23,.565,8,10,.800,105,38,74,.514,33,60,.550,5,14,.357,18,24,.750,99,2016-01-09,WAS,ORL
71,@,W 105-92 ,240,39,72,.542,34,60,.567,5,12,.417,22,26,.846,105,33,87,.379,24,51,.471,9,36,.250,17,22,.773,92,2016-01-16,MIL,CHO
72,Home,L 105-119 ,240,33,84,.393,27,64,.422,6,20,.300,33,37,.892,105,43,86,.500,34,59,.576,9,27,.333,24,26,.923,119,2016-01-25,DEN,ATL
73,@,L 105-114 ,240,40,89,.449,30,61,.492,10,28,.357,15,20,.750,105,43,98,.439,33,72,.458,10,26,.385,18,24,.750,114,2016-01-28,SAC,NOP
74,Home,W 105-93 ,240,40,81,.494,32,55,.582,8,26,.308,17,24,.708,105,34,78,.436,29,65,.446,5,13,.385,20,25,.800,93,2016-01-29,LAC,LAL
75,@,L 105-109 (OT),265,40,87,.460,36,69,.522,4,18,.222,21,25,.840,105,44,100,.440,35,73,.479,9,27,.333,12,16,.750,109,2016-01-30,DEN,IND
76,Home,W 105-103 ,240,43,93,.462,32,66,.485,11,27,.407,8,10,.800,105,40,84,.476,31,64,.484,9,20,.450,14,23,.609,103,2016-01-30,NOP,BRK
77,Home,L 105-108 ,240,42,92,.457,32,63,.508,10,29,.345,11,21,.524,105,47,95,.495,34,65,.523,13,30,.433,1,2,.500,108,2016-01-30,PHI,GSW
78,Home,W 105-87 ,240,39,81,.481,34,61,.557,5,20,.250,22,26,.846,105,27,70,.386,22,48,.458,5,22,.227,28,32,.875,87,2016-01-31,MIA,ATL
79,@,W 105-100 ,240,42,98,.429,32,68,.471,10,30,.333,11,16,.688,105,40,82,.488,33,66,.500,7,16,.438,13,15,.867,100,2016-02-01,DET,BRK
80,Home,W 105-96 (OT),265,38,85,.447,31,67,.463,7,18,.389,22,33,.667,105,39,90,.433,34,69,.493,5,21,.238,13,20,.650,96,2016-02-01,UTA,CHI
81,@,L 105-111 ,240,36,84,.429,30,62,.484,6,22,.273,27,34,.794,105,40,79,.506,31,62,.500,9,17,.529,22,33,.667,111,2016-02-04,NYK,DET
82,Home,L 105-111 ,240,32,83,.386,21,54,.389,11,29,.379,30,32,.938,105,37,86,.430,22,44,.500,15,42,.357,22,32,.688,111,2016-02-04,PHO,HOU
83,@,L 105-112 ,240,40,85,.471,32,65,.492,8,20,.400,17,19,.895,105,45,87,.517,44,75,.587,1,12,.083,21,22,.955,112,2016-02-06,CHI,MIN
84,Home,W 105-104 ,240,42,81,.519,33,62,.532,9,19,.474,12,15,.800,105,42,90,.467,33,65,.508,9,25,.360,11,13,.846,104,2016-02-08,BRK,DEN
85,Home,W 105-86 ,240,39,78,.500,27,53,.509,12,25,.480,15,20,.750,105,35,83,.422,31,66,.470,4,17,.235,12,15,.800,86,2016-02-18,LAC,SAS
86,@,L 105-137 ,240,36,92,.391,24,58,.414,12,34,.353,21,28,.750,105,52,97,.536,35,67,.522,17,30,.567,16,23,.696,137,2016-02-19,GSW,POR
87,@,W 105-102 ,240,41,82,.500,32,58,.552,9,24,.375,14,21,.667,105,38,91,.418,31,66,.470,7,25,.280,19,29,.655,102,2016-02-21,IND,ORL
88,@,L 105-108 ,240,35,77,.455,22,51,.431,13,26,.500,22,25,.880,105,46,91,.505,43,76,.566,3,15,.200,13,16,.813,108,2016-02-24,NYK,IND
89,@,L 105-114 ,240,37,74,.500,31,64,.484,6,10,.600,25,33,.758,105,41,85,.482,31,59,.525,10,26,.385,22,26,.846,114,2016-02-24,MIN,TOR
90,Home,L 105-119 ,240,37,80,.463,24,45,.533,13,35,.371,18,22,.818,105,44,82,.537,34,53,.642,10,29,.345,21,35,.600,119,2016-02-25,POR,HOU
91,Home,W 105-95 ,240,41,83,.494,32,60,.533,9,23,.391,14,16,.875,105,32,77,.416,24,58,.414,8,19,.421,23,33,.697,95,2016-02-29,LAC,BRK
92,@,L 105-109 (OT),265,37,80,.463,25,47,.532,12,33,.364,19,24,.792,105,41,103,.398,29,67,.433,12,36,.333,15,17,.882,109,2016-03-01,ATL,GSW
93,Home,W 105-104 ,240,41,90,.456,37,70,.529,4,20,.200,19,25,.760,105,42,92,.457,33,69,.478,9,23,.391,11,14,.786,104,2016-03-04,BOS,NYK
94,Home,L 105-112 ,240,41,85,.482,33,63,.524,8,22,.364,15,18,.833,105,38,81,.469,29,53,.547,9,28,.321,27,29,.931,112,2016-03-12,DAL,IND
95,Home,W 105-91 ,240,37,77,.481,24,49,.490,13,28,.464,18,25,.720,105,36,82,.439,27,61,.443,9,21,.429,10,12,.833,91,2016-03-18,TOR,BOS
96,@,L 105-109 ,240,33,82,.402,23,43,.535,10,39,.256,29,42,.690,105,35,71,.493,28,50,.560,7,21,.333,32,40,.800,109,2016-03-20,LAC,NOP
97,Home,L 105-120 ,240,39,92,.424,31,71,.437,8,21,.381,19,27,.704,105,46,94,.489,36,69,.522,10,25,.400,18,21,.857,120,2016-03-20,PHI,BOS
98,Home,W 105-100 ,240,35,81,.432,29,61,.475,6,20,.300,29,45,.644,105,40,83,.482,32,61,.525,8,22,.364,12,18,.667,100,2016-03-20,TOR,ORL
99,@,W 105-100 ,240,39,82,.476,29,54,.537,10,28,.357,17,21,.810,105,34,74,.459,26,56,.464,8,18,.444,24,27,.889,100,2016-03-22,CHO,BRK
0,@,L 105-112 ,240,37,93,.398,23,63,.365,14,30,.467,17,22,.773,105,42,91,.462,34,61,.557,8,30,.267,20,26,.769,112,2016-03-25,CHO,DET
1,Home,L 105-116 ,240,37,85,.435,27,62,.435,10,23,.435,21,26,.808,105,45,94,.479,35,68,.515,10,26,.385,16,24,.667,116,2016-03-25,LAL,DEN
2,@,L 105-108 ,240,39,93,.419,29,55,.527,10,38,.263,17,24,.708,105,38,91,.418,30,66,.455,8,25,.320,24,30,.800,108,2016-03-26,PHI,POR
3,@,L 105-117 ,240,42,90,.467,32,60,.533,10,30,.333,11,12,.917,105,44,83,.530,30,50,.600,14,33,.424,15,20,.750,117,2016-03-27,PHI,GSW
4,Home,W 105-90 ,240,38,80,.475,28,52,.538,10,28,.357,19,26,.731,105,37,94,.394,30,65,.462,7,29,.241,9,13,.692,90,2016-03-27,LAC,DEN
5,Home,W 105-93 ,240,38,80,.475,24,51,.471,14,29,.483,15,18,.833,105,37,89,.416,30,74,.405,7,15,.467,12,19,.632,93,2016-03-28,POR,SAC
6,@,L 105-139 ,240,37,79,.468,32,65,.492,5,14,.357,26,39,.667,105,56,91,.615,42,64,.656,14,27,.519,13,19,.684,139,2016-03-29,BRK,ORL
7,Home,L 105-109 ,240,41,95,.432,35,76,.461,6,19,.316,17,27,.630,105,38,78,.487,25,49,.510,13,29,.448,20,24,.833,109,2016-03-30,MEM,DEN
8,Home,W 105-94 ,240,37,77,.481,31,62,.500,6,15,.400,25,34,.735,105,38,84,.452,33,60,.550,5,24,.208,13,17,.765,94,2016-03-30,MIL,PHO
9,Home,W 105-97 ,240,36,80,.450,25,57,.439,11,23,.478,22,28,.786,105,37,83,.446,23,50,.460,14,33,.424,9,13,.692,97,2016-03-30,TOR,ATL
10,Home,W 105-91 ,240,42,84,.500,28,61,.459,14,23,.609,7,7,1.000,105,36,101,.356,32,77,.416,4,24,.167,15,20,.750,91,2016-04-01,NYK,BRK
11,@,W 105-97 ,240,36,80,.450,25,59,.424,11,21,.524,22,31,.710,105,36,85,.424,30,68,.441,6,17,.353,19,21,.905,97,2016-04-07,MIN,SAC
12,Home,W 105-102 ,240,40,89,.449,32,65,.492,8,24,.333,17,21,.810,105,36,83,.434,17,43,.395,19,40,.475,11,18,.611,102,2016-04-09,CHI,CLE
13,Home,L 105-106 ,240,40,80,.500,31,56,.554,9,24,.375,16,18,.889,105,41,84,.488,36,71,.507,5,13,.385,19,25,.760,106,2016-04-09,POR,MIN
14,@,L 105-129 ,240,35,91,.385,21,54,.389,14,37,.378,21,26,.808,105,48,86,.558,37,59,.627,11,27,.407,22,27,.815,129,2016-04-10,BRK,IND
15,Home,L 105-129 ,240,38,83,.458,33,62,.532,5,21,.238,24,33,.727,105,48,86,.558,33,56,.589,15,30,.500,18,26,.692,129,2016-04-11,MIN,HOU
16,@,W 105-101 ,240,41,83,.494,35,66,.530,6,17,.353,17,28,.607,105,41,100,.410,36,78,.462,5,22,.227,14,17,.824,101,2016-04-11,SAC,PHO
17,@,L 105-115 ,240,37,81,.457,20,46,.435,17,35,.486,14,18,.778,105,39,83,.470,24,59,.407,15,24,.625,22,27,.815,115,2016-04-13,PHI,CHI
18,@,L 105-114 ,240,43,96,.448,34,65,.523,9,31,.290,10,12,.833,105,45,99,.455,38,73,.521,7,26,.269,17,22,.773,114,2016-04-13,LAC,PHO
19,Home,W 105-99 ,240,36,92,.391,25,67,.373,11,25,.440,22,30,.733,105,38,76,.500,30,53,.566,8,23,.348,15,24,.625,99,2016-10-27,CHI,BOS
20,Home,W 105-99 ,240,36,88,.409,25,51,.490,11,37,.297,22,30,.733,105,38,84,.452,30,56,.536,8,28,.286,15,26,.577,99,2016-10-29,CLE,ORL
21,Home,W 105-102 ,240,41,88,.466,37,72,.514,4,16,.250,19,25,.760,105,33,81,.407,24,59,.407,9,22,.409,27,35,.771,102,2016-10-31,TOR,DEN
22,@,W 105-95 ,240,36,80,.450,24,49,.490,12,31,.387,21,26,.808,105,34,83,.410,24,55,.436,10,28,.357,17,20,.850,95,2016-11-04,POR,DAL
23,@,L 105-109 (OT),265,39,88,.443,34,69,.493,5,19,.263,22,23,.957,105,36,86,.419,25,54,.463,11,32,.344,26,31,.839,109,2016-11-11,IND,PHI
24,@,W 105-94 ,240,36,86,.419,22,53,.415,14,33,.424,19,26,.731,105,38,87,.437,35,72,.486,3,15,.200,15,19,.789,94,2016-11-11,CLE,WAS
25,@,W 105-99 ,240,35,80,.438,27,55,.491,8,25,.320,27,33,.818,105,36,86,.419,30,59,.508,6,27,.222,21,28,.750,99,2016-11-12,BOS,IND
26,Home,L 105-119 ,240,40,89,.449,32,67,.478,8,22,.364,17,21,.810,105,40,76,.526,29,52,.558,11,24,.458,28,37,.757,119,2016-11-12,MIN,LAC
27,@,L 105-112 ,240,36,91,.396,25,62,.403,11,29,.379,22,29,.759,105,39,99,.394,31,70,.443,8,29,.276,26,32,.813,112,2016-11-13,DEN,POR
28,@,L 105-106 ,240,38,95,.400,26,54,.481,12,41,.293,17,20,.850,105,35,79,.443,29,58,.500,6,21,.286,30,36,.833,106,2016-11-14,BOS,NOP
29,Home,W 105-102 ,240,42,93,.452,33,68,.485,9,25,.360,12,19,.632,105,42,85,.494,34,62,.548,8,23,.348,10,12,.833,102,2016-11-16,NYK,DET
30,Home,W 105-103 ,240,40,84,.476,28,59,.475,12,25,.480,13,14,.929,105,40,92,.435,26,52,.500,14,40,.350,9,14,.643,103,2016-11-16,OKC,HOU
31,Home,L 105-110 ,240,36,76,.474,27,56,.482,9,20,.450,24,31,.774,105,43,88,.489,32,58,.552,11,30,.367,13,17,.765,110,2016-11-16,SAC,SAS
32,@,L 105-124 ,240,35,83,.422,24,54,.444,11,29,.379,24,30,.800,105,49,89,.551,42,63,.667,7,26,.269,19,24,.792,124,2016-11-18,BRK,OKC
33,@,L 105-120 ,240,39,92,.424,33,71,.465,6,21,.286,21,34,.618,105,45,86,.523,28,51,.549,17,35,.486,13,20,.650,120,2016-11-19,PHO,PHI
34,Home,W 105-91 ,240,42,86,.488,34,64,.531,8,22,.364,13,30,.433,105,33,85,.388,26,59,.441,7,26,.269,18,23,.783,91,2016-11-20,DEN,UTA
35,@,W 105-90 ,240,40,84,.476,28,58,.483,12,26,.462,13,17,.765,105,30,73,.411,21,42,.500,9,31,.290,21,33,.636,90,2016-11-21,MEM,CHO
36,@,W 105-99 ,240,38,82,.463,24,50,.480,14,32,.438,15,19,.789,105,40,79,.506,28,50,.560,12,29,.414,7,12,.583,99,2016-11-25,TOR,MIL
37,@,W 105-89 ,240,40,90,.444,34,69,.493,6,21,.286,19,26,.731,105,31,78,.397,22,56,.393,9,22,.409,18,22,.818,89,2016-11-25,CHI,PHI
38,Home,L 105-122 ,240,38,87,.437,22,48,.458,16,39,.410,13,14,.929,105,46,86,.535,33,63,.524,13,23,.565,17,22,.773,122,2016-11-27,BRK,SAC
39,Home,W 105-100 ,240,37,85,.435,25,50,.500,12,35,.343,19,24,.792,105,36,86,.419,29,57,.509,7,29,.241,21,30,.700,100,2016-11-28,GSW,ATL
40,Home,W 105-88 ,240,38,88,.432,30,57,.526,8,31,.258,21,25,.840,105,37,87,.425,32,57,.561,5,30,.167,9,18,.500,88,2016-11-29,NOP,LAL
41,@,L 105-120 ,240,36,81,.444,25,54,.463,11,27,.407,22,26,.846,105,38,69,.551,22,37,.595,16,32,.500,28,33,.848,120,2016-11-30,MEM,TOR
42,@,L 105-111 ,240,45,83,.542,35,57,.614,10,26,.385,5,10,.500,105,47,96,.490,44,78,.564,3,18,.167,14,17,.824,111,2016-12-02,CLE,CHI
43,@,W 105-88 ,240,37,78,.474,24,52,.462,13,26,.500,18,26,.692,105,36,95,.379,27,63,.429,9,32,.281,7,10,.700,88,2016-12-02,ORL,PHI
44,@,L 105-107 ,240,41,81,.506,34,70,.486,7,11,.636,16,18,.889,105,39,80,.488,31,60,.517,8,20,.400,21,33,.636,107,2016-12-02,WAS,SAS
45,Home,W 105-98 ,240,35,78,.449,26,53,.491,9,25,.360,26,28,.929,105,37,83,.446,24,59,.407,13,24,.542,11,14,.786,98,2016-12-03,UTA,DEN
46,@,W 105-91 ,240,39,74,.527,28,50,.560,11,24,.458,16,19,.842,105,36,82,.439,29,62,.468,7,20,.350,12,18,.667,91,2016-12-06,SAS,MIN
47,@,L 105-112 ,240,39,84,.464,33,66,.500,6,18,.333,21,25,.840,105,36,73,.493,24,46,.522,12,27,.444,28,32,.875,112,2016-12-06,PHO,UTA
48,Home,W 105-100 ,240,38,84,.452,37,76,.487,1,8,.125,28,31,.903,105,42,91,.462,37,71,.521,5,20,.250,11,18,.611,100,2016-12-10,CHI,MIA
49,@,L 105-116 ,240,39,86,.453,29,59,.492,10,27,.370,17,24,.708,105,42,73,.575,29,42,.690,13,31,.419,19,28,.679,116,2016-12-10,CHO,CLE
50,@,L 105-133 ,240,40,83,.482,32,64,.500,8,19,.421,17,26,.654,105,54,94,.574,37,58,.638,17,36,.472,8,9,.889,133,2016-12-10,NOP,LAC
51,@,L 105-110 ,240,40,79,.506,27,54,.500,13,25,.520,12,15,.800,105,40,88,.455,32,67,.478,8,21,.381,22,28,.786,110,2016-12-10,MIL,WAS
52,@,W 105-90 ,240,40,83,.482,34,64,.531,6,19,.316,19,25,.760,105,32,84,.381,22,54,.407,10,30,.333,16,22,.727,90,2016-12-17,IND,DET
53,@,W 105-95 ,240,41,90,.456,32,62,.516,9,28,.321,14,19,.737,105,36,69,.522,27,45,.600,9,24,.375,14,25,.560,95,2016-12-18,BOS,MIA
54,@,L 105-107 ,240,38,88,.432,30,55,.545,8,33,.242,21,26,.808,105,41,87,.471,34,66,.515,7,21,.333,18,21,.857,107,2016-12-19,WAS,IND
55,Home,L 105-109 ,240,36,79,.456,24,47,.511,12,32,.375,21,26,.808,105,42,80,.525,27,51,.529,15,29,.517,10,14,.714,109,2016-12-23,MIN,SAC
56,Home,W 105-103 ,240,42,81,.519,32,53,.604,10,28,.357,11,14,.786,105,42,94,.447,35,69,.507,7,25,.280,12,17,.706,103,2016-12-28,DEN,MIN
57,@,L 105-111 ,240,35,79,.443,24,51,.471,11,28,.393,24,29,.828,105,38,78,.487,30,56,.536,8,22,.364,27,37,.730,111,2016-12-28,IND,WAS
58,Home,W 105-98 ,240,39,88,.443,31,62,.500,8,26,.308,19,25,.760,105,35,84,.417,26,53,.491,9,31,.290,19,21,.905,98,2016-12-30,ATL,DET
59,@,L 105-113 ,240,41,92,.446,30,62,.484,11,30,.367,12,14,.857,105,37,78,.474,20,46,.435,17,32,.531,22,24,.917,113,2017-01-03,WAS,DAL
60,@,W 105-104 ,240,37,78,.474,28,50,.560,9,28,.321,22,31,.710,105,42,94,.447,29,66,.439,13,28,.464,7,12,.583,104,2017-01-04,MIL,NYK
61,@,L 105-112 ,240,42,88,.477,35,70,.500,7,18,.389,14,17,.824,105,46,79,.582,34,57,.596,12,22,.545,8,9,.889,112,2017-01-06,MIN,WAS
62,@,W 105-95 ,240,37,94,.394,29,67,.433,8,27,.296,23,27,.852,105,36,78,.462,26,51,.510,10,27,.370,13,17,.765,95,2017-01-08,PHI,BRK
63,Home,W 105-96 ,240,39,76,.513,30,50,.600,9,26,.346,18,26,.692,105,39,92,.424,33,65,.508,6,27,.222,12,18,.667,96,2017-01-11,LAC,ORL
64,@,L 105-119 ,240,36,87,.414,21,45,.467,15,42,.357,18,22,.818,105,44,81,.543,36,58,.621,8,23,.348,23,25,.920,119,2017-01-11,HOU,MIN
65,Home,L 105-110 ,240,33,82,.402,23,41,.561,10,41,.244,29,36,.806,105,41,76,.539,31,49,.633,10,27,.370,18,27,.667,110,2017-01-13,HOU,MEM
66,@,L 105-108 ,240,36,71,.507,27,51,.529,9,20,.450,24,34,.706,105,39,85,.459,31,64,.484,8,21,.381,22,24,.917,108,2017-01-14,SAS,PHO
67,@,L 105-112 ,240,38,89,.427,21,48,.438,17,41,.415,12,15,.800,105,39,82,.476,25,53,.472,14,29,.483,20,22,.909,112,2017-01-21,BRK,CHO
68,Home,L 105-107 ,240,40,89,.449,29,68,.426,11,21,.524,14,16,.875,105,37,85,.435,28,61,.459,9,24,.375,24,27,.889,107,2017-01-21,NYK,PHO
69,Home,L 105-115 ,240,37,88,.420,28,59,.475,9,29,.310,22,26,.846,105,42,84,.500,28,60,.467,14,24,.583,17,22,.773,115,2017-01-23,ATL,LAC
70,Home,W 105-102 ,240,38,86,.442,25,56,.446,13,30,.433,16,27,.593,105,41,88,.466,33,58,.569,8,30,.267,12,20,.600,102,2017-01-23,MIA,GSW
71,Home,L 105-114 ,240,41,96,.427,30,69,.435,11,27,.407,12,19,.632,105,42,91,.462,32,64,.500,10,27,.370,20,28,.714,114,2017-01-25,NOP,OKC
72,Home,W 105-98 ,240,43,90,.478,39,75,.520,4,15,.267,15,20,.750,105,37,94,.394,26,65,.400,11,29,.379,13,14,.929,98,2017-01-25,POR,LAL
73,@,W 105-101 ,240,39,87,.448,27,53,.509,12,34,.353,15,16,.938,105,39,83,.470,31,61,.508,8,22,.364,15,23,.652,101,2017-01-29,DAL,SAS
74,@,L 105-111 (OT),265,41,96,.427,31,61,.508,10,35,.286,13,19,.684,105,40,92,.435,28,63,.444,12,29,.414,19,26,.731,111,2017-01-30,ORL,MIN
75,Home,W 105-83 ,240,38,85,.447,24,40,.600,14,45,.311,15,22,.682,105,30,86,.349,22,57,.386,8,29,.276,15,26,.577,83,2017-01-31,HOU,SAC
76,@,W 105-103 ,240,32,77,.416,20,48,.417,12,29,.414,29,35,.829,105,38,85,.447,28,58,.483,10,27,.370,17,22,.773,103,2017-02-03,PHO,SAC
77,Home,W 105-84 ,240,44,91,.484,37,67,.552,7,24,.292,10,15,.667,105,31,75,.413,25,58,.431,6,17,.353,16,20,.800,84,2017-02-04,IND,DET
78,Home,W 105-98 ,240,38,81,.469,25,48,.521,13,33,.394,16,24,.667,105,35,82,.427,22,49,.449,13,33,.394,15,18,.833,98,2017-02-04,UTA,CHO
79,Home,W 105-91 ,240,38,83,.458,28,52,.538,10,31,.323,19,22,.864,105,37,84,.440,32,67,.478,5,17,.294,12,22,.545,91,2017-02-04,WAS,NOP
80,Home,W 105-99 ,240,40,98,.408,36,80,.450,4,18,.222,21,28,.750,105,35,87,.402,25,59,.424,10,28,.357,19,21,.905,99,2017-02-05,OKC,POR
81,@,L 105-112 (OT),265,39,85,.459,26,56,.464,13,29,.448,14,17,.824,105,44,87,.506,39,67,.582,5,20,.250,19,25,.760,112,2017-02-09,UTA,DAL
82,Home,W 105-99 ,240,35,78,.449,24,47,.511,11,31,.355,24,27,.889,105,34,82,.415,21,51,.412,13,31,.419,18,21,.857,99,2017-02-12,SAC,NOP
83,@,W 105-99 ,240,41,86,.477,29,53,.547,12,33,.364,11,17,.647,105,34,78,.436,23,47,.489,11,31,.355,20,26,.769,99,2017-02-13,PHI,CHO
84,Home,W 105-94 ,240,35,73,.479,28,56,.500,7,17,.412,28,35,.800,105,35,77,.455,30,57,.526,5,20,.250,19,24,.792,94,2017-02-14,CHI,TOR
85,@,L 105-116 ,240,41,86,.477,30,65,.462,11,21,.524,12,14,.857,105,41,88,.466,29,65,.446,12,23,.522,22,31,.710,116,2017-02-15,NYK,OKC
86,@,W 105-97 ,240,35,82,.427,26,56,.464,9,26,.346,26,30,.867,105,35,79,.443,28,56,.500,7,23,.304,20,24,.833,97,2017-02-24,SAS,LAC
87,Home,W 105-86 ,240,37,81,.457,29,54,.537,8,27,.296,23,24,.958,105,32,85,.376,24,60,.400,8,25,.320,14,26,.538,86,2017-02-25,ORL,ATL
88,@,W 105-98 ,240,36,80,.450,25,47,.532,11,33,.333,22,25,.880,105,37,84,.440,26,50,.520,11,34,.324,13,17,.765,98,2017-02-26,MEM,DEN
89,@,W 105-96 ,240,40,84,.476,31,59,.525,9,25,.360,16,19,.842,105,33,90,.367,26,70,.371,7,20,.350,23,26,.885,96,2017-03-01,WAS,TOR
90,Home,W 105-102 ,240,36,83,.434,27,55,.491,9,28,.321,24,31,.774,105,33,84,.393,26,63,.413,7,21,.333,29,33,.879,102,2017-03-03,PHI,NYK
91,@,W 105-97 ,240,36,89,.404,27,65,.415,9,24,.375,24,35,.686,105,38,83,.458,28,55,.509,10,28,.357,11,15,.733,97,2017-03-05,NOP,LAL
92,Home,L 105-112 ,240,39,83,.470,32,61,.525,7,22,.318,20,25,.800,105,40,88,.455,27,53,.509,13,35,.371,19,23,.826,112,2017-03-05,NYK,GSW
93,Home,L 105-113 ,240,40,85,.471,31,53,.585,9,32,.281,16,24,.667,105,40,86,.465,34,72,.472,6,14,.429,27,28,.964,113,2017-03-06,ORL,NYK
94,@,L 105-110 ,240,37,80,.463,26,46,.565,11,34,.324,20,25,.800,105,41,95,.432,37,75,.493,4,20,.200,24,32,.750,110,2017-03-08,BRK,ATL
95,@,L 104-106 ,240,39,76,.513,37,71,.521,2,5,.400,24,31,.774,104,35,74,.473,26,54,.481,9,20,.450,27,34,.794,106,2011-12-25,BOS,NYK
96,@,W 104-96 ,240,42,79,.532,33,58,.569,9,21,.429,11,13,.846,104,35,85,.412,29,65,.446,6,20,.300,20,28,.714,96,2011-12-26,TOR,CLE
97,@,W 104-100 ,240,35,78,.449,30,62,.484,5,16,.313,29,31,.935,104,39,87,.448,36,65,.554,3,22,.136,19,26,.731,100,2011-12-26,OKC,MIN
98,Home,W 104-95 ,240,44,83,.530,35,61,.574,9,22,.409,7,10,.700,104,36,82,.439,30,55,.545,6,27,.222,17,20,.850,95,2011-12-26,ORL,HOU
99,Home,W 104-102 ,240,37,63,.587,31,49,.633,6,14,.429,24,32,.750,104,38,90,.422,29,64,.453,9,26,.346,17,21,.810,102,2011-12-29,OKC,DAL
0,Home,W 104-89 ,240,36,74,.486,26,58,.448,10,16,.625,22,31,.710,104,33,89,.371,31,73,.425,2,16,.125,21,25,.840,89,2011-12-31,SAS,UTA
1,Home,W 104-64 ,240,39,84,.464,34,71,.479,5,13,.385,21,29,.724,104,26,84,.310,25,75,.333,1,9,.111,11,14,.786,64,2012-01-01,CHI,MEM
2,@,W 104-97 ,240,37,87,.425,27,55,.491,10,32,.313,20,31,.645,104,38,73,.521,35,53,.660,3,20,.150,18,24,.750,97,2012-01-08,ORL,SAC
3,Home,L 104-107 ,240,41,86,.477,31,61,.508,10,25,.400,12,13,.923,104,41,70,.586,25,43,.581,16,27,.593,9,19,.474,107,2012-01-11,POR,ORL
4,@,L 104-117 ,240,38,81,.469,31,65,.477,7,16,.438,21,29,.724,104,43,78,.551,31,53,.585,12,25,.480,19,26,.731,117,2012-01-13,MIA,DEN
5,Home,W 104-92 ,240,34,71,.479,27,53,.509,7,18,.389,29,34,.853,104,34,83,.410,29,64,.453,5,19,.263,19,23,.826,92,2012-01-14,OKC,NYK
6,Home,L 104-108 (OT),265,43,98,.439,39,84,.464,4,14,.286,14,19,.737,104,43,89,.483,36,71,.507,7,18,.389,15,22,.682,108,2012-01-18,PHI,DEN
7,Home,L 104-108 ,240,40,95,.421,29,69,.420,11,26,.423,13,17,.765,104,39,79,.494,29,58,.500,10,21,.476,20,30,.667,108,2012-01-20,WAS,DEN
8,@,W 104-102 ,240,41,75,.547,34,59,.576,7,16,.438,15,20,.750,104,42,83,.506,36,71,.507,6,12,.500,12,13,.923,102,2012-01-23,SAS,NOH
9,Home,W 104-99 ,240,41,87,.471,37,73,.507,4,14,.286,18,22,.818,104,37,78,.474,33,68,.485,4,10,.400,21,23,.913,99,2012-02-07,IND,UTA
10,@,W 104-97 ,240,39,90,.433,30,69,.435,9,21,.429,17,23,.739,104,32,79,.405,26,56,.464,6,23,.261,27,31,.871,97,2012-02-10,DAL,MIN
11,Home,W 104-103 ,240,37,73,.507,33,63,.524,4,10,.400,26,38,.684,104,35,82,.427,23,56,.411,12,26,.462,21,27,.778,103,2012-02-18,MEM,GSW
12,Home,W 104-97 ,240,40,86,.465,28,57,.491,12,29,.414,12,18,.667,104,36,81,.444,24,48,.500,12,33,.364,13,17,.765,97,2012-02-19,NYK,DAL
13,Home,W 104-97 ,240,38,83,.458,29,60,.483,9,23,.391,19,24,.792,104,33,77,.429,22,51,.431,11,26,.423,20,27,.741,97,2012-02-20,GSW,LAC
14,Home,W 104-88 ,240,37,79,.468,30,58,.517,7,21,.333,23,29,.793,104,36,84,.429,31,64,.484,5,20,.250,11,19,.579,88,2012-02-20,PHO,WAS
15,@,L 104-119 ,240,34,70,.486,27,52,.519,7,18,.389,29,34,.853,104,42,84,.500,33,65,.508,9,19,.474,26,35,.743,119,2012-02-22,BOS,OKC
16,Home,L 104-106 ,240,43,90,.478,39,71,.549,4,19,.211,14,20,.700,104,39,84,.464,30,64,.469,9,20,.450,19,22,.864,106,2012-02-22,PHO,GSW
17,Home,W 104-95 ,240,44,91,.484,38,70,.543,6,21,.286,10,16,.625,104,38,87,.437,29,63,.460,9,24,.375,10,11,.909,95,2012-02-29,DEN,POR
18,Home,W 104-85 ,240,41,84,.488,36,63,.571,5,21,.238,17,22,.773,104,35,89,.393,30,70,.429,5,19,.263,10,18,.556,85,2012-02-29,LAL,MIN
19,Home,W 104-83 ,240,42,87,.483,38,75,.507,4,12,.333,16,16,1.000,104,32,82,.390,26,59,.441,6,23,.261,13,16,.813,83,2012-02-29,UTA,HOU
20,Home,W 104-95 ,240,42,79,.532,39,71,.549,3,8,.375,17,21,.810,104,34,86,.395,33,73,.452,1,13,.077,26,32,.813,95,2012-03-01,PHO,MIN
21,@,W 104-101 ,240,33,68,.485,28,51,.549,5,17,.294,33,44,.750,104,31,80,.388,29,66,.439,2,14,.143,37,39,.949,101,2012-03-04,NJN,CHA
22,Home,L 104-106 ,240,42,88,.477,37,73,.507,5,15,.333,15,19,.789,104,43,83,.518,38,67,.567,5,16,.313,15,17,.882,106,2012-03-07,MIL,CHI
23,@,L 104-115 ,240,38,84,.452,35,65,.538,3,19,.158,25,34,.735,104,40,91,.440,32,65,.492,8,26,.308,27,32,.844,115,2012-03-07,PHO,OKC
24,Home,W 104-86 ,240,42,88,.477,34,70,.486,8,18,.444,12,17,.706,104,31,72,.431,25,57,.439,6,15,.400,18,23,.783,86,2012-03-09,BOS,POR
25,Home,W 104-91 ,240,41,78,.526,38,71,.535,3,7,.429,19,27,.704,104,34,84,.405,31,73,.425,3,11,.273,20,24,.833,91,2012-03-09,PHI,UTA
26,Home,W 104-99 ,240,40,93,.430,35,79,.443,5,14,.357,19,28,.679,104,37,80,.463,34,69,.493,3,11,.273,22,31,.710,99,2012-03-12,CHI,NYK
27,@,W 104-103 ,240,41,89,.461,31,65,.477,10,24,.417,12,14,.857,104,39,84,.464,31,61,.508,8,23,.348,17,22,.773,103,2012-03-13,HOU,OKC
28,Home,W 104-98 (OT),265,36,73,.493,25,45,.556,11,28,.393,21,37,.568,104,40,91,.440,32,68,.471,8,23,.348,10,11,.909,98,2012-03-13,ORL,MIA
29,@,L 104-107 ,240,42,83,.506,36,67,.537,6,16,.375,14,16,.875,104,39,80,.488,30,60,.500,9,20,.450,20,27,.741,107,2012-03-20,LAL,HOU
30,Home,W 104-87 ,240,43,88,.489,34,63,.540,9,25,.360,9,11,.818,104,31,81,.383,20,55,.364,11,26,.423,14,17,.824,87,2012-03-23,SAS,DAL
31,Home,L 104-125 ,240,40,91,.440,30,70,.429,10,21,.476,14,18,.778,104,43,84,.512,36,72,.500,7,12,.583,32,39,.821,125,2012-03-24,MIL,IND
32,@,W 104-101 ,240,36,86,.419,31,66,.470,5,20,.250,27,34,.794,104,39,91,.429,33,72,.458,6,19,.316,17,18,.944,101,2012-03-27,LAL,GSW
33,@,W 104-103 ,240,39,90,.433,35,74,.473,4,16,.250,22,32,.688,104,31,88,.352,28,75,.373,3,13,.231,38,52,.731,103,2012-03-30,SAC,UTA
34,@,W 104-102 (OT),265,37,83,.446,31,68,.456,6,15,.400,24,28,.857,104,44,101,.436,35,80,.438,9,21,.429,5,10,.500,102,2012-04-01,IND,HOU
35,@,W 104-101 ,240,40,72,.556,32,53,.604,8,19,.421,16,21,.762,104,37,88,.420,29,56,.518,8,32,.250,19,25,.760,101,2012-04-01,DEN,ORL
36,@,L 104-112 ,240,38,83,.458,28,60,.467,10,23,.435,18,25,.720,104,41,86,.477,35,63,.556,6,23,.261,24,31,.774,112,2012-04-03,NYK,IND
37,Home,W 104-98 ,240,38,79,.481,32,63,.508,6,16,.375,22,25,.880,104,39,86,.453,30,64,.469,9,22,.409,11,12,.917,98,2012-04-06,UTA,GSW
38,@,W 104-87 ,240,42,93,.452,33,71,.465,9,22,.409,11,13,.846,104,30,70,.429,23,56,.411,7,14,.500,20,37,.541,87,2012-04-08,HOU,SAC
39,@,L 104-114 ,240,41,93,.441,35,77,.455,6,16,.375,16,26,.615,104,35,69,.507,29,47,.617,6,22,.273,38,43,.884,114,2012-04-08,UTA,SAS
40,@,W 104-98 (OT),265,36,77,.468,28,57,.491,8,20,.400,24,32,.750,104,40,88,.455,37,67,.552,3,21,.143,15,19,.789,98,2012-04-11,IND,CLE
41,Home,W 104-93 ,240,42,84,.500,38,70,.543,4,14,.286,16,19,.842,104,38,79,.481,31,55,.564,7,24,.292,10,14,.714,93,2012-04-11,MEM,PHO
42,@,L 104-112 ,240,37,80,.463,22,49,.449,15,31,.484,15,21,.714,104,44,81,.543,34,59,.576,10,22,.455,14,30,.467,112,2012-04-14,GSW,LAC
43,Home,W 104-103 ,240,45,95,.474,37,76,.487,8,19,.421,6,9,.667,104,40,76,.526,24,44,.545,16,32,.500,7,10,.700,103,2012-04-15,SAC,POR
44,@,W 104-98 ,240,38,78,.487,24,54,.444,14,24,.583,14,20,.700,104,36,73,.493,31,55,.564,5,18,.278,21,26,.808,98,2012-04-18,LAC,DEN
45,@,W 104-95 ,240,36,83,.434,23,48,.479,13,35,.371,19,24,.792,104,35,78,.449,25,53,.472,10,25,.400,15,17,.882,95,2012-04-18,NYK,NJN
46,Home,W 104-94 ,240,38,81,.469,35,62,.565,3,19,.158,25,26,.962,104,37,83,.446,28,64,.438,9,19,.474,11,21,.524,94,2012-04-20,DAL,GSW
47,@,W 104-84 ,240,44,85,.518,36,65,.554,8,20,.400,8,15,.533,104,32,74,.432,26,58,.448,6,16,.375,14,26,.538,84,2012-04-26,NYK,CHA
48,Home,W 104-70 ,240,42,76,.553,37,66,.561,5,10,.500,15,24,.625,104,24,67,.358,20,49,.408,4,18,.222,18,24,.750,70,2012-04-26,WAS,MIA
49,@,W 104-94 ,240,35,77,.455,29,64,.453,6,13,.462,28,34,.824,104,36,80,.450,26,60,.433,10,20,.500,12,17,.706,94,2012-11-02,MEM,GSW
50,Home,W 104-84 ,240,36,84,.429,17,48,.354,19,36,.528,13,15,.867,104,33,71,.465,26,51,.510,7,20,.350,11,13,.846,84,2012-11-02,NYK,MIA
51,@,W 104-95 ,240,41,83,.494,33,58,.569,8,25,.320,14,20,.700,104,33,71,.465,24,49,.490,9,22,.409,20,22,.909,95,2012-11-04,ATL,OKC
52,@,L 104-109 ,240,36,81,.444,31,59,.525,5,22,.227,27,31,.871,104,39,84,.464,31,63,.492,8,21,.381,23,35,.657,109,2012-11-07,TOR,DAL
53,Home,W 104-84 ,240,40,92,.435,34,75,.453,6,17,.353,18,25,.720,104,32,87,.368,28,64,.438,4,23,.174,16,22,.727,84,2012-11-09,DEN,UTA
54,Home,W 104-94 ,240,35,84,.417,27,62,.435,8,22,.364,26,38,.684,104,33,81,.407,25,53,.472,8,28,.286,20,23,.870,94,2012-11-09,NYK,DAL
55,Home,W 104-86 ,240,38,86,.442,24,62,.387,14,24,.583,14,16,.875,104,30,79,.380,26,64,.406,4,15,.267,22,36,.611,86,2012-11-11,MEM,MIA
56,@,W 104-100 ,240,39,86,.453,28,60,.467,11,26,.423,15,23,.652,104,38,87,.437,30,58,.517,8,29,.276,16,21,.762,100,2012-11-15,NYK,SAS
57,@,W 104-97 ,240,41,83,.494,39,66,.591,2,17,.118,20,22,.909,104,38,92,.413,31,76,.408,7,16,.438,14,21,.667,97,2012-11-23,SAS,IND
58,@,L 104-108 ,240,37,87,.425,29,61,.475,8,26,.308,22,30,.733,104,40,80,.500,29,59,.492,11,21,.524,17,20,.850,108,2012-11-23,CLE,ORL
59,Home,W 104-102 ,240,36,83,.434,33,68,.485,3,15,.200,29,33,.879,104,40,80,.500,30,63,.476,10,17,.588,12,16,.750,102,2012-11-23,UTA,SAC
60,Home,W 104-93 ,240,38,75,.507,31,58,.534,7,17,.412,21,26,.808,104,32,75,.427,24,56,.429,8,19,.421,21,25,.840,93,2012-11-24,ATL,LAC
61,Home,W 104-101 ,240,39,81,.481,30,62,.484,9,19,.474,17,23,.739,104,39,83,.470,35,72,.486,4,11,.364,19,20,.950,101,2012-11-25,PHI,PHO
62,@,W 104-98 ,240,44,86,.512,36,69,.522,8,17,.471,8,10,.800,104,39,83,.470,31,66,.470,8,17,.471,12,18,.667,98,2012-11-30,PHI,CHA
63,Home,L 104-105 ,240,42,74,.568,33,54,.611,9,20,.450,11,15,.733,104,42,89,.472,38,68,.559,4,21,.190,17,24,.708,105,2012-12-03,UTA,LAC
64,@,L 104-108 ,240,38,79,.481,31,62,.500,7,17,.412,21,25,.840,104,42,95,.442,34,73,.466,8,22,.364,16,19,.842,108,2012-12-05,DEN,ATL
65,Home,W 104-94 ,240,41,78,.526,37,61,.607,4,17,.235,18,26,.692,104,37,84,.440,31,65,.477,6,19,.316,14,30,.467,94,2012-12-05,BOS,MIN
66,@,W 104-97 ,240,34,75,.453,25,51,.490,9,24,.375,27,34,.794,104,35,79,.443,29,58,.500,6,21,.286,21,31,.677,97,2012-12-05,GSW,DET
67,Home,W 104-95 ,240,41,85,.482,31,59,.525,10,26,.385,12,19,.632,104,36,79,.456,29,63,.460,7,16,.438,16,20,.800,95,2012-12-07,ATL,WAS
68,Home,L 104-108 ,240,36,70,.514,28,56,.500,8,14,.571,24,31,.774,104,43,82,.524,38,68,.559,5,14,.357,17,21,.810,108,2012-12-07,DET,CHI
69,@,W 104-97 ,240,35,75,.467,26,60,.433,9,15,.600,25,33,.758,104,39,91,.429,33,64,.516,6,27,.222,13,17,.765,97,2012-12-08,DET,CLE
70,Home,W 104-93 ,240,37,76,.487,32,57,.561,5,19,.263,25,30,.833,104,38,82,.463,32,65,.492,6,17,.353,11,13,.846,93,2012-12-09,OKC,IND
71,@,W 104-96 ,240,38,84,.452,30,64,.469,8,20,.400,20,23,.870,104,31,83,.373,22,57,.386,9,26,.346,25,32,.781,96,2012-12-10,GSW,CHA
72,Home,W 104-97 ,240,44,82,.537,40,71,.563,4,11,.364,12,23,.522,104,32,81,.395,27,63,.429,5,18,.278,28,33,.848,97,2012-12-10,PHI,DET
73,Home,W 104-84 ,240,41,80,.513,32,64,.500,9,16,.563,13,18,.722,104,32,86,.372,30,71,.423,2,15,.133,18,25,.720,84,2012-12-19,IND,UTA
74,@,L 104-121 ,240,40,86,.465,34,76,.447,6,10,.600,18,22,.818,104,47,85,.553,30,57,.526,17,28,.607,10,11,.909,121,2012-12-19,CHA,PHO
75,Home,W 104-87 ,240,40,86,.465,33,62,.532,7,24,.292,17,28,.607,104,36,87,.414,33,68,.485,3,19,.158,12,16,.750,87,2012-12-28,LAL,POR
76,@,W 104-97 (OT),265,37,85,.435,32,61,.525,5,24,.208,25,32,.781,104,37,82,.451,32,69,.464,5,13,.385,18,24,.750,97,2012-12-28,TOR,NOH
77,Home,W 104-85 ,240,40,98,.408,32,77,.416,8,21,.381,16,17,.941,104,33,76,.434,29,63,.460,4,13,.308,15,24,.625,85,2012-12-29,MIL,MIA
78,@,L 104-123 ,240,43,90,.478,31,67,.463,12,23,.522,6,7,.857,104,45,84,.536,29,55,.527,16,29,.552,17,22,.773,123,2012-12-31,ATL,HOU
79,Home,W 104-73 ,240,43,73,.589,37,59,.627,6,14,.429,12,16,.750,104,28,74,.378,24,57,.421,4,17,.235,13,17,.765,73,2012-12-31,SAS,BRK
80,Home,W 104-92 ,240,41,83,.494,36,59,.610,5,24,.208,17,23,.739,104,38,90,.422,33,74,.446,5,16,.313,11,20,.550,92,2013-01-02,HOU,NOH
81,Home,L 104-106 ,240,37,82,.451,29,65,.446,8,17,.471,22,28,.786,104,39,78,.500,32,62,.516,7,16,.438,21,29,.724,106,2013-01-04,CHA,CLE
82,Home,L 104-112 ,240,36,91,.396,29,68,.426,7,23,.304,25,28,.893,104,37,79,.468,25,45,.556,12,34,.353,26,36,.722,112,2013-01-05,CLE,HOU
83,@,W 104-92 ,240,38,77,.494,32,55,.582,6,22,.273,22,24,.917,104,34,76,.447,26,53,.491,8,23,.348,16,21,.762,92,2013-01-06,OKC,TOR
84,@,W 104-96 ,240,39,84,.464,29,62,.468,10,22,.455,16,21,.762,104,39,95,.411,35,85,.412,4,10,.400,14,20,.700,96,2013-01-09,MIL,CHI
85,Home,W 104-92 ,240,44,84,.524,36,62,.581,8,22,.364,8,9,.889,104,31,69,.449,27,51,.529,4,18,.222,26,33,.788,92,2013-01-11,NOH,MIN
86,Home,W 104-83 ,240,39,80,.488,28,63,.444,11,17,.647,15,21,.714,104,32,84,.381,29,76,.382,3,8,.375,16,26,.615,83,2013-01-12,DAL,MEM
87,@,W 104-101 ,240,39,81,.481,28,56,.500,11,25,.440,15,19,.789,104,43,88,.489,34,66,.515,9,22,.409,6,6,1.000,101,2013-01-12,ORL,LAC
88,Home,W 104-97 ,240,36,76,.474,28,58,.483,8,18,.444,24,28,.857,104,39,72,.542,30,49,.612,9,23,.391,10,16,.625,97,2013-01-14,UTA,MIA
89,Home,W 104-88 ,240,42,84,.500,32,55,.582,10,29,.345,10,18,.556,104,34,95,.358,27,67,.403,7,28,.250,13,22,.591,88,2013-01-15,LAL,MIL
90,Home,L 104-110 ,240,34,81,.420,26,53,.491,8,28,.286,28,32,.875,104,39,88,.443,33,70,.471,6,18,.333,26,32,.813,110,2013-01-19,POR,MIL
91,Home,W 104-96 ,240,41,71,.577,31,55,.564,10,16,.625,12,21,.571,104,36,74,.486,31,60,.517,5,14,.357,19,26,.731,96,2013-01-21,ATL,MIN
92,@,W 104-92 ,240,43,87,.494,31,62,.500,12,25,.480,6,12,.500,104,31,76,.408,25,61,.410,6,15,.400,24,29,.828,92,2013-01-23,ATL,CHA
93,Home,W 104-99 ,240,37,84,.440,31,61,.508,6,23,.261,24,27,.889,104,36,78,.462,31,62,.500,5,16,.313,22,27,.815,99,2013-01-23,GSW,OKC
94,@,L 104-106 ,240,39,65,.600,29,42,.690,10,23,.435,16,20,.800,104,39,72,.542,23,45,.511,16,27,.593,12,17,.706,106,2013-01-27,ATL,NYK
95,@,W 104-102 ,240,40,79,.506,29,56,.518,11,23,.478,13,18,.722,104,40,90,.444,30,67,.448,10,23,.435,12,16,.750,102,2013-01-27,DET,ORL
96,@,L 104-106 ,240,42,84,.500,34,69,.493,8,15,.533,12,15,.800,104,39,86,.453,29,58,.500,10,28,.357,18,23,.783,106,2013-01-29,DAL,POR
97,@,W 104-88 ,240,45,91,.495,41,78,.526,4,13,.308,10,13,.769,104,34,82,.415,28,68,.412,6,14,.429,14,19,.737,88,2013-01-30,CHI,MIL
98,Home,W 104-99 ,240,34,68,.500,30,56,.536,4,12,.333,32,46,.696,104,37,78,.474,29,56,.518,8,22,.364,17,28,.607,99,2013-01-30,UTA,NOH
99,@,L 104-106 ,240,40,79,.506,31,58,.534,9,21,.429,15,21,.714,104,36,72,.500,25,54,.463,11,18,.611,23,27,.852,106,2013-02-03,LAC,BOS
0,@,L 104-112 ,240,48,100,.480,45,84,.536,3,16,.188,5,11,.455,104,40,91,.440,35,75,.467,5,16,.313,27,37,.730,112,2013-02-05,MIL,DEN
1,@,W 104-94 ,240,37,81,.457,27,56,.482,10,25,.400,20,21,.952,104,33,81,.407,25,63,.397,8,18,.444,20,23,.870,94,2013-02-06,SAS,MIN
2,@,L 104-110 ,240,42,83,.506,32,56,.571,10,27,.370,10,12,.833,104,47,93,.505,42,78,.538,5,15,.333,11,18,.611,110,2013-02-10,POR,ORL
3,@,L 104-117 ,240,39,73,.534,31,49,.633,8,24,.333,18,20,.900,104,43,74,.581,35,55,.636,8,19,.421,23,27,.852,117,2013-02-12,POR,MIA
4,@,W 104-100 ,240,40,84,.476,32,64,.500,8,20,.400,16,19,.842,104,37,91,.407,32,74,.432,5,17,.294,21,24,.875,100,2013-02-22,DAL,NOH
5,Home,W 104-97 ,240,44,85,.518,32,67,.478,12,18,.667,4,9,.444,104,36,86,.419,26,60,.433,10,26,.385,15,19,.789,97,2013-03-02,PHI,GSW
6,Home,L 104-108 ,240,38,82,.463,29,58,.500,9,24,.375,19,22,.864,104,38,80,.475,31,59,.525,7,21,.333,25,34,.735,108,2013-03-03,LAC,OKC
7,Home,W 104-88 ,240,46,86,.535,41,71,.577,5,15,.333,7,9,.778,104,36,89,.404,29,65,.446,7,24,.292,9,11,.818,88,2013-03-04,DEN,ATL
8,Home,W 104-101 ,240,37,90,.411,30,74,.405,7,16,.438,23,29,.793,104,38,87,.437,29,68,.426,9,19,.474,16,19,.842,101,2013-03-06,CLE,UTA
9,Home,W 104-87 ,240,35,70,.500,25,52,.481,10,18,.556,24,32,.750,104,32,79,.405,27,64,.422,5,15,.333,18,23,.783,87,2013-03-09,WAS,CHA
10,@,L 104-117 ,240,40,92,.435,33,65,.508,7,27,.259,17,21,.810,104,42,76,.553,38,63,.603,4,13,.308,29,43,.674,117,2013-03-15,ORL,OKC
11,Home,L 104-114 ,240,37,85,.435,33,60,.550,4,25,.160,26,31,.839,104,43,96,.448,39,75,.520,4,21,.190,24,29,.828,114,2013-03-19,OKC,DEN
12,Home,W 104-93 ,240,41,85,.482,33,59,.559,8,26,.308,14,15,.933,104,37,84,.440,31,72,.431,6,12,.500,13,15,.867,93,2013-03-20,SAS,GSW
13,@,W 104-93 ,240,41,87,.471,31,69,.449,10,18,.556,12,16,.750,104,37,83,.446,30,59,.508,7,24,.292,12,16,.750,93,2013-03-22,POR,ATL
14,Home,W 104-94 ,240,38,82,.463,32,63,.508,6,19,.316,22,28,.786,104,32,77,.416,27,60,.450,5,17,.294,25,27,.926,94,2013-03-22,DAL,BOS
15,Home,W 104-97 (OT),265,39,84,.464,31,64,.484,8,20,.400,18,24,.750,104,41,96,.427,33,79,.418,8,17,.471,7,12,.583,97,2013-03-22,SAS,UTA
16,@,W 104-99 ,240,39,78,.500,29,52,.558,10,26,.385,16,21,.762,104,42,92,.457,37,71,.521,5,21,.238,10,18,.556,99,2013-03-24,ATL,MIL
17,@,W 104-97 ,240,41,89,.461,31,63,.492,10,26,.385,12,17,.706,104,39,78,.500,33,66,.500,6,12,.500,13,19,.684,97,2013-03-24,CHI,MIN
18,Home,W 104-102 ,240,39,74,.527,33,59,.559,6,15,.400,20,21,.952,104,41,81,.506,33,62,.532,8,19,.421,12,21,.571,102,2013-03-29,SAS,LAC
19,Home,L 104-112 ,240,40,82,.488,34,70,.486,6,12,.500,18,19,.947,104,37,80,.463,33,65,.508,4,15,.267,34,46,.739,112,2013-03-30,PHO,IND
20,Home,W 104-85 ,240,39,79,.494,35,67,.522,4,12,.333,22,31,.710,104,35,86,.407,32,66,.485,3,20,.150,12,15,.800,85,2013-04-06,WAS,IND
21,Home,W 104-83 ,240,42,93,.452,37,73,.507,5,20,.250,15,23,.652,104,30,80,.375,23,66,.348,7,14,.500,16,20,.800,83,2013-04-09,BRK,PHI
22,Home,W 104-96 ,240,40,79,.506,33,54,.611,7,25,.280,17,22,.773,104,37,84,.440,32,64,.500,5,20,.250,17,18,.944,96,2013-04-09,LAL,NOH
23,Home,L 104-111 ,240,40,82,.488,37,67,.552,3,15,.200,21,26,.808,104,40,80,.500,36,64,.563,4,16,.250,27,42,.643,111,2013-04-10,CLE,DET
24,@,L 104-109 ,240,38,92,.413,21,59,.356,17,33,.515,11,16,.688,104,43,85,.506,37,65,.569,6,20,.300,17,25,.680,109,2013-04-12,MIL,ATL
25,Home,W 104-95 ,240,42,92,.457,37,69,.536,5,23,.217,15,20,.750,104,38,87,.437,31,60,.517,7,27,.259,12,21,.571,95,2013-04-15,OKC,SAC
26,Home,W 104-91 ,240,43,83,.518,39,64,.609,4,19,.211,14,18,.778,104,33,81,.407,25,55,.455,8,26,.308,17,24,.708,91,2013-10-30,PHO,POR
27,@,L 104-107 ,240,42,93,.452,39,79,.494,3,14,.214,17,19,.895,104,42,86,.488,31,64,.484,11,22,.500,12,18,.667,107,2013-11-02,CHI,PHI
28,@,W 104-93 ,240,34,67,.507,25,45,.556,9,22,.409,27,35,.771,104,34,81,.420,30,59,.508,4,22,.182,21,27,.778,93,2013-11-02,HOU,UTA
29,Home,W 104-88 ,240,40,78,.513,36,67,.537,4,11,.364,20,32,.625,104,31,82,.378,27,64,.422,4,18,.222,22,30,.733,88,2013-11-05,BRK,UTA
30,@,L 104-123 ,240,39,88,.443,27,57,.474,12,31,.387,14,20,.700,104,49,94,.521,36,67,.537,13,27,.481,12,14,.857,123,2013-11-05,LAL,DAL
31,@,W 104-98 ,240,39,78,.500,27,53,.509,12,25,.480,14,22,.636,104,37,85,.435,27,67,.403,10,18,.556,14,19,.737,98,2013-11-05,PHO,NOP
32,@,W 104-95 ,240,41,83,.494,31,60,.517,10,23,.435,12,14,.857,104,31,72,.431,25,51,.490,6,21,.286,27,33,.818,95,2013-11-05,MIA,TOR
33,@,L 104-109 ,240,38,85,.447,26,57,.456,12,28,.429,16,22,.727,104,36,72,.500,23,49,.469,13,23,.565,24,26,.923,109,2013-11-06,CLE,MIL
34,Home,W 104-91 ,240,39,80,.488,29,57,.509,10,23,.435,16,18,.889,104,36,86,.419,30,64,.469,6,22,.273,13,15,.867,91,2013-11-08,POR,SAC
35,Home,W 104-94 ,240,43,90,.478,37,71,.521,6,19,.316,12,17,.706,104,38,82,.463,30,65,.462,8,17,.471,10,18,.556,94,2013-11-09,ATL,ORL
36,@,L 104-110 (2OT),290,38,114,.333,30,89,.337,8,25,.320,20,27,.741,104,37,84,.440,30,58,.517,7,26,.269,29,47,.617,110,2013-11-11,TOR,HOU
37,Home,W 104-77 ,240,40,79,.506,35,63,.556,5,16,.313,19,21,.905,104,30,88,.341,22,72,.306,8,16,.500,9,11,.818,77,2013-11-15,IND,MIL
38,@,L 104-110 ,240,37,74,.500,25,46,.543,12,28,.429,18,21,.857,104,40,74,.541,35,61,.574,5,13,.385,25,30,.833,110,2013-11-15,DAL,MIA
39,Home,W 104-88 ,240,41,81,.506,31,60,.517,10,21,.476,12,19,.632,104,33,74,.446,22,50,.440,11,24,.458,11,15,.733,88,2013-11-19,MIA,ATL
40,@,L 104-107 ,240,37,79,.468,27,50,.540,10,29,.345,20,28,.714,104,39,83,.470,31,61,.508,8,22,.364,21,28,.750,107,2013-11-19,PHO,SAC
41,Home,W 104-100 ,240,41,85,.482,34,70,.486,7,15,.467,15,15,1.000,104,37,85,.435,27,57,.474,10,28,.357,16,24,.667,100,2013-11-19,WAS,MIN
42,Home,W 104-93 ,240,39,81,.481,31,60,.517,8,21,.381,18,24,.750,104,39,86,.453,35,71,.493,4,15,.267,11,12,.917,93,2013-11-20,SAS,BOS
43,Home,W 104-100 ,240,36,88,.409,30,71,.423,6,17,.353,26,33,.788,104,41,77,.532,33,54,.611,8,23,.348,10,16,.625,100,2013-11-22,NOP,CLE
44,@,W 104-96 ,240,46,95,.484,35,66,.530,11,29,.379,1,3,.333,104,39,84,.464,33,63,.524,6,21,.286,12,14,.857,96,2013-11-24,PHO,ORL
45,@,W 104-98 (OT),265,37,83,.446,31,63,.492,6,20,.300,24,37,.649,104,42,91,.462,36,68,.529,6,23,.261,8,10,.800,98,2013-11-29,LAC,SAC
46,Home,L 104-112 ,240,37,78,.474,25,51,.490,12,27,.444,18,25,.720,104,39,76,.513,30,58,.517,9,18,.500,25,29,.862,112,2013-11-30,PHO,UTA
47,@,L 104-111 ,240,39,89,.438,34,78,.436,5,11,.455,21,24,.875,104,44,98,.449,36,75,.480,8,23,.348,15,17,.882,111,2013-12-04,OKC,POR
48,Home,W 104-96 ,240,39,70,.557,36,58,.621,3,12,.250,23,28,.821,104,35,80,.438,24,58,.414,11,22,.500,15,21,.714,96,2013-12-10,BRK,BOS
49,@,L 104-111 ,240,40,94,.426,35,74,.473,5,20,.250,19,24,.792,104,39,89,.438,31,62,.500,8,27,.296,25,30,.833,111,2013-12-12,HOU,POR
50,Home,W 104-98 ,240,39,76,.513,30,54,.556,9,22,.409,17,20,.850,104,40,80,.500,34,65,.523,6,15,.400,12,17,.706,98,2013-12-13,NOP,MEM
51,Home,W 104-93 ,240,41,91,.451,36,71,.507,5,20,.250,17,24,.708,104,33,88,.375,28,70,.400,5,18,.278,22,30,.733,93,2013-12-17,GSW,NOP
52,@,W 104-102 (OT),265,37,81,.457,29,66,.439,8,15,.533,22,34,.647,104,41,96,.427,35,70,.500,6,26,.231,14,20,.700,102,2013-12-18,CHA,TOR
53,@,W 104-102 ,240,40,89,.449,29,62,.468,11,27,.407,13,19,.684,104,42,90,.467,34,59,.576,8,31,.258,10,11,.909,102,2013-12-19,SAS,GSW
54,Home,W 104-91 ,240,42,78,.538,35,59,.593,7,19,.368,13,15,.867,104,33,95,.347,28,73,.384,5,22,.227,20,25,.800,91,2013-12-20,LAL,MIN
55,@,W 104-98 ,240,36,91,.396,28,71,.394,8,20,.400,24,29,.828,104,28,76,.368,21,53,.396,7,23,.304,35,36,.972,98,2013-12-22,TOR,OKC
56,Home,L 104-111 ,240,38,70,.543,31,51,.608,7,19,.368,21,29,.724,104,40,79,.506,29,57,.509,11,22,.500,20,23,.870,111,2013-12-23,HOU,DAL
57,Home,W 104-94 ,240,39,83,.470,28,63,.444,11,20,.550,15,20,.750,104,35,75,.467,24,51,.471,11,24,.458,13,15,.867,94,2013-12-23,MEM,UTA
58,Home,W 104-93 ,240,34,79,.430,22,53,.415,12,26,.462,24,32,.750,104,33,88,.375,24,56,.429,9,32,.281,18,25,.720,93,2013-12-27,BRK,MIL
59,Home,L 104-108 (OT),265,38,92,.413,28,76,.368,10,16,.625,18,21,.857,104,42,95,.442,32,62,.516,10,33,.303,14,19,.737,108,2013-12-29,CLE,GSW
60,Home,L 104-111 ,240,31,84,.369,19,47,.404,12,37,.324,30,34,.882,104,39,95,.411,33,71,.465,6,24,.250,27,33,.818,111,2013-12-29,LAL,PHI
61,@,L 104-112 ,240,41,91,.451,34,77,.442,7,14,.500,15,20,.750,104,44,94,.468,36,70,.514,8,24,.333,16,19,.842,112,2013-12-29,SAC,SAS
62,@,L 104-134 ,240,34,79,.430,27,63,.429,7,16,.438,29,36,.806,104,54,93,.581,33,60,.550,21,33,.636,5,7,.714,134,2014-01-02,CHA,POR
63,Home,L 104-113 ,240,35,83,.422,28,60,.467,7,23,.304,27,37,.730,104,42,90,.467,37,71,.521,5,19,.263,24,31,.774,113,2014-01-02,SAC,PHI
64,@,W 104-103 ,240,38,92,.413,27,63,.429,11,29,.379,17,23,.739,104,34,86,.395,28,70,.400,6,16,.375,29,35,.829,103,2014-01-08,PHO,MIN
65,Home,W 104-95 (2OT),290,40,86,.465,33,66,.500,7,20,.350,17,21,.810,104,34,80,.425,28,57,.491,6,23,.261,21,27,.778,95,2014-01-10,BRK,MIA
66,Home,W 104-99 ,240,42,86,.488,36,71,.507,6,15,.400,14,23,.609,104,38,92,.413,27,62,.435,11,30,.367,12,16,.750,99,2014-01-10,MEM,PHO
67,Home,L 104-114 ,240,41,95,.432,33,71,.465,8,24,.333,14,20,.700,104,40,94,.426,29,64,.453,11,30,.367,23,33,.697,114,2014-01-10,PHI,DET
68,@,L 104-112 ,240,44,95,.463,40,81,.494,4,14,.286,12,17,.706,104,40,93,.430,30,72,.417,10,21,.476,22,26,.846,112,2014-01-11,BOS,POR
69,Home,W 104-86 ,240,42,74,.568,33,61,.541,9,13,.692,11,14,.786,104,33,93,.355,28,76,.368,5,17,.294,15,18,.833,86,2014-01-12,SAS,MIN
70,@,W 104-92 ,240,37,79,.468,29,60,.483,8,19,.421,22,34,.647,104,38,101,.376,35,84,.417,3,17,.176,13,14,.929,92,2014-01-13,HOU,BOS
71,@,W 104-92 ,240,38,82,.463,32,57,.561,6,25,.240,22,25,.880,104,33,82,.402,21,48,.438,12,34,.353,14,21,.667,92,2014-01-16,OKC,HOU
72,Home,L 104-107 ,240,44,99,.444,37,76,.487,7,23,.304,9,11,.818,104,37,74,.500,25,54,.463,12,20,.600,21,28,.750,107,2014-01-17,BOS,LAL
73,@,W 104-96 (OT),265,39,79,.494,32,58,.552,7,21,.333,19,29,.655,104,36,75,.480,29,58,.500,7,17,.412,17,23,.739,96,2014-01-18,MIA,CHA
74,@,L 104-114 ,240,40,80,.500,29,57,.509,11,23,.478,13,21,.619,104,41,85,.482,34,58,.586,7,27,.259,25,37,.676,114,2014-01-18,MIL,HOU
75,@,W 104-98 ,240,40,81,.494,34,60,.567,6,21,.286,18,31,.581,104,37,76,.487,29,55,.527,8,21,.381,16,29,.552,98,2014-01-18,DET,WAS
76,Home,W 104-101 ,240,41,84,.488,33,57,.579,8,27,.296,14,22,.636,104,36,84,.429,32,69,.464,4,15,.267,25,34,.735,101,2014-01-22,MIL,DET
77,@,W 104-95 ,240,40,84,.476,32,64,.500,8,20,.400,16,22,.727,104,38,89,.427,32,69,.464,6,20,.300,13,16,.813,95,2014-01-24,TOR,PHI
78,@,L 104-115 ,240,38,89,.427,29,67,.433,9,22,.409,19,22,.864,104,46,95,.484,42,79,.532,4,16,.250,19,24,.792,115,2014-01-25,MIN,POR
79,Home,W 104-101 ,240,38,81,.469,28,57,.491,10,24,.417,18,22,.818,104,39,91,.429,32,71,.451,7,20,.350,16,18,.889,101,2014-01-25,UTA,WAS
80,@,W 104-103 ,240,37,79,.468,28,57,.491,9,22,.409,21,26,.808,104,37,77,.481,26,53,.491,11,24,.458,18,22,.818,103,2014-01-27,TOR,BRK
81,@,W 104-92 ,240,42,99,.424,37,78,.474,5,21,.238,15,27,.556,104,37,94,.394,32,70,.457,5,24,.208,13,16,.813,92,2014-01-28,IND,LAL
82,@,W 104-100 ,240,36,77,.468,28,56,.500,8,21,.381,24,28,.857,104,39,89,.438,33,73,.452,6,16,.375,16,22,.727,100,2014-02-08,SAS,CHA
83,@,W 104-92 ,240,41,82,.500,32,63,.508,9,19,.474,13,14,.929,104,37,80,.463,31,63,.492,6,17,.353,12,17,.706,92,2014-02-12,SAS,BOS
84,Home,W 104-83 ,240,38,94,.404,27,61,.443,11,33,.333,17,22,.773,104,30,78,.385,26,58,.448,4,20,.200,19,23,.826,83,2014-02-12,TOR,ATL
85,Home,W 104-100 ,240,35,82,.427,23,56,.411,12,26,.462,22,30,.733,104,40,80,.500,29,55,.527,11,25,.440,9,16,.563,100,2014-02-18,MIL,ORL
86,Home,W 104-91 ,240,40,83,.482,34,63,.540,6,20,.300,18,31,.581,104,35,87,.402,29,65,.446,6,22,.273,15,20,.750,91,2014-02-19,MIN,IND
87,Home,L 104-121 ,240,37,79,.468,34,60,.567,3,19,.158,27,36,.750,104,43,84,.512,32,62,.516,11,22,.500,24,33,.727,121,2014-02-22,UTA,MIN
88,@,W 104-96 ,240,38,82,.463,25,51,.490,13,31,.419,15,22,.682,104,40,99,.404,36,86,.419,4,13,.308,12,18,.667,96,2014-02-24,GSW,DET
89,@,L 104-115 ,240,38,76,.500,29,57,.509,9,19,.474,19,24,.792,104,43,90,.478,35,68,.515,8,22,.364,21,23,.913,115,2014-02-26,ATL,BOS
90,Home,L 104-114 ,240,39,80,.488,26,49,.531,13,31,.419,13,17,.765,104,40,86,.465,29,60,.483,11,26,.423,23,24,.958,114,2014-02-26,OKC,CLE
91,@,L 104-116 ,240,42,78,.538,37,65,.569,5,13,.385,15,17,.882,104,40,74,.541,30,51,.588,10,23,.435,26,32,.813,116,2014-02-28,NOP,PHO
92,Home,W 104-98 ,240,38,79,.481,30,57,.526,8,22,.364,20,23,.870,104,37,88,.420,29,65,.446,8,23,.348,16,20,.800,98,2014-03-02,TOR,GSW
93,Home,L 104-110 ,240,39,81,.481,30,62,.484,9,19,.474,17,21,.810,104,43,79,.544,37,66,.561,6,13,.462,18,21,.857,110,2014-03-03,WAS,MEM
94,@,W 104-96 ,240,40,78,.513,32,58,.552,8,20,.400,16,22,.727,104,39,86,.453,32,67,.478,7,19,.368,11,19,.579,96,2014-03-04,LAC,PHO
95,Home,W 104-91 ,240,44,81,.543,38,66,.576,6,15,.400,10,10,1.000,104,35,78,.449,27,55,.491,8,23,.348,13,22,.591,91,2014-03-05,WAS,UTA
96,@,L 104-112 ,240,40,89,.449,35,69,.507,5,20,.250,19,25,.760,104,42,84,.500,34,64,.531,8,20,.400,20,23,.870,112,2014-03-07,MIL,NOP
97,@,W 104-92 ,240,37,80,.463,27,57,.474,10,23,.435,20,28,.714,104,36,76,.474,31,54,.574,5,22,.227,15,20,.750,92,2014-03-08,UTA,PHI
98,Home,W 104-89 ,240,41,77,.532,29,52,.558,12,25,.480,10,16,.625,104,36,81,.444,31,58,.534,5,23,.217,12,21,.571,89,2014-03-09,BRK,SAC
99,Home,L 104-111 ,240,41,95,.432,34,76,.447,7,19,.368,15,20,.750,104,37,76,.487,23,52,.442,14,24,.583,23,31,.742,111,2014-03-09,MIN,TOR
0,@,W 104-96 ,240,40,79,.506,28,58,.483,12,21,.571,12,15,.800,104,32,75,.427,24,57,.421,8,18,.444,24,28,.857,96,2014-03-11,SAS,CHI
1,Home,L 104-112 (OT),265,37,91,.407,30,68,.441,7,23,.304,23,30,.767,104,41,104,.394,34,80,.425,7,24,.292,23,25,.920,112,2014-03-15,DET,IND
2,@,L 104-113 ,240,37,75,.493,28,52,.538,9,23,.391,21,28,.750,104,40,78,.513,31,56,.554,9,22,.409,24,29,.828,113,2014-03-16,HOU,MIA
3,Home,W 104-102 ,240,34,78,.436,28,61,.459,6,17,.353,30,38,.789,104,41,85,.482,35,66,.530,6,19,.316,14,19,.737,102,2014-03-16,MIN,SAC
4,@,L 104-122 ,240,42,91,.462,37,80,.463,5,11,.455,15,21,.714,104,49,78,.628,39,62,.629,10,16,.625,14,19,.737,122,2014-03-16,UTA,SAS
5,Home,W 104-99 ,240,37,75,.493,28,55,.509,9,20,.450,21,35,.600,104,40,85,.471,31,58,.534,9,27,.333,10,12,.833,99,2014-03-19,BRK,CHA
6,Home,L 104-107 (OT),265,35,91,.385,25,60,.417,10,31,.323,24,31,.774,104,34,84,.405,23,54,.426,11,30,.367,28,33,.848,107,2014-03-23,DAL,BRK
7,@,L 104-109 (OT),265,33,90,.367,23,50,.460,10,40,.250,28,32,.875,104,40,85,.471,31,65,.477,9,20,.450,20,27,.741,109,2014-03-24,BRK,NOP
8,Home,L 104-114 ,240,41,96,.427,31,70,.443,10,26,.385,12,14,.857,104,38,82,.463,26,52,.500,12,30,.400,26,32,.813,114,2014-03-31,MIN,LAC
9,@,L 104-116 ,240,41,88,.466,32,61,.525,9,27,.333,13,21,.619,104,46,76,.605,31,45,.689,15,31,.484,9,11,.818,116,2014-04-04,DET,BRK
10,@,W 104-102 ,240,41,85,.482,30,61,.492,11,24,.458,11,19,.579,104,38,87,.437,34,71,.479,4,16,.250,22,29,.759,102,2014-04-09,IND,MIL
11,@,L 104-112 ,240,39,82,.476,30,56,.536,9,26,.346,17,19,.895,104,43,96,.448,30,66,.455,13,30,.433,13,16,.813,112,2014-04-11,PHO,SAS
12,@,L 104-111 ,240,39,88,.443,30,66,.455,9,22,.409,17,21,.810,104,35,74,.473,25,47,.532,10,27,.370,31,39,.795,111,2014-04-12,NOP,HOU
13,Home,W 104-91 ,240,40,84,.476,32,62,.516,8,22,.364,16,19,.842,104,32,68,.471,27,60,.450,5,8,.625,22,34,.647,91,2014-04-12,WAS,MIL
14,Home,W 104-98 ,240,38,85,.447,34,63,.540,4,22,.182,24,29,.828,104,39,89,.438,35,72,.486,4,17,.235,16,18,.889,98,2014-04-14,HOU,SAS
15,Home,L 104-119 ,240,42,81,.519,36,62,.581,6,19,.316,14,20,.700,104,45,82,.549,35,58,.603,10,24,.417,19,22,.864,119,2014-04-14,UTA,LAL
16,@,L 104-110 ,240,34,84,.405,26,50,.520,8,34,.235,28,33,.848,104,42,101,.416,32,75,.427,10,26,.385,16,22,.727,110,2014-04-16,LAC,POR
17,@,W 104-99 ,240,40,86,.465,32,66,.485,8,20,.400,16,22,.727,104,37,86,.430,33,67,.493,4,19,.211,21,30,.700,99,2014-04-16,PHO,SAC
18,@,W 104-80 ,240,36,71,.507,29,47,.617,7,24,.292,25,30,.833,104,31,85,.365,28,68,.412,3,17,.176,15,17,.882,80,2014-10-29,CHI,NYK
19,@,W 104-93 ,240,40,77,.519,26,50,.520,14,27,.519,10,14,.714,104,38,81,.469,35,63,.556,3,18,.167,14,17,.824,93,2014-10-29,HOU,UTA
20,@,L 104-127 ,240,41,88,.466,37,74,.500,4,14,.286,18,25,.720,104,46,83,.554,35,60,.583,11,23,.478,24,28,.857,127,2014-11-01,LAL,GSW
21,Home,W 104-90 ,240,32,76,.421,20,42,.476,12,34,.353,28,40,.700,104,37,98,.378,36,73,.493,1,25,.040,15,18,.833,90,2014-11-01,HOU,BOS
22,Home,L 104-109 ,240,38,89,.427,31,70,.443,7,19,.368,21,28,.750,104,46,89,.517,40,64,.625,6,25,.240,11,19,.579,109,2014-11-01,NOP,DAL
23,@,W 104-93 ,240,32,75,.427,16,41,.390,16,34,.471,24,30,.800,104,33,74,.446,22,52,.423,11,22,.500,16,23,.696,93,2014-11-03,HOU,PHI
24,@,L 104-121 ,240,38,82,.463,31,63,.492,7,19,.368,21,27,.778,104,43,74,.581,28,49,.571,15,25,.600,20,20,1.000,121,2014-11-05,LAC,GSW
25,Home,W 104-96 ,240,40,83,.482,36,69,.522,4,14,.286,20,23,.870,104,39,75,.520,31,60,.517,8,15,.533,10,16,.625,96,2014-11-09,BRK,ORL
26,Home,W 104-100 ,240,35,77,.455,26,56,.464,9,21,.429,25,30,.833,104,39,81,.481,27,56,.482,12,25,.480,10,16,.625,100,2014-11-11,TOR,ORL
27,@,L 104-112 ,240,35,74,.473,26,53,.491,9,21,.429,25,32,.781,104,39,81,.481,31,57,.544,8,24,.333,26,29,.897,112,2014-11-12,BRK,PHO
28,Home,L 104-114 ,240,42,84,.500,42,76,.553,0,8,.000,20,24,.833,104,44,89,.494,37,62,.597,7,27,.259,19,23,.826,114,2014-11-24,PHI,POR
29,Home,W 104-100 ,240,37,82,.451,33,65,.508,4,17,.235,26,32,.813,104,39,84,.464,25,51,.490,14,33,.424,8,11,.727,100,2014-11-24,TOR,PHO
30,@,W 104-98 ,240,37,78,.474,25,50,.500,12,28,.429,18,19,.947,104,35,78,.449,25,51,.490,10,27,.370,18,24,.750,98,2014-11-26,LAC,DET
31,@,W 104-88 ,240,39,77,.506,26,48,.542,13,29,.448,13,16,.813,104,34,83,.410,28,60,.467,6,23,.261,14,25,.560,88,2014-11-28,MIL,DET
32,@,L 104-112 ,240,38,75,.507,32,65,.492,6,10,.600,22,26,.846,104,42,82,.512,30,58,.517,12,24,.500,16,20,.800,112,2014-11-28,SAC,SAS
33,@,W 104-93 ,240,37,79,.468,28,58,.483,9,21,.429,21,27,.778,104,33,91,.363,22,68,.324,11,23,.478,16,24,.667,93,2014-11-30,GSW,DET
34,@,L 104-112 ,240,37,84,.440,30,60,.500,7,24,.292,23,27,.852,104,39,88,.443,34,71,.479,5,17,.294,29,45,.644,112,2014-12-02,OKC,NOP
35,Home,L 104-123 ,240,42,87,.483,34,59,.576,8,28,.286,12,15,.800,104,45,79,.570,33,58,.569,12,21,.571,21,24,.875,123,2014-12-03,UTA,TOR
36,@,W 104-87 ,240,43,83,.518,35,65,.538,8,18,.444,10,15,.667,104,36,90,.400,31,71,.437,5,19,.263,10,15,.667,87,2014-12-07,NOP,LAL
37,Home,W 104-93 ,240,40,80,.500,36,65,.554,4,15,.267,20,26,.769,104,37,78,.474,28,59,.475,9,19,.474,10,13,.769,93,2014-12-09,NOP,NYK
38,Home,W 104-96 ,240,39,80,.488,30,64,.469,9,16,.563,17,21,.810,104,32,75,.427,26,55,.473,6,20,.300,26,31,.839,96,2014-12-12,WAS,LAC
39,@,W 104-92 ,240,41,87,.471,35,67,.522,6,20,.300,16,24,.667,104,36,84,.429,31,66,.470,5,18,.278,15,17,.882,92,2014-12-16,OKC,SAC
40,Home,W 104-97 ,240,41,87,.471,34,64,.531,7,23,.304,15,29,.517,104,37,77,.481,30,58,.517,7,19,.368,16,22,.727,97,2014-12-17,POR,MIL
41,@,W 104-103 ,240,37,86,.430,29,65,.446,8,21,.381,22,29,.759,104,41,85,.482,31,60,.517,10,25,.400,11,15,.733,103,2014-12-19,OKC,LAL
42,Home,W 104-86 ,240,42,87,.483,33,65,.508,9,22,.409,11,16,.688,104,33,85,.388,25,54,.463,8,31,.258,12,15,.800,86,2014-12-20,CHO,UTA
43,@,W 104-97 ,240,38,74,.514,28,48,.583,10,26,.385,18,24,.750,104,34,86,.395,19,43,.442,15,43,.349,14,18,.778,97,2014-12-20,ATL,HOU
44,@,W 104-92 ,240,40,78,.513,34,61,.557,6,17,.353,18,25,.720,104,34,83,.410,31,69,.449,3,14,.214,21,29,.724,92,2014-12-21,PHO,WAS
45,@,L 104-107 ,240,37,92,.402,26,63,.413,11,29,.379,19,28,.679,104,34,76,.447,22,53,.415,12,23,.522,27,35,.771,107,2014-12-23,LAC,ATL
46,@,L 104-125 ,240,39,88,.443,35,75,.467,4,13,.308,22,29,.759,104,44,84,.524,32,60,.533,12,24,.500,25,31,.806,125,2014-12-23,MIN,CLE
47,@,W 104-94 (OT),265,40,85,.471,34,64,.531,6,21,.286,18,21,.857,104,33,90,.367,26,65,.400,7,25,.280,21,26,.808,94,2014-12-29,MIL,CHO
48,@,W 104-103 ,240,35,73,.479,27,55,.491,8,18,.444,26,28,.929,104,40,86,.465,31,57,.544,9,29,.310,14,23,.609,103,2014-12-29,WAS,HOU
49,@,L 104-109 (OT),265,45,100,.450,40,83,.482,5,17,.294,9,11,.818,104,37,100,.370,31,72,.431,6,28,.214,29,40,.725,109,2015-01-03,BOS,CHI
50,@,W 104-95 ,240,38,78,.487,32,59,.542,6,19,.316,22,23,.957,104,36,91,.396,29,73,.397,7,18,.389,16,23,.696,95,2015-01-05,CHO,BOS
51,Home,L 104-105 ,240,36,79,.456,27,58,.466,9,21,.429,23,34,.676,104,41,87,.471,38,68,.559,3,19,.158,20,28,.714,105,2015-01-06,SAS,DET
52,Home,W 104-83 ,240,36,92,.391,26,73,.356,10,19,.526,22,28,.786,104,29,89,.326,20,59,.339,9,30,.300,16,23,.696,83,2015-01-07,SAC,OKC
53,@,W 104-90 ,240,39,81,.481,33,60,.550,6,21,.286,20,24,.833,104,34,75,.453,25,49,.510,9,26,.346,13,18,.722,90,2015-01-11,MIA,LAC
54,Home,L 104-108 (OT),265,38,86,.442,37,68,.544,1,18,.056,27,34,.794,104,43,100,.430,37,76,.487,6,24,.250,16,23,.696,108,2015-01-13,SAC,DAL
55,Home,W 104-89 ,240,38,81,.469,25,52,.481,13,29,.448,15,19,.789,104,30,71,.423,24,53,.453,6,18,.333,23,27,.852,89,2015-01-14,GSW,MIA
56,Home,W 104-81 ,240,36,76,.474,30,57,.526,6,19,.316,26,32,.813,104,30,81,.370,24,60,.400,6,21,.286,15,18,.833,81,2015-01-22,CHI,SAS
57,@,W 104-91 ,240,34,73,.466,25,47,.532,9,26,.346,27,34,.794,104,34,82,.415,27,64,.422,7,18,.389,16,23,.696,91,2015-01-27,TOR,IND
58,@,W 104-86 ,240,44,93,.473,44,82,.537,0,11,.000,16,25,.640,104,33,92,.359,28,68,.412,5,24,.208,15,20,.750,86,2015-01-31,CHO,DEN
59,Home,W 104-97 ,240,37,75,.493,29,55,.527,8,20,.400,22,26,.846,104,38,90,.422,32,67,.478,6,23,.261,15,18,.833,97,2015-02-02,OKC,ORL
60,Home,W 104-100 ,240,40,99,.404,28,71,.394,12,28,.429,12,17,.706,104,33,80,.413,29,56,.518,4,24,.167,30,33,.909,100,2015-02-04,BOS,DEN
61,Home,W 104-86 ,240,42,80,.525,35,60,.583,7,20,.350,13,15,.867,104,35,75,.467,33,63,.524,2,12,.167,14,27,.519,86,2015-02-10,CHI,SAC
62,@,W 104-87 ,240,42,88,.477,32,61,.525,10,27,.370,10,11,.909,104,33,81,.407,24,60,.400,9,21,.429,12,17,.706,87,2015-02-11,SAS,DET
63,Home,W 104-89 ,240,38,91,.418,31,69,.449,7,22,.318,21,26,.808,104,33,91,.363,24,64,.375,9,27,.333,14,17,.824,89,2015-02-19,OKC,DAL
64,Home,W 104-98 ,240,39,81,.481,31,62,.500,8,19,.421,18,23,.783,104,34,89,.382,25,63,.397,9,26,.346,21,22,.955,98,2015-02-22,IND,GSW
65,Home,W 104-87 ,240,39,85,.459,26,50,.520,13,35,.371,13,16,.813,104,34,80,.425,29,49,.592,5,31,.161,14,18,.778,87,2015-02-25,ATL,DAL
66,Home,W 104-88 ,240,44,82,.537,39,67,.582,5,15,.333,11,16,.688,104,31,75,.413,20,50,.400,11,25,.440,15,19,.789,88,2015-02-25,MIL,PHI
67,@,W 104-82 ,240,39,68,.574,30,47,.638,9,21,.429,17,21,.810,104,28,84,.333,20,52,.385,8,32,.250,18,29,.621,82,2015-02-27,UTA,DEN
68,Home,W 104-102 ,240,39,76,.513,33,60,.550,6,16,.375,20,27,.741,104,41,84,.488,33,63,.524,8,21,.381,12,16,.750,102,2015-02-27,NOP,MIA
69,@,W 104-94 ,240,40,77,.519,30,54,.556,10,23,.435,14,23,.609,104,35,82,.427,26,54,.481,9,28,.321,15,18,.833,94,2015-02-28,BRK,DAL
70,Home,W 104-96 ,240,39,86,.453,31,57,.544,8,29,.276,18,21,.857,104,39,90,.433,25,49,.510,14,41,.341,4,9,.444,96,2015-03-03,ATL,HOU
71,Home,W 104-103 ,240,39,79,.494,34,66,.515,5,13,.385,21,31,.677,104,39,86,.453,33,69,.478,6,17,.353,19,21,.905,103,2015-03-03,CHO,LAL
72,Home,W 104-89 ,240,38,81,.469,27,58,.466,11,23,.478,17,19,.895,104,32,87,.368,26,67,.388,6,20,.300,19,26,.731,89,2015-03-06,GSW,DAL
73,@,W 104-98 ,240,36,79,.456,26,56,.464,10,23,.435,22,25,.880,104,38,80,.475,30,59,.508,8,21,.381,14,15,.933,98,2015-03-06,BOS,NOP
74,@,L 104-108 ,240,42,98,.429,31,71,.437,11,27,.407,9,9,1.000,104,42,82,.512,36,61,.590,6,21,.286,18,25,.720,108,2015-03-08,TOR,OKC
75,Home,W 104-98 ,240,37,81,.457,31,60,.517,6,21,.286,24,38,.632,104,32,73,.438,26,56,.464,6,17,.353,28,39,.718,98,2015-03-11,MIA,BRK
76,@,W 104-95 (OT),265,40,87,.460,30,63,.476,10,24,.417,14,20,.700,104,36,104,.346,25,63,.397,11,41,.268,12,25,.480,95,2015-03-11,CHI,PHI
77,Home,W 104-100 (OT),265,41,91,.451,38,77,.494,3,14,.214,19,27,.704,104,36,94,.383,33,80,.413,3,14,.214,25,30,.833,100,2015-03-17,NYK,SAS
78,@,L 104-108 ,240,41,81,.506,31,55,.564,10,26,.385,12,21,.571,104,46,87,.529,39,77,.506,7,10,.700,9,14,.643,108,2015-03-18,POR,MIA
79,@,L 104-111 ,240,38,80,.475,31,56,.554,7,24,.292,21,24,.875,104,43,94,.457,38,82,.463,5,12,.417,20,24,.833,111,2015-03-20,POR,ORL
80,Home,L 104-106 (OT),265,38,87,.437,29,59,.492,9,28,.321,19,31,.613,104,37,78,.474,25,59,.424,12,19,.632,20,25,.800,106,2015-03-23,UTA,MIN
81,@,L 104-108 ,240,35,75,.467,28,52,.538,7,23,.304,27,29,.931,104,40,93,.430,28,64,.438,12,29,.414,16,24,.667,108,2015-03-24,TOR,DET
82,Home,W 104-99 ,240,38,76,.500,28,59,.475,10,17,.588,18,26,.692,104,40,90,.444,34,75,.453,6,15,.400,13,19,.684,99,2015-03-29,IND,DAL
83,Home,L 104-116 ,240,40,85,.471,33,59,.559,7,26,.269,17,19,.895,104,45,89,.506,36,63,.571,9,26,.346,17,23,.739,116,2015-03-30,CHO,BOS
84,@,W 104-84 ,240,39,82,.476,29,49,.592,10,33,.303,16,18,.889,104,28,76,.368,22,60,.367,6,16,.375,22,27,.815,84,2015-03-30,UTA,MIN
85,@,L 104-107 ,240,40,82,.488,32,57,.561,8,25,.320,16,19,.842,104,45,94,.479,41,76,.539,4,18,.222,13,16,.813,107,2015-04-08,PHO,DAL
86,@,W 104-99 ,240,36,74,.486,25,40,.625,11,34,.324,21,26,.808,104,42,84,.500,36,66,.545,6,18,.333,9,13,.692,99,2015-04-08,CLE,MIL
87,Home,W 104-80 ,240,41,82,.500,31,54,.574,10,28,.357,12,16,.750,104,30,83,.361,22,53,.415,8,30,.267,12,18,.667,80,2015-04-10,ATL,CHO
88,@,W 104-103 ,240,41,85,.482,37,68,.544,4,17,.235,18,24,.750,104,31,66,.470,22,45,.489,9,21,.429,32,53,.604,103,2015-04-10,SAS,HOU
89,Home,L 104-107 ,240,37,81,.457,31,61,.508,6,20,.300,24,44,.545,104,35,83,.422,26,57,.456,9,26,.346,28,37,.757,107,2015-04-11,MIA,TOR
90,@,L 104-116 ,240,41,95,.432,30,67,.448,11,28,.393,11,28,.393,104,42,79,.532,32,59,.542,10,20,.500,22,35,.629,116,2015-04-12,OKC,IND
91,Home,W 104-94 ,240,36,73,.493,24,53,.453,12,20,.600,20,21,.952,104,33,84,.393,27,60,.450,6,24,.250,22,29,.759,94,2015-10-28,MIA,CHO
92,Home,L 104-111 ,240,41,94,.436,30,70,.429,11,24,.458,11,18,.611,104,42,80,.525,36,61,.590,6,19,.316,21,31,.677,111,2015-10-28,SAC,LAC
93,Home,W 104-88 ,240,38,87,.437,30,56,.536,8,31,.258,20,33,.606,104,35,97,.361,29,67,.433,6,30,.200,12,15,.800,88,2015-10-29,LAC,DAL
94,Home,W 104-98 ,240,40,90,.444,33,72,.458,7,18,.389,17,21,.810,104,38,84,.452,33,71,.465,5,13,.385,17,20,.850,98,2015-11-05,CHI,OKC
95,@,W 104-98 ,240,33,78,.423,26,55,.473,7,23,.304,31,40,.775,104,40,93,.430,37,74,.500,3,19,.158,15,20,.750,98,2015-11-06,LAL,BRK
96,@,L 104-119 ,240,39,92,.424,31,68,.456,8,24,.333,18,22,.818,104,46,93,.495,29,56,.518,17,37,.459,10,18,.556,119,2015-11-06,DEN,GSW
97,@,L 104-108 ,240,36,91,.396,26,62,.419,10,29,.345,22,27,.815,104,40,77,.519,33,58,.569,7,19,.368,21,32,.656,108,2015-11-09,POR,DEN
98,@,W 104-95 ,240,38,78,.487,30,52,.577,8,26,.308,20,27,.741,104,36,80,.450,27,61,.443,9,19,.474,14,19,.737,95,2015-11-10,CHO,MIN
99,@,L 104-118 ,240,40,90,.444,31,64,.484,9,26,.346,15,28,.536,104,44,83,.530,30,53,.566,14,30,.467,16,21,.762,118,2015-11-12,LAC,PHO
0,Home,W 104-99 ,240,36,84,.429,29,63,.460,7,21,.333,25,31,.806,104,38,80,.475,27,47,.574,11,33,.333,12,20,.600,99,2015-11-17,DET,CLE
1,Home,W 104-101 (OT),265,41,110,.373,32,89,.360,9,21,.429,13,21,.619,104,36,85,.424,32,67,.478,4,18,.222,25,30,.833,101,2015-11-18,ORL,MIN
2,Home,W 104-90 ,240,40,88,.455,32,66,.485,8,22,.364,16,17,.941,104,34,84,.405,25,67,.373,9,17,.529,13,16,.813,90,2015-11-20,NOP,SAS
3,Home,W 104-81 ,240,41,98,.418,25,67,.373,16,31,.516,6,7,.857,104,32,79,.405,26,59,.441,6,20,.300,11,16,.688,81,2015-11-25,DET,MIA
4,Home,W 104-92 ,240,37,87,.425,29,59,.492,8,28,.286,22,29,.759,104,32,92,.348,21,66,.318,11,26,.423,17,20,.850,92,2015-11-27,IND,CHI
5,Home,L 104-113 ,240,35,81,.432,26,54,.481,9,27,.333,25,33,.758,104,43,90,.478,41,80,.513,2,10,.200,25,26,.962,113,2015-12-01,NOP,MEM
6,Home,L 104-108 ,240,37,79,.468,30,58,.517,7,21,.333,23,31,.742,104,41,96,.427,33,71,.465,8,25,.320,18,20,.900,108,2015-12-02,WAS,LAL
7,Home,L 104-116 ,240,42,89,.472,34,62,.548,8,27,.296,12,21,.571,104,38,76,.500,22,45,.489,16,31,.516,24,27,.889,116,2015-12-06,WAS,DAL
8,Home,W 104-84 ,240,36,84,.429,28,58,.483,8,26,.308,24,35,.686,104,32,87,.368,22,53,.415,10,34,.294,10,22,.455,84,2015-12-07,CHO,DET
9,@,W 104-97 ,240,37,82,.451,24,51,.471,13,31,.419,17,20,.850,104,40,84,.476,31,59,.525,9,25,.360,8,9,.889,97,2015-12-07,DAL,NYK
10,@,L 104-107 ,240,40,85,.471,28,60,.467,12,25,.480,12,16,.750,104,41,80,.513,35,56,.625,6,24,.250,19,27,.704,107,2015-12-09,ORL,PHO
11,Home,W 104-98 (OT),265,35,79,.443,28,58,.483,7,21,.333,27,30,.900,104,39,94,.415,31,72,.431,8,22,.364,12,20,.600,98,2015-12-13,OKC,UTA
12,Home,W 104-94 ,240,38,77,.494,26,45,.578,12,32,.375,16,21,.762,104,33,80,.413,24,55,.436,9,25,.360,19,27,.704,94,2015-12-14,DAL,PHO
13,@,W 104-98 ,240,40,75,.533,33,54,.611,7,21,.333,17,24,.708,104,42,89,.472,38,73,.521,4,16,.250,10,14,.714,98,2015-12-16,MIA,BRK
14,@,W 104-94 ,240,34,73,.466,24,52,.462,10,21,.476,26,28,.929,104,32,67,.478,25,47,.532,7,20,.350,23,29,.793,94,2015-12-16,NOP,UTA
15,Home,W 104-100 ,240,41,88,.466,29,59,.492,12,29,.414,10,13,.769,104,35,74,.473,29,54,.537,6,20,.300,24,28,.857,100,2015-12-17,CLE,OKC
16,Home,W 104-97 ,240,37,89,.416,30,61,.492,7,28,.250,23,26,.885,104,36,86,.419,28,70,.400,8,16,.500,17,17,1.000,97,2015-12-18,IND,BRK
17,Home,W 104-88 ,240,44,84,.524,38,68,.559,6,16,.375,10,17,.588,104,26,71,.366,22,49,.449,4,22,.182,32,38,.842,88,2015-12-18,PHO,NOP
18,@,W 104-94 ,240,40,76,.526,31,55,.564,9,21,.429,15,24,.625,104,35,94,.372,27,65,.415,8,29,.276,16,17,.941,94,2015-12-20,SAC,TOR
19,@,W 104-90 ,240,40,85,.471,35,70,.500,5,15,.333,19,24,.792,104,31,66,.470,24,43,.558,7,23,.304,21,32,.656,90,2015-12-22,MEM,PHI
20,Home,W 104-101 ,240,44,84,.524,37,68,.544,7,16,.438,9,13,.692,104,41,83,.494,34,54,.630,7,29,.241,12,17,.706,101,2015-12-23,ORL,HOU
21,@,W 104-96 ,240,42,91,.462,28,56,.500,14,35,.400,6,13,.462,104,36,87,.414,23,62,.371,13,25,.520,11,17,.647,96,2015-12-23,DEN,PHO
22,Home,L 104-111 ,240,34,88,.386,24,61,.393,10,27,.370,26,34,.765,104,38,79,.481,26,52,.500,12,27,.444,23,27,.852,111,2015-12-26,PHO,PHI
23,Home,L 104-109 ,240,36,74,.486,26,47,.553,10,27,.370,22,27,.815,104,38,79,.481,25,53,.472,13,26,.500,20,24,.833,109,2015-12-26,UTA,LAC
24,Home,W 104-97 ,240,40,87,.460,32,66,.485,8,21,.381,16,24,.667,104,38,88,.432,32,68,.471,6,20,.300,15,24,.625,97,2015-12-28,CHI,TOR
25,Home,W 104-89 ,240,45,82,.549,38,65,.585,7,17,.412,7,11,.636,104,37,83,.446,32,63,.508,5,20,.250,10,15,.667,89,2015-12-28,ORL,NOP
26,Home,L 104-112 ,240,38,88,.432,31,61,.508,7,27,.259,21,25,.840,104,43,94,.457,34,75,.453,9,19,.474,17,23,.739,112,2015-12-30,BOS,LAL
27,Home,W 104-94 ,240,36,91,.396,21,58,.362,15,33,.455,17,18,.944,104,34,85,.400,24,53,.453,10,32,.313,16,18,.889,94,2016-01-01,TOR,CHO
28,Home,W 104-79 ,240,34,82,.415,22,45,.489,12,37,.324,24,39,.615,104,29,76,.382,23,51,.451,6,25,.240,15,17,.882,79,2016-01-02,CLE,ORL
29,Home,L 104-116 ,240,39,89,.438,29,60,.483,10,29,.345,16,23,.696,104,40,89,.449,33,72,.458,7,17,.412,29,39,.744,116,2016-01-04,OKC,SAC
30,@,L 104-110 ,240,41,91,.451,34,69,.493,7,22,.318,15,23,.652,104,45,86,.523,36,69,.522,9,17,.529,11,14,.786,110,2016-01-13,NYK,BRK
31,@,L 104-107 ,240,36,78,.462,28,61,.459,8,17,.471,24,30,.800,104,37,75,.493,30,45,.667,7,30,.233,26,38,.684,107,2016-01-13,MIN,HOU
32,Home,W 104-90 ,240,40,94,.426,29,69,.420,11,25,.440,13,16,.813,104,31,70,.443,22,46,.478,9,24,.375,19,29,.655,90,2016-01-13,LAC,MIA
33,Home,L 104-116 ,240,38,85,.447,30,66,.455,8,19,.421,20,28,.714,104,47,93,.505,32,58,.552,15,35,.429,7,11,.636,116,2016-01-15,BRK,POR
34,Home,L 104-118 ,240,38,80,.475,35,63,.556,3,17,.176,25,32,.781,104,51,98,.520,40,73,.548,11,25,.440,5,10,.500,118,2016-01-15,IND,WAS
35,Home,L 104-110 ,240,35,83,.422,28,63,.444,7,20,.350,27,36,.750,104,41,97,.423,35,69,.507,6,28,.214,22,30,.733,110,2016-01-19,DEN,OKC
36,@,W 104-98 ,240,39,87,.448,29,63,.460,10,24,.417,16,23,.696,104,41,94,.436,32,63,.508,9,31,.290,7,11,.636,98,2016-01-20,ATL,POR
37,Home,W 104-101 ,240,36,78,.462,28,56,.500,8,22,.364,24,29,.828,104,40,84,.476,29,55,.527,11,29,.379,10,19,.526,101,2016-01-23,DEN,DET
38,@,L 104-115 ,240,36,79,.456,21,49,.429,15,30,.500,17,22,.773,104,43,89,.483,28,45,.622,15,44,.341,14,21,.667,115,2016-01-24,DAL,HOU
39,@,L 104-111 ,240,42,84,.500,34,64,.531,8,20,.400,12,17,.706,104,39,86,.453,30,60,.500,9,26,.346,24,30,.800,111,2016-02-01,MIL,SAC
40,@,W 104-97 ,240,35,74,.473,26,47,.553,9,27,.333,25,32,.781,104,37,79,.468,25,48,.521,12,31,.387,11,15,.733,97,2016-02-02,TOR,PHO
41,@,W 104-103 ,240,38,88,.432,31,68,.456,7,20,.350,21,25,.840,104,37,87,.425,29,57,.509,8,30,.267,21,35,.600,103,2016-02-05,BOS,CLE
42,@,L 104-108 ,240,38,86,.442,29,61,.475,9,25,.360,19,24,.792,104,38,81,.469,26,54,.481,12,27,.444,20,25,.800,108,2016-02-06,WAS,CHO
43,@,L 104-112 ,240,38,79,.481,26,46,.565,12,33,.364,16,31,.516,104,41,76,.539,35,65,.538,6,11,.545,24,29,.828,112,2016-02-06,DET,IND
44,@,L 104-105 ,240,42,90,.467,33,65,.508,9,25,.360,11,13,.846,104,42,81,.519,33,62,.532,9,19,.474,12,15,.800,105,2016-02-08,DEN,BRK
45,Home,L 104-112 ,240,41,93,.441,35,72,.486,6,21,.286,16,22,.727,104,37,89,.416,23,49,.469,14,40,.350,24,29,.828,112,2016-02-10,PHO,GSW
46,@,L 104-109 ,240,31,75,.413,20,49,.408,11,26,.423,31,31,1.000,104,40,82,.488,33,61,.541,7,21,.333,22,28,.786,109,2016-02-19,MIN,MEM
47,@,L 104-110 (OT),265,37,89,.416,18,48,.375,19,41,.463,11,18,.611,104,41,102,.402,28,67,.418,13,35,.371,15,17,.882,110,2016-02-19,DAL,ORL
48,@,W 104-96 ,240,40,79,.506,30,52,.577,10,27,.370,14,15,.933,104,35,81,.432,30,59,.508,5,22,.227,21,24,.875,96,2016-02-21,CHO,BRK
49,@,L 104-112 ,240,43,90,.478,40,78,.513,3,12,.250,15,19,.789,104,40,80,.500,30,57,.526,10,23,.435,22,25,.880,112,2016-02-23,BRK,POR
50,@,L 104-109 ,240,38,90,.422,29,62,.468,9,28,.321,19,26,.731,104,44,88,.500,36,65,.554,8,23,.348,13,16,.813,109,2016-02-24,WAS,CHI
51,@,W 104-94 ,240,37,76,.487,29,57,.509,8,19,.421,22,28,.786,104,35,84,.417,27,59,.458,8,25,.320,16,22,.727,94,2016-02-27,SAS,HOU
52,@,W 104-85 ,240,37,88,.420,25,58,.431,12,30,.400,18,20,.900,104,33,88,.375,27,67,.403,6,21,.286,13,18,.722,85,2016-03-01,POR,NYK
53,Home,W 104-98 ,240,35,79,.443,30,61,.492,5,18,.278,29,33,.879,104,39,82,.476,30,56,.536,9,26,.346,11,20,.550,98,2016-03-02,MEM,SAC
54,@,W 104-99 ,240,38,80,.475,28,60,.467,10,20,.500,18,26,.692,104,34,76,.447,31,62,.500,3,14,.214,28,32,.875,99,2016-03-02,IND,MIL
55,@,W 104-98 ,240,42,84,.500,31,55,.564,11,29,.379,9,13,.692,104,32,75,.427,27,61,.443,5,14,.357,29,34,.853,98,2016-03-02,WAS,MIN
56,Home,W 104-94 ,240,40,80,.500,34,58,.586,6,22,.273,18,21,.857,104,37,83,.446,27,57,.474,10,26,.385,10,16,.625,94,2016-03-02,TOR,UTA
57,@,W 104-101 ,240,42,80,.525,35,55,.636,7,25,.280,13,24,.542,104,45,94,.479,38,65,.585,7,29,.241,4,6,.667,101,2016-03-03,SAC,DAL
58,@,L 104-105 ,240,42,92,.457,33,69,.478,9,23,.391,11,14,.786,104,41,90,.456,37,70,.529,4,20,.200,19,25,.760,105,2016-03-04,NYK,BOS
59,Home,W 104-94 ,240,40,81,.494,32,58,.552,8,23,.348,16,19,.842,104,37,81,.457,31,65,.477,6,16,.375,14,21,.667,94,2016-03-05,SAS,SAC
60,@,W 104-96 ,240,32,76,.421,25,51,.490,7,25,.280,33,43,.767,104,34,90,.378,31,71,.437,3,19,.158,25,30,.833,96,2016-03-06,OKC,MIL
61,Home,W 104-99 ,240,37,78,.474,27,55,.491,10,23,.435,20,25,.800,104,42,82,.512,36,70,.514,6,12,.500,9,9,1.000,99,2016-03-08,TOR,BRK
62,Home,L 104-118 ,240,35,86,.407,23,53,.434,12,33,.364,22,32,.688,104,38,86,.442,27,53,.509,11,33,.333,31,41,.756,118,2016-03-09,PHI,HOU
63,Home,W 104-96 ,240,38,82,.463,31,58,.534,7,24,.292,21,29,.724,104,35,82,.427,28,59,.475,7,23,.304,19,27,.704,96,2016-03-10,TOR,ATL
64,@,L 104-112 (OT),265,37,98,.378,28,73,.384,9,25,.360,21,26,.808,104,37,84,.440,31,66,.470,6,18,.333,32,38,.842,112,2016-03-12,MIA,TOR
65,Home,W 104-75 ,240,40,85,.471,25,55,.455,15,30,.500,9,10,.900,104,33,87,.379,28,63,.444,5,24,.208,4,7,.571,75,2016-03-13,ATL,IND
66,@,L 104-107 ,240,37,84,.440,33,68,.485,4,16,.250,26,30,.867,104,40,95,.421,29,60,.483,11,35,.314,16,20,.800,107,2016-03-14,MIN,PHO
67,Home,L 104-109 ,240,36,82,.439,29,63,.460,7,19,.368,25,30,.833,104,43,87,.494,35,63,.556,8,24,.333,15,24,.625,109,2016-03-21,MIN,GSW
68,@,L 104-113 ,240,43,80,.538,36,64,.563,7,16,.438,11,15,.733,104,40,83,.482,30,49,.612,10,34,.294,23,27,.852,113,2016-03-23,MIL,CLE
69,Home,W 104-103 ,240,33,76,.434,27,59,.458,6,17,.353,32,40,.800,104,37,94,.394,22,57,.386,15,37,.405,14,15,.933,103,2016-03-23,DEN,PHI
70,@,L 104-113 ,240,42,91,.462,34,71,.479,8,20,.400,12,23,.522,104,45,80,.563,40,67,.597,5,13,.385,18,32,.563,113,2016-03-23,SAC,MIN
71,Home,W 104-95 ,240,41,89,.461,33,67,.493,8,22,.364,14,19,.737,104,39,89,.438,29,51,.569,10,38,.263,7,9,.778,95,2016-03-24,BRK,CLE
72,@,L 104-110 ,240,44,83,.530,37,65,.569,7,18,.389,9,13,.692,104,44,77,.571,37,59,.627,7,18,.389,15,18,.833,110,2016-03-25,MEM,SAS
73,Home,W 104-101 ,240,41,87,.471,32,61,.525,9,26,.346,13,20,.650,104,38,85,.447,31,52,.596,7,33,.212,18,27,.667,101,2016-03-27,IND,HOU
74,Home,W 104-97 ,240,36,87,.414,26,53,.491,10,34,.294,22,27,.815,104,34,78,.436,25,54,.463,9,24,.375,20,23,.870,97,2016-04-06,BOS,NOP
75,Home,L 104-108 ,240,43,90,.478,39,75,.520,4,15,.267,14,19,.737,104,39,86,.453,28,59,.475,11,27,.407,19,31,.613,108,2016-04-06,ORL,DET
76,@,L 104-125 ,240,42,98,.429,34,74,.459,8,24,.333,12,16,.750,104,46,87,.529,26,40,.650,20,47,.426,13,16,.813,125,2016-04-13,MEM,GSW
77,@,L 104-113 ,240,40,82,.488,32,58,.552,8,24,.333,16,16,1.000,104,39,75,.520,26,56,.464,13,19,.684,22,22,1.000,113,2016-10-25,UTA,POR
78,@,W 104-98 ,240,39,81,.481,24,50,.480,15,31,.484,11,17,.647,104,32,79,.405,23,47,.489,9,32,.281,25,33,.758,98,2016-10-29,BOS,CHO
79,@,L 104-111 ,240,37,86,.430,28,61,.459,9,25,.360,21,26,.808,104,40,76,.526,34,55,.618,6,21,.286,25,39,.641,111,2016-10-29,MEM,NYK
80,@,W 104-72 ,240,42,85,.494,37,65,.569,5,20,.250,15,23,.652,104,28,80,.350,23,62,.371,5,18,.278,11,15,.733,72,2016-10-29,ATL,PHI
81,Home,L 104-127 ,240,37,86,.430,23,47,.489,14,39,.359,16,21,.762,104,50,89,.562,40,63,.635,10,26,.385,17,23,.739,127,2016-11-01,POR,GSW
82,Home,L 104-117 ,240,37,84,.440,29,61,.475,8,23,.348,22,27,.815,104,46,89,.517,37,68,.544,9,21,.429,16,21,.762,117,2016-11-04,CHI,NYK
83,Home,W 104-98 ,240,38,82,.463,30,56,.536,8,26,.308,20,29,.690,104,38,82,.463,30,48,.625,8,34,.235,14,18,.778,98,2016-11-09,CHO,UTA
84,Home,L 104-122 ,240,40,107,.374,32,74,.432,8,33,.242,16,21,.762,104,40,84,.476,24,47,.511,16,37,.432,26,30,.867,122,2016-11-12,PHO,BRK
85,Home,W 104-88 ,240,43,92,.467,38,76,.500,5,16,.313,13,16,.813,104,33,88,.375,28,61,.459,5,27,.185,17,22,.773,88,2016-11-14,DET,OKC
86,@,L 104-120 ,240,39,79,.494,31,59,.525,8,20,.400,18,29,.621,104,45,93,.484,37,76,.487,8,17,.471,22,24,.917,120,2016-11-16,PHO,DEN
87,@,W 104-88 ,240,44,90,.489,35,62,.565,9,28,.321,7,12,.583,104,31,83,.373,20,51,.392,11,32,.344,15,19,.789,88,2016-11-18,GSW,BOS
88,Home,W 104-81 ,240,40,83,.482,29,58,.500,11,25,.440,13,14,.929,104,29,93,.312,23,74,.311,6,19,.316,17,20,.850,81,2016-11-18,CLE,DET
89,Home,W 104-94 ,240,42,88,.477,32,61,.525,10,27,.370,10,14,.714,104,34,85,.400,28,64,.438,6,21,.286,20,29,.690,94,2016-11-20,NYK,ATL
90,Home,L 104-124 ,240,38,84,.452,27,60,.450,11,24,.458,17,18,.944,104,43,85,.506,28,53,.528,15,32,.469,23,31,.742,124,2016-11-23,DAL,LAC
91,@,W 104-99 (2OT),290,38,99,.384,28,70,.400,10,29,.345,18,24,.750,104,35,93,.376,23,57,.404,12,36,.333,17,23,.739,99,2016-11-23,MEM,PHI
92,@,L 104-119 ,240,36,76,.474,23,53,.434,13,23,.565,19,29,.655,104,47,100,.470,35,68,.515,12,32,.375,13,17,.765,119,2016-11-25,NOP,POR
93,Home,L 104-117 ,240,39,80,.488,30,48,.625,9,32,.281,17,21,.810,104,40,85,.471,19,35,.543,21,50,.420,16,20,.800,117,2016-11-25,SAC,HOU
94,@,W 104-96 ,240,41,86,.477,33,62,.532,8,24,.333,14,20,.700,104,38,92,.413,31,64,.484,7,28,.250,13,17,.765,96,2016-11-27,MIL,ORL
95,@,W 104-85 ,240,36,82,.439,27,56,.482,9,26,.346,23,31,.742,104,36,89,.404,29,60,.483,7,29,.241,6,13,.462,85,2016-11-28,CHO,MEM
96,Home,L 104-112 ,240,38,80,.475,32,50,.640,6,30,.200,22,32,.688,104,40,83,.482,29,56,.518,11,27,.407,21,26,.808,112,2016-11-28,MIA,BOS
97,Home,L 104-106 ,240,34,77,.442,30,58,.517,4,19,.211,32,39,.821,104,41,91,.451,28,59,.475,13,32,.406,11,15,.733,106,2016-11-30,MIN,NYK
98,Home,W 104-84 ,240,37,77,.481,24,48,.500,13,29,.448,17,18,.944,104,34,90,.378,25,64,.391,9,26,.346,7,13,.538,84,2016-12-10,UTA,SAC
99,Home,W 104-74 ,240,40,90,.444,31,67,.463,9,23,.391,15,17,.882,104,27,76,.355,18,46,.391,9,30,.300,11,20,.550,74,2016-12-20,GSW,UTA
0,@,L 104-116 ,240,36,91,.396,26,56,.464,10,35,.286,22,28,.786,104,42,91,.462,34,73,.466,8,18,.444,24,31,.774,116,2016-12-20,BRK,TOR
1,@,W 104-98 ,240,43,81,.531,35,60,.583,8,21,.381,10,15,.667,104,35,79,.443,25,52,.481,10,27,.370,18,21,.857,98,2016-12-23,TOR,UTA
2,Home,W 104-90 ,240,37,82,.451,22,51,.431,15,31,.484,15,18,.833,104,35,83,.422,27,51,.529,8,32,.250,12,17,.706,90,2016-12-26,MIN,ATL
3,@,L 104-111 ,240,37,75,.493,24,43,.558,13,32,.406,17,22,.773,104,37,70,.529,25,45,.556,12,25,.480,25,30,.833,111,2016-12-26,DAL,NOP
4,Home,W 104-92 ,240,38,85,.447,26,56,.464,12,29,.414,16,17,.941,104,35,93,.376,28,70,.400,7,23,.304,15,16,.938,92,2016-12-30,NOP,NYK
5,@,L 104-117 ,240,42,97,.433,32,59,.542,10,38,.263,10,11,.909,104,43,86,.500,34,64,.531,9,22,.409,22,24,.917,117,2017-01-01,ORL,IND
6,@,L 104-115 ,240,38,82,.463,27,56,.482,11,26,.423,17,21,.810,104,41,74,.554,24,43,.558,17,31,.548,16,17,.941,115,2017-01-03,UTA,BOS
7,Home,L 104-105 ,240,42,94,.447,29,66,.439,13,28,.464,7,12,.583,104,37,78,.474,28,50,.560,9,28,.321,22,31,.710,105,2017-01-04,NYK,MIL
8,@,W 104-95 ,240,38,90,.422,27,58,.466,11,32,.344,17,25,.680,104,40,97,.412,31,55,.564,9,42,.214,6,11,.545,95,2017-01-12,NOP,BRK
9,Home,W 104-89 ,240,44,92,.478,37,69,.536,7,23,.304,9,11,.818,104,35,89,.393,32,71,.451,3,18,.167,16,21,.762,89,2017-01-12,NYK,CHI
10,Home,L 104-108 ,240,40,95,.421,29,63,.460,11,32,.344,13,13,1.000,104,40,78,.513,36,61,.590,4,17,.235,24,35,.686,108,2017-01-15,MEM,CHI
11,Home,L 104-113 ,240,42,89,.472,37,75,.493,5,14,.357,15,22,.682,104,35,78,.449,21,41,.512,14,37,.378,29,36,.806,113,2017-01-16,MIL,PHI
12,Home,W 104-101 ,240,36,80,.450,28,51,.549,8,29,.276,24,26,.923,104,33,83,.398,25,58,.431,8,25,.320,27,34,.794,101,2017-01-18,WAS,MEM
13,@,W 104-101 ,240,40,84,.476,35,68,.515,5,16,.313,19,25,.760,104,42,87,.483,38,65,.585,4,22,.182,13,24,.542,101,2017-01-19,MIN,LAC
14,@,L 104-118 ,240,37,91,.407,27,60,.450,10,31,.323,20,26,.769,104,44,86,.512,35,64,.547,9,22,.409,21,25,.840,118,2017-01-19,DEN,SAS
15,Home,L 104-109 ,240,41,82,.500,31,54,.574,10,28,.357,12,17,.706,104,40,82,.488,31,61,.508,9,21,.429,20,26,.769,109,2017-01-23,DET,SAC
16,Home,W 104-97 ,240,39,86,.453,30,54,.556,9,32,.281,17,18,.944,104,35,75,.467,23,43,.535,12,32,.375,15,21,.714,97,2017-01-30,DAL,CLE
17,Home,W 104-96 ,240,39,82,.476,28,56,.500,11,26,.423,15,23,.652,104,37,87,.425,33,61,.541,4,26,.154,18,22,.818,96,2017-01-30,MIA,BRK
18,@,L 104-109 ,240,41,78,.526,33,47,.702,8,31,.258,14,25,.560,104,36,87,.414,24,51,.471,12,36,.333,25,30,.833,109,2017-02-01,TOR,BOS
19,Home,W 104-88 ,240,36,78,.462,25,49,.510,11,29,.379,21,27,.778,104,32,73,.438,23,50,.460,9,23,.391,15,25,.600,88,2017-02-01,UTA,MIL
20,Home,L 104-108 ,240,40,88,.455,31,58,.534,9,30,.300,15,20,.750,104,36,76,.474,19,45,.422,17,31,.548,19,23,.826,108,2017-02-03,POR,DAL
21,Home,L 104-111 ,240,39,86,.453,27,55,.491,12,31,.387,14,28,.500,104,41,84,.488,25,44,.568,16,40,.400,13,18,.722,111,2017-02-04,NYK,CLE
22,@,L 104-128 ,240,42,88,.477,36,63,.571,6,25,.240,14,20,.700,104,44,89,.494,28,51,.549,16,38,.421,24,36,.667,128,2017-02-07,ORL,HOU
23,Home,L 104-112 ,240,35,86,.407,27,55,.491,8,31,.258,26,30,.867,104,42,71,.592,29,41,.707,13,30,.433,15,23,.652,112,2017-02-11,UTA,BOS
24,Home,L 104-109 (OT),265,37,103,.359,21,61,.344,16,42,.381,14,25,.560,104,32,83,.386,24,55,.436,8,28,.286,37,48,.771,109,2017-02-13,POR,ATL
25,@,L 104-113 ,240,40,86,.465,28,62,.452,12,24,.500,12,14,.857,104,39,82,.476,21,43,.488,18,39,.462,17,19,.895,113,2017-02-15,IND,CLE
26,Home,W 104-103 ,240,38,90,.422,32,65,.492,6,25,.240,22,22,1.000,104,36,77,.468,22,40,.550,14,37,.378,17,20,.850,103,2017-02-16,CHI,BOS
27,@,L 104-119 ,240,42,100,.420,34,74,.459,8,26,.308,12,17,.706,104,46,87,.529,31,49,.633,15,38,.395,12,15,.800,119,2017-02-23,NYK,CLE
28,@,W 104-98 ,240,34,85,.400,22,50,.440,12,35,.343,24,30,.800,104,35,81,.432,23,48,.479,12,33,.364,16,35,.457,98,2017-02-26,BOS,DET
29,Home,L 104-109 ,240,41,84,.488,29,52,.558,12,32,.375,10,13,.769,104,38,85,.447,22,46,.478,16,39,.410,17,24,.708,109,2017-02-28,LAL,CHO
30,Home,W 104-100 ,240,39,82,.476,34,55,.618,5,27,.185,21,27,.778,104,38,82,.463,29,54,.537,9,28,.321,15,22,.682,100,2017-03-03,DAL,MEM
31,Home,W 104-89 ,240,42,86,.488,35,61,.574,7,25,.280,13,16,.813,104,33,82,.402,31,60,.517,2,22,.091,21,30,.700,89,2017-03-05,DAL,OKC
32,Home,W 104-93 ,240,37,86,.430,29,60,.483,8,26,.308,22,28,.786,104,39,84,.464,32,64,.500,7,20,.350,8,12,.667,93,2017-03-08,MIL,NYK
33,@,L 104-114 ,240,42,86,.488,35,67,.522,7,19,.368,13,16,.813,104,42,84,.500,28,55,.509,14,29,.483,16,21,.762,114,2017-03-08,SAC,SAS
34,@,L 103-107 ,240,40,83,.482,32,64,.500,8,19,.421,15,19,.789,103,40,97,.412,31,78,.397,9,19,.474,18,23,.783,107,2011-12-26,PHI,POR
35,@,W 103-83 ,240,41,86,.477,34,69,.493,7,17,.412,14,18,.778,103,33,80,.413,31,69,.449,2,11,.182,15,18,.833,83,2011-12-28,PHI,PHO
36,@,W 103-101 ,240,46,93,.495,43,79,.544,3,14,.214,8,14,.571,103,39,83,.470,28,54,.519,11,29,.379,12,20,.600,101,2011-12-30,MIA,MIN
37,@,W 103-93 ,240,34,76,.447,28,61,.459,6,15,.400,29,36,.806,103,36,83,.434,31,63,.492,5,20,.250,16,21,.762,93,2012-01-03,POR,OKC
38,Home,W 103-85 ,240,39,85,.459,31,66,.470,8,19,.421,17,25,.680,103,34,93,.366,32,81,.395,2,12,.167,15,18,.833,85,2012-01-04,ORL,WAS
39,Home,W 103-100 ,240,37,91,.407,33,70,.471,4,21,.190,25,30,.833,103,39,76,.513,30,57,.526,9,19,.474,13,21,.619,100,2012-01-05,SAC,MIL
40,@,W 103-80 ,240,39,83,.470,31,55,.564,8,28,.286,17,20,.850,103,29,78,.372,20,52,.385,9,26,.346,13,22,.591,80,2012-01-07,NYK,DET
41,@,L 103-106 ,240,45,75,.600,41,61,.672,4,14,.286,9,16,.563,103,44,85,.518,35,71,.493,9,14,.643,9,10,.900,106,2012-01-10,SAS,MIL
42,Home,W 103-89 ,240,40,89,.449,32,68,.471,8,21,.381,15,19,.789,103,35,80,.438,31,60,.517,4,20,.200,15,16,.938,89,2012-01-13,HOU,SAC
43,Home,L 103-110 ,240,41,79,.519,33,57,.579,8,22,.364,13,16,.813,103,40,80,.500,25,48,.521,15,32,.469,15,19,.789,110,2012-01-13,PHO,NJN
44,@,W 103-90 ,240,37,86,.430,31,70,.443,6,16,.375,23,27,.852,103,38,88,.432,35,74,.473,3,14,.214,11,17,.647,90,2012-01-14,PHI,WAS
45,Home,W 103-91 ,240,35,72,.486,27,51,.529,8,21,.381,25,40,.625,103,29,81,.358,21,62,.339,8,19,.421,25,31,.806,91,2012-01-22,LAC,TOR
46,Home,W 103-83 ,240,43,83,.518,37,67,.552,6,16,.375,11,20,.550,103,32,74,.432,32,67,.478,0,7,.000,19,27,.704,83,2012-01-23,PHI,WAS
47,Home,W 103-76 ,240,38,90,.422,33,75,.440,5,15,.333,22,30,.733,103,32,88,.364,31,80,.388,1,8,.125,11,16,.688,76,2012-01-27,HOU,WAS
48,Home,W 103-82 ,240,36,70,.514,26,53,.491,10,17,.588,21,26,.808,103,32,83,.386,31,74,.419,1,9,.111,17,20,.850,82,2012-01-30,MIL,DET
49,Home,L 103-120 ,240,40,77,.519,31,61,.508,9,16,.563,14,17,.824,103,41,78,.526,35,63,.556,6,15,.400,32,39,.821,120,2012-02-01,NOH,PHO
50,@,L 103-109 ,240,42,92,.457,30,69,.435,12,23,.522,7,9,.778,103,33,73,.452,20,43,.465,13,30,.433,30,39,.769,109,2012-02-01,WAS,ORL
51,@,W 103-96 ,240,41,78,.526,31,55,.564,10,23,.435,11,19,.579,103,35,74,.473,28,56,.500,7,18,.389,19,22,.864,96,2012-02-08,HOU,POR
52,@,W 103-89 ,240,42,80,.525,35,58,.603,7,22,.318,12,17,.706,103,35,87,.402,28,63,.444,7,24,.292,12,15,.800,89,2012-02-11,SAS,NJN
53,Home,W 103-87 ,240,40,75,.533,25,50,.500,15,25,.600,8,13,.615,103,36,85,.424,30,67,.448,6,18,.333,9,12,.750,87,2012-02-15,ORL,PHI
54,Home,W 103-102 ,240,41,82,.500,35,66,.530,6,16,.375,15,19,.789,103,41,83,.494,33,66,.500,8,17,.471,12,18,.667,102,2012-02-17,MEM,DEN
55,@,W 103-100 (OT),265,40,92,.435,28,64,.438,12,28,.429,11,21,.524,103,36,89,.404,28,63,.444,8,26,.308,20,23,.870,100,2012-02-18,SAS,LAC
56,@,L 103-104 ,240,35,82,.427,23,56,.411,12,26,.462,21,27,.778,103,37,73,.507,33,63,.524,4,10,.400,26,38,.684,104,2012-02-18,GSW,MEM
57,Home,W 103-101 (OT),265,37,92,.402,32,70,.457,5,22,.227,24,35,.686,103,36,99,.364,30,72,.417,6,27,.222,23,24,.958,101,2012-02-20,DEN,MIN
58,Home,W 103-92 ,240,38,83,.458,30,64,.469,8,19,.421,19,22,.864,103,32,78,.410,20,55,.364,12,23,.522,16,22,.727,92,2012-02-20,LAL,POR
59,Home,W 103-95 ,240,38,86,.442,31,59,.525,7,27,.259,20,28,.714,103,33,82,.402,27,59,.458,6,23,.261,23,31,.742,95,2012-02-22,LAC,DEN
60,Home,W 103-93 ,240,40,76,.526,37,69,.536,3,7,.429,20,28,.714,103,35,84,.417,33,72,.458,2,12,.167,21,27,.778,93,2012-02-22,TOR,DET
61,Home,W 103-96 ,240,37,84,.440,32,64,.500,5,20,.250,24,29,.828,103,40,85,.471,35,72,.486,5,13,.385,11,22,.500,96,2012-02-28,SAC,UTA
62,@,L 103-120 ,240,38,82,.463,29,62,.468,9,20,.450,18,27,.667,103,43,85,.506,37,65,.569,6,20,.300,28,42,.667,120,2012-02-29,CLE,NYK
63,Home,L 103-105 (OT),265,37,86,.430,27,66,.409,10,20,.500,19,24,.792,103,40,86,.465,34,72,.472,6,14,.429,19,25,.760,105,2012-03-04,HOU,LAC
64,Home,W 103-71 ,240,43,89,.483,37,72,.514,6,17,.353,11,15,.733,103,28,80,.350,28,72,.389,0,8,.000,15,18,.833,71,2012-03-07,PHI,BOS
65,Home,L 103-104 ,240,39,84,.464,31,61,.508,8,23,.348,17,22,.773,103,41,89,.461,31,65,.477,10,24,.417,12,14,.857,104,2012-03-13,OKC,HOU
66,Home,L 103-105 ,240,41,78,.526,36,57,.632,5,21,.238,16,19,.842,103,40,78,.513,34,65,.523,6,13,.462,19,21,.905,105,2012-03-14,GSW,BOS
67,@,W 103-90 ,240,36,79,.456,24,54,.444,12,25,.480,19,24,.792,103,34,78,.436,29,56,.518,5,22,.227,17,25,.680,90,2012-03-15,OKC,DEN
68,@,L 103-107 ,240,38,73,.521,30,55,.545,8,18,.444,19,24,.792,103,36,71,.507,32,62,.516,4,9,.444,31,34,.912,107,2012-03-17,TOR,CHA
69,@,W 103-87 ,240,43,85,.506,35,67,.522,8,18,.444,9,12,.750,103,33,84,.393,28,64,.438,5,20,.250,16,20,.800,87,2012-03-18,ATL,CLE
70,@,W 103-99 ,240,43,91,.473,41,81,.506,2,10,.200,15,22,.682,103,33,73,.452,31,60,.517,2,13,.154,31,40,.775,99,2012-03-18,UTA,LAL
71,Home,W 103-102 (OT),265,37,93,.398,29,73,.397,8,20,.400,21,24,.875,103,36,78,.462,30,59,.508,6,19,.316,24,33,.727,102,2012-03-21,ATL,CLE
72,Home,W 103-93 ,240,39,83,.470,28,60,.467,11,23,.478,14,21,.667,103,38,79,.481,34,67,.507,4,12,.333,13,19,.684,93,2012-03-21,ORL,PHO
73,@,W 103-102 ,240,43,91,.473,40,74,.541,3,17,.176,14,17,.824,103,43,106,.406,39,91,.429,4,15,.267,12,21,.571,102,2012-03-22,UTA,SAC
74,Home,W 103-96 ,240,40,85,.471,34,66,.515,6,19,.316,17,26,.654,103,36,82,.439,28,62,.452,8,20,.400,16,19,.842,96,2012-03-23,LAL,POR
75,Home,W 103-87 ,240,39,74,.527,33,63,.524,6,11,.545,19,23,.826,103,33,71,.465,26,49,.531,7,22,.318,14,14,1.000,87,2012-03-25,OKC,MIA
76,Home,W 103-85 ,240,45,92,.489,35,73,.479,10,19,.526,3,5,.600,103,28,70,.400,19,47,.404,9,23,.391,20,28,.714,85,2012-03-27,PHI,CLE
77,Home,W 103-86 ,240,41,82,.500,34,63,.540,7,19,.368,14,23,.609,103,30,80,.375,25,54,.463,5,26,.192,21,32,.656,86,2012-03-28,LAC,PHO
78,Home,L 103-104 ,240,31,88,.352,28,75,.373,3,13,.231,38,52,.731,103,39,90,.433,35,74,.473,4,16,.250,22,32,.688,104,2012-03-30,UTA,SAC
79,@,L 103-112 ,240,42,79,.532,37,65,.569,5,14,.357,14,18,.778,103,38,76,.500,29,57,.509,9,19,.474,27,33,.818,112,2012-03-31,IND,SAS
80,Home,W 103-98 ,240,35,85,.412,29,66,.439,6,19,.316,27,34,.794,103,34,77,.442,28,58,.483,6,19,.316,24,31,.774,98,2012-04-06,IND,OKC
81,@,L 103-128 ,240,36,77,.468,31,65,.477,5,12,.417,26,35,.743,103,51,84,.607,42,66,.636,9,18,.500,17,21,.810,128,2012-04-06,NOH,SAS
82,Home,W 103-79 ,240,40,68,.588,33,53,.623,7,15,.467,16,19,.842,103,29,76,.382,27,65,.415,2,11,.182,19,24,.792,79,2012-04-08,BOS,PHI
83,Home,W 103-98 ,240,36,71,.507,29,55,.527,7,16,.438,24,31,.774,103,36,75,.480,26,55,.473,10,20,.500,16,24,.667,98,2012-04-09,IND,TOR
84,Home,W 103-90 ,240,40,83,.482,29,64,.453,11,19,.579,12,14,.857,103,37,79,.468,34,68,.500,3,11,.273,13,16,.813,90,2012-04-10,CLE,CHA
85,@,W 103-91 ,240,40,78,.513,34,64,.531,6,14,.429,17,22,.773,103,31,87,.356,27,67,.403,4,20,.200,25,29,.862,91,2012-04-11,UTA,HOU
86,Home,L 103-112 ,240,38,81,.469,31,63,.492,7,18,.389,20,23,.870,103,44,88,.500,35,64,.547,9,24,.375,15,20,.750,112,2012-04-12,GSW,DAL
87,Home,W 103-97 ,240,38,75,.507,31,60,.517,7,15,.467,20,29,.690,103,41,92,.446,36,75,.480,5,17,.294,10,15,.667,97,2012-04-13,LAL,DEN
88,Home,W 103-65 ,240,39,84,.464,25,55,.455,14,29,.483,11,13,.846,103,22,79,.278,18,59,.305,4,20,.200,17,21,.810,65,2012-04-13,NYK,WAS
89,Home,W 103-98 ,240,34,70,.486,27,57,.474,7,13,.538,28,34,.824,103,40,83,.482,35,72,.486,5,11,.455,13,17,.765,98,2012-04-14,MEM,UTA
90,@,L 103-104 ,240,40,76,.526,24,44,.545,16,32,.500,7,10,.700,103,45,95,.474,37,76,.487,8,19,.421,6,9,.667,104,2012-04-15,POR,SAC
91,@,W 103-87 ,240,43,82,.524,34,67,.507,9,15,.600,8,10,.800,103,36,79,.456,31,65,.477,5,14,.357,10,16,.625,87,2012-04-18,PHI,CLE
92,Home,W 103-91 ,240,42,83,.506,34,61,.557,8,22,.364,11,13,.846,103,29,60,.483,27,53,.509,2,7,.286,31,38,.816,91,2012-04-18,MEM,NOH
93,@,W 103-92 ,240,40,75,.533,36,63,.571,4,12,.333,19,22,.864,103,38,93,.409,33,77,.429,5,16,.313,11,18,.611,92,2012-04-20,OKC,SAC
94,Home,W 103-97 ,240,35,92,.380,31,77,.403,4,15,.267,29,38,.763,103,38,83,.458,30,67,.448,8,16,.500,13,22,.591,97,2012-04-23,IND,DET
95,Home,W 103-94 ,240,38,91,.418,33,77,.429,5,14,.357,22,25,.880,103,40,90,.444,35,75,.467,5,15,.333,9,13,.692,94,2012-11-05,MEM,UTA
96,Home,W 103-73 ,240,40,77,.519,30,53,.566,10,24,.417,13,16,.813,103,30,80,.375,27,59,.458,3,21,.143,10,17,.588,73,2012-11-07,MIA,BRK
97,@,L 103-105 ,240,36,73,.493,28,51,.549,8,22,.364,23,31,.742,103,40,82,.488,33,66,.500,7,16,.438,18,24,.750,105,2012-11-07,DET,SAC
98,@,W 103-90 ,240,41,77,.532,38,64,.594,3,13,.231,18,25,.720,103,32,75,.427,25,55,.455,7,20,.350,19,30,.633,90,2012-11-08,LAC,POR
99,Home,W 103-90 ,240,36,81,.444,28,56,.500,8,25,.320,23,30,.767,103,36,90,.400,29,67,.433,7,23,.304,11,14,.786,90,2012-11-11,LAL,SAC
0,@,W 103-86 ,240,35,72,.486,21,45,.467,14,27,.519,19,22,.864,103,36,77,.468,35,66,.530,1,11,.091,13,19,.684,86,2012-11-13,POR,SAC
1,Home,W 103-83 ,240,39,83,.470,33,67,.493,6,16,.375,19,31,.613,103,30,81,.370,28,68,.412,2,13,.154,21,25,.840,83,2012-11-16,IND,DAL
2,@,W 103-95 ,240,38,74,.514,28,51,.549,10,23,.435,17,20,.850,103,36,96,.375,28,71,.394,8,25,.320,15,20,.750,95,2012-11-17,DAL,CLE
3,Home,W 103-83 ,240,39,72,.542,35,61,.574,4,11,.364,21,26,.808,103,32,71,.451,28,54,.519,4,17,.235,15,19,.789,83,2012-11-18,DET,BOS
4,@,L 103-131 ,240,37,86,.430,20,47,.426,17,39,.436,12,14,.857,103,46,89,.517,32,64,.500,14,25,.560,25,28,.893,131,2012-11-23,NYK,HOU
5,Home,W 103-95 ,240,42,78,.538,31,53,.585,11,25,.440,8,18,.444,103,32,78,.410,29,60,.483,3,18,.167,28,37,.757,95,2012-11-23,POR,MIN
6,@,L 103-105 ,240,40,73,.548,35,59,.593,5,14,.357,18,32,.563,103,36,78,.462,28,56,.500,8,22,.364,25,34,.735,105,2012-11-26,DEN,UTA
7,Home,W 103-82 ,240,38,80,.475,30,62,.484,8,18,.444,19,28,.679,103,29,74,.392,24,57,.421,5,17,.294,19,24,.792,82,2012-11-28,MEM,TOR
8,@,L 103-122 ,240,40,86,.465,32,62,.516,8,24,.333,15,22,.682,103,47,87,.540,30,54,.556,17,33,.515,11,17,.647,122,2012-11-30,DEN,LAL
9,Home,W 103-92 ,240,38,80,.475,29,60,.483,9,20,.450,18,19,.947,103,34,74,.459,26,52,.500,8,22,.364,16,20,.800,92,2012-12-01,GSW,IND
10,Home,L 103-113 ,240,36,86,.419,30,69,.435,6,17,.353,25,39,.641,103,43,86,.500,35,63,.556,8,23,.348,19,20,.950,113,2012-12-02,LAL,ORL
11,@,W 103-87 ,240,37,80,.463,24,52,.462,13,28,.464,16,22,.727,103,35,85,.412,28,66,.424,7,19,.368,10,18,.556,87,2012-12-05,LAL,NOH
12,@,L 103-113 ,240,34,75,.453,27,56,.482,7,19,.368,28,31,.903,103,41,83,.494,32,62,.516,9,21,.429,22,22,1.000,113,2012-12-14,SAC,OKC
13,Home,W 103-102 ,240,37,85,.435,24,50,.480,13,35,.371,16,23,.696,103,40,82,.488,31,58,.534,9,24,.375,13,17,.765,102,2012-12-15,NYK,CLE
14,Home,W 103-88 ,240,38,81,.469,26,56,.464,12,25,.480,15,20,.750,103,38,81,.469,32,65,.492,6,16,.375,6,8,.750,88,2012-12-15,SAS,BOS
15,Home,W 103-96 ,240,39,85,.459,31,55,.564,8,30,.267,17,20,.850,103,32,78,.410,25,55,.455,7,23,.304,25,32,.781,96,2012-12-16,TOR,HOU
16,Home,W 103-96 ,240,34,78,.436,28,60,.467,6,18,.333,29,34,.853,103,35,75,.467,26,48,.542,9,27,.333,17,17,1.000,96,2012-12-18,GSW,NOH
17,Home,W 103-92 ,240,36,77,.468,23,52,.442,13,25,.520,18,23,.783,103,37,86,.430,33,69,.478,4,17,.235,14,19,.737,92,2012-12-18,MIA,MIN
18,Home,W 103-91 ,240,37,62,.597,28,45,.622,9,17,.529,20,27,.741,103,36,88,.409,31,70,.443,5,18,.278,14,21,.667,91,2012-12-19,BOS,CLE
19,@,L 103-125 ,240,40,89,.449,34,72,.472,6,17,.353,17,24,.708,103,42,75,.560,31,48,.646,11,27,.407,30,36,.833,125,2012-12-19,PHI,HOU
20,@,W 103-77 ,240,38,71,.535,27,50,.540,11,21,.524,16,29,.552,103,29,80,.363,26,63,.413,3,17,.176,16,24,.667,77,2012-12-23,LAC,PHO
21,Home,W 103-97 ,240,38,80,.475,30,52,.577,8,28,.286,19,19,1.000,103,30,71,.423,25,55,.455,5,16,.313,32,38,.842,97,2012-12-25,MIA,OKC
22,Home,W 103-100 ,240,35,75,.467,31,60,.517,4,15,.267,29,39,.744,103,38,82,.463,29,62,.468,9,20,.450,15,19,.789,100,2012-12-29,BRK,CLE
23,Home,W 103-97 ,240,39,75,.520,31,55,.564,8,20,.400,17,22,.773,103,36,86,.419,27,60,.450,9,26,.346,16,21,.762,97,2013-01-01,DET,SAC
24,@,W 103-99 ,240,41,86,.477,33,64,.516,8,22,.364,13,20,.650,103,37,94,.394,34,72,.472,3,22,.136,22,33,.667,99,2013-01-01,PHI,LAL
25,@,W 103-94 ,240,41,82,.500,31,60,.517,10,22,.455,11,17,.647,103,32,79,.405,22,53,.415,10,26,.385,20,26,.769,94,2013-01-01,DAL,WAS
26,@,L 103-108 ,240,38,77,.494,28,55,.509,10,22,.455,17,21,.810,103,40,87,.460,32,72,.444,8,15,.533,20,26,.769,108,2013-01-08,ATL,MIN
27,Home,W 103-95 ,240,40,72,.556,31,53,.585,9,19,.474,14,23,.609,103,36,76,.474,28,56,.500,8,20,.400,15,19,.789,95,2013-01-11,ATL,UTA
28,Home,W 103-91 ,240,41,79,.519,32,56,.571,9,23,.391,12,16,.750,103,35,80,.438,26,47,.553,9,33,.273,12,29,.414,91,2013-01-11,BOS,HOU
29,Home,W 103-97 ,240,41,86,.477,35,71,.493,6,15,.400,15,18,.833,103,35,92,.380,20,49,.408,15,43,.349,12,19,.632,97,2013-01-11,GSW,POR
30,@,W 103-87 ,240,39,90,.433,31,68,.456,8,22,.364,17,25,.680,103,36,91,.396,35,75,.467,1,16,.063,14,19,.737,87,2013-01-11,DET,MIL
31,@,W 103-76 ,240,36,87,.414,28,65,.431,8,22,.364,23,28,.821,103,25,72,.347,22,63,.349,3,9,.333,23,30,.767,76,2013-01-15,IND,CHA
32,Home,W 103-82 ,240,44,76,.579,35,58,.603,9,18,.500,6,10,.600,103,29,69,.420,28,60,.467,1,9,.111,23,28,.821,82,2013-01-16,SAS,MEM
33,Home,W 103-88 ,240,36,78,.462,27,59,.458,9,19,.474,22,31,.710,103,33,83,.398,29,68,.426,4,15,.267,18,25,.720,88,2013-01-20,DET,BOS
34,@,L 103-108 ,240,38,88,.432,29,61,.475,9,27,.333,18,21,.857,103,46,84,.548,40,64,.625,6,20,.300,10,17,.588,108,2013-01-20,LAL,TOR
35,Home,W 103-87 ,240,41,88,.466,32,68,.471,9,20,.450,12,18,.667,103,27,78,.346,23,59,.390,4,19,.211,29,33,.879,87,2013-01-25,CHI,GSW
36,@,W 103-100 ,240,40,73,.548,32,60,.533,8,13,.615,15,19,.789,103,45,83,.542,41,74,.554,4,9,.444,6,9,.667,100,2013-01-28,MEM,PHI
37,@,L 103-114 ,240,36,81,.444,28,60,.467,8,21,.381,23,28,.821,103,36,75,.480,25,50,.500,11,25,.440,31,40,.775,114,2013-02-05,ATL,IND
38,Home,W 103-92 ,240,38,74,.514,28,50,.560,10,24,.417,17,23,.739,103,38,84,.452,33,72,.458,5,12,.417,11,16,.688,92,2013-02-06,ATL,MEM
39,@,L 103-118 ,240,40,88,.455,32,62,.516,8,26,.308,15,20,.750,103,47,79,.595,35,53,.660,12,26,.462,12,16,.750,118,2013-02-08,POR,HOU
40,Home,L 103-111 ,240,37,84,.440,28,64,.438,9,20,.450,20,26,.769,103,40,80,.500,34,63,.540,6,17,.353,25,34,.735,111,2013-02-09,CLE,DEN
41,@,W 103-89 ,240,39,75,.520,31,59,.525,8,16,.500,17,20,.850,103,37,78,.474,35,66,.530,2,12,.167,13,20,.650,89,2013-02-11,SAS,CHI
42,@,W 103-90 ,240,37,78,.474,27,55,.491,10,23,.435,19,25,.760,103,36,72,.500,29,46,.630,7,26,.269,11,16,.688,90,2013-02-20,MIA,ATL
43,@,W 103-102 ,240,39,91,.429,25,63,.397,14,28,.500,11,14,.786,103,41,89,.461,37,77,.481,4,12,.333,16,20,.800,102,2013-02-23,ATL,MIL
44,@,L 103-105 ,240,38,84,.452,19,38,.500,19,46,.413,8,14,.571,103,41,80,.513,34,64,.531,7,16,.438,16,19,.842,105,2013-02-23,HOU,WAS
45,@,W 103-99 ,240,34,72,.472,21,47,.447,13,25,.520,22,31,.710,103,39,87,.448,31,69,.449,8,18,.444,13,19,.684,99,2013-02-24,LAL,DAL
46,Home,L 103-114 ,240,41,84,.488,38,70,.543,3,14,.214,18,22,.818,103,40,79,.506,26,46,.565,14,33,.424,20,24,.833,114,2013-02-25,DET,ATL
47,Home,W 103-92 ,240,34,82,.415,29,69,.420,5,13,.385,30,32,.938,103,35,78,.449,33,58,.569,2,20,.100,20,25,.800,92,2013-02-27,CLE,TOR
48,@,L 103-105 ,240,36,83,.434,29,63,.460,7,20,.350,24,34,.706,103,43,95,.453,36,74,.486,7,21,.333,12,17,.706,105,2013-03-01,OKC,DEN
49,@,L 103-136 ,240,38,80,.475,26,53,.491,12,27,.444,15,24,.625,103,46,80,.575,32,46,.696,14,34,.412,30,40,.750,136,2013-03-03,DAL,HOU
50,@,W 103-92 ,240,45,86,.523,41,75,.547,4,11,.364,9,11,.818,103,33,72,.458,27,58,.466,6,14,.429,20,26,.769,92,2013-03-08,MEM,CLE
51,@,W 103-93 ,240,38,78,.487,25,50,.500,13,28,.464,14,19,.737,103,37,82,.451,31,67,.463,6,15,.400,13,20,.650,93,2013-03-09,MIL,GSW
52,Home,W 103-90 ,240,42,81,.519,36,65,.554,6,16,.375,13,15,.867,103,34,80,.425,27,60,.450,7,20,.350,15,18,.833,90,2013-03-11,UTA,DET
53,Home,L 103-105 ,240,39,72,.542,29,51,.569,10,21,.476,15,24,.625,103,42,85,.494,35,65,.538,7,20,.350,14,21,.667,105,2013-03-18,BOS,MIA
54,@,W 103-100 ,240,40,87,.460,29,61,.475,11,26,.423,12,16,.750,103,39,81,.481,28,58,.483,11,23,.478,11,17,.647,100,2013-03-22,WAS,LAL
55,Home,W 103-89 ,240,38,68,.559,30,53,.566,8,15,.533,19,26,.731,103,34,83,.410,27,61,.443,7,22,.318,14,18,.778,89,2013-03-22,MIA,DET
56,Home,W 103-83 ,240,43,82,.524,39,71,.549,4,11,.364,13,18,.722,103,32,79,.405,22,53,.415,10,26,.385,9,13,.692,83,2013-03-24,OKC,POR
57,Home,L 103-117 ,240,42,85,.494,33,61,.541,9,24,.375,10,12,.833,103,47,96,.490,39,75,.520,8,21,.381,15,21,.714,117,2013-03-24,SAC,PHI
58,@,L 103-109 ,240,36,91,.396,30,65,.462,6,26,.231,25,36,.694,103,43,90,.478,33,67,.493,10,23,.435,13,19,.684,109,2013-03-25,LAL,GSW
59,Home,W 103-80 ,240,29,63,.460,21,49,.429,8,14,.571,37,41,.902,103,27,84,.321,22,64,.344,5,20,.250,21,29,.724,80,2013-03-27,OKC,WAS
60,Home,W 103-88 ,240,44,85,.518,38,70,.543,6,15,.400,9,13,.692,103,34,76,.447,28,60,.467,6,16,.375,14,19,.737,88,2013-03-27,UTA,PHO
61,@,W 103-78 ,240,40,84,.476,33,69,.478,7,15,.467,16,26,.615,103,32,83,.386,28,69,.406,4,14,.286,10,14,.714,78,2013-03-28,IND,DAL
62,@,L 103-113 ,240,34,77,.442,29,57,.509,5,20,.250,30,39,.769,103,45,93,.484,38,74,.514,7,19,.368,16,22,.727,113,2013-03-28,LAL,MIL
63,Home,L 103-117 ,240,42,94,.447,35,74,.473,7,20,.350,12,23,.522,103,44,83,.530,37,65,.569,7,18,.389,22,24,.917,117,2013-03-28,PHO,SAC
64,Home,W 103-94 ,240,40,79,.506,36,68,.529,4,11,.364,19,21,.905,103,34,81,.420,25,54,.463,9,27,.333,17,21,.810,94,2013-03-29,MEM,HOU
65,@,W 103-98 ,240,38,82,.463,28,52,.538,10,30,.333,17,26,.654,103,39,86,.453,32,62,.516,7,24,.292,13,16,.813,98,2013-03-30,LAL,SAC
66,@,L 103-111 ,240,39,93,.419,33,78,.423,6,15,.400,19,21,.905,103,44,98,.449,35,69,.507,9,29,.310,14,22,.636,111,2013-04-01,ORL,HOU
67,@,L 103-113 (OT),265,39,101,.386,31,73,.425,8,28,.286,17,26,.654,103,51,109,.468,43,94,.457,8,15,.533,3,8,.375,113,2013-04-10,MIL,ORL
68,@,W 103-98 ,240,33,75,.440,16,34,.471,17,41,.415,20,23,.870,103,36,80,.450,25,57,.439,11,23,.478,15,21,.714,98,2013-04-10,MIA,WAS
69,@,W 103-97 ,240,38,80,.475,31,59,.525,7,21,.333,20,25,.800,103,34,76,.447,25,57,.439,9,19,.474,20,25,.800,97,2013-04-15,MEM,DAL
70,Home,W 103-99 ,240,39,81,.481,31,57,.544,8,24,.333,17,23,.739,103,37,78,.474,36,65,.554,1,13,.077,24,32,.750,99,2013-04-17,BRK,DET
71,@,L 103-116 ,240,41,83,.494,33,62,.532,8,21,.381,13,23,.565,103,42,93,.452,28,64,.438,14,29,.483,18,28,.643,116,2013-10-29,LAC,LAL
72,@,L 103-105 ,240,40,90,.444,31,68,.456,9,22,.409,14,26,.538,103,38,89,.427,29,64,.453,9,25,.360,20,24,.833,105,2013-11-03,ATL,LAL
73,Home,W 103-93 ,240,37,70,.529,26,43,.605,11,27,.407,18,27,.667,103,35,82,.427,23,52,.442,12,30,.400,11,16,.688,93,2013-11-03,MIA,WAS
74,Home,W 103-96 ,240,35,82,.427,33,64,.516,2,18,.111,31,37,.838,103,32,80,.400,18,43,.419,14,37,.378,18,22,.818,96,2013-11-03,OKC,PHO
75,@,L 103-114 ,240,36,80,.450,28,58,.483,8,22,.364,23,28,.821,103,40,83,.482,31,63,.492,9,20,.450,25,32,.781,114,2013-11-08,DEN,PHO
76,@,W 103-94 ,240,35,76,.461,25,49,.510,10,27,.370,23,28,.821,103,33,81,.407,28,68,.412,5,13,.385,23,29,.793,94,2013-11-11,ATL,CHA
77,@,L 103-109 ,240,42,91,.462,39,77,.506,3,14,.214,16,21,.762,103,42,82,.512,31,59,.525,11,23,.478,14,15,.933,109,2013-11-11,DET,POR
78,@,L 103-111 ,240,35,75,.467,29,59,.492,6,16,.375,27,33,.818,103,39,86,.453,33,58,.569,6,28,.214,27,34,.794,111,2013-11-13,OKC,LAC
79,@,W 103-87 ,240,31,67,.463,23,52,.442,8,15,.533,33,39,.846,103,35,82,.427,29,61,.475,6,21,.286,11,17,.647,87,2013-11-13,TOR,MEM
80,@,L 103-113 ,240,40,86,.465,35,67,.522,5,19,.263,18,23,.783,103,39,81,.481,29,58,.500,10,23,.435,25,31,.806,113,2013-11-15,PHI,ATL
81,@,L 103-110 ,240,36,85,.424,27,62,.435,9,23,.391,22,33,.667,103,40,77,.519,30,54,.556,10,23,.435,20,30,.667,110,2013-11-16,BRK,LAC
82,@,W 103-96 (OT),265,36,81,.444,26,60,.433,10,21,.476,21,22,.955,103,37,93,.398,31,68,.456,6,25,.240,16,22,.727,96,2013-11-16,CLE,WAS
83,@,W 103-96 (OT),265,33,87,.379,24,57,.421,9,30,.300,28,36,.778,103,37,100,.370,29,70,.414,8,30,.267,14,17,.824,96,2013-11-20,IND,NYK
84,Home,W 103-93 ,240,38,75,.507,31,58,.534,7,17,.412,20,27,.741,103,39,78,.500,32,58,.552,7,20,.350,8,12,.667,93,2013-11-22,DAL,UTA
85,Home,W 103-102 ,240,33,68,.485,22,43,.512,11,25,.440,26,45,.578,103,37,88,.420,32,71,.451,5,17,.294,23,30,.767,102,2013-11-23,LAC,SAC
86,Home,W 103-99 ,240,44,99,.444,37,81,.457,7,18,.389,8,10,.800,103,32,76,.421,23,53,.434,9,23,.391,26,34,.765,99,2013-11-27,DAL,GSW
87,Home,W 103-86 ,240,38,76,.500,27,53,.509,11,23,.478,16,26,.615,103,32,86,.372,28,68,.412,4,18,.222,18,27,.667,86,2013-11-29,BOS,CLE
88,@,W 103-99 ,240,38,77,.494,28,56,.500,10,21,.476,17,23,.739,103,34,76,.447,21,41,.512,13,35,.371,18,21,.857,99,2013-12-01,NOP,NYK
89,@,L 103-113 ,240,37,89,.416,28,60,.467,9,29,.310,20,26,.769,103,49,87,.563,40,68,.588,9,19,.474,6,9,.667,113,2013-12-01,MIN,OKC
90,@,L 103-109 ,240,40,83,.482,31,55,.564,9,28,.321,14,20,.700,103,43,79,.544,33,62,.532,10,17,.588,13,16,.813,109,2013-12-02,HOU,UTA
91,@,L 103-112 ,240,40,77,.519,32,57,.561,8,20,.400,15,18,.833,103,40,79,.506,28,50,.560,12,29,.414,20,25,.800,112,2013-12-03,TOR,GSW
92,@,W 103-82 ,240,43,78,.551,39,60,.650,4,18,.222,13,19,.684,103,24,82,.293,19,60,.317,5,22,.227,29,39,.744,82,2013-12-07,MIA,MIN
93,@,W 103-92 ,240,35,83,.422,28,61,.459,7,22,.318,26,34,.765,103,40,88,.455,37,72,.514,3,16,.188,9,14,.643,92,2013-12-07,DEN,PHI
94,Home,L 103-116 ,240,38,83,.458,28,60,.467,10,23,.435,17,19,.895,103,45,82,.549,32,59,.542,13,23,.565,13,16,.813,116,2013-12-10,TOR,SAS
95,@,W 103-93 ,240,38,84,.452,30,63,.476,8,21,.381,19,20,.950,103,36,85,.424,29,64,.453,7,21,.333,14,24,.583,93,2013-12-13,UTA,DEN
96,Home,W 103-99 ,240,39,83,.470,36,73,.493,3,10,.300,22,31,.710,103,36,79,.456,24,56,.429,12,23,.522,15,20,.750,99,2013-12-13,DET,BRK
97,@,W 103-99 ,240,35,88,.398,23,54,.426,12,34,.353,21,31,.677,103,35,85,.412,31,68,.456,4,17,.235,25,29,.862,99,2013-12-20,PHO,DEN
98,@,L 103-122 ,240,43,74,.581,36,52,.692,7,22,.318,10,24,.417,103,51,83,.614,41,60,.683,10,23,.435,10,14,.714,122,2013-12-20,SAC,MIA
99,@,W 103-86 ,240,38,83,.458,29,55,.527,9,28,.321,18,19,.947,103,29,76,.382,23,50,.460,6,26,.231,22,25,.880,86,2013-12-23,IND,BRK
0,@,W 103-98 ,240,39,86,.453,29,65,.446,10,21,.476,15,19,.789,103,37,89,.416,29,64,.453,8,25,.320,16,22,.727,98,2013-12-23,NYK,ORL
1,@,L 103-105 ,240,40,81,.494,36,63,.571,4,18,.222,19,23,.826,103,40,95,.421,30,71,.423,10,24,.417,15,22,.682,105,2013-12-25,LAC,GSW
2,@,L 103-108 (OT),265,38,86,.442,27,54,.500,11,32,.344,16,21,.762,103,41,83,.494,36,63,.571,5,20,.250,21,25,.840,108,2013-12-27,MIA,SAC
3,@,L 103-105 ,240,40,80,.500,33,57,.579,7,23,.304,16,23,.696,103,40,88,.455,31,65,.477,9,23,.391,16,20,.800,105,2013-12-27,LAL,UTA
4,Home,W 103-100 ,240,38,83,.458,29,58,.500,9,25,.360,18,25,.720,103,37,79,.468,28,61,.459,9,18,.500,17,24,.708,100,2013-12-28,BOS,CLE
5,Home,L 103-113 ,240,42,92,.457,36,75,.480,6,17,.353,13,19,.684,103,45,83,.542,36,68,.529,9,15,.600,14,23,.609,113,2014-01-04,SAC,CHA
6,Home,L 103-104 ,240,34,86,.395,28,70,.400,6,16,.375,29,35,.829,103,38,92,.413,27,63,.429,11,29,.379,17,23,.739,104,2014-01-08,MIN,PHO
7,Home,W 103-83 ,240,41,80,.513,38,66,.576,3,14,.214,18,19,.947,103,26,78,.333,18,51,.353,8,27,.296,23,29,.793,83,2014-01-10,SAC,ORL
8,Home,W 103-97 ,240,38,81,.469,32,67,.478,6,14,.429,21,26,.808,103,37,79,.468,33,68,.485,4,11,.364,19,20,.950,97,2014-01-11,CHI,CHA
9,@,L 103-118 ,240,37,84,.440,30,58,.517,7,26,.269,22,35,.629,103,44,79,.557,36,61,.590,8,18,.444,22,29,.759,118,2014-01-13,DEN,UTA
10,@,W 103-100 ,240,37,72,.514,33,59,.559,4,13,.308,25,41,.610,103,35,77,.455,27,57,.474,8,20,.400,22,29,.759,100,2014-01-15,HOU,NOP
11,Home,W 103-78 ,240,40,82,.488,34,62,.548,6,20,.300,17,20,.850,103,34,97,.351,32,78,.410,2,19,.105,8,12,.667,78,2014-01-18,CHI,PHI
12,@,L 103-117 ,240,36,82,.439,27,54,.500,9,28,.321,22,30,.733,103,46,91,.505,38,72,.528,8,19,.421,17,26,.654,117,2014-01-19,DEN,PHO
13,Home,L 103-112 ,240,40,79,.506,38,65,.585,2,14,.143,21,29,.724,103,40,72,.556,31,51,.608,9,21,.429,23,37,.622,112,2014-01-20,DET,LAC
14,@,W 103-80 ,240,37,75,.493,23,37,.622,14,38,.368,15,20,.750,103,24,71,.338,16,46,.348,8,25,.320,24,37,.649,80,2014-01-20,BRK,NYK
15,@,W 103-101 ,240,37,73,.507,30,56,.536,7,17,.412,22,24,.917,103,37,85,.435,31,67,.463,6,18,.333,21,28,.750,101,2014-01-24,NOP,DET
16,@,W 103-91 ,240,40,76,.526,36,55,.655,4,21,.190,19,25,.760,103,34,90,.378,30,63,.476,4,27,.148,19,27,.704,91,2014-01-25,OKC,PHI
17,Home,W 103-88 ,240,38,91,.418,28,66,.424,10,25,.400,17,21,.810,103,28,83,.337,22,62,.355,6,21,.286,26,33,.788,88,2014-01-26,GSW,POR
18,@,L 103-110 ,240,39,75,.520,28,52,.538,11,23,.478,14,18,.778,103,43,90,.478,32,64,.500,11,26,.423,13,18,.722,110,2014-01-26,LAL,NYK
19,Home,L 103-104 ,240,37,77,.481,26,53,.491,11,24,.458,18,22,.818,103,37,79,.468,28,57,.491,9,22,.409,21,26,.808,104,2014-01-27,BRK,TOR
20,Home,W 103-87 ,240,39,86,.453,33,66,.500,6,20,.300,19,28,.679,103,32,77,.416,24,57,.421,8,20,.400,15,25,.600,87,2014-01-28,DET,ORL
21,@,L 103-110 ,240,45,88,.511,42,66,.636,3,22,.136,10,17,.588,103,36,73,.493,30,58,.517,6,15,.400,32,42,.762,110,2014-01-29,WAS,LAC
22,@,L 103-107 ,240,38,75,.507,31,54,.574,7,21,.333,20,23,.870,103,38,80,.475,36,61,.590,2,19,.105,29,36,.806,107,2014-01-31,SAC,DAL
23,@,L 103-106 ,240,40,87,.460,34,67,.507,6,20,.300,17,25,.680,103,35,76,.461,27,58,.466,8,18,.444,28,35,.800,106,2014-02-01,TOR,POR
24,Home,W 103-89 ,240,46,93,.495,42,80,.525,4,13,.308,7,10,.700,103,29,73,.397,22,52,.423,7,21,.333,24,29,.828,89,2014-02-06,BRK,SAS
25,Home,W 103-81 ,240,38,81,.469,28,63,.444,10,18,.556,17,22,.773,103,31,76,.408,19,41,.463,12,35,.343,7,14,.500,81,2014-02-07,DAL,UTA
26,Home,W 103-102 ,240,38,80,.475,33,68,.485,5,12,.417,22,26,.846,103,37,73,.507,27,51,.529,10,22,.455,18,19,.947,102,2014-02-07,ORL,OKC
27,@,W 103-97 ,240,36,76,.474,27,49,.551,9,27,.333,22,30,.733,103,35,76,.461,23,48,.479,12,28,.429,15,17,.882,97,2014-02-11,MIA,PHO
28,Home,L 103-107 ,240,40,83,.482,30,55,.545,10,28,.357,13,22,.591,103,39,88,.443,31,60,.517,8,28,.286,21,24,.875,107,2014-02-13,LAL,OKC
29,Home,L 103-113 ,240,35,81,.432,29,60,.483,6,21,.286,27,38,.711,103,44,88,.500,35,68,.515,9,20,.450,16,21,.762,113,2014-02-18,LAC,SAS
30,@,W 103-93 ,240,42,74,.568,35,58,.603,7,16,.438,12,15,.800,103,38,81,.469,34,66,.515,4,15,.267,13,21,.619,93,2014-02-18,TOR,WAS
31,@,W 103-81 ,240,41,75,.547,36,54,.667,5,21,.238,16,21,.762,103,28,74,.378,26,54,.481,2,20,.100,23,30,.767,81,2014-02-20,MIA,OKC
32,Home,L 103-107 ,240,38,84,.452,24,51,.471,14,33,.424,13,16,.813,103,37,88,.420,29,64,.453,8,24,.333,25,29,.862,107,2014-02-25,ATL,CHI
33,Home,L 103-129 ,240,36,90,.400,31,72,.431,5,18,.278,26,31,.839,103,41,72,.569,30,50,.600,11,22,.500,36,42,.857,129,2014-02-25,SAC,HOU
34,Home,W 103-83 ,240,37,83,.446,32,69,.464,5,14,.357,24,30,.800,103,30,84,.357,25,63,.397,5,21,.238,18,22,.818,83,2014-02-26,CHI,GSW
35,@,L 103-108 ,240,38,77,.494,23,49,.469,15,28,.536,12,18,.667,103,45,92,.489,41,79,.519,4,13,.308,14,21,.667,108,2014-02-26,LAL,MEM
36,Home,L 103-126 ,240,36,95,.379,26,70,.371,10,25,.400,21,23,.913,103,44,92,.478,30,57,.526,14,35,.400,24,31,.774,126,2014-02-28,NYK,GSW
37,Home,L 103-122 ,240,38,84,.452,33,62,.532,5,22,.227,22,32,.688,103,45,89,.506,33,63,.524,12,26,.462,20,28,.714,122,2014-03-01,PHI,WAS
38,@,L 103-106 ,240,38,80,.475,31,53,.585,7,27,.259,20,29,.690,103,40,78,.513,32,55,.582,8,23,.348,18,27,.667,106,2014-03-04,MIA,HOU
39,Home,W 103-94 ,240,38,74,.514,23,48,.479,15,26,.577,12,13,.923,103,34,79,.430,28,64,.438,6,15,.400,20,25,.800,94,2014-03-05,BRK,MEM
40,Home,W 103-98 ,240,37,79,.468,33,66,.500,4,13,.308,25,34,.735,103,38,83,.458,31,57,.544,7,26,.269,15,21,.714,98,2014-03-07,DAL,POR
41,Home,W 103-90 ,240,38,88,.432,27,64,.422,11,24,.458,16,22,.727,103,32,83,.386,28,62,.452,4,21,.190,22,30,.733,90,2014-03-12,SAS,POR
42,@,W 103-94 ,240,40,82,.488,30,60,.500,10,22,.455,13,18,.722,103,35,77,.455,24,48,.500,11,29,.379,13,19,.684,94,2014-03-14,CLE,GSW
43,Home,L 103-111 ,240,41,86,.477,38,75,.507,3,11,.273,18,21,.857,103,38,78,.487,24,45,.533,14,33,.424,21,27,.778,111,2014-03-14,NOP,POR
44,@,W 103-77 ,240,38,70,.543,34,55,.618,4,15,.267,23,32,.719,103,31,83,.373,25,60,.417,6,23,.261,9,19,.474,77,2014-03-15,MEM,PHI
45,Home,W 103-89 ,240,37,82,.451,27,55,.491,10,27,.370,19,21,.905,103,35,77,.455,31,64,.484,4,13,.308,15,20,.750,89,2014-03-18,GSW,ORL
46,@,L 103-116 ,240,38,90,.422,26,63,.413,12,27,.444,15,17,.882,103,41,81,.506,27,46,.587,14,35,.400,20,25,.800,116,2014-03-20,WAS,POR
47,@,L 103-112 ,240,42,93,.452,30,64,.469,12,29,.414,7,13,.538,103,45,83,.542,34,54,.630,11,29,.379,11,17,.647,112,2014-03-22,DET,LAC
48,Home,W 103-94 ,240,37,80,.463,31,64,.484,6,16,.375,23,29,.793,103,37,82,.451,31,63,.492,6,19,.316,14,17,.824,94,2014-03-23,LAL,ORL
49,@,L 103-108 ,240,38,83,.458,31,64,.484,7,19,.368,20,25,.800,103,43,88,.489,35,68,.515,8,20,.400,14,20,.700,108,2014-03-26,DEN,SAS
50,Home,L 103-109 ,240,37,79,.468,27,59,.458,10,20,.500,19,27,.704,103,38,82,.463,27,56,.482,11,26,.423,22,25,.880,109,2014-03-27,DAL,LAC
51,@,L 103-105 ,240,40,76,.526,34,58,.586,6,18,.333,17,20,.850,103,40,86,.465,35,66,.530,5,20,.250,20,22,.909,105,2014-03-28,BOS,TOR
52,Home,W 103-100 ,240,34,70,.486,27,47,.574,7,23,.304,28,35,.800,103,42,81,.519,39,71,.549,3,10,.300,13,19,.684,100,2014-03-29,DAL,SAC
53,Home,W 103-95 ,240,36,84,.429,29,53,.547,7,31,.226,24,30,.800,103,36,77,.468,25,47,.532,11,30,.367,12,20,.600,95,2014-03-31,ATL,PHI
54,@,W 103-77 ,240,37,80,.463,29,63,.460,8,17,.471,21,25,.840,103,26,69,.377,20,55,.364,6,14,.429,19,24,.792,77,2014-03-31,SAS,IND
55,@,L 103-107 ,240,36,87,.414,27,61,.443,9,26,.346,22,30,.733,103,34,75,.453,24,50,.480,10,25,.400,29,39,.744,107,2014-04-02,HOU,TOR
56,@,L 103-106 ,240,44,87,.506,37,69,.536,7,18,.389,8,12,.667,103,41,79,.519,30,56,.536,11,23,.478,13,13,1.000,106,2014-04-11,CHA,BOS
57,@,L 103-106 ,240,35,88,.398,28,66,.424,7,22,.318,26,30,.867,103,41,82,.500,35,65,.538,6,17,.353,18,27,.667,106,2014-04-13,MIN,SAC
58,Home,L 103-111 ,240,40,77,.519,33,59,.559,7,18,.389,16,21,.762,103,41,76,.539,33,52,.635,8,24,.333,21,26,.808,111,2014-04-16,MIL,ATL
59,Home,W 103-91 ,240,38,81,.469,30,56,.536,8,25,.320,19,28,.679,103,34,89,.382,28,68,.412,6,21,.286,17,30,.567,91,2014-10-29,IND,PHI
60,Home,W 103-94 ,240,34,81,.420,30,71,.423,4,10,.400,31,35,.886,103,34,83,.410,25,57,.439,9,26,.346,17,19,.895,94,2014-10-31,SAC,POR
61,@,L 103-112 (OT),265,40,93,.430,36,75,.480,4,18,.222,19,25,.760,103,46,91,.505,41,81,.506,5,10,.500,15,19,.789,112,2014-11-07,MIN,ORL
62,Home,W 103-84 ,240,35,80,.438,26,58,.448,9,22,.409,24,31,.774,103,30,83,.361,27,64,.422,3,19,.158,21,32,.656,84,2014-11-07,TOR,WAS
63,Home,W 103-96 ,240,33,81,.407,24,59,.407,9,22,.409,28,36,.778,103,40,84,.476,32,63,.508,8,21,.381,8,11,.727,96,2014-11-08,ATL,NYK
64,@,L 103-107 ,240,38,81,.469,29,59,.492,9,22,.409,18,22,.818,103,40,83,.482,37,72,.514,3,11,.273,24,33,.727,107,2014-11-12,DET,WAS
65,@,L 103-114 ,240,35,74,.473,25,53,.472,10,21,.476,23,25,.920,103,42,75,.560,31,47,.660,11,28,.393,19,23,.826,114,2014-11-14,MIA,ATL
66,@,W 103-95 ,240,39,91,.429,32,75,.427,7,16,.438,18,19,.947,103,37,86,.430,29,57,.509,8,29,.276,13,14,.929,95,2014-11-14,CHO,PHO
67,Home,W 103-88 ,240,38,74,.514,34,68,.500,4,6,.667,23,27,.852,103,36,84,.429,31,65,.477,5,19,.263,11,16,.688,88,2014-11-20,SAC,CHI
68,@,W 103-86 ,240,40,85,.471,35,69,.507,5,16,.313,18,19,.947,103,31,81,.383,28,67,.418,3,14,.214,21,34,.618,86,2014-11-26,MIL,MIN
69,Home,L 103-117 ,240,33,74,.446,27,55,.491,6,19,.316,31,35,.886,103,44,87,.506,29,49,.592,15,38,.395,14,16,.875,117,2014-11-29,MIL,HOU
70,Home,L 103-110 ,240,36,85,.424,30,64,.469,6,21,.286,25,31,.806,103,40,89,.449,32,59,.542,8,30,.267,22,30,.733,110,2014-11-29,PHI,DAL
71,Home,L 103-109 ,240,38,89,.427,26,60,.433,12,29,.414,15,25,.600,103,36,83,.434,27,57,.474,9,26,.346,28,35,.800,109,2014-12-01,PHI,SAS
72,@,W 103-101 ,240,41,87,.471,32,61,.525,9,26,.346,12,17,.706,103,36,84,.429,29,66,.439,7,18,.389,22,30,.733,101,2014-12-01,DEN,UTA
73,Home,L 103-105 ,240,41,81,.506,34,61,.557,7,20,.350,14,19,.737,103,43,86,.500,38,64,.594,5,22,.227,14,17,.824,105,2014-12-02,DEN,POR
74,Home,W 103-102 ,240,42,88,.477,38,70,.543,4,18,.222,15,18,.833,103,37,79,.468,27,57,.474,10,22,.455,18,22,.818,102,2014-12-05,CHO,NYK
75,@,W 103-91 ,240,35,71,.493,26,48,.542,9,23,.391,24,31,.774,103,32,84,.381,24,56,.429,8,28,.286,19,30,.633,91,2014-12-05,OKC,PHI
76,Home,W 103-87 ,240,43,73,.589,35,60,.583,8,13,.615,9,11,.818,103,39,80,.488,34,64,.531,5,16,.313,4,8,.500,87,2014-12-07,MEM,MIA
77,@,W 103-99 ,240,36,85,.424,26,57,.456,10,28,.357,21,29,.724,103,41,79,.519,36,60,.600,5,19,.263,12,14,.857,99,2014-12-07,POR,NYK
78,@,W 103-97 ,240,43,80,.538,34,63,.540,9,17,.529,8,12,.667,103,37,77,.481,20,42,.476,17,35,.486,6,9,.667,97,2014-12-09,MIA,PHO
79,@,W 103-96 ,240,42,88,.477,35,64,.547,7,24,.292,12,14,.857,103,35,89,.393,26,62,.419,9,27,.333,17,22,.773,96,2014-12-10,LAC,IND
80,Home,W 103-94 ,240,38,87,.437,31,61,.508,7,26,.269,20,22,.909,103,31,85,.365,22,57,.386,9,28,.321,23,30,.767,94,2014-12-11,OKC,CLE
81,Home,L 103-105 ,240,39,83,.470,29,52,.558,10,31,.323,15,19,.789,103,40,84,.476,36,69,.522,4,15,.267,21,27,.778,105,2014-12-12,PHO,DET
82,Home,W 103-97 ,240,34,75,.453,22,52,.423,12,23,.522,23,30,.767,103,38,82,.463,32,73,.438,6,9,.667,15,19,.789,97,2014-12-18,CHI,NYK
83,Home,L 103-104 ,240,41,85,.482,31,60,.517,10,25,.400,11,15,.733,103,37,86,.430,29,65,.446,8,21,.381,22,29,.759,104,2014-12-19,LAL,OKC
84,@,W 103-97 ,240,32,73,.438,22,47,.468,10,26,.385,29,33,.879,103,37,94,.394,35,81,.432,2,13,.154,21,24,.875,97,2014-12-19,CHI,MEM
85,Home,L 103-105 ,240,40,75,.533,31,56,.554,9,19,.474,14,19,.737,103,39,79,.494,36,65,.554,3,14,.214,24,33,.727,105,2014-12-19,MIA,WAS
86,@,W 103-95 ,240,34,73,.466,27,57,.474,7,16,.438,28,37,.757,103,37,72,.514,31,52,.596,6,20,.300,15,21,.714,95,2014-12-27,MEM,MIA
87,@,W 103-80 ,240,41,91,.451,24,60,.400,17,31,.548,4,9,.444,103,31,82,.378,26,53,.491,5,29,.172,13,17,.765,80,2014-12-28,DET,CLE
88,Home,L 103-104 ,240,40,86,.465,31,57,.544,9,29,.310,14,23,.609,103,35,73,.479,27,55,.491,8,18,.444,26,28,.929,104,2014-12-29,HOU,WAS
89,Home,L 103-111 ,240,39,87,.448,31,61,.508,8,26,.308,17,27,.630,103,40,76,.526,26,51,.510,14,25,.560,17,26,.654,111,2014-12-30,DEN,LAL
90,@,W 103-95 ,240,42,88,.477,38,72,.528,4,16,.250,15,22,.682,103,33,83,.398,23,52,.442,10,31,.323,19,25,.760,95,2015-01-08,CHO,TOR
91,Home,L 103-106 ,240,38,96,.396,25,53,.472,13,43,.302,14,18,.778,103,40,82,.488,30,59,.508,10,23,.435,16,24,.667,106,2015-01-09,DET,ATL
92,@,L 103-107 (OT),265,41,103,.398,31,69,.449,10,34,.294,11,16,.688,103,34,92,.370,25,69,.362,9,23,.391,30,34,.882,107,2015-01-09,BOS,IND
93,Home,W 103-92 ,240,36,76,.474,26,50,.520,10,26,.385,21,26,.808,103,37,92,.402,34,71,.479,3,21,.143,15,20,.750,92,2015-01-10,POR,ORL
94,Home,W 103-84 ,240,42,86,.488,36,69,.522,6,17,.353,13,17,.765,103,33,78,.423,22,46,.478,11,32,.344,7,12,.583,84,2015-01-11,SAC,CLE
95,@,W 103-92 ,240,39,83,.470,36,66,.545,3,17,.176,22,29,.759,103,36,75,.480,26,49,.531,10,26,.385,10,12,.833,92,2015-01-14,MEM,BRK
96,Home,L 103-119 ,240,42,85,.494,37,69,.536,5,16,.313,14,16,.875,103,48,89,.539,35,64,.547,13,25,.520,10,12,.833,119,2015-01-16,BOS,CHI
97,@,W 103-95 ,240,34,76,.447,24,51,.471,10,25,.400,25,33,.758,103,36,85,.424,33,63,.524,3,22,.136,20,22,.909,95,2015-01-19,DAL,MEM
98,@,W 103-100 ,240,37,79,.468,32,59,.542,5,20,.250,24,30,.800,103,39,84,.464,34,66,.515,5,18,.278,17,24,.708,100,2015-01-21,BRK,SAC
99,Home,L 103-105 (OT),265,38,100,.380,31,70,.443,7,30,.233,20,26,.769,103,40,102,.392,34,73,.466,6,29,.207,19,23,.826,105,2015-01-21,WAS,OKC
0,Home,W 103-93 ,240,40,83,.482,30,58,.517,10,25,.400,13,13,1.000,103,36,87,.414,26,61,.426,10,26,.385,11,18,.611,93,2015-01-23,ATL,OKC
1,Home,W 103-96 ,240,35,87,.402,22,56,.393,13,31,.419,20,20,1.000,103,40,82,.488,35,67,.522,5,15,.333,11,14,.786,96,2015-01-24,POR,WAS
2,Home,W 103-94 ,240,36,76,.474,29,58,.500,7,18,.389,24,26,.923,103,37,78,.474,33,66,.500,4,12,.333,16,25,.640,94,2015-01-26,MEM,ORL
3,@,W 103-95 ,240,39,93,.419,30,59,.508,9,34,.265,16,17,.941,103,35,83,.422,27,59,.458,8,24,.333,17,23,.739,95,2015-01-27,CLE,DET
4,Home,W 103-82 ,240,42,79,.532,36,61,.590,6,18,.333,13,18,.722,103,34,81,.420,29,65,.446,5,16,.313,9,13,.692,82,2015-01-29,IND,NYK
5,@,L 103-108 ,240,42,92,.457,35,64,.547,7,28,.250,12,17,.706,103,36,86,.419,23,61,.377,13,25,.520,23,26,.885,108,2015-01-30,LAC,NOP
6,Home,W 103-94 ,240,37,74,.500,29,51,.569,8,23,.348,21,25,.840,103,34,76,.447,29,62,.468,5,14,.357,21,25,.840,94,2015-01-30,PHI,MIN
7,Home,W 103-102 ,240,36,76,.474,29,53,.547,7,23,.304,24,34,.706,103,39,85,.459,33,72,.458,6,13,.462,18,26,.692,102,2015-02-03,POR,UTA
8,@,L 103-110 ,240,42,84,.500,32,63,.508,10,21,.476,9,14,.643,103,44,84,.524,30,52,.577,14,32,.438,8,14,.571,110,2015-02-04,ORL,SAS
9,Home,W 103-99 ,240,37,79,.468,29,58,.500,8,21,.381,21,26,.808,103,40,89,.449,29,54,.537,11,35,.314,8,12,.667,99,2015-02-06,IND,CLE
10,Home,W 103-97 (OT),265,43,83,.518,38,68,.559,5,15,.333,12,14,.857,103,39,97,.402,28,71,.394,11,26,.423,8,13,.615,97,2015-02-06,ORL,LAL
11,@,W 103-102 ,240,37,84,.440,30,65,.462,7,19,.368,22,25,.880,103,36,77,.468,28,63,.444,8,14,.571,22,28,.786,102,2015-02-08,IND,CHO
12,Home,W 103-97 ,240,37,89,.416,30,71,.423,7,18,.389,22,25,.880,103,38,76,.500,29,51,.569,9,25,.360,12,19,.632,97,2015-02-09,MIL,BRK
13,@,L 103-111 ,240,36,84,.429,28,62,.452,8,22,.364,23,30,.767,103,39,80,.488,32,65,.492,7,15,.467,26,32,.813,111,2015-02-11,SAC,MIL
14,Home,L 103-110 ,240,40,93,.430,33,69,.478,7,24,.292,16,20,.800,103,42,95,.442,37,77,.481,5,18,.278,21,26,.808,110,2015-02-21,CHO,OKC
15,Home,W 103-98 ,240,39,82,.476,33,59,.559,6,23,.261,19,26,.731,103,36,78,.462,23,44,.523,13,34,.382,13,17,.765,98,2015-02-22,ORL,PHI
16,Home,W 103-98 ,240,33,75,.440,26,56,.464,7,19,.368,30,38,.789,103,34,81,.420,26,52,.500,8,29,.276,22,28,.786,98,2015-02-28,NYK,TOR
17,@,L 103-105 (OT),265,40,98,.408,28,58,.483,12,40,.300,11,21,.524,103,34,74,.459,23,44,.523,11,30,.367,26,33,.788,105,2015-03-01,CLE,HOU
18,Home,L 103-114 ,240,41,78,.526,33,58,.569,8,20,.400,13,19,.684,103,41,80,.513,30,53,.566,11,27,.407,21,24,.875,114,2015-03-02,PHI,TOR
19,@,L 103-104 ,240,39,86,.453,33,69,.478,6,17,.353,19,21,.905,103,39,79,.494,34,66,.515,5,13,.385,21,31,.677,104,2015-03-03,LAL,CHO
20,Home,W 103-94 ,240,40,85,.471,35,65,.538,5,20,.250,18,20,.900,103,37,91,.407,30,69,.435,7,22,.318,13,15,.867,94,2015-03-06,CHO,TOR
21,Home,W 103-93 ,240,38,91,.418,32,63,.508,6,28,.214,21,25,.840,103,37,102,.363,31,73,.425,6,29,.207,13,17,.765,93,2015-03-06,HOU,DET
22,Home,W 103-98 ,240,38,87,.437,31,65,.477,7,22,.318,20,30,.667,103,35,89,.393,20,55,.364,15,34,.441,13,16,.813,98,2015-03-08,ORL,BOS
23,Home,L 103-114 ,240,37,71,.521,33,56,.589,4,15,.267,25,31,.806,103,44,75,.587,35,60,.583,9,15,.600,17,21,.810,114,2015-03-09,MIL,NOP
24,@,L 103-109 (OT),265,35,91,.385,31,77,.403,4,14,.286,29,36,.806,103,39,79,.494,30,57,.526,9,22,.409,22,28,.786,109,2015-03-12,MIL,IND
25,@,L 103-114 ,240,39,92,.424,31,73,.425,8,19,.421,17,22,.773,103,41,82,.500,33,65,.508,8,17,.471,24,37,.649,114,2015-03-13,GSW,DEN
26,Home,L 103-110 ,240,38,81,.469,31,61,.508,7,20,.350,20,25,.800,103,38,84,.452,26,53,.491,12,31,.387,22,30,.733,110,2015-03-16,SAC,ATL
27,Home,W 103-86 ,240,34,82,.415,24,58,.414,10,24,.417,25,28,.893,103,32,81,.395,26,62,.419,6,19,.316,16,21,.762,86,2015-03-18,CHI,IND
28,Home,L 103-114 ,240,39,80,.488,32,66,.485,7,14,.500,18,24,.750,103,38,76,.500,30,56,.536,8,20,.400,30,38,.789,114,2015-03-18,MIL,SAS
29,@,W 103-82 ,240,41,79,.519,34,67,.507,7,12,.583,14,19,.737,103,32,76,.421,28,58,.483,4,18,.222,14,17,.824,82,2015-03-23,MEM,NYK
30,Home,L 103-116 ,240,39,83,.470,30,62,.484,9,21,.429,16,19,.842,103,45,74,.608,33,51,.647,12,23,.522,14,17,.824,116,2015-03-25,TOR,CHI
31,@,W 103-101 ,240,38,85,.447,29,59,.492,9,26,.346,18,28,.643,103,33,75,.440,28,61,.459,5,14,.357,30,38,.789,101,2015-03-25,IND,WAS
32,Home,W 103-89 ,240,42,83,.506,38,66,.576,4,17,.235,15,18,.833,103,36,82,.439,30,68,.441,6,14,.429,11,12,.917,89,2015-03-29,SAS,MEM
33,@,W 103-91 ,240,35,86,.407,22,57,.386,13,29,.448,20,23,.870,103,39,93,.419,34,76,.447,5,17,.294,8,9,.889,91,2015-04-01,SAS,ORL
34,Home,W 103-100 ,240,36,83,.434,27,64,.422,9,19,.474,22,30,.733,103,42,95,.442,33,73,.452,9,22,.409,7,10,.700,100,2015-04-07,NOP,GSW
35,Home,L 103-113 ,240,45,84,.536,38,66,.576,7,18,.389,6,10,.600,103,36,80,.450,28,52,.538,8,28,.286,33,34,.971,113,2015-04-08,DET,BOS
36,@,L 103-105 ,240,34,79,.430,22,53,.415,12,26,.462,23,31,.742,103,38,82,.463,30,59,.508,8,23,.348,21,24,.875,105,2015-04-08,CHI,ORL
37,Home,W 103-91 ,240,36,74,.486,23,43,.535,13,31,.419,18,25,.720,103,33,75,.440,26,59,.441,7,16,.438,18,28,.643,91,2015-04-08,UTA,SAC
38,Home,L 103-107 ,240,40,89,.449,29,66,.439,11,23,.478,12,23,.522,103,38,79,.481,27,60,.450,11,19,.579,20,22,.909,107,2015-04-10,DET,IND
39,Home,L 103-104 ,240,31,66,.470,22,45,.489,9,21,.429,32,53,.604,103,41,85,.482,37,68,.544,4,17,.235,18,24,.750,104,2015-04-10,HOU,SAS
40,@,L 103-116 ,240,37,81,.457,28,57,.491,9,24,.375,20,28,.714,103,44,97,.454,34,66,.515,10,31,.323,18,24,.750,116,2015-04-10,SAC,OKC
41,@,L 103-110 ,240,38,101,.376,26,68,.382,12,33,.364,15,22,.682,103,37,82,.451,30,61,.492,7,21,.333,29,37,.784,110,2015-04-13,DEN,LAC
42,@,L 103-108 ,240,45,79,.570,42,69,.609,3,10,.300,10,13,.769,103,43,83,.518,38,73,.521,5,10,.500,17,25,.680,108,2015-04-15,SAS,NOP
43,Home,L 103-112 ,240,37,78,.474,25,48,.521,12,30,.400,17,24,.708,103,41,82,.500,34,66,.515,7,16,.438,23,29,.793,112,2015-10-29,IND,MEM
44,Home,L 103-113 ,240,32,85,.376,25,59,.424,7,26,.269,32,41,.780,103,36,82,.439,25,56,.446,11,26,.423,30,35,.857,113,2015-10-30,BOS,TOR
45,@,W 103-93 ,240,40,87,.460,29,57,.509,11,30,.367,12,16,.750,103,31,85,.365,21,51,.412,10,34,.294,21,28,.750,93,2015-11-01,DAL,LAL
46,@,W 103-96 ,240,38,73,.521,29,50,.580,9,23,.391,18,26,.692,103,36,79,.456,30,60,.500,6,19,.316,18,22,.818,96,2015-11-02,MIL,BRK
47,@,W 103-94 ,240,42,90,.467,35,72,.486,7,18,.389,12,12,1.000,103,32,90,.356,20,54,.370,12,36,.333,18,25,.720,94,2015-11-03,ORL,NOP
48,@,W 103-89 ,240,40,83,.482,37,63,.587,3,20,.150,20,25,.800,103,29,74,.392,22,54,.407,7,20,.350,24,40,.600,89,2015-11-03,MEM,SAC
49,@,W 103-98 ,240,33,79,.418,28,65,.431,5,14,.357,32,39,.821,103,39,82,.476,31,59,.525,8,23,.348,12,14,.857,98,2015-11-04,TOR,OKC
50,@,W 103-94 ,240,38,92,.413,30,53,.566,8,39,.205,19,22,.864,103,38,87,.437,32,68,.471,6,19,.316,12,16,.750,94,2015-11-07,GSW,SAC
51,@,L 103-124 ,240,38,84,.452,31,68,.456,7,16,.438,20,26,.769,103,49,94,.521,45,74,.608,4,20,.200,22,30,.733,124,2015-11-08,PHO,OKC
52,Home,L 103-120 ,240,41,76,.539,32,51,.627,9,25,.360,12,18,.667,103,47,96,.490,36,66,.545,11,30,.367,15,22,.682,120,2015-11-08,POR,DET
53,Home,W 103-102 ,240,39,79,.494,31,55,.564,8,24,.333,17,24,.708,103,42,79,.532,32,57,.561,10,22,.455,8,9,.889,102,2015-11-11,DEN,MIL
54,Home,L 103-119 ,240,40,87,.460,28,58,.483,12,29,.414,11,17,.647,103,43,89,.483,38,71,.535,5,18,.278,28,31,.903,119,2015-11-11,PHI,TOR
55,@,L 103-107 ,240,42,83,.506,35,63,.556,7,20,.350,12,13,.923,103,41,86,.477,31,61,.508,10,25,.400,15,23,.652,107,2015-11-13,MIN,IND
56,@,W 103-91 ,240,36,97,.371,32,76,.421,4,21,.190,27,35,.771,103,36,79,.456,31,55,.564,5,24,.208,14,30,.467,91,2015-11-17,MIN,MIA
57,Home,W 103-97 ,240,38,89,.427,29,59,.492,9,30,.300,18,24,.750,103,38,86,.442,33,70,.471,5,16,.313,16,18,.889,97,2015-11-18,ATL,SAC
58,@,L 103-108 (OT),265,35,88,.398,26,58,.448,9,30,.300,24,29,.828,103,32,92,.348,18,48,.375,14,44,.318,30,35,.857,108,2015-11-18,POR,HOU
59,@,L 103-110 ,240,43,95,.453,35,63,.556,8,32,.250,9,9,1.000,103,38,85,.447,31,68,.456,7,17,.412,27,40,.675,110,2015-11-18,NOP,OKC
60,@,W 103-97 ,240,41,83,.494,32,64,.500,9,19,.474,12,14,.857,103,37,91,.407,29,64,.453,8,27,.296,15,21,.714,97,2015-11-18,CHI,PHO
61,@,L 103-117 ,240,40,81,.494,30,59,.508,10,22,.455,13,21,.619,103,43,81,.531,25,46,.543,18,35,.514,13,22,.591,117,2015-11-23,ORL,CLE
62,Home,W 103-99 ,240,40,79,.506,29,54,.537,11,25,.440,12,22,.545,103,36,82,.439,22,53,.415,14,29,.483,13,16,.813,99,2015-11-25,TOR,CLE
63,Home,W 103-87 ,240,37,79,.468,30,55,.545,7,24,.292,22,26,.846,103,31,90,.344,22,61,.361,9,29,.310,16,20,.800,87,2015-11-27,OKC,DET
64,Home,L 103-107 ,240,38,99,.384,27,66,.409,11,33,.333,16,22,.727,103,34,83,.410,25,56,.446,9,27,.333,30,37,.811,107,2015-11-29,LAL,IND
65,Home,L 103-106 ,240,40,89,.449,34,70,.486,6,19,.316,17,22,.773,103,40,82,.488,26,53,.491,14,29,.483,12,15,.800,106,2015-11-30,UTA,GSW
66,Home,W 103-91 ,240,37,79,.468,23,47,.489,14,32,.438,15,23,.652,103,33,89,.371,25,55,.455,8,34,.235,17,24,.708,91,2015-12-01,PHI,LAL
67,@,W 103-91 ,240,32,76,.421,25,56,.446,7,20,.350,32,39,.821,103,30,79,.380,24,52,.462,6,27,.222,25,39,.641,91,2015-12-02,IND,LAC
68,@,W 103-83 ,240,40,80,.500,30,62,.484,10,18,.556,13,18,.722,103,30,80,.375,28,64,.438,2,16,.125,21,25,.840,83,2015-12-03,SAS,MEM
69,@,W 103-94 ,240,40,89,.449,32,66,.485,8,23,.348,15,15,1.000,103,31,72,.431,17,39,.436,14,33,.424,18,24,.750,94,2015-12-03,ORL,UTA
70,Home,W 103-101 ,240,37,82,.451,25,51,.490,12,31,.387,17,25,.680,103,40,90,.444,34,70,.486,6,20,.300,15,18,.833,101,2015-12-05,LAC,ORL
71,Home,L 103-109 ,240,38,83,.458,33,68,.485,5,15,.333,22,26,.846,103,39,77,.506,29,57,.509,10,20,.500,21,30,.700,109,2015-12-05,MIN,POR
72,@,W 103-101 ,240,41,92,.446,34,75,.453,7,17,.412,14,17,.824,103,41,90,.456,35,69,.507,6,21,.286,13,18,.722,101,2015-12-07,PHO,CHI
73,Home,L 103-114 ,240,41,69,.594,36,53,.679,5,16,.313,16,22,.727,103,46,92,.500,37,74,.500,9,18,.500,13,17,.765,114,2015-12-07,MIA,WAS
74,Home,L 103-109 ,240,39,89,.438,34,64,.531,5,25,.200,20,24,.833,103,40,83,.482,28,50,.560,12,33,.364,17,25,.680,109,2015-12-09,WAS,HOU
75,@,W 103-78 ,240,36,74,.486,26,54,.481,10,20,.500,21,22,.955,103,30,80,.375,25,56,.446,5,24,.208,13,16,.813,78,2015-12-12,SAS,ATL
76,Home,L 103-105 (OT),265,37,89,.416,31,70,.443,6,19,.316,23,31,.742,103,44,97,.454,38,78,.487,6,19,.316,11,15,.733,105,2015-12-14,DET,LAC
77,@,L 103-128 ,240,41,91,.451,36,69,.522,5,22,.227,16,18,.889,103,46,88,.523,31,56,.554,15,32,.469,21,27,.778,128,2015-12-16,PHO,GSW
78,Home,W 103-90 ,240,36,75,.480,25,54,.463,11,21,.524,20,24,.833,103,38,88,.432,33,72,.458,5,16,.313,9,11,.818,90,2015-12-16,LAC,MIL
79,@,W 103-100 ,240,39,78,.500,28,56,.500,11,22,.500,14,20,.700,103,38,81,.469,34,69,.493,4,12,.333,20,24,.833,100,2015-12-20,ATL,ORL
80,Home,W 103-99 ,240,35,74,.473,23,48,.479,12,26,.462,21,27,.778,103,40,92,.435,29,63,.460,11,29,.379,8,11,.727,99,2015-12-22,TOR,DAL
81,Home,W 103-85 ,240,39,83,.470,30,60,.500,9,23,.391,16,16,1.000,103,33,80,.413,26,60,.433,7,20,.350,12,14,.857,85,2015-12-23,GSW,UTA
82,Home,W 103-93 ,240,38,84,.452,28,62,.452,10,22,.455,17,26,.654,103,38,79,.481,34,65,.523,4,14,.286,13,15,.867,93,2015-12-28,DAL,MIL
83,@,L 103-122 ,240,37,95,.389,24,64,.375,13,31,.419,16,28,.571,103,43,89,.483,23,47,.489,20,42,.476,16,24,.667,122,2015-12-28,SAC,GSW
84,@,L 103-110 ,240,37,87,.425,25,60,.417,12,27,.444,17,19,.895,103,41,87,.471,29,55,.527,12,32,.375,16,20,.800,110,2015-12-30,DEN,POR
85,Home,W 103-91 ,240,43,92,.467,35,66,.530,8,26,.308,9,10,.900,103,40,85,.471,35,65,.538,5,20,.250,6,8,.750,91,2016-01-01,WAS,ORL
86,@,L 103-121 ,240,37,74,.500,28,52,.538,9,22,.409,20,33,.606,103,45,86,.523,32,62,.516,13,24,.542,18,19,.947,121,2016-01-02,HOU,SAS
87,@,W 103-94 ,240,41,92,.446,35,71,.493,6,21,.286,15,19,.789,103,32,85,.376,26,57,.456,6,28,.214,24,27,.889,94,2016-01-04,BOS,BRK
88,Home,W 103-100 (OT),265,34,90,.378,29,68,.426,5,22,.227,30,39,.769,103,37,94,.394,29,66,.439,8,28,.286,18,25,.720,100,2016-01-04,MIA,IND
89,Home,W 103-94 ,240,39,75,.520,32,52,.615,7,23,.304,18,26,.692,103,38,78,.487,31,50,.620,7,28,.250,11,17,.647,94,2016-01-07,HOU,UTA
90,@,W 103-95 ,240,36,73,.493,29,55,.527,7,18,.389,24,30,.800,103,40,92,.435,34,68,.500,6,24,.250,9,13,.692,95,2016-01-08,MIA,PHO
91,Home,W 103-89 ,240,43,92,.467,35,65,.538,8,27,.296,9,14,.643,103,38,82,.463,33,73,.452,5,9,.556,8,10,.800,89,2016-01-09,DET,BRK
92,@,L 103-107 (OT),265,43,90,.478,34,59,.576,9,31,.290,8,10,.800,103,39,89,.438,25,51,.490,14,38,.368,15,23,.652,107,2016-01-10,IND,HOU
93,@,L 103-111 ,240,41,91,.451,34,72,.472,7,19,.368,14,16,.875,103,41,86,.477,34,63,.540,7,23,.304,22,30,.733,111,2016-01-11,MIA,GSW
94,Home,W 103-94 ,240,40,90,.444,31,64,.484,9,26,.346,14,20,.700,103,37,91,.407,32,61,.525,5,30,.167,15,20,.750,94,2016-01-13,BOS,IND
95,Home,W 103-101 ,240,37,76,.487,28,60,.467,9,16,.563,20,25,.800,103,37,72,.514,22,40,.550,15,32,.469,12,17,.706,101,2016-01-14,MEM,DET
96,Home,L 103-106 (OT),265,44,97,.454,35,74,.473,9,23,.391,6,8,.750,103,37,90,.411,29,66,.439,8,24,.333,24,31,.774,106,2016-01-14,ORL,TOR
97,@,W 103-101 ,240,34,74,.459,29,63,.460,5,11,.455,30,42,.714,103,35,83,.422,29,49,.592,6,34,.176,25,34,.735,101,2016-01-14,SAC,UTA
98,@,L 103-117 ,240,35,89,.393,25,62,.403,10,27,.370,23,28,.821,103,42,96,.438,28,66,.424,14,30,.467,19,29,.655,117,2016-01-15,PHO,BOS
99,Home,L 103-110 ,240,38,96,.396,25,57,.439,13,39,.333,14,19,.737,103,36,76,.474,23,51,.451,13,25,.520,25,33,.758,110,2016-01-16,LAC,SAC
0,Home,W 103-95 ,240,39,82,.476,34,72,.472,5,10,.500,20,26,.769,103,35,77,.455,30,57,.526,5,20,.250,20,24,.833,95,2016-01-16,MEM,NYK
1,@,L 103-121 ,240,34,69,.493,27,52,.519,7,17,.412,28,32,.875,103,47,93,.505,37,62,.597,10,31,.323,17,22,.773,121,2016-01-23,LAL,POR
2,@,L 103-113 ,240,39,83,.470,33,64,.516,6,19,.316,19,28,.679,103,39,81,.481,28,53,.528,11,28,.393,24,36,.667,113,2016-01-26,PHO,PHI
3,@,L 103-111 ,240,36,84,.429,29,63,.460,7,21,.333,24,32,.750,103,41,96,.427,32,68,.471,9,28,.321,20,24,.833,111,2016-01-27,DEN,BOS
4,Home,W 103-83 ,240,38,80,.475,28,52,.538,10,28,.357,17,20,.850,103,29,79,.367,28,63,.444,1,16,.063,24,27,.889,83,2016-01-28,MEM,MIL
5,Home,W 103-93 ,240,37,85,.435,29,65,.446,8,20,.400,21,29,.724,103,38,87,.437,31,69,.449,7,18,.389,10,20,.500,93,2016-01-28,TOR,NYK
6,Home,L 103-107 ,240,38,80,.475,36,68,.529,2,12,.167,25,28,.893,103,37,74,.500,30,56,.536,7,18,.389,26,32,.813,107,2016-01-29,MIL,MIA
7,Home,W 103-90 ,240,40,76,.526,30,51,.588,10,25,.400,13,16,.813,103,35,75,.467,33,65,.508,2,10,.200,18,26,.692,90,2016-01-29,UTA,MIN
8,@,L 103-117 ,240,40,81,.494,34,63,.540,6,18,.333,17,21,.810,103,45,82,.549,36,59,.610,9,23,.391,18,21,.857,117,2016-01-30,SAS,CLE
9,@,L 103-105 ,240,40,84,.476,31,64,.484,9,20,.450,14,23,.609,103,43,93,.462,32,66,.485,11,27,.407,8,10,.800,105,2016-01-30,BRK,NOP
10,Home,L 103-110 ,240,38,81,.469,28,56,.500,10,25,.400,17,23,.739,103,40,85,.471,28,66,.424,12,19,.632,18,25,.720,110,2016-02-04,POR,TOR
11,Home,L 103-104 ,240,37,87,.425,29,57,.509,8,30,.267,21,35,.600,103,38,88,.432,31,68,.456,7,20,.350,21,25,.840,104,2016-02-05,CLE,BOS
12,Home,W 103-98 ,240,38,81,.469,28,52,.538,10,29,.345,17,22,.773,103,35,76,.461,30,61,.492,5,15,.333,23,26,.885,98,2016-02-06,PHI,BRK
13,@,W 103-89 ,240,39,70,.557,28,50,.560,11,20,.550,14,17,.824,103,36,80,.450,28,52,.538,8,28,.286,9,17,.529,89,2016-02-08,TOR,DET
14,@,W 103-92 ,240,39,83,.470,33,64,.516,6,19,.316,19,24,.792,103,38,88,.432,28,61,.459,10,27,.370,6,7,.857,92,2016-02-10,DEN,DET
15,@,L 103-116 ,240,37,77,.481,26,43,.605,11,34,.324,18,34,.529,103,41,89,.461,33,61,.541,8,28,.286,26,34,.765,116,2016-02-10,HOU,POR
16,Home,W 103-89 ,240,42,86,.488,35,68,.515,7,18,.389,12,21,.571,103,31,77,.403,27,62,.435,4,15,.267,23,29,.793,89,2016-02-18,WAS,UTA
17,@,W 103-95 ,240,42,83,.506,37,66,.561,5,17,.294,14,16,.875,103,36,84,.429,31,72,.431,5,12,.417,18,25,.720,95,2016-02-20,NYK,MIN
18,@,L 103-129 ,240,37,77,.481,25,49,.510,12,28,.429,17,27,.630,103,41,85,.482,28,51,.549,13,34,.382,34,36,.944,129,2016-02-21,PHI,DAL
19,@,L 103-114 ,240,37,76,.487,27,47,.574,10,29,.345,19,27,.704,103,45,91,.495,32,59,.542,13,32,.406,11,17,.647,114,2016-02-24,CHO,CLE
20,Home,L 103-116 ,240,35,86,.407,26,58,.448,9,28,.321,24,30,.800,103,43,89,.483,31,56,.554,12,33,.364,18,22,.818,116,2016-02-24,DAL,OKC
21,Home,W 103-88 ,240,37,89,.416,30,55,.545,7,34,.206,22,24,.917,103,32,88,.364,27,68,.397,5,20,.250,19,22,.864,88,2016-02-26,ATL,CHI
22,@,W 103-94 ,240,40,94,.426,33,71,.465,7,23,.304,16,17,.941,103,35,82,.427,27,57,.474,8,25,.320,16,21,.762,94,2016-02-26,WAS,PHI
23,@,W 103-95 ,240,38,87,.437,33,66,.500,5,21,.238,22,27,.815,103,39,94,.415,32,72,.444,7,22,.318,10,12,.833,95,2016-02-27,POR,CHI
24,@,W 103-96 ,240,36,75,.480,33,55,.600,3,20,.150,28,36,.778,103,40,75,.533,32,50,.640,8,25,.320,8,10,.800,96,2016-02-29,MEM,DEN
25,Home,W 103-98 ,240,40,98,.408,31,66,.470,9,32,.281,14,21,.667,103,39,98,.398,29,63,.460,10,35,.286,10,11,.909,98,2016-03-02,LAC,OKC
26,@,L 103-120 ,240,37,80,.463,27,57,.474,10,23,.435,19,27,.704,103,42,82,.512,32,52,.615,10,30,.333,26,34,.765,120,2016-03-05,BOS,CLE
27,@,L 103-123 ,240,35,78,.449,24,47,.511,11,31,.355,22,23,.957,103,44,84,.524,32,62,.516,12,22,.545,23,28,.821,123,2016-03-06,POR,DET
28,Home,W 103-98 ,240,36,81,.444,28,67,.418,8,14,.571,23,30,.767,103,37,85,.435,26,54,.481,11,31,.355,13,22,.591,98,2016-03-06,MIA,PHI
29,@,L 103-108 ,240,39,80,.488,35,65,.538,4,15,.267,21,24,.875,103,41,90,.456,29,60,.483,12,30,.400,14,17,.824,108,2016-03-07,MIN,CHO
30,Home,L 103-106 ,240,36,80,.450,29,51,.569,7,29,.241,24,29,.828,103,41,86,.477,35,66,.530,6,20,.300,18,22,.818,106,2016-03-07,CLE,MEM
31,@,L 103-118 ,240,36,76,.474,27,46,.587,9,30,.300,22,27,.815,103,42,83,.506,32,58,.552,10,25,.400,24,29,.828,118,2016-03-11,DET,CHO
32,Home,W 103-92 ,240,40,81,.494,36,68,.529,4,13,.308,19,24,.792,103,35,89,.393,29,60,.483,6,29,.207,16,21,.762,92,2016-03-12,MIL,NOP
33,Home,W 103-98 ,240,39,84,.464,34,72,.472,5,12,.417,20,28,.714,103,36,94,.383,28,63,.444,8,31,.258,18,22,.818,98,2016-03-15,IND,BOS
34,Home,W 103-69 ,240,43,88,.489,32,63,.508,11,25,.440,6,9,.667,103,28,82,.341,22,56,.393,6,26,.231,7,14,.500,69,2016-03-17,UTA,PHO
35,Home,L 103-109 ,240,37,82,.451,26,60,.433,11,22,.500,18,22,.818,103,38,76,.500,25,48,.521,13,28,.464,20,27,.741,109,2016-03-18,ORL,CLE
36,@,L 103-115 ,240,42,80,.525,37,66,.561,5,14,.357,14,21,.667,103,46,94,.489,36,70,.514,10,24,.417,13,21,.619,115,2016-03-19,BRK,DET
37,@,W 103-97 ,240,39,90,.433,31,70,.443,8,20,.400,17,19,.895,103,30,76,.395,19,48,.396,11,28,.393,26,34,.765,97,2016-03-21,MEM,PHO
38,@,L 103-104 ,240,37,94,.394,22,57,.386,15,37,.405,14,15,.933,103,33,76,.434,27,59,.458,6,17,.353,32,40,.800,104,2016-03-23,PHI,DEN
39,@,L 103-109 ,240,42,96,.438,33,66,.500,9,30,.300,10,11,.909,103,40,89,.449,33,62,.532,7,27,.259,22,25,.880,109,2016-03-23,DAL,POR
40,@,W 103-96 (OT),265,39,89,.438,27,54,.500,12,35,.343,13,18,.722,103,37,92,.402,28,60,.467,9,32,.281,13,29,.448,96,2016-03-30,GSW,UTA
41,@,W 103-100 ,240,37,77,.481,26,53,.491,11,24,.458,18,22,.818,103,36,90,.400,27,65,.415,9,25,.360,19,22,.864,100,2016-03-31,CHI,HOU
42,@,L 103-112 ,240,34,76,.447,25,50,.500,9,26,.346,26,27,.963,103,45,83,.542,29,54,.537,16,29,.552,6,13,.462,112,2016-04-03,CHO,CLE
43,Home,W 103-90 ,240,39,95,.411,28,61,.459,11,34,.324,14,19,.737,103,30,81,.370,18,50,.360,12,31,.387,18,30,.600,90,2016-04-05,ATL,PHO
44,Home,W 103-81 ,240,40,78,.513,33,58,.569,7,20,.350,16,26,.615,103,26,83,.313,20,63,.317,6,20,.300,23,25,.920,81,2016-04-05,LAC,LAL
45,@,L 103-121 ,240,39,92,.424,32,75,.427,7,17,.412,18,24,.750,103,48,95,.505,40,67,.597,8,28,.286,17,20,.850,121,2016-04-06,BRK,WAS
46,Home,W 103-93 ,240,30,60,.500,18,29,.621,12,31,.387,31,39,.795,103,35,87,.402,28,65,.431,7,22,.318,16,22,.727,93,2016-04-08,DAL,MEM
47,@,W 103-96 ,240,41,93,.441,28,56,.500,13,37,.351,8,15,.533,103,39,89,.438,29,63,.460,10,26,.385,8,12,.667,96,2016-04-13,TOR,BRK
48,@,L 103-117 ,240,42,91,.462,34,64,.531,8,27,.296,11,18,.611,103,47,86,.547,36,57,.632,11,29,.379,12,19,.632,117,2016-04-13,ORL,CHO
49,@,W 103-97 ,240,39,94,.415,33,72,.458,6,22,.273,19,26,.731,103,36,84,.429,29,60,.483,7,24,.292,18,25,.720,97,2016-10-26,OKC,PHI
50,Home,W 103-94 ,240,38,87,.437,28,54,.519,10,33,.303,17,20,.850,103,37,98,.378,30,74,.405,7,24,.292,13,20,.650,94,2016-10-28,BRK,IND
51,@,L 103-106 ,240,37,70,.529,30,48,.625,7,22,.318,22,31,.710,103,39,85,.459,30,59,.508,9,26,.346,19,25,.760,106,2016-10-29,MIN,SAC
52,@,L 103-112 (OT),265,38,86,.442,33,61,.541,5,25,.200,22,25,.880,103,39,88,.443,24,57,.421,15,31,.484,19,26,.731,112,2016-10-30,WAS,MEM
53,@,W 103-101 ,240,42,93,.452,36,68,.529,6,25,.240,13,17,.765,103,40,81,.494,31,61,.508,9,20,.450,12,16,.750,101,2016-11-01,ORL,PHI
54,Home,L 103-113 ,240,42,72,.583,39,62,.629,3,10,.300,16,24,.667,103,43,77,.558,33,52,.635,10,25,.400,17,25,.680,113,2016-11-02,WAS,TOR
55,Home,W 103-86 ,240,40,84,.476,33,64,.516,7,20,.350,16,22,.727,103,31,94,.330,24,69,.348,7,25,.280,17,20,.850,86,2016-11-05,DET,DEN
56,Home,W 103-93 ,240,43,86,.500,33,58,.569,10,28,.357,7,11,.636,103,35,86,.407,24,56,.429,11,30,.367,12,20,.600,93,2016-11-16,IND,CLE
57,@,L 103-105 ,240,40,92,.435,26,52,.500,14,40,.350,9,14,.643,103,40,84,.476,28,59,.475,12,25,.480,13,14,.929,105,2016-11-16,HOU,OKC
58,@,L 103-107 ,240,38,86,.442,32,64,.500,6,22,.273,21,26,.808,103,45,96,.469,36,67,.537,9,29,.310,8,8,1.000,107,2016-11-22,POR,NYK
59,Home,L 103-109 ,240,42,91,.462,30,57,.526,12,34,.353,7,9,.778,103,38,81,.469,27,57,.474,11,24,.458,22,25,.880,109,2016-11-25,BOS,SAS
60,Home,L 103-112 ,240,36,81,.444,29,62,.468,7,19,.368,24,25,.960,103,40,79,.506,36,61,.590,4,18,.222,28,34,.824,112,2016-11-28,MIN,UTA
61,Home,L 103-112 ,240,36,91,.396,30,72,.417,6,19,.316,25,28,.893,103,46,92,.500,38,70,.543,8,22,.364,12,18,.667,112,2016-11-28,NYK,OKC
62,Home,W 103-100 ,240,41,88,.466,31,58,.534,10,30,.333,11,15,.733,103,35,81,.432,28,60,.467,7,21,.333,23,29,.793,100,2016-12-03,MEM,LAL
63,@,L 103-112 ,240,34,91,.374,23,50,.460,11,41,.268,24,33,.727,103,40,85,.471,34,61,.557,6,24,.250,26,36,.722,112,2016-12-03,BRK,MIL
64,Home,L 103-114 ,240,38,89,.427,27,64,.422,11,25,.440,16,27,.593,103,48,98,.490,41,73,.562,7,25,.280,11,16,.688,114,2016-12-06,MIA,NYK
65,Home,W 103-95 ,240,43,88,.489,39,69,.565,4,19,.211,13,15,.867,103,34,80,.425,23,53,.434,11,27,.407,16,20,.800,95,2016-12-07,ATL,MIA
66,@,L 103-111 ,240,32,69,.464,18,44,.409,14,25,.560,25,26,.962,103,39,80,.488,24,48,.500,15,32,.469,18,24,.750,111,2016-12-09,IND,DAL
67,@,W 103-100 ,240,36,84,.429,26,55,.473,10,29,.345,21,25,.840,103,35,87,.402,28,59,.475,7,28,.250,23,27,.852,100,2016-12-09,NYK,SAC
68,Home,W 103-86 ,240,37,81,.457,25,50,.500,12,31,.387,17,23,.739,103,35,86,.407,31,64,.484,4,22,.182,12,15,.800,86,2016-12-13,CLE,MEM
69,Home,W 103-90 ,240,45,96,.469,36,64,.563,9,32,.281,4,8,.500,103,38,93,.409,33,72,.458,5,21,.238,9,19,.474,90,2016-12-15,GSW,NYK
70,Home,W 103-100 ,240,37,65,.569,29,43,.674,8,22,.364,21,27,.778,103,35,77,.455,23,49,.469,12,28,.429,18,21,.857,100,2016-12-16,UTA,DAL
71,Home,W 103-91 ,240,37,84,.440,32,66,.485,5,18,.278,24,28,.857,103,38,96,.396,31,74,.419,7,22,.318,8,10,.800,91,2016-12-23,CHO,CHI
72,@,L 103-113 ,240,37,88,.420,28,58,.483,9,30,.300,20,29,.690,103,41,85,.482,29,54,.537,12,31,.387,19,21,.905,113,2016-12-27,MEM,BOS
73,@,L 103-105 ,240,42,94,.447,35,69,.507,7,25,.280,12,17,.706,103,42,81,.519,32,53,.604,10,28,.357,11,14,.786,105,2016-12-28,MIN,DEN
74,Home,L 103-115 ,240,39,83,.470,31,62,.500,8,21,.381,17,24,.708,103,45,91,.495,30,60,.500,15,31,.484,10,14,.714,115,2017-01-02,NYK,ORL
75,Home,W 103-95 ,240,36,81,.444,28,55,.509,8,26,.308,23,29,.793,103,38,92,.413,31,68,.456,7,24,.292,12,21,.571,95,2017-01-11,OKC,MEM
76,@,W 103-101 ,240,36,83,.434,19,39,.487,17,44,.386,14,19,.737,103,36,84,.429,25,54,.463,11,30,.367,18,21,.857,101,2017-01-13,BOS,ATL
77,@,L 103-109 ,240,36,90,.400,27,51,.529,9,39,.231,22,28,.786,103,42,90,.467,33,61,.541,9,29,.310,16,24,.667,109,2017-01-17,HOU,MIA
78,@,L 103-118 ,240,37,85,.435,33,66,.500,4,19,.211,25,31,.806,103,43,85,.506,24,43,.558,19,42,.452,13,19,.684,118,2017-01-19,PHO,CLE
79,Home,L 103-115 ,240,33,83,.398,26,56,.464,7,27,.259,30,35,.857,103,40,79,.506,31,57,.544,9,22,.409,26,28,.929,115,2017-01-22,TOR,PHO
80,Home,L 103-109 ,240,38,86,.442,31,60,.517,7,26,.269,20,25,.800,103,35,76,.461,27,54,.500,8,22,.364,31,35,.886,109,2017-01-23,IND,NYK
81,Home,W 103-93 ,240,35,76,.461,25,50,.500,10,26,.385,23,31,.742,103,35,85,.412,28,63,.444,7,22,.318,16,21,.762,93,2017-01-24,DEN,UTA
82,Home,L 103-113 ,240,38,92,.413,31,69,.449,7,23,.304,20,21,.952,103,39,82,.476,28,54,.519,11,28,.393,24,27,.889,113,2017-01-25,CHO,GSW
83,Home,W 103-95 ,240,39,83,.470,33,57,.579,6,26,.231,19,24,.792,103,39,92,.424,32,69,.464,7,23,.304,10,12,.833,95,2017-01-25,DAL,NYK
84,Home,L 103-109 ,240,36,81,.444,26,54,.481,10,27,.370,21,27,.778,103,42,81,.519,32,63,.508,10,18,.556,15,17,.882,109,2017-01-26,MIN,IND
85,@,L 103-119 ,240,33,85,.388,21,57,.368,12,28,.429,25,29,.862,103,48,93,.516,35,63,.556,13,30,.433,10,14,.714,119,2017-01-27,SAS,NOP
86,@,L 103-116 ,240,46,89,.517,42,77,.545,4,12,.333,7,12,.583,103,42,80,.525,28,52,.538,14,28,.500,18,23,.783,116,2017-01-28,DET,MIA
87,Home,L 103-105 ,240,38,85,.447,28,58,.483,10,27,.370,17,22,.773,103,32,77,.416,20,48,.417,12,29,.414,29,35,.829,105,2017-02-03,SAC,PHO
88,@,W 103-95 ,240,40,87,.460,35,68,.515,5,19,.263,18,20,.900,103,32,76,.421,19,42,.452,13,34,.382,18,21,.857,95,2017-02-05,TOR,BRK
89,Home,L 103-111 ,240,34,84,.405,21,50,.420,13,34,.382,22,29,.759,103,39,74,.527,28,52,.538,11,22,.500,22,25,.880,111,2017-02-08,PHI,SAS
90,@,W 103-92 ,240,41,82,.500,32,63,.508,9,19,.474,12,15,.800,103,39,92,.424,34,75,.453,5,17,.294,9,13,.692,92,2017-02-10,SAS,DET
91,Home,L 103-112 ,240,38,82,.463,26,45,.578,12,37,.324,15,18,.833,103,39,77,.506,30,55,.545,9,22,.409,25,27,.926,112,2017-02-13,BRK,MEM
92,@,L 103-104 ,240,36,77,.468,22,40,.550,14,37,.378,17,20,.850,103,38,90,.422,32,65,.492,6,25,.240,22,22,1.000,104,2017-02-16,BOS,CHI
93,Home,L 103-112 ,240,34,86,.395,27,64,.422,7,22,.318,28,39,.718,103,41,81,.506,32,62,.516,9,19,.474,21,27,.778,112,2017-02-23,ORL,POR
94,Home,W 103-99 ,240,36,78,.462,23,47,.489,13,31,.419,18,23,.783,103,37,91,.407,27,58,.466,10,33,.303,15,22,.682,99,2017-03-01,BOS,CLE
95,Home,L 103-122 ,240,42,94,.447,30,60,.500,12,34,.353,7,13,.538,103,37,87,.425,17,35,.486,20,52,.385,28,33,.848,122,2017-03-01,LAC,HOU
96,@,L 103-120 ,240,35,89,.393,25,55,.455,10,34,.294,23,28,.821,103,46,77,.597,39,58,.672,7,19,.368,21,25,.840,120,2017-03-02,CHO,PHO
97,@,L 102-104 ,240,38,90,.422,29,64,.453,9,26,.346,17,21,.810,102,37,63,.587,31,49,.633,6,14,.429,24,32,.750,104,2011-12-29,DAL,OKC
98,@,L 102-111 ,240,35,87,.402,31,67,.463,4,20,.200,28,33,.848,102,41,79,.519,33,59,.559,8,20,.400,21,23,.913,111,2011-12-29,DEN,POR
99,Home,W 102-81 ,240,39,73,.534,31,53,.585,8,20,.400,16,25,.640,102,30,85,.353,23,67,.343,7,18,.389,14,19,.737,81,2011-12-30,MIL,WAS
0,Home,W 102-99 ,240,35,79,.443,29,63,.460,6,16,.375,26,33,.788,102,37,77,.481,33,64,.516,4,13,.308,21,29,.724,99,2011-12-30,UTA,PHI
1,Home,W 102-96 ,240,37,75,.493,25,48,.521,12,27,.444,16,24,.667,102,32,70,.457,27,57,.474,5,13,.385,27,29,.931,96,2012-01-01,ORL,TOR
2,Home,W 102-91 ,240,39,87,.448,31,64,.484,8,23,.348,16,21,.762,102,36,72,.500,29,55,.527,7,17,.412,12,20,.600,91,2012-01-02,PHO,GSW
3,@,W 102-96 (OT),265,42,95,.442,35,75,.467,7,20,.350,11,16,.688,102,40,87,.460,33,69,.478,7,18,.389,9,13,.692,96,2012-01-06,ATL,CHA
4,Home,W 102-77 ,240,37,79,.468,30,59,.508,7,20,.350,21,25,.840,102,25,77,.325,23,58,.397,2,19,.105,25,35,.714,77,2012-01-06,PHO,POR
5,Home,W 102-93 ,240,37,78,.474,26,56,.464,11,22,.500,17,17,1.000,102,33,74,.446,30,69,.435,3,5,.600,24,24,1.000,93,2012-01-12,MIL,DET
6,Home,W 102-76 ,240,39,75,.520,29,53,.547,10,22,.455,14,18,.778,102,29,78,.372,24,54,.444,5,24,.208,13,16,.813,76,2012-01-13,DAL,MIL
7,Home,W 102-94 ,240,35,85,.412,26,64,.406,9,21,.429,23,30,.767,102,35,77,.455,30,65,.462,5,12,.417,19,25,.760,94,2012-01-14,LAC,LAL
8,Home,W 102-91 ,240,40,81,.494,35,62,.565,5,19,.263,17,23,.739,102,38,91,.418,33,76,.434,5,15,.333,10,14,.714,91,2012-01-15,SAS,PHO
9,@,W 102-94 ,240,39,80,.488,35,65,.538,4,15,.267,20,29,.690,102,38,86,.442,34,69,.493,4,17,.235,14,26,.538,94,2012-01-16,CLE,CHA
10,Home,W 102-86 ,240,47,87,.540,44,77,.571,3,10,.300,5,9,.556,102,33,78,.423,32,66,.485,1,12,.083,19,25,.760,86,2012-01-16,MEM,CHI
11,@,W 102-93 ,240,36,71,.507,19,36,.528,17,35,.486,13,22,.591,102,30,73,.411,25,53,.472,5,20,.250,28,33,.848,93,2012-01-16,ORL,NYK
12,@,L 102-105 ,240,37,77,.481,33,58,.569,4,19,.211,24,30,.800,102,33,86,.384,25,65,.385,8,21,.381,31,43,.721,105,2012-01-18,OKC,WAS
13,@,L 102-105 ,240,42,94,.447,35,72,.486,7,22,.318,11,15,.733,102,44,79,.557,38,57,.667,6,22,.273,11,12,.917,105,2012-01-21,SAS,HOU
14,Home,L 102-104 ,240,42,83,.506,36,71,.507,6,12,.500,12,13,.923,102,41,75,.547,34,59,.576,7,16,.438,15,20,.750,104,2012-01-23,NOH,SAS
15,@,W 102-83 ,240,38,83,.458,25,51,.490,13,32,.406,13,19,.684,102,31,78,.397,28,67,.418,3,11,.273,18,18,1.000,83,2012-01-24,ORL,IND
16,@,W 102-99 ,240,40,76,.526,34,65,.523,6,11,.545,16,21,.762,102,39,83,.470,35,72,.486,4,11,.364,17,29,.586,99,2012-01-28,WAS,CHA
17,Home,L 102-105 ,240,44,90,.489,40,74,.541,4,16,.250,10,14,.714,102,39,74,.527,33,62,.532,6,12,.500,21,29,.724,105,2012-02-02,NYK,CHI
18,Home,W 102-94 ,240,34,80,.425,25,54,.463,9,26,.346,25,36,.694,102,33,90,.367,26,72,.361,7,18,.389,21,27,.778,94,2012-02-03,ORL,CLE
19,Home,L 102-107 (OT),265,40,86,.465,29,56,.518,11,30,.367,11,16,.688,102,36,82,.439,23,51,.451,13,31,.419,22,25,.880,107,2012-02-06,ORL,LAC
20,Home,W 102-89 ,240,35,83,.422,18,41,.439,17,42,.405,15,21,.714,102,36,76,.474,31,61,.508,5,15,.333,12,17,.706,89,2012-02-08,ORL,MIA
21,Home,W 102-96 ,240,39,86,.453,32,68,.471,7,18,.389,17,21,.810,102,38,82,.463,33,57,.579,5,25,.200,15,19,.789,96,2012-02-13,GSW,PHO
22,Home,W 102-89 ,240,36,85,.424,24,55,.436,12,30,.400,18,22,.818,102,33,80,.413,27,59,.458,6,21,.286,17,25,.680,89,2012-02-13,ORL,MIN
23,Home,W 102-84 ,240,37,80,.463,27,54,.500,10,26,.385,18,22,.818,102,30,84,.357,24,57,.421,6,27,.222,18,31,.581,84,2012-02-15,DAL,DEN
24,Home,W 102-84 ,240,35,83,.422,24,62,.387,11,21,.524,21,28,.750,102,30,76,.395,25,54,.463,5,22,.227,19,28,.679,84,2012-02-15,LAC,WAS
25,Home,W 102-90 ,240,43,85,.506,39,69,.565,4,16,.250,12,16,.750,102,38,85,.447,31,67,.463,7,18,.389,7,15,.467,90,2012-02-15,MIN,CHA
26,@,L 102-103 ,240,41,83,.494,33,66,.500,8,17,.471,12,18,.667,102,41,82,.500,35,66,.530,6,16,.375,15,19,.789,103,2012-02-17,DEN,MEM
27,Home,W 102-90 ,240,34,80,.425,27,60,.450,7,20,.350,27,32,.844,102,35,78,.449,32,60,.533,3,18,.167,17,25,.680,90,2012-02-19,PHO,LAL
28,Home,L 102-106 ,240,40,84,.476,37,76,.487,3,8,.375,19,23,.826,102,36,78,.462,26,57,.456,10,21,.476,24,30,.800,106,2012-02-20,UTA,SAS
29,@,W 102-88 ,240,34,85,.400,27,69,.391,7,16,.438,27,32,.844,102,31,88,.352,23,69,.333,8,19,.421,18,23,.783,88,2012-02-22,IND,CHA
30,Home,W 102-88 ,240,42,85,.494,38,71,.535,4,14,.286,14,19,.737,102,31,79,.392,24,62,.387,7,17,.412,19,22,.864,88,2012-02-23,MIA,NYK
31,Home,W 102-78 ,240,37,84,.440,32,73,.438,5,11,.455,23,32,.719,102,29,85,.341,26,63,.413,3,22,.136,17,24,.708,78,2012-02-28,IND,GSW
32,Home,W 102-96 ,240,40,87,.460,37,71,.521,3,16,.188,19,28,.679,102,39,96,.406,35,81,.432,4,15,.267,14,16,.875,96,2012-02-29,BOS,MIL
33,@,W 102-95 ,240,34,75,.453,19,39,.487,15,36,.417,19,27,.704,102,37,90,.411,31,74,.419,6,16,.375,15,19,.789,95,2012-02-29,ORL,WAS
34,Home,L 102-105 ,240,40,84,.476,31,59,.525,9,25,.360,13,19,.684,102,38,74,.514,30,56,.536,8,18,.444,21,27,.778,105,2012-03-01,ORL,OKC
35,Home,W 102-72 ,240,39,82,.476,29,62,.468,10,20,.500,14,21,.667,102,31,83,.373,28,67,.418,3,16,.188,7,10,.700,72,2012-03-02,SAS,CHA
36,@,W 102-99 ,240,38,81,.469,34,70,.486,4,11,.364,22,32,.688,102,38,72,.528,32,56,.571,6,16,.375,17,20,.850,99,2012-03-02,MEM,TOR
37,Home,W 102-96 ,240,36,75,.480,26,52,.500,10,23,.435,20,24,.833,102,38,85,.447,34,69,.493,4,16,.250,16,21,.762,96,2012-03-03,DAL,UTA
38,@,W 102-84 ,240,35,80,.438,26,61,.426,9,19,.474,23,32,.719,102,33,81,.407,29,69,.420,4,12,.333,14,21,.667,84,2012-03-03,IND,NOH
39,Home,L 102-105 ,240,37,81,.457,29,61,.475,8,20,.400,20,26,.769,102,39,82,.476,33,64,.516,6,18,.333,21,27,.778,105,2012-03-09,MIN,LAL
40,@,L 102-106 ,240,38,85,.447,32,73,.438,6,12,.500,20,23,.870,102,36,77,.468,26,58,.448,10,19,.526,24,26,.923,106,2012-03-14,MIA,CHI
41,Home,W 102-88 ,240,40,83,.482,28,56,.500,12,27,.444,10,13,.769,102,38,78,.487,33,67,.493,5,11,.455,7,9,.778,88,2012-03-16,ATL,WAS
42,@,W 102-88 ,240,32,77,.416,25,53,.472,7,24,.292,31,40,.775,102,32,79,.405,28,60,.467,4,19,.211,20,27,.741,88,2012-03-17,NYK,IND
43,@,W 102-94 ,240,41,81,.506,33,65,.508,8,16,.500,12,13,.923,102,36,86,.419,26,63,.413,10,23,.435,12,14,.857,94,2012-03-17,NOH,NJN
44,Home,W 102-89 ,240,35,72,.486,27,58,.466,8,14,.571,24,26,.923,102,37,85,.435,31,63,.492,6,22,.273,9,20,.450,89,2012-03-20,IND,LAC
45,@,L 102-103 (OT),265,36,78,.462,30,59,.508,6,19,.316,24,33,.727,102,37,93,.398,29,73,.397,8,20,.400,21,24,.875,103,2012-03-21,CLE,ATL
46,Home,L 102-103 ,240,43,106,.406,39,91,.429,4,15,.267,12,21,.571,102,43,91,.473,40,74,.541,3,17,.176,14,17,.824,103,2012-03-22,SAC,UTA
47,@,L 102-121 ,240,36,78,.462,30,60,.500,6,18,.333,24,32,.750,102,48,81,.593,41,66,.621,7,15,.467,18,29,.621,121,2012-03-23,DEN,UTA
48,Home,W 102-101 (OT),265,41,103,.398,38,80,.475,3,23,.130,17,26,.654,102,39,87,.448,36,73,.493,3,14,.214,20,25,.800,101,2012-03-24,CHI,TOR
49,Home,W 102-89 ,240,39,88,.443,34,72,.472,5,16,.313,19,22,.864,102,35,79,.443,32,65,.492,3,14,.214,16,22,.727,89,2012-03-24,NJN,CHA
50,@,W 102-96 ,240,44,86,.512,38,73,.521,6,13,.462,8,10,.800,102,31,73,.425,24,55,.436,7,18,.389,27,30,.900,96,2012-03-25,MEM,LAL
51,@,W 102-95 ,240,33,73,.452,31,61,.508,2,12,.167,34,45,.756,102,33,79,.418,29,67,.433,4,12,.333,25,35,.714,95,2012-03-26,BOS,CHA
52,@,W 102-87 ,240,43,79,.544,36,68,.529,7,11,.636,9,14,.643,102,33,74,.446,23,46,.500,10,28,.357,11,15,.733,87,2012-03-28,NOH,GSW
53,@,W 102-93 ,240,42,91,.462,37,79,.468,5,12,.417,13,17,.765,102,35,84,.417,31,73,.425,4,11,.364,19,23,.826,93,2012-03-29,OKC,LAL
54,@,W 102-100 ,240,35,81,.432,27,61,.443,8,20,.400,24,30,.800,102,40,76,.526,33,61,.541,7,15,.467,13,16,.813,100,2012-03-30,NJN,GSW
55,Home,L 102-104 (OT),265,44,101,.436,35,80,.438,9,21,.429,5,10,.500,102,37,83,.446,31,68,.456,6,15,.400,24,28,.857,104,2012-04-01,HOU,IND
56,@,W 102-97 ,240,41,84,.488,37,69,.536,4,15,.267,16,21,.762,102,35,81,.432,23,59,.390,12,22,.545,15,18,.833,97,2012-04-02,UTA,POR
57,Home,W 102-95 ,240,43,76,.566,40,65,.615,3,11,.273,13,19,.684,102,33,72,.458,23,48,.479,10,24,.417,19,24,.792,95,2012-04-03,DET,ORL
58,Home,W 102-83 ,240,37,90,.411,31,70,.443,6,20,.300,22,26,.846,102,28,79,.354,21,58,.362,7,21,.333,20,22,.909,83,2012-04-13,IND,CLE
59,@,W 102-86 ,240,41,74,.554,37,62,.597,4,12,.333,16,23,.696,102,29,72,.403,24,50,.480,5,22,.227,23,31,.742,86,2012-04-15,TOR,ATL
60,Home,L 102-105 ,240,40,94,.426,32,65,.492,8,29,.276,14,17,.824,102,38,80,.475,29,62,.468,9,18,.500,20,29,.690,105,2012-04-16,HOU,DEN
61,@,W 102-97 ,240,37,89,.416,24,65,.369,13,24,.542,15,18,.833,102,34,76,.447,29,62,.468,5,14,.357,24,32,.750,97,2012-04-17,IND,PHI
62,Home,W 102-98 ,240,38,70,.543,35,63,.556,3,7,.429,23,27,.852,102,36,78,.462,30,54,.556,6,24,.250,20,30,.667,98,2012-04-18,BOS,ORL
63,Home,L 102-127 ,240,41,92,.446,35,71,.493,6,21,.286,14,20,.700,102,47,80,.588,39,59,.661,8,21,.381,25,31,.806,127,2012-04-18,SAC,SAS
64,@,L 102-109 ,240,40,80,.500,32,61,.525,8,19,.421,14,20,.700,102,43,86,.500,32,62,.516,11,24,.458,12,14,.857,109,2012-04-24,LAC,ATL
65,Home,W 102-95 ,240,33,82,.402,19,44,.432,14,38,.368,22,28,.786,102,31,70,.443,26,53,.491,5,17,.294,28,32,.875,95,2012-04-25,ORL,CHA
66,Home,L 102-131 ,240,40,89,.449,30,62,.484,10,27,.370,12,19,.632,102,56,89,.629,51,79,.646,5,10,.500,14,20,.700,131,2012-04-26,MIN,DEN
67,Home,L 102-109 ,240,40,85,.471,33,63,.524,7,22,.318,15,17,.882,102,38,90,.422,30,60,.500,8,30,.267,25,29,.862,109,2012-11-02,ATL,HOU
68,Home,W 102-89 ,240,42,86,.488,37,71,.521,5,15,.333,13,18,.722,102,32,84,.381,25,58,.431,7,26,.269,18,27,.667,89,2012-11-02,ORL,DEN
69,@,L 102-105 ,240,39,83,.470,33,67,.493,6,16,.375,18,29,.621,102,41,79,.519,32,55,.582,9,24,.375,14,21,.667,105,2012-11-03,CLE,MIL
70,Home,W 102-97 ,240,36,85,.424,28,63,.444,8,22,.364,22,28,.786,102,35,75,.467,28,62,.452,7,13,.538,20,25,.800,97,2012-11-15,BRK,BOS
71,@,L 102-114 ,240,45,92,.489,40,78,.513,5,14,.357,7,15,.467,102,42,89,.472,34,68,.500,8,21,.381,22,28,.786,114,2012-11-16,PHO,LAL
72,Home,W 102-94 ,240,39,79,.494,30,57,.526,9,22,.409,15,20,.750,102,37,75,.493,33,59,.559,4,16,.250,16,18,.889,94,2012-11-18,POR,CHI
73,Home,W 102-98 ,240,36,82,.439,33,71,.465,3,11,.273,27,30,.900,102,44,93,.473,42,77,.545,2,16,.125,8,11,.727,98,2012-11-19,CHA,MIL
74,Home,W 102-91 ,240,37,92,.402,28,71,.394,9,21,.429,19,23,.826,102,30,86,.349,23,65,.354,7,21,.333,24,31,.774,91,2012-11-19,UTA,HOU
75,@,W 102-80 ,240,37,83,.446,23,47,.489,14,36,.389,14,19,.737,102,29,69,.420,21,51,.412,8,18,.444,14,21,.667,80,2012-11-20,NYK,NOH
76,Home,W 102-93 ,240,40,75,.533,33,60,.550,7,15,.467,15,19,.789,102,38,83,.458,32,60,.533,6,23,.261,11,15,.733,93,2012-11-21,GSW,BRK
77,Home,W 102-91 ,240,40,84,.476,35,65,.538,5,19,.263,17,30,.567,102,35,80,.438,28,63,.444,7,17,.412,14,18,.778,91,2012-11-23,DEN,GSW
78,@,L 102-104 ,240,40,80,.500,30,63,.476,10,17,.588,12,16,.750,102,36,83,.434,33,68,.485,3,15,.200,29,33,.879,104,2012-11-23,SAC,UTA
79,Home,W 102-84 ,240,40,75,.533,35,62,.565,5,13,.385,17,21,.810,102,33,85,.388,27,72,.375,6,13,.462,12,20,.600,84,2012-11-25,DEN,NOH
80,@,W 102-88 ,240,35,73,.479,24,52,.462,11,21,.524,21,25,.840,102,33,72,.458,28,59,.475,5,13,.385,17,21,.810,88,2012-11-28,NYK,MIL
81,Home,W 102-89 ,240,40,78,.513,33,58,.569,7,20,.350,15,19,.789,102,33,75,.440,27,47,.574,6,28,.214,17,27,.630,89,2012-12-01,MIA,BRK
82,@,W 102-94 ,240,40,92,.435,32,69,.464,8,23,.348,14,16,.875,102,37,81,.457,30,64,.469,7,17,.412,13,18,.722,94,2012-12-03,ORL,GSW
83,Home,W 102-81 ,240,43,82,.524,38,70,.543,5,12,.417,11,11,1.000,102,29,76,.382,21,57,.368,8,19,.421,15,23,.652,81,2012-12-03,NOH,MIL
84,Home,L 102-109 ,240,37,87,.425,26,54,.481,11,33,.333,17,23,.739,102,46,90,.511,37,71,.521,9,19,.474,8,10,.800,109,2012-12-07,BRK,GSW
85,Home,L 102-132 ,240,37,79,.468,31,64,.484,6,15,.400,22,31,.710,102,50,90,.556,31,56,.554,19,34,.559,13,15,.867,132,2012-12-08,CHA,SAS
86,Home,W 102-83 ,240,36,79,.456,30,60,.500,6,19,.316,24,34,.706,102,30,77,.390,20,51,.392,10,26,.385,13,17,.765,83,2012-12-09,LAC,TOR
87,Home,L 102-113 ,240,42,78,.538,31,54,.574,11,24,.458,7,10,.700,102,47,88,.534,40,71,.563,7,17,.412,12,17,.706,113,2012-12-14,NOH,MIN
88,@,W 102-96 ,240,37,82,.451,29,53,.547,8,29,.276,20,28,.714,102,36,83,.434,28,62,.452,8,21,.381,16,20,.800,96,2012-12-14,LAL,WAS
89,Home,W 102-72 ,240,40,79,.506,32,52,.615,8,27,.296,14,21,.667,102,27,72,.375,20,52,.385,7,20,.350,11,15,.733,72,2012-12-15,MIA,WAS
90,@,L 102-103 ,240,40,82,.488,31,58,.534,9,24,.375,13,17,.765,102,37,85,.435,24,50,.480,13,35,.371,16,23,.696,103,2012-12-15,CLE,NYK
91,Home,W 102-93 ,240,44,82,.537,38,68,.559,6,14,.429,8,8,1.000,102,39,96,.406,32,71,.451,7,25,.280,8,12,.667,93,2012-12-17,ORL,MIN
92,@,W 102-94 ,240,38,78,.487,25,54,.463,13,24,.542,13,16,.813,102,36,86,.419,28,65,.431,8,21,.381,14,14,1.000,94,2012-12-28,ATL,CLE
93,Home,W 102-79 ,240,41,77,.532,33,54,.611,8,23,.348,12,17,.706,102,31,70,.443,27,48,.563,4,22,.182,13,16,.813,79,2013-01-02,TOR,POR
94,@,L 102-107 ,240,35,76,.461,29,51,.569,6,25,.240,26,36,.722,102,41,82,.500,35,68,.515,6,14,.429,19,25,.760,107,2013-01-04,LAL,LAC
95,@,W 102-97 ,240,37,86,.430,21,62,.339,16,24,.667,12,13,.923,102,38,91,.418,33,75,.440,5,16,.313,16,18,.889,97,2013-01-05,POR,MIN
96,@,W 102-96 ,240,39,74,.527,33,56,.589,6,18,.333,18,20,.900,102,31,76,.408,17,44,.386,14,32,.438,20,26,.769,96,2013-01-07,BOS,NYK
97,Home,L 102-112 ,240,42,88,.477,38,80,.475,4,8,.500,14,22,.636,102,44,82,.537,34,60,.567,10,22,.455,14,21,.667,112,2013-01-09,CHA,UTA
98,@,W 102-90 ,240,40,84,.476,35,67,.522,5,17,.294,17,22,.773,102,35,84,.417,26,59,.441,9,25,.360,11,18,.611,90,2013-01-14,OKC,PHO
99,@,W 102-87 ,240,33,72,.458,22,41,.537,11,31,.355,25,31,.806,102,35,79,.443,29,62,.468,6,17,.353,11,22,.500,87,2013-01-17,NYK,DET
0,@,L 102-110 ,240,42,95,.442,34,79,.430,8,16,.500,10,13,.769,102,41,79,.519,34,63,.540,7,16,.438,21,33,.636,110,2013-01-22,PHI,MIL
1,@,L 102-106 ,240,38,81,.469,28,64,.438,10,17,.588,16,23,.696,102,43,80,.538,35,55,.636,8,25,.320,12,23,.522,106,2013-01-23,NOH,SAS
2,Home,W 102-84 ,240,43,80,.538,34,59,.576,9,21,.429,7,13,.538,102,34,81,.420,31,67,.463,3,14,.214,13,16,.813,84,2013-01-25,LAL,UTA
3,Home,W 102-101 ,240,37,73,.507,32,62,.516,5,11,.455,23,26,.885,102,37,77,.481,27,57,.474,10,20,.500,17,23,.739,101,2013-01-26,CHA,MIN
4,@,L 102-109 ,240,39,93,.419,26,65,.400,13,28,.464,11,11,1.000,102,41,101,.406,28,71,.394,13,30,.433,14,20,.700,109,2013-01-26,GSW,MIL
5,Home,L 102-104 ,240,40,90,.444,30,67,.448,10,23,.435,12,16,.750,102,40,79,.506,29,56,.518,11,23,.478,13,18,.722,104,2013-01-27,ORL,DET
6,Home,W 102-101 ,240,37,78,.474,30,64,.469,7,14,.500,21,30,.700,102,39,85,.459,28,62,.452,11,23,.478,12,17,.706,101,2013-01-28,DEN,IND
7,Home,L 102-114 ,240,38,87,.437,32,68,.471,6,19,.316,20,23,.870,102,46,86,.535,40,71,.563,6,15,.400,16,20,.800,114,2013-01-28,TOR,GSW
8,Home,W 102-78 ,240,38,69,.551,29,53,.547,9,16,.563,17,21,.810,102,30,73,.411,26,54,.481,4,19,.211,14,17,.824,78,2013-01-30,SAS,CHA
9,Home,W 102-89 ,240,39,70,.557,32,53,.604,7,17,.412,17,24,.708,102,33,70,.471,28,56,.500,5,14,.357,18,24,.750,89,2013-02-01,IND,MIA
10,@,W 102-88 ,240,41,80,.513,31,52,.596,10,28,.357,10,16,.625,102,33,74,.446,26,51,.510,7,23,.304,15,18,.833,88,2013-02-10,LAC,NYK
11,Home,W 102-89 ,240,40,78,.513,32,62,.516,8,16,.500,14,18,.778,102,34,69,.493,29,56,.518,5,13,.385,16,25,.640,89,2013-02-10,TOR,NOH
12,@,W 102-90 ,240,42,74,.568,38,62,.613,4,12,.333,14,17,.824,102,36,95,.379,31,72,.431,5,23,.217,13,22,.591,90,2013-02-11,WAS,MIL
13,@,W 102-98 ,240,41,82,.500,38,69,.551,3,13,.231,17,20,.850,102,33,80,.413,27,60,.450,6,20,.300,26,32,.813,98,2013-02-19,PHO,POR
14,Home,L 102-108 ,240,34,90,.378,25,65,.385,9,25,.360,25,29,.862,102,35,75,.467,25,45,.556,10,30,.333,28,35,.800,108,2013-02-19,SAC,SAS
15,Home,L 102-103 ,240,41,89,.461,37,77,.481,4,12,.333,16,20,.800,102,39,91,.429,25,63,.397,14,28,.500,11,14,.786,103,2013-02-23,MIL,ATL
16,Home,W 102-72 ,240,36,79,.456,30,62,.484,6,17,.353,24,27,.889,102,25,86,.291,21,68,.309,4,18,.222,18,24,.750,72,2013-02-24,OKC,CHI
17,@,W 102-91 ,240,38,78,.487,33,61,.541,5,17,.294,21,26,.808,102,37,83,.446,33,68,.485,4,15,.267,13,23,.565,91,2013-02-27,ATL,UTA
18,@,L 102-130 ,240,39,85,.459,32,64,.500,7,21,.333,17,19,.895,102,51,84,.607,42,64,.656,9,20,.450,19,23,.826,130,2013-03-01,SAC,SAS
19,@,W 102-97 ,240,36,78,.462,24,48,.500,12,30,.400,18,21,.857,102,37,73,.507,31,53,.585,6,20,.300,17,24,.708,97,2013-03-04,NYK,CLE
20,Home,L 102-105 ,240,37,80,.463,29,59,.492,8,21,.381,20,26,.769,102,43,87,.494,36,66,.545,7,21,.333,12,16,.750,105,2013-03-04,NOH,ORL
21,Home,L 102-108 ,240,38,88,.432,29,64,.453,9,24,.375,17,20,.850,102,38,78,.487,27,50,.540,11,28,.393,21,29,.724,108,2013-03-06,NOH,LAL
22,@,L 102-107 (OT),265,40,88,.455,31,61,.508,9,27,.333,13,17,.765,102,40,78,.513,30,58,.517,10,20,.500,17,20,.850,107,2013-03-08,ATL,BOS
23,@,W 102-99 ,240,41,78,.526,30,56,.536,11,22,.500,9,15,.600,102,39,96,.406,30,66,.455,9,30,.300,12,19,.632,99,2013-03-08,DAL,DET
24,Home,W 102-93 ,240,42,79,.532,34,58,.586,8,21,.381,10,13,.769,102,37,77,.481,27,56,.482,10,21,.476,9,11,.818,93,2013-03-08,MIA,PHI
25,@,W 102-97 ,240,39,76,.513,36,65,.554,3,11,.273,21,31,.677,102,32,79,.405,27,63,.429,5,16,.313,28,29,.966,97,2013-03-12,MEM,POR
26,@,L 102-113 ,240,42,96,.438,32,65,.492,10,31,.323,8,8,1.000,102,41,72,.569,29,44,.659,12,28,.429,19,29,.655,113,2013-03-17,SAC,LAL
27,Home,W 102-95 ,240,42,87,.483,33,68,.485,9,19,.474,9,13,.692,102,36,83,.434,23,57,.404,13,26,.500,10,13,.769,95,2013-03-19,MIL,POR
28,Home,W 102-78 ,240,38,79,.481,35,67,.522,3,12,.250,23,30,.767,102,31,101,.307,28,82,.341,3,19,.158,13,22,.591,78,2013-03-22,IND,MIL
29,@,W 102-100 ,240,35,76,.461,31,62,.500,4,14,.286,28,31,.903,102,41,99,.414,35,78,.449,6,21,.286,12,17,.706,100,2013-03-24,BRK,PHO
30,@,L 102-109 (OT),265,38,85,.447,28,52,.538,10,33,.303,16,25,.640,102,40,82,.488,34,59,.576,6,23,.261,23,27,.852,109,2013-03-26,LAC,DAL
31,@,L 102-111 ,240,34,73,.466,24,47,.511,10,26,.385,24,31,.774,102,38,77,.494,29,58,.500,9,19,.474,26,30,.867,111,2013-03-29,CHA,NYK
32,@,L 102-104 ,240,41,81,.506,33,62,.532,8,19,.421,12,21,.571,102,39,74,.527,33,59,.559,6,15,.400,20,21,.952,104,2013-03-29,LAC,SAS
33,Home,W 102-94 ,240,37,81,.457,28,51,.549,9,30,.300,19,26,.731,102,41,81,.506,38,69,.551,3,12,.250,9,15,.600,94,2013-04-01,ATL,CLE
34,@,L 102-131 ,240,37,73,.507,31,54,.574,6,19,.316,22,28,.786,102,51,100,.510,37,73,.507,14,27,.519,15,17,.882,131,2013-04-01,CHA,MIL
35,@,L 102-112 ,240,39,67,.582,26,44,.591,13,23,.565,11,17,.647,102,45,83,.542,36,61,.590,9,22,.409,13,18,.722,112,2013-04-01,POR,UTA
36,@,W 102-90 ,240,37,71,.521,23,44,.523,14,27,.519,14,20,.700,102,30,60,.500,22,40,.550,8,20,.400,22,27,.815,90,2013-04-02,NYK,MIA
37,Home,L 102-112 ,240,34,87,.391,28,66,.424,6,21,.286,28,34,.824,102,42,86,.488,32,56,.571,10,30,.333,18,21,.857,112,2013-04-03,SAC,HOU
38,@,W 102-91 ,240,37,89,.416,25,62,.403,12,27,.444,16,17,.941,102,34,85,.400,28,68,.412,6,17,.353,17,21,.810,91,2013-04-10,PHO,DAL
39,@,W 102-84 ,240,42,75,.560,33,58,.569,9,17,.529,9,13,.692,102,31,74,.419,29,64,.453,2,10,.200,20,33,.606,84,2013-04-15,CHI,ORL
40,@,L 102-113 ,240,34,78,.436,24,53,.453,10,25,.400,24,32,.750,102,39,78,.500,30,54,.556,9,24,.375,26,33,.788,113,2013-10-30,WAS,DET
41,Home,W 102-95 ,240,36,77,.468,26,54,.481,10,23,.435,20,31,.645,102,40,88,.455,33,65,.508,7,23,.304,8,14,.571,95,2013-11-01,ATL,TOR
42,Home,L 102-109 ,240,41,94,.436,32,68,.471,9,26,.346,11,17,.647,102,48,94,.511,42,71,.592,6,23,.261,7,14,.500,109,2013-11-01,WAS,PHI
43,@,W 102-94 ,240,40,86,.465,36,70,.514,4,16,.250,18,20,.900,102,35,83,.422,26,64,.406,9,19,.474,15,20,.750,94,2013-11-05,SAS,DEN
44,@,W 102-97 ,240,30,71,.423,22,50,.440,8,21,.381,34,42,.810,102,35,82,.427,27,54,.500,8,28,.286,19,23,.826,97,2013-11-05,CHA,NYK
45,Home,L 102-116 ,240,39,83,.470,33,65,.508,6,18,.333,18,26,.692,102,43,98,.439,25,65,.385,18,33,.545,12,16,.750,116,2013-11-06,PHI,WAS
46,Home,W 102-97 ,240,38,71,.535,33,55,.600,5,16,.313,21,33,.636,102,36,73,.493,28,49,.571,8,24,.333,17,21,.810,97,2013-11-07,MIA,LAC
47,Home,W 102-88 ,240,41,80,.513,32,59,.542,9,21,.429,11,14,.786,102,35,77,.455,27,60,.450,8,17,.471,10,16,.625,88,2013-11-16,GSW,UTA
48,Home,L 102-106 ,240,34,86,.395,27,63,.429,7,23,.304,27,32,.844,102,39,81,.481,34,69,.493,5,12,.417,23,30,.767,106,2013-11-18,LAC,MEM
49,@,W 102-98 ,240,40,81,.494,28,57,.491,12,24,.500,10,16,.625,102,34,90,.378,29,68,.426,5,22,.227,25,31,.806,98,2013-11-20,LAC,MIN
50,Home,W 102-95 ,240,39,82,.476,28,58,.483,11,24,.458,13,17,.765,102,34,82,.415,25,60,.417,9,22,.409,18,28,.643,95,2013-11-22,LAL,GSW
51,@,W 102-86 ,240,42,79,.532,35,62,.565,7,17,.412,11,16,.688,102,35,80,.438,32,69,.464,3,11,.273,13,17,.765,86,2013-11-22,SAS,MEM
52,Home,W 102-100 ,240,35,79,.443,24,47,.511,11,32,.344,21,30,.700,102,35,87,.402,28,66,.424,7,21,.333,23,25,.920,100,2013-11-23,DEN,DAL
53,@,L 102-103 ,240,37,88,.420,32,71,.451,5,17,.294,23,30,.767,102,33,68,.485,22,43,.512,11,25,.440,26,45,.578,103,2013-11-23,SAC,LAC
54,Home,W 102-91 ,240,37,84,.440,28,59,.475,9,25,.360,19,22,.864,102,38,85,.447,32,70,.457,6,15,.400,9,14,.643,91,2013-11-25,POR,NYK
55,@,W 102-101 ,240,40,88,.455,33,69,.478,7,19,.368,15,21,.714,102,41,87,.471,32,68,.471,9,19,.474,10,13,.769,101,2013-11-26,GSW,NOP
56,@,W 102-100 ,240,39,77,.506,35,63,.556,4,14,.286,20,22,.909,102,34,78,.436,23,52,.442,11,26,.423,21,22,.955,100,2013-11-26,BRK,TOR
57,Home,L 102-106 ,240,44,100,.440,43,92,.467,1,8,.125,13,25,.520,102,36,80,.450,22,49,.449,14,31,.452,20,30,.667,106,2013-11-29,DET,LAL
58,@,L 102-106 ,240,39,88,.443,30,66,.455,9,22,.409,15,17,.882,102,36,76,.474,31,63,.492,5,13,.385,29,33,.879,106,2013-12-02,IND,POR
59,Home,W 102-100 ,240,42,78,.538,36,60,.600,6,18,.333,12,17,.706,102,42,96,.438,31,65,.477,11,31,.355,5,5,1.000,100,2013-12-02,SAS,ATL
60,Home,L 102-112 (OT),265,36,89,.404,28,70,.400,8,19,.421,22,30,.733,102,39,94,.415,36,79,.456,3,15,.200,31,38,.816,112,2013-12-07,UTA,SAC
61,Home,W 102-93 ,240,33,74,.446,25,54,.463,8,20,.400,28,30,.933,102,26,70,.371,20,46,.435,6,24,.250,35,52,.673,93,2013-12-12,BRK,LAC
62,Home,W 102-93 ,240,37,85,.435,30,61,.492,7,24,.292,21,28,.750,102,37,85,.435,30,61,.492,7,24,.292,12,19,.632,93,2013-12-15,DEN,NOP
63,@,L 102-106 ,240,34,80,.425,23,58,.397,11,22,.500,23,33,.697,102,35,79,.443,22,52,.423,13,27,.481,23,34,.676,106,2013-12-15,GSW,PHO
64,@,W 102-101 ,240,39,72,.542,28,54,.519,11,18,.611,13,17,.765,102,33,79,.418,22,49,.449,11,30,.367,24,31,.774,101,2013-12-16,WAS,NYK
65,Home,L 102-104 (OT),265,41,96,.427,35,70,.500,6,26,.231,14,20,.700,102,37,81,.457,29,66,.439,8,15,.533,22,34,.647,104,2013-12-18,TOR,CHA
66,Home,L 102-104 ,240,42,90,.467,34,59,.576,8,31,.258,10,11,.909,102,40,89,.449,29,62,.468,11,27,.407,13,19,.684,104,2013-12-19,GSW,SAS
67,Home,W 102-83 ,240,38,98,.388,26,67,.388,12,31,.387,14,19,.737,102,26,80,.325,22,60,.367,4,20,.200,27,33,.818,83,2013-12-21,GSW,LAL
68,@,L 102-109 ,240,36,81,.444,21,42,.500,15,39,.385,15,21,.714,102,41,74,.554,33,53,.623,8,21,.381,19,24,.792,109,2013-12-29,ATL,ORL
69,Home,L 102-114 ,240,36,91,.396,31,66,.470,5,25,.200,25,35,.714,102,43,92,.467,34,69,.493,9,23,.391,19,28,.679,114,2014-01-01,DEN,PHI
70,Home,W 102-100 ,240,34,74,.459,24,48,.500,10,26,.385,24,28,.857,102,37,89,.416,28,65,.431,9,24,.375,17,24,.708,100,2014-01-03,HOU,NYK
71,Home,W 102-97 ,240,38,81,.469,35,70,.500,3,11,.273,23,27,.852,102,39,77,.506,32,55,.582,7,22,.318,12,21,.571,97,2014-01-05,MIA,TOR
72,Home,W 102-98 ,240,34,77,.442,29,58,.500,5,19,.263,29,35,.829,102,36,78,.462,27,52,.519,9,26,.346,17,23,.739,98,2014-01-08,BRK,GSW
73,@,W 102-96 ,240,38,80,.475,28,59,.475,10,21,.476,16,26,.615,102,35,78,.449,31,65,.477,4,13,.308,22,27,.815,96,2014-01-08,WAS,NOP
74,Home,W 102-92 ,240,44,82,.537,35,58,.603,9,24,.375,5,10,.500,102,37,68,.544,30,47,.638,7,21,.333,11,21,.524,92,2014-01-09,NYK,MIA
75,Home,L 102-113 ,240,39,81,.481,30,61,.492,9,20,.450,15,27,.556,102,45,83,.542,38,69,.551,7,14,.500,16,20,.800,113,2014-01-10,UTA,CLE
76,@,W 102-92 ,240,39,82,.476,33,64,.516,6,18,.333,18,23,.783,102,36,78,.462,31,59,.525,5,19,.263,15,21,.714,92,2014-01-11,NYK,PHI
77,@,W 102-88 ,240,39,75,.520,32,57,.561,7,18,.389,17,28,.607,102,34,79,.430,25,58,.431,9,21,.429,11,19,.579,88,2014-01-13,WAS,CHI
78,Home,W 102-100 (OT),265,39,102,.382,32,81,.395,7,21,.333,17,24,.708,102,35,83,.422,27,58,.466,8,25,.320,22,26,.846,100,2014-01-20,CHI,LAL
79,@,W 102-97 ,240,38,83,.458,34,63,.540,4,20,.200,22,28,.786,102,33,81,.407,28,58,.483,5,23,.217,26,33,.788,97,2014-01-20,DAL,CLE
80,@,W 102-94 ,240,41,91,.451,33,72,.458,8,19,.421,12,15,.800,102,35,86,.407,25,56,.446,10,30,.333,14,20,.700,94,2014-01-20,IND,GSW
81,@,L 102-109 ,240,40,88,.455,31,63,.492,9,25,.360,13,21,.619,102,45,78,.577,37,58,.638,8,20,.400,11,23,.478,109,2014-01-23,LAL,MIA
82,@,W 102-94 ,240,39,91,.429,31,74,.419,8,17,.471,16,20,.800,102,38,87,.437,37,72,.514,1,15,.067,17,24,.708,94,2014-01-30,PHO,IND
83,@,L 102-113 ,240,39,87,.448,29,66,.439,10,21,.476,14,24,.583,102,43,83,.518,36,67,.537,7,16,.438,20,25,.800,113,2014-01-31,MIL,ORL
84,Home,W 102-87 ,240,38,74,.514,36,62,.581,2,12,.167,24,37,.649,102,29,81,.358,19,51,.373,10,30,.333,19,28,.679,87,2014-02-01,LAC,UTA
85,@,L 102-108 ,240,37,71,.521,29,51,.569,8,20,.400,20,28,.714,102,32,72,.444,22,47,.468,10,25,.400,34,39,.872,108,2014-02-03,PHI,BRK
86,Home,W 102-96 ,240,39,85,.459,32,65,.492,7,20,.350,17,21,.810,102,34,83,.410,28,65,.431,6,18,.333,22,29,.759,96,2014-02-03,MIA,DET
87,@,W 102-95 ,240,38,81,.469,33,63,.524,5,18,.278,21,25,.840,102,36,79,.456,30,65,.462,6,14,.429,17,20,.850,95,2014-02-03,SAS,NOP
88,Home,W 102-87 ,240,40,83,.482,29,61,.475,11,22,.500,11,15,.733,102,32,77,.416,28,63,.444,4,14,.286,19,20,.950,87,2014-02-06,GSW,CHI
89,@,L 102-103 ,240,37,73,.507,27,51,.529,10,22,.455,18,19,.947,102,38,80,.475,33,68,.485,5,12,.417,22,26,.846,103,2014-02-07,OKC,ORL
90,@,W 102-91 ,240,37,82,.451,27,59,.458,10,23,.435,18,20,.900,102,33,92,.359,22,65,.338,11,27,.407,14,15,.933,91,2014-02-09,DAL,BOS
91,@,W 102-86 ,240,42,88,.477,35,68,.515,7,20,.350,11,14,.786,102,31,72,.431,25,56,.446,6,16,.375,18,25,.720,86,2014-02-10,BOS,MIL
92,@,W 102-98 ,240,41,79,.519,35,66,.530,6,13,.462,14,17,.824,102,39,80,.488,33,64,.516,6,16,.375,14,19,.737,98,2014-02-12,NOP,MIL
93,Home,W 102-99 (OT),265,37,93,.398,28,66,.424,9,27,.333,19,24,.792,102,37,101,.366,28,71,.394,9,30,.300,16,25,.640,99,2014-02-20,GSW,HOU
94,Home,W 102-96 ,240,42,87,.483,37,72,.514,5,15,.333,13,15,.867,102,31,80,.388,24,56,.429,7,24,.292,27,43,.628,96,2014-02-21,MEM,LAC
95,Home,W 102-94 ,240,39,91,.429,32,71,.451,7,20,.350,17,17,1.000,102,37,82,.451,31,69,.449,6,13,.462,14,18,.778,94,2014-02-21,POR,UTA
96,Home,L 102-113 ,240,40,82,.488,38,71,.535,2,11,.182,20,30,.667,102,44,90,.489,36,67,.537,8,23,.348,17,22,.773,113,2014-02-22,DET,DAL
97,Home,L 102-108 ,240,39,76,.513,32,59,.542,7,17,.412,17,26,.654,102,36,76,.474,24,51,.471,12,25,.480,24,32,.750,108,2014-02-23,LAL,BRK
98,@,W 102-97 ,240,39,77,.506,34,64,.531,5,13,.385,19,23,.826,102,38,89,.427,31,68,.456,7,21,.333,14,17,.824,97,2014-03-01,IND,BOS
99,Home,W 102-96 ,240,37,81,.457,32,54,.593,5,27,.185,23,24,.958,102,33,83,.398,26,60,.433,7,23,.304,23,35,.657,96,2014-03-01,POR,DEN
0,Home,L 102-116 ,240,36,82,.439,30,65,.462,6,17,.353,24,29,.828,102,43,83,.518,39,69,.565,4,14,.286,26,32,.813,116,2014-03-05,MIL,SAC
1,Home,W 102-78 ,240,35,79,.443,22,50,.440,13,29,.448,19,21,.905,102,29,88,.330,25,61,.410,4,27,.148,16,19,.842,78,2014-03-05,POR,ATL
2,Home,W 102-97 ,240,36,74,.486,23,45,.511,13,29,.448,17,20,.850,102,37,89,.416,34,70,.486,3,19,.158,20,26,.769,97,2014-03-13,ATL,MIL
3,@,L 102-131 ,240,37,94,.394,24,67,.358,13,27,.481,15,25,.600,102,45,89,.506,32,59,.542,13,30,.433,28,30,.933,131,2014-03-13,LAL,OKC
4,Home,W 102-80 ,240,42,94,.447,34,66,.515,8,28,.286,10,15,.667,102,29,83,.349,21,59,.356,8,24,.333,14,20,.700,80,2014-03-16,LAC,CLE
5,@,L 102-104 ,240,41,85,.482,35,66,.530,6,19,.316,14,19,.737,102,34,78,.436,28,61,.459,6,17,.353,30,38,.789,104,2014-03-16,SAC,MIN
6,@,W 102-94 ,240,36,83,.434,28,68,.412,8,15,.533,22,27,.815,102,37,81,.457,26,57,.456,11,24,.458,9,19,.474,94,2014-03-19,CHI,PHI
7,@,W 102-95 ,240,38,89,.427,28,58,.483,10,31,.323,16,20,.800,102,36,81,.444,28,59,.475,8,22,.364,15,24,.625,95,2014-03-20,OKC,CLE
8,@,L 102-105 ,240,41,85,.482,36,70,.514,5,15,.333,15,18,.833,102,40,91,.440,29,64,.453,11,27,.407,14,18,.778,105,2014-03-23,WAS,DEN
9,@,W 102-95 ,240,38,74,.514,26,50,.520,12,24,.500,14,16,.875,102,30,72,.417,22,49,.449,8,23,.348,27,33,.818,95,2014-03-24,PHO,ATL
10,Home,W 102-100 ,240,36,70,.514,32,57,.561,4,13,.308,26,33,.788,102,35,88,.398,21,56,.375,14,32,.438,16,26,.615,100,2014-03-25,CLE,TOR
11,Home,L 102-133 ,240,35,87,.402,29,64,.453,6,23,.261,26,35,.743,102,55,98,.561,42,74,.568,13,24,.542,10,14,.714,133,2014-03-28,DEN,SAS
12,Home,W 102-95 ,240,36,71,.507,30,57,.526,6,14,.429,24,32,.750,102,33,68,.485,26,47,.553,7,21,.333,22,27,.815,95,2014-03-28,NOP,UTA
13,Home,L 102-107 ,240,40,87,.460,30,58,.517,10,29,.345,12,16,.750,102,37,70,.529,29,54,.537,8,16,.500,25,31,.806,107,2014-03-30,BOS,CHI
14,@,W 102-97 ,240,38,80,.475,35,69,.507,3,11,.273,23,31,.742,102,36,73,.493,31,59,.525,5,14,.357,20,26,.769,97,2014-03-31,SAC,NOP
15,Home,W 102-88 ,240,43,81,.531,38,65,.585,5,16,.313,11,16,.688,102,40,95,.421,36,84,.429,4,11,.364,4,6,.667,88,2014-04-02,MIN,MEM
16,@,L 102-107 ,240,37,96,.385,25,68,.368,12,28,.429,16,20,.800,102,42,86,.488,37,71,.521,5,15,.333,18,27,.667,107,2014-04-02,LAL,SAC
17,Home,L 102-111 ,240,38,87,.437,29,54,.537,9,33,.273,17,21,.810,102,39,77,.506,33,58,.569,6,19,.316,27,37,.730,111,2014-04-04,BOS,PHI
18,Home,W 102-90 ,240,31,84,.369,24,62,.387,7,22,.318,33,42,.786,102,31,68,.456,29,60,.483,2,8,.250,26,35,.743,90,2014-04-04,CHI,MIL
19,Home,W 102-69 ,240,42,93,.452,32,63,.508,10,30,.333,8,12,.667,102,25,78,.321,24,68,.353,1,10,.100,18,25,.720,69,2014-04-04,GSW,SAC
20,Home,W 102-94 ,240,40,84,.476,30,62,.484,10,22,.455,12,16,.750,102,33,78,.423,27,67,.403,6,11,.545,22,28,.786,94,2014-04-04,TOR,IND
21,@,W 102-98 ,240,36,81,.444,24,54,.444,12,27,.444,18,22,.818,102,38,79,.481,37,70,.529,1,9,.111,21,27,.778,98,2014-04-05,TOR,MIL
22,@,L 102-130 ,240,39,86,.453,35,73,.479,4,13,.308,20,28,.714,102,52,90,.578,35,57,.614,17,33,.515,9,9,1.000,130,2014-04-06,UTA,GSW
23,Home,W 102-91 ,240,34,61,.557,22,34,.647,12,27,.444,22,30,.733,102,33,88,.375,18,46,.391,15,42,.357,10,13,.769,91,2014-04-06,MIA,NYK
24,@,W 102-95 ,240,37,86,.430,31,69,.449,6,17,.353,22,32,.688,102,34,89,.382,25,54,.463,9,35,.257,18,24,.750,95,2014-04-08,DET,ATL
25,@,L 102-107 ,240,38,73,.521,23,48,.479,15,25,.600,11,12,.917,102,43,78,.551,36,58,.621,7,20,.350,14,21,.667,107,2014-04-09,MIA,MEM
26,Home,L 102-104 ,240,38,87,.437,34,71,.479,4,16,.250,22,29,.759,102,41,85,.482,30,61,.492,11,24,.458,11,19,.579,104,2014-04-09,MIL,IND
27,@,W 102-87 ,240,41,82,.500,30,61,.492,11,21,.524,9,12,.750,102,34,80,.425,30,63,.476,4,17,.235,15,16,.938,87,2014-04-09,CHI,MIN
28,Home,W 102-97 ,240,38,72,.528,29,52,.558,9,20,.450,17,23,.739,102,36,84,.429,29,56,.518,7,28,.250,18,19,.947,97,2014-04-13,IND,OKC
29,@,W 102-90 ,240,42,88,.477,34,73,.466,8,15,.533,10,13,.769,102,35,80,.438,24,53,.453,11,27,.407,9,11,.818,90,2014-04-13,MEM,LAL
30,Home,L 102-118 ,240,39,84,.464,32,54,.593,7,30,.233,17,23,.739,102,50,88,.568,44,70,.629,6,18,.333,12,17,.706,118,2014-04-16,BOS,WAS
31,@,L 102-109 ,240,40,80,.500,27,58,.466,13,22,.591,9,17,.529,102,37,90,.411,29,64,.453,8,26,.308,27,33,.818,109,2014-10-29,ATL,TOR
32,@,L 102-120 ,240,36,83,.434,22,48,.458,14,35,.400,16,18,.889,102,47,85,.553,39,64,.609,8,21,.381,18,23,.783,120,2014-10-30,UTA,DAL
33,Home,W 102-92 ,240,35,69,.507,28,49,.571,7,20,.350,25,33,.758,102,31,81,.383,19,49,.388,12,32,.375,18,21,.857,92,2014-11-01,ATL,IND
34,@,W 102-90 ,240,42,87,.483,35,61,.574,7,26,.269,11,13,.846,102,32,76,.421,31,59,.525,1,17,.059,25,35,.714,90,2014-11-01,BRK,DET
35,Home,W 102-91 ,240,37,80,.463,31,60,.517,6,20,.300,22,31,.710,102,35,80,.438,28,54,.519,7,26,.269,14,20,.700,91,2014-11-01,OKC,DEN
36,@,L 102-107 ,240,37,79,.468,33,63,.524,4,16,.250,24,39,.615,102,35,70,.500,26,46,.565,9,24,.375,28,38,.737,107,2014-11-02,TOR,MIA
37,@,W 102-91 ,240,40,80,.500,31,63,.492,9,17,.529,13,17,.765,102,32,69,.464,24,48,.500,8,21,.381,19,21,.905,91,2014-11-05,MEM,PHO
38,Home,W 102-100 ,240,39,77,.506,32,56,.571,7,21,.333,17,22,.773,102,30,72,.417,24,56,.429,6,16,.375,34,40,.850,100,2014-11-05,UTA,CLE
39,@,L 102-106 ,240,36,80,.450,26,55,.473,10,25,.400,20,25,.800,102,40,81,.494,35,69,.507,5,12,.417,21,30,.700,106,2014-11-08,POR,LAC
40,Home,W 102-92 ,240,41,78,.526,36,65,.554,5,13,.385,15,17,.882,102,35,87,.402,31,71,.437,4,16,.250,18,23,.783,92,2014-11-08,MIA,MIN
41,Home,W 102-91 ,240,39,88,.443,32,68,.471,7,20,.350,17,20,.850,102,34,80,.425,27,66,.409,7,14,.500,16,25,.640,91,2014-11-10,CHI,DET
42,@,L 102-107 ,240,41,87,.471,34,65,.523,7,22,.318,13,17,.765,102,41,78,.526,37,67,.552,4,11,.364,21,26,.808,107,2014-11-11,LAL,MEM
43,Home,W 102-100 ,240,40,93,.430,32,68,.471,8,25,.320,14,16,.875,102,35,75,.467,28,59,.475,7,16,.438,23,27,.852,100,2014-11-11,POR,CHO
44,@,L 102-109 ,240,35,84,.417,28,63,.444,7,21,.333,25,32,.781,102,45,82,.549,37,63,.587,8,19,.421,11,18,.611,109,2014-11-12,LAL,NOP
45,@,W 102-100 ,240,36,70,.514,26,48,.542,10,22,.455,20,25,.800,102,39,82,.476,34,74,.459,5,8,.625,17,20,.850,100,2014-11-14,UTA,NYK
46,Home,W 102-93 ,240,38,76,.500,31,57,.544,7,19,.368,19,23,.826,102,38,85,.447,33,66,.500,5,19,.263,12,19,.632,93,2014-11-17,POR,NOP
47,Home,L 102-105 ,240,37,84,.440,27,62,.435,10,22,.455,18,21,.857,102,34,82,.415,22,54,.407,12,28,.429,25,29,.862,105,2014-11-19,WAS,DAL
48,Home,L 102-106 ,240,36,84,.429,27,64,.422,9,20,.450,21,29,.724,102,36,85,.424,29,60,.483,7,25,.280,27,34,.794,106,2014-11-25,WAS,ATL
49,@,L 102-109 (OT),265,39,92,.424,25,64,.391,14,28,.500,10,16,.625,102,38,95,.400,34,64,.531,4,31,.129,29,38,.763,109,2014-11-26,NYK,DAL
50,Home,W 102-89 ,240,42,94,.447,30,59,.508,12,35,.343,6,15,.400,102,31,71,.437,26,55,.473,5,16,.313,22,28,.786,89,2014-11-26,HOU,SAC
51,Home,L 102-109 ,240,37,92,.402,31,70,.443,6,22,.273,22,29,.759,102,37,90,.411,32,73,.438,5,17,.294,30,37,.811,109,2014-11-28,BOS,CHI
52,@,W 102-85 ,240,38,81,.469,29,56,.518,9,25,.360,17,22,.773,102,32,82,.390,22,45,.489,10,37,.270,11,15,.733,85,2014-11-28,LAC,HOU
53,Home,L 102-106 ,240,38,91,.418,24,58,.414,14,33,.424,12,16,.750,102,40,86,.465,29,60,.483,11,26,.423,15,22,.682,106,2014-11-28,TOR,DAL
54,@,W 102-84 ,240,34,69,.493,27,45,.600,7,24,.292,27,34,.794,102,32,86,.372,30,72,.417,2,14,.143,18,24,.750,84,2014-11-30,CHI,BRK
55,@,L 102-109 (OT),265,37,102,.363,29,75,.387,8,27,.296,20,29,.690,102,37,93,.398,24,63,.381,13,30,.433,22,27,.815,109,2014-12-03,DET,BOS
56,@,W 102-95 ,240,37,80,.463,25,52,.481,12,28,.429,16,21,.762,102,36,90,.400,34,75,.453,2,15,.133,21,23,.913,95,2014-12-03,CHI,CHO
57,Home,L 102-112 ,240,36,64,.563,30,48,.625,6,16,.375,24,32,.750,102,40,74,.541,28,49,.571,12,25,.480,20,23,.870,112,2014-12-03,MIA,ATL
58,@,L 102-103 ,240,37,79,.468,27,57,.474,10,22,.455,18,22,.818,102,42,88,.477,38,70,.543,4,18,.222,15,18,.833,103,2014-12-05,NYK,CHO
59,Home,W 102-101 (OT),265,36,83,.434,34,73,.466,2,10,.200,28,40,.700,102,36,96,.375,30,70,.429,6,26,.231,23,29,.793,101,2014-12-05,SAC,IND
60,Home,L 102-112 ,240,36,83,.434,29,62,.468,7,21,.333,23,27,.852,102,40,89,.449,28,59,.475,12,30,.400,20,25,.800,112,2014-12-06,CHI,GSW
61,@,L 102-125 ,240,42,84,.500,38,69,.551,4,15,.267,14,17,.824,102,49,84,.583,37,53,.698,12,31,.387,15,19,.789,125,2014-12-07,MIL,DAL
62,@,W 102-86 ,240,42,91,.462,37,69,.536,5,22,.227,13,14,.929,102,32,88,.364,30,77,.390,2,11,.182,20,29,.690,86,2014-12-08,GSW,MIN
63,Home,W 102-82 ,240,38,85,.447,30,62,.484,8,23,.348,18,27,.667,102,30,82,.366,23,60,.383,7,22,.318,15,21,.714,82,2014-12-10,DEN,MIA
64,Home,W 102-100 ,240,34,78,.436,28,60,.467,6,18,.333,28,45,.622,102,40,90,.444,36,71,.507,4,19,.211,16,23,.696,100,2014-12-17,LAC,IND
65,@,L 102-106 ,240,43,81,.531,35,57,.614,8,24,.333,8,15,.533,102,37,81,.457,25,55,.455,12,26,.462,20,27,.741,106,2014-12-20,MIL,LAC
66,Home,L 102-105 ,240,39,90,.433,28,62,.452,11,28,.393,13,20,.650,102,40,81,.494,33,62,.532,7,19,.368,18,27,.667,105,2014-12-22,DAL,ATL
67,Home,W 102-96 ,240,43,91,.473,37,68,.544,6,23,.261,10,14,.714,102,36,82,.439,29,57,.509,7,25,.280,17,22,.773,96,2014-12-23,BRK,DEN
68,@,W 102-91 ,240,44,86,.512,37,70,.529,7,16,.438,7,10,.700,102,36,80,.450,32,58,.552,4,22,.182,15,19,.789,91,2014-12-25,WAS,NYK
69,Home,W 102-98 ,240,42,83,.506,37,65,.569,5,18,.278,13,24,.542,102,36,99,.364,25,70,.357,11,29,.379,15,20,.750,98,2014-12-26,DAL,LAL
70,@,L 102-106 ,240,41,103,.398,38,88,.432,3,15,.200,17,24,.708,102,39,95,.411,36,76,.474,3,19,.158,25,32,.781,106,2014-12-26,MIN,DEN
71,@,W 102-94 ,240,38,83,.458,30,63,.476,8,20,.400,18,24,.750,102,36,86,.419,28,62,.452,8,24,.333,14,18,.778,94,2014-12-27,ORL,CHO
72,Home,L 102-116 ,240,37,87,.425,33,70,.471,4,17,.235,24,34,.706,102,43,88,.489,33,65,.508,10,23,.435,20,32,.625,116,2014-12-28,DEN,TOR
73,@,W 102-101 ,240,41,77,.532,30,52,.577,11,25,.440,9,13,.692,102,33,63,.524,26,49,.531,7,14,.500,28,40,.700,101,2014-12-29,ORL,MIA
74,Home,W 102-97 (OT),265,38,95,.400,26,59,.441,12,36,.333,14,18,.778,102,40,99,.404,36,77,.468,4,22,.182,13,15,.867,97,2014-12-30,POR,TOR
75,Home,W 102-83 ,240,38,88,.432,21,45,.467,17,43,.395,9,14,.643,102,29,76,.382,26,58,.448,3,18,.167,22,26,.846,83,2014-12-31,HOU,CHO
76,@,L 102-109 ,240,39,84,.464,28,63,.444,11,21,.524,13,15,.867,102,44,83,.530,36,64,.563,8,19,.421,13,19,.684,109,2015-01-02,WAS,OKC
77,@,W 102-96 ,240,37,81,.457,30,56,.536,7,25,.280,21,27,.778,102,37,88,.420,34,68,.500,3,20,.150,19,22,.864,96,2015-01-06,PHO,MIL
78,@,L 102-117 ,240,37,81,.457,31,55,.564,6,26,.231,22,23,.957,102,45,91,.495,33,63,.524,12,28,.429,15,20,.750,117,2015-01-07,IND,GSW
79,Home,W 102-86 ,240,41,86,.477,33,71,.465,8,15,.533,12,19,.632,102,32,83,.386,22,57,.386,10,26,.385,12,19,.632,86,2015-01-09,WAS,CHI
80,Home,L 102-109 ,240,39,76,.513,31,52,.596,8,24,.333,16,23,.696,102,37,78,.474,28,48,.583,9,30,.300,26,36,.722,109,2015-01-15,LAL,CLE
81,@,W 102-80 ,240,37,81,.457,33,69,.478,4,12,.333,24,31,.774,102,31,73,.425,27,56,.482,4,17,.235,14,16,.875,80,2015-01-16,BRK,WAS
82,Home,W 102-98 ,240,39,77,.506,31,62,.500,8,15,.533,16,24,.667,102,36,93,.387,23,57,.404,13,36,.361,13,15,.867,98,2015-01-17,MEM,POR
83,Home,W 102-93 ,240,39,82,.476,30,61,.492,9,21,.429,15,19,.789,102,33,84,.393,21,55,.382,12,29,.414,15,21,.714,93,2015-01-19,LAC,BOS
84,@,W 102-98 ,240,38,78,.487,29,62,.468,9,16,.563,17,20,.850,102,37,82,.451,31,64,.484,6,18,.333,18,18,1.000,98,2015-01-23,CHI,DAL
85,Home,W 102-98 ,240,38,80,.475,31,61,.508,7,19,.368,19,22,.864,102,40,83,.482,32,62,.516,8,21,.381,10,15,.667,98,2015-01-26,LAC,DEN
86,Home,L 102-109 ,240,38,75,.507,31,55,.564,7,20,.350,19,26,.731,102,39,71,.549,30,55,.545,9,16,.563,22,30,.733,109,2015-01-27,MIA,MIL
87,@,L 102-113 ,240,39,87,.448,30,63,.476,9,24,.375,15,18,.833,102,38,82,.463,26,49,.531,12,33,.364,25,26,.962,113,2015-01-28,BRK,ATL
88,@,L 102-119 ,240,35,73,.479,28,56,.500,7,17,.412,25,29,.862,102,43,84,.512,26,50,.520,17,34,.500,16,19,.842,119,2015-01-28,SAC,TOR
89,Home,W 102-100 ,240,41,83,.494,29,56,.518,12,27,.444,8,18,.444,102,42,89,.472,34,66,.515,8,23,.348,8,25,.320,100,2015-02-02,BRK,LAC
90,@,W 102-101 ,240,36,83,.434,33,72,.458,3,11,.273,27,34,.794,102,42,84,.500,36,68,.529,6,16,.375,11,18,.611,101,2015-02-02,MEM,PHO
91,@,L 102-103 ,240,39,85,.459,33,72,.458,6,13,.462,18,26,.692,102,36,76,.474,29,53,.547,7,23,.304,24,34,.706,103,2015-02-03,UTA,POR
92,Home,W 102-101 ,240,37,72,.514,31,61,.508,6,11,.545,22,27,.815,102,39,80,.488,32,64,.500,7,16,.438,16,24,.667,101,2015-02-04,MIN,MIA
93,@,W 102-91 ,240,45,85,.529,40,70,.571,5,15,.333,7,11,.636,102,37,97,.381,30,72,.417,7,25,.280,10,13,.769,91,2015-02-04,OKC,NOP
94,Home,W 102-90 ,240,43,86,.500,38,67,.567,5,19,.263,11,17,.647,102,32,82,.390,29,69,.420,3,13,.231,23,33,.697,90,2015-02-07,UTA,SAC
95,Home,L 102-103 ,240,36,77,.468,28,63,.444,8,14,.571,22,28,.786,102,37,84,.440,30,65,.462,7,19,.368,22,25,.880,103,2015-02-08,CHO,IND
96,Home,W 102-86 ,240,35,86,.407,25,56,.446,10,30,.333,22,23,.957,102,34,93,.366,27,77,.351,7,16,.438,11,11,1.000,86,2015-02-11,POR,LAL
97,@,L 102-113 ,240,31,93,.333,26,75,.347,5,18,.278,35,39,.897,102,39,94,.415,27,56,.482,12,38,.316,23,34,.676,113,2015-02-23,MIN,HOU
98,@,W 102-93 ,240,34,77,.442,20,40,.500,14,37,.378,20,24,.833,102,33,82,.402,24,58,.414,9,24,.375,18,30,.600,93,2015-02-24,CLE,DET
99,Home,W 102-96 ,240,38,74,.514,27,49,.551,11,25,.440,15,19,.789,102,39,92,.424,32,71,.451,7,21,.333,11,15,.733,96,2015-02-25,NOP,BRK
0,Home,W 102-90 ,240,39,80,.488,33,64,.516,6,16,.375,18,25,.720,102,34,84,.405,30,68,.441,4,16,.250,18,23,.783,90,2015-02-25,SAC,MEM
1,Home,W 102-98 ,240,39,84,.464,30,52,.577,9,32,.281,15,17,.882,102,38,85,.447,34,68,.500,4,17,.235,18,20,.900,98,2015-02-27,HOU,BRK
2,@,L 102-104 ,240,41,84,.488,33,63,.524,8,21,.381,12,16,.750,102,39,76,.513,33,60,.550,6,16,.375,20,27,.741,104,2015-02-27,MIA,NOP
3,Home,W 102-93 ,240,38,79,.481,32,63,.508,6,16,.375,20,22,.909,102,35,74,.473,25,53,.472,10,21,.476,13,16,.813,93,2015-03-02,DAL,NOP
4,Home,W 102-93 ,240,37,73,.507,23,39,.590,14,34,.412,14,25,.560,102,34,80,.425,29,66,.439,5,14,.357,20,25,.800,93,2015-03-04,GSW,MIL
5,@,W 102-100 ,240,42,83,.506,38,67,.567,4,16,.250,14,17,.824,102,42,86,.488,31,58,.534,11,28,.393,5,5,1.000,100,2015-03-04,MEM,HOU
6,@,L 102-115 ,240,34,81,.420,25,54,.463,9,27,.333,25,27,.926,102,42,84,.500,29,53,.547,13,31,.419,18,20,.900,115,2015-03-11,ATL,DEN
7,Home,W 102-92 ,240,34,79,.430,22,46,.478,12,33,.364,22,31,.710,102,35,79,.443,30,56,.536,5,23,.217,17,24,.708,92,2015-03-13,TOR,MIA
8,Home,W 102-89 ,240,41,83,.494,35,65,.538,6,18,.333,14,23,.609,102,32,73,.438,27,59,.458,5,14,.357,20,30,.667,89,2015-03-15,PHO,NYK
9,@,L 102-107 ,240,40,87,.460,31,59,.525,9,28,.321,13,14,.929,102,39,80,.488,26,49,.531,13,31,.419,16,24,.667,107,2015-03-18,ORL,DAL
10,Home,L 102-117 ,240,41,87,.471,31,53,.585,10,34,.294,10,12,.833,102,46,92,.500,38,77,.494,8,15,.533,17,24,.708,117,2015-03-21,HOU,PHO
11,Home,W 102-88 ,240,43,84,.512,34,64,.531,9,20,.450,7,12,.583,102,35,79,.443,28,64,.438,7,15,.467,11,18,.611,88,2015-03-27,NOP,SAC
12,@,L 102-109 ,240,40,83,.482,32,58,.552,8,25,.320,14,22,.636,102,39,82,.476,32,64,.500,7,18,.389,24,29,.828,109,2015-03-29,DET,MIA
13,Home,W 102-78 ,240,38,90,.422,29,68,.426,9,22,.409,17,24,.708,102,31,88,.352,26,66,.394,5,22,.227,11,18,.611,78,2015-04-01,CHO,DET
14,@,W 102-86 ,240,38,77,.494,34,55,.618,4,22,.182,22,27,.815,102,29,84,.345,22,67,.328,7,17,.412,21,26,.808,86,2015-04-08,IND,NYK
15,Home,W 102-92 ,240,35,72,.486,31,56,.554,4,16,.250,28,36,.778,102,40,96,.417,36,81,.444,4,15,.267,8,13,.615,92,2015-04-13,SAC,LAL
16,Home,W 102-92 ,240,39,86,.453,33,61,.541,6,25,.240,18,21,.857,102,33,77,.429,27,56,.482,6,21,.286,20,22,.909,92,2015-10-30,CLE,MIA
17,Home,W 102-75 ,240,40,86,.465,31,64,.484,9,22,.409,13,13,1.000,102,31,77,.403,26,61,.426,5,16,.313,8,15,.533,75,2015-10-30,SAS,BRK
18,Home,W 102-96 ,240,37,81,.457,29,55,.527,8,26,.308,20,23,.870,102,36,98,.367,27,68,.397,9,30,.300,15,21,.714,96,2015-11-02,LAC,PHO
19,@,W 102-91 ,240,37,82,.451,32,65,.492,5,17,.294,23,26,.885,102,33,86,.384,26,63,.413,7,23,.304,18,25,.720,91,2015-11-03,TOR,DAL
20,Home,W 102-99 ,240,42,87,.483,34,64,.531,8,23,.348,10,14,.714,102,37,81,.457,30,59,.508,7,22,.318,18,20,.900,99,2015-11-04,WAS,SAS
21,@,L 102-108 ,240,41,79,.519,31,56,.554,10,23,.435,10,15,.667,102,45,88,.511,35,62,.565,10,26,.385,8,12,.667,108,2015-11-06,PHI,CLE
22,@,W 102-93 (OT),265,39,96,.406,32,80,.400,7,16,.438,17,27,.630,102,33,93,.355,22,61,.361,11,32,.344,16,23,.696,93,2015-11-07,MIN,CHI
23,@,W 102-91 ,240,38,79,.481,32,62,.516,6,17,.353,20,31,.645,102,32,77,.416,28,53,.528,4,24,.167,23,32,.719,91,2015-11-11,IND,BOS
24,@,L 102-103 ,240,42,79,.532,32,57,.561,10,22,.455,8,9,.889,102,39,79,.494,31,55,.564,8,24,.333,17,24,.708,103,2015-11-11,MIL,DEN
25,Home,W 102-97 ,240,37,84,.440,33,68,.485,4,16,.250,24,31,.774,102,36,95,.379,21,62,.339,15,33,.455,10,12,.833,97,2015-11-13,CHI,CHO
26,Home,W 102-85 ,240,39,97,.402,31,72,.431,8,25,.320,16,21,.762,102,30,86,.349,25,69,.362,5,17,.294,20,28,.714,85,2015-11-13,OKC,PHI
27,Home,W 102-93 ,240,32,76,.421,22,49,.449,10,27,.370,28,31,.903,102,34,87,.391,26,62,.419,8,25,.320,17,23,.739,93,2015-11-13,ORL,UTA
28,Home,W 102-94 ,240,36,89,.404,26,69,.377,10,20,.500,20,21,.952,102,36,82,.439,31,62,.500,5,20,.250,17,25,.680,94,2015-11-17,NYK,CHO
29,Home,L 102-106 ,240,38,92,.413,30,66,.455,8,26,.308,18,24,.750,102,37,72,.514,30,52,.577,7,20,.350,25,35,.714,106,2015-11-18,BOS,DAL
30,Home,W 102-93 ,240,39,83,.470,31,55,.564,8,28,.286,16,17,.941,102,35,80,.438,29,60,.483,6,20,.300,17,21,.810,93,2015-11-20,DAL,UTA
31,@,W 102-91 ,240,34,78,.436,19,45,.422,15,33,.455,19,24,.792,102,35,77,.455,27,52,.519,8,25,.320,13,17,.765,91,2015-11-20,TOR,LAL
32,Home,W 102-91 ,240,38,90,.422,30,65,.462,8,25,.320,18,24,.750,102,38,86,.442,31,62,.500,7,24,.292,8,16,.500,91,2015-11-20,POR,LAC
33,Home,L 102-107 ,240,35,81,.432,23,53,.434,12,28,.429,20,28,.714,102,34,80,.425,22,55,.400,12,25,.480,27,34,.794,107,2015-11-21,HOU,NYK
34,@,W 102-93 ,240,39,80,.488,36,64,.563,3,16,.188,21,23,.913,102,30,71,.423,20,37,.541,10,34,.294,23,27,.852,93,2015-11-25,MEM,HOU
35,@,W 102-91 ,240,39,77,.506,33,64,.516,6,13,.462,18,25,.720,102,38,75,.507,34,63,.540,4,12,.333,11,17,.647,91,2015-11-25,UTA,LAC
36,Home,L 102-107 ,240,38,86,.442,26,57,.456,12,29,.414,14,17,.824,102,40,94,.426,29,67,.433,11,27,.407,16,20,.800,107,2015-11-29,TOR,PHO
37,Home,W 102-87 ,240,33,85,.388,25,66,.379,8,19,.421,28,56,.500,102,33,87,.379,28,64,.438,5,23,.217,16,27,.593,87,2015-11-30,LAC,POR
38,Home,W 102-95 ,240,34,82,.415,27,59,.458,7,23,.304,27,39,.692,102,39,87,.448,35,69,.507,4,18,.222,13,14,.929,95,2015-12-04,DET,MIL
39,@,W 102-96 ,240,37,89,.416,27,55,.491,10,34,.294,18,25,.720,102,37,89,.416,28,64,.438,9,25,.360,13,19,.684,96,2015-12-05,CHO,CHI
40,Home,W 102-93 ,240,34,74,.459,25,49,.510,9,25,.360,25,32,.781,102,34,83,.410,27,64,.422,7,19,.368,18,20,.900,93,2015-12-07,TOR,LAL
41,@,L 102-107 ,240,42,101,.416,38,80,.475,4,21,.190,14,14,1.000,102,37,85,.435,29,64,.453,8,21,.381,25,30,.833,107,2015-12-16,MIN,NYK
42,Home,W 102-94 ,240,39,84,.464,37,69,.536,2,15,.133,22,31,.710,102,32,73,.438,21,41,.512,11,32,.344,19,26,.731,94,2015-12-18,ORL,POR
43,Home,L 102-105 ,240,43,95,.453,34,69,.493,9,26,.346,7,13,.538,102,43,94,.457,36,74,.486,7,20,.350,12,14,.857,105,2015-12-21,CHI,BRK
44,Home,W 102-95 ,240,33,71,.465,26,43,.605,7,28,.250,29,41,.707,102,29,83,.349,17,42,.405,12,41,.293,25,31,.806,95,2015-12-21,HOU,CHO
45,@,W 102-89 ,240,36,85,.424,29,56,.518,7,29,.241,23,26,.885,102,29,81,.358,21,53,.396,8,28,.286,23,32,.719,89,2015-12-23,BOS,CHO
46,@,W 102-88 ,240,40,80,.500,31,54,.574,9,26,.346,13,14,.929,102,35,75,.467,31,63,.492,4,12,.333,14,18,.778,88,2015-12-26,IND,MIN
47,Home,W 102-100 (OT),265,37,86,.430,31,68,.456,6,18,.333,22,27,.815,102,37,97,.381,30,75,.400,7,22,.318,19,24,.792,100,2015-12-30,CHI,IND
48,@,L 102-111 ,240,38,87,.437,27,59,.458,11,28,.393,15,22,.682,102,41,84,.488,22,51,.431,19,33,.576,10,13,.769,111,2016-01-06,CHO,PHO
49,@,L 102-115 ,240,36,80,.450,30,55,.545,6,25,.240,24,36,.667,102,42,83,.506,29,55,.527,13,28,.464,18,24,.750,115,2016-01-21,LAC,CLE
50,@,W 102-101 ,240,36,72,.500,30,51,.588,6,21,.286,24,29,.828,102,36,80,.450,27,50,.540,9,30,.300,20,26,.769,101,2016-01-21,MEM,DEN
51,Home,W 102-98 ,240,38,94,.404,23,50,.460,15,44,.341,11,16,.688,102,39,85,.459,36,71,.507,3,14,.214,17,22,.773,98,2016-01-22,HOU,MIL
52,@,L 102-108 (OT),265,40,86,.465,30,58,.517,10,28,.357,12,14,.857,102,43,100,.430,37,82,.451,6,18,.333,16,25,.640,108,2016-01-25,ORL,MEM
53,@,W 102-98 ,240,45,83,.542,42,74,.568,3,9,.333,9,10,.900,102,36,71,.507,27,53,.509,9,18,.500,17,23,.739,98,2016-01-26,MIA,BRK
54,Home,W 102-73 ,240,40,81,.494,28,50,.560,12,31,.387,10,15,.667,102,25,68,.368,19,43,.442,6,25,.240,17,21,.810,73,2016-01-27,UTA,CHO
55,Home,W 102-84 ,240,36,84,.429,29,64,.453,7,20,.350,23,26,.885,102,35,85,.412,28,59,.475,7,26,.269,7,12,.583,84,2016-01-29,NYK,PHO
56,@,L 102-115 ,240,38,85,.447,32,68,.471,6,17,.353,20,27,.741,102,44,84,.524,28,49,.571,16,35,.457,11,16,.688,115,2016-02-02,MIA,HOU
57,Home,W 102-95 ,240,42,96,.438,35,75,.467,7,21,.333,11,13,.846,102,32,85,.376,21,51,.412,11,34,.324,20,28,.714,95,2016-02-03,BOS,DET
58,Home,L 102-108 ,240,33,75,.440,22,43,.512,11,32,.344,25,34,.735,102,39,77,.506,31,60,.517,8,17,.471,22,26,.846,108,2016-02-03,LAC,MIN
59,Home,L 102-107 ,240,42,88,.477,36,68,.529,6,20,.300,12,19,.632,102,40,88,.455,29,67,.433,11,21,.524,16,21,.762,107,2016-02-03,SAC,CHI
60,Home,W 102-96 ,240,39,76,.513,29,49,.592,10,27,.370,14,20,.700,102,38,91,.418,25,60,.417,13,31,.419,7,9,.778,96,2016-02-05,ATL,IND
61,@,L 102-106 ,240,34,86,.395,24,56,.429,10,30,.333,24,27,.889,102,39,88,.443,31,64,.484,8,24,.333,20,25,.800,106,2016-02-06,LAL,SAS
62,Home,L 102-116 ,240,36,81,.444,34,69,.493,2,12,.167,28,35,.800,102,47,97,.485,37,73,.507,10,24,.417,12,20,.600,116,2016-02-08,MIN,NOP
63,Home,L 102-105 ,240,38,91,.418,31,66,.470,7,25,.280,19,29,.655,102,41,82,.500,32,58,.552,9,24,.375,14,21,.667,105,2016-02-21,ORL,IND
64,@,W 102-92 ,240,39,89,.438,25,44,.568,14,45,.311,10,12,.833,102,36,86,.419,26,52,.500,10,34,.294,10,16,.625,92,2016-02-22,GSW,ATL
65,@,W 102-91 ,240,37,88,.420,25,58,.431,12,30,.400,16,24,.667,102,38,78,.487,31,66,.470,7,12,.583,8,12,.667,91,2016-02-27,DET,MIL
66,Home,L 102-111 ,240,40,93,.430,37,79,.468,3,14,.214,19,25,.760,102,41,81,.506,27,57,.474,14,24,.583,15,21,.714,111,2016-02-28,IND,POR
67,Home,W 102-89 ,240,39,97,.402,32,76,.421,7,21,.333,17,22,.773,102,38,99,.384,32,80,.400,6,19,.316,7,11,.636,89,2016-03-02,ORL,CHI
68,@,W 102-84 ,240,35,78,.449,30,64,.469,5,14,.357,27,39,.692,102,35,101,.347,28,74,.378,7,27,.259,7,14,.500,84,2016-03-04,PHO,ORL
69,Home,L 102-112 ,240,36,95,.379,27,64,.422,9,31,.290,21,27,.778,102,39,88,.443,34,72,.472,5,16,.313,29,36,.806,112,2016-03-04,PHI,MIA
70,Home,W 102-89 ,240,42,79,.532,38,63,.603,4,16,.250,14,18,.778,102,36,92,.391,30,66,.455,6,26,.231,11,15,.733,89,2016-03-05,NYK,DET
71,@,W 102-96 ,240,38,85,.447,29,58,.500,9,27,.333,17,30,.567,102,39,86,.453,30,56,.536,9,30,.300,9,11,.818,96,2016-03-09,DET,DAL
72,@,W 102-98 ,240,40,88,.455,35,62,.565,5,26,.192,17,25,.680,102,34,91,.374,26,60,.433,8,31,.258,22,28,.786,98,2016-03-11,HOU,BOS
73,@,L 102-118 ,240,40,86,.465,34,65,.523,6,21,.286,16,20,.800,102,46,94,.489,35,70,.500,11,24,.458,15,15,1.000,118,2016-03-17,BRK,CHI
74,@,L 102-113 ,240,31,66,.470,19,36,.528,12,30,.400,28,39,.718,102,40,82,.488,36,67,.537,4,15,.267,29,36,.806,113,2016-03-19,LAC,MEM
75,Home,L 102-117 ,240,38,78,.487,25,45,.556,13,33,.394,13,17,.765,102,46,91,.505,33,66,.500,13,25,.520,12,20,.600,117,2016-03-21,ATL,WAS
76,@,L 102-109 ,240,40,88,.455,31,59,.525,9,29,.310,13,16,.813,102,41,91,.451,29,67,.433,12,24,.500,15,23,.652,109,2016-03-21,SAC,CHI
77,@,L 102-118 ,240,39,98,.398,31,73,.425,8,25,.320,16,19,.842,102,43,80,.538,32,56,.571,11,24,.458,21,25,.840,118,2016-03-23,ORL,DET
78,@,W 102-99 ,240,35,84,.417,27,55,.491,8,29,.276,24,27,.889,102,37,85,.435,30,54,.556,7,31,.226,18,21,.857,99,2016-03-26,BOS,PHO
79,@,W 102-100 ,240,36,85,.424,31,63,.492,5,22,.227,25,28,.893,102,40,106,.377,31,84,.369,9,22,.409,11,15,.733,100,2016-03-28,ATL,CHI
80,Home,W 102-94 ,240,38,87,.437,27,62,.435,11,25,.440,15,23,.652,102,36,86,.419,31,63,.492,5,23,.217,17,27,.630,94,2016-03-29,GSW,WAS
81,Home,W 102-100 (OT),265,37,102,.363,31,82,.378,6,20,.300,22,29,.759,102,41,86,.477,38,69,.551,3,17,.176,15,26,.577,100,2016-03-30,LAL,MIA
82,Home,L 102-115 ,240,34,83,.410,18,46,.391,16,37,.432,18,26,.692,102,44,84,.524,36,61,.590,8,23,.348,19,23,.826,115,2016-04-02,PHI,IND
83,Home,W 102-95 ,240,35,77,.455,30,57,.526,5,20,.250,27,30,.900,102,40,80,.500,34,62,.548,6,18,.333,9,10,.900,95,2016-04-02,SAS,TOR
84,@,W 102-98 ,240,39,74,.527,32,48,.667,7,26,.269,17,22,.773,102,40,85,.471,38,78,.487,2,7,.286,16,20,.800,98,2016-04-03,CHI,MIL
85,Home,L 102-124 ,240,37,88,.420,27,58,.466,10,30,.333,18,27,.667,102,46,87,.529,31,54,.574,15,33,.455,17,24,.708,124,2016-04-05,DEN,OKC
86,Home,W 102-98 ,240,40,86,.465,34,64,.531,6,22,.273,16,19,.842,102,36,85,.424,33,71,.465,3,14,.214,23,28,.821,98,2016-04-08,DEN,SAS
87,@,L 102-110 ,240,34,81,.420,23,57,.404,11,24,.458,23,27,.852,102,42,79,.532,32,57,.561,10,22,.455,16,21,.762,110,2016-04-08,LAL,NOP
88,Home,L 102-109 ,240,32,91,.352,18,54,.333,14,37,.378,24,36,.667,102,43,91,.473,39,75,.520,4,16,.250,19,30,.633,109,2016-04-08,PHI,NYK
89,@,W 102-99 (OT),265,37,83,.446,24,54,.444,13,29,.448,15,19,.789,102,36,82,.439,25,51,.490,11,31,.355,16,23,.696,99,2016-04-08,LAC,UTA
90,@,L 102-105 ,240,36,83,.434,17,43,.395,19,40,.475,11,18,.611,102,40,89,.449,32,65,.492,8,24,.333,17,21,.810,105,2016-04-09,CLE,CHI
91,Home,W 102-90 ,240,41,80,.513,35,61,.574,6,19,.316,14,20,.700,102,36,80,.450,26,53,.491,10,27,.370,8,9,.889,90,2016-04-12,IND,NYK
92,Home,W 102-98 (OT),265,37,87,.425,33,73,.452,4,14,.286,24,32,.750,102,35,87,.402,29,62,.468,6,25,.240,22,25,.880,98,2016-04-12,SAS,OKC
93,Home,W 102-98 ,240,36,80,.450,25,56,.446,11,24,.458,19,27,.704,102,36,86,.419,30,68,.441,6,18,.333,20,29,.690,98,2016-10-26,MEM,MIN
94,Home,L 102-107 ,240,38,92,.413,35,73,.479,3,19,.158,23,26,.885,102,37,83,.446,29,59,.492,8,24,.333,25,33,.758,107,2016-10-26,NOP,DEN
95,@,W 102-94 ,240,36,79,.456,30,61,.492,6,18,.333,24,27,.889,102,28,70,.400,22,50,.440,6,20,.300,32,38,.842,94,2016-10-27,SAS,SAC
96,@,L 102-105 ,240,33,81,.407,24,59,.407,9,22,.409,27,35,.771,102,41,88,.466,37,72,.514,4,16,.250,19,25,.760,105,2016-10-31,DEN,TOR
97,Home,W 102-89 ,240,41,89,.461,33,76,.434,8,13,.615,12,21,.571,102,35,86,.407,28,64,.438,7,22,.318,12,15,.800,89,2016-11-01,DET,NYK
98,@,W 102-99 ,240,39,81,.481,33,59,.559,6,22,.273,18,25,.720,102,35,88,.398,26,66,.394,9,22,.409,20,25,.800,99,2016-11-03,DEN,MIN
99,Home,W 102-94 ,240,38,84,.452,28,54,.519,10,30,.333,16,23,.696,102,38,80,.475,31,62,.500,7,18,.389,11,17,.647,94,2016-11-03,ORL,SAC
0,@,W 102-101 ,240,37,91,.407,23,53,.434,14,38,.368,14,18,.778,102,40,87,.460,26,49,.531,14,38,.368,7,12,.583,101,2016-11-05,CLE,PHI
1,Home,W 102-94 ,240,39,81,.481,31,56,.554,8,25,.320,16,20,.800,102,38,84,.452,33,63,.524,5,21,.238,13,18,.722,94,2016-11-08,SAC,NOP
2,Home,L 102-112 ,240,31,74,.419,19,40,.475,12,34,.353,28,31,.903,102,43,83,.518,32,57,.561,11,26,.423,15,22,.682,112,2016-11-09,OKC,TOR
3,@,W 102-91 ,240,40,81,.494,34,61,.557,6,20,.300,16,19,.842,102,38,81,.469,33,64,.516,5,17,.294,10,19,.526,91,2016-11-12,UTA,MIA
4,@,W 102-96 ,240,36,76,.474,28,55,.509,8,21,.381,22,26,.846,102,35,73,.479,27,45,.600,8,28,.286,18,22,.818,96,2016-11-14,MEM,UTA
5,@,L 102-105 ,240,42,85,.494,34,62,.548,8,23,.348,10,12,.833,102,42,93,.452,33,68,.485,9,25,.360,12,19,.632,105,2016-11-16,DET,NYK
6,@,L 102-109 ,240,38,91,.418,30,68,.441,8,23,.348,18,25,.720,102,42,77,.545,32,49,.653,10,28,.357,15,22,.682,109,2016-11-16,WAS,PHI
7,@,L 102-111 ,240,39,76,.513,27,49,.551,12,27,.444,12,17,.706,102,42,94,.447,30,62,.484,12,32,.375,15,20,.750,111,2016-11-19,UTA,HOU
8,Home,W 102-95 ,240,36,77,.468,25,50,.500,11,27,.407,19,23,.826,102,33,77,.429,24,47,.511,9,30,.300,20,24,.833,95,2016-11-19,LAC,CHI
9,Home,W 102-99 ,240,36,81,.444,25,54,.463,11,27,.407,19,25,.760,102,34,85,.400,25,61,.410,9,24,.375,22,24,.917,99,2016-11-20,SAC,TOR
10,Home,L 102-115 ,240,38,78,.487,24,36,.667,14,42,.333,12,12,1.000,102,43,88,.489,31,65,.477,12,23,.522,17,21,.810,115,2016-11-23,HOU,TOR
11,@,L 102-107 ,240,37,98,.378,25,66,.379,12,32,.375,16,20,.800,102,35,80,.438,27,58,.466,8,22,.364,29,42,.690,107,2016-11-26,NYK,CHO
12,@,L 102-115 ,240,41,89,.461,31,54,.574,10,35,.286,10,12,.833,102,45,81,.556,34,59,.576,11,22,.500,14,17,.824,115,2016-11-26,MIN,GSW
13,Home,L 102-111 ,240,36,81,.444,26,51,.510,10,30,.333,20,28,.714,102,39,79,.494,34,65,.523,5,14,.357,28,35,.800,111,2016-12-04,LAC,IND
14,@,W 102-99 ,240,37,80,.463,27,49,.551,10,31,.323,18,28,.643,102,34,77,.442,27,55,.491,7,22,.318,24,32,.750,99,2016-12-05,OKC,ATL
15,Home,W 102-91 ,240,40,88,.455,32,67,.478,8,21,.381,14,21,.667,102,33,75,.440,31,60,.517,2,15,.133,23,32,.719,91,2016-12-06,DET,CHI
16,@,W 102-99 ,240,36,92,.391,25,50,.500,11,42,.262,19,30,.633,102,34,81,.420,27,53,.509,7,28,.250,24,31,.774,99,2016-12-09,HOU,OKC
17,Home,W 102-95 ,240,36,86,.419,26,59,.441,10,27,.370,20,28,.714,102,36,87,.414,33,66,.500,3,21,.143,20,24,.833,95,2016-12-15,NOP,IND
18,@,W 102-98 ,240,36,83,.434,29,58,.500,7,25,.280,23,29,.793,102,38,93,.409,32,66,.485,6,27,.222,16,25,.640,98,2016-12-16,LAC,MIA
19,@,W 102-100 ,240,36,77,.468,24,54,.444,12,23,.522,18,25,.720,102,35,92,.380,29,54,.537,6,38,.158,24,27,.889,100,2016-12-20,SAS,HOU
20,@,L 102-119 ,240,39,90,.433,28,51,.549,11,39,.282,13,20,.650,102,47,86,.547,31,50,.620,16,36,.444,9,13,.692,119,2016-12-20,DEN,LAC
21,@,L 102-113 ,240,36,77,.468,27,55,.491,9,22,.409,21,29,.724,102,43,87,.494,28,60,.467,15,27,.556,12,19,.632,113,2016-12-21,MIL,CLE
22,Home,L 102-109 ,240,35,82,.427,28,59,.475,7,23,.304,25,29,.862,102,38,92,.413,28,53,.528,10,39,.256,23,27,.852,109,2016-12-22,IND,BOS
23,@,L 102-111 ,240,37,85,.435,27,56,.482,10,29,.345,18,22,.818,102,40,84,.476,32,59,.542,8,25,.320,23,30,.767,111,2016-12-25,LAC,LAL
24,Home,L 102-106 ,240,39,84,.464,30,59,.508,9,25,.360,15,20,.750,102,36,82,.439,25,51,.490,11,31,.355,23,28,.821,106,2016-12-26,LAC,DEN
25,@,L 102-112 ,240,35,76,.461,25,51,.490,10,25,.400,22,28,.786,102,44,86,.512,31,60,.517,13,26,.500,11,16,.688,112,2016-12-26,MEM,ORL
26,Home,W 102-100 ,240,39,87,.448,32,62,.516,7,25,.280,17,21,.810,102,39,79,.494,30,54,.556,9,25,.360,13,18,.722,100,2016-12-26,SAC,PHI
27,@,L 102-107 ,240,40,85,.471,34,64,.531,6,21,.286,16,23,.696,102,40,79,.506,28,50,.560,12,29,.414,15,20,.750,107,2016-12-26,MIL,WAS
28,@,W 102-100 ,240,38,75,.507,29,49,.592,9,26,.346,17,24,.708,102,39,83,.470,35,67,.522,4,16,.250,18,22,.818,100,2016-12-27,UTA,LAL
29,Home,W 102-98 (OT),265,37,101,.366,30,74,.405,7,27,.259,21,27,.778,102,35,93,.376,28,66,.424,7,27,.259,21,26,.808,98,2016-12-28,ATL,NYK
30,Home,W 102-98 ,240,40,87,.460,30,58,.517,10,29,.345,12,21,.571,102,37,94,.394,26,57,.456,11,37,.297,13,18,.722,98,2016-12-28,NOP,LAC
31,Home,W 102-89 ,240,35,74,.473,23,49,.469,12,25,.480,20,22,.909,102,31,79,.392,22,51,.431,9,28,.321,18,23,.783,89,2016-12-28,POR,SAC
32,@,L 102-116 ,240,30,77,.390,20,46,.435,10,31,.323,32,35,.914,102,42,82,.512,25,49,.510,17,33,.515,15,28,.536,116,2017-01-03,MEM,LAL
33,Home,L 102-107 ,240,40,78,.513,32,58,.552,8,20,.400,14,17,.824,102,35,72,.486,23,44,.523,12,28,.429,25,29,.862,107,2017-01-04,SAC,MIA
34,@,W 102-95 ,240,38,85,.447,31,68,.456,7,17,.412,19,22,.864,102,36,79,.456,27,50,.540,9,29,.310,14,17,.824,95,2017-01-05,PHO,DAL
35,Home,W 102-85 ,240,36,89,.404,23,55,.418,13,34,.382,17,20,.850,102,30,75,.400,26,54,.481,4,21,.190,21,25,.840,85,2017-01-07,SAS,CHO
36,Home,W 102-86 ,240,40,93,.430,30,63,.476,10,30,.333,12,16,.750,102,28,82,.341,19,52,.365,9,30,.300,21,28,.750,86,2017-01-11,POR,CLE
37,Home,W 102-93 ,240,36,76,.474,22,38,.579,14,38,.368,16,20,.800,102,28,85,.329,22,62,.355,6,23,.261,31,32,.969,93,2017-01-13,PHI,CHO
38,@,W 102-97 ,240,41,95,.432,32,70,.457,9,25,.360,11,16,.688,102,36,83,.434,30,57,.526,6,26,.231,19,24,.792,97,2017-01-15,DET,LAL
39,Home,W 102-93 ,240,39,82,.476,30,60,.500,9,22,.409,15,19,.789,102,34,81,.420,27,53,.509,7,28,.250,18,19,.947,93,2017-01-20,ATL,CHI
40,Home,W 102-99 ,240,34,83,.410,28,66,.424,6,17,.353,28,33,.848,102,37,84,.440,28,58,.483,9,26,.346,16,21,.762,99,2017-01-21,CHI,SAC
41,@,L 102-105 ,240,41,88,.466,33,58,.569,8,30,.267,12,20,.600,102,38,86,.442,25,56,.446,13,30,.433,16,27,.593,105,2017-01-23,GSW,MIA
42,Home,W 102-86 ,240,37,84,.440,27,59,.458,10,25,.400,18,23,.783,102,31,80,.388,24,57,.421,7,23,.304,17,24,.708,86,2017-01-27,TOR,MIL
43,@,W 102-95 ,240,41,80,.513,30,54,.556,11,26,.423,9,10,.900,102,29,62,.468,19,37,.514,10,25,.400,27,29,.931,95,2017-01-28,MEM,UTA
44,Home,W 102-86 ,240,38,89,.427,32,68,.471,6,21,.286,20,27,.741,102,30,88,.341,21,63,.333,9,25,.360,17,23,.739,86,2017-02-02,SAS,PHI
45,@,L 102-114 ,240,40,83,.482,37,64,.578,3,19,.158,19,22,.864,102,38,80,.475,25,54,.463,13,26,.500,25,33,.758,114,2017-02-03,MEM,OKC
46,Home,W 102-94 ,240,37,80,.463,32,66,.485,5,14,.357,23,32,.719,102,34,87,.391,24,59,.407,10,28,.357,16,21,.762,94,2017-02-03,ORL,TOR
47,@,L 102-125 ,240,35,84,.417,29,61,.475,6,23,.261,26,31,.839,102,48,82,.585,36,60,.600,12,22,.545,17,23,.739,125,2017-02-04,PHI,MIA
48,@,L 102-107 ,240,35,84,.417,25,55,.455,10,29,.345,22,28,.786,102,37,88,.420,21,36,.583,16,52,.308,17,20,.850,107,2017-02-05,LAC,BOS
49,@,L 102-121 ,240,37,86,.430,31,63,.492,6,23,.261,22,26,.846,102,51,97,.526,47,81,.580,4,16,.250,15,24,.625,121,2017-02-08,LAL,DET
50,Home,L 102-107 ,240,37,85,.435,24,48,.500,13,37,.351,15,20,.750,102,40,85,.471,26,51,.510,14,34,.412,13,20,.650,107,2017-02-11,CHO,LAC
51,@,L 102-133 ,240,37,94,.394,29,72,.403,8,22,.364,20,26,.769,102,42,85,.494,24,49,.490,18,36,.500,31,39,.795,133,2017-02-11,PHO,HOU
52,@,W 102-101 ,240,36,84,.429,28,53,.528,8,31,.258,22,29,.759,102,38,75,.507,30,59,.508,8,16,.500,17,25,.680,101,2017-02-12,DET,TOR
53,Home,W 102-89 ,240,40,79,.506,34,58,.586,6,21,.286,16,16,1.000,102,34,78,.436,27,57,.474,7,21,.333,14,19,.737,89,2017-02-13,MIL,DET
54,Home,W 102-92 ,240,40,78,.513,29,52,.558,11,26,.423,11,11,1.000,102,35,84,.417,26,57,.456,9,27,.333,13,23,.565,92,2017-02-24,IND,MEM
55,@,W 102-92 ,240,34,72,.472,23,48,.479,11,24,.458,23,32,.719,102,37,87,.425,29,65,.446,8,22,.364,10,13,.769,92,2017-02-26,UTA,WAS
56,Home,W 102-95 ,240,35,70,.500,25,42,.595,10,28,.357,22,26,.846,102,37,83,.446,26,53,.491,11,30,.367,10,16,.625,95,2017-02-27,CLE,MIL
57,@,W 102-88 ,240,40,95,.421,32,72,.444,8,23,.348,14,20,.700,102,36,82,.439,30,65,.462,6,17,.353,10,15,.667,88,2017-02-27,MIN,SAC
58,@,L 102-105 ,240,33,84,.393,26,63,.413,7,21,.333,29,33,.879,102,36,83,.434,27,55,.491,9,28,.321,24,31,.774,105,2017-03-03,NYK,PHI
59,Home,L 102-112 ,240,36,80,.450,27,50,.540,9,30,.300,21,25,.840,102,41,90,.456,25,63,.397,16,27,.593,14,17,.824,112,2017-03-04,DEN,CHO
60,@,L 102-116 ,240,34,83,.410,24,48,.500,10,35,.286,24,29,.828,102,39,73,.534,30,53,.566,9,20,.450,29,47,.617,116,2017-03-06,BOS,LAC
61,Home,W 102-92 ,240,41,88,.466,35,68,.515,6,20,.300,14,21,.667,102,35,84,.417,29,65,.446,6,19,.316,16,20,.800,92,2017-03-09,OKC,SAS
62,Home,W 101-79 ,240,38,85,.447,35,67,.522,3,18,.167,22,28,.786,101,31,82,.378,28,66,.424,3,16,.188,14,22,.636,79,2011-12-27,POR,SAC
63,Home,W 101-83 ,240,32,75,.427,23,52,.442,9,23,.391,28,35,.800,101,30,77,.390,24,61,.393,6,16,.375,17,22,.773,83,2011-12-28,ATL,WAS
64,Home,L 101-114 ,240,41,80,.513,34,65,.523,7,15,.467,12,20,.600,101,39,78,.500,32,61,.525,7,17,.412,29,34,.853,114,2011-12-30,LAC,CHI
65,Home,L 101-103 ,240,39,83,.470,28,54,.519,11,29,.379,12,20,.600,101,46,93,.495,43,79,.544,3,14,.214,8,14,.571,103,2011-12-30,MIN,MIA
66,@,L 101-115 ,240,40,90,.444,36,76,.474,4,14,.286,17,19,.895,101,45,90,.500,35,69,.507,10,21,.476,15,26,.577,115,2012-01-03,CHA,CLE
67,@,W 101-93 ,240,41,86,.477,37,70,.529,4,16,.250,15,18,.833,101,35,79,.443,32,69,.464,3,10,.300,20,25,.800,93,2012-01-04,PHI,NOH
68,Home,W 101-95 ,240,37,78,.474,27,61,.443,10,17,.588,17,24,.708,101,37,80,.463,28,60,.467,9,20,.450,12,19,.632,95,2012-01-04,SAS,GSW
69,@,W 101-90 ,240,38,76,.500,33,61,.541,5,15,.333,20,24,.833,101,28,83,.337,18,50,.360,10,33,.303,24,32,.750,90,2012-01-07,MIA,NJN
70,Home,L 101-106 ,240,36,77,.468,25,55,.455,11,22,.500,18,21,.857,101,42,78,.538,33,57,.579,9,21,.429,13,19,.684,106,2012-01-09,NJN,ATL
71,Home,W 101-95 (OT),265,42,92,.457,37,76,.487,5,16,.313,12,17,.706,101,41,96,.427,38,75,.507,3,21,.143,10,12,.833,95,2012-01-11,SAS,HOU
72,@,W 101-90 ,240,39,89,.438,29,70,.414,10,19,.526,13,21,.619,101,34,75,.453,26,54,.481,8,21,.381,14,20,.700,90,2012-01-12,CLE,PHO
73,Home,W 101-91 ,240,37,80,.463,29,59,.492,8,21,.381,19,35,.543,101,33,78,.423,25,54,.463,8,24,.333,17,26,.654,91,2012-01-16,LAC,NJN
74,@,W 101-98 ,240,36,81,.444,30,66,.455,6,15,.400,23,33,.697,101,33,71,.465,22,50,.440,11,21,.524,21,28,.750,98,2012-01-20,MIN,LAC
75,Home,W 101-89 ,240,41,88,.466,34,69,.493,7,19,.368,12,21,.571,101,32,80,.400,25,62,.403,7,18,.389,18,25,.720,89,2012-01-23,POR,SAC
76,@,W 101-98 ,240,37,71,.521,32,56,.571,5,15,.333,22,25,.880,101,36,72,.500,29,50,.580,7,22,.318,19,25,.760,98,2012-01-25,MIA,DET
77,Home,W 101-93 ,240,41,79,.519,30,59,.508,11,20,.550,8,14,.571,101,34,83,.410,26,62,.419,8,21,.381,17,20,.850,93,2012-01-25,GSW,POR
78,Home,W 101-91 ,240,34,64,.531,29,51,.569,5,13,.385,28,33,.848,101,35,75,.467,34,68,.500,1,7,.143,20,21,.952,91,2012-01-25,OKC,NOH
79,@,L 101-116 ,240,39,84,.464,34,72,.472,5,12,.417,18,22,.818,101,45,82,.549,34,63,.540,11,19,.579,15,22,.682,116,2012-01-27,UTA,DAL
80,Home,L 101-107 (OT),265,38,93,.409,31,77,.403,7,16,.438,18,22,.818,101,40,82,.488,30,66,.455,10,16,.625,17,25,.680,107,2012-01-27,DET,ATL
81,Home,W 101-100 (OT),265,44,100,.440,40,80,.500,4,20,.200,9,12,.750,101,39,94,.415,27,69,.391,12,25,.480,10,19,.526,100,2012-01-29,DAL,SAS
82,Home,L 101-106 ,240,40,104,.385,35,83,.422,5,21,.238,16,23,.696,101,40,79,.506,32,60,.533,8,19,.421,18,23,.783,106,2012-01-29,MIN,LAL
83,@,L 101-119 ,240,36,79,.456,33,67,.493,3,12,.250,26,34,.765,101,45,96,.469,37,72,.514,8,24,.333,21,25,.840,119,2012-02-02,UTA,GSW
84,Home,W 101-94 ,240,34,71,.479,27,54,.500,7,17,.412,26,33,.788,101,37,87,.425,33,74,.446,4,13,.308,16,20,.800,94,2012-02-03,OKC,MEM
85,Home,L 101-109 ,240,37,85,.435,28,61,.459,9,24,.375,18,27,.667,101,41,79,.519,28,54,.519,13,25,.520,14,22,.636,109,2012-02-09,DEN,GSW
86,@,L 101-106 ,240,37,77,.481,30,59,.508,7,18,.389,20,26,.769,101,40,99,.404,33,79,.418,7,20,.350,19,26,.731,106,2012-02-09,OKC,SAC
87,@,W 101-87 ,240,35,74,.473,31,54,.574,4,20,.200,27,32,.844,101,38,80,.475,35,71,.493,3,9,.333,8,13,.615,87,2012-02-10,OKC,UTA
88,@,W 101-99 ,240,38,80,.475,28,59,.475,10,21,.476,15,18,.833,101,37,69,.536,31,52,.596,6,17,.353,19,27,.704,99,2012-02-15,ATL,PHO
89,Home,W 101-85 ,240,37,72,.514,27,53,.509,10,19,.526,17,24,.708,101,32,81,.395,27,67,.403,5,14,.357,16,20,.800,85,2012-02-19,HOU,UTA
90,@,L 101-103 (OT),265,36,99,.364,30,72,.417,6,27,.222,23,24,.958,101,37,92,.402,32,70,.457,5,22,.227,24,35,.686,103,2012-02-20,MIN,DEN
91,Home,W 101-93 ,240,36,80,.450,28,54,.519,8,26,.308,21,24,.875,101,33,91,.363,26,77,.338,7,14,.500,20,23,.870,93,2012-02-20,OKC,NOH
92,Home,W 101-100 ,240,34,78,.436,25,60,.417,9,18,.500,24,32,.750,101,37,95,.389,30,78,.385,7,17,.412,19,24,.792,100,2012-02-21,CLE,DET
93,Home,W 101-98 ,240,40,87,.460,32,66,.485,8,21,.381,13,21,.619,101,37,83,.446,29,62,.468,8,21,.381,16,26,.615,98,2012-03-03,WAS,CLE
94,Home,L 101-104 ,240,31,80,.388,29,66,.439,2,14,.143,37,39,.949,101,33,68,.485,28,51,.549,5,17,.294,33,44,.750,104,2012-03-04,CHA,NJN
95,@,W 101-96 ,240,38,83,.458,30,64,.469,8,19,.421,17,22,.773,101,31,70,.443,26,55,.473,5,15,.333,29,40,.725,96,2012-03-06,ATL,IND
96,Home,W 101-100 ,240,33,72,.458,23,47,.489,10,25,.400,25,31,.806,101,35,76,.461,24,54,.444,11,22,.500,19,27,.704,100,2012-03-07,NJN,LAC
97,@,L 101-106 ,240,32,81,.395,24,60,.400,8,21,.381,29,37,.784,101,43,92,.467,36,66,.545,7,26,.269,13,19,.684,106,2012-03-07,LAL,WAS
98,Home,L 101-107 (OT),265,44,85,.518,41,75,.547,3,10,.300,10,13,.769,101,37,82,.451,32,63,.508,5,19,.263,28,35,.800,107,2012-03-14,NOH,LAL
99,Home,W 101-96 ,240,38,84,.452,29,59,.492,9,25,.360,16,21,.762,101,35,84,.417,27,63,.429,8,21,.381,18,20,.900,96,2012-03-15,DAL,CHA
0,@,L 101-109 ,240,40,78,.513,32,63,.508,8,15,.533,13,18,.722,101,41,83,.494,31,63,.492,10,20,.500,17,22,.773,109,2012-03-16,DET,PHO
1,@,W 101-92 ,240,39,89,.438,25,60,.417,14,29,.483,9,10,.900,101,39,79,.494,36,70,.514,3,9,.333,11,14,.786,92,2012-03-21,GSW,NOH
2,@,L 101-102 (OT),265,39,87,.448,36,73,.493,3,14,.214,20,25,.800,101,41,103,.398,38,80,.475,3,23,.130,17,26,.654,102,2012-03-24,TOR,CHI
3,@,W 101-99 (OT),265,37,80,.463,31,58,.534,6,22,.273,21,24,.875,101,37,96,.385,28,71,.394,9,25,.360,16,18,.889,99,2012-03-24,DAL,HOU
4,Home,W 101-85 ,240,36,72,.500,31,56,.554,5,16,.313,24,33,.727,101,33,78,.423,24,63,.381,9,15,.600,10,14,.714,85,2012-03-24,LAC,MEM
5,Home,W 101-79 ,240,38,78,.487,32,58,.552,6,20,.300,19,30,.633,101,28,76,.368,22,57,.386,6,19,.316,17,22,.773,79,2012-03-24,NYK,DET
6,Home,L 101-117 ,240,35,74,.473,24,52,.462,11,22,.500,20,24,.833,101,44,81,.543,29,47,.617,15,34,.441,14,19,.737,117,2012-03-26,TOR,ORL
7,Home,L 101-104 ,240,39,91,.429,33,72,.458,6,19,.316,17,18,.944,101,36,86,.419,31,66,.470,5,20,.250,27,34,.794,104,2012-03-27,GSW,LAL
8,@,L 101-108 ,240,42,84,.500,35,61,.574,7,23,.304,10,17,.588,101,44,88,.500,39,77,.506,5,11,.455,15,16,.938,108,2012-03-27,ATL,MIL
9,Home,L 101-113 ,240,39,72,.542,34,58,.586,5,14,.357,18,19,.947,101,44,77,.571,39,63,.619,5,14,.357,20,24,.833,113,2012-03-30,TOR,MIA
10,Home,L 101-104 ,240,37,88,.420,29,56,.518,8,32,.250,19,25,.760,101,40,72,.556,32,53,.604,8,19,.421,16,21,.762,104,2012-04-01,ORL,DEN
11,Home,W 101-88 ,240,37,81,.457,25,57,.439,12,24,.500,15,19,.789,101,32,86,.372,26,67,.388,6,19,.316,18,19,.947,88,2012-04-04,POR,NJN
12,Home,W 101-96 ,240,39,81,.481,35,66,.530,4,15,.267,19,27,.704,101,37,78,.474,30,63,.476,7,15,.467,15,22,.682,96,2012-04-06,ATL,DET
13,Home,W 101-86 ,240,41,83,.494,37,67,.552,4,16,.250,15,21,.714,101,32,87,.368,22,61,.361,10,26,.385,12,20,.600,86,2012-04-15,DEN,HOU
14,@,W 101-98 ,240,36,71,.507,30,53,.566,6,18,.333,23,27,.852,101,41,82,.500,36,66,.545,5,16,.313,11,16,.688,98,2012-04-16,MIA,NJN
15,Home,W 101-74 ,240,44,78,.564,39,63,.619,5,15,.333,8,11,.727,101,28,75,.373,22,52,.423,6,23,.261,12,17,.706,74,2012-04-22,DEN,ORL
16,@,L 101-109 ,240,37,80,.463,26,56,.464,11,24,.458,16,22,.727,101,38,81,.469,33,68,.485,5,13,.385,28,36,.778,109,2012-04-23,CLE,MEM
17,Home,W 101-73 ,240,46,83,.554,44,65,.677,2,18,.111,7,12,.583,101,25,73,.342,21,58,.362,4,15,.267,19,23,.826,73,2012-04-23,WAS,CHA
18,Home,L 101-106 ,240,39,79,.494,29,55,.527,10,24,.417,13,15,.867,101,40,90,.444,32,67,.478,8,23,.348,18,30,.600,106,2012-04-25,OKC,DEN
19,Home,L 101-107 ,240,45,87,.517,43,79,.544,2,8,.250,9,12,.750,101,42,96,.438,33,65,.508,9,31,.290,14,17,.824,107,2012-04-26,GSW,SAS
20,Home,W 101-92 ,240,38,74,.514,33,59,.559,5,15,.333,20,29,.690,101,33,86,.384,31,72,.431,2,14,.143,24,30,.800,92,2012-10-31,LAC,MEM
21,Home,L 101-108 ,240,39,74,.527,30,49,.612,9,25,.360,14,16,.875,101,40,92,.435,26,63,.413,14,29,.483,14,22,.636,108,2012-11-05,LAC,CLE
22,Home,W 101-79 ,240,41,87,.471,33,69,.478,8,18,.444,11,13,.846,101,27,79,.342,21,59,.356,6,20,.300,19,22,.864,79,2012-11-05,SAS,IND
23,Home,W 101-77 ,240,36,90,.400,28,62,.452,8,28,.286,21,28,.750,101,29,86,.337,22,61,.361,7,25,.280,12,20,.600,77,2012-11-09,LAL,GSW
24,@,W 101-91 ,240,40,78,.513,34,63,.540,6,15,.400,15,19,.789,101,34,78,.436,30,60,.500,4,18,.222,19,22,.864,91,2012-11-09,MIL,WAS
25,Home,W 101-97 (OT),265,40,95,.421,37,75,.493,3,20,.150,18,28,.643,101,32,79,.405,23,60,.383,9,19,.474,24,30,.800,97,2012-11-10,CHA,DAL
26,Home,L 101-107 (2OT),290,39,102,.382,30,77,.390,9,25,.360,14,23,.609,101,43,113,.381,38,89,.427,5,24,.208,16,27,.593,107,2012-11-10,GSW,DEN
27,@,W 101-95 ,240,41,81,.506,38,65,.585,3,16,.188,16,16,1.000,101,34,74,.459,31,65,.477,3,9,.333,24,31,.774,95,2012-11-12,BOS,CHI
28,@,L 101-114 ,240,38,87,.437,35,73,.479,3,14,.214,22,26,.846,101,42,77,.545,37,55,.673,5,22,.227,25,31,.806,114,2012-11-13,CLE,BRK
29,@,L 101-107 ,240,39,81,.481,26,54,.481,13,27,.481,10,11,.909,101,39,78,.500,36,67,.537,3,11,.273,26,33,.788,107,2012-11-14,WAS,DAL
30,Home,W 101-80 ,240,37,75,.493,32,59,.542,5,16,.313,22,30,.733,101,30,89,.337,28,75,.373,2,14,.143,18,22,.818,80,2012-11-17,LAC,CHI
31,Home,L 101-105 (OT),265,37,86,.430,27,65,.415,10,21,.476,17,24,.708,101,37,91,.407,28,67,.418,9,24,.375,22,30,.733,105,2012-11-19,DAL,GSW
32,Home,W 101-100 (OT),265,40,92,.435,31,67,.463,9,25,.360,12,21,.571,101,38,89,.427,31,69,.449,7,20,.350,17,24,.708,100,2012-11-21,ATL,WAS
33,@,W 101-94 ,240,35,79,.443,26,58,.448,9,21,.429,22,26,.846,101,34,89,.382,24,61,.393,10,28,.357,16,25,.640,94,2012-11-21,DEN,MIN
34,@,W 101-91 ,240,42,78,.538,31,56,.554,11,22,.500,6,14,.429,101,31,83,.373,23,61,.377,8,22,.364,21,26,.808,91,2012-11-23,ATL,CHA
35,@,L 101-104 ,240,39,83,.470,35,72,.486,4,11,.364,19,20,.950,101,39,81,.481,30,62,.484,9,19,.474,17,23,.739,104,2012-11-25,PHO,PHI
36,@,L 101-108 ,240,36,85,.424,30,66,.455,6,19,.316,23,31,.742,101,42,80,.525,33,65,.508,9,15,.600,15,22,.682,108,2012-11-26,POR,DET
37,@,L 101-117 ,240,42,86,.488,34,63,.540,8,23,.348,9,12,.750,101,44,83,.530,31,57,.544,13,26,.500,16,21,.762,117,2012-11-27,TOR,HOU
38,Home,W 101-78 ,240,34,69,.493,28,59,.475,6,10,.600,27,33,.818,101,28,81,.346,24,63,.381,4,18,.222,18,20,.900,78,2012-11-28,CHI,DAL
39,Home,W 101-95 ,240,37,81,.457,33,62,.532,4,19,.211,23,26,.885,101,31,82,.378,25,60,.417,6,22,.273,27,35,.771,95,2012-11-28,LAC,MIN
40,Home,W 101-97 ,240,39,81,.481,31,67,.463,8,14,.571,15,22,.682,101,37,77,.481,31,61,.508,6,16,.375,17,19,.895,97,2012-11-30,TOR,PHO
41,@,L 101-105 ,240,41,89,.461,33,61,.541,8,28,.286,11,16,.688,101,38,79,.481,31,60,.517,7,19,.368,22,29,.759,105,2012-12-04,MIA,WAS
42,@,W 101-97 ,240,35,81,.432,26,59,.441,9,22,.409,22,27,.815,101,37,87,.425,28,62,.452,9,25,.360,14,23,.609,97,2012-12-08,GSW,WAS
43,Home,W 101-92 ,240,39,67,.582,30,46,.652,9,21,.429,14,22,.636,101,32,75,.427,23,47,.489,9,28,.321,19,20,.950,92,2012-12-10,MIA,ATL
44,@,W 101-94 ,240,37,80,.463,31,63,.492,6,17,.353,21,34,.618,101,34,81,.420,29,68,.426,5,13,.385,21,31,.677,94,2012-12-11,DEN,DET
45,Home,W 101-89 ,240,37,76,.487,27,49,.551,10,27,.370,17,23,.739,101,34,85,.400,26,65,.400,8,20,.400,13,17,.765,89,2012-12-14,HOU,BOS
46,Home,W 101-90 ,240,41,85,.482,33,63,.524,8,22,.364,11,15,.733,101,34,83,.410,31,70,.443,3,13,.231,19,24,.792,90,2012-12-17,PHO,SAC
47,Home,W 101-100 ,240,35,88,.398,25,57,.439,10,31,.323,21,27,.778,101,38,95,.400,28,71,.394,10,24,.417,14,22,.636,100,2012-12-18,LAL,CHA
48,Home,W 101-93 ,240,33,92,.359,19,56,.339,14,36,.389,21,26,.808,101,38,98,.388,38,76,.500,0,22,.000,17,24,.708,93,2012-12-20,POR,DEN
49,Home,W 101-83 ,240,38,73,.521,26,54,.481,12,19,.632,13,16,.813,101,31,86,.360,26,64,.406,5,22,.227,16,21,.762,83,2012-12-29,GSW,BOS
50,@,W 101-97 ,240,37,83,.446,31,67,.463,6,16,.375,21,30,.700,101,40,86,.465,34,64,.531,6,22,.273,11,20,.550,97,2013-01-03,MIN,DEN
51,Home,L 101-115 ,240,39,87,.448,33,73,.452,6,14,.429,17,23,.739,101,45,83,.542,32,50,.640,13,33,.394,12,19,.632,115,2013-01-04,MIL,HOU
52,Home,L 101-108 (OT),265,40,80,.500,32,54,.593,8,26,.308,13,19,.684,101,40,92,.435,37,79,.468,3,13,.231,25,29,.862,108,2013-01-06,DET,CHA
53,Home,W 101-99 ,240,38,87,.437,28,69,.406,10,18,.556,15,18,.833,101,34,80,.425,28,55,.509,6,25,.240,25,30,.833,99,2013-01-07,WAS,OKC
54,Home,L 101-116 ,240,39,98,.398,33,70,.471,6,28,.214,17,22,.773,101,44,87,.506,35,58,.603,9,29,.310,19,28,.679,116,2013-01-11,LAL,OKC
55,Home,W 101-98 (OT),265,40,85,.471,37,73,.507,3,12,.250,18,21,.857,101,35,76,.461,25,51,.490,10,25,.400,18,22,.818,98,2013-01-11,MEM,SAS
56,Home,L 101-108 ,240,37,90,.411,26,68,.382,11,22,.500,16,23,.696,101,39,68,.574,34,57,.596,5,11,.455,25,34,.735,108,2013-01-11,NYK,CHI
57,Home,L 101-104 ,240,43,88,.489,34,66,.515,9,22,.409,6,6,1.000,101,39,81,.481,28,56,.500,11,25,.440,15,19,.789,104,2013-01-12,LAC,ORL
58,@,L 101-108 (OT),265,40,88,.455,29,63,.460,11,25,.440,10,13,.769,101,47,91,.516,43,72,.597,4,19,.211,10,14,.714,108,2013-01-18,TOR,PHI
59,Home,W 101-77 ,240,47,90,.522,43,81,.531,4,9,.444,3,8,.375,101,29,71,.408,26,54,.481,3,17,.176,16,25,.640,77,2013-01-25,MEM,BRK
60,@,L 101-114 ,240,39,88,.443,36,74,.486,3,14,.214,20,33,.606,101,48,83,.578,40,66,.606,8,17,.471,10,17,.588,114,2013-01-25,MIN,WAS
61,@,L 101-102 ,240,37,77,.481,27,57,.474,10,20,.500,17,23,.739,101,37,73,.507,32,62,.516,5,11,.455,23,26,.885,102,2013-01-26,MIN,CHA
62,Home,W 101-100 ,240,35,75,.467,24,50,.480,11,25,.440,20,21,.952,101,40,81,.494,33,65,.508,7,16,.438,13,17,.765,100,2013-01-26,POR,LAC
63,@,L 101-102 ,240,39,85,.459,28,62,.452,11,23,.478,12,17,.706,101,37,78,.474,30,64,.469,7,14,.500,21,30,.700,102,2013-01-28,IND,DEN
64,@,L 101-111 ,240,39,88,.443,35,72,.486,4,16,.250,19,22,.864,101,39,74,.527,33,60,.550,6,14,.429,27,34,.794,111,2013-02-04,CHI,IND
65,Home,L 101-105 ,240,38,89,.427,29,68,.426,9,21,.429,16,20,.800,101,40,77,.519,31,51,.608,9,26,.346,16,23,.696,105,2013-02-11,DAL,ATL
66,@,L 101-108 ,240,40,86,.465,36,70,.514,4,16,.250,17,24,.708,101,41,75,.547,35,62,.565,6,13,.462,20,24,.833,108,2013-02-12,SAC,MEM
67,Home,W 101-77 ,240,41,95,.432,35,76,.461,6,19,.316,13,19,.684,101,26,82,.317,21,66,.318,5,16,.313,20,28,.714,77,2013-02-13,IND,CHA
68,Home,L 101-125 ,240,38,75,.507,32,55,.582,6,20,.300,19,27,.704,101,46,89,.517,30,59,.508,16,30,.533,17,22,.773,125,2013-02-14,LAL,LAC
69,@,L 101-115 ,240,39,83,.470,34,66,.515,5,17,.294,18,24,.750,101,39,78,.500,29,57,.509,10,21,.476,27,33,.818,115,2013-02-19,GSW,UTA
70,@,L 101-107 (OT),265,37,95,.389,33,73,.452,4,22,.182,23,32,.719,101,39,94,.415,34,73,.466,5,21,.238,24,30,.800,107,2013-02-22,SAS,GSW
71,@,W 101-98 ,240,40,81,.494,35,64,.547,5,17,.294,16,19,.842,101,39,78,.500,30,57,.526,9,21,.429,11,15,.733,98,2013-02-26,CLE,CHI
72,@,W 101-97 ,240,37,76,.487,25,56,.446,12,20,.600,15,18,.833,101,40,87,.460,35,73,.479,5,14,.357,12,15,.800,97,2013-02-26,BRK,NOH
73,Home,L 101-125 ,240,37,83,.446,31,64,.484,6,19,.316,21,25,.840,101,46,84,.548,36,62,.581,10,22,.455,23,29,.793,125,2013-02-27,ORL,SAC
74,Home,L 101-105 (OT),265,35,81,.432,29,64,.453,6,17,.353,25,35,.714,101,44,95,.463,41,83,.494,3,12,.250,14,21,.667,105,2013-02-27,SAS,PHO
75,Home,L 101-109 ,240,41,100,.410,36,79,.456,5,21,.238,14,18,.778,101,42,83,.506,31,64,.484,11,19,.579,14,16,.875,109,2013-03-05,PHI,BOS
76,@,L 101-104 ,240,38,87,.437,29,68,.426,9,19,.474,16,19,.842,101,37,90,.411,30,74,.405,7,16,.438,23,29,.793,104,2013-03-06,UTA,CLE
77,@,L 101-117 ,240,38,79,.481,25,50,.500,13,29,.448,12,15,.800,101,47,87,.540,35,58,.603,12,29,.414,11,14,.786,117,2013-03-06,MIL,LAC
78,Home,W 101-83 ,240,40,74,.541,32,60,.533,8,14,.571,13,18,.722,101,33,90,.367,24,70,.343,9,20,.450,8,8,1.000,83,2013-03-06,SAS,CHI
79,@,L 101-112 ,240,40,76,.526,35,59,.593,5,17,.294,16,24,.667,101,41,86,.477,34,67,.507,7,19,.368,23,24,.958,112,2013-03-16,DET,POR
80,Home,L 101-107 ,240,38,83,.458,29,62,.468,9,21,.429,16,16,1.000,101,39,80,.488,34,59,.576,5,21,.238,24,30,.800,107,2013-03-17,DAL,OKC
81,Home,W 101-100 ,240,43,86,.500,38,70,.543,5,16,.313,10,13,.769,101,38,90,.422,26,62,.419,12,28,.429,12,14,.857,100,2013-03-18,PHI,POR
82,@,L 101-116 ,240,36,80,.450,27,54,.500,9,26,.346,20,26,.769,101,37,73,.507,23,45,.511,14,28,.500,28,34,.824,116,2013-03-19,LAC,SAC
83,@,L 101-107 ,240,35,83,.422,30,61,.492,5,22,.227,26,26,1.000,101,35,75,.467,27,59,.458,8,16,.500,29,40,.725,107,2013-03-20,TOR,CHA
84,Home,W 101-72 ,240,41,78,.526,35,58,.603,6,20,.300,13,19,.684,101,29,79,.367,23,59,.390,6,20,.300,8,10,.800,72,2013-03-20,LAC,PHI
85,Home,W 101-100 ,240,37,76,.487,30,65,.462,7,11,.636,20,27,.741,101,43,78,.551,36,60,.600,7,18,.389,7,11,.636,100,2013-03-21,DEN,PHI
86,Home,W 101-98 ,240,40,75,.533,34,57,.596,6,18,.333,15,18,.833,101,41,98,.418,40,79,.506,1,19,.053,15,18,.833,98,2013-03-21,SAC,MIN
87,Home,W 101-95 ,240,37,85,.435,33,71,.465,4,14,.286,23,32,.719,101,39,86,.453,31,58,.534,8,28,.286,9,17,.529,95,2013-03-23,DEN,SAC
88,Home,W 101-92 ,240,37,75,.493,27,55,.491,10,20,.500,17,22,.773,101,36,88,.409,29,71,.408,7,17,.412,13,16,.813,92,2013-03-23,GSW,WAS
89,Home,W 101-95 ,240,37,79,.468,28,53,.528,9,26,.346,18,24,.750,101,34,74,.459,25,49,.510,9,25,.360,18,24,.750,95,2013-03-23,LAC,BRK
90,Home,W 101-97 ,240,40,85,.471,32,63,.508,8,22,.364,13,18,.722,101,37,77,.481,30,57,.526,7,20,.350,16,23,.696,97,2013-03-27,CHI,MIA
91,@,L 101-108 ,240,33,70,.471,27,49,.551,6,21,.286,29,35,.829,101,38,74,.514,25,43,.581,13,31,.419,19,22,.864,108,2013-03-27,MEM,NYK
92,Home,W 101-93 ,240,37,83,.446,32,68,.471,5,15,.333,22,27,.815,101,36,79,.456,31,63,.492,5,16,.313,16,20,.800,93,2013-03-29,MIN,OKC
93,Home,W 101-81 ,240,36,81,.444,28,57,.491,8,24,.333,21,33,.636,101,34,81,.420,27,62,.435,7,19,.368,6,12,.500,81,2013-04-02,LAL,DAL
94,@,L 101-126 ,240,35,77,.455,28,60,.467,7,17,.412,24,25,.960,101,52,93,.559,43,72,.597,9,21,.429,13,18,.722,126,2013-04-03,PHO,LAC
95,@,W 101-90 ,240,37,80,.463,28,64,.438,9,16,.563,18,24,.750,101,34,73,.466,29,56,.518,5,17,.294,17,27,.630,90,2013-04-05,PHI,ATL
96,Home,W 101-83 ,240,41,89,.461,29,53,.547,12,36,.333,7,8,.875,101,29,76,.382,17,46,.370,12,30,.400,13,18,.722,83,2013-04-05,NYK,MIL
97,@,L 101-107 ,240,40,75,.533,34,60,.567,6,15,.400,15,21,.714,101,36,83,.434,30,69,.435,6,14,.429,29,38,.763,107,2013-04-06,DET,MIN
98,@,W 101-98 ,240,37,72,.514,30,54,.556,7,18,.389,20,24,.833,101,37,86,.430,27,69,.391,10,17,.588,14,20,.700,98,2013-04-09,TOR,CHI
99,Home,W 101-98 ,240,37,86,.430,31,56,.554,6,30,.200,21,24,.875,101,38,86,.442,31,74,.419,7,12,.583,15,19,.789,98,2013-04-09,HOU,PHO
0,@,W 101-93 ,240,34,74,.459,26,55,.473,8,19,.421,25,28,.893,101,37,81,.457,31,65,.477,6,16,.375,13,17,.765,93,2013-04-10,BRK,BOS
1,Home,L 101-124 ,240,37,88,.420,30,67,.448,7,21,.333,20,22,.909,101,49,91,.538,41,69,.594,8,22,.364,18,19,.947,124,2013-04-10,PHI,ATL
2,@,W 101-91 ,240,40,79,.506,30,51,.588,10,28,.357,11,17,.647,101,34,79,.430,28,57,.491,6,22,.273,17,24,.708,91,2013-04-12,NYK,CLE
3,@,L 101-109 ,240,41,85,.482,35,62,.565,6,23,.261,13,13,1.000,101,39,71,.549,27,48,.563,12,23,.522,19,28,.679,109,2013-04-12,BOS,MIA
4,@,L 101-108 ,240,39,89,.438,28,69,.406,11,20,.550,12,15,.800,101,42,77,.545,36,60,.600,6,17,.353,18,21,.857,108,2013-04-12,SAC,SAS
5,@,L 101-106 ,240,41,77,.532,37,66,.561,4,11,.364,15,20,.750,101,43,92,.467,36,77,.468,7,15,.467,13,27,.481,106,2013-04-15,WAS,BRK
6,@,L 101-109 ,240,39,87,.448,33,65,.508,6,22,.273,17,21,.810,101,41,83,.494,32,58,.552,9,25,.360,18,22,.818,109,2013-04-15,PHI,DET
7,Home,W 101-94 ,240,40,76,.526,29,56,.518,11,20,.550,10,16,.625,101,39,93,.419,31,78,.397,8,15,.533,8,15,.533,94,2013-10-30,SAS,MEM
8,@,W 101-98 ,240,33,81,.407,27,62,.435,6,19,.316,29,33,.879,101,36,79,.456,30,57,.526,6,22,.273,20,30,.667,98,2013-10-30,OKC,UTA
9,Home,W 101-100 ,240,33,68,.485,25,52,.481,8,16,.500,27,39,.692,101,32,67,.478,25,53,.472,7,14,.500,29,36,.806,100,2013-11-01,BRK,MIA
10,Home,L 101-110 ,240,36,79,.456,30,62,.484,6,17,.353,23,32,.719,101,35,70,.500,23,46,.500,12,24,.500,28,34,.824,110,2013-11-01,SAC,LAC
11,Home,L 101-116 ,240,36,87,.414,26,56,.464,10,31,.323,19,29,.655,101,41,75,.547,35,53,.660,6,22,.273,28,34,.824,116,2013-11-05,POR,HOU
12,@,W 101-91 ,240,42,90,.467,30,64,.469,12,26,.462,5,9,.556,101,31,76,.408,27,60,.450,4,16,.250,25,30,.833,91,2013-11-08,NYK,CHA
13,Home,W 101-94 ,240,38,78,.487,31,56,.554,7,22,.318,18,23,.783,101,39,88,.443,35,75,.467,4,13,.308,12,13,.923,94,2013-11-10,PHO,NOP
14,Home,L 101-113 ,240,36,77,.468,29,60,.483,7,17,.412,22,30,.733,101,37,86,.430,27,65,.415,10,21,.476,29,35,.829,113,2013-11-23,GSW,POR
15,@,L 101-112 ,240,40,100,.400,32,74,.432,8,26,.308,13,17,.765,101,41,79,.519,24,48,.500,17,31,.548,13,16,.813,112,2013-11-23,MIN,HOU
16,Home,W 101-99 ,240,37,78,.474,31,53,.585,6,25,.240,21,26,.808,101,34,73,.466,24,50,.480,10,23,.435,21,29,.724,99,2013-11-23,MIA,ORL
17,Home,L 101-102 ,240,41,87,.471,32,68,.471,9,19,.474,10,13,.769,101,40,88,.455,33,69,.478,7,19,.368,15,21,.714,102,2013-11-26,NOP,GSW
18,Home,L 101-112 ,240,40,83,.482,35,63,.556,5,20,.250,16,20,.800,101,41,75,.547,33,50,.660,8,25,.320,22,25,.880,112,2013-11-29,UTA,PHO
19,@,L 101-108 ,240,36,81,.444,29,64,.453,7,17,.412,22,26,.846,101,38,78,.487,26,54,.481,12,24,.500,20,30,.667,108,2013-11-30,ATL,WAS
20,@,W 101-81 ,240,38,80,.475,27,60,.450,11,20,.550,14,18,.778,101,29,77,.377,26,64,.406,3,13,.231,20,26,.769,81,2013-12-05,LAC,MEM
21,@,W 101-92 ,240,38,86,.442,34,68,.500,4,18,.222,21,28,.750,101,31,87,.356,22,61,.361,9,26,.346,21,27,.778,92,2013-12-10,OKC,ATL
22,Home,L 101-122 ,240,35,78,.449,31,65,.477,4,13,.308,27,33,.818,101,48,89,.539,35,66,.530,13,23,.565,13,15,.867,122,2013-12-11,SAC,UTA
23,Home,W 101-99 (OT),265,38,89,.427,31,68,.456,7,21,.333,18,24,.750,101,42,100,.420,38,86,.442,4,14,.286,11,18,.611,99,2013-12-13,ATL,WAS
24,@,W 101-93 ,240,35,79,.443,23,53,.434,12,26,.462,19,25,.760,101,37,83,.446,32,68,.471,5,15,.333,14,20,.700,93,2013-12-15,MIN,MEM
25,Home,W 101-98 ,240,39,87,.448,34,68,.500,5,19,.263,18,20,.900,101,37,82,.451,30,58,.517,7,24,.292,17,26,.654,98,2013-12-15,OKC,ORL
26,Home,W 101-97 ,240,38,86,.442,31,65,.477,7,21,.333,18,23,.783,101,37,98,.378,29,69,.420,8,29,.276,15,26,.577,97,2013-12-16,BOS,MIN
27,@,W 101-96 ,240,38,88,.432,31,68,.456,7,20,.350,18,28,.643,101,35,81,.432,29,64,.453,6,17,.353,20,27,.741,96,2013-12-16,DET,IND
28,Home,L 101-102 ,240,33,79,.418,22,49,.449,11,30,.367,24,31,.774,101,39,72,.542,28,54,.519,11,18,.611,13,17,.765,102,2013-12-16,NYK,WAS
29,Home,L 101-107 (2OT),290,34,82,.415,26,60,.433,8,22,.364,25,35,.714,101,38,101,.376,21,60,.350,17,41,.415,14,19,.737,107,2013-12-18,MIL,NYK
30,Home,L 101-108 ,240,38,82,.463,31,67,.463,7,15,.467,18,24,.750,101,41,87,.471,34,69,.493,7,18,.389,19,24,.792,108,2013-12-18,PHO,SAS
31,@,W 101-95 ,240,41,80,.513,32,53,.604,9,27,.333,10,17,.588,101,33,79,.418,19,43,.442,14,36,.389,15,26,.577,95,2013-12-25,MIA,LAL
32,@,L 101-115 ,240,37,95,.389,26,66,.394,11,29,.379,16,22,.727,101,44,95,.463,35,62,.565,9,33,.273,18,23,.783,115,2013-12-28,PHI,PHO
33,Home,L 101-105 ,240,37,77,.481,23,45,.511,14,32,.438,13,19,.684,101,39,76,.513,30,59,.508,9,17,.529,18,20,.900,105,2014-01-02,SAS,NYK
34,@,W 101-100 ,240,39,87,.448,33,60,.550,6,27,.222,17,25,.680,101,37,80,.463,27,49,.551,10,31,.323,16,19,.842,100,2014-01-03,GSW,ATL
35,@,W 101-88 ,240,40,79,.506,29,57,.509,11,22,.500,10,13,.769,101,34,82,.415,30,70,.429,4,12,.333,16,17,.941,88,2014-01-03,TOR,WAS
36,@,W 101-99 ,240,40,88,.455,36,74,.486,4,14,.286,17,24,.708,101,36,99,.364,33,77,.429,3,22,.136,24,30,.800,99,2014-01-04,PHI,POR
37,Home,W 101-81 ,240,35,83,.422,24,52,.462,11,31,.355,20,24,.833,101,30,84,.357,23,65,.354,7,19,.368,14,21,.667,81,2014-01-06,LAC,ORL
38,@,W 101-80 ,240,39,85,.459,29,53,.547,10,32,.313,13,20,.650,101,31,80,.388,26,65,.400,5,15,.333,13,18,.722,80,2014-01-07,GSW,MIL
39,@,L 101-112 ,240,35,89,.393,29,55,.527,6,34,.176,25,31,.806,101,40,68,.588,32,50,.640,8,18,.444,24,31,.774,112,2014-01-07,OKC,UTA
40,Home,W 101-88 ,240,37,90,.411,23,59,.390,14,31,.452,13,18,.722,101,30,85,.353,24,61,.393,6,24,.250,22,27,.815,88,2014-01-09,DEN,OKC
41,Home,W 101-85 ,240,35,86,.407,25,61,.410,10,25,.400,21,27,.778,101,32,81,.395,20,50,.400,12,31,.387,9,14,.643,85,2014-01-11,OKC,MIL
42,@,L 101-108 ,240,38,80,.475,29,53,.547,9,27,.333,16,24,.667,101,43,83,.518,37,68,.544,6,15,.400,16,20,.800,108,2014-01-12,ATL,MEM
43,@,W 101-95 ,240,35,67,.522,30,55,.545,5,12,.417,26,31,.839,101,38,87,.437,31,76,.408,7,11,.636,12,17,.706,95,2014-01-13,SAS,NOP
44,Home,L 101-111 ,240,38,82,.463,28,57,.491,10,25,.400,15,21,.714,101,39,74,.527,32,59,.542,7,15,.467,26,35,.743,111,2014-01-17,ORL,CHA
45,@,W 101-86 ,240,38,80,.475,30,57,.526,8,23,.348,17,20,.850,101,31,84,.369,29,64,.453,2,20,.100,22,37,.595,86,2014-01-17,MIA,PHI
46,Home,W 101-90 ,240,40,81,.494,30,53,.566,10,28,.357,11,13,.846,101,33,72,.458,26,53,.491,7,19,.368,17,23,.739,90,2014-01-21,BRK,ORL
47,@,L 101-104 ,240,36,84,.429,32,69,.464,4,15,.267,25,34,.735,101,41,84,.488,33,57,.579,8,27,.296,14,22,.636,104,2014-01-22,DET,MIL
48,@,W 101-83 ,240,43,80,.538,38,67,.567,5,13,.385,10,13,.769,101,32,75,.427,27,48,.563,5,27,.185,14,19,.737,83,2014-01-24,OKC,BOS
49,Home,L 101-103 ,240,37,85,.435,31,67,.463,6,18,.333,21,28,.750,101,37,73,.507,30,56,.536,7,17,.412,22,24,.917,103,2014-01-24,DET,NOP
50,@,W 101-95 ,240,39,86,.453,33,70,.471,6,16,.375,17,23,.739,101,34,71,.479,27,49,.551,7,22,.318,20,25,.800,95,2014-01-24,WAS,PHO
51,@,L 101-104 ,240,39,91,.429,32,71,.451,7,20,.350,16,18,.889,101,38,81,.469,28,57,.491,10,24,.417,18,22,.818,104,2014-01-25,WAS,UTA
52,@,L 101-113 ,240,38,76,.500,32,54,.593,6,22,.273,19,23,.826,101,43,74,.581,35,55,.636,8,19,.421,19,20,.950,113,2014-01-26,SAS,MIA
53,@,W 101-98 ,240,33,78,.423,28,64,.438,5,14,.357,30,42,.714,101,39,100,.390,30,72,.417,9,28,.321,11,13,.846,98,2014-01-29,CHA,DEN
54,Home,W 101-98 ,240,36,81,.444,25,63,.397,11,18,.611,18,21,.857,101,34,78,.436,19,44,.432,15,34,.441,15,24,.625,98,2014-02-03,MIL,NYK
55,@,W 101-92 ,240,35,78,.449,29,60,.483,6,18,.333,25,31,.806,101,31,80,.388,23,52,.442,8,28,.286,22,29,.759,92,2014-02-04,CHI,PHO
56,@,L 101-109 ,240,36,84,.429,26,59,.441,10,25,.400,19,24,.792,101,32,81,.395,28,69,.406,4,12,.333,41,51,.804,109,2014-02-05,TOR,SAC
57,@,W 101-95 ,240,42,85,.494,34,61,.557,8,24,.333,9,13,.692,101,40,90,.444,34,75,.453,6,15,.400,9,11,.818,95,2014-02-08,HOU,MIL
58,@,L 101-108 ,240,39,77,.506,33,65,.508,6,12,.500,17,26,.654,101,36,76,.474,26,52,.500,10,24,.417,26,33,.788,108,2014-02-10,NOP,TOR
59,Home,L 101-106 (OT),265,41,90,.456,32,66,.485,9,24,.375,10,14,.714,101,40,85,.471,30,62,.484,10,23,.435,16,19,.842,106,2014-02-12,NYK,SAC
60,Home,W 101-93 ,240,33,80,.413,28,60,.467,5,20,.250,30,37,.811,101,35,89,.393,29,67,.433,6,22,.273,17,24,.708,93,2014-02-19,CLE,ORL
61,@,W 101-92 ,240,39,86,.453,36,67,.537,3,19,.158,20,24,.833,101,33,79,.418,27,62,.435,6,17,.353,20,28,.714,92,2014-02-19,GSW,SAC
62,@,W 101-90 ,240,39,76,.513,31,58,.534,8,18,.444,15,26,.577,101,35,82,.427,31,61,.508,4,21,.190,16,20,.800,90,2014-02-20,DEN,MIL
63,Home,W 101-92 ,240,40,83,.482,33,61,.541,7,22,.318,14,19,.737,101,38,97,.392,34,75,.453,4,22,.182,12,17,.706,92,2014-02-21,LAL,BOS
64,Home,L 101-110 ,240,42,95,.442,39,80,.488,3,15,.200,14,18,.778,101,42,87,.483,37,69,.536,5,18,.278,21,32,.656,110,2014-02-25,PHO,MIN
65,Home,W 101-93 ,240,41,93,.441,33,69,.478,8,24,.333,11,13,.846,101,34,77,.442,26,52,.500,8,25,.320,17,24,.708,93,2014-02-26,LAC,HOU
66,@,W 101-90 ,240,39,94,.415,30,76,.395,9,18,.500,14,16,.875,101,32,87,.368,27,65,.415,5,22,.227,21,28,.750,90,2014-02-26,ORL,PHI
67,Home,W 101-96 ,240,38,74,.514,32,59,.542,6,15,.400,19,22,.864,101,38,87,.437,26,63,.413,12,24,.500,8,11,.727,96,2014-02-27,IND,MIL
68,Home,L 101-122 ,240,38,79,.481,28,60,.467,10,19,.526,15,20,.750,101,43,90,.478,29,57,.509,14,33,.424,22,24,.917,122,2014-03-04,CLE,SAS
69,@,W 101-89 ,240,40,82,.488,34,60,.567,6,22,.273,15,24,.625,101,38,84,.452,35,70,.500,3,14,.214,10,12,.833,89,2014-03-05,HOU,ORL
70,Home,W 101-92 ,240,36,77,.468,27,48,.563,9,29,.310,20,22,.909,101,37,86,.430,34,69,.493,3,17,.176,15,20,.750,92,2014-03-07,CHA,CLE
71,@,L 101-114 ,240,38,94,.404,34,81,.420,4,13,.308,21,30,.700,101,41,91,.451,35,71,.493,6,20,.300,26,33,.788,114,2014-03-07,DET,MIN
72,Home,W 101-97 ,240,34,70,.486,23,50,.460,11,20,.550,22,31,.710,101,35,71,.493,29,48,.604,6,23,.261,21,24,.875,97,2014-03-10,BRK,TOR
73,@,L 101-112 ,240,39,74,.527,34,59,.576,5,15,.333,18,29,.621,101,41,85,.482,33,65,.508,8,20,.400,22,30,.733,112,2014-03-11,MIL,MIN
74,Home,L 101-110 ,240,39,90,.433,29,54,.537,10,36,.278,13,22,.591,101,38,81,.469,26,57,.456,12,24,.500,22,27,.815,110,2014-03-12,PHO,CLE
75,Home,W 101-87 ,240,37,88,.420,29,68,.426,8,20,.400,19,25,.760,101,34,78,.436,25,56,.446,9,22,.409,10,24,.417,87,2014-03-12,TOR,DET
76,Home,L 101-108 ,240,40,85,.471,35,59,.593,5,26,.192,16,21,.762,101,42,79,.532,29,58,.500,13,21,.619,11,12,.917,108,2014-03-12,UTA,DAL
77,Home,L 101-105 (OT),265,43,97,.443,36,72,.500,7,25,.280,8,10,.800,101,36,90,.400,26,67,.388,10,23,.435,23,29,.793,105,2014-03-14,ORL,WAS
78,@,W 101-94 ,240,39,67,.582,30,46,.652,9,21,.429,14,22,.636,101,35,90,.389,27,64,.422,8,26,.308,16,18,.889,94,2014-03-14,IND,PHI
79,Home,W 101-94 ,240,36,77,.468,28,51,.549,8,26,.308,21,25,.840,101,34,71,.479,23,50,.460,11,21,.524,15,22,.682,94,2014-03-15,WAS,BRK
80,@,W 101-92 ,240,39,68,.574,30,48,.625,9,20,.450,14,18,.778,101,37,89,.416,30,71,.423,7,18,.389,11,16,.688,92,2014-03-16,CHA,MIL
81,Home,W 101-96 ,240,39,77,.506,26,49,.531,13,28,.464,10,12,.833,101,40,81,.494,36,64,.563,4,17,.235,12,15,.800,96,2014-03-19,BOS,MIA
82,Home,W 101-97 ,240,39,79,.494,33,65,.508,6,14,.429,17,25,.680,101,34,80,.425,25,49,.510,9,31,.290,20,28,.714,97,2014-03-29,WAS,ATL
83,Home,W 101-94 ,240,39,79,.494,34,61,.557,5,18,.278,18,24,.750,101,34,93,.366,27,77,.351,7,16,.438,19,28,.679,94,2014-04-02,IND,DET
84,Home,L 101-105 ,240,36,79,.456,26,56,.464,10,23,.435,19,27,.704,101,41,80,.513,35,59,.593,6,21,.286,17,23,.739,105,2014-04-05,PHI,BRK
85,Home,L 101-107 ,240,36,86,.419,28,59,.475,8,27,.296,21,34,.618,101,38,90,.422,33,69,.478,5,21,.238,26,32,.813,107,2014-04-09,LAC,OKC
86,Home,W 101-98 ,240,39,79,.494,28,55,.509,11,24,.458,12,15,.800,101,36,78,.462,28,61,.459,8,17,.471,18,23,.783,98,2014-04-12,DAL,PHO
87,Home,W 101-94 ,240,35,84,.417,28,62,.452,7,22,.318,24,29,.828,101,34,79,.430,32,66,.485,2,13,.154,24,32,.750,94,2014-04-12,DEN,UTA
88,@,L 101-117 ,240,35,82,.427,31,73,.425,4,9,.444,27,33,.818,101,41,81,.506,32,62,.516,9,19,.474,26,36,.722,117,2014-04-12,SAC,LAC
89,Home,W 101-89 ,240,35,79,.443,26,50,.520,9,29,.310,22,30,.733,101,31,77,.403,22,45,.489,9,32,.281,18,22,.818,89,2014-04-14,NOP,OKC
90,@,W 101-86 ,240,41,88,.466,30,65,.462,11,23,.478,8,11,.727,101,32,79,.405,27,64,.422,5,15,.333,17,24,.708,86,2014-04-16,IND,ORL
91,Home,W 101-84 ,240,41,101,.406,37,84,.440,4,17,.235,15,31,.484,101,32,84,.381,28,73,.384,4,11,.364,16,21,.762,84,2014-10-28,NOP,ORL
92,Home,W 101-100 ,240,37,70,.529,23,42,.548,14,28,.500,13,16,.813,101,38,78,.487,30,57,.526,8,21,.381,16,19,.842,100,2014-10-28,SAS,DAL
93,@,L 101-105 ,240,39,86,.453,33,74,.446,6,12,.500,17,23,.739,101,43,82,.524,39,67,.582,4,15,.267,15,20,.750,105,2014-10-29,MIN,MEM
94,@,L 101-107 ,240,36,77,.468,26,50,.520,10,27,.370,19,24,.792,101,41,81,.506,31,58,.534,10,23,.435,15,17,.882,107,2014-11-03,UTA,LAC
95,Home,W 101-82 ,240,37,75,.493,29,50,.580,8,25,.320,19,25,.760,101,31,85,.365,22,64,.344,9,21,.429,11,14,.786,82,2014-11-04,POR,CLE
96,Home,W 101-98 ,240,39,85,.459,30,58,.517,9,27,.333,14,16,.875,101,40,88,.455,35,69,.507,5,19,.263,13,13,1.000,98,2014-11-07,BOS,IND
97,Home,L 101-110 ,240,40,85,.471,29,56,.518,11,29,.379,10,15,.667,101,40,84,.476,34,61,.557,6,23,.261,24,33,.727,110,2014-11-07,DEN,CLE
98,Home,L 101-106 ,240,42,92,.457,34,74,.459,8,18,.444,9,15,.600,101,42,81,.519,35,62,.565,7,19,.368,15,20,.750,106,2014-11-08,CHI,BOS
99,Home,W 101-93 ,240,36,78,.462,30,60,.500,6,18,.333,23,27,.852,101,36,80,.450,30,56,.536,6,24,.250,15,22,.682,93,2014-11-09,OKC,SAC
0,Home,L 101-113 ,240,36,81,.444,30,69,.435,6,12,.500,23,30,.767,101,43,89,.483,30,61,.492,13,28,.464,14,19,.737,113,2014-11-12,MIN,HOU
1,Home,W 101-85 ,240,35,80,.438,25,56,.446,10,24,.417,21,27,.778,101,36,80,.450,34,61,.557,2,19,.105,11,14,.786,85,2014-11-14,ORL,MIL
2,@,W 101-90 ,240,41,83,.494,35,63,.556,6,20,.300,13,21,.619,101,34,86,.395,27,65,.415,7,21,.333,15,21,.714,90,2014-11-19,BOS,PHI
3,Home,W 101-88 ,240,41,82,.500,35,59,.593,6,23,.261,13,19,.684,101,35,82,.427,29,65,.446,6,17,.353,12,19,.632,88,2014-11-21,GSW,UTA
4,Home,L 101-113 ,240,37,90,.411,31,73,.425,6,17,.353,21,27,.778,101,40,81,.494,32,55,.582,8,26,.308,25,30,.833,113,2014-11-22,MIN,SAC
5,@,W 101-94 (OT),265,34,90,.378,24,53,.453,10,37,.270,23,38,.605,101,33,89,.371,30,65,.462,3,24,.125,25,34,.735,94,2014-11-23,DEN,LAL
6,Home,L 101-106 ,240,38,87,.437,32,68,.471,6,19,.316,19,23,.826,101,42,99,.424,35,73,.479,7,26,.269,15,16,.938,106,2014-11-28,CHO,GSW
7,@,L 101-127 ,240,35,82,.427,33,70,.471,2,12,.167,29,40,.725,101,41,80,.513,26,46,.565,15,34,.441,30,36,.833,127,2014-12-01,MIN,LAC
8,Home,L 101-103 ,240,36,84,.429,29,66,.439,7,18,.389,22,30,.733,101,41,87,.471,32,61,.525,9,26,.346,12,17,.706,103,2014-12-01,UTA,DEN
9,Home,L 101-107 ,240,37,80,.463,32,68,.471,5,12,.417,22,26,.846,101,40,84,.476,26,59,.441,14,25,.560,13,16,.813,107,2014-12-05,MEM,SAS
10,@,L 101-102 (OT),265,36,96,.375,30,70,.429,6,26,.231,23,29,.793,101,36,83,.434,34,73,.466,2,10,.200,28,40,.700,102,2014-12-05,IND,SAC
11,Home,L 101-108 (OT),265,34,87,.391,28,64,.438,6,23,.261,27,35,.771,101,40,87,.460,33,64,.516,7,23,.304,21,30,.700,108,2014-12-06,DET,PHI
12,@,L 101-123 ,240,35,83,.422,29,67,.433,6,16,.375,25,32,.781,101,47,82,.573,40,64,.625,7,18,.389,22,25,.880,123,2014-12-06,MIN,SAS
13,Home,W 101-93 ,240,36,88,.409,28,71,.394,8,17,.471,21,26,.808,101,34,93,.366,23,66,.348,11,27,.407,14,21,.667,93,2014-12-07,BOS,WAS
14,Home,W 101-92 ,240,35,74,.473,32,66,.485,3,8,.375,28,36,.778,101,32,79,.405,29,62,.468,3,17,.176,25,37,.676,92,2014-12-08,SAC,UTA
15,@,L 101-105 ,240,42,82,.512,35,59,.593,7,23,.304,10,10,1.000,101,39,79,.494,30,53,.566,9,26,.346,18,21,.857,105,2014-12-09,TOR,CLE
16,@,L 101-114 ,240,34,84,.405,30,63,.476,4,21,.190,29,35,.829,101,41,82,.500,37,61,.607,4,21,.190,28,34,.824,114,2014-12-09,MIL,OKC
17,@,W 101-95 ,240,40,81,.494,34,65,.523,6,16,.375,15,18,.833,101,37,85,.435,30,63,.476,7,22,.318,14,18,.778,95,2014-12-12,NYK,BOS
18,@,W 101-94 ,240,39,73,.534,35,62,.565,4,11,.364,19,24,.792,101,37,83,.446,25,61,.410,12,22,.545,8,12,.667,94,2014-12-19,UTA,ORL
19,@,W 101-99 ,240,43,90,.478,36,70,.514,7,20,.350,8,10,.800,101,38,83,.458,33,63,.524,5,20,.250,18,24,.750,99,2014-12-21,NOP,OKC
20,@,L 101-108 ,240,33,87,.379,23,61,.377,10,26,.385,25,30,.833,101,38,79,.481,31,56,.554,7,23,.304,25,36,.694,108,2014-12-21,LAL,SAC
21,Home,L 101-108 ,240,39,82,.476,31,61,.508,8,21,.381,15,20,.750,101,36,82,.439,28,61,.459,8,21,.381,28,36,.778,108,2014-12-23,MIL,CHO
22,Home,W 101-91 ,240,40,84,.476,33,63,.524,7,21,.333,14,17,.824,101,32,72,.444,26,46,.565,6,26,.231,21,33,.636,91,2014-12-25,MIA,CLE
23,Home,W 101-88 ,240,45,90,.500,40,77,.519,5,13,.385,6,10,.600,101,32,79,.405,26,55,.473,6,24,.250,18,24,.750,88,2014-12-27,WAS,BOS
24,Home,W 101-79 ,240,38,81,.469,22,45,.489,16,36,.444,9,12,.750,101,31,93,.333,24,66,.364,7,27,.259,10,15,.667,79,2014-12-28,POR,NYK
25,Home,W 101-97 ,240,37,81,.457,27,58,.466,10,23,.435,17,22,.773,101,38,92,.413,30,73,.411,8,19,.421,13,22,.591,97,2014-12-29,LAC,UTA
26,Home,L 101-102 ,240,33,63,.524,26,49,.531,7,14,.500,28,40,.700,101,41,77,.532,30,52,.577,11,25,.440,9,13,.692,102,2014-12-29,MIA,ORL
27,@,L 101-109 ,240,37,84,.440,24,53,.453,13,31,.419,14,21,.667,101,40,79,.506,30,50,.600,10,29,.345,19,26,.731,109,2014-12-30,CLE,ATL
28,@,L 101-106 ,240,37,92,.402,32,78,.410,5,14,.357,22,27,.815,101,38,91,.418,30,76,.395,8,15,.533,22,25,.880,106,2015-01-01,DEN,CHI
29,Home,L 101-119 ,240,38,89,.427,26,55,.473,12,34,.353,13,19,.684,101,45,96,.469,32,69,.464,13,27,.481,16,17,.941,119,2015-01-02,BOS,DAL
30,@,W 101-89 ,240,38,75,.507,27,55,.491,11,20,.550,14,21,.667,101,34,86,.395,28,67,.418,6,19,.316,15,18,.833,89,2015-01-03,UTA,MIN
31,Home,W 101-92 ,240,43,78,.551,39,62,.629,4,16,.250,11,18,.611,101,40,82,.488,36,68,.529,4,14,.286,8,13,.615,92,2015-01-03,SAS,WAS
32,Home,L 101-110 ,240,38,89,.427,28,65,.431,10,24,.417,15,18,.833,101,46,84,.548,39,65,.600,7,19,.368,11,16,.688,110,2015-01-05,MIN,DEN
33,Home,L 101-105 ,240,35,81,.432,31,58,.534,4,23,.174,27,34,.794,101,35,74,.473,28,61,.459,7,13,.538,28,30,.933,105,2015-01-05,UTA,IND
34,Home,W 101-91 ,240,39,76,.513,31,60,.517,8,16,.500,15,21,.714,101,34,82,.415,23,56,.411,11,26,.423,12,16,.750,91,2015-01-07,WAS,NYK
35,Home,W 101-84 ,240,36,90,.400,29,69,.420,7,21,.333,22,31,.710,101,30,76,.395,24,62,.387,6,14,.429,18,23,.783,84,2015-01-09,LAL,ORL
36,Home,L 101-110 ,240,39,80,.488,34,62,.548,5,18,.278,18,30,.600,101,41,87,.471,31,67,.463,10,20,.500,18,19,.947,110,2015-01-13,IND,MIN
37,Home,W 101-93 ,240,37,75,.493,31,63,.492,6,12,.500,21,24,.875,101,38,96,.396,29,67,.433,9,29,.310,8,12,.667,93,2015-01-13,WAS,SAS
38,@,L 101-112 ,240,35,81,.432,24,52,.462,11,29,.379,20,28,.714,101,41,86,.477,25,50,.500,16,36,.444,14,19,.737,112,2015-01-15,OKC,HOU
39,@,W 101-99 ,240,32,71,.451,18,40,.450,14,31,.452,23,28,.821,101,42,92,.457,37,79,.468,5,13,.385,10,12,.833,99,2015-01-22,UTA,MIL
40,@,L 101-126 ,240,34,82,.415,30,65,.462,4,17,.235,29,34,.853,101,45,94,.479,28,54,.519,17,40,.425,19,22,.864,126,2015-01-23,SAC,GSW
41,Home,W 101-83 ,240,37,79,.468,31,65,.477,6,14,.429,21,25,.840,101,31,81,.383,22,57,.386,9,24,.375,12,22,.545,83,2015-01-24,MEM,PHI
42,Home,W 101-86 ,240,41,81,.506,30,64,.469,11,17,.647,8,10,.800,101,31,86,.360,25,61,.410,6,25,.240,18,25,.720,86,2015-01-24,MIL,DET
43,Home,W 101-95 ,240,35,83,.422,30,61,.492,5,22,.227,26,30,.867,101,39,82,.476,31,65,.477,8,17,.471,9,13,.692,95,2015-01-25,SAS,MIL
44,Home,W 101-90 ,240,38,80,.475,27,49,.551,11,31,.355,14,22,.636,101,30,84,.357,27,66,.409,3,18,.167,27,32,.844,90,2015-01-30,CLE,SAC
45,@,L 101-114 ,240,39,87,.448,28,55,.509,11,32,.344,12,19,.632,101,41,82,.500,31,57,.544,10,25,.400,22,35,.629,114,2015-01-31,HOU,DET
46,Home,L 101-102 ,240,42,84,.500,36,68,.529,6,16,.375,11,18,.611,101,36,83,.434,33,72,.458,3,11,.273,27,34,.794,102,2015-02-02,PHO,MEM
47,Home,W 101-90 ,240,38,92,.413,30,65,.462,8,27,.296,17,23,.739,101,31,89,.348,23,64,.359,8,25,.320,20,26,.769,90,2015-02-04,HOU,CHI
48,@,L 101-102 ,240,39,80,.488,32,64,.500,7,16,.438,16,24,.667,101,37,72,.514,31,61,.508,6,11,.545,22,27,.815,102,2015-02-04,MIA,MIN
49,@,W 101-78 ,240,41,96,.427,29,62,.468,12,34,.353,7,10,.700,101,29,79,.367,26,58,.448,3,21,.143,17,22,.773,78,2015-02-05,DAL,SAC
50,@,L 101-111 (OT),265,37,89,.416,27,57,.474,10,32,.313,17,24,.708,101,43,105,.410,29,69,.420,14,36,.389,11,16,.688,111,2015-02-07,POR,DAL
51,Home,L 101-112 ,240,37,79,.468,27,48,.563,10,31,.323,17,22,.773,101,39,76,.513,34,64,.531,5,12,.417,29,34,.853,112,2015-02-08,DET,MIN
52,@,L 101-109 ,240,40,100,.400,34,78,.436,6,22,.273,15,26,.577,101,40,83,.482,32,61,.525,8,22,.364,21,26,.808,109,2015-02-20,BOS,SAC
53,@,W 101-83 ,240,40,79,.506,28,46,.609,12,33,.364,9,15,.600,101,37,99,.374,34,80,.425,3,19,.158,6,7,.857,83,2015-02-22,CLE,NYK
54,Home,W 101-93 ,240,40,85,.471,34,67,.507,6,18,.333,15,22,.682,101,34,87,.391,30,70,.429,4,17,.235,21,29,.724,93,2015-02-27,LAL,MIL
55,@,W 101-97 ,240,38,64,.594,34,53,.642,4,11,.364,21,29,.724,101,34,88,.386,27,69,.391,7,19,.368,22,27,.815,97,2015-02-28,MEM,MIN
56,@,W 101-74 ,240,41,92,.446,37,73,.507,4,19,.211,15,17,.882,101,25,84,.298,20,68,.294,5,16,.313,19,24,.792,74,2015-02-28,SAS,PHO
57,Home,L 101-106 ,240,40,109,.367,32,78,.410,8,31,.258,13,17,.765,101,40,95,.421,28,61,.459,12,34,.353,14,17,.824,106,2015-03-01,BOS,GSW
58,Home,L 101-108 ,240,40,90,.444,31,65,.477,9,25,.360,12,18,.667,101,40,97,.412,29,65,.446,11,32,.344,17,23,.739,108,2015-03-01,LAL,OKC
59,Home,L 101-108 ,240,39,89,.438,36,75,.480,3,14,.214,20,25,.800,101,41,79,.519,35,62,.565,6,17,.353,20,23,.870,108,2015-03-08,DET,CHO
60,@,W 101-91 ,240,42,84,.500,37,70,.529,5,14,.357,12,17,.706,101,35,80,.438,25,58,.431,10,22,.455,11,14,.786,91,2015-03-09,MEM,CHI
61,@,W 101-94 ,240,36,77,.468,27,59,.458,9,18,.500,20,26,.769,101,38,90,.422,33,72,.458,5,18,.278,13,21,.619,94,2015-03-12,NYK,LAL
62,Home,W 101-91 ,240,33,89,.371,26,70,.371,7,19,.368,28,33,.848,101,31,82,.378,16,50,.320,15,32,.469,14,19,.737,91,2015-03-13,CHO,CHI
63,Home,L 101-112 ,240,34,76,.447,26,54,.481,8,22,.364,25,36,.694,101,41,77,.532,33,59,.559,8,18,.444,22,32,.688,112,2015-03-20,DAL,MEM
64,Home,W 101-91 ,240,37,78,.474,28,57,.491,9,21,.429,18,25,.720,101,36,91,.396,30,73,.411,6,18,.333,13,16,.813,91,2015-03-20,SAC,CHO
65,Home,W 101-89 ,240,38,81,.469,33,58,.569,5,23,.217,20,23,.870,101,35,88,.398,30,68,.441,5,20,.250,14,20,.700,89,2015-03-20,SAS,BOS
66,Home,W 101-87 ,240,39,81,.481,34,67,.507,5,14,.357,18,22,.818,101,32,89,.360,23,62,.371,9,27,.333,14,21,.667,87,2015-03-22,LAL,PHI
67,Home,W 101-94 ,240,42,87,.483,35,65,.538,7,22,.318,10,13,.769,101,36,85,.424,28,57,.491,8,28,.286,14,18,.778,94,2015-03-24,DAL,SAS
68,@,W 101-99 (OT),265,39,92,.424,33,66,.500,6,26,.231,17,18,.944,101,33,78,.423,27,56,.482,6,22,.273,27,30,.900,99,2015-03-25,LAL,MIN
69,Home,L 101-103 ,240,33,75,.440,28,61,.459,5,14,.357,30,38,.789,101,38,85,.447,29,59,.492,9,26,.346,18,28,.643,103,2015-03-25,WAS,IND
70,Home,W 101-88 ,240,36,79,.456,27,50,.540,9,29,.310,20,24,.833,101,34,75,.453,30,58,.517,4,17,.235,16,23,.696,88,2015-03-30,ATL,MIL
71,Home,L 101-108 ,240,37,84,.440,29,58,.500,8,26,.308,19,27,.704,101,34,77,.442,23,46,.500,11,31,.355,29,40,.725,108,2015-04-02,DAL,HOU
72,Home,L 101-110 ,240,39,88,.443,31,64,.484,8,24,.333,15,16,.938,101,45,85,.529,36,61,.590,9,24,.375,11,18,.611,110,2015-04-03,BOS,MIL
73,@,W 101-95 ,240,34,87,.391,20,58,.345,14,29,.483,19,28,.679,101,37,78,.474,31,61,.508,6,17,.353,15,25,.600,95,2015-04-03,NOP,SAC
74,Home,W 101-87 ,240,43,93,.462,36,77,.468,7,16,.438,8,12,.667,101,31,84,.369,24,63,.381,7,21,.333,18,20,.900,87,2015-04-03,WAS,NYK
75,Home,W 101-91 ,240,37,72,.514,34,59,.576,3,13,.231,24,29,.828,101,38,99,.384,28,67,.418,10,32,.313,5,8,.625,91,2015-04-05,NYK,PHI
76,@,W 101-95 ,240,40,87,.460,32,63,.508,8,24,.333,13,18,.722,101,38,79,.481,33,64,.516,5,15,.333,14,24,.583,95,2015-04-05,UTA,SAC
77,@,L 101-119 ,240,36,75,.480,31,59,.525,5,16,.313,24,35,.686,101,44,88,.500,31,58,.534,13,30,.433,18,24,.750,119,2015-04-08,LAL,DEN
78,@,W 101-99 ,240,39,94,.415,30,64,.469,9,30,.300,14,15,.933,101,41,89,.461,34,69,.493,7,20,.350,10,10,1.000,99,2015-04-10,TOR,ORL
79,@,L 101-110 ,240,35,79,.443,24,55,.436,11,24,.458,20,26,.769,101,42,93,.452,31,62,.500,11,31,.355,15,21,.714,110,2015-04-11,MIN,GSW
80,Home,W 101-90 ,240,39,96,.406,35,75,.467,4,21,.190,19,27,.704,101,38,83,.458,30,60,.500,8,23,.348,6,9,.667,90,2015-04-13,OKC,POR
81,Home,L 101-112 ,240,39,80,.488,28,54,.519,11,26,.423,12,20,.600,101,42,87,.483,27,49,.551,15,38,.395,13,18,.722,112,2015-04-14,PHO,LAC
82,Home,W 101-88 ,240,39,80,.488,30,56,.536,9,24,.375,14,23,.609,101,38,79,.481,31,59,.525,7,20,.350,5,13,.385,88,2015-04-15,BRK,ORL
83,Home,L 101-105 ,240,38,83,.458,33,54,.611,5,29,.172,20,25,.800,101,39,89,.438,27,58,.466,12,31,.387,15,20,.750,105,2015-04-15,PHI,MIA
84,Home,L 101-112 ,240,38,93,.409,32,64,.500,6,29,.207,19,21,.905,101,42,83,.506,32,59,.542,10,24,.417,18,26,.692,112,2015-10-29,NYK,ATL
85,Home,W 101-91 ,240,34,80,.425,25,57,.439,9,23,.391,24,28,.857,101,38,79,.481,35,66,.530,3,13,.231,12,18,.667,91,2015-10-31,MEM,BRK
86,@,W 101-90 ,240,39,94,.415,28,62,.452,11,32,.344,12,16,.750,101,33,79,.418,25,49,.510,8,30,.267,16,28,.571,90,2015-10-31,PHO,POR
87,Home,L 101-106 ,240,34,79,.430,31,66,.470,3,13,.231,30,39,.769,101,41,89,.461,32,59,.542,9,30,.300,15,20,.750,106,2015-11-02,MIN,POR
88,Home,W 101-87 ,240,37,76,.487,29,54,.537,8,22,.364,19,24,.792,101,36,83,.434,31,62,.500,5,21,.238,10,13,.769,87,2015-11-04,ATL,BRK
89,Home,W 101-97 ,240,38,83,.458,30,59,.508,8,24,.333,17,25,.680,101,39,90,.433,33,72,.458,6,18,.333,13,19,.684,97,2015-11-08,CLE,IND
90,Home,W 101-88 ,240,38,84,.452,33,64,.516,5,20,.250,20,27,.741,101,34,77,.442,23,55,.418,11,22,.500,9,12,.750,88,2015-11-10,MIA,LAL
91,Home,L 101-125 ,240,38,97,.392,33,73,.452,5,24,.208,20,26,.769,101,44,86,.512,29,63,.460,15,23,.652,22,29,.759,125,2015-11-10,WAS,OKC
92,Home,W 101-99 ,240,40,100,.400,27,72,.375,13,28,.464,8,12,.667,101,39,79,.494,32,57,.561,7,22,.318,14,18,.778,99,2015-11-11,ORL,LAL
93,Home,L 101-113 ,240,39,88,.443,30,66,.455,9,22,.409,14,23,.609,101,46,82,.561,39,67,.582,7,15,.467,14,18,.778,113,2015-11-11,POR,SAS
94,Home,W 101-92 ,240,37,74,.500,28,58,.483,9,16,.563,18,24,.750,101,34,89,.382,25,57,.439,9,32,.281,15,20,.750,92,2015-11-11,SAC,DET
95,Home,W 101-100 ,240,36,86,.419,30,70,.429,6,16,.375,23,27,.852,101,33,69,.478,25,47,.532,8,22,.364,26,29,.897,100,2015-11-13,MEM,POR
96,Home,W 101-96 ,240,37,79,.468,30,60,.500,7,19,.368,20,26,.769,101,33,74,.446,26,47,.553,7,27,.259,23,35,.657,96,2015-11-14,LAC,DET
97,@,L 101-107 ,240,38,87,.437,23,56,.411,15,31,.484,10,14,.714,101,39,76,.513,29,51,.569,10,25,.400,19,24,.792,107,2015-11-15,TOR,SAC
98,@,L 101-120 ,240,37,77,.481,28,57,.491,9,20,.450,18,20,.900,101,45,93,.484,34,63,.540,11,30,.367,19,25,.760,120,2015-11-16,LAL,PHO
99,@,L 101-104 (OT),265,36,85,.424,32,67,.478,4,18,.222,25,30,.833,101,41,110,.373,32,89,.360,9,21,.429,13,21,.619,104,2015-11-18,MIN,ORL
0,@,L 101-111 ,240,35,82,.427,21,45,.467,14,37,.378,17,21,.810,101,40,79,.506,35,64,.547,5,15,.333,26,33,.788,111,2015-11-22,BOS,BRK
1,Home,W 101-87 ,240,39,83,.470,31,57,.544,8,26,.308,15,15,1.000,101,31,87,.356,21,55,.382,10,32,.313,15,18,.833,87,2015-11-25,CHO,WAS
2,Home,L 101-116 ,240,35,80,.438,23,50,.460,12,30,.400,19,21,.905,101,35,75,.467,21,36,.583,14,39,.359,32,36,.889,116,2015-11-27,MEM,ATL
3,@,W 101-91 ,240,37,77,.481,28,52,.538,9,25,.360,18,19,.947,101,37,86,.430,29,64,.453,8,22,.364,9,15,.600,91,2015-11-27,MIN,SAC
4,@,L 101-120 ,240,39,100,.390,29,75,.387,10,25,.400,13,15,.867,101,39,80,.488,23,50,.460,16,30,.533,26,31,.839,120,2015-11-28,SAC,GSW
5,Home,W 101-87 ,240,38,82,.463,29,64,.453,9,18,.500,16,21,.762,101,29,69,.420,24,52,.462,5,17,.294,24,30,.800,87,2015-11-28,UTA,NOP
6,@,L 101-108 ,240,36,88,.409,29,63,.460,7,25,.280,22,25,.880,101,36,87,.414,28,60,.467,8,27,.296,28,39,.718,108,2015-12-02,NOP,HOU
7,@,L 101-103 ,240,40,90,.444,34,70,.486,6,20,.300,15,18,.833,101,37,82,.451,25,51,.490,12,31,.387,17,25,.680,103,2015-12-05,ORL,LAC
8,Home,L 101-103 ,240,41,90,.456,35,69,.507,6,21,.286,13,18,.722,101,41,92,.446,34,75,.453,7,17,.412,14,17,.824,103,2015-12-07,CHI,PHO
9,@,L 101-108 ,240,33,73,.452,25,54,.463,8,19,.421,27,34,.794,101,39,87,.448,29,57,.509,10,30,.333,20,24,.833,108,2015-12-13,MIN,PHO
10,@,L 101-105 ,240,36,82,.439,28,57,.491,8,25,.320,21,27,.778,101,35,81,.432,22,49,.449,13,32,.406,22,29,.759,105,2015-12-14,NOP,POR
11,Home,L 101-109 ,240,34,77,.442,24,54,.444,10,23,.435,23,31,.742,101,41,88,.466,37,68,.544,4,20,.200,23,29,.793,109,2015-12-18,BOS,ATL
12,@,L 101-109 ,240,39,93,.419,29,60,.483,10,33,.303,13,16,.813,101,40,79,.506,31,59,.525,9,20,.450,20,23,.870,109,2015-12-19,CHO,WAS
13,@,W 101-95 ,240,41,79,.519,36,63,.571,5,16,.313,14,24,.583,101,33,74,.446,25,56,.446,8,18,.444,21,24,.875,95,2015-12-20,MIL,PHO
14,@,L 101-104 ,240,41,83,.494,34,54,.630,7,29,.241,12,17,.706,101,44,84,.524,37,68,.544,7,16,.438,9,13,.692,104,2015-12-23,HOU,ORL
15,Home,L 101-108 ,240,43,79,.544,34,60,.567,9,19,.474,6,13,.462,101,38,77,.494,28,57,.491,10,20,.500,22,23,.957,108,2015-12-26,ORL,MIA
16,Home,W 101-86 ,240,39,81,.481,32,71,.451,7,10,.700,16,17,.941,101,38,86,.442,33,68,.485,5,18,.278,5,6,.833,86,2015-12-26,SAS,DEN
17,@,W 101-97 ,240,33,71,.465,16,30,.533,17,41,.415,18,25,.720,101,36,79,.456,25,54,.463,11,25,.440,14,20,.700,97,2015-12-28,CLE,PHO
18,Home,W 101-95 ,240,37,72,.514,32,55,.582,5,17,.294,22,28,.786,101,39,82,.476,36,71,.507,3,11,.273,14,24,.583,95,2015-12-28,SAS,MIN
19,@,L 101-111 ,240,38,86,.442,31,65,.477,7,21,.333,18,19,.947,101,45,87,.517,30,53,.566,15,34,.441,6,6,1.000,111,2016-01-04,CHO,GSW
20,Home,L 101-107 ,240,37,87,.425,22,48,.458,15,39,.385,12,19,.632,101,40,84,.476,35,66,.530,5,18,.278,22,24,.917,107,2016-01-05,ATL,NYK
21,Home,W 101-92 ,240,39,94,.415,30,72,.417,9,22,.409,14,17,.824,101,35,98,.357,30,73,.411,5,25,.200,17,22,.773,92,2016-01-07,CHI,BOS
22,Home,W 101-98 ,240,31,84,.369,27,68,.397,4,16,.250,35,40,.875,101,37,88,.420,30,66,.455,7,22,.318,17,23,.739,98,2016-01-10,MEM,BOS
23,@,L 101-106 ,240,35,85,.412,23,56,.411,12,29,.414,19,24,.792,101,43,93,.462,40,80,.500,3,13,.231,17,28,.607,106,2016-01-12,CHI,MIL
24,@,W 101-96 ,240,39,84,.464,30,62,.484,9,22,.409,14,18,.778,101,36,81,.444,29,63,.460,7,18,.389,17,23,.739,96,2016-01-12,OKC,MIN
25,@,L 101-106 ,240,38,72,.528,37,64,.578,1,8,.125,24,34,.706,101,38,84,.452,26,57,.456,12,27,.444,18,24,.750,106,2016-01-13,MIL,WAS
26,@,L 101-103 ,240,37,72,.514,22,40,.550,15,32,.469,12,17,.706,101,37,76,.487,28,60,.467,9,16,.563,20,25,.800,103,2016-01-14,DET,MEM
27,Home,L 101-103 ,240,35,83,.422,29,49,.592,6,34,.176,25,34,.735,101,34,74,.459,29,63,.460,5,11,.455,30,42,.714,103,2016-01-14,UTA,SAC
28,@,L 101-108 (OT),265,43,100,.430,34,70,.486,9,30,.300,6,6,1.000,101,40,96,.417,37,86,.430,3,10,.300,25,37,.676,108,2016-01-15,ATL,MIL
29,Home,L 101-111 ,240,42,95,.442,37,69,.536,5,26,.192,12,20,.600,101,44,84,.524,35,63,.556,9,21,.429,14,20,.700,111,2016-01-18,DET,CHI
30,Home,W 101-99 ,240,35,75,.467,27,56,.482,8,19,.421,23,30,.767,101,36,74,.486,30,55,.545,6,19,.316,21,23,.913,99,2016-01-18,MEM,NOP
31,Home,L 101-102 ,240,36,80,.450,27,50,.540,9,30,.300,20,26,.769,101,36,72,.500,30,51,.588,6,21,.286,24,29,.828,102,2016-01-21,DEN,MEM
32,@,L 101-110 ,240,38,89,.427,35,76,.461,3,13,.231,22,26,.846,101,43,96,.448,35,73,.479,8,23,.348,16,21,.762,110,2016-01-22,CHI,BOS
33,Home,W 101-81 ,240,35,75,.467,22,50,.440,13,25,.520,18,21,.857,101,33,81,.407,29,64,.453,4,17,.235,11,17,.647,81,2016-01-22,TOR,MIA
34,@,L 101-104 ,240,40,84,.476,29,55,.527,11,29,.379,10,19,.526,101,36,78,.462,28,56,.500,8,22,.364,24,29,.828,104,2016-01-23,DET,DEN
35,@,L 101-106 ,240,37,79,.468,28,60,.467,9,19,.474,18,22,.818,101,34,68,.500,29,51,.569,5,17,.294,33,36,.917,106,2016-01-23,MEM,MIN
36,@,W 101-82 ,240,36,96,.375,23,60,.383,13,36,.361,16,26,.615,101,27,80,.338,19,51,.373,8,29,.276,20,23,.870,82,2016-01-31,CHO,LAL
37,@,W 101-96 ,240,37,86,.430,32,65,.492,5,21,.238,22,28,.786,101,37,84,.440,29,62,.468,8,22,.364,14,20,.700,96,2016-02-07,DEN,NYK
38,Home,L 101-119 ,240,40,70,.571,36,58,.621,4,12,.333,17,24,.708,101,47,89,.528,41,75,.547,6,14,.429,19,26,.731,119,2016-02-09,MIA,SAS
39,@,W 101-98 ,240,39,88,.443,30,66,.455,9,22,.409,14,22,.636,101,42,96,.438,37,70,.529,5,26,.192,9,10,.900,98,2016-02-19,IND,OKC
40,Home,L 101-121 ,240,34,73,.466,28,52,.538,6,21,.286,27,34,.794,101,47,97,.485,37,65,.569,10,32,.313,17,20,.850,121,2016-02-21,DEN,BOS
41,Home,W 101-93 (OT),265,38,100,.380,36,87,.414,2,13,.154,23,34,.676,101,36,92,.391,31,77,.403,5,15,.333,16,25,.640,93,2016-02-22,MIA,IND
42,@,L 101-108 ,240,28,76,.368,16,47,.340,12,29,.414,33,43,.767,101,44,86,.512,39,70,.557,5,16,.313,15,25,.600,108,2016-02-22,LAL,MIL
43,Home,W 101-89 ,240,39,96,.406,34,80,.425,5,16,.313,18,22,.818,101,36,87,.414,35,74,.473,1,13,.077,16,23,.696,89,2016-02-27,BOS,MIA
44,@,L 101-128 ,240,34,90,.378,27,67,.403,7,23,.304,26,37,.703,101,47,89,.528,34,53,.642,13,36,.361,21,21,1.000,128,2016-02-28,MIN,DAL
45,@,L 101-114 ,240,39,80,.488,29,59,.492,10,21,.476,13,18,.722,101,41,71,.577,29,48,.604,12,23,.522,20,27,.741,114,2016-02-28,TOR,DET
46,@,L 101-107 ,240,39,89,.438,34,71,.479,5,18,.278,18,27,.667,101,41,83,.494,30,57,.526,11,26,.423,14,21,.667,107,2016-03-01,BRK,LAL
47,Home,L 101-104 ,240,45,94,.479,38,65,.585,7,29,.241,4,6,.667,101,42,80,.525,35,55,.636,7,25,.280,13,24,.542,104,2016-03-03,DAL,SAC
48,@,L 101-108 ,240,37,90,.411,28,62,.452,9,28,.321,18,21,.857,101,38,79,.481,25,48,.521,13,31,.419,19,23,.826,108,2016-03-04,IND,CHO
49,@,L 101-116 ,240,42,87,.483,35,65,.538,7,22,.318,10,14,.714,101,43,83,.518,29,59,.492,14,24,.583,16,20,.800,116,2016-03-04,MIN,MIL
50,@,L 101-109 ,240,39,86,.453,28,64,.438,11,22,.500,12,13,.923,101,44,93,.473,38,76,.500,6,17,.353,15,19,.789,109,2016-03-10,CHI,SAS
51,Home,W 101-94 ,240,38,85,.447,25,56,.446,13,29,.448,12,16,.750,101,34,83,.410,30,63,.476,4,20,.200,22,25,.880,94,2016-03-11,LAC,NYK
52,@,W 101-94 (OT),265,32,88,.364,25,66,.379,7,22,.318,30,38,.789,101,35,91,.385,27,63,.429,8,28,.286,16,23,.696,94,2016-03-17,TOR,IND
53,@,W 101-93 ,240,38,87,.437,29,69,.420,9,18,.500,16,23,.696,101,35,83,.422,26,51,.510,9,32,.281,14,20,.700,93,2016-03-19,DEN,CHO
54,@,L 101-122 ,240,40,76,.526,30,52,.577,10,24,.417,11,13,.846,101,46,84,.548,35,65,.538,11,19,.579,19,23,.826,122,2016-03-19,CLE,MIA
55,Home,L 101-122 ,240,39,92,.424,27,62,.435,12,30,.400,11,12,.917,101,45,84,.536,28,42,.667,17,42,.405,15,22,.682,122,2016-03-23,WAS,ATL
56,Home,W 101-90 ,240,41,97,.423,36,65,.554,5,32,.156,14,17,.824,101,35,84,.417,32,71,.451,3,13,.231,17,26,.654,90,2016-03-25,ATL,MIL
57,@,L 101-104 ,240,38,85,.447,31,52,.596,7,33,.212,18,27,.667,101,41,87,.471,32,61,.525,9,26,.346,13,20,.650,104,2016-03-27,HOU,IND
58,@,W 101-88 ,240,39,72,.542,32,54,.593,7,18,.389,16,29,.552,101,33,87,.379,26,59,.441,7,28,.250,15,17,.882,88,2016-03-27,WAS,LAL
59,@,W 101-87 ,240,37,72,.514,32,57,.561,5,15,.333,22,30,.733,101,33,83,.398,27,64,.422,6,19,.316,15,24,.625,87,2016-03-28,SAS,MEM
60,Home,W 101-95 ,240,40,90,.444,27,61,.443,13,29,.448,8,9,.889,101,36,83,.434,26,56,.464,10,27,.370,13,17,.765,95,2016-03-31,NOP,DEN
61,@,W 101-86 ,240,39,81,.481,29,54,.537,10,27,.370,13,17,.765,101,33,78,.423,25,51,.490,8,27,.296,12,19,.632,86,2016-04-03,UTA,PHO
62,@,L 101-112 ,240,39,80,.488,32,64,.500,7,16,.438,16,23,.696,101,45,83,.542,33,58,.569,12,25,.480,10,11,.909,112,2016-04-07,SAS,GSW
63,Home,L 101-105 ,240,41,100,.410,36,78,.462,5,22,.227,14,17,.824,101,41,83,.494,35,66,.530,6,17,.353,17,28,.607,105,2016-04-11,PHO,SAC
64,@,W 101-92 ,240,36,81,.444,25,49,.510,11,32,.344,18,22,.818,101,35,77,.455,26,44,.591,9,33,.273,13,18,.722,92,2016-04-11,DAL,UTA
65,Home,W 101-96 ,240,41,85,.482,35,60,.583,6,25,.240,13,15,.867,101,39,83,.470,30,53,.566,9,30,.300,9,15,.600,96,2016-04-13,LAL,UTA
66,@,L 101-118 ,240,43,88,.489,36,70,.514,7,18,.389,8,9,.889,101,45,86,.523,36,65,.554,9,21,.429,19,21,.905,118,2016-10-29,IND,CHI
67,Home,L 101-103 ,240,40,81,.494,31,61,.508,9,20,.450,12,16,.750,101,42,93,.452,36,68,.529,6,25,.240,13,17,.765,103,2016-11-01,PHI,ORL
68,@,L 101-109 ,240,37,88,.420,28,63,.444,9,25,.360,18,21,.857,101,41,76,.539,28,49,.571,13,27,.481,14,17,.824,109,2016-11-02,DET,BRK
69,Home,L 101-102 ,240,40,87,.460,26,49,.531,14,38,.368,7,12,.583,101,37,91,.407,23,53,.434,14,38,.368,14,18,.778,102,2016-11-05,PHI,CLE
70,@,W 101-99 ,240,37,78,.474,27,48,.563,10,30,.333,17,22,.773,101,33,84,.393,26,61,.426,7,23,.304,26,30,.867,99,2016-11-09,HOU,SAS
71,Home,L 101-125 ,240,38,94,.404,25,58,.431,13,36,.361,12,17,.706,101,46,85,.541,32,55,.582,14,30,.467,19,20,.950,125,2016-11-10,DEN,GSW
72,@,W 101-91 ,240,38,74,.514,29,47,.617,9,27,.333,16,22,.727,101,34,85,.400,26,64,.406,8,21,.381,15,20,.750,91,2016-11-10,LAL,SAC
73,@,L 101-113 ,240,33,88,.375,21,54,.389,12,34,.353,23,26,.885,101,45,82,.549,36,58,.621,9,24,.375,14,20,.700,113,2016-11-18,POR,NOP
74,Home,W 101-94 ,240,37,78,.474,26,52,.500,11,26,.423,16,20,.800,101,34,88,.386,27,57,.474,7,31,.226,19,28,.679,94,2016-11-21,PHI,MIA
75,@,L 101-106 ,240,39,91,.429,28,64,.438,11,27,.407,12,15,.800,101,37,91,.407,27,63,.429,10,28,.357,22,34,.647,106,2016-11-21,PHO,WAS
76,@,L 101-116 ,240,32,76,.421,25,51,.490,7,25,.280,30,38,.789,101,44,94,.468,32,66,.485,12,28,.429,16,17,.941,116,2016-11-23,OKC,SAC
77,Home,W 101-95 (OT),265,35,85,.412,25,60,.417,10,25,.400,21,26,.808,101,38,93,.409,35,72,.486,3,21,.143,16,26,.615,95,2016-11-28,WAS,SAC
78,@,L 101-118 ,240,32,75,.427,18,36,.500,14,39,.359,23,31,.742,101,46,86,.535,39,67,.582,7,19,.368,19,23,.826,118,2016-11-29,CLE,MIL
79,@,L 101-120 ,240,37,91,.407,26,61,.426,11,30,.367,16,22,.727,101,41,74,.554,26,46,.565,15,28,.536,23,27,.852,120,2016-11-29,HOU,UTA
80,Home,W 101-92 ,240,41,89,.461,35,61,.574,6,28,.214,13,26,.500,101,36,98,.367,30,70,.429,6,28,.214,14,19,.737,92,2016-12-04,OKC,NOP
81,Home,L 101-109 ,240,37,89,.416,24,53,.453,13,36,.361,14,18,.778,101,40,79,.506,37,61,.607,3,18,.167,26,28,.929,109,2016-12-05,DAL,CHO
82,Home,L 101-107 ,240,39,87,.448,34,73,.466,5,14,.357,18,23,.783,101,38,80,.475,25,48,.521,13,32,.406,18,29,.621,107,2016-12-05,LAL,UTA
83,@,W 101-94 ,240,34,82,.415,25,62,.403,9,20,.450,24,27,.889,101,31,83,.373,14,41,.341,17,42,.405,15,22,.682,94,2016-12-09,TOR,BOS
84,@,L 101-130 ,240,36,87,.414,29,60,.483,7,27,.259,22,25,.880,101,50,94,.532,36,68,.529,14,26,.538,16,18,.889,130,2016-12-10,BRK,SAS
85,@,L 101-112 ,240,39,84,.464,34,61,.557,5,23,.217,18,22,.818,101,45,88,.511,36,62,.581,9,26,.346,13,19,.684,112,2016-12-12,WAS,MIA
86,@,L 101-108 ,240,37,84,.440,27,53,.509,10,31,.323,17,20,.850,101,44,80,.550,36,58,.621,8,22,.364,12,14,.857,108,2016-12-14,BOS,SAS
87,@,L 101-114 ,240,39,90,.433,31,68,.456,8,22,.364,15,20,.750,101,41,81,.506,34,65,.523,7,16,.438,25,34,.735,114,2016-12-17,PHO,OKC
88,Home,L 101-117 ,240,38,86,.442,25,51,.490,13,35,.371,12,16,.750,101,47,104,.452,35,67,.522,12,37,.324,11,14,.786,117,2016-12-22,BRK,GSW
89,@,L 101-106 ,240,37,92,.402,31,73,.425,6,19,.316,21,25,.840,101,39,83,.470,28,55,.509,11,28,.393,17,22,.773,106,2016-12-22,SAS,LAC
90,Home,W 101-99 ,240,35,88,.398,32,75,.427,3,13,.231,28,29,.966,101,37,86,.430,24,53,.453,13,33,.394,12,16,.750,99,2016-12-28,CHI,BRK
91,Home,L 101-120 ,240,42,86,.488,33,52,.635,9,34,.265,8,10,.800,101,46,84,.548,36,60,.600,10,24,.417,18,19,.947,120,2016-12-28,ORL,CHO
92,@,W 101-89 ,240,38,77,.494,24,46,.522,14,31,.452,11,14,.786,101,32,68,.471,25,49,.510,7,19,.368,18,25,.720,89,2016-12-29,DAL,LAL
93,@,L 101-111 ,240,35,84,.417,29,61,.475,6,23,.261,25,31,.806,101,39,81,.481,32,62,.516,7,19,.368,26,30,.867,111,2016-12-30,CHI,IND
94,@,W 101-89 ,240,39,93,.419,32,69,.464,7,24,.292,16,20,.800,101,33,78,.423,27,51,.529,6,27,.222,17,23,.739,89,2017-01-02,UTA,BRK
95,Home,W 101-91 ,240,37,86,.430,25,47,.532,12,39,.308,15,21,.714,101,38,87,.437,32,61,.525,6,26,.231,9,12,.750,91,2017-01-02,HOU,WAS
96,Home,W 101-93 ,240,36,91,.396,28,70,.400,8,21,.381,21,28,.750,101,34,73,.466,27,53,.509,7,20,.350,18,21,.857,93,2017-01-05,TOR,UTA
97,Home,L 101-107 ,240,37,80,.463,28,57,.491,9,23,.391,18,20,.900,101,41,84,.488,31,52,.596,10,32,.313,15,18,.833,107,2017-01-08,MIL,WAS
98,Home,W 101-92 ,240,40,71,.563,34,55,.618,6,16,.375,15,21,.714,101,36,78,.462,23,50,.460,13,28,.464,7,9,.778,92,2017-01-09,MIN,DAL
99,Home,W 101-99 ,240,42,83,.506,31,61,.508,11,22,.500,6,9,.667,101,35,88,.398,25,61,.410,10,27,.370,19,21,.905,99,2017-01-10,WAS,CHI
0,Home,L 101-103 ,240,36,84,.429,25,54,.463,11,30,.367,18,21,.857,101,36,83,.434,19,39,.487,17,44,.386,14,19,.737,103,2017-01-13,ATL,BOS
1,@,L 101-116 ,240,35,84,.417,23,55,.418,12,29,.414,19,27,.704,101,44,89,.494,36,67,.537,8,22,.364,20,23,.870,116,2017-01-15,NYK,TOR
2,Home,L 101-106 ,240,40,81,.494,35,59,.593,5,22,.227,16,17,.941,101,41,89,.461,33,66,.500,8,23,.348,16,24,.667,106,2017-01-16,PHO,UTA
3,@,L 101-120 ,240,37,88,.420,29,62,.468,8,26,.308,19,25,.760,101,42,86,.488,29,63,.460,13,23,.565,23,25,.920,120,2017-01-16,POR,WAS
4,@,L 101-104 ,240,33,83,.398,25,58,.431,8,25,.320,27,34,.794,101,36,80,.450,28,51,.549,8,29,.276,24,26,.923,104,2017-01-18,MEM,WAS
5,Home,L 101-104 ,240,42,87,.483,38,65,.585,4,22,.182,13,24,.542,101,40,84,.476,35,68,.515,5,16,.313,19,25,.760,104,2017-01-19,LAC,MIN
6,Home,W 101-99 ,240,36,78,.462,26,56,.464,10,22,.455,19,25,.760,101,39,92,.424,29,58,.500,10,34,.294,11,19,.579,99,2017-01-25,MEM,TOR
7,@,L 101-120 ,240,34,83,.410,23,44,.523,11,39,.282,22,25,.880,101,47,87,.540,42,66,.636,5,21,.238,21,26,.808,120,2017-01-29,HOU,IND
8,Home,L 101-105 ,240,39,83,.470,31,61,.508,8,22,.364,15,23,.652,101,39,87,.448,27,53,.509,12,34,.353,15,16,.938,105,2017-01-29,SAS,DAL
9,@,L 101-117 ,240,34,93,.366,29,69,.420,5,24,.208,28,35,.800,101,49,88,.557,42,66,.636,7,22,.318,12,15,.800,117,2017-01-31,NYK,WAS
10,Home,L 101-102 ,240,38,75,.507,30,59,.508,8,16,.500,17,25,.680,101,36,84,.429,28,53,.528,8,31,.258,22,29,.759,102,2017-02-12,TOR,DET
11,@,L 101-137 ,240,35,93,.376,26,67,.388,9,26,.346,22,28,.786,101,49,88,.557,39,64,.609,10,24,.417,29,34,.853,137,2017-02-15,LAL,PHO
12,@,W 101-90 ,240,34,81,.420,26,52,.500,8,29,.276,25,31,.806,101,34,83,.410,29,58,.500,5,25,.200,17,22,.773,90,2017-03-01,NYK,ORL
13,@,L 101-112 ,240,36,64,.563,28,45,.622,8,19,.421,21,36,.583,101,44,80,.550,34,55,.618,10,25,.400,14,15,.933,112,2017-03-03,LAC,MIL
14,@,W 101-98 (OT),265,40,95,.421,34,68,.500,6,27,.222,15,25,.600,101,35,91,.385,27,66,.409,8,25,.320,20,24,.833,98,2017-03-03,SAS,NOP
15,@,W 101-91 ,240,41,85,.482,35,60,.583,6,25,.240,13,16,.813,101,35,83,.422,29,66,.439,6,17,.353,15,20,.750,91,2017-03-04,LAC,CHI
16,Home,W 101-94 ,240,38,87,.437,32,60,.533,6,27,.222,19,23,.826,101,35,75,.467,28,54,.519,7,21,.333,17,20,.850,94,2017-03-04,MIL,TOR
17,@,L 101-108 ,240,37,80,.463,30,59,.508,7,21,.333,20,21,.952,101,37,85,.435,20,44,.455,17,41,.415,17,24,.708,108,2017-03-08,CHO,MIA
18,@,L 101-106 ,240,39,84,.464,28,45,.622,11,39,.282,12,19,.632,101,41,87,.471,32,61,.525,9,26,.346,15,19,.789,106,2017-03-09,CLE,DET
19,Home,L 100-104 ,240,39,87,.448,36,65,.554,3,22,.136,19,26,.731,100,35,78,.449,30,62,.484,5,16,.313,29,31,.935,104,2011-12-26,MIN,OKC
20,Home,W 100-91 ,240,35,75,.467,26,57,.456,9,18,.500,21,35,.600,100,37,88,.420,36,72,.500,1,16,.063,16,19,.842,91,2011-12-26,SAC,LAL
21,@,L 100-117 ,240,38,79,.481,31,63,.492,7,16,.438,17,25,.680,100,46,86,.535,40,67,.597,6,19,.316,19,26,.731,117,2011-12-28,UTA,DEN
22,@,W 100-79 ,240,37,84,.440,25,56,.446,12,28,.429,14,24,.583,100,30,83,.361,25,68,.368,5,15,.333,14,18,.778,79,2011-12-30,ORL,CHA
23,Home,W 100-92 ,240,38,83,.458,28,63,.444,10,20,.500,14,21,.667,100,35,83,.422,32,72,.444,3,11,.273,19,23,.826,92,2012-01-02,BOS,WAS
24,Home,W 100-87 ,240,39,80,.488,34,64,.531,5,16,.313,17,20,.850,100,31,77,.403,26,58,.448,5,19,.263,20,26,.769,87,2012-01-02,DAL,OKC
25,@,W 100-92 ,240,39,82,.476,30,66,.455,9,16,.563,13,20,.650,100,34,73,.466,29,60,.483,5,13,.385,19,28,.679,92,2012-01-02,ATL,MIA
26,@,L 100-103 ,240,39,76,.513,30,57,.526,9,19,.474,13,21,.619,100,37,91,.407,33,70,.471,4,21,.190,25,30,.833,103,2012-01-05,MIL,SAC
27,@,W 100-86 ,240,38,69,.551,34,54,.630,4,15,.267,20,27,.741,100,30,69,.435,24,56,.429,6,13,.462,20,25,.800,86,2012-01-10,DAL,DET
28,@,W 100-95 ,240,34,74,.459,28,59,.475,6,15,.400,26,32,.813,100,39,85,.459,34,73,.466,5,12,.417,12,20,.600,95,2012-01-10,OKC,MEM
29,Home,L 100-111 ,240,33,78,.423,25,56,.446,8,22,.364,26,32,.813,100,43,81,.531,32,61,.525,11,20,.550,14,21,.667,111,2012-01-10,MIN,CHI
30,@,L 100-112 ,240,35,84,.417,30,64,.469,5,20,.250,25,32,.781,100,38,76,.500,31,63,.492,7,13,.538,29,38,.763,112,2012-01-14,GSW,CHA
31,@,L 100-107 ,240,37,72,.514,29,56,.518,8,16,.500,18,27,.667,100,37,75,.493,26,46,.565,11,29,.379,22,25,.880,107,2012-01-18,GSW,NJN
32,@,W 100-86 ,240,39,82,.476,31,60,.517,8,22,.364,14,20,.700,100,27,73,.370,21,51,.412,6,22,.273,26,33,.788,86,2012-01-20,MIL,NYK
33,@,W 100-94 ,240,37,72,.514,32,60,.533,5,12,.417,21,30,.700,100,37,77,.481,35,62,.565,2,15,.133,18,21,.857,94,2012-01-22,BOS,WAS
34,@,L 100-107 ,240,39,92,.424,32,68,.471,7,24,.292,15,16,.938,100,41,90,.456,36,73,.493,5,17,.294,20,33,.606,107,2012-01-27,MIL,CHI
35,Home,W 100-89 ,240,40,80,.500,35,61,.574,5,19,.263,15,16,.938,100,36,82,.439,30,63,.476,6,19,.316,11,17,.647,89,2012-01-28,MIL,LAL
36,@,L 100-101 (OT),265,39,94,.415,27,69,.391,12,25,.480,10,19,.526,100,44,100,.440,40,80,.500,4,20,.200,9,12,.750,101,2012-01-29,SAS,DAL
37,@,L 100-112 ,240,38,78,.487,29,56,.518,9,22,.409,15,23,.652,100,45,80,.563,32,55,.582,13,25,.520,9,15,.600,112,2012-01-30,OKC,LAC
38,Home,W 100-97 (OT),265,33,86,.384,27,74,.365,6,12,.500,28,35,.800,100,35,80,.438,28,57,.491,7,23,.304,20,27,.741,97,2012-01-31,MEM,DEN
39,@,W 100-77 ,240,41,80,.513,34,62,.548,7,18,.389,11,13,.846,100,27,73,.370,23,53,.434,4,20,.200,19,23,.826,77,2012-01-31,ATL,TOR
40,Home,W 100-64 ,240,39,75,.520,27,51,.529,12,24,.500,10,12,.833,100,25,73,.342,19,59,.322,6,14,.429,8,18,.444,64,2012-02-01,BOS,TOR
41,Home,W 100-91 ,240,37,82,.451,31,62,.500,6,20,.300,20,23,.870,100,39,91,.429,37,81,.457,2,10,.200,11,14,.786,91,2012-02-04,MIN,HOU
42,@,W 100-92 ,240,37,78,.474,29,54,.537,8,24,.333,18,25,.720,100,34,81,.420,31,72,.431,3,9,.333,21,26,.808,92,2012-02-06,SAC,NOH
43,@,W 100-90 ,240,37,84,.440,32,69,.464,5,15,.333,21,26,.808,100,38,93,.409,31,79,.392,7,14,.500,7,11,.636,90,2012-02-08,SAS,PHI
44,@,W 100-98 ,240,40,84,.476,33,65,.508,7,19,.368,13,22,.591,100,37,84,.440,31,65,.477,6,19,.316,18,19,.947,98,2012-02-11,NYK,MIN
45,Home,L 100-105 ,240,37,72,.514,26,45,.578,11,27,.407,15,15,1.000,100,41,88,.466,35,73,.479,6,15,.400,17,20,.850,105,2012-02-15,NJN,MEM
46,Home,W 100-85 ,240,39,77,.506,32,53,.604,7,24,.292,15,17,.882,100,33,87,.379,29,69,.420,4,18,.222,15,20,.750,85,2012-02-15,NYK,SAC
47,@,L 100-114 ,240,38,84,.452,36,73,.493,2,11,.182,22,26,.846,100,47,89,.528,42,74,.568,5,15,.333,15,19,.789,114,2012-02-17,WAS,UTA
48,Home,L 100-103 (OT),265,36,89,.404,28,63,.444,8,26,.308,20,23,.870,100,40,92,.435,28,64,.438,12,28,.429,11,21,.524,103,2012-02-18,LAC,SAS
49,@,W 100-92 ,240,32,82,.390,17,51,.333,15,31,.484,21,29,.724,100,34,85,.400,29,64,.453,5,21,.238,19,26,.731,92,2012-02-20,NJN,NYK
50,@,L 100-101 ,240,37,95,.389,30,78,.385,7,17,.412,19,24,.792,100,34,78,.436,25,60,.417,9,18,.500,24,32,.750,101,2012-02-21,DET,CLE
51,Home,W 100-98 ,240,31,77,.403,20,55,.364,11,22,.500,27,38,.711,100,39,85,.459,38,78,.487,1,7,.143,19,24,.792,98,2012-02-22,MIN,UTA
52,Home,W 100-85 ,240,36,77,.468,29,52,.558,7,25,.280,21,25,.840,100,30,78,.385,26,65,.400,4,13,.308,21,23,.913,85,2012-02-23,OKC,LAL
53,Home,L 100-108 ,240,37,79,.468,28,59,.475,9,20,.450,17,23,.739,100,44,92,.478,32,69,.464,12,23,.522,8,8,1.000,108,2012-03-01,SAC,LAC
54,Home,W 100-83 ,240,37,75,.493,31,64,.484,6,11,.545,20,22,.909,100,29,76,.382,27,67,.403,2,9,.222,23,29,.793,83,2012-03-03,MEM,DET
55,Home,L 100-109 ,240,37,81,.457,28,58,.483,9,23,.391,17,27,.630,100,40,80,.500,35,71,.493,5,9,.556,24,29,.828,109,2012-03-05,CLE,UTA
56,Home,L 100-120 ,240,36,85,.424,28,63,.444,8,22,.364,20,36,.556,100,45,83,.542,30,60,.500,15,23,.652,15,16,.938,120,2012-03-05,WAS,GSW
57,Home,W 100-84 ,240,38,80,.475,34,70,.486,4,10,.400,20,27,.741,100,31,80,.388,18,45,.400,13,35,.371,9,17,.529,84,2012-03-06,CHA,ORL
58,@,W 100-99 ,240,37,82,.451,30,59,.508,7,23,.304,19,23,.826,100,35,81,.432,31,61,.508,4,20,.200,25,32,.781,99,2012-03-07,CLE,DEN
59,@,L 100-101 ,240,35,76,.461,24,54,.444,11,22,.500,19,27,.704,100,33,72,.458,23,47,.489,10,25,.400,25,31,.806,101,2012-03-07,LAC,NJN
60,@,W 100-89 ,240,39,79,.494,28,58,.483,11,21,.524,11,12,.917,100,36,85,.424,28,58,.483,8,27,.296,9,11,.818,89,2012-03-16,POR,CHI
61,@,L 100-115 ,240,32,81,.395,24,62,.387,8,19,.421,28,34,.824,100,41,81,.506,30,56,.536,11,25,.440,22,28,.786,115,2012-03-16,IND,NYK
62,Home,L 100-105 ,240,34,81,.420,28,58,.483,6,23,.261,26,31,.839,100,41,89,.461,36,74,.486,5,15,.333,18,27,.667,105,2012-03-19,NJN,CLE
63,@,L 100-116 ,240,39,88,.443,32,66,.485,7,22,.318,15,20,.750,100,45,95,.474,38,76,.500,7,19,.368,19,25,.760,116,2012-03-21,MIN,SAS
64,@,W 100-91 ,240,43,89,.483,36,72,.500,7,17,.412,7,10,.700,100,36,90,.400,33,75,.440,3,15,.200,16,20,.800,91,2012-03-22,BOS,MIL
65,@,L 100-117 ,240,41,81,.506,38,66,.576,3,15,.200,15,22,.682,100,45,99,.455,33,64,.516,12,35,.343,15,15,1.000,117,2012-03-25,DEN,MIN
66,Home,L 100-107 ,240,41,87,.471,34,68,.500,7,19,.368,11,12,.917,100,45,92,.489,39,65,.600,6,27,.222,11,13,.846,107,2012-03-27,PHO,SAS
67,Home,W 100-84 ,240,40,82,.488,33,66,.500,7,16,.438,13,15,.867,100,35,77,.455,29,57,.509,6,20,.300,8,13,.615,84,2012-03-28,NJN,IND
68,Home,W 100-90 ,240,37,73,.507,33,54,.611,4,19,.211,22,26,.846,100,31,70,.443,25,53,.472,6,17,.353,22,33,.667,90,2012-03-30,ATL,NYK
69,Home,L 100-102 ,240,40,76,.526,33,61,.541,7,15,.467,13,16,.813,100,35,81,.432,27,61,.443,8,20,.400,24,30,.800,102,2012-03-30,GSW,NJN
70,@,W 100-79 ,240,44,90,.489,40,78,.513,4,12,.333,8,11,.727,100,26,75,.347,20,51,.392,6,24,.250,21,25,.840,79,2012-03-30,BOS,MIN
71,@,W 100-98 ,240,38,80,.475,31,58,.534,7,22,.318,17,21,.810,100,35,78,.449,24,46,.522,11,32,.344,17,28,.607,98,2012-03-30,DAL,ORL
72,Home,L 100-109 ,240,39,85,.459,38,75,.507,1,10,.100,21,32,.656,100,40,90,.444,35,68,.515,5,22,.227,24,28,.857,109,2012-04-03,SAC,PHO
73,Home,W 100-99 (OT),265,39,102,.382,31,68,.456,8,34,.235,14,20,.700,100,35,89,.393,28,67,.418,7,22,.318,22,31,.710,99,2012-04-08,NYK,CHI
74,@,L 100-110 ,240,41,92,.446,32,67,.478,9,25,.360,9,17,.529,100,41,92,.446,34,78,.436,7,14,.500,21,28,.750,110,2012-04-10,SAC,DAL
75,@,W 100-98 ,240,38,81,.469,33,65,.508,5,16,.313,19,21,.905,100,31,76,.408,19,50,.380,12,26,.462,24,27,.889,98,2012-04-11,LAC,OKC
76,@,W 100-84 ,240,36,79,.456,25,50,.500,11,29,.379,17,21,.810,100,28,75,.373,22,56,.393,6,19,.316,22,29,.759,84,2012-04-15,ORL,CLE
77,@,W 100-94 (OT),265,39,91,.429,34,74,.459,5,17,.294,17,23,.739,100,33,84,.393,27,69,.391,6,15,.400,22,28,.786,94,2012-04-15,CHI,DET
78,@,L 100-113 ,240,40,80,.500,31,62,.500,9,18,.500,11,15,.733,100,48,90,.533,37,72,.514,11,18,.611,6,6,1.000,113,2012-04-16,PHI,ORL
79,@,W 100-68 ,240,40,83,.482,31,64,.484,9,19,.474,11,19,.579,100,25,84,.298,24,76,.316,1,8,.125,17,23,.739,68,2012-04-18,CHI,CHA
80,Home,W 100-88 ,240,37,87,.425,33,74,.446,4,13,.308,22,29,.759,100,34,84,.405,29,61,.475,5,23,.217,15,23,.652,88,2012-04-24,UTA,PHO
81,@,L 100-107 ,240,37,82,.451,30,64,.469,7,18,.389,19,25,.760,100,37,81,.457,31,66,.470,6,15,.400,27,37,.730,107,2012-11-03,TOR,BRK
82,@,L 100-110 ,240,38,77,.494,33,64,.516,5,13,.385,19,22,.864,100,42,74,.568,35,61,.574,7,13,.538,19,23,.826,110,2012-11-03,UTA,SAS
83,Home,W 100-84 ,240,39,77,.506,28,50,.560,11,27,.407,11,18,.611,100,34,79,.430,26,62,.419,8,17,.471,8,10,.800,84,2012-11-04,NYK,PHI
84,Home,W 100-94 (OT),265,34,81,.420,30,68,.441,4,13,.308,28,34,.824,100,39,95,.411,29,66,.439,10,29,.345,6,7,.857,94,2012-11-07,BOS,WAS
85,Home,L 100-106 ,240,37,76,.487,33,66,.500,4,10,.400,22,31,.710,100,40,82,.488,33,69,.478,7,13,.538,19,23,.826,106,2012-11-09,BOS,PHI
86,@,L 100-110 ,240,41,76,.539,34,60,.567,7,16,.438,11,18,.611,100,43,94,.457,36,82,.439,7,12,.583,17,21,.810,110,2012-11-12,DEN,PHO
87,Home,W 100-96 ,240,36,80,.450,26,51,.510,10,29,.345,18,22,.818,100,34,84,.405,26,60,.433,8,24,.333,20,21,.952,96,2012-11-14,HOU,NOH
88,@,L 100-107 ,240,35,77,.455,26,56,.464,9,21,.429,21,29,.724,100,35,72,.486,25,51,.490,10,21,.476,27,32,.844,107,2012-11-14,MIA,LAC
89,Home,L 100-104 ,240,38,87,.437,30,58,.517,8,29,.276,16,21,.762,100,39,86,.453,28,60,.467,11,26,.423,15,23,.652,104,2012-11-15,SAS,NYK
90,@,L 100-126 ,240,39,78,.500,35,67,.522,4,11,.364,18,26,.692,100,47,88,.534,31,61,.508,16,27,.593,16,20,.800,126,2012-11-17,DEN,SAS
91,@,L 100-101 (OT),265,38,89,.427,31,69,.449,7,20,.350,17,24,.708,100,40,92,.435,31,67,.463,9,25,.360,12,21,.571,101,2012-11-21,WAS,ATL
92,Home,L 100-112 ,240,41,77,.532,38,69,.551,3,8,.375,15,17,.882,100,45,77,.584,37,61,.607,8,16,.500,14,19,.737,112,2012-11-21,BOS,SAS
93,@,L 100-108 ,240,37,79,.468,31,55,.564,6,24,.250,20,24,.833,100,39,80,.488,30,63,.476,9,17,.529,21,24,.875,108,2012-11-23,OKC,BOS
94,@,L 100-121 ,240,37,78,.474,28,58,.483,9,20,.450,17,22,.773,100,38,79,.481,21,46,.457,17,33,.515,28,31,.903,121,2012-11-25,DET,NYK
95,Home,W 100-98 ,240,35,75,.467,29,61,.475,6,14,.429,24,32,.750,100,37,81,.457,32,62,.516,5,19,.263,19,22,.864,98,2012-11-27,PHI,DAL
96,@,L 100-105 ,240,36,80,.450,26,50,.520,10,30,.333,18,24,.750,100,42,86,.488,37,73,.507,5,13,.385,16,19,.842,105,2012-11-29,SAS,MIA
97,@,W 100-79 ,240,40,79,.506,33,63,.524,7,16,.438,13,17,.765,100,30,81,.370,24,57,.421,6,24,.250,13,18,.722,79,2012-12-01,OKC,NOH
98,@,W 100-98 ,240,39,92,.424,26,51,.510,13,41,.317,9,13,.692,100,39,83,.470,32,67,.478,7,16,.438,13,15,.867,98,2012-12-05,NYK,CHA
99,@,L 100-107 ,240,35,86,.407,29,63,.460,6,23,.261,24,28,.857,100,38,82,.463,32,67,.478,6,15,.400,25,34,.735,107,2012-12-05,TOR,SAC
0,@,W 100-97 ,240,36,78,.462,22,50,.440,14,28,.500,14,18,.778,100,36,68,.529,32,50,.640,4,18,.222,21,28,.750,97,2012-12-11,NYK,BRK
1,Home,W 100-94 ,240,37,84,.440,26,57,.456,11,27,.407,15,26,.577,100,31,75,.413,24,48,.500,7,27,.259,25,40,.625,94,2012-12-11,CLE,LAL
2,@,W 100-94 ,240,37,85,.435,28,62,.452,9,23,.391,17,25,.680,100,35,82,.427,30,66,.455,5,16,.313,19,24,.792,94,2012-12-12,LAC,CHA
3,Home,W 100-89 ,240,37,74,.500,32,65,.492,5,9,.556,21,24,.875,100,35,81,.432,30,71,.423,5,10,.500,14,19,.737,89,2012-12-18,CHI,BOS
4,@,L 100-107 ,240,37,86,.430,24,51,.471,13,35,.371,13,15,.867,100,39,72,.542,35,61,.574,4,11,.364,25,29,.862,107,2012-12-18,PHI,DAL
5,@,L 100-101 ,240,38,95,.400,28,71,.394,10,24,.417,14,22,.636,100,35,88,.398,25,57,.439,10,31,.323,21,27,.778,101,2012-12-18,CHA,LAL
6,@,W 100-95 (OT),265,34,78,.436,25,54,.463,9,24,.375,23,34,.676,100,36,95,.379,30,77,.390,6,18,.333,17,22,.773,95,2012-12-18,ATL,WAS
7,@,W 100-92 ,240,36,84,.429,27,59,.458,9,25,.360,19,20,.950,100,36,94,.383,27,70,.386,9,24,.375,11,17,.647,92,2012-12-19,OKC,ATL
8,Home,W 100-86 ,240,38,83,.458,27,54,.500,11,29,.379,13,17,.765,100,35,78,.449,25,53,.472,10,25,.400,6,9,.667,86,2012-12-19,NYK,BRK
9,Home,W 100-68 ,240,38,90,.422,28,66,.424,10,24,.417,14,21,.667,100,28,85,.329,26,73,.356,2,12,.167,10,13,.769,68,2012-12-21,DET,WAS
10,@,L 100-115 ,240,33,90,.367,25,69,.362,8,21,.381,26,35,.743,100,44,85,.518,30,58,.517,14,27,.519,13,16,.813,115,2012-12-21,CHA,GSW
11,@,L 100-112 ,240,40,80,.500,37,67,.552,3,13,.231,17,24,.708,100,45,93,.484,34,68,.500,11,25,.440,11,19,.579,112,2012-12-25,DEN,LAC
12,Home,W 100-94 ,240,37,77,.481,32,56,.571,5,21,.238,21,31,.677,100,38,89,.427,29,63,.460,9,26,.346,9,16,.563,94,2012-12-25,LAL,NYK
13,Home,W 100-80 ,240,34,71,.479,26,52,.500,8,19,.421,24,29,.828,100,33,78,.423,26,60,.433,7,18,.389,7,12,.583,80,2012-12-26,SAS,TOR
14,@,L 100-109 ,240,38,80,.475,33,65,.508,5,15,.333,19,22,.864,100,44,80,.550,34,60,.567,10,20,.500,11,14,.786,109,2012-12-29,IND,ATL
15,@,L 100-103 ,240,38,82,.463,29,62,.468,9,20,.450,15,19,.789,100,35,75,.467,31,60,.517,4,15,.267,29,39,.744,103,2012-12-29,CLE,BRK
16,Home,L 100-105 ,240,36,84,.429,26,47,.553,10,37,.270,18,24,.750,100,41,81,.506,30,48,.625,11,33,.333,12,18,.667,105,2013-01-01,NYK,POR
17,Home,W 100-83 ,240,39,82,.476,27,55,.491,12,27,.444,10,16,.625,100,28,77,.364,19,43,.442,9,34,.265,18,21,.857,83,2013-01-03,NYK,SAS
18,Home,W 100-94 ,240,31,78,.397,21,59,.356,10,19,.526,28,36,.778,100,35,81,.432,29,62,.468,6,19,.316,18,20,.900,94,2013-01-07,UTA,DAL
19,@,L 100-107 ,240,37,84,.440,29,52,.558,8,32,.250,18,22,.818,100,43,87,.494,37,69,.536,6,18,.333,15,19,.789,107,2013-01-12,HOU,PHI
20,Home,W 100-87 ,240,35,81,.432,24,51,.471,11,30,.367,19,25,.760,100,33,82,.402,29,59,.492,4,23,.174,17,22,.773,87,2013-01-13,NYK,NOH
21,Home,W 100-89 ,240,39,80,.488,31,59,.525,8,21,.381,14,20,.700,100,33,79,.418,27,64,.422,6,15,.400,17,24,.708,89,2013-01-14,BOS,CHA
22,@,L 100-105 ,240,33,84,.393,22,57,.386,11,27,.407,23,30,.767,100,33,86,.384,28,64,.438,5,22,.227,34,43,.791,105,2013-01-16,HOU,DAL
23,@,W 100-99 (OT),265,36,75,.480,31,60,.517,5,15,.333,23,32,.719,100,38,91,.418,35,77,.455,3,14,.214,20,28,.714,99,2013-01-18,CHI,BOS
24,Home,L 100-106 ,240,37,79,.468,26,48,.542,11,31,.355,15,21,.714,100,37,79,.468,33,67,.493,4,12,.333,28,38,.737,106,2013-01-18,ORL,CHA
25,@,W 100-94 ,240,29,74,.392,19,45,.422,10,29,.345,32,41,.780,100,34,81,.420,28,66,.424,6,15,.400,20,24,.833,94,2013-01-21,HOU,CHA
26,Home,W 100-80 ,240,44,78,.564,42,67,.627,2,11,.182,10,12,.833,100,30,80,.375,24,57,.421,6,23,.261,14,17,.824,80,2013-01-23,POR,IND
27,@,W 100-82 ,240,34,71,.479,23,50,.460,11,21,.524,21,26,.808,100,31,80,.388,28,60,.467,3,20,.150,17,20,.850,82,2013-01-25,HOU,NOH
28,@,L 100-101 ,240,40,81,.494,33,65,.508,7,16,.438,13,17,.765,100,35,75,.467,24,50,.480,11,25,.440,20,21,.952,101,2013-01-26,LAC,POR
29,Home,W 100-98 (2OT),290,36,88,.409,31,68,.456,5,20,.250,23,27,.852,100,39,96,.406,34,73,.466,5,23,.217,15,20,.750,98,2013-01-27,BOS,MIA
30,Home,L 100-103 ,240,45,83,.542,41,74,.554,4,9,.444,6,9,.667,100,40,73,.548,32,60,.533,8,13,.615,15,19,.789,103,2013-01-28,PHI,MEM
31,Home,W 100-97 ,240,36,84,.429,29,64,.453,7,20,.350,21,25,.840,100,36,81,.444,28,56,.500,8,25,.320,17,24,.708,97,2013-01-31,GSW,DAL
32,Home,L 100-111 ,240,41,89,.461,31,67,.463,10,22,.455,8,18,.444,100,39,92,.424,27,60,.450,12,32,.375,21,25,.840,111,2013-02-01,MIN,LAL
33,@,W 100-85 ,240,40,75,.533,37,63,.587,3,12,.250,17,23,.739,100,28,75,.373,24,57,.421,4,18,.222,25,32,.781,85,2013-02-03,MIA,TOR
34,@,W 100-98 ,240,41,70,.586,34,52,.654,7,18,.389,11,16,.688,100,40,85,.471,37,72,.514,3,13,.231,15,19,.789,98,2013-02-04,POR,MIN
35,Home,W 100-86 ,240,39,81,.481,34,71,.479,5,10,.500,17,26,.654,100,29,82,.354,23,63,.365,6,19,.316,22,29,.759,86,2013-02-06,UTA,MIL
36,Home,L 100-111 ,240,35,74,.473,22,50,.440,13,24,.542,17,23,.739,100,45,86,.523,36,70,.514,9,16,.563,12,18,.667,111,2013-02-08,ATL,NOH
37,@,W 100-93 ,240,36,80,.450,28,54,.519,8,26,.308,20,25,.800,100,38,89,.427,34,75,.453,4,14,.286,13,19,.684,93,2013-02-08,LAL,CHA
38,@,W 100-98 (OT),265,42,96,.438,40,87,.460,2,9,.222,14,19,.737,100,35,78,.449,26,56,.464,9,22,.409,19,28,.679,98,2013-02-08,TOR,IND
39,@,W 100-94 ,240,38,81,.469,30,55,.545,8,26,.308,16,20,.800,100,37,80,.463,36,67,.537,1,13,.077,19,27,.704,94,2013-02-08,NYK,MIN
40,Home,L 100-105 ,240,34,86,.395,27,69,.391,7,17,.412,25,28,.893,100,41,83,.494,33,66,.500,8,17,.471,15,19,.789,105,2013-02-09,MIL,DET
41,@,W 100-92 ,240,39,75,.520,31,61,.508,8,14,.571,14,17,.824,100,40,79,.506,35,61,.574,5,18,.278,7,11,.636,92,2013-02-11,MIN,CLE
42,@,L 100-123 ,240,33,80,.413,29,64,.453,4,16,.250,30,36,.833,100,43,92,.467,30,58,.517,13,34,.382,24,26,.923,123,2013-02-13,SAC,DAL
43,Home,L 100-110 ,240,32,73,.438,29,60,.483,3,13,.231,33,34,.971,100,41,88,.466,30,59,.508,11,29,.379,17,22,.773,110,2013-02-14,OKC,MIA
44,@,L 100-105 ,240,37,76,.487,30,61,.492,7,15,.467,19,22,.864,100,38,77,.494,33,63,.524,5,14,.357,24,34,.706,105,2013-02-20,NOH,CLE
45,Home,L 100-104 ,240,37,91,.407,32,74,.432,5,17,.294,21,24,.875,100,40,84,.476,32,64,.500,8,20,.400,16,19,.842,104,2013-02-22,NOH,DAL
46,Home,W 100-98 ,240,35,80,.438,28,62,.452,7,18,.389,23,28,.821,100,35,75,.467,25,47,.532,10,28,.357,18,23,.783,98,2013-02-22,TOR,NYK
47,@,W 100-99 ,240,37,81,.457,30,64,.469,7,17,.412,19,23,.826,100,37,85,.435,36,74,.486,1,11,.091,24,31,.774,99,2013-02-24,GSW,MIN
48,Home,W 100-95 ,240,35,81,.432,28,61,.459,7,20,.350,23,31,.742,100,39,78,.500,32,59,.542,7,19,.368,10,16,.625,95,2013-03-01,NOH,DET
49,@,W 100-77 ,240,42,92,.457,34,71,.479,8,21,.381,8,10,.800,100,32,88,.364,30,70,.429,2,18,.111,11,14,.786,77,2013-03-10,DAL,MIN
50,Home,W 100-96 ,240,33,84,.393,25,61,.410,8,23,.348,26,34,.765,100,36,86,.419,29,65,.446,7,21,.333,17,27,.630,96,2013-03-10,TOR,CLE
51,Home,W 100-74 ,240,35,77,.455,29,60,.483,6,17,.353,24,30,.800,100,27,66,.409,23,53,.434,4,13,.308,16,25,.640,74,2013-03-12,CHA,BOS
52,@,L 100-108 ,240,39,81,.481,33,57,.579,6,24,.250,16,20,.800,100,36,74,.486,25,43,.581,11,31,.355,25,31,.806,108,2013-03-15,MIN,HOU
53,@,L 100-101 ,240,38,90,.422,26,62,.419,12,28,.429,12,14,.857,100,43,86,.500,38,70,.543,5,16,.313,10,13,.769,101,2013-03-18,POR,PHI
54,Home,W 100-93 ,240,34,76,.447,28,53,.528,6,23,.261,26,32,.813,100,36,79,.456,31,62,.500,5,17,.294,16,20,.800,93,2013-03-20,HOU,UTA
55,@,L 100-101 ,240,43,78,.551,36,60,.600,7,18,.389,7,11,.636,100,37,76,.487,30,65,.462,7,11,.636,20,27,.741,101,2013-03-21,PHI,DEN
56,Home,L 100-103 ,240,39,81,.481,28,58,.483,11,23,.478,11,17,.647,100,40,87,.460,29,61,.475,11,26,.423,12,16,.750,103,2013-03-22,LAL,WAS
57,Home,L 100-102 ,240,41,99,.414,35,78,.449,6,21,.286,12,17,.706,100,35,76,.461,31,62,.500,4,14,.286,28,31,.903,102,2013-03-24,PHO,BRK
58,Home,W 100-94 ,240,40,84,.476,32,61,.525,8,23,.348,12,15,.800,100,36,80,.450,29,59,.492,7,21,.333,15,25,.600,94,2013-03-25,IND,ATL
59,@,W 100-85 ,240,39,90,.433,31,62,.500,8,28,.286,14,18,.778,100,31,69,.449,25,49,.510,6,20,.300,17,22,.773,85,2013-03-26,NYK,BOS
60,@,W 100-91 ,240,35,78,.449,29,60,.483,6,18,.333,24,28,.857,100,32,83,.386,26,62,.419,6,21,.286,21,26,.808,91,2013-03-27,IND,HOU
61,Home,W 100-92 ,240,42,89,.472,34,73,.466,8,16,.500,8,9,.889,100,37,89,.416,31,65,.477,6,24,.250,12,13,.923,92,2013-03-27,PHI,MIL
62,Home,W 100-99 ,240,35,76,.461,25,61,.410,10,15,.667,20,27,.741,100,42,88,.477,42,78,.538,0,10,.000,15,17,.882,99,2013-03-27,SAS,DEN
63,Home,W 100-98 ,240,40,79,.506,34,61,.557,6,18,.333,14,18,.778,100,38,80,.475,26,59,.441,12,21,.571,10,18,.556,98,2013-03-30,DAL,CHI
64,Home,W 100-92 ,240,38,73,.521,33,57,.579,5,16,.313,19,27,.704,100,38,76,.500,36,68,.529,2,8,.250,14,23,.609,92,2013-03-30,PHI,CHA
65,@,L 100-110 ,240,42,81,.519,35,65,.538,7,16,.438,9,14,.643,100,40,83,.482,35,65,.538,5,18,.278,25,27,.926,110,2013-04-01,BOS,MIN
66,Home,W 100-88 ,240,38,82,.463,26,58,.448,12,24,.500,12,13,.923,100,33,83,.398,25,62,.403,8,21,.381,14,17,.824,88,2013-04-04,OKC,SAS
67,Home,W 100-83 ,240,36,76,.474,30,57,.526,6,19,.316,22,29,.759,100,30,83,.361,27,73,.370,3,10,.300,20,23,.870,83,2013-04-06,MIL,TOR
68,@,L 100-107 ,240,36,78,.462,28,56,.500,8,22,.364,20,21,.952,100,42,72,.583,34,59,.576,8,13,.615,15,17,.882,107,2013-04-12,MIN,UTA
69,@,L 100-121 ,240,39,100,.390,31,75,.413,8,25,.320,14,17,.824,100,45,83,.542,32,56,.571,13,27,.481,18,24,.750,121,2013-04-14,SAC,HOU
70,@,L 100-101 ,240,32,67,.478,25,53,.472,7,14,.500,29,36,.806,100,33,68,.485,25,52,.481,8,16,.500,27,39,.692,101,2013-11-01,MIA,BRK
71,Home,W 100-81 ,240,33,77,.429,25,57,.439,8,20,.400,26,33,.788,100,29,83,.349,22,52,.423,7,31,.226,16,19,.842,81,2013-11-01,MIN,OKC
72,Home,L 100-109 ,240,40,89,.449,31,57,.544,9,32,.281,11,13,.846,100,35,79,.443,25,52,.481,10,27,.370,29,38,.763,109,2013-11-03,NYK,MIN
73,Home,L 100-105 ,240,35,80,.438,25,49,.510,10,31,.323,20,21,.952,100,39,81,.481,31,59,.525,8,22,.364,19,26,.731,105,2013-11-05,SAC,ATL
74,@,W 100-81 ,240,36,80,.450,31,63,.492,5,17,.294,23,27,.852,100,31,77,.403,28,60,.467,3,17,.176,16,23,.696,81,2013-11-11,DEN,UTA
75,@,W 100-98 (OT),265,38,87,.437,36,75,.480,2,12,.167,22,29,.759,100,34,79,.430,24,51,.471,10,28,.357,20,25,.800,98,2013-11-15,BRK,PHO
76,Home,L 100-108 ,240,37,70,.529,33,55,.600,4,15,.267,22,28,.786,100,43,84,.512,33,57,.579,10,27,.370,12,18,.667,108,2013-11-16,ORL,DAL
77,@,L 100-104 ,240,37,85,.435,27,57,.474,10,28,.357,16,24,.667,100,41,85,.482,34,70,.486,7,15,.467,15,15,1.000,104,2013-11-19,MIN,WAS
78,@,L 100-104 ,240,41,77,.532,33,54,.611,8,23,.348,10,16,.625,100,36,88,.409,30,71,.423,6,17,.353,26,33,.788,104,2013-11-22,CLE,NOP
79,@,L 100-102 ,240,35,87,.402,28,66,.424,7,21,.333,23,25,.920,100,35,79,.443,24,47,.511,11,32,.344,21,30,.700,102,2013-11-23,DAL,DEN
80,Home,W 100-86 ,240,40,87,.460,32,61,.525,8,26,.308,12,15,.800,100,35,84,.417,27,60,.450,8,24,.333,8,15,.533,86,2013-11-24,LAL,SAC
81,Home,L 100-102 ,240,34,78,.436,23,52,.442,11,26,.423,21,22,.955,100,39,77,.506,35,63,.556,4,14,.286,20,22,.909,102,2013-11-26,TOR,BRK
82,@,W 100-93 ,240,36,80,.450,33,71,.465,3,9,.333,25,31,.806,100,38,89,.427,31,69,.449,7,20,.350,10,13,.769,93,2013-11-27,MEM,BOS
83,@,W 100-92 (OT),265,37,74,.500,27,48,.563,10,26,.385,16,22,.727,100,37,85,.435,27,60,.450,10,25,.400,8,10,.800,92,2013-11-27,WAS,MIL
84,@,L 100-115 ,240,38,88,.432,31,65,.477,7,23,.304,17,19,.895,100,41,89,.461,31,61,.508,10,28,.357,23,39,.590,115,2013-12-01,PHI,DET
85,Home,L 100-105 ,240,36,82,.439,32,67,.478,4,15,.267,24,31,.774,100,39,89,.438,31,63,.492,8,26,.308,19,26,.731,105,2013-12-01,LAC,IND
86,@,L 100-102 ,240,42,96,.438,31,65,.477,11,31,.355,5,5,1.000,100,42,78,.538,36,60,.600,6,18,.333,12,17,.706,102,2013-12-02,ATL,SAS
87,@,L 100-108 ,240,37,78,.474,29,60,.483,8,18,.444,18,21,.857,100,38,77,.494,27,53,.509,11,24,.458,21,27,.778,108,2013-12-03,MIL,BOS
88,@,W 100-97 ,240,37,86,.430,26,62,.419,11,24,.458,15,22,.682,100,38,94,.404,31,72,.431,7,22,.318,14,15,.933,97,2013-12-04,DAL,NOP
89,Home,L 100-106 ,240,37,86,.430,27,64,.422,10,22,.455,16,22,.727,100,41,86,.477,29,54,.537,12,32,.375,12,18,.667,106,2013-12-06,SAC,LAL
90,Home,L 100-111 ,240,41,91,.451,28,65,.431,13,26,.500,5,6,.833,100,38,71,.535,29,52,.558,9,19,.474,26,28,.929,111,2013-12-07,SAS,IND
91,Home,L 100-116 ,240,34,81,.420,28,66,.424,6,15,.400,26,34,.765,100,40,71,.563,31,53,.585,9,18,.500,27,33,.818,116,2013-12-11,MEM,OKC
92,Home,L 100-109 ,240,37,85,.435,26,55,.473,11,30,.367,15,16,.938,100,42,87,.483,34,66,.515,8,21,.381,17,20,.850,109,2013-12-13,ORL,CLE
93,@,L 100-108 ,240,37,84,.440,28,61,.459,9,23,.391,17,21,.810,100,39,82,.476,29,57,.509,10,25,.400,20,24,.833,108,2013-12-13,PHI,TOR
94,@,W 100-84 ,240,41,88,.466,33,68,.485,8,20,.400,10,12,.833,100,35,89,.393,29,69,.420,6,20,.300,8,11,.727,84,2013-12-14,SAS,UTA
95,@,L 100-114 ,240,39,82,.476,34,61,.557,5,21,.238,17,21,.810,100,45,92,.489,34,65,.523,11,27,.407,13,15,.867,114,2013-12-16,LAL,ATL
96,Home,W 100-84 ,240,37,69,.536,27,54,.500,10,15,.667,16,24,.667,100,36,90,.400,32,72,.444,4,18,.222,8,9,.889,84,2013-12-21,CHI,CLE
97,Home,L 100-105 ,240,39,82,.476,31,62,.500,8,20,.400,14,23,.609,100,39,79,.494,27,56,.482,12,23,.522,15,23,.652,105,2013-12-21,ORL,SAC
98,Home,L 100-113 ,240,35,82,.427,26,63,.413,9,19,.474,21,26,.808,100,43,88,.489,31,61,.508,12,27,.444,15,18,.833,113,2013-12-21,SAS,OKC
99,Home,L 100-113 ,240,31,74,.419,24,57,.421,7,17,.412,31,42,.738,100,41,83,.494,33,66,.500,8,17,.471,23,27,.852,113,2013-12-23,SAC,NOP
0,Home,W 100-92 ,240,31,71,.437,26,47,.553,5,24,.208,33,40,.825,100,38,93,.409,33,75,.440,5,18,.278,11,20,.550,92,2013-12-26,HOU,MEM
1,@,L 100-103 ,240,37,79,.468,28,61,.459,9,18,.500,17,24,.708,100,38,83,.458,29,58,.500,9,25,.360,18,25,.720,103,2013-12-28,CLE,BOS
2,@,L 100-115 ,240,39,80,.488,32,59,.542,7,21,.333,15,20,.750,100,36,80,.450,21,48,.438,15,32,.469,28,34,.824,115,2013-12-28,NYK,TOR
3,@,W 100-98 ,240,41,86,.477,35,62,.565,6,24,.250,12,14,.857,100,36,79,.456,30,56,.536,6,23,.261,20,23,.870,98,2013-12-30,DAL,MIN
4,Home,L 100-101 ,240,37,80,.463,27,49,.551,10,31,.323,16,19,.842,100,39,87,.448,33,60,.550,6,27,.222,17,25,.680,101,2014-01-03,ATL,GSW
5,@,L 100-102 ,240,37,89,.416,28,65,.431,9,24,.375,17,24,.708,100,34,74,.459,24,48,.500,10,26,.385,24,28,.857,102,2014-01-03,NYK,HOU
6,@,L 100-116 ,240,37,68,.544,27,47,.574,10,21,.476,16,20,.800,100,41,85,.482,29,58,.500,12,27,.444,22,25,.880,116,2014-01-04,MIL,PHO
7,Home,L 100-103 ,240,35,77,.455,27,57,.474,8,20,.400,22,29,.759,100,37,72,.514,33,59,.559,4,13,.308,25,41,.610,103,2014-01-15,NOP,HOU
8,Home,L 100-109 ,240,38,84,.452,30,64,.469,8,20,.400,16,20,.800,100,41,86,.477,33,70,.471,8,16,.500,19,20,.950,109,2014-01-17,SAS,POR
9,Home,W 100-95 ,240,32,65,.492,23,49,.469,9,16,.563,27,33,.818,100,39,95,.411,29,66,.439,10,29,.345,7,10,.700,95,2014-01-20,CHA,TOR
10,@,L 100-102 (OT),265,35,83,.422,27,58,.466,8,25,.320,22,26,.846,100,39,102,.382,32,81,.395,7,21,.333,17,24,.708,102,2014-01-20,LAL,CHI
11,@,L 100-124 ,240,38,75,.507,33,60,.550,5,15,.333,19,28,.679,100,45,83,.542,34,67,.507,11,16,.688,23,32,.719,124,2014-01-22,IND,PHO
12,Home,W 100-92 ,240,37,81,.457,32,69,.464,5,12,.417,21,27,.778,100,36,77,.468,33,62,.532,3,15,.200,17,19,.895,92,2014-01-26,NOP,ORL
13,@,W 100-89 ,240,39,74,.527,35,61,.574,4,13,.308,18,23,.783,100,33,80,.413,27,65,.415,6,15,.400,17,27,.630,89,2014-01-28,NOP,CLE
14,@,W 100-90 ,240,37,85,.435,29,64,.453,8,21,.381,18,20,.900,100,36,80,.450,28,59,.475,8,21,.381,10,14,.714,90,2014-01-31,TOR,DEN
15,Home,L 100-110 ,240,36,93,.387,30,67,.448,6,26,.231,22,27,.815,100,46,88,.523,44,77,.571,2,11,.182,16,22,.727,110,2014-01-31,LAL,CHA
16,Home,W 100-90 ,240,37,84,.440,30,67,.448,7,17,.412,19,22,.864,100,37,81,.457,32,62,.516,5,19,.263,11,12,.917,90,2014-02-03,WAS,POR
17,@,L 100-110 ,240,36,95,.379,29,79,.367,7,16,.438,21,31,.677,100,39,84,.464,29,61,.475,10,23,.435,22,26,.846,110,2014-02-05,MIL,DEN
18,@,L 100-105 ,240,38,84,.452,24,54,.444,14,30,.467,10,14,.714,100,40,86,.465,35,72,.486,5,14,.357,20,22,.909,105,2014-02-05,ATL,NOP
19,Home,L 100-104 ,240,39,89,.438,33,73,.452,6,16,.375,16,22,.727,100,36,77,.468,28,56,.500,8,21,.381,24,28,.857,104,2014-02-08,CHA,SAS
20,@,L 100-112 ,240,38,86,.442,29,62,.468,9,24,.375,15,20,.750,100,40,73,.548,28,46,.609,12,27,.444,20,27,.741,112,2014-02-09,NYK,OKC
21,@,L 100-109 ,240,43,82,.524,38,65,.585,5,17,.294,9,11,.818,100,43,90,.478,38,74,.514,5,16,.313,18,26,.692,109,2014-02-10,SAS,DET
22,Home,W 100-85 ,240,43,85,.506,35,65,.538,8,20,.400,6,13,.462,100,35,80,.438,25,57,.439,10,23,.435,5,9,.556,85,2014-02-11,CHI,ATL
23,@,L 100-105 ,240,37,80,.463,29,61,.475,8,19,.421,18,23,.783,100,37,87,.425,34,71,.479,3,16,.188,28,32,.875,105,2014-02-12,PHI,UTA
24,@,L 100-104 ,240,40,80,.500,29,55,.527,11,25,.440,9,16,.563,100,35,82,.427,23,56,.411,12,26,.462,22,30,.733,104,2014-02-18,ORL,MIL
25,Home,W 100-94 ,240,36,82,.439,25,54,.463,11,28,.393,17,26,.654,100,34,87,.391,29,70,.414,5,17,.294,21,28,.750,94,2014-02-19,PHO,BOS
26,Home,L 100-110 ,240,35,83,.422,26,56,.464,9,27,.333,21,32,.656,100,36,80,.450,27,62,.435,9,18,.500,29,40,.725,110,2014-02-22,MIL,IND
27,@,W 100-95 ,240,28,76,.368,16,45,.356,12,31,.387,32,38,.842,100,37,103,.359,33,83,.398,4,20,.200,17,26,.654,95,2014-02-25,POR,DEN
28,@,W 100-91 ,240,36,71,.507,27,52,.519,9,19,.474,19,28,.679,100,34,85,.400,23,54,.426,11,31,.355,12,17,.706,91,2014-02-28,CHI,DAL
29,@,L 100-110 ,240,36,92,.391,31,71,.437,5,21,.238,23,25,.920,100,38,93,.409,32,68,.471,6,25,.240,28,33,.848,110,2014-03-17,LAC,DEN
30,@,W 100-96 ,240,34,75,.453,22,45,.489,12,30,.400,20,31,.645,100,37,72,.514,30,50,.600,7,22,.318,15,22,.682,96,2014-03-18,MIA,CLE
31,Home,L 100-107 ,240,36,67,.537,32,54,.593,4,13,.308,24,32,.750,100,36,86,.419,27,64,.422,9,22,.409,26,32,.813,107,2014-03-19,NOP,TOR
32,Home,L 100-106 ,240,35,77,.455,23,50,.460,12,27,.444,18,19,.947,100,42,69,.609,33,51,.647,9,18,.500,13,17,.765,106,2014-03-23,NYK,CLE
33,@,W 100-89 ,240,39,82,.476,27,55,.491,12,27,.444,10,18,.556,100,32,86,.372,28,65,.431,4,21,.190,21,25,.840,89,2014-03-24,HOU,CHA
34,@,L 100-102 ,240,35,88,.398,21,56,.375,14,32,.438,16,26,.615,100,36,70,.514,32,57,.561,4,13,.308,26,33,.788,102,2014-03-25,TOR,CLE
35,@,W 100-85 ,240,37,80,.463,27,54,.500,10,26,.385,16,21,.762,100,34,84,.405,30,62,.484,4,22,.182,13,17,.765,85,2014-03-27,POR,ATL
36,Home,W 100-93 ,240,40,81,.494,31,61,.508,9,20,.450,11,14,.786,100,41,81,.506,39,69,.565,2,12,.167,9,16,.563,93,2014-03-28,GSW,MEM
37,@,L 100-103 ,240,42,81,.519,39,71,.549,3,10,.300,13,19,.684,100,34,70,.486,27,47,.574,7,23,.304,28,35,.800,103,2014-03-29,SAC,DAL
38,Home,W 100-94 ,240,34,78,.436,31,57,.544,3,21,.143,29,34,.853,100,38,79,.481,29,62,.468,9,17,.529,9,13,.692,94,2014-03-31,CHA,WAS
39,Home,W 100-92 ,240,32,83,.386,30,72,.417,2,11,.182,34,38,.895,100,29,80,.363,22,57,.386,7,23,.304,27,32,.844,92,2014-04-04,MEM,DEN
40,Home,W 100-96 ,240,33,64,.516,29,53,.547,4,11,.364,30,35,.857,100,34,73,.466,26,54,.481,8,19,.421,20,29,.690,96,2014-04-04,UTA,NOP
41,Home,W 100-92 ,240,43,79,.544,34,62,.548,9,17,.529,5,9,.556,100,36,77,.468,35,63,.556,1,14,.071,19,28,.679,92,2014-04-05,ORL,MIN
42,Home,W 100-94 ,240,41,87,.471,36,65,.554,5,22,.227,13,15,.867,100,38,90,.422,34,78,.436,4,12,.333,14,18,.778,94,2014-04-06,POR,NOP
43,@,L 100-122 ,240,34,96,.354,25,68,.368,9,28,.321,23,32,.719,100,53,93,.570,42,67,.627,11,26,.423,5,9,.556,122,2014-04-09,DET,CLE
44,Home,W 100-99 ,240,38,75,.507,31,52,.596,7,23,.304,17,22,.773,100,39,91,.429,34,80,.425,5,11,.455,16,22,.727,99,2014-04-09,POR,SAC
45,Home,L 100-109 ,240,39,83,.470,34,71,.479,5,12,.417,17,21,.810,100,38,88,.432,22,54,.407,16,34,.471,17,22,.773,109,2014-04-10,DAL,SAS
46,@,W 100-99 ,240,39,104,.375,29,70,.414,10,34,.294,12,19,.632,100,40,88,.455,34,65,.523,6,23,.261,13,15,.867,99,2014-04-10,DEN,GSW
47,Home,L 100-108 ,240,30,76,.395,15,43,.349,15,33,.455,25,31,.806,100,35,73,.479,29,49,.592,6,24,.250,32,36,.889,108,2014-04-11,TOR,NYK
48,Home,W 100-89 ,240,37,81,.457,28,56,.500,9,25,.360,17,21,.810,100,29,74,.392,23,52,.442,6,22,.273,25,32,.781,89,2014-04-13,NYK,CHI
49,@,L 100-110 ,240,38,73,.521,32,63,.508,6,10,.600,18,26,.692,100,38,81,.469,24,49,.490,14,32,.438,20,26,.769,110,2014-04-14,MIL,TOR
50,@,W 100-87 ,240,38,74,.514,28,51,.549,10,23,.435,14,16,.875,100,30,73,.411,20,43,.465,10,30,.333,17,22,.773,87,2014-04-16,PHI,MIA
51,@,L 100-105 ,240,35,81,.432,21,51,.412,14,30,.467,16,24,.667,100,43,82,.524,37,70,.529,6,12,.500,13,20,.650,105,2014-04-16,HOU,NOP
52,Home,L 100-113 ,240,41,99,.414,31,69,.449,10,30,.333,8,10,.800,100,45,91,.495,34,64,.531,11,27,.407,12,17,.706,113,2014-04-16,SAS,LAL
53,@,L 100-101 ,240,38,78,.487,30,57,.526,8,21,.381,16,19,.842,100,37,70,.529,23,42,.548,14,28,.500,13,16,.813,101,2014-10-28,DAL,SAS
54,Home,W 100-91 ,240,38,81,.469,33,63,.524,5,18,.278,19,19,1.000,100,37,80,.463,31,59,.525,6,21,.286,11,13,.846,91,2014-11-04,NOP,CHO
55,Home,W 100-88 ,240,32,81,.395,24,50,.480,8,31,.258,28,33,.848,100,34,65,.523,28,44,.636,6,21,.286,14,25,.560,88,2014-11-04,TOR,OKC
56,@,L 100-102 ,240,30,72,.417,24,56,.429,6,16,.375,34,40,.850,100,39,77,.506,32,56,.571,7,21,.333,17,22,.773,102,2014-11-05,CLE,UTA
57,@,W 100-99 ,240,40,85,.471,32,64,.500,8,21,.381,12,14,.857,100,36,80,.450,31,62,.500,5,18,.278,22,29,.759,99,2014-11-08,NOP,SAS
58,@,L 100-116 ,240,36,91,.396,31,78,.397,5,13,.385,23,30,.767,100,45,100,.450,29,69,.420,16,31,.516,10,14,.714,116,2014-11-09,DEN,POR
59,Home,L 100-113 ,240,38,70,.543,31,50,.620,7,20,.350,17,20,.850,100,46,93,.495,36,68,.529,10,25,.400,11,15,.733,113,2014-11-11,GSW,SAS
60,@,L 100-102 ,240,35,75,.467,28,59,.475,7,16,.438,23,27,.852,100,40,93,.430,32,68,.471,8,25,.320,14,16,.875,102,2014-11-11,CHO,POR
61,@,L 100-104 ,240,39,81,.481,27,56,.482,12,25,.480,10,16,.625,100,35,77,.455,26,56,.464,9,21,.429,25,30,.833,104,2014-11-11,ORL,TOR
62,Home,W 100-97 ,240,39,76,.513,30,56,.536,9,20,.450,13,18,.722,100,43,86,.500,38,63,.603,5,23,.217,6,12,.500,97,2014-11-12,ATL,UTA
63,@,W 100-93 ,240,37,77,.481,33,62,.532,4,15,.267,22,32,.688,100,35,89,.393,27,64,.422,8,25,.320,15,21,.714,93,2014-11-13,CHI,TOR
64,Home,L 100-102 ,240,39,82,.476,34,74,.459,5,8,.625,17,20,.850,100,36,70,.514,26,48,.542,10,22,.455,20,25,.800,102,2014-11-14,NYK,UTA
65,Home,W 100-75 ,240,36,81,.444,26,55,.473,10,26,.385,18,21,.857,100,27,83,.325,23,57,.404,4,26,.154,17,24,.708,75,2014-11-17,SAS,PHI
66,Home,L 100-106 ,240,38,86,.442,34,75,.453,4,11,.364,20,29,.690,100,39,79,.494,30,55,.545,9,24,.375,19,24,.792,106,2014-11-18,SAC,NOP
67,@,L 100-107 ,240,36,79,.456,26,56,.464,10,23,.435,18,25,.720,100,40,82,.488,30,53,.566,10,29,.345,17,22,.773,107,2014-11-19,OKC,DEN
68,Home,L 100-105 ,240,42,91,.462,35,71,.493,7,20,.350,9,15,.600,100,39,82,.476,35,66,.530,4,16,.250,23,32,.719,105,2014-11-21,CHO,ORL
69,@,L 100-117 ,240,38,88,.432,29,61,.475,9,27,.333,15,21,.714,100,48,91,.527,40,75,.533,8,16,.500,13,14,.929,117,2014-11-21,BOS,MEM
70,Home,L 100-111 ,240,36,84,.429,31,69,.449,5,15,.333,23,26,.885,100,43,93,.462,35,75,.467,8,18,.444,17,22,.773,111,2014-11-22,MIL,WAS
71,Home,L 100-111 ,240,40,80,.500,32,56,.571,8,24,.333,12,21,.571,100,37,77,.481,24,51,.471,13,26,.500,24,36,.667,111,2014-11-24,DAL,IND
72,@,L 100-104 ,240,39,84,.464,25,51,.490,14,33,.424,8,11,.727,100,37,82,.451,33,65,.508,4,17,.235,26,32,.813,104,2014-11-24,PHO,TOR
73,@,L 100-106 ,240,40,87,.460,30,66,.455,10,21,.476,10,18,.556,100,41,74,.554,36,59,.610,5,15,.333,19,29,.655,106,2014-11-26,IND,SAS
74,Home,W 100-91 ,240,38,76,.500,33,59,.559,5,17,.294,19,22,.864,100,36,89,.404,29,65,.446,7,24,.292,12,16,.750,91,2014-11-28,ATL,NOP
75,Home,W 100-95 ,240,33,81,.407,22,54,.407,11,27,.407,23,31,.742,100,34,93,.366,27,65,.415,7,28,.250,20,26,.769,95,2014-12-06,HOU,PHO
76,@,L 100-120 ,240,38,80,.475,30,57,.526,8,23,.348,16,25,.640,100,43,78,.551,26,46,.565,17,32,.531,17,24,.708,120,2014-12-06,NOP,LAC
77,Home,W 100-96 ,240,40,80,.500,36,66,.545,4,14,.286,16,22,.727,100,39,84,.464,35,64,.547,4,20,.200,14,23,.609,96,2014-12-09,UTA,SAS
78,@,W 100-95 ,240,36,72,.500,29,52,.558,7,20,.350,21,31,.677,100,34,77,.442,26,49,.531,8,28,.286,19,22,.864,95,2014-12-12,MIA,UTA
79,Home,W 100-99 ,240,37,74,.500,27,53,.509,10,21,.476,16,21,.762,100,35,84,.417,27,57,.474,8,27,.296,21,24,.875,99,2014-12-13,ORL,ATL
80,@,W 100-94 ,240,34,81,.420,29,64,.453,5,17,.294,27,34,.794,100,38,90,.422,35,80,.438,3,10,.300,15,20,.750,94,2014-12-14,LAL,MIN
81,@,L 100-102 ,240,40,90,.444,36,71,.507,4,19,.211,16,23,.696,100,34,78,.436,28,60,.467,6,18,.333,28,45,.622,102,2014-12-17,IND,LAC
82,Home,L 100-110 ,240,41,94,.436,33,69,.478,8,25,.320,10,15,.667,100,42,88,.477,34,61,.557,8,27,.296,18,24,.750,110,2014-12-19,DET,TOR
83,Home,W 100-84 ,240,37,78,.474,31,57,.544,6,21,.286,20,26,.769,100,33,83,.398,27,60,.450,6,23,.261,12,15,.800,84,2014-12-21,MIA,BOS
84,@,W 100-96 ,240,42,84,.500,36,65,.554,6,19,.316,10,14,.714,100,36,77,.468,31,66,.470,5,11,.455,19,24,.792,96,2014-12-21,IND,MIN
85,Home,W 100-95 ,240,39,83,.470,32,65,.492,7,18,.389,15,23,.652,100,33,85,.388,26,62,.419,7,23,.304,22,29,.759,95,2014-12-23,ORL,BOS
86,Home,W 100-86 ,240,34,87,.391,25,55,.455,9,32,.281,23,31,.742,100,34,80,.425,28,52,.538,6,28,.214,12,22,.545,86,2014-12-25,LAC,GSW
87,@,L 100-107 ,240,41,88,.466,37,74,.500,4,14,.286,14,16,.875,100,41,89,.461,35,69,.507,6,20,.300,19,22,.864,107,2014-12-27,NOP,CHI
88,Home,W 100-94 ,240,38,79,.481,31,60,.517,7,19,.368,17,22,.773,100,38,82,.463,30,65,.462,8,17,.471,10,14,.714,94,2014-12-30,UTA,MIN
89,@,W 100-98 ,240,41,72,.569,34,52,.654,7,20,.350,11,18,.611,100,37,88,.420,26,66,.394,11,22,.500,13,20,.650,98,2015-01-02,BRK,ORL
90,Home,W 100-95 ,240,38,89,.427,27,66,.409,11,23,.478,13,18,.722,100,37,83,.446,30,57,.526,7,26,.269,14,21,.667,95,2015-01-09,SAS,PHO
91,@,L 100-120 ,240,38,86,.442,26,56,.464,12,30,.400,12,17,.706,100,46,88,.523,33,57,.579,13,31,.419,15,21,.714,120,2015-01-10,DAL,LAC
92,@,L 100-108 ,240,31,75,.413,25,60,.417,6,15,.400,32,37,.865,100,37,88,.420,29,64,.453,8,24,.333,26,31,.839,108,2015-01-12,NOP,BOS
93,@,L 100-107 ,240,36,82,.439,23,47,.489,13,35,.371,15,20,.750,100,40,76,.526,33,56,.589,7,20,.350,20,27,.741,107,2015-01-13,CLE,PHO
94,@,W 100-94 ,240,37,88,.420,29,65,.446,8,23,.348,18,19,.947,100,35,87,.402,29,61,.475,6,26,.231,18,20,.900,94,2015-01-14,LAC,POR
95,Home,W 100-84 ,240,38,82,.463,28,53,.528,10,29,.345,14,22,.636,100,31,80,.388,28,61,.459,3,19,.158,19,31,.613,84,2015-01-14,TOR,PHI
96,@,L 100-115 ,240,34,75,.453,26,58,.448,8,17,.471,24,35,.686,100,43,86,.500,30,54,.556,13,32,.406,16,22,.727,115,2015-01-19,LAL,PHO
97,Home,L 100-103 ,240,39,84,.464,34,66,.515,5,18,.278,17,24,.708,100,37,79,.468,32,59,.542,5,20,.250,24,30,.800,103,2015-01-21,SAC,BRK
98,@,W 100-99 ,240,37,75,.493,28,54,.519,9,21,.429,17,27,.630,100,37,89,.416,31,68,.456,6,21,.286,19,26,.731,99,2015-01-23,BOS,DEN
99,@,L 100-112 ,240,37,71,.521,31,55,.564,6,16,.375,20,25,.800,100,45,80,.563,35,52,.673,10,28,.357,12,18,.667,112,2015-01-25,MIN,ATL
0,Home,L 100-120 ,240,34,80,.425,24,51,.471,10,29,.345,22,27,.815,100,43,87,.494,33,64,.516,10,23,.435,24,36,.667,120,2015-01-25,PHO,LAC
1,Home,W 100-92 ,240,40,91,.440,32,74,.432,8,17,.471,12,17,.706,100,34,85,.400,29,63,.460,5,22,.227,19,22,.864,92,2015-01-28,NYK,OKC
2,Home,L 100-115 ,240,37,82,.451,32,64,.500,5,18,.278,21,30,.700,100,45,87,.517,33,62,.532,12,25,.480,13,18,.722,115,2015-01-29,ORL,MIL
3,@,L 100-110 ,240,37,86,.430,29,59,.492,8,27,.296,18,25,.720,100,42,94,.447,33,69,.478,9,25,.360,17,28,.607,110,2015-01-30,GSW,UTA
4,@,L 100-102 ,240,42,89,.472,34,66,.515,8,23,.348,8,25,.320,100,41,83,.494,29,56,.518,12,27,.444,8,18,.444,102,2015-02-02,LAC,BRK
5,Home,W 100-94 ,240,39,84,.464,29,53,.547,10,31,.323,12,18,.667,100,34,82,.415,31,69,.449,3,13,.231,23,26,.885,94,2015-02-02,DAL,MIN
6,@,L 100-115 ,240,40,89,.449,33,67,.493,7,22,.318,13,17,.765,100,43,86,.500,34,63,.540,9,23,.391,20,23,.870,115,2015-02-02,ATL,NOP
7,@,L 100-104 ,240,33,80,.413,29,56,.518,4,24,.167,30,33,.909,100,40,99,.404,28,71,.394,12,28,.429,12,17,.706,104,2015-02-04,DEN,BOS
8,@,W 100-90 ,240,38,80,.475,32,67,.478,6,13,.462,18,22,.818,100,33,73,.452,26,50,.520,7,23,.304,17,26,.654,90,2015-02-04,MEM,UTA
9,Home,W 100-93 ,240,38,84,.452,24,57,.421,14,27,.519,10,14,.714,100,37,80,.463,30,60,.500,7,20,.350,12,18,.667,93,2015-02-06,PHO,UTA
10,@,W 100-96 ,240,39,93,.419,30,72,.417,9,21,.429,13,19,.684,100,33,79,.418,20,57,.351,13,22,.591,17,20,.850,96,2015-02-09,UTA,NOP
11,@,L 100-111 ,240,36,87,.414,24,50,.480,12,37,.324,16,26,.615,100,44,93,.473,35,69,.507,9,24,.375,14,18,.778,111,2015-02-20,HOU,DAL
12,Home,W 100-91 ,240,38,84,.452,32,62,.516,6,22,.273,18,33,.545,100,33,78,.423,28,62,.452,5,16,.313,20,22,.909,91,2015-02-20,DET,CHI
13,Home,W 100-97 ,240,40,78,.513,30,56,.536,10,22,.455,10,16,.625,100,35,84,.417,30,61,.492,5,23,.217,22,31,.710,97,2015-02-23,NOP,TOR
14,@,W 100-97 ,240,40,89,.449,38,78,.487,2,11,.182,18,21,.857,100,34,73,.466,27,61,.443,7,12,.583,22,34,.647,97,2015-02-25,LAL,UTA
15,Home,L 100-102 ,240,42,86,.488,31,58,.534,11,28,.393,5,5,1.000,100,42,83,.506,38,67,.567,4,16,.250,14,17,.824,102,2015-03-04,HOU,MEM
16,Home,W 100-94 ,240,32,79,.405,29,63,.460,3,16,.188,33,43,.767,100,38,88,.432,31,70,.443,7,18,.389,11,17,.647,94,2015-03-04,MIA,LAL
17,@,W 100-85 ,240,42,92,.457,34,72,.472,8,20,.400,8,10,.800,100,32,82,.390,29,64,.453,3,18,.167,18,25,.720,85,2015-03-04,DEN,MIN
18,Home,L 100-105 ,240,41,87,.471,36,67,.537,5,20,.250,13,15,.867,100,37,79,.468,29,58,.500,8,21,.381,23,27,.852,105,2015-03-04,ORL,PHO
19,Home,L 100-108 (OT),265,34,97,.351,26,75,.347,8,22,.364,24,29,.828,100,39,91,.429,36,65,.554,3,26,.115,27,35,.771,108,2015-03-06,BRK,PHO
20,Home,L 100-114 ,240,38,92,.413,29,62,.468,9,30,.300,15,19,.789,100,40,86,.465,30,58,.517,10,28,.357,24,32,.750,114,2015-03-07,DEN,HOU
21,@,W 100-93 ,240,38,78,.487,29,52,.558,9,26,.346,15,22,.682,100,38,82,.463,36,68,.529,2,14,.143,15,21,.714,93,2015-03-08,DAL,LAL
22,@,W 100-90 ,240,39,87,.448,33,62,.532,6,25,.240,16,17,.941,100,29,69,.420,25,52,.481,4,17,.235,28,34,.824,90,2015-03-09,BOS,MIA
23,@,L 100-105 ,240,38,91,.418,27,60,.450,11,31,.355,13,23,.565,100,42,92,.457,32,59,.542,10,33,.303,11,14,.786,105,2015-03-11,HOU,POR
24,@,W 100-98 ,240,32,86,.372,25,56,.446,7,30,.233,29,36,.806,100,36,82,.439,24,56,.429,12,26,.462,14,24,.583,98,2015-03-15,HOU,LAC
25,@,L 100-109 ,240,37,83,.446,28,54,.519,9,29,.310,17,24,.708,100,40,87,.460,32,66,.485,8,21,.381,21,30,.700,109,2015-03-15,CHI,OKC
26,@,L 100-104 (OT),265,36,94,.383,33,80,.413,3,14,.214,25,30,.833,100,41,91,.451,38,77,.494,3,14,.214,19,27,.704,104,2015-03-17,SAS,NYK
27,@,L 100-105 ,240,42,87,.483,36,70,.514,6,17,.353,10,15,.667,100,35,79,.443,23,50,.460,12,29,.414,23,27,.852,105,2015-03-18,MIN,TOR
28,@,L 100-107 ,240,38,75,.507,26,53,.491,12,22,.545,12,16,.750,100,42,91,.462,35,68,.515,7,23,.304,16,23,.696,107,2015-03-22,NOP,LAC
29,Home,L 100-119 ,240,41,85,.482,37,68,.544,4,17,.235,14,17,.824,100,42,90,.467,30,62,.484,12,28,.429,23,30,.767,119,2015-03-22,ORL,DEN
30,Home,L 100-110 ,240,40,90,.444,32,66,.485,8,24,.333,12,19,.632,100,31,65,.477,18,41,.439,13,24,.542,35,37,.946,110,2015-03-23,IND,HOU
31,@,L 100-115 ,240,37,86,.430,22,56,.393,15,30,.500,11,14,.786,100,42,80,.525,30,54,.556,12,26,.462,19,22,.864,115,2015-03-28,ATL,CHO
32,Home,W 100-87 ,240,39,86,.453,33,59,.559,6,27,.222,16,18,.889,100,34,81,.420,28,66,.424,6,15,.400,13,23,.565,87,2015-04-01,BOS,IND
33,@,W 100-98 ,240,41,81,.506,32,65,.492,9,16,.563,9,12,.750,100,37,81,.457,26,58,.448,11,23,.478,13,15,.867,98,2015-04-01,BRK,NYK
34,Home,W 100-92 ,240,38,80,.475,34,59,.576,4,21,.190,20,28,.714,100,36,88,.409,32,71,.451,4,17,.235,16,26,.615,92,2015-04-03,MEM,OKC
35,@,L 100-105 ,240,35,84,.417,26,59,.441,9,25,.360,21,27,.778,100,39,81,.481,32,57,.561,7,24,.292,20,30,.667,105,2015-04-07,LAL,LAC
36,@,L 100-105 ,240,39,91,.429,34,73,.466,5,18,.278,17,21,.810,100,40,81,.494,37,66,.561,3,15,.200,22,28,.786,105,2015-04-07,CHO,MIA
37,@,L 100-103 ,240,42,95,.442,33,73,.452,9,22,.409,7,10,.700,100,36,83,.434,27,64,.422,9,19,.474,22,30,.733,103,2015-04-07,GSW,NOP
38,@,W 100-90 ,240,35,85,.412,26,50,.520,9,35,.257,21,26,.808,100,34,83,.410,21,51,.412,13,32,.406,9,17,.529,90,2015-04-13,HOU,CHO
39,Home,W 100-93 ,240,39,83,.470,36,73,.493,3,10,.300,19,23,.826,100,35,85,.412,29,64,.453,6,21,.286,17,28,.607,93,2015-04-13,MIA,ORL
40,@,W 100-88 ,240,37,84,.440,31,63,.492,6,21,.286,20,24,.833,100,31,78,.397,27,64,.422,4,14,.286,22,28,.786,88,2015-04-13,NOP,MIN
41,Home,L 100-105 ,240,41,89,.461,34,68,.500,7,21,.333,11,16,.688,100,42,85,.494,29,55,.527,13,30,.433,8,14,.571,105,2015-04-15,MIL,BOS
42,Home,L 100-115 ,240,39,93,.419,39,84,.464,0,9,.000,22,28,.786,100,42,78,.538,28,50,.560,14,28,.500,17,20,.850,115,2015-10-28,BRK,CHI
43,Home,L 100-107 ,240,38,85,.447,31,61,.508,7,24,.292,17,23,.739,100,42,81,.519,34,59,.576,8,22,.364,15,20,.750,107,2015-11-02,PHI,CLE
44,Home,W 100-98 ,240,35,91,.385,27,68,.397,8,23,.348,22,29,.759,100,35,83,.422,25,56,.446,10,27,.370,18,22,.818,98,2015-11-04,IND,BOS
45,@,W 100-92 ,240,37,74,.500,29,52,.558,8,22,.364,18,36,.500,100,37,92,.402,27,62,.435,10,30,.333,8,13,.615,92,2015-11-06,DET,PHO
46,@,W 100-84 ,240,36,75,.480,25,48,.521,11,27,.407,17,23,.739,100,24,70,.343,21,55,.382,3,15,.200,33,36,.917,84,2015-11-11,GSW,MEM
47,@,L 100-101 ,240,33,69,.478,25,47,.532,8,22,.364,26,29,.897,100,36,86,.419,30,70,.429,6,16,.375,23,27,.852,101,2015-11-13,POR,MEM
48,Home,W 100-81 ,240,34,77,.442,25,56,.446,9,21,.429,23,27,.852,100,30,82,.366,23,59,.390,7,23,.304,14,20,.700,81,2015-11-13,TOR,NOP
49,@,W 100-85 ,240,39,82,.476,30,59,.508,9,23,.391,13,20,.650,100,28,77,.364,22,52,.423,6,25,.240,23,29,.793,85,2015-11-15,BOS,OKC
50,@,L 100-115 ,240,38,73,.521,35,65,.538,3,8,.375,21,26,.808,100,40,71,.563,29,47,.617,11,24,.458,24,30,.800,115,2015-11-19,MIL,CLE
51,Home,W 100-95 ,240,36,78,.462,33,66,.500,3,12,.250,25,27,.926,100,32,78,.410,22,47,.468,10,31,.323,21,27,.778,95,2015-11-23,MIN,PHI
52,Home,W 100-91 ,240,34,86,.395,29,70,.414,5,16,.313,27,32,.844,100,31,83,.373,22,56,.393,9,27,.333,20,25,.800,91,2015-11-25,ORL,NYK
53,@,L 100-106 ,240,37,93,.398,30,74,.405,7,19,.368,19,22,.864,100,39,90,.433,29,62,.468,10,28,.357,18,20,.900,106,2015-11-30,OKC,ATL
54,Home,W 100-87 ,240,37,74,.500,27,48,.563,10,26,.385,16,20,.800,100,32,86,.372,19,59,.322,13,27,.481,10,13,.769,87,2015-12-04,ATL,LAL
55,@,W 100-96 ,240,39,84,.464,27,58,.466,12,26,.462,10,18,.556,100,37,81,.457,29,52,.558,8,29,.276,14,20,.700,96,2015-12-04,HOU,DAL
56,@,L 100-105 ,240,40,79,.506,29,53,.547,11,26,.423,9,16,.563,100,40,79,.506,31,58,.534,9,21,.429,16,20,.800,105,2015-12-08,POR,CLE
57,@,L 100-105 ,240,39,91,.429,33,70,.471,6,21,.286,16,23,.696,100,38,92,.413,33,69,.478,5,23,.217,24,28,.857,105,2015-12-09,CHI,BOS
58,Home,W 100-91 ,240,37,74,.500,31,60,.517,6,14,.429,20,27,.741,100,34,87,.391,30,56,.536,4,31,.129,19,22,.864,91,2015-12-10,BRK,PHI
59,Home,L 100-105 ,240,35,79,.443,30,60,.500,5,19,.263,25,30,.833,100,43,86,.500,35,62,.565,8,24,.333,11,18,.611,105,2015-12-12,BRK,LAC
60,Home,W 100-97 ,240,37,77,.481,30,55,.545,7,22,.318,19,23,.826,100,40,77,.519,33,58,.569,7,19,.368,10,14,.714,97,2015-12-13,MIA,MEM
61,@,W 100-88 ,240,40,89,.449,33,73,.452,7,16,.438,13,15,.867,100,33,84,.393,25,51,.490,8,33,.242,14,15,.933,88,2015-12-14,MIA,ATL
62,Home,L 100-112 ,240,36,77,.468,32,67,.478,4,10,.400,24,31,.774,100,41,73,.562,31,55,.564,10,18,.556,20,27,.741,112,2015-12-15,MIN,DEN
63,@,L 100-104 ,240,35,74,.473,29,54,.537,6,20,.300,24,28,.857,100,41,88,.466,29,59,.492,12,29,.414,10,13,.769,104,2015-12-17,OKC,CLE
64,@,W 100-85 ,240,38,80,.475,35,68,.515,3,12,.250,21,24,.875,100,32,78,.410,27,57,.474,5,21,.238,16,20,.800,85,2015-12-20,MIN,BRK
65,Home,L 100-103 ,240,38,81,.469,34,69,.493,4,12,.333,20,24,.833,100,39,78,.500,28,56,.500,11,22,.500,14,20,.700,103,2015-12-20,ORL,ATL
66,@,W 100-99 ,240,40,85,.471,36,68,.529,4,17,.235,16,20,.800,100,41,87,.471,34,65,.523,7,22,.318,10,14,.714,99,2015-12-21,OKC,LAC
67,@,L 100-107 ,240,38,89,.427,31,68,.456,7,21,.333,17,33,.515,100,43,89,.483,37,69,.536,6,20,.300,15,20,.750,107,2015-12-23,DET,ATL
68,@,L 100-113 ,240,37,81,.457,30,61,.492,7,20,.350,19,29,.655,100,51,85,.600,46,73,.630,5,12,.417,6,8,.750,113,2015-12-23,PHI,MIL
69,Home,W 100-91 ,240,37,82,.451,26,57,.456,11,25,.440,15,19,.789,100,33,72,.458,30,55,.545,3,17,.176,22,32,.688,91,2015-12-23,WAS,MEM
70,Home,W 100-91 ,240,36,85,.424,28,65,.431,8,20,.400,20,29,.690,100,33,89,.371,29,70,.414,4,19,.211,21,24,.875,91,2015-12-27,BOS,NYK
71,@,L 100-102 (OT),265,37,97,.381,30,75,.400,7,22,.318,19,24,.792,100,37,86,.430,31,68,.456,6,18,.333,22,27,.815,102,2015-12-30,IND,CHI
72,Home,W 100-93 ,240,36,82,.439,27,56,.482,9,26,.346,19,21,.905,100,35,83,.422,32,63,.508,3,20,.150,20,22,.909,93,2015-12-30,ORL,BRK
73,@,W 100-97 ,240,38,93,.409,35,75,.467,3,18,.167,21,22,.955,100,34,88,.386,27,56,.482,7,32,.219,22,28,.786,97,2016-01-02,BRK,BOS
74,@,L 100-122 ,240,36,73,.493,28,54,.519,8,19,.421,20,29,.690,100,41,74,.554,24,41,.585,17,33,.515,23,26,.885,122,2016-01-04,TOR,CLE
75,@,L 100-103 (OT),265,37,94,.394,29,66,.439,8,28,.286,18,25,.720,100,34,90,.378,29,68,.426,5,22,.227,30,39,.769,103,2016-01-04,IND,MIA
76,@,W 100-91 ,240,37,87,.425,30,59,.508,7,28,.250,19,22,.864,100,34,92,.370,27,62,.435,7,30,.233,16,20,.800,91,2016-01-06,DAL,NOP
77,Home,W 100-99 ,240,41,93,.441,37,80,.463,4,13,.308,14,17,.824,100,38,91,.418,29,70,.414,9,21,.429,14,17,.824,99,2016-01-08,SAS,NYK
78,Home,W 100-88 ,240,39,84,.464,32,60,.533,7,24,.292,15,18,.833,100,32,80,.400,29,67,.433,3,13,.231,21,30,.700,88,2016-01-10,NYK,MIL
79,Home,L 100-114 ,240,34,81,.420,25,59,.424,9,22,.409,23,27,.852,100,48,99,.485,39,75,.520,9,24,.375,9,10,.900,114,2016-01-11,CHI,WAS
80,@,L 100-112 ,240,39,76,.513,34,62,.548,5,14,.357,17,19,.895,100,43,85,.506,30,61,.492,13,24,.542,13,18,.722,112,2016-01-18,BRK,TOR
81,@,L 100-107 ,240,33,80,.413,20,56,.357,13,24,.542,21,29,.724,100,38,77,.494,33,64,.516,5,13,.385,26,31,.839,107,2016-01-26,ORL,MIL
82,Home,L 100-105 ,240,40,82,.488,33,66,.500,7,16,.438,13,15,.867,100,42,98,.429,32,68,.471,10,30,.333,11,16,.688,105,2016-02-01,BRK,DET
83,Home,L 100-114 ,240,36,81,.444,29,58,.500,7,23,.304,21,31,.677,100,44,88,.500,32,64,.500,12,24,.500,14,17,.824,114,2016-02-03,BRK,IND
84,@,W 100-93 ,240,37,81,.457,28,56,.500,9,25,.360,17,33,.515,100,33,83,.398,26,66,.394,7,17,.412,20,29,.690,93,2016-02-07,LAC,MIA
85,@,L 100-120 ,240,36,82,.439,27,59,.458,9,23,.391,19,29,.655,100,45,94,.479,29,59,.492,16,35,.457,14,19,.737,120,2016-02-08,SAC,CLE
86,Home,W 100-96 ,240,39,82,.476,31,63,.492,8,19,.421,14,21,.667,100,33,70,.471,26,49,.531,7,21,.333,23,30,.767,96,2016-02-10,NOP,UTA
87,Home,L 100-116 ,240,30,82,.366,19,47,.404,11,35,.314,29,35,.829,100,37,78,.474,30,54,.556,7,24,.292,35,56,.625,116,2016-02-19,PHO,HOU
88,Home,W 100-95 ,240,37,84,.440,31,66,.470,6,18,.333,20,29,.690,100,38,101,.376,31,77,.403,7,24,.292,12,17,.706,95,2016-02-29,BOS,UTA
89,Home,W 100-96 ,240,35,83,.422,26,54,.481,9,29,.310,21,25,.840,100,37,80,.463,29,62,.468,8,18,.444,14,15,.933,96,2016-02-29,CLE,IND
90,Home,W 100-95 ,240,36,81,.444,33,46,.717,3,35,.086,25,38,.658,100,36,90,.400,22,53,.415,14,37,.378,9,13,.692,95,2016-03-02,HOU,NOP
91,@,L 100-108 ,240,35,87,.402,26,52,.500,9,35,.257,21,30,.700,100,36,79,.456,27,58,.466,9,21,.429,27,34,.794,108,2016-03-05,HOU,CHI
92,@,W 100-99 ,240,37,83,.446,30,62,.484,7,21,.333,19,20,.950,100,39,89,.438,33,74,.446,6,15,.400,15,24,.625,99,2016-03-05,IND,WAS
93,Home,L 100-109 ,240,32,80,.400,22,58,.379,10,22,.455,26,33,.788,100,37,71,.521,25,43,.581,12,28,.429,23,30,.767,109,2016-03-06,MEM,PHO
94,Home,W 100-90 ,240,39,78,.500,29,53,.547,10,25,.400,12,15,.800,100,36,91,.396,29,73,.397,7,18,.389,11,17,.647,90,2016-03-07,CHI,MIL
95,Home,L 100-107 ,240,35,88,.398,27,63,.429,8,25,.320,22,25,.880,100,41,79,.519,37,64,.578,4,15,.267,21,34,.618,107,2016-03-11,SAC,ORL
96,@,L 100-116 ,240,36,86,.419,29,65,.446,7,21,.333,21,29,.724,100,42,80,.525,34,56,.607,8,24,.333,24,29,.828,116,2016-03-12,WAS,DEN
97,Home,L 100-109 ,240,39,70,.557,27,43,.628,12,27,.444,10,13,.769,100,45,89,.506,39,75,.520,6,14,.429,13,21,.619,109,2016-03-13,BRK,MIL
98,@,L 100-105 ,240,40,83,.482,32,61,.525,8,22,.364,12,18,.667,100,35,81,.432,29,61,.475,6,20,.300,29,45,.644,105,2016-03-20,ORL,TOR
99,Home,L 100-105 ,240,34,74,.459,26,56,.464,8,18,.444,24,27,.889,100,39,82,.476,29,54,.537,10,28,.357,17,21,.810,105,2016-03-22,BRK,CHO
0,@,L 100-107 ,240,40,80,.500,36,65,.554,4,15,.267,16,23,.696,100,39,77,.506,33,58,.569,6,19,.316,23,24,.958,107,2016-03-22,MEM,LAL
1,Home,L 100-102 ,240,40,106,.377,31,84,.369,9,22,.409,11,15,.733,100,36,85,.424,31,63,.492,5,22,.227,25,28,.893,102,2016-03-28,CHI,ATL
2,Home,L 100-119 ,240,38,93,.409,30,69,.435,8,24,.333,16,23,.696,100,41,86,.477,30,60,.500,11,26,.423,26,32,.813,119,2016-03-28,TOR,OKC
3,Home,L 100-106 ,240,31,86,.360,17,46,.370,14,40,.350,24,28,.857,100,38,79,.481,29,54,.537,9,25,.360,21,42,.500,106,2016-03-29,CLE,HOU
4,@,W 100-85 ,240,38,87,.437,31,62,.500,7,25,.280,17,18,.944,100,30,96,.313,14,52,.269,16,44,.364,9,10,.900,85,2016-03-29,CHO,PHI
5,@,L 100-102 (OT),265,41,86,.477,38,69,.551,3,17,.176,15,26,.577,100,37,102,.363,31,82,.378,6,20,.300,22,29,.759,102,2016-03-30,MIA,LAL
6,Home,W 100-92 ,240,36,75,.480,24,51,.471,12,24,.500,16,22,.727,100,36,80,.450,28,63,.444,8,17,.471,12,18,.667,92,2016-03-30,SAS,NOP
7,Home,L 100-103 ,240,36,90,.400,27,65,.415,9,25,.360,19,22,.864,100,37,77,.481,26,53,.491,11,24,.458,18,22,.818,103,2016-03-31,HOU,CHI
8,Home,W 100-91 ,240,36,84,.429,29,57,.509,7,27,.259,21,27,.778,100,33,90,.367,23,51,.451,10,39,.256,15,21,.714,91,2016-04-01,CHO,PHI
9,Home,L 100-107 ,240,37,90,.411,31,69,.449,6,21,.286,20,29,.690,100,41,91,.451,33,61,.541,8,30,.267,17,22,.773,107,2016-04-03,LAL,BOS
10,@,W 100-99 ,240,39,87,.448,29,51,.569,10,36,.278,12,13,.923,100,37,96,.385,30,75,.400,7,21,.333,18,20,.900,99,2016-04-09,GSW,MEM
11,Home,L 100-121 ,240,39,95,.411,32,74,.432,7,21,.333,15,20,.750,100,43,83,.518,33,58,.569,10,25,.400,25,31,.806,121,2016-04-09,NOP,PHO
12,@,W 100-84 ,240,36,79,.456,24,48,.500,12,31,.387,16,21,.762,100,32,80,.400,26,53,.491,6,27,.222,14,19,.737,84,2016-04-10,UTA,DEN
13,Home,L 100-114 ,240,34,89,.382,26,65,.400,8,24,.333,24,29,.828,100,41,81,.506,27,49,.551,14,32,.438,18,22,.818,114,2016-04-11,BOS,CHO
14,Home,L 100-129 ,240,40,85,.471,33,52,.635,7,33,.212,13,18,.722,100,47,98,.480,35,74,.473,12,24,.500,23,26,.885,129,2016-10-25,GSW,SAS
15,Home,L 100-106 ,240,37,90,.411,29,67,.433,8,23,.348,18,25,.720,100,35,83,.422,27,54,.500,8,29,.276,28,33,.848,106,2016-10-30,PHO,GSW
16,@,L 100-107 ,240,35,81,.432,28,61,.459,7,20,.350,23,31,.742,100,41,87,.471,27,55,.491,14,32,.438,11,17,.647,107,2016-11-02,CHI,BOS
17,@,W 100-86 ,240,37,83,.446,31,63,.492,6,20,.300,20,22,.909,100,30,80,.375,19,54,.352,11,26,.423,15,24,.625,86,2016-11-04,SAS,UTA
18,@,W 100-94 ,240,32,71,.451,18,38,.474,14,33,.424,22,27,.815,100,31,81,.383,25,55,.455,6,26,.231,26,32,.813,94,2016-11-06,POR,MEM
19,@,L 100-122 ,240,40,94,.426,31,61,.508,9,33,.273,11,15,.733,100,41,84,.488,29,52,.558,12,32,.375,28,32,.875,122,2016-11-07,IND,CHO
20,@,L 100-107 ,240,32,89,.360,23,67,.343,9,22,.409,27,32,.844,100,38,84,.452,30,62,.484,8,22,.364,23,30,.767,107,2016-11-09,DET,PHO
21,Home,L 100-106 ,240,34,89,.382,19,42,.452,15,47,.319,17,21,.810,100,41,76,.539,36,58,.621,5,18,.278,19,24,.792,106,2016-11-12,HOU,SAS
22,Home,W 100-93 ,240,39,92,.424,25,54,.463,14,38,.368,8,15,.533,100,36,95,.379,25,66,.379,11,29,.379,10,12,.833,93,2016-11-13,CLE,CHO
23,@,L 100-107 ,240,39,98,.398,31,66,.470,8,32,.250,14,18,.778,100,35,72,.486,25,40,.625,10,32,.313,27,31,.871,107,2016-11-16,MIL,ATL
24,Home,W 100-96 ,240,37,90,.411,27,61,.443,10,29,.345,16,24,.667,100,39,84,.464,32,56,.571,7,28,.250,11,17,.647,96,2016-11-18,CHO,ATL
25,Home,L 100-112 ,240,42,88,.477,36,66,.545,6,22,.273,10,14,.714,100,40,75,.533,31,51,.608,9,24,.375,23,29,.793,112,2016-11-26,WAS,SAS
26,@,L 100-105 ,240,36,86,.419,29,57,.509,7,29,.241,21,30,.700,100,37,85,.435,25,50,.500,12,35,.343,19,24,.792,105,2016-11-28,ATL,GSW
27,@,L 100-103 ,240,35,81,.432,28,60,.467,7,21,.333,23,29,.793,100,41,88,.466,31,58,.534,10,30,.333,11,15,.733,103,2016-12-03,LAL,MEM
28,Home,L 100-103 ,240,35,87,.402,28,59,.475,7,28,.250,23,27,.852,100,36,84,.429,26,55,.473,10,29,.345,21,25,.840,103,2016-12-09,SAC,NYK
29,@,L 100-105 ,240,42,91,.462,37,71,.521,5,20,.250,11,18,.611,100,38,84,.452,37,76,.487,1,8,.125,28,31,.903,105,2016-12-10,MIA,CHI
30,@,L 100-122 ,240,42,89,.472,38,65,.585,4,24,.167,12,17,.706,100,42,81,.519,28,56,.500,14,25,.560,24,28,.857,122,2016-12-12,MIL,TOR
31,@,L 100-122 ,240,40,98,.408,31,71,.437,9,27,.333,11,20,.550,100,42,94,.447,18,33,.545,24,61,.393,14,19,.737,122,2016-12-16,NOP,HOU
32,@,W 100-89 ,240,36,79,.456,27,49,.551,9,30,.300,19,22,.864,100,32,88,.364,26,57,.456,6,31,.194,19,24,.792,89,2016-12-16,LAL,PHI
33,@,L 100-103 ,240,35,77,.455,23,49,.469,12,28,.429,18,21,.857,100,37,65,.569,29,43,.674,8,22,.364,21,27,.778,103,2016-12-16,DAL,UTA
34,@,L 100-113 ,240,41,89,.461,31,63,.492,10,26,.385,8,14,.571,100,42,86,.488,31,64,.484,11,22,.500,18,22,.818,113,2016-12-18,NOP,SAS
35,Home,L 100-102 ,240,35,92,.380,29,54,.537,6,38,.158,24,27,.889,100,36,77,.468,24,54,.444,12,23,.522,18,25,.720,102,2016-12-20,HOU,SAS
36,@,L 100-112 ,240,39,83,.470,35,71,.493,4,12,.333,18,23,.783,100,42,82,.512,34,58,.586,8,24,.333,20,24,.833,112,2016-12-25,MIN,OKC
37,@,L 100-119 ,240,39,86,.453,32,68,.471,7,18,.389,15,20,.750,100,48,85,.565,39,67,.582,9,18,.500,14,19,.737,119,2016-12-25,CHI,SAS
38,@,L 100-102 ,240,39,79,.494,30,54,.556,9,25,.360,13,18,.722,100,39,87,.448,32,62,.516,7,25,.280,17,21,.810,102,2016-12-26,PHI,SAC
39,Home,L 100-102 ,240,39,83,.470,35,67,.522,4,16,.250,18,22,.818,100,38,75,.507,29,49,.592,9,26,.346,17,24,.708,102,2016-12-27,LAL,UTA
40,Home,W 100-83 ,240,35,73,.479,20,47,.426,15,26,.577,15,28,.536,100,35,87,.402,29,63,.460,6,24,.250,7,8,.875,83,2016-12-29,UTA,PHI
41,@,L 100-127 ,240,38,92,.413,30,60,.500,8,32,.250,16,27,.593,100,48,96,.500,38,68,.559,10,28,.357,21,29,.724,127,2017-01-06,MIA,LAL
42,@,W 100-93 ,240,39,86,.453,24,37,.649,15,49,.306,7,12,.583,100,38,91,.418,30,68,.441,8,23,.348,9,13,.692,93,2017-01-06,HOU,ORL
43,Home,W 100-94 ,240,32,73,.438,19,50,.380,13,23,.565,23,29,.793,100,36,82,.439,24,55,.436,12,27,.444,10,16,.625,94,2017-01-10,SAC,DET
44,Home,W 100-92 ,240,38,79,.481,25,45,.556,13,34,.382,11,19,.579,100,31,85,.365,22,54,.407,9,31,.290,21,25,.840,92,2017-01-10,UTA,CLE
45,@,L 100-121 ,240,38,90,.422,30,62,.484,8,28,.286,16,19,.842,100,46,85,.541,36,64,.563,10,21,.476,19,27,.704,121,2017-01-18,OKC,GSW
46,Home,L 100-106 ,240,35,72,.486,26,51,.510,9,21,.429,21,27,.778,100,39,75,.520,32,54,.593,7,21,.333,21,25,.840,106,2017-01-18,SAC,IND
47,@,L 100-109 ,240,39,77,.506,29,57,.509,10,20,.500,12,17,.706,100,39,84,.464,33,60,.550,6,24,.250,25,32,.781,109,2017-01-21,IND,UTA
48,@,W 100-92 ,240,35,77,.455,28,55,.509,7,22,.318,23,30,.767,100,35,85,.412,28,63,.444,7,22,.318,15,20,.750,92,2017-01-24,CHI,ORL
49,@,W 100-88 ,240,41,89,.461,32,65,.492,9,24,.375,9,11,.818,100,33,79,.418,30,66,.455,3,13,.231,19,25,.760,88,2017-01-27,MIA,CHI
50,Home,L 100-128 ,240,38,100,.380,28,63,.444,10,37,.270,14,17,.824,100,49,81,.605,43,66,.652,6,15,.400,24,30,.800,128,2017-02-01,OKC,CHI
51,Home,L 100-116 ,240,35,73,.479,25,51,.490,10,22,.455,20,24,.833,100,35,73,.479,18,42,.429,17,31,.548,29,37,.784,116,2017-02-11,IND,MIL
52,@,L 100-116 ,240,39,88,.443,27,53,.509,12,35,.343,10,14,.714,100,46,88,.523,39,74,.527,7,14,.500,17,19,.895,116,2017-02-23,DEN,SAC
53,Home,W 100-96 ,240,39,76,.513,33,56,.589,6,20,.300,16,18,.889,100,40,83,.482,35,69,.507,5,14,.357,11,16,.688,96,2017-02-26,MIL,PHO
54,Home,W 100-95 ,240,36,64,.563,26,43,.605,10,21,.476,18,24,.750,100,35,77,.455,21,44,.477,14,33,.424,11,13,.846,95,2017-03-01,ATL,DAL
55,Home,L 100-109 ,240,35,81,.432,24,59,.407,11,22,.500,19,22,.864,100,34,74,.459,23,46,.500,11,28,.393,30,36,.833,109,2017-03-01,SAC,BRK
56,Home,W 100-99 ,240,35,74,.473,26,45,.578,9,29,.310,21,24,.875,100,37,81,.457,30,58,.517,7,23,.304,18,25,.720,99,2017-03-01,SAS,IND
57,@,L 100-104 ,240,38,82,.463,29,54,.537,9,28,.321,15,22,.682,100,39,82,.476,34,55,.618,5,27,.185,21,27,.778,104,2017-03-03,MEM,DAL
58,Home,W 100-88 ,240,35,86,.407,24,55,.436,11,31,.355,19,21,.905,100,37,81,.457,25,51,.490,12,30,.400,2,3,.667,88,2017-03-06,CHO,IND
59,Home,W 99-91 ,240,36,77,.468,32,62,.516,4,15,.267,23,31,.742,99,34,82,.415,26,58,.448,8,24,.333,15,22,.682,91,2011-12-26,GSW,CHI
60,Home,W 99-82 ,240,38,73,.521,29,57,.509,9,16,.563,14,22,.636,99,21,67,.313,15,45,.333,6,22,.273,34,41,.829,82,2011-12-29,LAL,NYK
61,Home,W 99-86 ,240,32,72,.444,25,47,.532,7,25,.280,28,38,.737,99,33,72,.458,27,58,.466,6,14,.429,14,18,.778,86,2011-12-30,DAL,TOR
62,@,L 99-102 ,240,37,77,.481,33,64,.516,4,13,.308,21,29,.724,99,35,79,.443,29,63,.460,6,16,.375,26,33,.788,102,2011-12-30,PHI,UTA
63,Home,W 99-90 ,240,33,71,.465,31,53,.585,2,18,.111,31,37,.838,99,35,88,.398,31,65,.477,4,23,.174,16,24,.667,90,2012-01-01,DEN,LAL
64,Home,W 99-82 ,240,36,85,.424,26,63,.413,10,22,.455,17,24,.708,99,29,77,.377,22,53,.415,7,24,.292,17,21,.810,82,2012-01-01,MIN,DAL
65,@,L 99-108 ,240,41,96,.427,30,65,.462,11,31,.355,6,7,.857,99,41,78,.526,36,64,.563,5,14,.357,21,27,.778,108,2012-01-03,HOU,LAL
66,@,W 99-83 ,240,40,76,.526,35,64,.547,5,12,.417,14,21,.667,99,36,88,.409,35,82,.427,1,6,.167,10,12,.833,83,2012-01-04,CHI,DET
67,@,W 99-96 ,240,39,89,.438,33,71,.465,6,18,.333,15,21,.714,99,41,85,.482,35,71,.493,6,14,.429,8,13,.615,96,2012-01-06,NYK,WAS
68,Home,W 99-77 ,240,39,77,.506,37,68,.544,2,9,.222,19,26,.731,99,29,89,.326,24,73,.329,5,16,.313,14,21,.667,77,2012-01-07,IND,CHA
69,Home,W 99-83 ,240,39,80,.488,37,63,.587,2,17,.118,19,23,.826,99,34,80,.425,27,60,.450,7,20,.350,8,12,.667,83,2012-01-10,LAL,PHO
70,Home,W 99-83 ,240,38,74,.514,32,57,.561,6,17,.353,17,25,.680,99,34,84,.405,29,66,.439,5,18,.278,10,14,.714,83,2012-01-13,SAS,POR
71,Home,W 99-60 ,240,37,81,.457,30,65,.462,7,16,.438,18,25,.720,99,22,86,.256,20,65,.308,2,21,.095,14,18,.778,60,2012-01-14,DAL,SAC
72,@,L 99-108 ,240,35,75,.467,31,65,.477,4,10,.400,25,31,.806,99,35,78,.449,30,68,.441,5,10,.500,33,41,.805,108,2012-01-14,NOH,MEM
73,@,W 99-91 ,240,38,73,.521,35,58,.603,3,15,.200,20,27,.741,99,31,74,.419,24,55,.436,7,19,.368,22,26,.846,91,2012-01-15,GSW,DET
74,Home,W 99-86 ,240,37,80,.463,27,54,.500,10,26,.385,15,19,.789,99,35,79,.443,31,62,.500,4,17,.235,12,20,.600,86,2012-01-16,MIN,SAC
75,Home,W 99-79 ,240,41,77,.532,34,61,.557,7,16,.438,10,14,.714,99,28,82,.341,24,68,.353,4,14,.286,19,27,.704,79,2012-01-23,OKC,DET
76,@,W 99-96 ,240,34,82,.415,26,67,.388,8,15,.533,23,25,.920,99,39,82,.476,34,66,.515,5,16,.313,13,17,.765,96,2012-01-24,TOR,PHO
77,Home,L 99-105 ,240,38,93,.409,30,62,.484,8,31,.258,15,20,.750,99,39,91,.429,25,62,.403,14,29,.483,13,17,.765,105,2012-01-25,HOU,MIL
78,@,W 99-96 ,240,36,79,.456,25,51,.490,11,28,.393,16,21,.762,99,38,81,.469,32,62,.516,6,19,.316,14,24,.583,96,2012-01-27,NJN,CLE
79,Home,W 99-89 ,240,37,80,.463,35,70,.500,2,10,.200,23,26,.885,99,30,84,.357,12,41,.293,18,43,.419,11,14,.786,89,2012-01-27,MIA,NYK
80,Home,L 99-102 ,240,39,83,.470,35,72,.486,4,11,.364,17,29,.586,99,40,76,.526,34,65,.523,6,11,.545,16,21,.762,102,2012-01-28,CHA,WAS
81,Home,L 99-122 ,240,35,80,.438,23,59,.390,12,21,.571,17,20,.850,99,48,87,.552,34,60,.567,14,27,.519,12,18,.667,122,2012-01-30,PHO,DAL
82,@,L 99-106 ,240,35,74,.473,23,45,.511,12,29,.414,17,23,.739,99,38,73,.521,34,62,.548,4,11,.364,26,36,.722,106,2012-01-31,NJN,IND
83,Home,L 99-109 ,240,34,91,.374,31,74,.419,3,17,.176,28,37,.757,99,38,84,.452,31,69,.449,7,15,.467,26,34,.765,109,2012-02-01,MIN,IND
84,Home,W 99-96 ,240,38,79,.481,30,56,.536,8,23,.348,15,25,.600,99,40,82,.488,35,64,.547,5,18,.278,11,14,.786,96,2012-02-01,NJN,DET
85,Home,W 99-91 ,240,35,76,.461,28,58,.483,7,18,.389,22,31,.710,99,36,79,.456,27,57,.474,9,22,.409,10,13,.769,91,2012-02-01,SAS,HOU
86,Home,W 99-81 ,240,39,89,.438,35,74,.473,4,15,.267,17,17,1.000,99,34,83,.410,30,64,.469,4,19,.211,9,14,.643,81,2012-02-03,HOU,PHO
87,@,W 99-79 ,240,40,77,.519,32,64,.500,8,13,.615,11,20,.550,99,32,81,.395,27,69,.391,5,12,.417,10,14,.714,79,2012-02-03,MIA,PHI
88,Home,W 99-92 ,240,37,83,.446,35,69,.507,2,14,.143,23,26,.885,99,30,72,.417,20,46,.435,10,26,.385,22,26,.846,92,2012-02-04,NYK,NJN
89,@,W 99-90 ,240,41,79,.519,30,55,.545,11,24,.458,6,7,.857,99,33,84,.393,27,60,.450,6,24,.250,18,21,.857,90,2012-02-06,PHO,ATL
90,@,W 99-90 ,240,35,81,.432,25,62,.403,10,19,.526,19,24,.792,99,34,78,.436,31,56,.554,3,22,.136,19,33,.576,90,2012-02-06,HOU,DEN
91,Home,W 99-88 ,240,35,73,.479,26,45,.578,9,28,.321,20,31,.645,99,33,76,.434,31,65,.477,2,11,.182,20,26,.769,88,2012-02-06,NYK,UTA
92,@,L 99-104 ,240,37,78,.474,33,68,.485,4,10,.400,21,23,.913,99,41,87,.471,37,73,.507,4,14,.286,18,22,.818,104,2012-02-07,UTA,IND
93,Home,W 99-92 ,240,36,71,.507,29,53,.547,7,18,.389,20,26,.769,99,32,78,.410,29,63,.460,3,15,.200,25,29,.862,92,2012-02-08,CLE,LAC
94,@,W 99-92 ,240,39,73,.534,37,64,.578,2,9,.222,19,29,.655,99,33,78,.423,23,51,.451,10,27,.370,16,20,.800,92,2012-02-08,DET,NJN
95,Home,L 99-105 ,240,37,90,.411,28,66,.424,9,24,.375,16,17,.941,99,33,72,.458,21,47,.447,12,25,.480,27,37,.730,105,2012-02-08,TOR,MIL
96,@,W 99-84 ,240,35,79,.443,29,65,.446,6,14,.429,23,30,.767,99,31,84,.369,28,70,.400,3,14,.214,19,25,.760,84,2012-02-11,PHI,CLE
97,@,W 99-94 ,240,35,81,.432,20,44,.455,15,37,.405,14,21,.667,99,39,93,.419,30,71,.423,9,22,.409,7,7,1.000,94,2012-02-11,ORL,MIL
98,@,W 99-95 ,240,36,83,.434,30,69,.435,6,14,.429,21,32,.656,99,39,84,.464,36,71,.507,3,13,.231,14,25,.560,95,2012-02-14,SAS,DET
99,Home,L 99-101 ,240,37,69,.536,31,52,.596,6,17,.353,19,27,.704,99,38,80,.475,28,59,.475,10,21,.476,15,18,.833,101,2012-02-15,PHO,ATL
0,@,L 99-111 ,240,41,90,.456,33,64,.516,8,26,.308,9,13,.692,99,44,83,.530,39,72,.542,5,11,.455,18,24,.750,111,2012-02-17,PHO,LAL
1,Home,W 99-82 ,240,38,80,.475,30,58,.517,8,22,.364,15,24,.625,99,32,81,.395,24,52,.462,8,29,.276,10,18,.556,82,2012-02-22,NYK,ATL
2,Home,L 99-114 ,240,37,83,.446,30,64,.469,7,19,.368,18,21,.857,99,41,86,.477,28,59,.475,13,27,.481,19,23,.826,114,2012-02-23,DEN,SAS
3,Home,W 99-95 ,240,41,90,.456,38,72,.528,3,18,.167,14,20,.700,99,36,89,.404,32,80,.400,4,9,.444,19,22,.864,95,2012-02-28,CHI,NOH
4,Home,W 99-94 ,240,39,86,.453,31,63,.492,8,23,.348,13,15,.867,99,32,85,.376,26,67,.388,6,18,.333,24,28,.857,94,2012-03-02,ATL,MIL
5,Home,L 99-102 ,240,38,72,.528,32,56,.571,6,16,.375,17,20,.850,99,38,81,.469,34,70,.486,4,11,.364,22,32,.688,102,2012-03-02,TOR,MEM
6,Home,W 99-98 ,240,38,90,.422,35,80,.438,3,10,.300,20,27,.741,99,37,75,.493,29,58,.500,8,17,.471,16,22,.727,98,2012-03-02,UTA,MIA
7,@,W 99-94 ,240,36,86,.419,30,69,.435,6,17,.353,21,28,.750,99,32,72,.444,22,45,.489,10,27,.370,20,27,.741,94,2012-03-04,DEN,SAS
8,@,W 99-93 ,240,39,87,.448,38,80,.475,1,7,.143,20,24,.833,99,32,68,.471,29,61,.475,3,7,.429,26,37,.703,93,2012-03-07,UTA,CHA
9,Home,L 99-100 ,240,35,81,.432,31,61,.508,4,20,.200,25,32,.781,99,37,82,.451,30,59,.508,7,23,.304,19,23,.826,100,2012-03-07,DEN,CLE
10,Home,W 99-98 ,240,38,76,.500,30,53,.566,8,23,.348,15,23,.652,99,42,77,.545,39,68,.574,3,9,.333,11,12,.917,98,2012-03-07,SAC,NOH
11,@,W 99-94 ,240,32,76,.421,21,50,.420,11,26,.423,24,31,.774,99,35,86,.407,30,64,.469,5,22,.227,19,26,.731,94,2012-03-08,ORL,CHI
12,Home,L 99-110 ,240,39,82,.476,34,66,.515,5,16,.313,16,25,.640,99,40,78,.513,36,61,.590,4,17,.235,26,27,.963,110,2012-03-10,WAS,POR
13,Home,L 99-106 ,240,38,82,.463,28,53,.528,10,29,.345,13,17,.765,99,42,82,.512,35,61,.574,7,21,.333,15,23,.652,106,2012-03-11,SAC,ATL
14,Home,L 99-105 ,240,40,86,.465,36,73,.493,4,13,.308,15,19,.789,99,35,73,.479,29,55,.527,6,18,.333,29,35,.829,105,2012-03-11,TOR,MIL
15,@,L 99-104 ,240,37,80,.463,34,69,.493,3,11,.273,22,31,.710,99,40,93,.430,35,79,.443,5,14,.357,19,28,.679,104,2012-03-12,NYK,CHI
16,Home,L 99-105 ,240,37,76,.487,33,59,.559,4,17,.235,21,29,.724,99,43,92,.467,33,67,.493,10,25,.400,9,11,.818,105,2012-03-12,NJN,MIL
17,@,W 99-89 ,240,39,75,.520,33,57,.579,6,18,.333,15,17,.882,99,34,75,.453,30,61,.492,4,14,.286,17,19,.895,89,2012-03-15,WAS,NOH
18,@,L 99-106 ,240,39,79,.494,28,55,.509,11,24,.458,10,18,.556,99,37,79,.468,26,55,.473,11,24,.458,21,25,.840,106,2012-03-17,SAS,DAL
19,Home,W 99-92 (OT),265,42,101,.416,40,88,.455,2,13,.154,13,16,.813,99,33,80,.413,27,55,.491,6,25,.240,20,25,.800,92,2012-03-17,UTA,GSW
20,Home,L 99-103 ,240,33,73,.452,31,60,.517,2,13,.154,31,40,.775,99,43,91,.473,41,81,.506,2,10,.200,15,22,.682,103,2012-03-18,LAL,UTA
21,Home,W 99-86 ,240,40,85,.471,33,65,.508,7,20,.350,12,19,.632,99,35,82,.427,34,71,.479,1,11,.091,15,22,.682,86,2012-03-18,PHO,HOU
22,@,L 99-115 ,240,38,92,.413,32,67,.478,6,25,.240,17,17,1.000,99,44,96,.458,36,68,.529,8,28,.286,19,21,.905,115,2012-03-18,MIN,SAC
23,Home,W 99-95 ,240,36,76,.474,35,67,.522,1,9,.111,26,35,.743,99,36,80,.450,30,65,.462,6,15,.400,17,24,.708,95,2012-03-20,MIA,PHO
24,Home,W 99-86 ,240,41,92,.446,38,82,.463,3,10,.300,14,18,.778,99,36,74,.486,32,64,.500,4,10,.400,10,13,.769,86,2012-03-23,PHI,BOS
25,Home,L 99-101 (OT),265,37,96,.385,28,71,.394,9,25,.360,16,18,.889,99,37,80,.463,31,58,.534,6,22,.273,21,24,.875,101,2012-03-24,HOU,DAL
26,Home,W 99-93 ,240,39,80,.488,27,52,.519,12,28,.429,9,13,.692,99,33,71,.465,26,58,.448,7,13,.538,20,21,.952,93,2012-03-29,POR,NOH
27,@,W 99-88 ,240,38,73,.521,36,56,.643,2,17,.118,21,29,.724,99,36,98,.367,30,76,.395,6,22,.273,10,11,.909,88,2012-03-30,DEN,CHA
28,@,W 99-95 ,240,37,88,.420,33,73,.452,4,15,.267,21,28,.750,99,34,82,.415,29,65,.446,5,17,.294,22,28,.786,95,2012-03-31,MEM,MIL
29,Home,L 99-111 ,240,39,90,.433,36,73,.493,3,17,.176,18,23,.783,99,43,92,.467,33,64,.516,10,28,.357,15,20,.750,111,2012-03-31,SAC,NJN
30,Home,W 99-92 ,240,37,77,.481,33,60,.550,4,17,.235,21,23,.913,99,34,71,.479,26,51,.510,8,20,.400,16,20,.800,92,2012-04-01,TOR,WAS
31,@,W 99-93 ,240,42,89,.472,38,76,.500,4,13,.308,11,14,.786,99,40,83,.482,35,66,.530,5,17,.294,8,17,.471,93,2012-04-02,HOU,CHI
32,Home,W 99-93 ,240,35,75,.467,32,62,.516,3,13,.231,26,32,.813,99,38,83,.458,35,73,.479,3,10,.300,14,17,.824,93,2012-04-03,MIA,PHI
33,@,W 99-78 ,240,39,77,.506,30,56,.536,9,21,.429,12,12,1.000,99,34,79,.430,31,67,.463,3,12,.250,7,8,.875,78,2012-04-04,TOR,PHI
34,Home,W 99-94 ,240,36,68,.529,32,58,.552,4,10,.400,23,39,.590,99,33,78,.423,26,57,.456,7,21,.333,21,29,.724,94,2012-04-05,DET,WAS
35,@,W 99-97 (OT),265,41,94,.436,33,73,.452,8,21,.381,9,11,.818,99,42,93,.452,35,69,.507,7,24,.292,6,8,.750,97,2012-04-06,POR,DAL
36,@,L 99-105 ,240,34,82,.415,26,60,.433,8,22,.364,23,29,.793,99,37,92,.402,26,65,.400,11,27,.407,20,31,.645,105,2012-04-06,PHO,DEN
37,Home,W 99-90 ,240,40,82,.488,36,69,.522,4,13,.308,15,19,.789,99,33,81,.407,23,56,.411,10,25,.400,14,18,.778,90,2012-04-07,NOH,MIN
38,@,L 99-100 (OT),265,35,89,.393,28,67,.418,7,22,.318,22,31,.710,99,39,102,.382,31,68,.456,8,34,.235,14,20,.700,100,2012-04-08,CHI,NYK
39,Home,L 99-105 ,240,37,84,.440,28,61,.459,9,23,.391,16,26,.615,99,37,92,.402,30,73,.411,7,19,.368,24,26,.923,105,2012-04-14,MIL,IND
40,Home,L 99-120 ,240,38,93,.409,30,73,.411,8,20,.400,15,17,.882,99,36,92,.391,24,65,.369,12,27,.444,36,43,.837,120,2012-04-16,GSW,SAS
41,@,W 99-87 ,240,37,79,.468,33,63,.524,4,16,.250,21,28,.750,99,38,90,.422,34,71,.479,4,19,.211,7,10,.700,87,2012-04-18,LAL,GSW
42,@,L 99-105 (OT),265,37,89,.416,26,58,.448,11,31,.355,14,25,.560,99,41,87,.471,37,67,.552,4,20,.200,19,24,.792,105,2012-04-19,HOU,NOH
43,Home,W 99-96 ,240,40,84,.476,30,58,.517,10,26,.385,9,15,.600,99,36,73,.493,31,57,.544,5,16,.313,19,22,.864,96,2012-04-21,HOU,GSW
44,Home,W 99-93 ,240,36,77,.468,27,53,.509,9,24,.375,18,24,.750,99,34,70,.486,23,45,.511,11,25,.440,14,25,.560,93,2012-04-25,NYK,LAC
45,@,W 99-91 ,240,40,85,.471,35,70,.500,5,15,.333,14,18,.778,99,38,77,.494,35,64,.547,3,13,.231,12,31,.387,91,2012-10-30,DAL,LAL
46,@,W 99-95 ,240,38,80,.475,32,60,.533,6,20,.300,17,26,.654,99,35,80,.438,31,63,.492,4,17,.235,21,23,.913,95,2012-10-31,SAS,NOH
47,@,W 99-88 ,240,40,86,.465,32,68,.471,8,18,.444,11,12,.917,99,33,74,.446,28,60,.467,5,14,.357,17,21,.810,88,2012-11-02,MIL,BOS
48,@,L 99-126 ,240,39,91,.429,36,74,.486,3,17,.176,18,24,.750,99,49,80,.613,33,55,.600,16,25,.640,12,15,.800,126,2012-11-03,CHA,DAL
49,@,L 99-124 ,240,35,88,.398,28,67,.418,7,21,.333,22,29,.759,99,47,86,.547,32,60,.533,15,26,.577,15,19,.789,124,2012-11-05,PHO,MIA
50,Home,W 99-93 ,240,40,84,.476,38,78,.487,2,6,.333,17,24,.708,99,36,86,.419,28,67,.418,8,19,.421,13,17,.765,93,2012-11-06,CHI,ORL
51,@,L 99-107 ,240,40,83,.482,33,62,.532,7,21,.333,12,18,.667,99,43,83,.518,35,61,.574,8,22,.364,13,21,.619,107,2012-11-09,CHA,NOH
52,@,W 99-89 ,240,41,84,.488,32,60,.533,9,24,.375,8,11,.727,99,37,75,.493,32,61,.525,5,14,.357,10,17,.588,89,2012-11-13,NYK,ORL
53,Home,W 99-85 ,240,38,91,.418,35,75,.467,3,16,.188,20,25,.800,99,30,80,.375,25,60,.417,5,20,.250,20,31,.645,85,2012-11-14,MIL,IND
54,Home,W 99-93 ,240,40,87,.460,30,69,.435,10,18,.556,9,10,.900,99,36,81,.444,29,59,.492,7,22,.318,14,18,.778,93,2012-11-16,PHI,UTA
55,@,W 99-90 ,240,36,75,.480,31,58,.534,5,17,.294,22,25,.880,99,37,80,.463,31,62,.500,6,18,.333,10,19,.526,90,2012-11-18,BRK,SAC
56,Home,W 99-95 (OT),265,37,89,.416,30,60,.500,7,29,.241,18,24,.750,99,36,99,.364,32,84,.381,4,15,.267,19,22,.864,95,2012-12-01,SAS,MEM
57,@,L 99-106 ,240,39,80,.488,31,57,.544,8,23,.348,13,19,.684,99,40,90,.444,28,61,.459,12,29,.414,14,17,.824,106,2012-12-02,PHO,NYK
58,Home,W 99-92 ,240,36,80,.450,27,54,.500,9,26,.346,18,19,.947,99,34,79,.430,28,57,.491,6,22,.273,18,22,.818,92,2012-12-05,IND,POR
59,@,L 99-110 ,240,35,84,.417,30,72,.417,5,12,.417,24,29,.828,99,40,85,.471,34,64,.531,6,21,.286,24,28,.857,110,2012-12-05,MIL,SAS
60,@,L 99-131 ,240,33,82,.402,26,58,.448,7,24,.292,26,31,.839,99,45,91,.495,32,68,.471,13,23,.565,28,35,.800,131,2012-12-07,TOR,UTA
61,@,L 99-117 ,240,36,78,.462,27,54,.500,9,24,.375,18,20,.900,99,48,93,.516,41,70,.586,7,23,.304,14,24,.583,117,2012-12-08,PHO,LAC
62,@,W 99-80 ,240,36,86,.419,27,67,.403,9,19,.474,18,22,.818,99,29,75,.387,21,54,.389,8,21,.381,14,18,.778,80,2012-12-08,SAC,POR
63,Home,W 99-93 ,240,34,76,.447,25,52,.481,9,24,.375,22,30,.733,99,35,89,.393,28,64,.438,7,25,.280,16,20,.800,93,2012-12-12,HOU,WAS
64,Home,W 99-96 ,240,41,84,.488,33,65,.508,8,19,.421,9,15,.600,99,37,87,.425,29,68,.426,8,19,.421,14,18,.778,96,2012-12-12,UTA,SAS
65,Home,W 99-94 ,240,36,69,.522,32,59,.542,4,10,.400,23,26,.885,99,39,94,.415,32,75,.427,7,19,.368,9,10,.900,94,2012-12-14,DEN,MEM
66,Home,W 99-85 ,240,41,86,.477,32,65,.492,9,21,.429,8,11,.727,99,34,92,.370,27,72,.375,7,20,.350,10,11,.909,85,2012-12-14,ORL,GSW
67,Home,W 99-84 ,240,38,83,.458,32,70,.457,6,13,.462,17,22,.773,99,33,82,.402,30,71,.423,3,11,.273,15,21,.714,84,2012-12-14,PHO,UTA
68,@,W 99-86 ,240,38,85,.447,34,74,.459,4,11,.364,19,24,.792,99,31,74,.419,26,57,.456,5,17,.294,19,24,.792,86,2012-12-15,MEM,UTA
69,Home,L 99-113 ,240,36,70,.514,29,54,.537,7,16,.438,20,30,.667,99,39,75,.520,27,51,.529,12,24,.500,23,27,.852,113,2012-12-18,CLE,TOR
70,Home,W 99-93 ,240,37,84,.440,28,64,.438,9,20,.450,16,23,.696,99,33,82,.402,28,62,.452,5,20,.250,22,26,.846,93,2012-12-20,MIN,OKC
71,@,W 99-94 (OT),265,36,83,.434,31,67,.463,5,16,.313,22,36,.611,99,36,94,.383,31,70,.443,5,24,.208,17,20,.850,94,2012-12-21,MIL,BOS
72,@,W 99-89 ,240,39,80,.488,34,64,.531,5,16,.313,16,25,.640,99,32,80,.400,27,64,.422,5,16,.313,20,26,.769,89,2012-12-21,IND,CLE
73,Home,W 99-80 ,240,44,86,.512,36,67,.537,8,19,.421,3,7,.429,99,31,79,.392,22,54,.407,9,25,.360,9,12,.750,80,2012-12-21,PHI,ATL
74,Home,W 99-94 ,240,39,76,.513,35,58,.603,4,18,.222,17,23,.739,99,39,86,.453,37,70,.529,2,16,.125,14,16,.875,94,2012-12-21,SAS,NOH
75,@,W 99-89 ,240,37,71,.521,28,55,.509,9,16,.563,16,23,.696,99,35,90,.389,30,75,.400,5,15,.333,14,17,.824,89,2012-12-26,PHI,MEM
76,@,W 99-97 ,240,40,88,.455,31,66,.470,9,22,.409,10,14,.714,99,38,83,.458,30,62,.484,8,21,.381,13,16,.813,97,2012-12-26,NYK,PHO
77,@,L 99-109 ,240,39,77,.506,30,48,.625,9,29,.310,12,16,.750,99,43,74,.581,31,55,.564,12,19,.632,11,17,.647,109,2012-12-28,MIA,DET
78,Home,L 99-103 ,240,37,94,.394,34,72,.472,3,22,.136,22,33,.667,99,41,86,.477,33,64,.516,8,22,.364,13,20,.650,103,2013-01-01,LAL,PHI
79,@,W 99-96 (OT),265,39,86,.453,31,65,.477,8,21,.381,13,16,.813,99,39,85,.459,32,66,.485,7,19,.368,11,13,.846,96,2013-01-05,NOH,DAL
80,Home,W 99-71 ,240,38,82,.463,30,61,.492,8,21,.381,15,16,.938,99,29,81,.358,23,60,.383,6,21,.286,7,14,.500,71,2013-01-06,MIA,WAS
81,@,L 99-101 ,240,34,80,.425,28,55,.509,6,25,.240,25,30,.833,99,38,87,.437,28,69,.406,10,18,.556,15,18,.833,101,2013-01-07,OKC,WAS
82,@,L 99-108 ,240,37,90,.411,33,70,.471,4,20,.200,21,26,.808,99,42,91,.462,33,74,.446,9,17,.529,15,19,.789,108,2013-01-08,PHO,MIL
83,Home,W 99-83 ,240,37,81,.457,25,58,.431,12,23,.522,13,20,.650,99,37,84,.440,30,62,.484,7,22,.318,2,5,.400,83,2013-01-09,CLE,ATL
84,Home,W 99-93 ,240,38,79,.481,28,55,.509,10,24,.417,13,21,.619,99,36,84,.429,30,66,.455,6,18,.333,15,18,.833,93,2013-01-09,LAC,DAL
85,Home,W 99-79 ,240,34,75,.453,28,62,.452,6,13,.462,25,32,.781,99,31,79,.392,24,65,.369,7,14,.500,10,16,.625,79,2013-01-11,BRK,PHO
86,Home,W 99-78 ,240,39,86,.453,27,59,.458,12,27,.444,9,11,.818,99,28,75,.373,25,63,.397,3,12,.250,19,22,.864,78,2013-01-11,TOR,CHA
87,Home,L 99-128 ,240,38,87,.437,29,69,.420,9,18,.500,14,19,.737,99,45,80,.563,28,43,.651,17,37,.459,21,24,.875,128,2013-01-12,SAC,MIA
88,@,W 99-73 ,240,35,76,.461,30,62,.484,5,14,.357,24,32,.750,99,27,89,.303,21,69,.304,6,20,.300,13,17,.765,73,2013-01-14,LAC,MEM
89,Home,L 99-111 ,240,39,82,.476,28,61,.459,11,21,.524,10,13,.769,99,44,83,.530,34,65,.523,10,18,.556,13,18,.722,111,2013-01-15,PHI,NOH
90,@,W 99-90 ,240,40,83,.482,38,70,.543,2,13,.154,17,23,.739,99,31,72,.431,21,50,.420,10,22,.455,18,28,.643,90,2013-01-17,MIA,LAL
91,Home,L 99-100 (OT),265,38,91,.418,35,77,.455,3,14,.214,20,28,.714,99,36,75,.480,31,60,.517,5,15,.333,23,32,.719,100,2013-01-18,BOS,CHI
92,@,L 99-106 ,240,38,83,.458,27,53,.509,11,30,.367,12,22,.545,99,39,75,.520,27,53,.509,12,22,.545,16,18,.889,106,2013-01-21,LAC,GSW
93,@,L 99-104 ,240,36,78,.462,31,62,.500,5,16,.313,22,27,.815,99,37,84,.440,31,61,.508,6,23,.261,24,27,.889,104,2013-01-23,OKC,GSW
94,@,L 99-108 ,240,41,81,.506,35,69,.507,6,12,.500,11,14,.786,99,41,83,.494,34,59,.576,7,24,.292,19,23,.826,108,2013-01-26,PHO,SAS
95,@,W 99-98 ,240,37,78,.474,31,67,.463,6,11,.545,19,22,.864,99,40,82,.488,35,65,.538,5,17,.294,13,18,.722,98,2013-01-26,CLE,TOR
96,Home,W 99-81 ,240,39,73,.534,34,57,.596,5,16,.313,16,20,.800,99,29,73,.397,23,56,.411,6,17,.353,17,26,.654,81,2013-01-30,BOS,SAC
97,@,L 99-104 ,240,37,78,.474,29,56,.518,8,22,.364,17,28,.607,99,34,68,.500,30,56,.536,4,12,.333,32,46,.696,104,2013-01-30,NOH,UTA
98,@,L 99-117 ,240,35,88,.398,29,68,.426,6,20,.300,23,26,.885,99,45,83,.542,41,69,.594,4,14,.286,23,43,.535,117,2013-02-01,CLE,DET
99,Home,L 99-109 ,240,38,89,.427,34,74,.459,4,15,.267,19,25,.760,99,40,88,.455,32,67,.478,8,21,.381,21,25,.840,109,2013-02-01,PHO,DAL
0,@,L 99-105 ,240,39,90,.433,31,71,.437,8,19,.421,13,16,.813,99,38,75,.507,28,57,.491,10,18,.556,19,28,.679,105,2013-02-02,UTA,POR
1,Home,W 99-94 ,240,41,81,.506,40,69,.580,1,12,.083,16,24,.667,99,34,80,.425,26,55,.473,8,25,.320,18,20,.900,94,2013-02-04,MIA,CHA
2,Home,W 99-85 ,240,36,79,.456,22,45,.489,14,34,.412,13,16,.813,99,38,90,.422,35,77,.455,3,13,.231,6,12,.500,85,2013-02-04,NYK,DET
3,@,L 99-105 ,240,36,84,.429,26,54,.481,10,30,.333,17,19,.895,99,41,86,.477,31,66,.470,10,20,.500,13,19,.684,105,2013-02-06,POR,DAL
4,@,W 99-95 ,240,35,73,.479,31,54,.574,4,19,.211,25,30,.833,99,34,82,.415,30,64,.469,4,18,.222,23,26,.885,95,2013-02-06,BOS,TOR
5,Home,W 99-93 ,240,36,79,.456,28,59,.475,8,20,.400,19,23,.826,99,36,74,.486,30,57,.526,6,17,.353,15,20,.750,93,2013-02-08,MEM,GSW
6,Home,W 99-63 ,240,41,87,.471,36,75,.480,5,12,.417,12,18,.667,99,24,74,.324,22,57,.386,2,17,.118,13,13,1.000,63,2013-02-13,NOH,POR
7,Home,L 99-105 ,240,36,89,.404,25,64,.391,11,25,.440,16,21,.762,99,40,81,.494,32,64,.500,8,17,.471,17,23,.739,105,2013-02-20,CHA,DET
8,@,L 99-113 ,240,39,82,.476,30,62,.484,9,20,.450,12,20,.600,99,42,83,.506,35,61,.574,7,22,.318,22,31,.710,113,2013-02-20,BOS,LAL
9,Home,L 99-113 ,240,37,82,.451,35,71,.493,2,11,.182,23,30,.767,99,44,83,.530,37,64,.578,7,19,.368,18,22,.818,113,2013-02-23,CHA,DEN
10,Home,L 99-103 ,240,39,87,.448,31,69,.449,8,18,.444,13,19,.684,99,34,72,.472,21,47,.447,13,25,.520,22,31,.710,103,2013-02-24,DAL,LAL
11,Home,L 99-100 ,240,37,85,.435,36,74,.486,1,11,.091,24,31,.774,99,37,81,.457,30,64,.469,7,17,.412,19,23,.826,100,2013-02-24,MIN,GSW
12,Home,W 99-93 ,240,32,75,.427,24,42,.571,8,33,.242,27,35,.771,99,36,85,.424,32,72,.444,4,13,.308,17,20,.850,93,2013-02-24,NYK,PHI
13,@,W 99-91 ,240,39,80,.488,35,57,.614,4,23,.174,17,21,.810,99,32,75,.427,23,50,.460,9,25,.360,18,25,.720,91,2013-02-28,LAC,IND
14,Home,W 99-98 ,240,38,78,.487,28,57,.491,10,21,.476,13,18,.722,99,41,82,.500,33,60,.550,8,22,.364,8,15,.533,98,2013-03-03,LAL,ATL
15,@,W 99-93 ,240,39,84,.464,31,64,.484,8,20,.400,13,19,.684,99,32,74,.432,24,45,.533,8,29,.276,21,26,.808,93,2013-03-03,MIA,NYK
16,@,W 99-78 ,240,34,67,.507,21,40,.525,13,27,.481,18,22,.818,99,32,84,.381,28,66,.424,4,18,.222,10,15,.667,78,2013-03-06,BRK,CHA
17,Home,L 99-102 ,240,39,96,.406,30,66,.455,9,30,.300,12,19,.632,99,41,78,.526,30,56,.536,11,22,.500,9,15,.600,102,2013-03-08,DET,DAL
18,Home,W 99-91 ,240,41,83,.494,29,56,.518,12,27,.444,5,7,.714,99,40,86,.465,35,74,.473,5,12,.417,6,10,.600,91,2013-03-10,ORL,PHI
19,@,W 99-93 ,240,33,78,.423,20,52,.385,13,26,.500,20,30,.667,99,37,99,.374,25,72,.347,12,27,.444,7,9,.778,93,2013-03-15,LAL,IND
20,Home,W 99-76 ,240,42,87,.483,34,67,.507,8,20,.400,7,15,.467,99,29,87,.333,24,65,.369,5,22,.227,13,16,.813,76,2013-03-18,PHO,LAL
21,@,W 99-89 ,240,41,84,.488,31,63,.492,10,21,.476,7,10,.700,99,39,89,.438,35,75,.467,4,14,.286,7,11,.636,89,2013-03-21,POR,CHI
22,@,W 99-94 ,240,38,71,.535,28,49,.571,10,22,.455,13,24,.542,99,36,79,.456,25,47,.532,11,32,.344,11,14,.786,94,2013-03-22,NYK,TOR
23,Home,L 99-104 ,240,42,92,.457,37,71,.521,5,21,.238,10,18,.556,99,39,78,.500,29,52,.558,10,26,.385,16,21,.762,104,2013-03-24,MIL,ATL
24,@,L 99-100 ,240,42,88,.477,42,78,.538,0,10,.000,15,17,.882,99,35,76,.461,25,61,.410,10,15,.667,20,27,.741,100,2013-03-27,DEN,SAS
25,@,W 99-82 ,240,44,82,.537,40,69,.580,4,13,.308,7,9,.778,99,31,76,.408,26,58,.448,5,18,.278,15,23,.652,82,2013-03-29,TOR,DET
26,Home,L 99-109 ,240,37,98,.378,25,69,.362,12,29,.414,13,15,.867,99,40,75,.533,36,59,.610,4,16,.250,25,32,.781,109,2013-03-30,MIL,OKC
27,@,W 99-86 ,240,37,73,.507,31,63,.492,6,10,.600,19,27,.704,99,29,67,.433,24,51,.471,5,16,.313,23,34,.676,86,2013-03-30,MEM,MIN
28,Home,W 99-97 ,240,36,80,.450,33,65,.508,3,15,.200,24,29,.828,99,35,83,.422,30,71,.423,5,12,.417,22,25,.880,97,2013-04-06,SAS,ATL
29,Home,W 99-85 ,240,39,73,.534,30,55,.545,9,18,.500,12,17,.706,99,33,73,.452,30,58,.517,3,15,.200,16,25,.640,85,2013-04-07,DET,CHI
30,Home,W 99-94 ,240,32,79,.405,28,63,.444,4,16,.250,31,46,.674,99,39,85,.459,36,75,.480,3,10,.300,13,15,.867,94,2013-04-09,IND,CLE
31,@,L 99-120 ,240,35,77,.455,27,57,.474,8,20,.400,21,30,.700,99,45,80,.563,25,44,.568,20,36,.556,10,14,.714,120,2013-04-09,WAS,NYK
32,@,L 99-103 ,240,37,78,.474,36,65,.554,1,13,.077,24,32,.750,99,39,81,.481,31,57,.544,8,24,.333,17,23,.739,103,2013-04-17,DET,BRK
33,Home,W 99-87 ,240,42,82,.512,36,66,.545,6,16,.375,9,11,.818,99,31,84,.369,27,73,.370,4,11,.364,21,28,.750,87,2013-04-17,DAL,NOH
34,Home,W 99-95 (OT),265,33,90,.367,23,58,.397,10,32,.313,23,34,.676,99,35,84,.417,27,51,.529,8,33,.242,17,24,.708,95,2013-04-17,LAL,HOU
35,@,W 99-88 ,240,40,93,.430,31,72,.431,9,21,.429,10,13,.769,99,35,82,.427,29,70,.414,6,12,.500,12,14,.857,88,2013-04-17,GSW,POR
36,@,L 99-111 ,240,37,87,.425,34,71,.479,3,16,.188,22,26,.846,99,32,80,.400,25,61,.410,7,19,.368,40,46,.870,111,2013-11-02,MEM,DAL
37,@,W 99-91 ,240,38,73,.521,29,52,.558,9,21,.429,14,23,.609,99,33,87,.379,28,62,.452,5,25,.200,20,25,.800,91,2013-11-05,IND,DET
38,@,W 99-84 ,240,38,78,.487,34,65,.523,4,13,.308,19,21,.905,99,34,71,.479,30,56,.536,4,15,.267,12,14,.857,84,2013-11-06,NOP,MEM
39,Home,W 99-96 ,240,41,85,.482,35,69,.507,6,16,.375,11,15,.733,99,42,85,.494,35,66,.530,7,19,.368,5,9,.556,96,2013-11-06,SAS,PHO
40,@,W 99-98 ,240,36,92,.391,20,57,.351,16,35,.457,11,15,.733,99,29,77,.377,22,50,.440,7,27,.259,33,52,.635,98,2013-11-07,LAL,HOU
41,@,L 99-111 ,240,37,94,.394,29,73,.397,8,21,.381,17,26,.654,99,40,100,.400,34,79,.430,6,21,.286,25,37,.676,111,2013-11-13,LAL,DEN
42,@,L 99-114 ,240,42,87,.483,34,64,.531,8,23,.348,7,17,.412,99,47,90,.522,37,65,.569,10,25,.400,10,10,1.000,114,2013-11-17,DET,LAL
43,@,L 99-101 ,240,34,73,.466,24,50,.480,10,23,.435,21,29,.724,99,37,78,.474,31,53,.585,6,25,.240,21,26,.808,101,2013-11-23,ORL,MIA
44,@,W 99-94 ,240,34,85,.400,21,55,.382,13,30,.433,18,22,.818,99,31,83,.373,20,53,.377,11,30,.367,21,26,.808,94,2013-11-27,LAL,BRK
45,@,W 99-74 ,240,32,84,.381,22,59,.373,10,25,.400,25,32,.781,99,26,83,.313,23,74,.311,3,9,.333,19,28,.679,74,2013-11-27,IND,CHA
46,@,L 99-103 ,240,32,76,.421,23,53,.434,9,23,.391,26,34,.765,99,44,99,.444,37,81,.457,7,18,.389,8,10,.800,103,2013-11-27,GSW,DAL
47,@,W 99-79 ,240,42,79,.532,36,62,.581,6,17,.353,9,12,.750,99,34,77,.442,32,65,.492,2,12,.167,9,19,.474,79,2013-11-27,CHI,DET
48,Home,W 99-98 ,240,36,69,.522,28,51,.549,8,18,.444,19,25,.760,99,35,76,.461,31,61,.508,4,15,.267,24,28,.857,98,2013-12-01,MIA,CHA
49,Home,L 99-103 ,240,34,76,.447,21,41,.512,13,35,.371,18,21,.857,99,38,77,.494,28,56,.500,10,21,.476,17,23,.739,103,2013-12-01,NYK,NOP
50,@,L 99-106 ,240,39,74,.527,30,54,.556,9,20,.450,12,14,.857,99,37,96,.385,30,76,.395,7,20,.350,25,29,.862,106,2013-12-11,PHI,MIN
51,@,L 99-101 (OT),265,42,100,.420,38,86,.442,4,14,.286,11,18,.611,99,38,89,.427,31,68,.456,7,21,.333,18,24,.750,101,2013-12-13,WAS,ATL
52,@,L 99-103 ,240,36,79,.456,24,56,.429,12,23,.522,15,20,.750,99,39,83,.470,36,73,.493,3,10,.300,22,31,.710,103,2013-12-13,BRK,DET
53,Home,W 99-94 ,240,36,76,.474,28,55,.509,8,21,.381,19,25,.760,99,39,83,.470,35,71,.493,4,12,.333,12,17,.706,94,2013-12-13,IND,CHA
54,@,W 99-77 ,240,40,83,.482,35,68,.515,5,15,.333,14,18,.778,99,31,86,.360,25,68,.368,6,18,.333,9,12,.750,77,2013-12-14,TOR,CHI
55,Home,L 99-103 ,240,35,85,.412,31,68,.456,4,17,.235,25,29,.862,99,35,88,.398,23,54,.426,12,34,.353,21,31,.677,103,2013-12-20,DEN,PHO
56,Home,L 99-106 ,240,42,87,.483,38,67,.567,4,20,.200,11,18,.611,99,41,87,.471,33,66,.500,8,21,.381,16,22,.727,106,2013-12-21,BOS,WAS
57,@,L 99-112 ,240,37,81,.457,30,60,.500,7,21,.333,18,25,.720,99,41,91,.451,32,68,.471,9,23,.391,21,27,.778,112,2013-12-23,TOR,SAS
58,@,L 99-120 ,240,33,70,.471,23,48,.479,10,22,.455,23,28,.821,99,47,91,.516,39,72,.542,8,19,.421,18,25,.720,120,2013-12-28,DEN,MEM
59,Home,L 99-106 ,240,36,82,.439,30,62,.484,6,20,.300,21,35,.600,99,39,78,.500,32,59,.542,7,19,.368,21,27,.778,106,2013-12-30,DET,WAS
60,@,W 99-91 ,240,44,92,.478,41,78,.526,3,14,.214,8,14,.571,99,37,90,.411,29,60,.483,8,30,.267,9,16,.563,91,2014-01-02,MEM,PHO
61,@,L 99-110 ,240,38,86,.442,30,60,.500,8,26,.308,15,23,.652,99,42,81,.519,32,57,.561,10,24,.417,16,21,.762,110,2014-01-03,UTA,LAL
62,Home,W 99-82 ,240,39,83,.470,32,61,.525,7,22,.318,14,19,.737,99,31,68,.456,28,59,.475,3,9,.333,17,26,.654,82,2014-01-04,IND,NOP
63,Home,L 99-101 ,240,36,99,.364,33,77,.429,3,22,.136,24,30,.800,99,40,88,.455,36,74,.486,4,14,.286,17,24,.708,101,2014-01-04,POR,PHI
64,@,L 99-113 ,240,36,88,.409,29,64,.453,7,24,.292,20,25,.800,99,39,86,.453,32,58,.552,7,28,.250,28,50,.560,113,2014-01-08,LAL,HOU
65,Home,W 99-97 ,240,38,92,.413,30,66,.455,8,26,.308,15,21,.714,99,38,85,.447,31,66,.470,7,19,.368,14,16,.875,97,2014-01-10,GSW,BOS
66,@,L 99-104 ,240,38,92,.413,27,62,.435,11,30,.367,12,16,.750,99,42,86,.488,36,71,.507,6,15,.400,14,23,.609,104,2014-01-10,PHO,MEM
67,@,L 99-107 ,240,37,88,.420,33,70,.471,4,18,.222,21,31,.677,99,37,84,.440,32,66,.485,5,18,.278,28,35,.800,107,2014-01-20,PHI,WAS
68,Home,W 99-81 ,240,41,88,.466,34,69,.493,7,19,.368,10,14,.714,99,30,81,.370,21,49,.429,9,32,.281,12,17,.706,81,2014-01-25,MEM,HOU
69,@,W 99-90 ,240,34,82,.415,25,55,.455,9,27,.333,22,28,.786,99,34,86,.395,29,70,.414,5,16,.313,17,24,.708,90,2014-01-26,PHO,CLE
70,@,L 99-106 ,240,37,90,.411,32,68,.471,5,22,.227,20,26,.769,99,32,80,.400,25,60,.417,7,20,.350,35,53,.660,106,2014-01-27,SAC,UTA
71,@,W 99-89 ,240,41,75,.547,37,61,.607,4,14,.286,13,16,.813,99,38,79,.481,33,58,.569,5,21,.238,8,8,1.000,89,2014-01-29,MEM,SAC
72,Home,L 99-125 ,240,32,87,.368,26,65,.400,6,22,.273,29,37,.784,99,45,89,.506,37,73,.507,8,16,.500,27,34,.794,125,2014-01-31,PHI,ATL
73,Home,W 99-90 ,240,38,79,.481,32,69,.464,6,10,.600,17,22,.773,99,30,76,.395,21,53,.396,9,23,.391,21,25,.840,90,2014-02-01,MEM,MIL
74,Home,W 99-70 ,240,36,69,.522,34,61,.557,2,8,.250,25,34,.735,99,22,78,.282,18,58,.310,4,20,.200,22,34,.647,70,2014-02-03,SAC,CHI
75,@,L 99-109 ,240,33,79,.418,23,58,.397,10,21,.476,23,26,.885,99,37,83,.446,29,66,.439,8,17,.471,27,38,.711,109,2014-02-04,LAL,MIN
76,Home,W 99-89 ,240,40,88,.455,31,66,.470,9,22,.409,10,15,.667,99,31,87,.356,26,72,.361,5,15,.333,22,24,.917,89,2014-02-07,BOS,SAC
77,@,L 99-109 ,240,34,74,.459,26,48,.542,8,26,.308,23,33,.697,99,41,86,.477,29,65,.446,12,21,.571,15,23,.652,109,2014-02-11,SAC,CLE
78,Home,L 99-105 ,240,37,82,.451,28,58,.483,9,24,.375,16,17,.941,99,41,82,.500,32,59,.542,9,23,.391,14,20,.700,105,2014-02-19,UTA,BRK
79,@,L 99-102 (OT),265,37,101,.366,28,71,.394,9,30,.300,16,25,.640,99,37,93,.398,28,66,.424,9,27,.333,19,24,.792,102,2014-02-20,HOU,GSW
80,@,W 99-93 ,240,35,79,.443,25,47,.532,10,32,.313,19,24,.792,99,34,84,.405,29,67,.433,5,17,.294,20,24,.833,93,2014-02-25,TOR,CLE
81,Home,W 99-79 ,240,43,88,.489,39,73,.534,4,15,.267,9,12,.750,99,28,80,.350,14,51,.275,14,29,.483,9,14,.643,79,2014-02-28,CLE,UTA
82,@,L 99-116 ,240,30,68,.441,22,46,.478,8,22,.364,31,40,.775,99,41,82,.500,33,60,.550,8,22,.364,26,30,.867,116,2014-03-02,CHA,OKC
83,Home,W 99-87 ,240,34,73,.466,24,52,.462,10,21,.476,21,28,.750,99,30,72,.417,25,53,.472,5,19,.263,22,37,.595,87,2014-03-07,TOR,SAC
84,Home,W 99-90 ,240,40,80,.500,30,59,.508,10,21,.476,9,9,1.000,99,36,89,.404,24,58,.414,12,31,.387,6,9,.667,90,2014-03-10,MIA,WAS
85,Home,W 99-89 ,240,38,87,.437,31,69,.449,7,18,.389,16,19,.842,99,34,84,.405,31,69,.449,3,15,.200,18,30,.600,89,2014-03-11,DET,SAC
86,@,L 99-109 ,240,35,86,.407,28,69,.406,7,17,.412,22,29,.759,99,47,84,.560,41,72,.569,6,12,.500,9,13,.692,109,2014-03-11,POR,MEM
87,Home,W 99-86 ,240,36,71,.507,27,54,.500,9,17,.529,18,22,.818,99,33,74,.446,31,66,.470,2,8,.250,18,27,.667,86,2014-03-14,TOR,MEM
88,Home,W 99-90 ,240,31,81,.383,25,63,.397,6,18,.333,31,38,.816,99,35,81,.432,26,58,.448,9,23,.391,11,20,.550,90,2014-03-17,IND,PHI
89,@,L 99-104 ,240,40,85,.471,31,58,.534,9,27,.333,10,12,.833,99,37,75,.493,28,55,.509,9,20,.450,21,35,.600,104,2014-03-19,CHA,BRK
90,@,W 99-79 ,240,36,93,.387,31,68,.456,5,25,.200,22,27,.815,99,32,80,.400,28,66,.424,4,14,.286,11,18,.611,79,2014-03-21,SAS,SAC
91,@,W 99-90 ,240,35,89,.393,25,61,.410,10,28,.357,19,25,.760,99,31,77,.403,28,62,.452,3,15,.200,25,29,.862,90,2014-03-22,SAS,GSW
92,@,W 99-90 ,240,36,80,.450,25,57,.439,11,23,.478,16,18,.889,99,32,79,.405,23,57,.404,9,22,.409,17,22,.773,90,2014-03-26,TOR,BOS
93,Home,L 99-107 ,240,33,69,.478,27,52,.519,6,17,.353,27,35,.771,99,40,73,.548,25,47,.532,15,26,.577,12,13,.923,107,2014-03-26,SAC,NYK
94,@,W 99-93 ,240,37,75,.493,23,47,.489,14,28,.500,11,12,.917,99,37,81,.457,31,62,.500,6,19,.316,13,21,.619,93,2014-03-26,PHO,WAS
95,@,L 99-114 ,240,39,83,.470,36,71,.507,3,12,.250,18,27,.667,99,43,86,.500,31,53,.585,12,33,.364,16,22,.727,114,2014-03-30,MIN,BRK
96,@,L 99-115 ,240,35,91,.385,27,55,.491,8,36,.222,21,28,.750,99,44,83,.530,39,65,.600,5,18,.278,22,24,.917,115,2014-03-30,PHO,LAL
97,@,L 99-100 ,240,39,91,.429,34,80,.425,5,11,.455,16,22,.727,99,38,75,.507,31,52,.596,7,23,.304,17,22,.773,100,2014-04-09,SAC,POR
98,Home,L 99-100 ,240,40,88,.455,34,65,.523,6,23,.261,13,15,.867,99,39,104,.375,29,70,.414,10,34,.294,12,19,.632,100,2014-04-10,GSW,DEN
99,Home,L 99-111 ,240,40,86,.465,34,73,.466,6,13,.462,13,16,.813,99,40,87,.460,29,65,.446,11,22,.500,20,24,.833,111,2014-04-11,UTA,POR
0,Home,L 99-111 ,240,37,90,.411,32,72,.444,5,18,.278,20,30,.667,99,42,90,.467,30,60,.500,12,30,.400,15,18,.833,111,2014-04-12,CLE,BOS
1,Home,L 99-104 ,240,37,86,.430,33,67,.493,4,19,.211,21,30,.700,99,40,86,.465,32,66,.485,8,20,.400,16,22,.727,104,2014-04-16,SAC,PHO
2,@,L 99-119 ,240,37,86,.430,33,73,.452,4,13,.308,21,25,.840,99,45,82,.549,29,50,.580,16,32,.500,13,18,.722,119,2014-10-29,LAL,PHO
3,@,L 99-110 ,240,37,90,.411,29,71,.408,8,19,.421,17,21,.810,99,38,74,.514,24,50,.480,14,24,.583,20,26,.769,110,2014-11-07,NYK,BRK
4,Home,L 99-100 ,240,36,80,.450,31,62,.500,5,18,.278,22,29,.759,99,40,85,.471,32,64,.500,8,21,.381,12,14,.857,100,2014-11-08,SAS,NOP
5,@,L 99-107 ,240,39,89,.438,36,73,.493,3,16,.188,18,20,.900,99,41,90,.456,30,56,.536,11,34,.324,14,21,.667,107,2014-11-13,BRK,GSW
6,@,W 99-90 ,240,37,77,.481,30,59,.508,7,18,.389,18,25,.720,99,35,83,.422,31,66,.470,4,17,.235,16,23,.696,90,2014-11-15,IND,CHI
7,@,L 99-115 ,240,34,69,.493,25,53,.472,9,16,.563,22,28,.786,99,44,89,.494,33,67,.493,11,22,.500,16,22,.727,115,2014-11-19,NYK,MIN
8,Home,W 99-89 ,240,38,80,.475,33,56,.589,5,24,.208,18,26,.692,99,31,83,.373,27,62,.435,4,21,.190,23,24,.958,89,2014-11-21,ATL,DET
9,@,W 99-92 ,240,37,71,.521,25,45,.556,12,26,.462,13,18,.722,99,35,78,.449,32,62,.516,3,16,.188,19,27,.704,92,2014-11-22,MIA,ORL
10,Home,W 99-87 ,240,41,79,.519,33,58,.569,8,21,.381,9,11,.818,99,34,91,.374,25,64,.391,9,27,.333,10,10,1.000,87,2014-11-22,SAS,BRK
11,@,W 99-89 ,240,37,77,.481,32,63,.508,5,14,.357,20,24,.833,99,33,79,.418,30,62,.484,3,17,.176,20,29,.690,89,2014-11-25,SAC,NOP
12,@,W 99-93 ,240,36,80,.450,31,58,.534,5,22,.227,22,25,.880,99,33,81,.407,25,62,.403,8,19,.421,19,24,.792,93,2014-11-26,MEM,LAL
13,@,W 99-91 ,240,35,71,.493,27,47,.574,8,24,.333,21,28,.750,99,34,85,.400,25,61,.410,9,24,.375,14,17,.824,91,2014-11-26,BRK,PHI
14,Home,L 99-112 ,240,39,97,.402,31,69,.449,8,28,.286,13,18,.722,99,45,84,.536,39,71,.549,6,13,.462,16,26,.615,112,2014-11-28,POR,MEM
15,@,L 99-116 ,240,41,85,.482,37,72,.514,4,13,.308,13,17,.765,99,43,86,.500,31,61,.508,12,25,.480,18,26,.692,116,2014-12-02,IND,PHO
16,Home,L 99-103 ,240,41,79,.519,36,60,.600,5,19,.263,12,14,.857,99,36,85,.424,26,57,.456,10,28,.357,21,29,.724,103,2014-12-07,NYK,POR
17,@,L 99-100 ,240,35,84,.417,27,57,.474,8,27,.296,21,24,.875,99,37,74,.500,27,53,.509,10,21,.476,16,21,.762,100,2014-12-13,ATL,ORL
18,@,W 99-91 ,240,34,74,.459,29,58,.500,5,16,.313,26,35,.743,99,34,83,.410,26,67,.388,8,16,.500,15,21,.714,91,2014-12-14,SAS,DEN
19,@,W 99-90 ,240,38,82,.463,33,64,.516,5,18,.278,18,22,.818,99,33,86,.384,27,61,.443,6,25,.240,18,23,.783,90,2014-12-18,NOP,HOU
20,Home,W 99-93 ,240,37,86,.430,28,60,.467,9,26,.346,16,20,.800,99,32,77,.416,29,64,.453,3,13,.231,26,26,1.000,93,2014-12-20,DAL,SAS
21,@,W 99-90 ,240,35,78,.449,25,53,.472,10,25,.400,19,23,.826,99,35,88,.398,28,66,.424,7,22,.318,13,16,.813,90,2014-12-20,PHO,NYK
22,Home,L 99-101 ,240,38,83,.458,33,63,.524,5,20,.250,18,24,.750,99,43,90,.478,36,70,.514,7,20,.350,8,10,.800,101,2014-12-21,OKC,NOP
23,@,W 99-91 ,240,39,85,.459,34,68,.500,5,17,.294,16,24,.667,99,38,89,.427,33,80,.413,5,9,.556,10,16,.625,91,2014-12-23,CHI,WAS
24,@,L 99-107 ,240,37,76,.487,28,56,.500,9,20,.450,16,20,.800,99,36,80,.450,28,59,.475,8,21,.381,27,39,.692,107,2014-12-29,SAC,BRK
25,Home,W 99-78 ,240,36,82,.439,21,48,.438,15,34,.441,12,20,.600,99,32,84,.381,28,67,.418,4,17,.235,10,15,.667,78,2014-12-31,LAC,NYK
26,Home,W 99-83 ,240,40,95,.421,32,68,.471,8,27,.296,11,15,.733,99,29,77,.377,26,63,.413,3,14,.214,22,30,.733,83,2015-01-08,POR,MIA
27,Home,W 99-94 ,240,42,91,.462,35,70,.500,7,21,.333,8,9,.889,99,36,74,.486,29,53,.547,7,21,.333,15,22,.682,94,2015-01-09,OKC,UTA
28,Home,L 99-113 ,240,39,84,.464,34,63,.540,5,21,.238,16,18,.889,99,41,86,.477,25,46,.543,16,40,.400,15,20,.750,113,2015-01-12,BRK,HOU
29,Home,L 99-105 ,240,34,79,.430,21,52,.404,13,27,.481,18,24,.750,99,40,78,.513,35,63,.556,5,15,.333,20,25,.800,105,2015-01-14,CHI,WAS
30,@,L 99-110 ,240,42,91,.462,34,69,.493,8,22,.364,7,12,.583,99,48,87,.552,43,72,.597,5,15,.333,9,11,.818,110,2015-01-16,MIN,PHO
31,@,W 99-90 ,240,40,77,.519,35,61,.574,5,16,.313,14,27,.519,99,36,82,.439,32,65,.492,4,17,.235,14,18,.778,90,2015-01-17,WAS,BRK
32,Home,L 99-107 ,240,37,80,.463,28,54,.519,9,26,.346,16,20,.800,99,40,84,.476,29,58,.500,11,26,.423,16,21,.762,107,2015-01-17,CHI,ATL
33,Home,L 99-127 ,240,35,88,.398,27,65,.415,8,23,.348,21,27,.778,99,48,83,.578,39,58,.672,9,25,.360,22,32,.688,127,2015-01-18,ORL,OKC
34,Home,W 99-92 ,240,38,78,.487,28,55,.509,10,23,.435,13,17,.765,99,35,84,.417,27,57,.474,8,27,.296,14,20,.700,92,2015-01-19,NYK,NOP
35,Home,L 99-109 ,240,37,79,.468,32,65,.492,5,14,.357,20,29,.690,99,38,84,.452,27,57,.474,11,27,.407,22,27,.815,109,2015-01-20,DEN,SAS
36,Home,L 99-101 ,240,42,92,.457,37,79,.468,5,13,.385,10,12,.833,99,32,71,.451,18,40,.450,14,31,.452,23,28,.821,101,2015-01-22,MIL,UTA
37,Home,L 99-100 ,240,37,89,.416,31,68,.456,6,21,.286,19,26,.731,99,37,75,.493,28,54,.519,9,21,.429,17,27,.630,100,2015-01-23,DEN,BOS
38,Home,W 99-85 ,240,36,84,.429,29,60,.483,7,24,.292,20,27,.741,99,33,83,.398,28,70,.400,5,13,.385,14,20,.700,85,2015-01-23,SAS,LAL
39,@,W 99-87 ,240,35,87,.402,22,43,.512,13,44,.295,16,21,.762,99,34,79,.430,33,66,.500,1,13,.077,18,25,.720,87,2015-01-25,HOU,LAL
40,Home,L 99-106 ,240,38,78,.487,32,61,.525,6,17,.353,17,23,.739,99,43,83,.518,35,63,.556,8,20,.400,12,18,.667,106,2015-01-25,ORL,IND
41,Home,W 99-74 ,240,39,86,.453,32,70,.457,7,16,.438,14,19,.737,99,28,81,.346,26,66,.394,2,15,.133,16,21,.762,74,2015-01-26,NOP,PHI
42,@,W 99-90 ,240,35,74,.473,27,55,.491,8,19,.421,21,23,.913,99,35,82,.427,26,58,.448,9,24,.375,11,19,.579,90,2015-01-26,BOS,UTA
43,Home,W 99-94 ,240,34,85,.400,19,48,.396,15,37,.405,16,18,.889,99,35,80,.438,25,49,.510,10,31,.323,14,17,.824,94,2015-01-28,CLE,POR
44,Home,W 99-94 ,240,36,88,.409,22,53,.415,14,35,.400,13,15,.867,99,35,82,.427,25,57,.439,10,25,.400,14,16,.875,94,2015-01-28,HOU,DAL
45,Home,W 99-69 ,240,39,88,.443,36,72,.500,3,16,.188,18,27,.667,99,29,87,.333,27,61,.443,2,26,.077,9,10,.900,69,2015-01-29,MEM,DEN
46,@,L 99-105 ,240,39,87,.448,28,57,.491,11,30,.367,10,11,.909,99,40,84,.476,29,61,.475,11,23,.478,14,22,.636,105,2015-01-30,POR,ATL
47,Home,W 99-93 ,240,39,90,.433,33,68,.485,6,22,.273,15,17,.882,99,36,87,.414,32,69,.464,4,18,.222,17,27,.630,93,2015-01-30,PHO,CHI
48,@,W 99-94 ,240,34,80,.425,29,65,.446,5,15,.333,26,29,.897,99,33,80,.413,28,55,.509,5,25,.200,23,25,.920,94,2015-01-31,SAC,IND
49,@,L 99-103 ,240,40,89,.449,29,54,.537,11,35,.314,8,12,.667,99,37,79,.468,29,58,.500,8,21,.381,21,26,.808,103,2015-02-06,CLE,IND
50,@,L 99-110 ,240,39,81,.481,33,62,.532,6,19,.316,15,20,.750,99,41,84,.488,24,51,.471,17,33,.515,11,18,.611,110,2015-02-20,SAS,GSW
51,@,L 99-126 ,240,30,88,.341,26,72,.361,4,16,.250,35,46,.761,99,46,95,.484,32,60,.533,14,35,.400,20,28,.714,126,2015-02-21,SAC,LAC
52,Home,W 99-92 ,240,38,79,.481,30,60,.500,8,19,.421,15,18,.833,99,38,84,.452,29,58,.500,9,26,.346,7,11,.636,92,2015-02-24,DAL,TOR
53,@,L 99-110 ,240,39,92,.424,28,63,.444,11,29,.379,10,19,.526,99,36,77,.468,27,49,.551,9,28,.321,29,35,.829,110,2015-02-26,GSW,CLE
54,Home,W 99-95 ,240,37,78,.474,30,58,.517,7,20,.350,18,25,.720,99,38,79,.481,30,53,.566,8,26,.308,11,21,.524,95,2015-02-28,WAS,DET
55,@,W 99-92 ,240,36,74,.486,31,52,.596,5,22,.227,22,30,.733,99,37,92,.402,28,59,.475,9,33,.273,9,17,.529,92,2015-03-01,NOP,DEN
56,Home,L 99-110 ,240,39,86,.453,36,74,.486,3,12,.250,18,23,.783,99,41,83,.494,31,59,.525,10,24,.417,18,20,.900,110,2015-03-01,SAC,POR
57,Home,W 99-97 ,240,38,82,.463,31,59,.525,7,23,.304,16,18,.889,99,37,79,.468,27,52,.519,10,27,.370,13,19,.684,97,2015-03-06,WAS,MIA
58,@,L 99-129 ,240,41,82,.500,29,50,.580,12,32,.375,5,12,.417,99,51,84,.607,35,56,.625,16,28,.571,11,16,.688,129,2015-03-13,LAC,DAL
59,@,L 99-113 ,240,34,78,.436,31,66,.470,3,12,.250,28,31,.903,99,44,101,.436,33,77,.429,11,24,.458,14,14,1.000,113,2015-03-13,MIN,OKC
60,@,L 99-118 ,240,41,91,.451,34,66,.515,7,25,.280,10,12,.833,99,46,80,.575,35,59,.593,11,21,.524,15,17,.882,118,2015-03-13,DET,POR
61,Home,W 99-92 ,240,35,77,.455,26,53,.491,9,24,.375,20,28,.714,99,32,79,.405,27,65,.415,5,14,.357,23,29,.793,92,2015-03-17,LAC,CHO
62,@,L 99-113 ,240,37,86,.430,31,67,.463,6,19,.316,19,23,.826,99,45,86,.523,33,63,.524,12,23,.522,11,17,.647,113,2015-03-20,WAS,LAC
63,@,W 99-85 ,240,35,84,.417,21,50,.420,14,34,.412,15,22,.682,99,29,84,.345,21,55,.382,8,29,.276,19,27,.704,85,2015-03-25,PHI,DEN
64,Home,L 99-101 (OT),265,33,78,.423,27,56,.482,6,22,.273,27,30,.900,99,39,92,.424,33,66,.500,6,26,.231,17,18,.944,101,2015-03-25,MIN,LAL
65,Home,L 99-108 ,240,38,87,.437,32,62,.516,6,25,.240,17,26,.654,99,40,81,.494,32,60,.533,8,21,.381,20,23,.870,108,2015-03-25,PHO,SAC
66,Home,W 99-86 ,240,37,72,.514,31,54,.574,6,18,.333,19,24,.792,99,32,82,.390,21,47,.447,11,35,.314,11,15,.733,86,2015-03-27,ATL,MIA
67,@,L 99-107 ,240,42,91,.462,36,73,.493,6,18,.333,9,11,.818,99,42,87,.483,34,59,.576,8,28,.286,15,21,.714,107,2015-03-29,LAL,BRK
68,@,L 99-104 ,240,40,90,.444,34,75,.453,6,15,.400,13,19,.684,99,38,76,.500,28,59,.475,10,17,.588,18,26,.692,104,2015-03-29,DAL,IND
69,@,W 99-91 ,240,34,80,.425,25,51,.490,9,29,.310,22,33,.667,99,29,75,.387,25,60,.417,4,15,.267,29,37,.784,91,2015-03-29,HOU,WAS
70,Home,W 99-96 ,240,35,78,.449,27,56,.482,8,22,.364,21,27,.778,99,35,84,.417,27,57,.474,8,27,.296,18,31,.581,96,2015-03-30,TOR,HOU
71,Home,L 99-113 ,240,41,77,.532,36,63,.571,5,14,.357,12,19,.632,99,42,76,.553,29,46,.630,13,30,.433,16,23,.696,113,2015-04-01,MIN,TOR
72,@,L 99-131 ,240,39,80,.488,29,57,.509,10,23,.435,11,17,.647,99,49,82,.598,32,49,.653,17,33,.515,16,19,.842,131,2015-04-04,BRK,ATL
73,Home,W 99-98 ,240,36,73,.493,24,47,.511,12,26,.462,15,23,.652,99,37,77,.481,32,57,.561,5,20,.250,19,26,.731,98,2015-04-04,DET,MIA
74,Home,W 99-90 ,240,36,84,.429,30,68,.441,6,16,.375,21,23,.913,99,39,85,.459,32,69,.464,7,16,.438,5,10,.500,90,2015-04-04,POR,NOP
75,Home,W 99-94 ,240,35,83,.422,19,46,.413,16,37,.432,13,22,.591,99,34,76,.447,23,49,.469,11,27,.407,15,21,.714,94,2015-04-05,CLE,CHI
76,Home,L 99-104 ,240,42,84,.500,36,66,.545,6,18,.333,9,13,.692,99,36,74,.486,25,40,.625,11,34,.324,21,26,.808,104,2015-04-08,MIL,CLE
77,@,W 99-90 ,240,38,84,.452,30,62,.484,8,22,.364,15,21,.714,99,32,77,.416,23,43,.535,9,34,.265,17,25,.680,90,2015-04-10,BOS,CLE
78,@,W 99-91 ,240,37,76,.487,31,59,.525,6,17,.353,19,29,.655,99,34,72,.472,29,59,.492,5,13,.385,18,24,.750,91,2015-04-10,MIL,NYK
79,Home,L 99-101 ,240,41,89,.461,34,69,.493,7,20,.350,10,10,1.000,99,39,94,.415,30,64,.469,9,30,.300,14,15,.933,101,2015-04-10,ORL,TOR
80,@,L 99-108 ,240,36,87,.414,27,58,.466,9,29,.310,18,24,.750,99,39,85,.459,30,64,.469,9,21,.429,21,27,.778,108,2015-04-12,ATL,WAS
81,Home,W 99-95 (2OT),290,40,105,.381,31,75,.413,9,30,.300,10,17,.588,99,37,104,.356,30,80,.375,7,24,.292,14,17,.824,95,2015-04-14,IND,WAS
82,Home,L 99-122 ,240,36,94,.383,29,70,.414,7,24,.292,20,25,.800,99,46,84,.548,38,67,.567,8,17,.471,22,41,.537,122,2015-04-15,LAL,SAC
83,@,L 99-106 ,240,32,86,.372,23,63,.365,9,23,.391,26,31,.839,99,36,80,.450,29,62,.468,7,18,.389,27,39,.692,106,2015-10-28,IND,TOR
84,@,W 99-71 ,240,36,88,.409,29,75,.387,7,13,.538,20,25,.800,99,19,63,.302,13,48,.271,6,15,.400,27,37,.730,71,2015-10-30,UTA,PHI
85,@,L 99-102 ,240,37,81,.457,30,59,.508,7,22,.318,18,20,.900,99,42,87,.483,34,64,.531,8,23,.348,10,14,.714,102,2015-11-04,SAS,WAS
86,@,W 99-92 ,240,35,81,.432,32,67,.478,3,14,.214,26,29,.897,99,33,81,.407,29,57,.509,4,24,.167,22,28,.786,92,2015-11-06,MIL,NYK
87,@,L 99-114 ,240,38,78,.487,30,54,.556,8,24,.333,15,17,.882,99,43,92,.467,30,59,.508,13,33,.394,15,15,1.000,114,2015-11-07,WAS,ATL
88,Home,W 99-95 ,240,33,84,.393,24,57,.421,9,27,.333,24,29,.828,99,36,94,.383,27,67,.403,9,27,.333,14,23,.609,95,2015-11-08,NYK,LAL
89,@,W 99-83 ,240,38,86,.442,31,56,.554,7,30,.233,16,19,.842,99,30,73,.411,24,56,.429,6,17,.353,17,23,.739,83,2015-11-10,BOS,MIL
90,@,L 99-101 ,240,39,79,.494,32,57,.561,7,22,.318,14,18,.778,99,40,100,.400,27,72,.375,13,28,.464,8,12,.667,101,2015-11-11,LAL,ORL
91,@,L 99-107 (OT),265,41,98,.418,39,80,.488,2,18,.111,15,16,.938,99,43,97,.443,31,63,.492,12,34,.353,9,10,.900,107,2015-11-14,BRK,GSW
92,@,L 99-108 ,240,38,87,.437,34,69,.493,4,18,.222,19,24,.792,99,39,83,.470,27,54,.500,12,29,.414,18,26,.692,108,2015-11-14,ORL,WAS
93,@,L 99-104 ,240,38,80,.475,27,47,.574,11,33,.333,12,20,.600,99,36,84,.429,29,63,.460,7,21,.333,25,31,.806,104,2015-11-17,CLE,DET
94,Home,W 99-95 ,240,34,82,.415,25,61,.410,9,21,.429,22,29,.759,99,31,82,.378,23,51,.451,8,31,.258,25,35,.714,95,2015-11-25,MIN,ATL
95,@,L 99-110 ,240,43,94,.457,40,81,.494,3,13,.231,10,12,.833,99,41,78,.526,31,54,.574,10,24,.417,18,21,.857,110,2015-11-25,BRK,OKC
96,@,L 99-103 ,240,36,82,.439,22,53,.415,14,29,.483,13,16,.813,99,40,79,.506,29,54,.537,11,25,.440,12,22,.545,103,2015-11-25,CLE,TOR
97,@,L 99-107 ,240,37,82,.451,29,66,.439,8,16,.500,17,21,.810,99,39,75,.520,31,53,.585,8,22,.364,21,33,.636,107,2015-11-29,MIN,LAC
98,Home,W 99-90 ,240,36,89,.404,30,72,.417,6,17,.353,21,27,.778,99,36,93,.387,31,78,.397,5,15,.333,13,22,.591,90,2015-12-02,CHI,DEN
99,Home,L 99-116 ,240,35,94,.372,26,63,.413,9,31,.290,20,30,.667,99,46,88,.523,30,54,.556,16,34,.471,8,11,.727,116,2015-12-02,CHO,GSW
0,Home,W 99-87 ,240,38,88,.432,34,69,.493,4,19,.211,19,22,.864,99,32,86,.372,23,56,.411,9,30,.300,14,24,.583,87,2015-12-02,NYK,PHI
1,Home,W 99-84 ,240,37,68,.544,30,52,.577,7,16,.438,18,29,.621,99,31,85,.365,25,57,.439,6,28,.214,16,24,.667,84,2015-12-05,MIA,CLE
2,Home,W 99-81 ,240,40,81,.494,29,54,.537,11,27,.407,8,17,.471,99,29,75,.387,23,54,.426,6,21,.286,17,24,.708,81,2015-12-09,CHO,MIA
3,Home,W 99-97 ,240,42,93,.452,39,77,.506,3,16,.188,12,16,.750,99,33,83,.398,24,54,.444,9,29,.310,22,28,.786,97,2015-12-10,SAC,NYK
4,Home,L 99-123 ,240,32,80,.400,25,60,.417,7,20,.350,28,37,.757,99,39,78,.500,21,41,.512,18,37,.486,27,30,.900,123,2015-12-11,MEM,CHO
5,@,L 99-109 (OT),265,35,97,.361,26,58,.448,9,39,.231,20,28,.714,99,37,85,.435,27,56,.482,10,29,.345,25,31,.806,109,2015-12-17,TOR,CHO
6,Home,W 99-95 ,240,39,82,.476,33,64,.516,6,18,.333,15,16,.938,99,38,81,.469,31,58,.534,7,23,.304,12,17,.706,95,2015-12-18,MIN,SAC
7,@,L 99-113 ,240,36,79,.456,34,66,.515,2,13,.154,25,32,.781,99,46,89,.517,34,64,.531,12,25,.480,9,16,.563,113,2015-12-21,MIN,BOS
8,Home,L 99-100 ,240,41,87,.471,34,65,.523,7,22,.318,10,14,.714,99,40,85,.471,36,68,.529,4,17,.235,16,20,.800,100,2015-12-21,LAC,OKC
9,Home,L 99-107 ,240,39,76,.513,32,52,.615,7,24,.292,14,16,.875,99,44,86,.512,34,64,.531,10,22,.455,9,11,.818,107,2015-12-21,NYK,ORL
10,@,L 99-113 ,240,37,91,.407,30,69,.435,7,22,.318,18,22,.818,99,42,83,.506,28,59,.475,14,24,.583,15,17,.882,113,2015-12-21,SAC,WAS
11,@,L 99-103 ,240,40,92,.435,29,63,.460,11,29,.379,8,11,.727,99,35,74,.473,23,48,.479,12,26,.462,21,27,.778,103,2015-12-22,DAL,TOR
12,@,W 99-93 ,240,39,84,.464,35,61,.574,4,23,.174,17,23,.739,99,35,91,.385,29,66,.439,6,25,.240,17,25,.680,93,2015-12-26,BOS,DET
13,Home,W 99-90 (OT),265,38,87,.437,34,72,.472,4,15,.267,19,20,.950,99,35,79,.443,24,50,.480,11,29,.379,9,18,.500,90,2015-12-29,MEM,MIA
14,@,L 99-130 ,240,41,89,.461,32,66,.485,9,23,.391,8,17,.471,99,49,81,.605,37,58,.638,12,23,.522,20,25,.800,130,2016-01-02,PHI,LAC
15,@,L 99-109 ,240,39,73,.534,37,68,.544,2,5,.400,19,24,.792,99,48,87,.552,44,67,.657,4,20,.200,9,14,.643,109,2016-01-04,MIN,PHI
16,@,W 99-94 ,240,33,74,.446,23,47,.489,10,27,.370,23,36,.639,99,34,91,.374,28,63,.444,6,28,.214,20,27,.741,94,2016-01-06,DET,BOS
17,Home,L 99-125 ,240,36,79,.456,29,63,.460,7,16,.438,20,26,.769,99,43,81,.531,30,54,.556,13,27,.481,26,29,.897,125,2016-01-08,MIN,CLE
18,@,L 99-100 ,240,38,91,.418,29,70,.414,9,21,.429,14,17,.824,99,41,93,.441,37,80,.463,4,13,.308,14,17,.824,100,2016-01-08,NYK,SAS
19,Home,L 99-105 ,240,38,74,.514,33,60,.550,5,14,.357,18,24,.750,99,42,76,.553,29,53,.547,13,23,.565,8,10,.800,105,2016-01-09,ORL,WAS
20,Home,L 99-109 ,240,38,91,.418,32,68,.471,6,23,.261,17,26,.654,99,41,85,.482,36,71,.507,5,14,.357,22,27,.815,109,2016-01-12,DET,SAS
21,Home,W 99-85 ,240,39,88,.443,28,62,.452,11,26,.423,10,15,.667,99,31,76,.408,23,57,.404,8,19,.421,15,22,.682,85,2016-01-13,POR,UTA
22,Home,W 99-95 ,240,38,83,.458,33,66,.500,5,17,.294,18,22,.818,99,38,82,.463,28,56,.500,10,26,.385,9,11,.818,95,2016-01-14,SAS,CLE
23,Home,W 99-74 ,240,40,88,.455,33,66,.500,7,22,.318,12,12,1.000,99,30,72,.417,26,58,.448,4,14,.286,10,11,.909,74,2016-01-17,OKC,MIA
24,@,L 99-101 ,240,36,74,.486,30,55,.545,6,19,.316,21,23,.913,99,35,75,.467,27,56,.482,8,19,.421,23,30,.767,101,2016-01-18,NOP,MEM
25,@,L 99-114 ,240,36,76,.474,33,62,.532,3,14,.214,24,31,.774,99,42,83,.506,32,60,.533,10,23,.435,20,23,.870,114,2016-01-19,MIN,NOP
26,@,L 99-115 ,240,38,91,.418,31,61,.508,7,30,.233,16,20,.800,99,46,86,.535,41,74,.554,5,12,.417,18,18,1.000,115,2016-01-21,DET,NOP
27,@,L 99-116 ,240,39,74,.527,33,59,.559,6,15,.400,15,18,.833,99,43,94,.457,26,63,.413,17,31,.548,13,17,.765,116,2016-01-23,MIL,NOP
28,@,L 99-130 ,240,28,73,.384,20,43,.465,8,30,.267,35,52,.673,99,50,90,.556,38,67,.567,12,23,.522,18,21,.857,130,2016-01-27,HOU,SAS
29,@,W 99-96 ,240,39,81,.481,32,61,.525,7,20,.350,14,20,.700,99,39,85,.459,35,65,.538,4,20,.200,14,26,.538,96,2016-02-04,LAL,NOP
30,Home,W 99-84 ,240,39,90,.433,25,49,.510,14,41,.341,7,7,1.000,99,34,87,.391,29,64,.453,5,23,.217,11,16,.688,84,2016-02-06,CLE,NOP
31,Home,W 99-92 ,240,36,82,.439,32,68,.471,4,14,.286,23,32,.719,99,34,88,.386,28,56,.500,6,32,.188,18,24,.750,92,2016-02-11,MIL,WAS
32,Home,W 99-97 ,240,37,73,.507,31,56,.554,6,17,.353,19,26,.731,99,35,74,.473,23,50,.460,12,24,.500,15,21,.714,97,2016-02-26,TOR,CLE
33,@,L 99-113 ,240,32,80,.400,23,51,.451,9,29,.310,26,30,.867,99,39,79,.494,28,48,.583,11,31,.355,24,34,.706,113,2016-02-28,CLE,WAS
34,Home,L 99-104 ,240,34,76,.447,31,62,.500,3,14,.214,28,32,.875,99,38,80,.475,28,60,.467,10,20,.500,18,26,.692,104,2016-03-02,MIL,IND
35,Home,L 99-119 ,240,34,85,.400,21,52,.404,13,33,.394,18,26,.692,99,40,81,.494,30,56,.536,10,25,.400,29,35,.829,119,2016-03-02,PHI,CHO
36,Home,L 99-100 ,240,39,89,.438,33,74,.446,6,15,.400,15,24,.625,99,37,83,.446,30,62,.484,7,21,.333,19,20,.950,100,2016-03-05,WAS,IND
37,Home,W 99-91 ,240,32,78,.410,25,62,.403,7,16,.438,28,30,.933,99,34,96,.354,30,68,.441,4,28,.143,19,22,.864,91,2016-03-07,IND,SAS
38,@,L 99-104 ,240,42,82,.512,36,70,.514,6,12,.500,9,9,1.000,99,37,78,.474,27,55,.491,10,23,.435,20,25,.800,104,2016-03-08,BRK,TOR
39,@,W 99-96 ,240,37,86,.430,30,65,.462,7,21,.333,18,21,.857,99,36,84,.429,30,57,.526,6,27,.222,18,25,.720,96,2016-03-11,MIN,OKC
40,Home,L 99-108 ,240,38,81,.469,29,60,.483,9,21,.429,14,21,.667,99,39,82,.476,27,54,.500,12,28,.429,18,22,.818,108,2016-03-13,SAC,UTA
41,@,L 99-107 ,240,35,83,.422,24,58,.414,11,25,.440,18,21,.857,99,40,100,.400,29,63,.460,11,37,.297,16,21,.762,107,2016-03-16,ORL,CHO
42,Home,W 99-98 ,240,39,88,.443,29,51,.569,10,37,.270,11,13,.846,99,37,79,.468,30,57,.526,7,22,.318,17,19,.895,98,2016-03-16,CLE,DAL
43,@,W 99-94 ,240,40,90,.444,34,63,.540,6,27,.222,13,19,.684,99,35,91,.385,29,58,.500,6,33,.182,18,26,.692,94,2016-03-17,WAS,PHI
44,Home,W 99-89 ,240,39,87,.448,31,58,.534,8,29,.276,13,17,.765,99,32,81,.395,22,60,.367,10,21,.476,15,17,.882,89,2016-03-19,WAS,NYK
45,Home,L 99-113 ,240,34,87,.391,27,71,.380,7,16,.438,24,30,.800,99,44,88,.500,41,69,.594,3,19,.158,22,27,.815,113,2016-03-22,NOP,MIA
46,Home,L 99-102 ,240,37,85,.435,30,54,.556,7,31,.226,18,21,.857,99,35,84,.417,27,55,.491,8,29,.276,24,27,.889,102,2016-03-26,PHO,BOS
47,@,L 99-110 ,240,41,77,.532,38,66,.576,3,11,.273,14,18,.778,99,48,84,.571,43,68,.632,5,16,.313,9,12,.750,110,2016-03-28,BRK,MIA
48,Home,W 99-91 ,240,32,75,.427,24,56,.429,8,19,.421,27,37,.730,99,36,89,.404,26,58,.448,10,31,.323,9,13,.692,91,2016-03-28,NOP,NYK
49,@,W 99-79 ,240,37,84,.440,28,53,.528,9,31,.290,16,18,.889,99,30,87,.345,22,64,.344,8,23,.348,11,17,.647,79,2016-03-30,LAC,MIN
50,@,W 99-95 ,240,30,71,.423,18,43,.419,12,28,.429,27,29,.931,99,37,91,.407,30,72,.417,7,19,.368,14,17,.824,95,2016-04-01,TOR,MEM
51,Home,L 99-106 ,240,36,93,.387,29,70,.414,7,23,.304,20,26,.769,99,38,86,.442,28,60,.467,10,26,.385,20,25,.800,106,2016-04-01,PHO,WAS
52,@,L 99-113 ,240,39,92,.424,29,67,.433,10,25,.400,11,20,.550,99,41,83,.494,27,46,.587,14,37,.378,17,20,.850,113,2016-04-08,BRK,CHO
53,@,L 99-112 ,240,38,86,.442,32,67,.478,6,19,.316,17,23,.739,99,36,77,.468,22,45,.489,14,32,.438,26,29,.897,112,2016-04-08,WAS,DET
54,Home,L 99-102 (OT),265,36,82,.439,25,51,.490,11,31,.355,16,23,.696,99,37,83,.446,24,54,.444,13,29,.448,15,19,.789,102,2016-04-08,UTA,LAC
55,Home,L 99-100 ,240,37,96,.385,30,75,.400,7,21,.333,18,20,.900,99,39,87,.448,29,51,.569,10,36,.278,12,13,.923,100,2016-04-09,MEM,GSW
56,@,W 99-93 ,240,38,78,.487,31,58,.534,7,20,.350,16,22,.727,99,34,84,.405,29,66,.439,5,18,.278,20,30,.667,93,2016-04-12,MIA,DET
57,@,L 99-107 ,240,40,94,.426,33,69,.478,7,25,.280,12,18,.667,99,39,89,.438,28,53,.528,11,36,.306,18,22,.818,107,2016-04-13,DEN,POR
58,@,L 99-114 ,240,40,94,.426,34,74,.459,6,20,.300,13,18,.722,99,44,88,.500,32,62,.516,12,26,.462,14,18,.778,114,2016-10-27,WAS,ATL
59,@,L 99-105 ,240,38,76,.500,30,53,.566,8,23,.348,15,24,.625,99,36,92,.391,25,67,.373,11,25,.440,22,30,.733,105,2016-10-27,BOS,CHI
60,@,L 99-105 ,240,38,84,.452,30,56,.536,8,28,.286,15,26,.577,99,36,88,.409,25,51,.490,11,37,.297,22,30,.733,105,2016-10-29,ORL,CLE
61,Home,L 99-106 ,240,37,80,.463,30,60,.500,7,20,.350,18,26,.692,99,37,82,.451,27,64,.422,10,18,.556,22,26,.846,106,2016-10-30,MIA,SAS
62,Home,L 99-118 ,240,37,85,.435,29,65,.446,8,20,.400,17,25,.680,99,42,89,.472,27,49,.551,15,40,.375,19,27,.704,118,2016-11-02,NYK,HOU
63,Home,L 99-102 ,240,35,88,.398,26,66,.394,9,22,.409,20,25,.800,99,39,81,.481,33,59,.559,6,22,.273,18,25,.720,102,2016-11-03,MIN,DEN
64,@,W 99-95 ,240,36,86,.419,26,56,.464,10,30,.333,17,24,.708,99,35,87,.402,26,51,.510,9,36,.250,16,21,.762,95,2016-11-04,CHO,BRK
65,@,W 99-88 ,240,32,85,.376,24,58,.414,8,27,.296,27,33,.818,99,31,84,.369,22,58,.379,9,26,.346,17,22,.773,88,2016-11-04,LAC,MEM
66,Home,L 99-101 ,240,33,84,.393,26,61,.426,7,23,.304,26,30,.867,99,37,78,.474,27,48,.563,10,30,.333,17,22,.773,101,2016-11-09,SAS,HOU
67,Home,L 99-105 ,240,36,86,.419,30,59,.508,6,27,.222,21,28,.750,99,35,80,.438,27,55,.491,8,25,.320,27,33,.818,105,2016-11-12,IND,BOS
68,Home,L 99-126 ,240,39,90,.433,33,70,.471,6,20,.300,15,19,.789,99,52,94,.553,36,64,.563,16,30,.533,6,7,.857,126,2016-11-12,NOP,LAL
69,@,L 99-125 ,240,33,71,.465,25,47,.532,8,24,.333,25,30,.833,99,42,80,.525,29,53,.547,13,27,.481,28,42,.667,125,2016-11-13,LAL,MIN
70,@,L 99-102 ,240,34,85,.400,25,61,.410,9,24,.375,22,24,.917,99,36,81,.444,25,54,.463,11,27,.407,19,25,.760,102,2016-11-20,TOR,SAC
71,@,W 99-96 ,240,35,78,.449,25,47,.532,10,31,.323,19,27,.704,99,36,87,.414,29,70,.414,7,17,.412,17,24,.708,96,2016-11-21,HOU,DET
72,@,W 99-93 ,240,38,84,.452,26,46,.565,12,38,.316,11,14,.786,99,36,86,.419,32,62,.516,4,24,.167,17,25,.680,93,2016-11-21,BOS,MIN
73,Home,L 99-104 (2OT),290,35,93,.376,23,57,.404,12,36,.333,17,23,.739,99,38,99,.384,28,70,.400,10,29,.345,18,24,.750,104,2016-11-23,PHI,MEM
74,Home,L 99-105 ,240,40,79,.506,28,50,.560,12,29,.414,7,12,.583,99,38,82,.463,24,50,.480,14,32,.438,15,19,.789,105,2016-11-25,MIL,TOR
75,Home,W 99-92 ,240,36,89,.404,27,65,.415,9,24,.375,18,24,.750,99,38,86,.442,32,64,.500,6,22,.273,10,15,.667,92,2016-12-03,POR,MIA
76,Home,L 99-102 ,240,34,77,.442,27,55,.491,7,22,.318,24,32,.750,99,37,80,.463,27,49,.551,10,31,.323,18,28,.643,102,2016-12-05,ATL,OKC
77,@,W 99-88 ,240,39,91,.429,27,51,.529,12,40,.300,9,13,.692,99,33,84,.393,26,59,.441,7,25,.280,15,22,.682,88,2016-12-08,PHI,NOP
78,Home,L 99-106 ,240,37,89,.416,27,51,.529,10,38,.263,15,21,.714,99,39,80,.488,27,51,.529,12,29,.414,16,23,.696,106,2016-12-08,UTA,GSW
79,Home,L 99-102 ,240,34,81,.420,27,53,.509,7,28,.250,24,31,.774,99,36,92,.391,25,50,.500,11,42,.262,19,30,.633,102,2016-12-09,OKC,HOU
80,Home,W 99-96 ,240,41,83,.494,38,62,.613,3,21,.143,14,27,.519,99,40,90,.444,29,58,.500,11,32,.344,5,8,.625,96,2016-12-11,OKC,BOS
81,@,W 99-94 ,240,38,86,.442,32,65,.492,6,21,.286,17,22,.773,99,38,87,.437,34,72,.472,4,15,.267,14,19,.737,94,2016-12-13,MIN,CHI
82,Home,L 99-107 ,240,40,86,.465,30,60,.500,10,26,.385,9,16,.563,99,43,88,.489,31,61,.508,12,27,.444,9,13,.692,107,2016-12-17,ATL,CHO
83,Home,W 99-79 ,240,34,77,.442,21,44,.477,13,33,.394,18,22,.818,99,30,76,.395,22,45,.489,8,31,.258,11,17,.647,79,2016-12-18,DAL,SAC
84,@,L 99-119 ,240,38,85,.447,30,55,.545,8,30,.267,15,18,.833,99,45,99,.455,37,64,.578,8,35,.229,21,24,.875,119,2016-12-23,BRK,CLE
85,@,L 99-101 ,240,37,86,.430,24,53,.453,13,33,.394,12,16,.750,99,35,88,.398,32,75,.427,3,13,.231,28,29,.966,101,2016-12-28,BRK,CHI
86,Home,W 99-91 ,240,37,83,.446,28,62,.452,9,21,.429,16,23,.696,99,30,75,.400,23,48,.479,7,27,.259,24,29,.828,91,2016-12-29,PHO,TOR
87,@,L 99-108 ,240,39,93,.419,31,61,.508,8,32,.250,13,15,.867,99,42,84,.500,31,51,.608,11,33,.333,13,15,.867,108,2016-12-30,DAL,GSW
88,@,L 99-116 ,240,40,74,.541,32,56,.571,8,18,.444,11,17,.647,99,43,77,.558,30,52,.577,13,25,.520,17,21,.810,116,2016-12-30,MIL,MIN
89,Home,W 99-90 ,240,36,77,.468,27,54,.500,9,23,.391,18,22,.818,99,36,91,.396,30,68,.441,6,23,.261,12,16,.750,90,2017-01-03,PHO,MIA
90,Home,L 99-127 ,240,39,86,.453,32,61,.525,7,25,.280,14,17,.824,99,51,90,.567,39,66,.591,12,24,.500,13,17,.765,127,2017-01-05,DEN,SAS
91,@,W 99-94 ,240,38,90,.422,29,67,.433,9,23,.391,14,17,.824,99,34,93,.366,19,58,.328,15,35,.429,11,14,.786,94,2017-01-05,ATL,NOP
92,@,L 99-101 ,240,35,88,.398,25,61,.410,10,27,.370,19,21,.905,99,42,83,.506,31,61,.508,11,22,.500,6,9,.667,101,2017-01-10,CHI,WAS
93,@,L 99-107 ,240,39,84,.464,32,61,.525,7,23,.304,14,21,.667,99,43,101,.426,35,81,.432,8,20,.400,13,23,.565,107,2017-01-14,NOP,CHI
94,@,W 99-98 ,240,37,78,.474,26,50,.520,11,28,.393,14,18,.778,99,37,82,.451,31,68,.456,6,14,.429,18,22,.818,98,2017-01-17,DAL,CHI
95,Home,W 99-95 ,240,35,73,.479,26,53,.491,9,20,.450,20,29,.690,99,37,82,.451,23,46,.500,14,36,.389,7,11,.636,95,2017-01-19,MIA,DAL
96,@,L 99-102 ,240,37,84,.440,28,58,.483,9,26,.346,16,21,.762,99,34,83,.410,28,66,.424,6,17,.353,28,33,.848,102,2017-01-21,SAC,CHI
97,Home,L 99-109 ,240,35,90,.389,27,58,.466,8,32,.250,21,25,.840,99,43,80,.538,33,55,.600,10,25,.400,13,17,.765,109,2017-01-23,CHO,WAS
98,@,L 99-101 ,240,39,92,.424,29,58,.500,10,34,.294,11,19,.579,99,36,78,.462,26,56,.464,10,22,.455,19,25,.760,101,2017-01-25,TOR,MEM
99,Home,L 99-119 ,240,32,80,.400,23,55,.418,9,25,.360,26,35,.743,99,45,92,.489,31,62,.500,14,30,.467,15,20,.750,119,2017-02-01,DEN,MEM
0,Home,L 99-107 ,240,35,84,.417,25,58,.431,10,26,.385,19,24,.792,99,32,77,.416,22,49,.449,10,28,.357,33,39,.846,107,2017-02-04,MIN,MEM
1,@,L 99-105 ,240,35,87,.402,25,59,.424,10,28,.357,19,21,.905,99,40,98,.408,36,80,.450,4,18,.222,21,28,.750,105,2017-02-05,POR,OKC
2,Home,L 99-108 ,240,35,81,.432,27,61,.443,8,20,.400,21,28,.750,99,41,92,.446,34,69,.493,7,23,.304,19,21,.905,108,2017-02-10,BRK,MIA
3,@,L 99-105 ,240,34,82,.415,21,51,.412,13,31,.419,18,21,.857,99,35,78,.449,24,47,.511,11,31,.355,24,27,.889,105,2017-02-12,NOP,SAC
4,Home,L 99-105 ,240,34,78,.436,23,47,.489,11,31,.355,20,26,.769,99,41,86,.477,29,53,.547,12,33,.364,11,17,.647,105,2017-02-13,CHO,PHI
5,Home,L 99-112 ,240,38,94,.404,27,60,.450,11,34,.324,12,18,.667,99,41,86,.477,35,68,.515,6,18,.333,24,28,.857,112,2017-02-15,DEN,MIN
6,Home,W 99-84 ,240,37,79,.468,23,42,.548,14,37,.378,11,12,.917,99,32,79,.405,25,53,.472,7,26,.269,13,19,.684,84,2017-02-15,LAC,ATL
7,Home,L 99-129 ,240,36,86,.419,30,55,.545,6,31,.194,21,26,.808,99,45,91,.495,25,40,.625,20,51,.392,19,24,.792,129,2017-02-23,NOP,HOU
8,Home,L 99-117 ,240,37,80,.463,23,43,.535,14,37,.378,11,15,.733,99,46,93,.495,31,63,.492,15,30,.500,10,16,.625,117,2017-02-25,CLE,CHI
9,@,W 99-85 ,240,34,85,.400,20,47,.426,14,38,.368,17,18,.944,99,31,79,.392,20,51,.392,11,28,.393,12,15,.800,85,2017-02-25,CHO,SAC
10,@,L 99-103 ,240,37,91,.407,27,58,.466,10,33,.303,15,22,.682,99,36,78,.462,23,47,.489,13,31,.419,18,23,.783,103,2017-03-01,CLE,BOS
11,@,L 99-100 ,240,37,81,.457,30,58,.517,7,23,.304,18,25,.720,99,35,74,.473,26,45,.578,9,29,.310,21,24,.875,100,2017-03-01,IND,SAS
12,@,L 99-110 ,240,35,91,.385,27,63,.429,8,28,.286,21,25,.840,99,45,90,.500,40,73,.548,5,17,.294,15,19,.789,110,2017-03-03,MIA,ORL
13,@,W 99-86 ,240,37,84,.440,27,55,.491,10,29,.345,15,19,.789,99,37,84,.440,31,54,.574,6,30,.200,6,9,.667,86,2017-03-08,BOS,GSW
14,Home,W 98-95 ,240,40,94,.426,38,78,.487,2,16,.125,16,20,.800,98,28,70,.400,22,56,.393,6,14,.429,33,45,.733,95,2011-12-27,MIL,MIN
15,@,W 98-95 ,240,29,77,.377,19,52,.365,10,25,.400,30,38,.789,98,34,87,.391,32,71,.451,2,16,.125,25,33,.758,95,2011-12-28,OKC,MEM
16,Home,L 98-108 ,240,35,83,.422,27,66,.409,8,17,.471,20,34,.588,98,43,80,.538,37,68,.544,6,12,.500,16,21,.762,108,2011-12-29,SAC,CHI
17,@,L 98-105 ,240,38,82,.463,29,62,.468,9,20,.450,13,14,.929,98,37,77,.481,33,62,.532,4,15,.267,27,38,.711,105,2011-12-30,NJN,ATL
18,Home,W 98-91 (OT),265,36,94,.383,34,84,.405,2,10,.200,24,32,.750,98,34,88,.386,29,63,.460,5,25,.200,18,31,.581,91,2011-12-30,IND,CLE
19,Home,W 98-82 ,240,38,78,.487,22,52,.423,16,26,.615,6,11,.545,98,27,71,.380,20,49,.408,7,22,.318,21,28,.750,82,2012-01-01,CLE,NJN
20,Home,W 98-89 ,240,38,91,.418,30,69,.435,8,22,.364,14,21,.667,98,37,82,.451,32,65,.492,5,17,.294,10,15,.667,89,2012-01-04,DAL,PHO
21,@,W 98-87 ,240,37,80,.463,29,63,.460,8,17,.471,16,22,.727,98,31,79,.392,27,59,.458,4,20,.200,21,31,.677,87,2012-01-06,CLE,MIN
22,@,W 98-95 ,240,36,85,.424,29,64,.453,7,21,.333,19,22,.864,98,38,87,.437,33,73,.452,5,14,.357,14,15,.933,95,2012-01-07,OKC,HOU
23,Home,W 98-78 ,240,38,92,.413,32,69,.464,6,23,.261,16,18,.889,98,29,79,.367,26,55,.473,3,24,.125,17,24,.708,78,2012-01-08,POR,CLE
24,@,W 98-91 ,240,30,81,.370,23,57,.404,7,24,.292,31,34,.912,98,34,80,.425,28,60,.467,6,20,.300,17,21,.810,91,2012-01-11,SAC,TOR
25,@,W 98-81 ,240,40,82,.488,33,68,.485,7,14,.500,11,16,.688,98,33,74,.446,32,66,.485,1,8,.125,14,16,.875,81,2012-01-13,DET,CHA
26,@,L 98-120 ,240,38,80,.475,28,55,.509,10,25,.400,12,17,.706,98,46,79,.582,30,53,.566,16,26,.615,12,19,.632,120,2012-01-17,SAS,MIA
27,Home,W 98-87 ,240,38,85,.447,29,67,.433,9,18,.500,13,18,.722,98,34,81,.420,28,61,.459,6,20,.300,13,16,.813,87,2012-01-19,MIA,LAL
28,@,W 98-81 ,240,39,68,.574,34,59,.576,5,9,.556,15,20,.750,98,29,66,.439,25,56,.446,4,10,.400,19,26,.731,81,2012-01-20,MEM,DET
29,Home,L 98-101 ,240,33,71,.465,22,50,.440,11,21,.524,21,28,.750,98,36,81,.444,30,66,.455,6,15,.400,23,33,.697,101,2012-01-20,LAC,MIN
30,@,L 98-108 ,240,37,83,.446,29,62,.468,8,21,.381,16,21,.762,98,41,79,.519,36,64,.563,5,15,.333,21,29,.724,108,2012-01-21,MIN,UTA
31,@,W 98-96 ,240,36,77,.468,26,59,.441,10,18,.556,16,19,.842,98,36,86,.419,34,77,.442,2,9,.222,22,33,.667,96,2012-01-22,IND,LAL
32,Home,L 98-101 ,240,36,72,.500,29,50,.580,7,22,.318,19,25,.760,98,37,71,.521,32,56,.571,5,15,.333,22,25,.880,101,2012-01-25,DET,MIA
33,Home,W 98-91 ,240,35,72,.486,26,50,.520,9,22,.409,19,27,.704,98,30,84,.357,24,66,.364,6,18,.333,25,31,.806,91,2012-01-26,LAC,MEM
34,@,W 98-88 ,240,34,75,.453,28,55,.509,6,20,.300,24,31,.774,98,37,92,.402,34,78,.436,3,14,.214,11,13,.846,88,2012-01-30,CHI,WAS
35,Home,W 98-82 ,240,40,84,.476,36,73,.493,4,11,.364,14,19,.737,98,32,74,.432,25,57,.439,7,17,.412,11,16,.688,82,2012-02-01,PHI,CHI
36,@,W 98-87 ,240,37,87,.425,25,62,.403,12,25,.480,12,16,.750,98,35,83,.422,29,67,.433,6,16,.375,11,13,.846,87,2012-02-03,IND,DAL
37,@,W 98-87 ,240,44,88,.500,40,79,.506,4,9,.444,6,9,.667,98,32,74,.432,27,59,.458,5,15,.333,18,27,.667,87,2012-02-04,PHI,ATL
38,Home,W 98-80 ,240,36,73,.493,29,53,.547,7,20,.350,19,21,.905,98,32,87,.368,29,73,.397,3,14,.214,13,16,.813,80,2012-02-05,BOS,MEM
39,Home,W 98-92 ,240,34,73,.466,33,64,.516,1,9,.111,29,37,.784,98,30,78,.385,24,62,.387,6,16,.375,26,37,.703,92,2012-02-10,MEM,IND
40,Home,L 98-100 ,240,37,84,.440,31,65,.477,6,19,.316,18,19,.947,98,40,84,.476,33,65,.508,7,19,.368,13,22,.591,100,2012-02-11,MIN,NYK
41,@,W 98-84 ,240,39,78,.500,31,55,.564,8,23,.348,12,15,.800,98,27,77,.351,19,56,.339,8,21,.381,22,28,.786,84,2012-02-11,PHO,SAC
42,@,W 98-77 ,240,37,79,.468,31,64,.484,6,15,.400,18,21,.857,98,29,89,.326,28,78,.359,1,11,.091,18,19,.947,77,2012-02-12,WAS,DET
43,@,W 98-88 ,240,42,83,.506,37,70,.529,5,13,.385,9,13,.692,98,34,78,.436,32,68,.471,2,10,.200,18,23,.783,88,2012-02-12,UTA,MEM
44,@,W 98-89 ,240,36,83,.434,30,65,.462,6,18,.333,20,24,.833,98,30,73,.411,23,56,.411,7,17,.412,22,30,.733,89,2012-02-13,PHI,CHA
45,@,W 98-88 ,240,35,74,.473,31,62,.500,4,12,.333,24,29,.828,98,34,77,.442,33,71,.465,1,6,.167,19,32,.594,88,2012-02-15,DET,BOS
46,Home,W 98-87 ,240,36,77,.468,26,50,.520,10,27,.370,16,23,.696,98,32,87,.368,27,71,.380,5,16,.313,18,27,.667,87,2012-02-15,CLE,IND
47,Home,L 98-111 ,240,40,85,.471,30,65,.462,10,20,.500,8,10,.800,98,43,77,.558,38,62,.613,5,15,.333,20,23,.870,111,2012-02-17,HOU,MIN
48,@,W 98-91 ,240,37,74,.500,31,59,.525,6,15,.400,18,23,.783,98,35,84,.417,33,68,.485,2,16,.125,19,28,.679,91,2012-02-17,CHA,TOR
49,@,L 98-100 ,240,39,85,.459,38,78,.487,1,7,.143,19,24,.792,98,31,77,.403,20,55,.364,11,22,.500,27,38,.711,100,2012-02-22,UTA,MIN
50,@,L 98-99 ,240,37,75,.493,29,58,.500,8,17,.471,16,22,.727,98,38,90,.422,35,80,.438,3,10,.300,20,27,.741,99,2012-03-02,MIA,UTA
51,@,L 98-114 ,240,37,79,.468,31,63,.492,6,16,.375,18,27,.667,98,42,81,.519,28,54,.519,14,27,.519,16,27,.593,114,2012-03-03,MIL,ORL
52,@,L 98-101 ,240,37,83,.446,29,62,.468,8,21,.381,16,26,.615,98,40,87,.460,32,66,.485,8,21,.381,13,21,.619,101,2012-03-03,CLE,WAS
53,@,L 98-99 ,240,42,77,.545,39,68,.574,3,9,.333,11,12,.917,98,38,76,.500,30,53,.566,8,23,.348,15,23,.652,99,2012-03-07,NOH,SAC
54,@,L 98-116 ,240,29,70,.414,26,59,.441,3,11,.273,37,44,.841,98,45,76,.592,39,64,.609,6,12,.500,20,24,.833,116,2012-03-07,HOU,TOR
55,Home,W 98-91 ,240,41,86,.477,37,75,.493,4,11,.364,12,15,.800,98,36,86,.419,31,72,.431,5,14,.357,14,19,.737,91,2012-03-10,PHO,MEM
56,@,L 98-107 ,240,35,80,.438,33,68,.485,2,12,.167,26,38,.684,98,44,87,.506,38,65,.585,6,22,.273,13,15,.867,107,2012-03-13,WAS,DAL
57,@,L 98-104 (OT),265,40,91,.440,32,68,.471,8,23,.348,10,11,.909,98,36,73,.493,25,45,.556,11,28,.393,21,37,.568,104,2012-03-13,MIA,ORL
58,Home,W 98-84 ,240,38,79,.481,31,62,.500,7,17,.412,15,17,.882,98,31,81,.383,30,71,.423,1,10,.100,21,25,.840,84,2012-03-14,NJN,TOR
59,Home,L 98-120 ,240,35,79,.443,25,57,.439,10,22,.455,18,20,.900,98,45,93,.484,35,71,.493,10,22,.455,20,22,.909,120,2012-03-16,GSW,MIL
60,Home,W 98-91 ,240,34,74,.459,27,54,.500,7,20,.350,23,31,.742,98,36,76,.474,33,61,.541,3,15,.200,16,17,.941,91,2012-03-17,DEN,BOS
61,@,W 98-77 ,240,38,81,.469,29,65,.446,9,16,.563,13,20,.650,98,32,80,.400,27,63,.429,5,17,.294,8,9,.889,77,2012-03-28,CHI,ATL
62,Home,W 98-89 ,240,38,73,.521,31,59,.525,7,14,.500,15,20,.750,98,35,94,.372,34,79,.430,1,15,.067,18,26,.692,89,2012-03-30,HOU,MEM
63,Home,W 98-97 ,240,39,75,.520,31,54,.574,8,21,.381,12,19,.632,98,39,78,.500,31,59,.525,8,19,.421,11,15,.733,97,2012-03-30,LAC,POR
64,Home,L 98-100 ,240,35,78,.449,24,46,.522,11,32,.344,17,28,.607,98,38,80,.475,31,58,.534,7,22,.318,17,21,.810,100,2012-03-30,ORL,DAL
65,Home,L 98-112 ,240,36,81,.444,29,63,.460,7,18,.389,19,20,.950,98,43,83,.518,39,73,.534,4,10,.400,22,29,.759,112,2012-04-02,WAS,MIL
66,Home,W 98-94 ,240,37,80,.463,28,63,.444,9,17,.529,15,24,.625,98,38,82,.463,31,64,.484,7,18,.389,11,16,.688,94,2012-04-03,MEM,GSW
67,Home,W 98-93 ,240,31,83,.373,21,59,.356,10,24,.417,26,29,.897,98,35,81,.432,30,64,.469,5,17,.294,18,20,.900,93,2012-04-04,MIA,OKC
68,@,L 98-107 ,240,39,95,.411,31,69,.449,8,26,.308,12,13,.923,98,48,84,.571,46,73,.630,2,11,.182,9,17,.529,107,2012-04-04,CLE,MIL
69,@,L 98-103 ,240,34,77,.442,28,58,.483,6,19,.316,24,31,.774,98,35,85,.412,29,66,.439,6,19,.316,27,34,.794,103,2012-04-06,OKC,IND
70,@,L 98-110 ,240,38,84,.452,33,72,.458,5,12,.417,17,22,.773,98,45,80,.563,38,62,.613,7,18,.389,13,19,.684,110,2012-04-06,WAS,NJN
71,@,L 98-104 ,240,39,86,.453,30,64,.469,9,22,.409,11,12,.917,98,38,79,.481,32,63,.508,6,16,.375,22,25,.880,104,2012-04-06,GSW,UTA
72,Home,W 98-75 ,240,36,83,.434,29,60,.483,7,23,.304,19,29,.655,98,28,75,.373,25,56,.446,3,19,.158,16,23,.696,75,2012-04-08,MIA,DET
73,@,L 98-103 ,240,36,75,.480,26,55,.473,10,20,.500,16,24,.667,98,36,71,.507,29,55,.527,7,16,.438,24,31,.774,103,2012-04-09,TOR,IND
74,Home,W 98-86 ,240,39,90,.433,30,70,.429,9,20,.450,11,16,.688,98,31,73,.425,24,52,.462,7,21,.333,17,21,.810,86,2012-04-10,CHI,NYK
75,Home,L 98-104 (OT),265,40,88,.455,37,67,.552,3,21,.143,15,19,.789,98,36,77,.468,28,57,.491,8,20,.400,24,32,.750,104,2012-04-11,CLE,IND
76,Home,L 98-100 ,240,31,76,.408,19,50,.380,12,26,.462,24,27,.889,98,38,81,.469,33,65,.508,5,16,.313,19,21,.905,100,2012-04-11,OKC,LAC
77,@,W 98-84 ,240,40,89,.449,29,66,.439,11,23,.478,7,12,.583,98,33,81,.407,20,57,.351,13,24,.542,5,9,.556,84,2012-04-11,LAL,SAS
78,@,L 98-103 ,240,40,83,.482,35,72,.486,5,11,.455,13,17,.765,98,34,70,.486,27,57,.474,7,13,.538,28,34,.824,103,2012-04-14,UTA,MEM
79,@,W 98-89 ,240,34,66,.515,31,58,.534,3,8,.375,27,33,.818,98,38,87,.437,34,73,.466,4,14,.286,9,12,.750,89,2012-04-14,CLE,WAS
80,Home,L 98-101 ,240,41,82,.500,36,66,.545,5,16,.313,11,16,.688,98,36,71,.507,30,53,.566,6,18,.333,23,27,.852,101,2012-04-16,NJN,MIA
81,@,L 98-102 ,240,36,78,.462,30,54,.556,6,24,.250,20,30,.667,98,38,70,.543,35,63,.556,3,7,.429,23,27,.852,102,2012-04-18,ORL,BOS
82,Home,L 98-104 ,240,36,73,.493,31,55,.564,5,18,.278,21,26,.808,98,38,78,.487,24,54,.444,14,24,.583,14,20,.700,104,2012-04-18,DEN,LAC
83,Home,W 98-90 ,240,36,79,.456,30,60,.500,6,19,.316,20,27,.741,98,35,83,.422,23,50,.460,12,33,.364,8,15,.533,90,2012-04-20,CLE,NYK
84,@,L 98-107 ,240,35,71,.493,32,59,.542,3,12,.250,25,34,.735,98,33,77,.429,26,49,.531,7,28,.250,34,43,.791,107,2012-04-22,NOH,LAC
85,@,L 98-114 ,240,37,88,.420,32,66,.485,5,22,.227,19,28,.679,98,42,77,.545,34,57,.596,8,20,.400,22,29,.759,114,2012-04-22,CLE,SAS
86,Home,W 98-67 ,240,37,88,.420,27,69,.391,10,19,.526,14,18,.778,98,25,83,.301,19,65,.292,6,18,.333,11,16,.688,67,2012-04-26,TOR,NJN
87,@,L 98-106 (2OT),290,37,102,.363,29,80,.363,8,22,.364,16,20,.800,98,39,99,.394,35,77,.455,4,22,.182,24,27,.889,106,2012-11-03,SAC,IND
88,Home,W 98-93 ,240,36,72,.500,32,62,.516,4,10,.400,22,29,.759,98,33,82,.402,26,67,.388,7,15,.467,20,28,.714,93,2012-11-14,BOS,UTA
89,@,W 98-93 ,240,36,77,.468,23,50,.460,13,27,.481,13,16,.813,98,37,88,.420,31,68,.456,6,20,.300,13,19,.684,93,2012-11-15,MIA,DEN
90,Home,L 98-106 ,240,34,79,.430,27,61,.443,7,18,.389,23,29,.793,98,43,85,.506,41,70,.586,2,15,.133,18,26,.692,106,2012-11-16,MIN,GSW
91,@,L 98-102 ,240,44,93,.473,42,77,.545,2,16,.125,8,11,.727,98,36,82,.439,33,71,.465,3,11,.273,27,30,.900,102,2012-11-19,MIL,CHA
92,@,L 98-106 ,240,37,82,.451,33,66,.500,4,16,.250,20,29,.690,98,40,85,.471,31,61,.508,9,24,.375,17,19,.895,106,2012-11-20,TOR,PHI
93,Home,W 98-97 ,240,36,86,.419,33,67,.493,3,19,.158,23,28,.821,98,37,80,.463,28,57,.491,9,23,.391,14,20,.700,97,2012-11-21,CHA,TOR
94,@,L 98-106 ,240,33,74,.446,21,47,.447,12,27,.444,20,24,.833,98,38,75,.507,32,64,.500,6,11,.545,24,30,.800,106,2012-11-23,LAL,MEM
95,Home,W 98-85 ,240,39,92,.424,34,75,.453,5,17,.294,15,21,.714,98,34,78,.436,27,61,.443,7,17,.412,10,13,.769,85,2012-11-25,BRK,POR
96,Home,L 98-105 ,240,37,79,.468,19,42,.452,18,37,.486,6,11,.545,98,36,71,.507,21,46,.457,15,25,.600,18,23,.783,105,2012-11-26,LAC,NOH
97,@,L 98-100 ,240,37,81,.457,32,62,.516,5,19,.263,19,22,.864,98,35,75,.467,29,61,.475,6,14,.429,24,32,.750,100,2012-11-27,DAL,PHI
98,@,L 98-120 ,240,36,87,.414,28,66,.424,8,21,.381,18,30,.600,98,47,87,.540,38,65,.585,9,22,.409,17,22,.773,120,2012-11-28,HOU,OKC
99,Home,L 98-104 ,240,39,83,.470,31,66,.470,8,17,.471,12,18,.667,98,44,86,.512,36,69,.522,8,17,.471,8,10,.800,104,2012-11-30,CHA,PHI
0,@,W 98-86 ,240,38,83,.458,27,63,.429,11,20,.550,11,13,.846,98,35,78,.449,34,67,.507,1,11,.091,15,19,.789,86,2012-11-30,BRK,ORL
1,@,L 98-108 (OT),265,38,82,.463,32,68,.471,6,14,.429,16,22,.727,98,40,85,.471,36,66,.545,4,19,.211,24,31,.774,108,2012-12-04,PHO,MEM
2,Home,L 98-100 ,240,39,83,.470,32,67,.478,7,16,.438,13,15,.867,98,39,92,.424,26,51,.510,13,41,.317,9,13,.692,100,2012-12-05,CHA,NYK
3,@,W 98-90 ,240,40,77,.519,35,62,.565,5,15,.333,13,18,.722,98,36,78,.462,31,58,.534,5,20,.250,13,18,.722,90,2012-12-09,ORL,PHO
4,Home,W 98-85 ,240,39,96,.406,33,79,.418,6,17,.353,14,24,.583,98,32,86,.372,29,67,.433,3,19,.158,18,21,.857,85,2012-12-12,MIL,SAC
5,Home,W 98-90 ,240,40,88,.455,33,61,.541,7,27,.259,11,12,.917,98,33,72,.458,27,53,.509,6,19,.316,18,25,.720,90,2012-12-13,POR,SAS
6,Home,L 98-107 ,240,36,78,.462,32,66,.485,4,12,.333,22,29,.759,98,43,79,.544,38,62,.613,5,17,.294,16,19,.842,107,2012-12-15,CHA,ORL
7,Home,L 98-111 ,240,41,83,.494,31,58,.534,10,25,.400,6,11,.545,98,39,80,.488,25,46,.543,14,34,.412,19,24,.792,111,2012-12-16,PHI,LAL
8,Home,W 98-93 ,240,37,86,.430,31,72,.431,6,14,.429,18,26,.692,98,32,80,.400,30,72,.417,2,8,.250,27,34,.794,93,2012-12-18,MIL,IND
9,@,W 98-95 ,240,35,82,.427,24,58,.414,11,24,.458,17,23,.739,98,39,79,.494,35,69,.507,4,10,.400,13,20,.650,95,2012-12-29,NOH,CHA
10,Home,W 98-91 ,240,36,82,.439,32,66,.485,4,16,.250,22,31,.710,98,37,85,.435,32,61,.525,5,24,.208,12,16,.750,91,2013-01-11,DEN,CLE
11,@,L 98-101 (OT),265,35,76,.461,25,51,.490,10,25,.400,18,22,.818,98,40,85,.471,37,73,.507,3,12,.250,18,21,.857,101,2013-01-11,SAS,MEM
12,@,L 98-113 ,240,35,85,.412,29,65,.446,6,20,.300,22,29,.759,98,46,77,.597,40,64,.625,6,13,.462,15,16,.938,113,2013-01-14,MIN,DAL
13,@,W 98-94 ,240,39,92,.424,33,76,.434,6,16,.375,14,20,.700,98,34,89,.382,30,75,.400,4,14,.286,22,29,.759,94,2013-01-17,MIL,PHO
14,@,W 98-93 ,240,41,86,.477,33,62,.532,8,24,.333,8,11,.727,98,35,85,.412,27,64,.422,8,21,.381,15,22,.682,93,2013-01-19,SAS,ATL
15,@,L 98-109 ,240,34,83,.410,28,62,.452,6,21,.286,24,30,.800,98,45,90,.500,39,74,.527,6,16,.375,13,17,.765,109,2013-01-19,CLE,UTA
16,@,W 98-95 ,240,39,84,.464,31,65,.477,8,19,.421,12,17,.706,98,37,81,.457,30,57,.526,7,24,.292,14,18,.778,95,2013-01-21,WAS,POR
17,Home,L 98-99 ,240,40,82,.488,35,65,.538,5,17,.294,13,18,.722,98,37,78,.474,31,67,.463,6,11,.545,19,22,.864,99,2013-01-26,TOR,CLE
18,@,L 98-100 (2OT),290,39,96,.406,34,73,.466,5,23,.217,15,20,.750,98,36,88,.409,31,68,.456,5,20,.250,23,27,.852,100,2013-01-27,MIA,BOS
19,Home,W 98-79 ,240,36,81,.444,29,67,.433,7,14,.500,19,21,.905,98,32,88,.364,29,70,.414,3,18,.167,12,27,.444,79,2013-01-30,IND,DET
20,@,L 98-113 ,240,38,72,.528,34,59,.576,4,13,.308,18,21,.857,98,44,84,.524,37,62,.597,7,22,.318,18,22,.818,113,2013-02-01,NOH,DEN
21,Home,W 98-73 ,240,38,81,.469,26,55,.473,12,26,.462,10,17,.588,98,25,72,.347,22,53,.415,3,19,.158,20,31,.645,73,2013-02-01,TOR,LAC
22,@,L 98-107 ,240,41,94,.436,36,75,.480,5,19,.263,11,22,.500,98,42,90,.467,33,66,.500,9,24,.375,14,20,.700,107,2013-02-02,ORL,MIL
23,@,W 98-97 ,240,39,83,.470,33,63,.524,6,20,.300,14,22,.636,98,41,92,.446,36,78,.462,5,14,.357,10,15,.667,97,2013-02-03,LAL,DET
24,Home,L 98-100 ,240,40,85,.471,37,72,.514,3,13,.231,15,19,.789,98,41,70,.586,34,52,.654,7,18,.389,11,16,.688,100,2013-02-04,MIN,POR
25,Home,W 98-91 (OT),265,38,72,.528,31,60,.517,7,12,.583,15,18,.833,98,35,87,.402,32,67,.478,3,20,.150,18,25,.720,91,2013-02-04,UTA,SAC
26,Home,W 98-90 ,240,37,84,.440,30,72,.417,7,12,.583,17,27,.630,98,37,79,.468,33,62,.532,4,17,.235,12,15,.800,90,2013-02-04,WAS,LAC
27,@,L 98-119 ,240,38,93,.409,28,73,.384,10,20,.500,12,16,.750,98,48,95,.505,40,72,.556,8,23,.348,15,20,.750,119,2013-02-06,GSW,OKC
28,Home,L 98-100 (OT),265,35,78,.449,26,56,.464,9,22,.409,19,28,.679,98,42,96,.438,40,87,.460,2,9,.222,14,19,.737,100,2013-02-08,IND,TOR
29,Home,L 98-102 ,240,33,80,.413,27,60,.450,6,20,.300,26,32,.813,98,41,82,.500,38,69,.551,3,13,.231,17,20,.850,102,2013-02-19,POR,PHO
30,@,L 98-108 ,240,40,84,.476,31,67,.463,9,17,.529,9,14,.643,98,42,87,.483,32,67,.478,10,20,.500,14,17,.824,108,2013-02-20,PHO,GSW
31,@,L 98-100 ,240,35,75,.467,25,47,.532,10,28,.357,18,23,.783,98,35,80,.438,28,62,.452,7,18,.389,23,28,.821,100,2013-02-22,NYK,TOR
32,Home,L 98-101 ,240,39,78,.500,30,57,.526,9,21,.429,11,15,.733,98,40,81,.494,35,64,.547,5,17,.294,16,19,.842,101,2013-02-26,CHI,CLE
33,@,W 98-84 ,240,41,76,.539,36,63,.571,5,13,.385,11,16,.688,98,32,81,.395,25,60,.417,7,21,.333,13,18,.722,84,2013-02-26,ORL,PHI
34,@,W 98-90 ,240,39,78,.500,30,57,.526,9,21,.429,11,14,.786,98,36,78,.462,29,55,.527,7,23,.304,11,14,.786,90,2013-03-01,DAL,BRK
35,Home,W 98-91 ,240,34,73,.466,24,54,.444,10,19,.526,20,27,.741,98,33,77,.429,29,64,.453,4,13,.308,21,27,.778,91,2013-03-01,MIA,MEM
36,Home,W 98-68 ,240,38,78,.487,33,62,.532,5,16,.313,17,23,.739,98,28,81,.346,23,63,.365,5,18,.278,7,12,.583,68,2013-03-01,UTA,CHA
37,@,L 98-99 ,240,41,82,.500,33,60,.550,8,22,.364,8,15,.533,98,38,78,.487,28,57,.491,10,21,.476,13,18,.722,99,2013-03-03,ATL,LAL
38,@,W 98-71 ,240,37,77,.481,26,53,.491,11,24,.458,13,15,.867,98,28,74,.378,21,51,.412,7,23,.304,8,15,.533,71,2013-03-06,TOR,PHO
39,Home,W 98-96 ,240,40,86,.465,29,66,.439,11,20,.550,7,9,.778,98,37,76,.487,26,51,.510,11,25,.440,11,12,.917,96,2013-03-10,NOH,POR
40,@,L 98-108 ,240,40,78,.513,35,62,.565,5,16,.313,13,15,.867,98,40,80,.500,35,64,.547,5,16,.313,23,31,.742,108,2013-03-12,NOH,BRK
41,Home,W 98-81 ,240,35,82,.427,29,62,.468,6,20,.300,22,30,.733,98,33,78,.423,28,56,.500,5,22,.227,10,14,.714,81,2013-03-12,MIA,ATL
42,@,W 98-94 ,240,35,75,.467,30,55,.545,5,20,.250,23,27,.852,98,40,85,.471,33,67,.493,7,18,.389,7,12,.583,94,2013-03-13,MIA,PHI
43,Home,W 98-91 ,240,39,79,.494,33,66,.500,6,13,.462,14,19,.737,98,34,88,.386,28,72,.389,6,16,.375,17,21,.810,91,2013-03-16,PHI,IND
44,Home,W 98-90 ,240,38,79,.481,30,61,.492,8,18,.444,14,17,.824,98,37,99,.374,29,80,.363,8,19,.421,8,11,.727,90,2013-03-20,ATL,MIL
45,@,W 98-95 ,240,32,72,.444,20,43,.465,12,29,.414,22,30,.733,98,37,81,.457,30,60,.500,7,21,.333,14,17,.824,95,2013-03-20,MIA,CLE
46,@,L 98-101 ,240,41,98,.418,40,79,.506,1,19,.053,15,18,.833,98,40,75,.533,34,57,.596,6,18,.333,15,18,.833,101,2013-03-21,MIN,SAC
47,Home,L 98-105 ,240,41,90,.456,36,66,.545,5,24,.208,11,13,.846,98,41,90,.456,30,62,.484,11,28,.393,12,21,.571,105,2013-03-27,GSW,SAC
48,@,L 98-100 ,240,38,80,.475,26,59,.441,12,21,.571,10,18,.556,98,40,79,.506,34,61,.557,6,18,.333,14,18,.778,100,2013-03-30,CHI,DAL
49,@,L 98-125 ,240,33,86,.384,25,63,.397,8,23,.348,24,29,.828,98,47,87,.540,38,67,.567,9,20,.450,22,27,.815,125,2013-03-30,POR,GSW
50,Home,W 98-81 ,240,35,80,.438,26,56,.464,9,24,.375,19,27,.704,98,31,78,.397,24,56,.429,7,22,.318,12,14,.857,81,2013-03-30,HOU,LAC
51,Home,L 98-103 ,240,39,86,.453,32,62,.516,7,24,.292,13,16,.813,98,38,82,.463,28,52,.538,10,30,.333,17,26,.654,103,2013-03-30,SAC,LAL
52,Home,L 98-108 ,240,41,81,.506,33,60,.550,8,21,.381,8,10,.800,98,43,77,.558,36,62,.581,7,15,.467,15,21,.714,108,2013-04-01,TOR,DET
53,Home,W 98-93 ,240,36,71,.507,29,51,.569,7,20,.350,19,22,.864,98,34,93,.366,30,69,.435,4,24,.167,21,30,.700,93,2013-04-03,BOS,DET
54,Home,W 98-88 ,240,36,78,.462,29,59,.492,7,19,.368,19,22,.864,98,33,83,.398,29,68,.426,4,15,.267,18,23,.783,88,2013-04-03,GSW,NOH
55,Home,L 98-107 ,240,42,96,.438,34,73,.466,8,23,.348,6,9,.667,98,44,84,.524,36,71,.507,8,13,.615,11,16,.688,107,2013-04-03,MIL,MIN
56,Home,W 98-84 ,240,40,90,.444,30,61,.492,10,29,.345,8,13,.615,98,35,90,.389,29,73,.397,6,17,.353,8,9,.889,84,2013-04-03,SAS,ORL
57,Home,L 98-116 ,240,38,91,.418,36,71,.507,2,20,.100,20,24,.833,98,39,76,.513,27,48,.563,12,28,.429,26,35,.743,116,2013-04-05,POR,HOU
58,Home,L 98-101 ,240,37,86,.430,27,69,.391,10,17,.588,14,20,.700,98,37,72,.514,30,54,.556,7,18,.389,20,24,.833,101,2013-04-09,CHI,TOR
59,@,L 98-101 ,240,38,86,.442,31,74,.419,7,12,.583,15,19,.789,98,37,86,.430,31,56,.554,6,30,.200,21,24,.875,101,2013-04-09,PHO,HOU
60,Home,L 98-103 ,240,36,80,.450,25,57,.439,11,23,.478,15,21,.714,98,33,75,.440,16,34,.471,17,41,.415,20,23,.870,103,2013-04-10,WAS,MIA
61,@,L 98-105 ,240,39,80,.488,31,57,.544,8,23,.348,12,18,.667,98,37,73,.507,29,53,.547,8,20,.400,23,30,.767,105,2013-04-17,CLE,CHA
62,@,L 98-118 ,240,40,104,.385,33,79,.418,7,25,.280,11,17,.647,98,49,93,.527,45,77,.584,4,16,.250,16,20,.800,118,2013-04-17,PHO,DEN
63,Home,W 98-92 ,240,39,91,.429,30,67,.448,9,24,.375,11,16,.688,98,37,90,.411,35,69,.507,2,21,.095,16,17,.941,92,2013-04-17,NYK,ATL
64,Home,W 98-94 ,240,35,84,.417,30,69,.435,5,15,.333,23,34,.676,98,33,82,.402,24,58,.414,9,24,.375,19,24,.792,94,2013-10-30,CLE,BRK
65,Home,L 98-101 ,240,36,79,.456,30,57,.526,6,22,.273,20,30,.667,98,33,81,.407,27,62,.435,6,19,.316,29,33,.879,101,2013-10-30,UTA,OKC
66,Home,L 98-105 ,240,34,76,.447,30,60,.500,4,16,.250,26,38,.684,98,35,84,.417,29,69,.420,6,15,.400,29,34,.853,105,2013-11-01,BOS,MIL
67,Home,L 98-113 ,240,36,99,.364,30,81,.370,6,18,.333,20,34,.588,98,44,103,.427,30,81,.370,14,22,.636,11,15,.733,113,2013-11-01,DEN,POR
68,Home,W 98-87 ,240,39,76,.513,28,49,.571,11,27,.407,9,12,.750,98,30,87,.345,24,61,.393,6,26,.231,21,24,.875,87,2013-11-02,GSW,SAC
69,Home,L 98-104 ,240,37,85,.435,27,67,.403,10,18,.556,14,19,.737,98,39,78,.500,27,53,.509,12,25,.480,14,22,.636,104,2013-11-05,NOP,PHO
70,Home,W 98-90 ,240,40,82,.488,35,66,.530,5,16,.313,13,17,.765,98,36,95,.379,33,76,.434,3,19,.158,15,21,.714,90,2013-11-06,ORL,LAC
71,Home,L 98-99 ,240,29,77,.377,22,50,.440,7,27,.259,33,52,.635,98,36,92,.391,20,57,.351,16,35,.457,11,15,.733,99,2013-11-07,HOU,LAL
72,Home,L 98-100 (OT),265,34,79,.430,24,51,.471,10,28,.357,20,25,.800,98,38,87,.437,36,75,.480,2,12,.167,22,29,.759,100,2013-11-15,PHO,BRK
73,@,L 98-135 ,240,35,83,.422,29,64,.453,6,19,.316,22,31,.710,98,52,86,.605,39,58,.672,13,28,.464,18,27,.667,135,2013-11-16,PHI,NOP
74,Home,L 98-108 ,240,31,85,.365,28,72,.389,3,13,.231,33,35,.943,98,41,76,.539,33,58,.569,8,18,.444,18,21,.857,108,2013-11-18,BRK,POR
75,@,W 98-87 ,240,32,79,.405,20,57,.351,12,22,.545,22,30,.733,98,32,81,.395,25,66,.379,7,15,.467,16,19,.842,87,2013-11-18,GSW,UTA
76,@,W 98-91 ,240,38,84,.452,30,65,.462,8,19,.421,14,14,1.000,98,32,77,.416,23,54,.426,9,23,.391,18,21,.857,91,2013-11-20,WAS,CLE
77,Home,L 98-102 ,240,34,90,.378,29,68,.426,5,22,.227,25,31,.806,98,40,81,.494,28,57,.491,12,24,.500,10,16,.625,102,2013-11-20,MIN,LAC
78,@,L 98-105 ,240,37,83,.446,29,59,.492,8,24,.333,16,20,.800,98,40,79,.506,35,64,.547,5,15,.333,20,33,.606,105,2013-11-20,UTA,NOP
79,Home,L 98-108 ,240,34,76,.447,27,56,.482,7,20,.350,23,31,.742,98,36,86,.419,22,57,.386,14,29,.483,22,28,.786,108,2013-11-20,PHI,TOR
80,@,W 98-91 ,240,33,70,.471,23,47,.489,10,23,.435,22,38,.579,98,32,77,.416,29,63,.460,3,14,.214,24,33,.727,91,2013-11-22,PHO,CHA
81,Home,W 98-95 ,240,36,88,.409,24,62,.387,12,26,.462,14,15,.933,98,32,83,.386,27,69,.391,5,14,.357,26,29,.897,95,2013-11-22,POR,CHI
82,@,L 98-106 ,240,35,102,.343,31,77,.403,4,25,.160,24,32,.750,98,35,76,.461,30,58,.517,5,18,.278,31,38,.816,106,2013-11-23,PHI,IND
83,Home,W 98-89 ,240,37,76,.487,30,57,.526,7,19,.368,17,22,.773,98,36,82,.439,25,53,.472,11,29,.379,6,15,.400,89,2013-11-23,WAS,NYK
84,Home,W 98-84 ,240,40,80,.500,32,65,.492,8,15,.533,10,17,.588,98,29,88,.330,26,69,.377,3,19,.158,23,28,.821,84,2013-11-25,IND,MIN
85,Home,L 98-104 (OT),265,42,91,.462,36,68,.529,6,23,.261,8,10,.800,98,37,83,.446,31,63,.492,6,20,.300,24,37,.649,104,2013-11-29,SAC,LAC
86,@,L 98-99 ,240,35,76,.461,31,61,.508,4,15,.267,24,28,.857,98,36,69,.522,28,51,.549,8,18,.444,19,25,.760,99,2013-12-01,CHA,MIA
87,Home,L 98-112 ,240,35,87,.402,27,65,.415,8,22,.364,20,26,.769,98,44,87,.506,34,64,.531,10,23,.435,14,19,.737,112,2013-12-01,TOR,DEN
88,Home,W 98-80 ,240,33,73,.452,24,60,.400,9,13,.692,23,29,.793,98,30,77,.390,27,62,.435,3,15,.200,17,19,.895,80,2013-12-02,WAS,ORL
89,Home,W 98-88 ,240,37,91,.407,32,77,.416,5,14,.357,19,24,.792,98,36,92,.391,30,69,.435,6,23,.261,10,13,.769,88,2013-12-04,CLE,DEN
90,Home,L 98-105 ,240,36,91,.396,27,64,.422,9,27,.333,17,22,.773,98,33,86,.384,26,65,.400,7,21,.333,32,42,.762,105,2013-12-04,MIL,DET
91,@,L 98-106 ,240,34,77,.442,28,60,.467,6,17,.353,24,29,.828,98,43,83,.518,37,63,.587,6,20,.300,14,18,.778,106,2013-12-06,DEN,BOS
92,@,L 98-130 ,240,39,93,.419,35,82,.427,4,11,.364,16,19,.842,98,46,83,.554,29,60,.483,17,23,.739,21,24,.875,130,2013-12-06,UTA,POR
93,Home,W 98-88 ,240,32,76,.421,22,43,.512,10,33,.303,24,42,.571,98,32,93,.344,24,64,.375,8,29,.276,16,28,.571,88,2013-12-08,HOU,ORL
94,@,L 98-104 ,240,40,80,.500,34,65,.523,6,15,.400,12,17,.706,98,39,76,.513,30,54,.556,9,22,.409,17,20,.850,104,2013-12-13,MEM,NOP
95,@,L 98-101 ,240,37,82,.451,30,58,.517,7,24,.292,17,26,.654,98,39,87,.448,34,68,.500,5,19,.263,18,20,.900,101,2013-12-15,ORL,OKC
96,Home,L 98-104 ,240,28,76,.368,21,53,.396,7,23,.304,35,36,.972,98,36,91,.396,28,71,.394,8,20,.400,24,29,.828,104,2013-12-22,OKC,TOR
97,Home,L 98-103 ,240,37,89,.416,29,64,.453,8,25,.320,16,22,.727,98,39,86,.453,29,65,.446,10,21,.476,15,19,.789,103,2013-12-23,ORL,NYK
98,Home,L 98-111 ,240,37,91,.407,32,71,.451,5,20,.250,19,23,.826,98,45,86,.523,33,62,.532,12,24,.500,9,18,.500,111,2013-12-25,SAS,HOU
99,@,L 98-120 ,240,38,83,.458,30,62,.484,8,21,.381,14,17,.824,98,42,85,.494,37,70,.529,5,15,.333,31,38,.816,120,2013-12-27,WAS,MIN
0,@,L 98-107 ,240,41,93,.441,31,71,.437,10,22,.455,6,8,.750,98,38,77,.494,32,51,.627,6,26,.231,25,32,.781,107,2013-12-28,NOP,HOU
1,Home,W 98-90 ,240,35,77,.455,32,63,.508,3,14,.214,25,32,.781,98,32,76,.421,25,57,.439,7,19,.368,19,21,.905,90,2013-12-28,LAC,UTA
2,Home,L 98-100 ,240,36,79,.456,30,56,.536,6,23,.261,20,23,.870,98,41,86,.477,35,62,.565,6,24,.250,12,14,.857,100,2013-12-30,MIN,DAL
3,@,W 98-94 ,240,36,91,.396,28,58,.483,8,33,.242,18,21,.857,98,36,82,.439,33,68,.485,3,14,.214,19,26,.731,94,2013-12-31,POR,OKC
4,@,L 98-129 ,240,35,91,.385,31,73,.425,4,18,.222,24,32,.750,98,43,83,.518,29,52,.558,14,31,.452,29,38,.763,129,2014-01-07,BOS,DEN
5,@,L 98-102 ,240,36,78,.462,27,52,.519,9,26,.346,17,23,.739,98,34,77,.442,29,58,.500,5,19,.263,29,35,.829,102,2014-01-08,GSW,BRK
6,Home,W 98-96 (OT),265,35,81,.432,28,61,.459,7,20,.350,21,27,.778,98,33,93,.355,26,63,.413,7,30,.233,23,28,.821,96,2014-01-13,NYK,PHO
7,@,L 98-108 ,240,39,81,.481,33,64,.516,6,17,.353,14,18,.778,98,38,75,.507,32,61,.525,6,14,.429,26,33,.788,108,2014-01-14,NYK,CHA
8,Home,W 98-72 ,240,36,83,.434,30,66,.455,6,17,.353,20,34,.588,98,21,73,.288,14,48,.292,7,25,.280,23,29,.793,72,2014-01-18,MIN,UTA
9,Home,L 98-104 ,240,37,76,.487,29,55,.527,8,21,.381,16,29,.552,98,40,81,.494,34,60,.567,6,21,.286,18,31,.581,104,2014-01-18,WAS,DET
10,@,W 98-87 ,240,37,70,.529,27,49,.551,10,21,.476,14,18,.778,98,33,88,.375,25,69,.362,8,19,.421,13,18,.722,87,2014-01-22,CHI,CLE
11,@,L 98-119 ,240,34,86,.395,22,56,.393,12,30,.400,18,30,.600,98,43,90,.478,35,59,.593,8,31,.258,25,40,.625,119,2014-01-22,SAC,HOU
12,@,W 98-81 ,240,43,83,.518,37,70,.529,6,13,.462,6,10,.600,98,30,87,.345,26,63,.413,4,24,.167,17,22,.773,81,2014-01-28,MEM,POR
13,Home,L 98-101 ,240,39,100,.390,30,72,.417,9,28,.321,11,13,.846,98,33,78,.423,28,64,.438,5,14,.357,30,42,.714,101,2014-01-29,DEN,CHA
14,Home,W 98-83 ,240,37,87,.425,23,56,.411,14,31,.452,10,13,.769,98,28,84,.333,22,65,.338,6,19,.316,21,26,.808,83,2014-01-29,TOR,ORL
15,Home,W 98-79 ,240,38,90,.422,30,65,.462,8,25,.320,14,17,.824,98,33,83,.398,26,67,.388,7,16,.438,6,10,.600,79,2014-02-03,IND,ORL
16,@,L 98-101 ,240,34,78,.436,19,44,.432,15,34,.441,15,24,.625,98,36,81,.444,25,63,.397,11,18,.611,18,21,.857,101,2014-02-03,NYK,MIL
17,@,L 98-112 ,240,39,85,.459,33,65,.508,6,20,.300,14,23,.609,98,44,89,.494,38,71,.535,6,18,.333,18,20,.900,112,2014-02-05,DET,ORL
18,Home,W 98-91 ,240,39,81,.481,31,66,.470,8,15,.533,12,16,.750,98,28,75,.373,24,57,.421,4,18,.222,31,37,.838,91,2014-02-07,NOP,MIN
19,Home,L 98-112 ,240,37,87,.425,22,55,.400,15,32,.469,9,17,.529,98,45,89,.506,37,71,.521,8,18,.444,14,20,.700,112,2014-02-07,PHI,LAL
20,@,W 98-95 ,240,40,83,.482,33,69,.478,7,14,.500,11,12,.917,98,32,85,.376,25,62,.403,7,23,.304,24,27,.889,95,2014-02-11,OKC,POR
21,Home,L 98-102 ,240,39,80,.488,33,64,.516,6,16,.375,14,19,.737,98,41,79,.519,35,66,.530,6,13,.462,14,17,.824,102,2014-02-12,MIL,NOP
22,@,L 98-108 ,240,37,77,.481,25,51,.490,12,26,.462,12,19,.632,98,39,79,.494,30,56,.536,9,23,.391,21,26,.808,108,2014-02-18,ATL,IND
23,Home,W 98-93 ,240,37,75,.493,31,63,.492,6,12,.500,18,24,.750,98,35,85,.412,29,58,.500,6,27,.222,17,20,.850,93,2014-02-18,MEM,NYK
24,@,L 98-116 ,240,38,90,.422,30,72,.417,8,18,.444,14,20,.700,98,42,82,.512,34,62,.548,8,20,.400,24,31,.774,116,2014-02-19,DET,CHA
25,@,W 98-91 ,240,37,83,.446,27,62,.435,10,21,.476,14,20,.700,98,35,75,.467,28,54,.519,7,21,.333,14,21,.667,91,2014-02-19,NYK,NOP
26,Home,W 98-91 ,240,40,93,.430,33,72,.458,7,21,.333,11,13,.846,98,32,82,.390,26,62,.419,6,20,.300,21,29,.724,91,2014-02-21,TOR,CLE
27,@,L 98-107 ,240,39,89,.438,29,61,.475,10,28,.357,10,16,.625,98,32,74,.432,16,43,.372,16,31,.516,27,33,.818,107,2014-02-22,NYK,ATL
28,@,L 98-105 ,240,34,87,.391,28,66,.424,6,21,.286,24,36,.667,98,38,73,.521,33,64,.516,5,9,.556,24,28,.857,105,2014-02-22,BOS,SAC
29,@,L 98-110 ,240,37,84,.440,33,69,.478,4,15,.267,20,21,.952,98,44,80,.550,38,63,.603,6,17,.353,16,21,.762,110,2014-02-24,BOS,UTA
30,@,L 98-118 ,240,39,90,.433,31,67,.463,8,23,.348,12,20,.600,98,47,101,.465,42,85,.494,5,16,.313,19,25,.760,118,2014-02-25,LAL,IND
31,@,L 98-112 ,240,36,83,.434,32,65,.492,4,18,.222,22,29,.759,98,43,74,.581,37,58,.638,6,16,.375,20,24,.833,112,2014-03-01,ORL,MIA
32,Home,L 98-107 ,240,34,74,.459,29,62,.468,5,12,.417,25,31,.806,98,37,83,.446,27,58,.466,10,25,.400,23,31,.742,107,2014-03-01,MIL,BRK
33,@,L 98-104 ,240,37,88,.420,29,65,.446,8,23,.348,16,20,.800,98,38,79,.481,30,57,.526,8,22,.364,20,23,.870,104,2014-03-02,GSW,TOR
34,@,W 98-96 ,240,37,84,.440,27,64,.422,10,20,.500,14,21,.667,98,36,86,.419,33,70,.471,3,16,.188,21,22,.955,96,2014-03-04,GSW,IND
35,@,L 98-103 ,240,38,83,.458,31,57,.544,7,26,.269,15,21,.714,98,37,79,.468,33,66,.500,4,13,.308,25,34,.735,103,2014-03-07,POR,DAL
36,@,L 98-105 ,240,36,83,.434,31,59,.525,5,24,.208,21,31,.677,98,37,81,.457,29,61,.475,8,20,.400,23,28,.821,105,2014-03-10,DEN,CHA
37,@,L 98-105 ,240,42,88,.477,33,65,.508,9,23,.391,5,8,.625,98,38,84,.452,30,57,.526,8,27,.296,21,25,.840,105,2014-03-10,ORL,MIL
38,@,L 98-106 ,240,33,79,.418,24,54,.444,9,25,.360,23,34,.676,98,34,80,.425,23,51,.451,11,29,.379,27,34,.794,106,2014-03-11,HOU,OKC
39,@,L 98-111 ,240,36,82,.439,28,61,.459,8,21,.381,18,25,.720,98,43,88,.489,35,70,.500,8,18,.444,17,24,.708,111,2014-03-12,GSW,LAC
40,Home,L 98-115 ,240,33,84,.393,25,61,.410,8,23,.348,24,28,.857,98,34,74,.459,27,56,.482,7,18,.389,40,50,.800,115,2014-03-12,PHI,SAC
41,@,W 98-85 ,240,38,78,.487,33,60,.550,5,18,.278,17,22,.773,98,35,82,.427,26,57,.456,9,25,.360,6,9,.667,85,2014-03-12,CHA,WAS
42,@,L 98-114 ,240,35,83,.422,26,56,.464,9,27,.333,19,23,.826,98,44,78,.564,35,61,.574,9,17,.529,17,24,.708,114,2014-03-21,BOS,BRK
43,Home,W 98-92 ,240,33,73,.452,25,48,.521,8,25,.320,24,35,.686,98,39,90,.433,35,74,.473,4,16,.250,10,26,.385,92,2014-03-21,PHO,DET
44,@,L 98-106 ,240,41,85,.482,36,72,.500,5,13,.385,11,16,.688,98,38,78,.487,30,60,.500,8,18,.444,22,27,.815,106,2014-03-24,MIL,LAC
45,Home,W 98-96 ,240,38,90,.422,35,78,.449,3,12,.250,19,25,.760,98,33,80,.413,20,50,.400,13,30,.433,17,28,.607,96,2014-03-26,NOP,LAC
46,@,L 98-120 ,240,35,90,.389,21,54,.389,14,36,.389,14,22,.636,98,44,90,.489,35,64,.547,9,26,.346,23,34,.676,120,2014-03-27,PHI,HOU
47,@,L 98-123 ,240,33,85,.388,27,64,.422,6,21,.286,26,32,.813,98,48,92,.522,36,71,.507,12,21,.571,15,19,.789,123,2014-03-29,DET,PHI
48,@,W 98-93 ,240,33,73,.452,27,54,.500,6,19,.316,26,27,.963,98,38,69,.551,31,50,.620,7,19,.368,10,14,.714,93,2014-03-30,TOR,ORL
49,@,L 98-105 ,240,41,89,.461,36,72,.500,5,17,.294,11,18,.611,98,39,75,.520,34,60,.567,5,15,.333,22,25,.880,105,2014-03-30,MEM,POR
50,Home,L 98-119 ,240,35,79,.443,24,51,.471,11,28,.393,17,20,.850,98,45,78,.577,36,60,.600,9,18,.500,20,24,.833,119,2014-04-02,ORL,CLE
51,@,L 98-117 ,240,36,91,.396,31,70,.443,5,21,.238,21,25,.840,98,48,82,.585,35,53,.660,13,29,.448,8,10,.800,117,2014-04-04,CLE,ATL
52,Home,L 98-102 ,240,38,79,.481,37,70,.529,1,9,.111,21,27,.778,98,36,81,.444,24,54,.444,12,27,.444,18,22,.818,102,2014-04-05,MIL,TOR
53,@,L 98-106 ,240,40,86,.465,35,69,.507,5,17,.294,13,23,.565,98,40,81,.494,35,62,.565,5,19,.263,21,23,.913,106,2014-04-11,DET,CHI
54,Home,W 98-86 ,240,35,75,.467,29,59,.492,6,16,.375,22,28,.786,98,31,65,.477,23,51,.451,8,14,.571,16,19,.842,86,2014-04-11,MIA,IND
55,Home,W 98-85 ,240,36,78,.462,26,56,.464,10,22,.455,16,19,.842,98,35,73,.479,29,48,.604,6,25,.240,9,19,.474,85,2014-04-12,ATL,MIA
56,@,L 98-101 ,240,36,78,.462,28,61,.459,8,17,.471,18,23,.783,98,39,79,.494,28,55,.509,11,24,.458,12,15,.800,101,2014-04-12,PHO,DAL
57,@,L 98-104 ,240,39,89,.438,35,72,.486,4,17,.235,16,18,.889,98,38,85,.447,34,63,.540,4,22,.182,24,29,.828,104,2014-04-14,SAS,HOU
58,Home,L 98-109 ,240,33,75,.440,23,50,.460,10,25,.400,22,31,.710,98,32,67,.478,21,46,.457,11,21,.524,34,40,.850,109,2014-04-15,BRK,NYK
59,Home,L 98-105 ,240,37,72,.514,31,57,.544,6,15,.400,18,24,.750,98,39,80,.488,32,67,.478,7,13,.538,20,26,.769,105,2014-10-30,ORL,WAS
60,@,W 98-92 ,240,34,68,.500,31,58,.534,3,10,.300,27,33,.818,98,33,88,.375,24,57,.421,9,31,.290,17,21,.810,92,2014-11-02,SAC,LAC
61,Home,W 98-90 ,240,35,75,.467,28,60,.467,7,15,.467,21,27,.778,98,38,88,.432,32,74,.432,6,14,.429,8,14,.571,90,2014-11-04,CHI,ORL
62,@,W 98-83 ,240,39,80,.488,31,62,.500,8,18,.444,12,19,.632,98,30,81,.370,22,66,.333,8,15,.533,15,19,.789,83,2014-11-04,WAS,NYK
63,@,W 98-91 ,240,37,90,.411,30,73,.411,7,17,.412,17,22,.773,98,36,82,.439,28,61,.459,8,21,.381,11,17,.647,91,2014-11-05,MIN,BRK
64,Home,W 98-95 ,240,32,87,.368,21,64,.328,11,23,.478,23,33,.697,98,39,90,.433,30,70,.429,9,20,.450,8,10,.800,95,2014-11-05,DET,NYK
65,Home,W 98-81 ,240,34,72,.472,24,45,.533,10,27,.370,20,33,.606,98,31,90,.344,29,70,.414,2,20,.100,17,19,.895,81,2014-11-06,HOU,SAS
66,@,L 98-101 ,240,40,88,.455,35,69,.507,5,19,.263,13,13,1.000,98,39,85,.459,30,58,.517,9,27,.333,14,16,.875,101,2014-11-07,IND,BOS
67,Home,W 98-95 ,240,37,75,.493,26,52,.500,11,23,.478,13,24,.542,98,36,77,.468,31,57,.544,5,20,.250,18,23,.783,95,2014-11-07,DET,MIL
68,@,W 98-87 ,240,39,87,.448,30,59,.508,9,28,.321,11,17,.647,98,30,86,.349,20,44,.455,10,42,.238,17,21,.810,87,2014-11-08,GSW,HOU
69,@,L 98-106 ,240,32,72,.444,23,53,.434,9,19,.474,25,32,.781,98,38,80,.475,28,53,.528,10,27,.370,20,24,.833,106,2014-11-11,SAC,DAL
70,Home,W 98-93 ,240,42,84,.500,39,74,.527,3,10,.300,11,16,.688,98,37,78,.474,30,61,.492,7,17,.412,12,18,.667,93,2014-11-15,WAS,ORL
71,Home,W 98-81 ,240,35,81,.432,25,57,.439,10,24,.417,18,26,.692,98,30,84,.357,22,61,.361,8,23,.348,13,19,.684,81,2014-11-18,UTA,OKC
72,@,W 98-92 ,240,37,91,.407,32,71,.451,5,20,.250,19,23,.826,98,30,74,.405,15,36,.417,15,38,.395,17,23,.739,92,2014-11-19,LAL,HOU
73,Home,W 98-86 ,240,39,90,.433,29,68,.426,10,22,.455,10,13,.769,98,36,78,.462,29,58,.500,7,20,.350,7,17,.412,86,2014-11-25,MIL,DET
74,Home,L 98-104 ,240,35,78,.449,25,51,.490,10,27,.370,18,24,.750,98,37,78,.474,25,50,.500,12,28,.429,18,19,.947,104,2014-11-26,DET,LAC
75,Home,W 98-83 ,240,41,94,.436,37,78,.474,4,16,.250,12,14,.857,98,31,70,.443,24,52,.462,7,18,.389,14,16,.875,83,2014-11-28,IND,ORL
76,Home,W 98-97 ,240,38,82,.463,30,55,.545,8,27,.296,14,18,.778,98,39,87,.448,33,70,.471,6,17,.353,13,14,.929,97,2014-12-02,GSW,ORL
77,@,W 98-93 ,240,39,89,.438,33,72,.458,6,17,.353,14,20,.700,98,35,81,.432,24,53,.453,11,28,.393,12,14,.857,93,2014-12-02,BRK,NYK
78,@,W 98-75 ,240,35,81,.432,22,47,.468,13,34,.382,15,24,.625,98,30,80,.375,27,62,.435,3,18,.167,12,19,.632,75,2014-12-05,ATL,BRK
79,@,W 98-93 ,240,37,74,.500,30,57,.526,7,17,.412,17,20,.850,98,36,79,.456,28,63,.444,8,16,.500,13,21,.619,93,2014-12-05,ORL,UTA
80,@,W 98-86 ,240,41,84,.488,32,63,.508,9,21,.429,7,8,.875,98,34,97,.351,29,75,.387,5,22,.227,13,16,.813,86,2014-12-09,POR,DET
81,Home,W 98-95 ,240,38,96,.396,33,71,.465,5,25,.200,17,25,.680,98,32,70,.457,25,55,.455,7,15,.467,24,37,.649,95,2014-12-09,LAL,SAC
82,Home,L 98-105 ,240,36,89,.404,31,64,.484,5,25,.200,21,30,.700,98,37,83,.446,27,51,.529,10,32,.313,21,27,.778,105,2014-12-13,DAL,GSW
83,@,L 98-105 ,240,39,95,.411,30,64,.469,9,31,.290,11,12,.917,98,42,92,.457,37,78,.474,5,14,.357,16,19,.842,105,2014-12-16,GSW,MEM
84,Home,L 98-127 ,240,37,82,.451,29,52,.558,8,30,.267,16,21,.762,98,49,76,.645,33,48,.688,16,28,.571,13,16,.813,127,2014-12-17,CLE,ATL
85,@,L 98-114 ,240,42,93,.452,36,81,.444,6,12,.500,8,16,.500,98,48,85,.565,40,62,.645,8,23,.348,10,14,.714,114,2014-12-19,MIN,BOS
86,@,L 98-102 ,240,36,99,.364,25,70,.357,11,29,.379,15,20,.750,98,42,83,.506,37,65,.569,5,18,.278,13,24,.542,102,2014-12-26,LAL,DAL
87,Home,W 98-75 ,240,36,88,.409,28,61,.459,8,27,.296,18,21,.857,98,25,87,.287,20,63,.317,5,24,.208,20,26,.769,75,2014-12-26,OKC,CHO
88,@,W 98-89 ,240,33,80,.413,25,50,.500,8,30,.267,24,26,.923,98,36,73,.493,27,52,.519,9,21,.429,8,12,.667,89,2014-12-26,CLE,ORL
89,Home,L 98-110 ,240,37,81,.457,25,56,.446,12,25,.480,12,15,.800,98,41,86,.477,28,52,.538,13,34,.382,15,19,.789,110,2014-12-27,LAC,TOR
90,Home,L 98-100 ,240,37,88,.420,26,66,.394,11,22,.500,13,20,.650,98,41,72,.569,34,52,.654,7,20,.350,11,18,.611,100,2015-01-02,ORL,BRK
91,@,W 98-92 ,240,33,81,.407,27,58,.466,6,23,.261,26,30,.867,98,32,86,.372,22,55,.400,10,31,.323,18,24,.750,92,2015-01-02,ATL,UTA
92,@,W 98-90 ,240,35,78,.449,31,62,.500,4,16,.250,24,32,.750,98,33,87,.379,29,68,.426,4,19,.211,20,21,.952,90,2015-01-03,CHO,ORL
93,Home,L 98-107 ,240,33,74,.446,26,49,.531,7,25,.280,25,33,.758,98,36,81,.444,23,54,.426,13,27,.481,22,33,.667,107,2015-01-05,LAC,ATL
94,Home,W 98-94 ,240,33,83,.398,22,57,.386,11,26,.423,21,24,.875,98,37,88,.420,33,74,.446,4,14,.286,16,20,.800,94,2015-01-05,POR,LAL
95,Home,W 98-94 ,240,37,86,.430,33,72,.458,4,14,.286,20,26,.769,98,36,80,.450,30,62,.484,6,18,.333,16,24,.667,94,2015-01-07,CHO,NOP
96,Home,W 98-84 ,240,39,75,.520,27,56,.482,12,19,.632,8,10,.800,98,32,79,.405,26,57,.456,6,22,.273,14,17,.824,84,2015-01-09,MIL,MIN
97,Home,W 98-93 ,240,34,80,.425,23,47,.489,11,33,.333,19,26,.731,98,37,88,.420,28,57,.491,9,31,.290,10,10,1.000,93,2015-01-10,DET,BRK
98,@,W 98-93 ,240,37,85,.435,29,64,.453,8,21,.381,16,20,.800,98,33,86,.384,29,73,.397,4,13,.308,23,35,.657,93,2015-01-14,SAS,CHO
99,@,W 98-96 ,240,32,85,.376,19,54,.352,13,31,.419,21,24,.875,98,40,89,.449,34,71,.479,6,18,.333,10,12,.833,96,2015-01-16,DET,IND
0,@,L 98-102 ,240,36,93,.387,23,57,.404,13,36,.361,13,15,.867,98,39,77,.506,31,62,.500,8,15,.533,16,24,.667,102,2015-01-17,POR,MEM
1,@,L 98-110 ,240,39,85,.459,33,58,.569,6,27,.222,14,18,.778,98,37,72,.514,25,41,.610,12,31,.387,24,33,.727,110,2015-01-19,IND,HOU
2,Home,W 98-94 ,240,35,88,.398,24,52,.462,11,36,.306,17,26,.654,98,34,76,.447,30,64,.469,4,12,.333,22,30,.733,94,2015-01-19,POR,SAC
3,@,W 98-75 ,240,39,76,.513,28,49,.571,11,27,.407,9,14,.643,98,31,89,.348,29,74,.392,2,15,.133,11,15,.733,75,2015-01-21,DAL,MIN
4,@,W 98-91 ,240,37,91,.407,30,71,.423,7,20,.350,17,20,.850,98,29,79,.367,21,56,.375,8,23,.348,25,32,.781,91,2015-01-21,NYK,PHI
5,Home,L 98-102 ,240,37,82,.451,31,64,.484,6,18,.333,18,18,1.000,98,38,78,.487,29,62,.468,9,16,.563,17,20,.850,102,2015-01-23,DAL,CHI
6,@,L 98-108 ,240,37,94,.394,27,64,.422,10,30,.333,14,18,.778,98,36,82,.439,20,46,.435,16,36,.444,20,29,.690,108,2015-01-25,OKC,CLE
7,@,L 98-102 ,240,40,83,.482,32,62,.516,8,21,.381,10,15,.667,98,38,80,.475,31,61,.508,7,19,.368,19,22,.864,102,2015-01-26,DEN,LAC
8,@,W 98-92 ,240,38,78,.487,34,62,.548,4,16,.250,18,27,.667,98,37,87,.425,32,67,.478,5,20,.250,13,16,.813,92,2015-01-27,WAS,LAL
9,@,L 98-110 ,240,42,91,.462,35,68,.515,7,23,.304,7,9,.778,98,38,77,.494,32,61,.525,6,16,.375,28,32,.875,110,2015-01-28,BOS,MIN
10,@,L 98-106 ,240,37,88,.420,29,70,.414,8,18,.444,16,23,.696,98,40,88,.455,29,59,.492,11,29,.379,15,18,.833,106,2015-01-28,WAS,PHO
11,@,L 98-105 ,240,33,85,.388,21,54,.389,12,31,.387,20,28,.714,98,31,70,.443,20,43,.465,11,27,.407,32,42,.762,105,2015-02-03,DEN,PHI
12,Home,W 98-88 ,240,37,82,.451,33,58,.569,4,24,.167,20,26,.769,98,33,85,.388,28,63,.444,5,22,.227,17,22,.773,88,2015-02-06,DET,DEN
13,Home,W 98-85 ,240,40,83,.482,29,54,.537,11,29,.379,7,9,.778,98,36,80,.450,31,64,.484,5,16,.313,8,9,.889,85,2015-02-06,SAS,MIA
14,Home,L 98-109 ,240,31,82,.378,18,47,.383,13,35,.371,23,34,.676,98,40,76,.526,31,47,.660,9,29,.310,20,23,.870,109,2015-02-08,HOU,POR
15,@,W 98-97 ,240,37,77,.481,29,55,.527,8,22,.364,16,18,.889,98,39,83,.470,30,58,.517,9,25,.360,10,13,.769,97,2015-02-08,CHI,ORL
16,Home,L 98-115 ,240,33,81,.407,23,47,.489,10,34,.294,22,30,.733,98,41,92,.446,32,65,.492,9,27,.333,24,29,.828,115,2015-02-09,DAL,LAC
17,@,L 98-113 ,240,37,85,.435,29,54,.537,8,31,.258,16,22,.727,98,42,92,.457,33,69,.478,9,23,.391,20,26,.769,113,2015-02-12,CLE,CHI
18,Home,W 98-76 ,240,35,84,.417,29,55,.527,6,29,.207,22,31,.710,98,25,77,.325,21,59,.356,4,18,.222,22,28,.786,76,2015-02-21,HOU,TOR
19,@,L 98-104 ,240,34,89,.382,25,63,.397,9,26,.346,21,22,.955,98,39,81,.481,31,62,.500,8,19,.421,18,23,.783,104,2015-02-22,GSW,IND
20,@,L 98-103 ,240,36,78,.462,23,44,.523,13,34,.382,13,17,.765,98,39,82,.476,33,59,.559,6,23,.261,19,26,.731,103,2015-02-22,PHI,ORL
21,@,W 98-92 ,240,42,89,.472,39,80,.488,3,9,.333,11,13,.846,98,33,82,.402,20,49,.408,13,33,.394,13,16,.813,92,2015-02-22,MEM,POR
22,@,W 98-86 ,240,39,84,.464,35,70,.500,4,14,.286,16,21,.762,98,34,77,.442,31,60,.517,3,17,.176,15,23,.652,86,2015-02-25,CHO,CHI
23,@,L 98-106 ,240,37,82,.451,27,61,.443,10,21,.476,14,17,.824,98,40,96,.417,26,61,.426,14,35,.400,12,15,.800,106,2015-02-27,CHO,BOS
24,@,L 98-102 ,240,38,85,.447,34,68,.500,4,17,.235,18,20,.900,98,39,84,.464,30,52,.577,9,32,.281,15,17,.882,102,2015-02-27,BRK,HOU
25,@,L 98-103 ,240,34,81,.420,26,52,.500,8,29,.276,22,28,.786,98,33,75,.440,26,56,.464,7,19,.368,30,38,.789,103,2015-02-28,TOR,NYK
26,@,W 98-83 ,240,40,80,.500,32,62,.516,8,18,.444,10,14,.714,98,31,85,.365,25,70,.357,6,15,.400,15,20,.750,83,2015-03-01,CHO,ORL
27,@,L 98-115 ,240,33,78,.423,26,47,.553,7,31,.226,25,38,.658,98,43,82,.524,36,68,.529,7,14,.500,22,30,.733,115,2015-03-02,PHO,MIA
28,@,W 98-93 (OT),265,34,87,.391,26,55,.473,8,32,.250,22,29,.759,98,37,96,.385,26,65,.400,11,31,.355,8,18,.444,93,2015-03-04,POR,LAC
29,Home,W 98-84 ,240,34,80,.425,28,60,.467,6,20,.300,24,33,.727,98,31,86,.360,26,63,.413,5,23,.217,17,19,.895,84,2015-03-06,IND,CHI
30,Home,L 98-104 ,240,38,80,.475,30,59,.508,8,21,.381,14,15,.933,98,36,79,.456,26,56,.464,10,23,.435,22,25,.880,104,2015-03-06,NOP,BOS
31,@,L 98-106 ,240,40,83,.482,32,58,.552,8,25,.320,10,14,.714,98,40,80,.500,30,58,.517,10,22,.455,16,23,.696,106,2015-03-08,LAC,GSW
32,@,L 98-103 ,240,35,89,.393,20,55,.364,15,34,.441,13,16,.813,98,38,87,.437,31,65,.477,7,22,.318,20,30,.667,103,2015-03-08,BOS,ORL
33,@,W 98-80 ,240,35,83,.422,22,52,.423,13,31,.419,15,19,.789,98,29,77,.377,25,66,.379,4,11,.364,18,23,.783,80,2015-03-09,GSW,PHO
34,@,L 98-105 ,240,42,98,.429,38,86,.442,4,12,.333,10,12,.833,98,44,84,.524,37,64,.578,7,20,.350,10,13,.769,105,2015-03-11,DET,GSW
35,@,L 98-104 ,240,32,73,.438,26,56,.464,6,17,.353,28,39,.718,98,37,81,.457,31,60,.517,6,21,.286,24,38,.632,104,2015-03-11,BRK,MIA
36,Home,L 98-100 ,240,36,82,.439,24,56,.429,12,26,.462,14,24,.583,98,32,86,.372,25,56,.446,7,30,.233,29,36,.806,100,2015-03-15,LAC,HOU
37,Home,L 98-117 ,240,38,88,.432,36,69,.522,2,19,.105,20,25,.800,98,39,82,.476,27,59,.458,12,23,.522,27,33,.818,117,2015-03-16,IND,TOR
38,Home,L 98-109 ,240,41,74,.554,37,63,.587,4,11,.364,12,16,.750,98,45,89,.506,39,71,.549,6,18,.333,13,16,.813,109,2015-03-22,MIN,CHO
39,Home,W 98-92 ,240,39,76,.513,33,55,.600,6,21,.286,14,23,.609,98,37,96,.385,32,77,.416,5,19,.263,13,22,.591,92,2015-03-22,PHO,DAL
40,Home,W 98-86 ,240,37,82,.451,34,66,.515,3,16,.188,21,29,.724,98,28,81,.346,20,61,.328,8,20,.400,22,28,.786,86,2015-03-23,CHI,CHO
41,@,L 98-106 ,240,37,81,.457,29,51,.569,8,30,.267,16,20,.800,98,40,86,.465,31,63,.492,9,23,.391,17,19,.895,106,2015-03-27,CLE,BRK
42,Home,L 98-119 ,240,36,86,.419,25,55,.455,11,31,.355,15,27,.556,98,44,82,.537,32,53,.604,12,29,.414,19,31,.613,119,2015-03-27,PHI,LAC
43,Home,L 98-100 ,240,37,81,.457,26,58,.448,11,23,.478,13,15,.867,98,41,81,.506,32,65,.492,9,16,.563,9,12,.750,100,2015-04-01,NYK,BRK
44,Home,W 98-84 ,240,37,77,.481,28,54,.519,9,23,.391,15,24,.625,98,33,95,.347,26,62,.419,7,33,.212,11,12,.917,84,2015-04-01,UTA,DEN
45,@,L 98-99 ,240,37,77,.481,32,57,.561,5,20,.250,19,26,.731,98,36,73,.493,24,47,.511,12,26,.462,15,23,.652,99,2015-04-04,MIA,DET
46,@,L 98-110 ,240,39,84,.464,29,59,.492,10,25,.400,10,16,.625,98,48,95,.505,41,74,.554,7,21,.333,7,9,.778,110,2015-04-08,HOU,SAS
47,@,L 98-106 ,240,32,74,.432,29,59,.492,3,15,.200,31,34,.912,98,41,83,.494,32,60,.533,9,23,.391,15,24,.625,106,2015-04-10,MIN,LAL
48,@,L 98-114 ,240,38,91,.418,31,66,.470,7,25,.280,15,18,.833,98,39,86,.453,30,61,.492,9,25,.360,27,34,.794,114,2015-04-15,POR,DAL
49,Home,W 98-94 (OT),265,39,104,.375,33,76,.434,6,28,.214,14,28,.500,98,34,84,.405,27,62,.435,7,22,.318,19,26,.731,94,2015-10-30,DET,CHI
50,@,W 98-92 ,240,37,90,.411,30,69,.435,7,21,.333,17,22,.773,98,38,86,.442,33,58,.569,5,28,.179,11,16,.688,92,2015-11-03,ATL,MIA
51,@,L 98-100 ,240,35,83,.422,25,56,.446,10,27,.370,18,22,.818,98,35,91,.385,27,68,.397,8,23,.348,22,29,.759,100,2015-11-04,BOS,IND
52,Home,L 98-103 ,240,39,82,.476,31,59,.525,8,23,.348,12,14,.857,98,33,79,.418,28,65,.431,5,14,.357,32,39,.821,103,2015-11-04,OKC,TOR
53,@,L 98-104 ,240,38,84,.452,33,71,.465,5,13,.385,17,20,.850,98,40,90,.444,33,72,.458,7,18,.389,17,21,.810,104,2015-11-05,OKC,CHI
54,@,L 98-118 ,240,36,88,.409,28,63,.444,8,25,.320,18,23,.783,98,44,97,.454,32,67,.478,12,30,.400,18,23,.783,118,2015-11-06,WAS,BOS
55,Home,L 98-104 ,240,40,93,.430,37,74,.500,3,19,.158,15,20,.750,98,33,78,.423,26,55,.473,7,23,.304,31,40,.775,104,2015-11-06,BRK,LAL
56,@,L 98-107 ,240,39,86,.453,30,58,.517,9,28,.321,11,13,.846,98,40,84,.476,31,60,.517,9,24,.375,18,22,.818,107,2015-11-07,NOP,DAL
57,@,L 98-106 ,240,37,83,.446,23,54,.426,14,29,.483,10,15,.667,98,42,86,.488,32,60,.533,10,26,.385,12,16,.750,106,2015-11-11,NOP,ATL
58,Home,L 98-106 ,240,42,98,.429,34,64,.531,8,34,.235,6,12,.500,98,42,98,.429,34,81,.420,8,17,.471,14,17,.824,106,2015-11-11,HOU,BRK
59,@,L 98-107 ,240,33,77,.429,24,48,.500,9,29,.310,23,31,.742,98,37,81,.457,28,61,.459,9,20,.450,24,32,.750,107,2015-11-13,HOU,DEN
60,Home,L 98-110 ,240,32,84,.381,23,50,.460,9,34,.265,25,32,.781,98,43,89,.483,35,61,.574,8,28,.286,16,21,.762,110,2015-11-14,HOU,DAL
61,Home,L 98-115 ,240,41,83,.494,34,60,.567,7,23,.304,9,11,.818,98,45,85,.529,30,55,.545,15,30,.500,10,13,.769,115,2015-11-17,NOP,DEN
62,@,L 98-109 ,240,38,98,.388,33,83,.398,5,15,.333,17,18,.944,98,42,86,.488,33,68,.485,9,18,.500,16,20,.800,109,2015-11-18,DEN,SAS
63,Home,W 98-84 ,240,42,82,.512,33,62,.532,9,20,.450,5,10,.500,98,34,73,.466,27,54,.500,7,19,.368,9,10,.900,84,2015-11-23,SAS,PHO
64,@,L 98-112 ,240,36,84,.429,27,47,.574,9,37,.243,17,22,.773,98,36,79,.456,27,48,.563,9,31,.290,31,44,.705,112,2015-11-30,DAL,SAC
65,Home,L 98-114 ,240,39,89,.438,34,72,.472,5,17,.294,15,23,.652,98,44,86,.512,30,53,.566,14,33,.424,12,23,.522,114,2015-12-06,BRK,GSW
66,Home,W 98-95 ,240,35,86,.407,29,64,.453,6,22,.273,22,31,.710,98,35,88,.398,28,64,.438,7,24,.292,18,30,.600,95,2015-12-06,OKC,SAC
67,@,W 98-95 ,240,39,81,.481,33,61,.541,6,20,.300,14,18,.778,98,36,100,.360,29,69,.420,7,31,.226,16,19,.842,95,2015-12-09,ATL,DAL
68,Home,W 98-94 ,240,33,78,.423,25,58,.431,8,20,.400,24,29,.828,98,40,89,.449,34,73,.466,6,16,.375,8,11,.727,94,2015-12-12,CHI,NOP
69,@,W 98-93 ,240,40,96,.417,31,71,.437,9,25,.360,9,10,.900,98,36,88,.409,25,53,.472,11,35,.314,10,10,1.000,93,2015-12-12,BOS,CHO
70,@,L 98-104 (OT),265,39,94,.415,31,72,.431,8,22,.364,12,20,.600,98,35,79,.443,28,58,.483,7,21,.333,27,30,.900,104,2015-12-13,UTA,OKC
71,Home,L 98-104 ,240,42,89,.472,38,73,.521,4,16,.250,10,14,.714,98,40,75,.533,33,54,.611,7,21,.333,17,24,.708,104,2015-12-16,BRK,MIA
72,Home,W 98-85 ,240,38,86,.442,29,62,.468,9,24,.375,13,19,.684,98,32,76,.421,27,57,.474,5,19,.263,16,28,.571,85,2015-12-16,CHI,MEM
73,@,L 98-113 ,240,36,79,.456,22,45,.489,14,34,.412,12,15,.800,98,43,77,.558,29,53,.547,14,24,.583,13,15,.867,113,2015-12-16,CHO,ORL
74,@,L 98-117 ,240,39,81,.481,32,57,.561,7,24,.292,13,17,.765,98,47,88,.534,39,63,.619,8,25,.320,15,18,.833,117,2015-12-26,NYK,ATL
75,Home,W 98-92 ,240,28,69,.406,14,37,.378,14,32,.438,28,32,.875,98,37,90,.411,30,71,.423,7,19,.368,11,21,.524,92,2015-12-26,CHO,MEM
76,@,W 98-94 ,240,38,92,.413,28,59,.475,10,33,.303,12,16,.750,98,30,76,.395,21,52,.404,9,24,.375,25,31,.806,94,2015-12-27,POR,SAC
77,@,L 98-108 ,240,35,85,.412,26,56,.464,9,29,.310,19,23,.826,98,43,89,.483,37,64,.578,6,25,.240,16,22,.727,108,2015-12-28,LAL,CHO
78,Home,L 98-105 ,240,36,83,.434,26,57,.456,10,26,.385,16,19,.842,98,40,83,.482,34,63,.540,6,20,.300,19,24,.792,105,2016-01-02,DAL,NOP
79,Home,L 98-123 ,240,37,77,.481,34,65,.523,3,12,.250,21,30,.700,98,49,90,.544,40,70,.571,9,20,.450,16,20,.800,123,2016-01-04,MIL,SAS
80,@,W 98-90 ,240,39,70,.557,36,62,.581,3,8,.375,17,18,.944,98,37,82,.451,35,65,.538,2,17,.118,14,15,.933,90,2016-01-06,NYK,MIA
81,Home,L 98-109 ,240,38,86,.442,29,60,.483,9,26,.346,13,23,.565,98,42,83,.506,31,60,.517,11,23,.478,14,17,.824,109,2016-01-06,POR,LAC
82,@,L 98-123 ,240,37,79,.468,30,61,.492,7,18,.389,17,18,.944,98,52,86,.605,43,65,.662,9,21,.429,10,13,.769,123,2016-01-06,UTA,SAS
83,Home,L 98-126 ,240,39,86,.453,34,68,.500,5,18,.278,15,25,.600,98,49,92,.533,36,60,.600,13,32,.406,15,19,.789,126,2016-01-07,PHI,ATL
84,Home,W 98-83 ,240,39,71,.549,30,51,.588,9,20,.450,11,18,.611,98,34,82,.415,28,63,.444,6,19,.316,9,17,.529,83,2016-01-09,UTA,MIA
85,@,L 98-101 ,240,37,88,.420,30,66,.455,7,22,.318,17,23,.739,98,31,84,.369,27,68,.397,4,16,.250,35,40,.875,101,2016-01-10,BOS,MEM
86,@,L 98-116 ,240,40,90,.444,36,67,.537,4,23,.174,14,24,.583,98,43,86,.500,30,53,.566,13,33,.394,17,20,.850,116,2016-01-14,LAL,GSW
87,@,W 98-95 ,240,40,81,.494,36,69,.522,4,12,.333,14,19,.737,98,32,78,.410,26,60,.433,6,18,.333,25,26,.962,95,2016-01-15,MIA,DEN
88,Home,W 98-81 ,240,41,80,.513,32,61,.525,9,19,.474,7,10,.700,98,30,87,.345,24,65,.369,6,22,.273,15,20,.750,81,2016-01-18,ATL,ORL
89,Home,L 98-132 ,240,37,77,.481,30,58,.517,7,19,.368,17,25,.680,98,46,85,.541,27,45,.600,19,40,.475,21,27,.778,132,2016-01-18,CLE,GSW
90,Home,L 98-108 ,240,37,77,.481,28,56,.500,9,21,.429,15,20,.750,98,43,84,.512,26,53,.491,17,31,.548,5,11,.455,108,2016-01-18,WAS,POR
91,Home,L 98-104 ,240,41,94,.436,32,63,.508,9,31,.290,7,11,.636,98,39,87,.448,29,63,.460,10,24,.417,16,23,.696,104,2016-01-20,POR,ATL
92,@,L 98-102 ,240,39,85,.459,36,71,.507,3,14,.214,17,22,.773,98,38,94,.404,23,50,.460,15,44,.341,11,16,.688,102,2016-01-22,MIL,HOU
93,Home,W 98-95 ,240,34,85,.400,24,61,.393,10,24,.417,20,26,.769,98,34,84,.405,22,50,.440,12,34,.353,15,18,.833,95,2016-01-23,PHO,ATL
94,Home,L 98-102 ,240,36,71,.507,27,53,.509,9,18,.500,17,23,.739,98,45,83,.542,42,74,.568,3,9,.333,9,10,.900,102,2016-01-26,BRK,MIA
95,@,L 98-114 ,240,40,86,.465,33,60,.550,7,26,.269,11,15,.733,98,43,83,.518,36,61,.590,7,22,.318,21,27,.778,114,2016-02-01,WAS,OKC
96,@,W 98-95 ,240,43,94,.457,43,85,.506,0,9,.000,12,18,.667,98,36,81,.444,26,55,.473,10,26,.385,13,15,.867,95,2016-02-05,MIA,CHO
97,@,L 98-103 ,240,35,76,.461,30,61,.492,5,15,.333,23,26,.885,98,38,81,.469,28,52,.538,10,29,.345,17,22,.773,103,2016-02-06,BRK,PHI
98,@,W 98-89 ,240,34,78,.436,29,62,.468,5,16,.313,25,31,.806,98,30,80,.375,21,56,.375,9,24,.375,20,26,.769,89,2016-02-06,UTA,PHO
99,@,W 98-92 (OT),265,35,95,.368,30,73,.411,5,22,.227,23,31,.742,98,34,90,.378,28,65,.431,6,25,.240,18,21,.857,92,2016-02-08,LAC,PHI
0,@,W 98-96 ,240,38,89,.427,30,69,.435,8,20,.400,14,15,.933,98,37,91,.407,29,71,.408,8,20,.400,14,16,.875,96,2016-02-10,SAS,ORL
1,@,L 98-109 ,240,36,82,.439,26,56,.464,10,26,.385,16,18,.889,98,42,86,.488,34,69,.493,8,17,.471,17,20,.850,109,2016-02-19,NYK,BRK
2,@,W 98-95 ,240,37,86,.430,28,55,.509,9,31,.290,15,18,.833,98,36,81,.444,29,62,.468,7,19,.368,16,21,.762,95,2016-02-19,CHO,MIL
3,Home,L 98-101 ,240,42,96,.438,37,70,.529,5,26,.192,9,10,.900,98,39,88,.443,30,66,.455,9,22,.409,14,22,.636,101,2016-02-19,OKC,IND
4,Home,W 98-86 ,240,36,78,.462,29,56,.518,7,22,.318,19,26,.731,98,35,82,.427,28,59,.475,7,23,.304,9,17,.529,86,2016-02-19,WAS,DET
5,Home,W 98-85 ,240,33,81,.407,26,53,.491,7,28,.250,25,31,.806,98,28,76,.368,25,56,.446,3,20,.150,26,32,.813,85,2016-02-21,TOR,MEM
6,@,W 98-96 ,240,40,84,.476,33,69,.478,7,15,.467,11,17,.647,98,37,89,.416,32,69,.464,5,20,.250,17,25,.680,96,2016-02-27,BRK,UTA
7,@,W 98-81 ,240,40,84,.476,39,76,.513,1,8,.125,17,21,.810,98,32,87,.368,26,72,.361,6,15,.400,11,12,.917,81,2016-02-28,MIA,NYK
8,@,L 98-103 ,240,39,98,.398,29,63,.460,10,35,.286,10,11,.909,98,40,98,.408,31,66,.470,9,32,.281,14,21,.667,103,2016-03-02,OKC,LAC
9,@,L 98-104 ,240,39,82,.476,30,56,.536,9,26,.346,11,20,.550,98,35,79,.443,30,61,.492,5,18,.278,29,33,.879,104,2016-03-02,SAC,MEM
10,Home,L 98-104 ,240,32,75,.427,27,61,.443,5,14,.357,29,34,.853,98,42,84,.500,31,55,.564,11,29,.379,9,13,.692,104,2016-03-02,MIN,WAS
11,@,L 98-103 ,240,37,85,.435,26,54,.481,11,31,.355,13,22,.591,98,36,81,.444,28,67,.418,8,14,.571,23,30,.767,103,2016-03-06,PHI,MIA
12,@,L 98-107 ,240,37,76,.487,32,57,.561,5,19,.263,19,27,.704,98,40,81,.494,31,54,.574,9,27,.333,18,23,.783,107,2016-03-08,ORL,LAL
13,@,L 98-116 ,240,33,89,.371,27,61,.443,6,28,.214,26,33,.788,98,44,91,.484,31,63,.492,13,28,.464,15,19,.789,116,2016-03-10,PHO,DEN
14,Home,L 98-102 ,240,34,91,.374,26,60,.433,8,31,.258,22,28,.786,98,40,88,.455,35,62,.565,5,26,.192,17,25,.680,102,2016-03-11,BOS,HOU
15,@,L 98-103 ,240,36,94,.383,28,63,.444,8,31,.258,18,22,.818,98,39,84,.464,34,72,.472,5,12,.417,20,28,.714,103,2016-03-15,BOS,IND
16,Home,L 98-106 ,240,37,84,.440,32,58,.552,5,26,.192,19,26,.731,98,38,79,.481,34,61,.557,4,18,.222,26,33,.788,106,2016-03-15,LAL,SAC
17,@,L 98-99 ,240,37,79,.468,30,57,.526,7,22,.318,17,19,.895,98,39,88,.443,29,51,.569,10,37,.270,11,13,.846,99,2016-03-16,DAL,CLE
18,@,L 98-116 ,240,39,87,.448,33,65,.508,6,22,.273,14,17,.824,98,40,80,.500,28,54,.519,12,26,.462,24,28,.857,116,2016-03-17,DEN,ATL
19,@,L 98-114 ,240,36,85,.424,28,57,.491,8,28,.286,18,27,.667,98,39,87,.448,24,53,.453,15,34,.441,21,28,.750,114,2016-03-23,LAC,GSW
20,@,W 98-96 ,240,37,87,.425,27,61,.443,10,26,.385,14,16,.875,98,39,90,.433,36,71,.507,3,19,.158,15,17,.882,96,2016-03-29,CHI,IND
21,@,W 98-89 ,240,39,85,.459,31,61,.508,8,24,.333,12,14,.857,98,31,81,.383,18,48,.375,13,33,.394,14,24,.583,89,2016-04-01,DAL,DET
22,Home,W 98-85 ,240,38,72,.528,30,50,.600,8,22,.364,14,23,.609,98,35,79,.443,26,56,.464,9,23,.391,6,10,.600,85,2016-04-01,UTA,MIN
23,Home,L 98-102 ,240,40,85,.471,38,78,.487,2,7,.286,16,20,.800,98,39,74,.527,32,48,.667,7,26,.269,17,22,.773,102,2016-04-03,MIL,CHI
24,@,L 98-106 ,240,35,78,.449,32,64,.500,3,14,.214,25,28,.893,98,44,92,.478,40,78,.513,4,14,.286,14,17,.824,106,2016-04-07,CHI,MIA
25,@,L 98-102 ,240,36,85,.424,33,71,.465,3,14,.214,23,28,.821,98,40,86,.465,34,64,.531,6,22,.273,16,19,.842,102,2016-04-08,SAS,DEN
26,@,L 98-111 ,240,37,83,.446,29,56,.518,8,27,.296,16,20,.800,98,37,68,.544,27,46,.587,10,22,.455,27,38,.711,111,2016-04-08,IND,TOR
27,Home,W 98-91 ,240,37,76,.487,28,58,.483,9,18,.500,15,37,.405,98,30,74,.405,22,44,.500,8,30,.267,23,33,.697,91,2016-04-10,LAC,DAL
28,@,L 98-113 ,240,28,81,.346,16,48,.333,12,33,.364,30,35,.857,98,42,80,.525,33,59,.559,9,21,.429,20,28,.714,113,2016-04-10,CHO,WAS
29,@,L 98-107 ,240,41,78,.526,38,63,.603,3,15,.200,13,19,.684,98,41,84,.488,34,61,.557,7,23,.304,18,28,.643,107,2016-04-11,MIL,ORL
30,@,L 98-102 (OT),265,35,87,.402,29,62,.468,6,25,.240,22,25,.880,98,37,87,.425,33,73,.452,4,14,.286,24,32,.750,102,2016-04-12,OKC,SAS
31,@,L 98-122 ,240,35,77,.455,20,42,.476,15,35,.429,13,25,.520,98,48,95,.505,38,70,.543,10,25,.400,16,19,.842,122,2016-04-12,PHI,TOR
32,Home,W 98-88 ,240,37,86,.430,32,72,.444,5,14,.357,19,22,.864,98,38,88,.432,36,69,.522,2,19,.105,10,12,.833,88,2016-04-13,BOS,MIA
33,@,L 98-109 ,240,32,81,.395,21,52,.404,11,29,.379,23,31,.742,98,42,88,.477,33,60,.550,9,28,.321,16,30,.533,109,2016-04-13,ATL,WAS
34,@,L 98-102 ,240,36,86,.419,30,68,.441,6,18,.333,20,29,.690,98,36,80,.450,25,56,.446,11,24,.458,19,27,.704,102,2016-10-26,MIN,MEM
35,Home,L 98-106 ,240,35,80,.438,27,51,.529,8,29,.276,20,24,.833,98,33,70,.471,18,38,.474,15,32,.469,25,31,.806,106,2016-10-28,DAL,HOU
36,Home,L 98-104 ,240,32,79,.405,23,47,.489,9,32,.281,25,33,.758,98,39,81,.481,24,50,.480,15,31,.484,11,17,.647,104,2016-10-29,CHO,BOS
37,Home,W 98-79 ,240,35,83,.422,25,59,.424,10,24,.417,18,23,.783,98,32,86,.372,28,64,.438,4,22,.182,11,15,.733,79,2016-10-29,SAS,NOP
38,Home,W 98-83 ,240,39,88,.443,34,68,.500,5,20,.250,15,20,.750,98,34,87,.391,30,70,.429,4,17,.235,11,14,.786,83,2016-10-30,DET,MIL
39,@,L 98-116 ,240,35,84,.417,30,69,.435,5,15,.333,23,31,.742,98,40,80,.500,34,64,.531,6,16,.375,30,38,.789,116,2016-10-31,PHO,LAC
40,@,L 98-104 ,240,38,82,.463,30,48,.625,8,34,.235,14,18,.778,98,38,82,.463,30,56,.536,8,26,.308,20,29,.690,104,2016-11-09,UTA,CHO
41,@,W 98-95 ,240,37,89,.416,31,73,.425,6,16,.375,18,20,.900,98,36,88,.409,23,59,.390,13,29,.448,10,15,.667,95,2016-11-10,CHI,MIA
42,@,W 98-85 ,240,34,85,.400,27,63,.429,7,22,.318,23,25,.920,98,32,79,.405,26,53,.491,6,26,.231,15,21,.714,85,2016-11-25,MIN,PHO
43,Home,L 98-106 ,240,38,91,.418,31,69,.449,7,22,.318,15,24,.625,98,41,93,.441,32,69,.464,9,24,.375,15,26,.577,106,2016-11-30,DEN,MIA
44,@,L 98-105 ,240,37,83,.446,24,59,.407,13,24,.542,11,14,.786,98,35,78,.449,26,53,.491,9,25,.360,26,28,.929,105,2016-12-03,DEN,UTA
45,@,W 98-92 ,240,42,79,.532,35,56,.625,7,23,.304,7,14,.500,98,38,86,.442,28,59,.475,10,27,.370,6,13,.462,92,2016-12-04,ORL,DET
46,@,L 98-106 ,240,31,97,.320,22,69,.319,9,28,.321,27,31,.871,98,39,88,.443,28,59,.475,11,29,.379,17,24,.708,106,2016-12-04,SAC,NYK
47,Home,L 98-106 ,240,35,86,.407,24,55,.436,11,31,.355,17,23,.739,98,35,76,.461,25,49,.510,10,27,.370,26,34,.765,106,2016-12-05,PHI,DEN
48,Home,L 98-115 ,240,36,92,.391,28,66,.424,8,26,.308,18,24,.750,98,42,89,.472,35,58,.603,7,31,.226,24,29,.828,115,2016-12-07,LAC,GSW
49,@,L 98-132 ,240,39,92,.424,28,60,.467,11,32,.344,9,11,.818,98,50,85,.588,28,43,.651,22,42,.524,10,16,.625,132,2016-12-14,SAC,HOU
50,Home,L 98-102 ,240,38,93,.409,32,66,.485,6,27,.222,16,25,.640,98,36,83,.434,29,58,.500,7,25,.280,23,29,.793,102,2016-12-16,MIA,LAC
51,@,W 98-86 ,240,35,82,.427,23,52,.442,12,30,.400,16,19,.842,98,26,72,.361,20,49,.408,6,23,.261,28,37,.757,86,2016-12-21,MEM,DET
52,Home,L 98-104 ,240,35,79,.443,25,52,.481,10,27,.370,18,21,.857,98,43,81,.531,35,60,.583,8,21,.381,10,15,.667,104,2016-12-23,UTA,TOR
53,@,L 98-102 (OT),265,35,93,.376,28,66,.424,7,27,.259,21,26,.808,98,37,101,.366,30,74,.405,7,27,.259,21,27,.778,102,2016-12-28,NYK,ATL
54,@,L 98-102 ,240,37,94,.394,26,57,.456,11,37,.297,13,18,.722,98,40,87,.460,30,58,.517,10,29,.345,12,21,.571,102,2016-12-28,LAC,NOP
55,@,L 98-119 ,240,36,74,.486,29,58,.500,7,16,.438,19,24,.792,98,47,87,.540,42,70,.600,5,17,.294,20,25,.800,119,2016-12-28,PHO,SAS
56,@,L 98-105 ,240,35,84,.417,26,53,.491,9,31,.290,19,21,.905,98,39,88,.443,31,62,.500,8,26,.308,19,25,.760,105,2016-12-30,DET,ATL
57,Home,L 98-112 ,240,31,72,.431,20,44,.455,11,28,.393,25,28,.893,98,44,87,.506,27,52,.519,17,35,.486,7,9,.778,112,2016-12-31,SAC,MEM
58,Home,L 98-107 ,240,35,77,.455,21,51,.412,14,26,.538,14,18,.778,98,42,86,.488,33,64,.516,9,22,.409,14,22,.636,107,2017-01-01,MIA,DET
59,@,L 98-109 ,240,39,102,.382,37,87,.425,2,15,.133,18,22,.818,98,37,80,.463,30,64,.469,7,16,.438,28,38,.737,109,2017-01-02,PHO,LAC
60,Home,W 98-94 ,240,38,79,.481,31,60,.517,7,19,.368,15,24,.625,98,36,78,.462,27,51,.529,9,27,.333,13,19,.684,94,2017-01-02,MIL,OKC
61,Home,L 98-106 ,240,36,87,.414,27,57,.474,9,30,.300,17,22,.773,98,39,84,.464,26,53,.491,13,31,.419,15,21,.714,106,2017-01-06,SAC,LAC
62,Home,W 98-86 ,240,36,86,.419,27,56,.482,9,30,.300,17,25,.680,98,31,84,.369,24,57,.421,7,27,.259,17,21,.810,86,2017-01-08,LAC,MIA
63,Home,W 98-97 ,240,37,95,.389,30,67,.448,7,28,.250,17,21,.810,98,42,86,.488,38,64,.594,4,22,.182,9,10,.900,97,2017-01-11,PHI,NYK
64,@,L 98-111 ,240,39,79,.494,33,60,.550,6,19,.316,14,18,.778,98,42,80,.525,29,54,.537,13,26,.500,14,18,.778,111,2017-01-15,MIL,ATL
65,Home,W 98-87 ,240,36,77,.468,24,48,.500,12,29,.414,14,19,.737,98,35,80,.438,30,59,.508,5,21,.238,12,18,.667,87,2017-01-15,DAL,MIN
66,@,L 98-108 ,240,38,86,.442,30,61,.492,8,25,.320,14,17,.824,98,42,84,.500,27,45,.600,15,39,.385,9,10,.900,108,2017-01-16,CHO,BOS
67,Home,W 98-95 ,240,41,81,.506,36,62,.581,5,19,.263,11,16,.688,98,36,83,.434,26,58,.448,10,25,.400,13,18,.722,95,2017-01-16,IND,NOP
68,@,L 98-120 ,240,36,85,.424,26,55,.473,10,30,.333,16,19,.842,98,45,82,.549,33,54,.611,12,28,.429,18,22,.818,120,2017-01-16,OKC,LAC
69,Home,L 98-99 ,240,37,82,.451,31,68,.456,6,14,.429,18,22,.818,98,37,78,.474,26,50,.520,11,28,.393,14,18,.778,99,2017-01-17,CHI,DAL
70,@,L 98-118 ,240,39,88,.443,28,56,.500,11,32,.344,9,11,.818,98,46,93,.495,31,57,.544,15,36,.417,11,15,.733,118,2017-01-18,ORL,NOP
71,@,L 98-123 ,240,40,96,.417,30,64,.469,10,32,.313,8,8,1.000,98,46,87,.529,36,63,.571,10,24,.417,21,26,.808,123,2017-01-21,LAC,DEN
72,Home,L 98-118 ,240,42,96,.438,35,68,.515,7,28,.250,7,16,.438,98,42,89,.472,23,47,.489,19,42,.452,15,19,.789,118,2017-01-22,ORL,GSW
73,@,L 98-105 ,240,37,94,.394,26,65,.400,11,29,.379,13,14,.929,98,43,90,.478,39,75,.520,4,15,.267,15,20,.750,105,2017-01-25,LAL,POR
74,@,L 98-109 ,240,38,84,.452,27,58,.466,11,26,.423,11,13,.846,98,37,72,.514,28,50,.560,9,22,.409,26,36,.722,109,2017-01-26,DAL,OKC
75,@,L 98-128 ,240,38,87,.437,29,62,.468,9,25,.360,13,18,.722,98,50,89,.562,34,55,.618,16,34,.471,12,15,.800,128,2017-01-27,ORL,BOS
76,@,L 98-144 ,240,36,82,.439,24,54,.444,12,28,.429,14,22,.636,98,57,92,.620,40,58,.690,17,34,.500,13,16,.813,144,2017-01-28,LAC,GSW
77,@,L 98-115 ,240,33,83,.398,22,52,.423,11,31,.355,21,25,.840,98,42,93,.452,31,62,.500,11,31,.355,20,23,.870,115,2017-01-31,CHO,POR
78,@,L 98-118 ,240,41,82,.500,36,61,.590,5,21,.238,11,14,.786,98,48,88,.545,38,62,.613,10,26,.385,12,17,.706,118,2017-02-01,NOP,DET
79,@,W 98-88 ,240,33,69,.478,24,49,.490,9,20,.450,23,26,.885,98,31,77,.403,25,53,.472,6,24,.250,20,28,.714,88,2017-02-01,IND,ORL
80,@,L 98-105 ,240,35,82,.427,22,49,.449,13,33,.394,15,18,.833,98,38,81,.469,25,48,.521,13,33,.394,16,24,.667,105,2017-02-04,CHO,UTA
81,Home,L 98-111 ,240,35,77,.455,26,50,.520,9,27,.333,19,25,.760,98,40,81,.494,24,47,.511,16,34,.471,15,18,.833,111,2017-02-13,DAL,BOS
82,@,L 98-120 ,240,34,96,.354,27,62,.435,7,34,.206,23,30,.767,98,42,73,.575,29,53,.547,13,20,.650,23,28,.821,120,2017-02-13,OKC,WAS
83,Home,W 98-91 ,240,36,82,.439,30,63,.476,6,19,.316,20,22,.909,98,35,92,.380,25,55,.455,10,37,.270,11,11,1.000,91,2017-02-15,DET,DAL
84,Home,L 98-111 ,240,40,81,.494,36,63,.571,4,18,.222,14,18,.778,98,43,83,.518,28,54,.519,15,29,.517,10,15,.667,111,2017-02-16,IND,WAS
85,Home,L 98-105 ,240,37,84,.440,26,50,.520,11,34,.324,13,17,.765,98,36,80,.450,25,47,.532,11,33,.333,22,25,.880,105,2017-02-26,DEN,MEM
86,Home,L 98-104 ,240,35,81,.432,23,48,.479,12,33,.364,16,35,.457,98,34,85,.400,22,50,.440,12,35,.343,24,30,.800,104,2017-02-26,DET,BOS
87,Home,L 98-119 ,240,40,87,.460,33,65,.508,7,22,.318,11,18,.611,98,49,94,.521,39,73,.534,10,21,.476,11,13,.846,119,2017-02-26,LAL,SAS
88,Home,L 98-114 ,240,34,87,.391,24,53,.453,10,34,.294,20,25,.800,98,46,95,.484,40,70,.571,6,25,.240,16,20,.800,114,2017-02-27,BOS,ATL
89,@,L 98-125 ,240,37,85,.435,31,68,.456,6,17,.353,18,22,.818,98,49,90,.544,36,60,.600,13,30,.433,14,21,.667,125,2017-03-01,PHI,MIA
90,Home,L 98-110 ,240,38,83,.458,29,65,.446,9,18,.500,13,15,.867,98,41,84,.488,31,51,.608,10,33,.303,18,20,.900,110,2017-03-01,MIL,DEN
91,Home,L 98-101 (OT),265,35,91,.385,27,66,.409,8,25,.320,20,24,.833,98,40,95,.421,34,68,.500,6,27,.222,15,25,.600,101,2017-03-03,NOP,SAS
92,Home,L 98-106 ,240,35,78,.449,26,51,.510,9,27,.333,19,29,.655,98,39,91,.429,23,56,.411,16,35,.457,12,14,.857,106,2017-03-06,CLE,MIA
93,Home,L 98-112 ,240,39,89,.438,31,59,.525,8,30,.267,12,19,.632,98,41,83,.494,27,50,.540,14,33,.424,16,20,.800,112,2017-03-06,PHI,MIL
94,@,L 98-115 ,240,39,89,.438,32,63,.508,7,26,.269,13,22,.591,98,44,88,.500,33,65,.508,11,23,.478,16,19,.842,115,2017-03-08,DET,IND
95,Home,W 98-91 ,240,37,89,.416,30,64,.469,7,25,.280,17,21,.810,98,36,81,.444,24,53,.453,12,28,.429,7,11,.636,91,2017-03-08,ORL,CHI
96,Home,L 98-114 ,240,37,83,.446,30,63,.476,7,20,.350,17,22,.773,98,40,78,.513,29,48,.604,11,30,.367,23,28,.821,114,2017-03-09,MEM,LAC
97,Home,W 97-89 ,240,34,72,.472,24,53,.453,10,19,.526,19,26,.731,97,30,81,.370,22,53,.415,8,28,.286,21,26,.808,89,2011-12-25,OKC,ORL
98,Home,W 97-78 ,240,36,79,.456,32,67,.478,4,12,.333,21,25,.840,97,29,78,.372,22,61,.361,7,17,.412,13,18,.722,78,2011-12-28,NOH,BOS
99,@,L 97-107 ,240,35,88,.398,27,62,.435,8,26,.308,19,23,.826,97,41,77,.532,32,55,.582,9,22,.409,16,18,.889,107,2011-12-31,PHO,OKC
0,Home,W 97-90 ,240,37,77,.481,34,66,.515,3,11,.273,20,29,.690,97,38,77,.494,34,63,.540,4,14,.286,10,19,.526,90,2012-01-06,LAL,GSW
1,@,W 97-83 ,240,38,86,.442,30,72,.417,8,14,.571,13,17,.765,97,30,75,.400,23,55,.418,7,20,.350,16,21,.762,83,2012-01-06,CHI,ORL
2,@,W 97-85 ,240,31,80,.388,16,49,.327,15,31,.484,20,27,.741,97,33,73,.452,27,56,.482,6,17,.353,13,19,.684,85,2012-01-06,NJN,TOR
3,Home,W 97-62 ,240,36,83,.434,31,62,.500,5,21,.238,20,27,.741,97,27,85,.318,26,73,.356,1,12,.083,7,12,.583,62,2012-01-07,PHI,TOR
4,Home,L 97-104 ,240,38,73,.521,35,53,.660,3,20,.150,18,24,.750,97,37,87,.425,27,55,.491,10,32,.313,20,31,.645,104,2012-01-08,SAC,ORL
5,Home,W 97-87 ,240,34,77,.442,31,58,.534,3,19,.158,26,28,.929,97,27,80,.338,20,56,.357,7,24,.292,26,33,.788,87,2012-01-09,TOR,MIN
6,@,L 97-105 ,240,37,83,.446,31,60,.517,6,23,.261,17,24,.708,97,37,72,.514,32,58,.552,5,14,.357,26,32,.813,105,2012-01-10,LAC,POR
7,Home,W 97-92 ,240,37,76,.487,32,62,.516,5,14,.357,18,23,.783,97,32,85,.376,24,61,.393,8,24,.333,20,25,.800,92,2012-01-13,LAL,CLE
8,Home,W 97-83 ,240,35,94,.372,30,78,.385,5,16,.313,22,23,.957,97,32,83,.386,27,68,.397,5,15,.333,14,18,.778,83,2012-01-14,IND,BOS
9,@,W 97-88 ,240,36,80,.450,29,61,.475,7,19,.368,18,19,.947,97,34,87,.391,28,73,.384,6,14,.429,14,16,.875,88,2012-01-16,OKC,BOS
10,@,L 97-118 ,240,38,74,.514,33,63,.524,5,11,.455,16,19,.842,97,47,88,.534,42,78,.538,5,10,.500,19,24,.792,118,2012-01-17,PHO,CHI
11,Home,W 97-80 ,240,40,81,.494,32,62,.516,8,19,.421,9,12,.750,97,34,83,.410,30,70,.429,4,13,.308,8,9,.889,80,2012-01-17,HOU,DET
12,Home,W 97-87 ,240,38,86,.442,31,59,.525,7,27,.259,14,15,.933,97,37,79,.468,32,65,.492,5,14,.357,8,15,.533,87,2012-01-22,NJN,CHA
13,@,W 97-92 ,240,38,83,.458,35,72,.486,3,11,.273,18,21,.857,97,37,92,.402,32,75,.427,5,17,.294,13,17,.765,92,2012-01-23,ATL,MIL
14,Home,W 97-84 ,240,31,72,.431,26,50,.520,5,22,.227,30,36,.833,97,34,90,.378,31,76,.408,3,14,.214,13,17,.765,84,2012-01-24,POR,MEM
15,@,W 97-90 (OT),265,37,82,.451,25,55,.455,12,27,.444,11,14,.786,97,35,79,.443,30,65,.462,5,14,.357,15,19,.789,90,2012-01-25,NJN,PHI
16,Home,W 97-84 ,240,38,77,.494,34,65,.523,4,12,.333,17,22,.773,97,34,89,.382,29,63,.460,5,26,.192,11,15,.733,84,2012-01-28,HOU,NYK
17,Home,W 97-93 ,240,32,78,.410,29,70,.414,3,8,.375,30,40,.750,97,35,81,.432,32,70,.457,3,11,.273,20,28,.714,93,2012-01-29,MIA,CHI
18,@,L 97-100 (OT),265,35,80,.438,28,57,.491,7,23,.304,20,27,.741,97,33,86,.384,27,74,.365,6,12,.500,28,35,.800,100,2012-01-31,DEN,MEM
19,@,L 97-105 ,240,34,73,.466,25,53,.472,9,20,.450,20,24,.833,97,39,88,.443,29,65,.446,10,23,.435,17,25,.680,105,2012-02-01,MIA,MIL
20,@,L 97-117 ,240,35,79,.443,30,57,.526,5,22,.227,22,24,.917,97,46,86,.535,31,53,.585,15,33,.455,10,12,.833,117,2012-02-04,DEN,POR
21,Home,W 97-87 ,240,35,76,.461,26,55,.473,9,21,.429,18,24,.750,97,33,75,.440,28,61,.459,5,14,.357,16,23,.696,87,2012-02-08,ATL,IND
22,Home,L 97-104 ,240,32,79,.405,26,56,.464,6,23,.261,27,31,.871,97,39,90,.433,30,69,.435,9,21,.429,17,23,.739,104,2012-02-10,MIN,DAL
23,Home,W 97-94 (2OT),290,39,84,.464,33,65,.508,6,19,.316,13,19,.684,97,36,97,.371,33,77,.429,3,20,.150,19,21,.905,94,2012-02-11,DAL,POR
24,@,L 97-106 ,240,31,75,.413,20,46,.435,11,29,.379,24,33,.727,97,40,79,.506,27,55,.491,13,24,.542,13,18,.722,106,2012-02-12,HOU,GSW
25,@,W 97-85 ,240,34,85,.400,24,63,.381,10,22,.455,19,25,.760,97,33,84,.393,30,71,.423,3,13,.231,16,27,.593,85,2012-02-18,NJN,CHI
26,Home,W 97-77 ,240,38,81,.469,29,59,.492,9,22,.409,12,16,.750,97,30,73,.411,23,46,.500,7,27,.259,10,13,.769,77,2012-02-18,POR,ATL
27,@,L 97-104 ,240,36,81,.444,24,48,.500,12,33,.364,13,17,.765,97,40,86,.465,28,57,.491,12,29,.414,12,18,.667,104,2012-02-19,DAL,NYK
28,@,L 97-104 ,240,33,77,.429,22,51,.431,11,26,.423,20,27,.741,97,38,83,.458,29,60,.483,9,23,.391,19,24,.792,104,2012-02-20,LAC,GSW
29,Home,W 97-93 ,240,35,74,.473,28,52,.538,7,22,.318,20,25,.800,97,38,79,.481,35,66,.530,3,13,.231,14,18,.778,93,2012-02-20,HOU,MEM
30,@,L 97-137 ,240,32,84,.381,24,64,.375,8,20,.400,25,32,.781,97,51,86,.593,36,58,.621,15,28,.536,20,24,.833,137,2012-02-21,SAS,POR
31,@,W 97-68 ,240,42,84,.500,37,71,.521,5,13,.385,8,9,.889,97,25,79,.316,23,69,.333,2,10,.200,16,20,.800,68,2012-02-28,PHI,DET
32,Home,L 97-109 ,240,40,85,.471,38,74,.514,2,11,.182,15,22,.682,97,40,78,.513,30,56,.536,10,22,.455,19,27,.704,109,2012-02-28,LAC,MIN
33,Home,W 97-92 ,240,40,88,.455,37,75,.493,3,13,.231,14,17,.824,97,37,83,.446,26,54,.481,11,29,.379,7,10,.700,92,2012-03-02,NOH,DAL
34,Home,W 97-90 ,240,37,85,.435,29,68,.426,8,17,.471,15,22,.682,97,30,73,.411,24,50,.480,6,23,.261,24,29,.828,90,2012-03-03,ATL,OKC
35,Home,W 97-93 ,240,35,88,.398,28,68,.412,7,20,.350,20,23,.870,97,35,94,.372,28,75,.373,7,19,.368,16,23,.696,93,2012-03-05,MIL,PHI
36,Home,W 97-92 (OT),265,35,81,.432,31,67,.463,4,14,.286,23,31,.742,97,32,83,.386,27,64,.422,5,19,.263,23,29,.793,92,2012-03-06,BOS,HOU
37,@,L 97-110 ,240,33,72,.458,29,61,.475,4,11,.364,27,32,.844,97,41,73,.562,35,50,.700,6,23,.261,22,32,.688,110,2012-03-09,NOH,DEN
38,@,L 97-110 ,240,39,86,.453,33,64,.516,6,22,.273,13,18,.722,97,43,85,.506,32,58,.552,11,27,.407,13,13,1.000,110,2012-03-09,DAL,SAC
39,@,L 97-111 ,240,40,85,.471,40,82,.488,0,3,.000,17,22,.773,97,43,77,.558,36,59,.610,7,18,.389,18,24,.750,111,2012-03-10,UTA,CHI
40,@,W 97-93 ,240,36,70,.514,28,55,.509,8,15,.533,17,21,.810,97,34,79,.430,28,60,.467,6,19,.316,19,35,.543,93,2012-03-11,GSW,LAC
41,Home,W 97-94 ,240,36,71,.507,28,55,.509,8,16,.500,17,26,.654,97,39,83,.470,33,66,.500,6,17,.353,10,12,.833,94,2012-03-11,LAL,BOS
42,@,L 97-112 ,240,39,87,.448,31,70,.443,8,17,.471,11,14,.786,97,47,87,.540,39,65,.600,8,22,.364,10,19,.526,112,2012-03-12,WAS,SAS
43,Home,W 97-92 ,240,33,80,.413,23,58,.397,10,22,.455,21,27,.778,97,37,92,.402,33,70,.471,4,22,.182,14,20,.700,92,2012-03-16,LAL,MIN
44,Home,W 97-92 ,240,34,85,.400,32,78,.410,2,7,.286,27,37,.730,97,37,78,.474,31,60,.517,6,18,.333,12,19,.632,92,2012-03-18,MEM,WAS
45,@,W 97-93 ,240,35,74,.473,26,53,.491,9,21,.429,18,23,.783,97,34,80,.425,24,54,.444,10,26,.385,15,20,.750,93,2012-03-19,MIN,GSW
46,Home,W 97-90 ,240,38,80,.475,33,70,.471,5,10,.500,16,22,.727,97,30,71,.423,22,52,.423,8,19,.421,22,30,.733,90,2012-03-20,UTA,OKC
47,Home,W 97-90 ,240,34,59,.576,32,54,.593,2,5,.400,27,34,.794,97,35,90,.389,30,63,.476,5,27,.185,15,24,.625,90,2012-03-22,NOH,LAC
48,Home,W 97-93 ,240,31,73,.425,21,48,.438,10,25,.400,25,25,1.000,97,37,81,.457,34,73,.466,3,8,.375,16,23,.696,93,2012-03-22,POR,MEM
49,Home,W 97-85 ,240,37,74,.500,29,48,.604,8,26,.308,15,21,.714,97,31,62,.500,29,51,.569,2,11,.182,21,31,.677,85,2012-03-26,LAC,NOH
50,@,L 97-98 ,240,39,78,.500,31,59,.525,8,19,.421,11,15,.733,97,39,75,.520,31,54,.574,8,21,.381,12,19,.632,98,2012-03-30,POR,LAC
51,Home,W 97-76 ,240,42,87,.483,35,70,.500,7,17,.412,6,6,1.000,97,30,82,.366,27,68,.397,3,14,.214,13,17,.765,76,2012-03-30,WAS,PHI
52,Home,L 97-102 ,240,35,81,.432,23,59,.390,12,22,.545,15,18,.833,97,41,84,.488,37,69,.536,4,15,.267,16,21,.762,102,2012-04-02,POR,UTA
53,@,W 97-94 ,240,41,86,.477,37,70,.529,4,16,.250,11,16,.688,97,37,87,.425,28,56,.500,9,31,.290,11,16,.688,94,2012-04-04,GSW,MIN
54,Home,L 97-99 (OT),265,42,93,.452,35,69,.507,7,24,.292,6,8,.750,97,41,94,.436,33,73,.452,8,21,.381,9,11,.818,99,2012-04-06,DAL,POR
55,@,W 97-82 ,240,38,82,.463,30,65,.462,8,17,.471,13,17,.765,97,33,82,.402,29,64,.453,4,18,.222,12,16,.750,82,2012-04-06,MEM,MIA
56,@,L 97-112 ,240,37,80,.463,29,55,.527,8,25,.320,15,20,.750,97,46,88,.523,38,67,.567,8,21,.381,12,16,.750,112,2012-04-07,DEN,GSW
57,@,L 97-107 ,240,36,85,.424,32,66,.485,4,19,.211,21,27,.778,97,37,76,.487,30,56,.536,7,20,.350,26,31,.839,107,2012-04-12,MEM,SAS
58,Home,L 97-113 ,240,37,78,.474,34,68,.500,3,10,.300,20,24,.833,97,45,87,.517,40,72,.556,5,15,.333,18,22,.818,113,2012-04-13,DET,MIL
59,@,L 97-103 ,240,41,92,.446,36,75,.480,5,17,.294,10,15,.667,97,38,75,.507,31,60,.517,7,15,.467,20,29,.690,103,2012-04-13,DEN,LAL
60,@,W 97-94 ,240,40,83,.482,31,63,.492,9,20,.450,8,10,.800,97,35,83,.422,29,58,.500,6,25,.240,18,23,.783,94,2012-04-13,DAL,POR
61,Home,L 97-102 ,240,34,76,.447,29,62,.468,5,14,.357,24,32,.750,97,37,89,.416,24,65,.369,13,24,.542,15,18,.833,102,2012-04-17,PHI,IND
62,Home,L 97-109 ,240,34,83,.410,28,63,.444,6,20,.300,23,32,.719,97,36,80,.450,30,64,.469,6,16,.375,31,34,.912,109,2012-04-18,PHO,OKC
63,Home,W 97-92 ,240,37,72,.514,28,55,.509,9,17,.529,14,17,.824,97,39,81,.481,34,69,.493,5,12,.417,9,14,.643,92,2012-04-20,ATL,BOS
64,@,L 97-121 ,240,33,76,.434,27,62,.435,6,14,.429,25,30,.833,97,47,77,.610,37,62,.597,10,15,.667,17,18,.944,121,2012-04-20,LAL,SAS
65,Home,W 97-88 ,240,35,85,.412,30,69,.435,5,16,.313,22,24,.917,97,35,76,.461,28,56,.500,7,20,.350,11,13,.846,88,2012-04-22,MIA,HOU
66,@,L 97-103 ,240,38,83,.458,30,67,.448,8,16,.500,13,22,.591,97,35,92,.380,31,77,.403,4,15,.267,29,38,.763,103,2012-04-23,DET,IND
67,@,L 97-109 ,240,35,78,.449,29,66,.439,6,12,.500,21,25,.840,97,41,92,.446,31,62,.500,10,30,.333,17,22,.773,109,2012-11-06,DET,DEN
68,@,W 97-91 ,240,36,73,.493,31,60,.517,5,13,.385,20,21,.952,97,35,84,.417,30,69,.435,5,15,.333,16,18,.889,91,2012-11-08,OKC,CHI
69,@,W 97-86 ,240,35,72,.486,30,54,.556,5,18,.278,22,26,.846,97,32,91,.352,29,75,.387,3,16,.188,19,26,.731,86,2012-11-09,SAS,SAC
70,@,L 97-101 (OT),265,32,79,.405,23,60,.383,9,19,.474,24,30,.800,97,40,95,.421,37,75,.493,3,20,.150,18,28,.643,101,2012-11-10,DAL,CHA
71,Home,L 97-107 ,240,35,72,.486,29,59,.492,6,13,.462,21,26,.808,97,44,93,.473,37,76,.487,7,17,.412,12,14,.857,107,2012-11-14,OKC,MEM
72,@,L 97-102 ,240,35,75,.467,28,62,.452,7,13,.538,20,25,.800,97,36,85,.424,28,63,.444,8,22,.364,22,28,.786,102,2012-11-15,BOS,BRK
73,@,W 97-88 ,240,38,71,.535,30,52,.577,8,19,.421,13,19,.684,97,34,79,.430,29,61,.475,5,18,.278,15,21,.714,88,2012-11-17,MIA,PHO
74,Home,W 97-86 ,240,38,80,.475,31,62,.500,7,18,.389,14,23,.609,97,32,80,.400,28,67,.418,4,13,.308,18,21,.857,86,2012-11-18,TOR,ORL
75,@,W 97-92 ,240,36,81,.444,31,66,.470,5,15,.333,20,28,.714,97,36,78,.462,30,61,.492,6,17,.353,14,17,.824,92,2012-11-19,DEN,MEM
76,@,L 97-98 ,240,37,80,.463,28,57,.491,9,23,.391,14,20,.700,97,36,86,.419,33,67,.493,3,19,.158,23,28,.821,98,2012-11-21,TOR,CHA
77,@,L 97-113 ,240,29,65,.446,17,39,.436,12,26,.462,27,39,.692,97,44,81,.543,37,66,.561,7,15,.467,18,22,.818,113,2012-11-21,LAL,SAC
78,Home,L 97-104 ,240,38,92,.413,31,76,.408,7,16,.438,14,21,.667,97,41,83,.494,39,66,.591,2,17,.118,20,22,.909,104,2012-11-23,IND,SAS
79,@,L 97-108 ,240,32,79,.405,21,54,.389,11,25,.440,22,30,.733,97,40,74,.541,34,58,.586,6,16,.375,22,32,.688,108,2012-11-24,UTA,SAC
80,@,W 97-89 ,240,38,83,.458,32,61,.525,6,22,.273,15,18,.833,97,37,84,.440,31,67,.463,6,17,.353,9,14,.643,89,2012-11-27,MIN,SAC
81,@,W 97-92 ,240,37,85,.435,28,59,.475,9,26,.346,14,19,.737,97,32,75,.427,26,58,.448,6,17,.353,22,25,.880,92,2012-11-30,IND,SAC
82,@,L 97-101 ,240,37,77,.481,31,61,.508,6,16,.375,17,19,.895,97,39,81,.481,31,67,.463,8,14,.571,15,22,.682,101,2012-11-30,PHO,TOR
83,Home,L 97-104 ,240,35,79,.443,29,58,.500,6,21,.286,21,31,.677,97,34,75,.453,25,51,.490,9,24,.375,27,34,.794,104,2012-12-05,DET,GSW
84,@,W 97-94 ,240,37,78,.474,33,66,.500,4,12,.333,19,24,.792,97,34,85,.400,26,64,.406,8,21,.381,18,25,.720,94,2012-12-06,DAL,PHO
85,Home,L 97-104 ,240,39,91,.429,33,64,.516,6,27,.222,13,17,.765,97,35,75,.467,26,60,.433,9,15,.600,25,33,.758,104,2012-12-08,CLE,DET
86,Home,L 97-101 ,240,37,87,.425,28,62,.452,9,25,.360,14,23,.609,97,35,81,.432,26,59,.441,9,22,.409,22,27,.815,101,2012-12-08,WAS,GSW
87,@,W 97-88 ,240,33,71,.465,26,55,.473,7,16,.438,24,30,.800,97,32,79,.405,25,54,.463,7,25,.280,17,23,.739,88,2012-12-09,MIL,BRK
88,@,L 97-104 ,240,32,81,.395,27,63,.429,5,18,.278,28,33,.848,97,44,82,.537,40,71,.563,4,11,.364,12,23,.522,104,2012-12-10,DET,PHI
89,Home,L 97-100 ,240,36,68,.529,32,50,.640,4,18,.222,21,28,.750,97,36,78,.462,22,50,.440,14,28,.500,14,18,.778,100,2012-12-11,BRK,NYK
90,@,W 97-95 ,240,38,82,.463,29,58,.500,9,24,.375,12,14,.857,97,38,80,.475,31,58,.534,7,22,.318,12,15,.800,95,2012-12-12,GSW,MIA
91,Home,L 97-122 ,240,31,91,.341,25,67,.373,6,24,.250,29,34,.853,97,46,85,.541,38,67,.567,8,18,.444,22,29,.759,122,2012-12-16,SAC,DEN
92,Home,W 97-91 ,240,35,72,.486,25,43,.581,10,29,.345,17,22,.773,97,35,84,.417,32,72,.444,3,12,.250,18,30,.600,91,2012-12-19,TOR,DET
93,Home,W 97-85 ,240,37,87,.425,30,64,.469,7,23,.304,16,24,.667,97,33,79,.418,25,57,.439,8,22,.364,11,16,.688,85,2012-12-21,LAC,SAC
94,@,W 97-93 ,240,36,83,.434,29,65,.446,7,18,.389,18,25,.720,97,38,76,.500,29,56,.518,9,20,.450,8,15,.533,93,2012-12-23,UTA,ORL
95,Home,L 97-120 ,240,37,83,.446,31,63,.492,6,20,.300,17,20,.850,97,46,82,.561,38,62,.613,8,20,.400,20,24,.833,120,2012-12-25,CHI,HOU
96,@,L 97-103 ,240,30,71,.423,25,55,.455,5,16,.313,32,38,.842,97,38,80,.475,30,52,.577,8,28,.286,19,19,1.000,103,2012-12-25,OKC,MIA
97,@,W 97-94 ,240,38,76,.500,36,64,.563,2,12,.167,19,20,.950,97,36,79,.456,25,49,.510,11,30,.367,11,13,.846,94,2012-12-26,NOH,ORL
98,Home,L 97-99 ,240,38,83,.458,30,62,.484,8,21,.381,13,16,.813,97,40,88,.455,31,66,.470,9,22,.409,10,14,.714,99,2012-12-26,PHO,NYK
99,Home,W 97-81 ,240,34,76,.447,25,49,.510,9,27,.333,20,26,.769,97,28,73,.384,25,63,.397,3,10,.300,22,32,.688,81,2012-12-28,BRK,CHA
0,Home,W 97-91 ,240,34,77,.442,26,61,.426,8,16,.500,21,29,.724,97,38,82,.463,36,68,.529,2,14,.143,13,16,.813,91,2012-12-28,IND,PHO
1,Home,L 97-104 (OT),265,37,82,.451,32,69,.464,5,13,.385,18,24,.750,97,37,85,.435,32,61,.525,5,24,.208,25,32,.781,104,2012-12-28,NOH,TOR
2,@,L 97-105 ,240,39,86,.453,29,58,.500,10,28,.357,9,11,.818,97,42,88,.477,36,68,.529,6,20,.300,15,17,.882,105,2012-12-28,ORL,WAS
3,@,L 97-103 ,240,36,86,.419,27,60,.450,9,26,.346,16,21,.762,97,39,75,.520,31,55,.564,8,20,.400,17,22,.773,103,2013-01-01,SAC,DET
4,@,W 97-94 ,240,38,88,.432,35,72,.486,3,16,.188,18,23,.783,97,34,87,.391,29,66,.439,5,21,.238,21,24,.875,94,2013-01-02,SAC,CLE
5,Home,L 97-101 ,240,40,86,.465,34,64,.531,6,22,.273,11,20,.550,97,37,83,.446,31,67,.463,6,16,.375,21,30,.700,101,2013-01-03,DEN,MIN
6,Home,L 97-102 ,240,38,91,.418,33,75,.440,5,16,.313,16,18,.889,97,37,86,.430,21,62,.339,16,24,.667,12,13,.923,102,2013-01-05,MIN,POR
7,@,L 97-103 ,240,35,92,.380,20,49,.408,15,43,.349,12,19,.632,97,41,86,.477,35,71,.493,6,15,.400,15,18,.833,103,2013-01-11,POR,GSW
8,@,W 97-81 ,240,36,73,.493,30,59,.508,6,14,.429,19,25,.760,97,32,88,.364,30,77,.390,2,11,.182,15,21,.714,81,2013-01-12,PHO,CHI
9,Home,W 97-86 ,240,33,81,.407,27,67,.403,6,14,.429,25,31,.806,97,35,83,.422,29,59,.492,6,24,.250,10,12,.833,86,2013-01-13,BRK,IND
10,Home,W 97-58 ,240,33,79,.418,27,65,.415,6,14,.429,25,33,.758,97,24,82,.293,22,68,.324,2,14,.143,8,10,.800,58,2013-01-14,CHI,ATL
11,@,L 97-104 ,240,39,72,.542,30,49,.612,9,23,.391,10,16,.625,97,36,76,.474,28,58,.483,8,18,.444,24,28,.857,104,2013-01-14,MIA,UTA
12,@,L 97-117 ,240,33,73,.452,31,58,.534,2,15,.133,29,37,.784,97,44,85,.518,35,66,.530,9,19,.474,20,26,.769,117,2013-01-16,DEN,OKC
13,Home,W 97-86 ,240,40,86,.465,28,65,.431,12,21,.571,5,5,1.000,97,37,85,.435,35,68,.515,2,17,.118,10,12,.833,86,2013-01-16,ORL,IND
14,@,W 97-93 ,240,37,81,.457,32,63,.508,5,18,.278,18,21,.857,97,31,72,.431,26,57,.456,5,15,.333,26,38,.684,93,2013-01-19,SAC,CHA
15,Home,L 97-109 ,240,39,84,.464,35,68,.515,4,16,.250,15,21,.714,97,41,78,.526,26,51,.510,15,27,.556,12,14,.857,109,2013-01-22,LAC,OKC
16,@,W 97-95 ,240,39,78,.500,35,62,.565,4,16,.250,15,19,.789,97,35,81,.432,27,63,.429,8,18,.444,17,20,.850,95,2013-01-24,TOR,ORL
17,Home,W 97-80 ,240,38,75,.507,32,56,.571,6,19,.316,15,22,.682,97,28,81,.346,24,54,.444,4,27,.148,20,23,.870,80,2013-01-26,PHI,NYK
18,Home,W 97-77 ,240,37,74,.500,24,45,.533,13,29,.448,10,12,.833,97,32,79,.405,26,52,.500,6,27,.222,7,9,.778,77,2013-01-28,BRK,ORL
19,@,L 97-113 ,240,38,77,.494,31,51,.608,7,26,.269,14,16,.875,97,47,82,.573,33,48,.688,14,34,.412,5,8,.625,113,2013-01-30,ORL,NYK
20,@,L 97-100 ,240,36,81,.444,28,56,.500,8,25,.320,17,24,.708,97,36,84,.429,29,64,.453,7,20,.350,21,25,.840,100,2013-01-31,DAL,GSW
21,Home,W 97-84 ,240,42,84,.500,38,66,.576,4,18,.222,9,14,.643,97,36,95,.379,33,76,.434,3,19,.158,9,9,1.000,84,2013-02-01,BOS,ORL
22,Home,L 97-98 ,240,41,92,.446,36,78,.462,5,14,.357,10,15,.667,97,39,83,.470,33,63,.524,6,20,.300,14,22,.636,98,2013-02-03,DET,LAL
23,@,L 97-107 ,240,35,70,.500,28,58,.483,7,12,.583,20,26,.769,97,44,80,.550,38,64,.594,6,16,.375,13,14,.929,107,2013-02-10,LAL,MIA
24,@,W 97-69 ,240,34,76,.447,25,59,.424,9,17,.529,20,27,.741,97,30,91,.330,26,77,.338,4,14,.286,5,5,1.000,69,2013-02-10,OKC,PHO
25,@,W 97-93 ,240,38,87,.437,36,76,.474,2,11,.182,19,25,.760,97,29,85,.341,24,63,.381,5,22,.227,30,38,.789,93,2013-02-13,UTA,MIN
26,Home,W 97-90 ,240,33,77,.429,26,57,.456,7,20,.350,24,36,.667,97,35,79,.443,28,59,.475,7,20,.350,13,16,.813,90,2013-02-19,DEN,BOS
27,@,W 97-94 ,240,34,85,.400,25,59,.424,9,26,.346,20,26,.769,97,35,75,.467,29,61,.475,6,14,.429,18,31,.581,94,2013-02-20,BRK,MIL
28,@,W 97-87 ,240,32,72,.444,27,55,.491,5,17,.294,28,35,.800,97,30,81,.370,27,72,.375,3,9,.333,24,33,.727,87,2013-02-24,SAS,PHO
29,@,L 97-108 ,240,33,76,.434,21,55,.382,12,21,.571,19,24,.792,97,41,84,.488,35,63,.556,6,21,.286,20,27,.741,108,2013-02-26,GSW,IND
30,Home,L 97-101 ,240,40,87,.460,35,73,.479,5,14,.357,12,15,.800,97,37,76,.487,25,56,.446,12,20,.600,15,18,.833,101,2013-02-26,NOH,BRK
31,@,L 97-104 ,240,36,86,.419,26,60,.433,10,26,.385,15,19,.789,97,44,85,.518,32,67,.478,12,18,.667,4,9,.444,104,2013-03-02,GSW,PHI
32,Home,W 97-92 ,240,33,71,.465,27,58,.466,6,13,.462,25,33,.758,97,35,81,.432,27,62,.435,8,19,.421,14,18,.778,92,2013-03-03,IND,CHI
33,Home,L 97-102 ,240,37,73,.507,31,53,.585,6,20,.300,17,24,.708,97,36,78,.462,24,48,.500,12,30,.400,18,21,.857,102,2013-03-04,CLE,NYK
34,@,W 97-81 ,240,38,74,.514,33,53,.623,5,21,.238,16,19,.842,97,33,88,.375,28,68,.412,5,20,.250,10,15,.667,81,2013-03-04,MIA,MIN
35,Home,W 97-96 ,240,32,74,.432,26,46,.565,6,28,.214,27,31,.871,97,40,89,.449,34,61,.557,6,28,.214,10,12,.833,96,2013-03-06,MIA,ORL
36,@,L 97-129 ,240,30,64,.469,19,41,.463,11,23,.478,26,42,.619,97,50,80,.625,36,52,.692,14,28,.500,15,25,.600,129,2013-03-10,DET,LAC
37,@,L 97-106 ,240,40,81,.494,34,62,.548,6,19,.316,11,16,.688,97,40,76,.526,32,61,.525,8,15,.533,18,27,.667,106,2013-03-11,BRK,PHI
38,Home,L 97-106 ,240,37,93,.398,27,61,.443,10,32,.313,13,17,.765,97,34,73,.466,25,48,.521,9,25,.360,29,47,.617,106,2013-03-12,ORL,LAL
39,Home,L 97-102 ,240,32,79,.405,27,63,.429,5,16,.313,28,29,.966,97,39,76,.513,36,65,.554,3,11,.273,21,31,.677,102,2013-03-12,POR,MEM
40,@,L 97-105 ,240,40,89,.449,35,72,.486,5,17,.294,12,14,.857,97,41,72,.569,33,54,.611,8,18,.444,15,25,.600,105,2013-03-13,DET,GSW
41,Home,W 97-95 ,240,36,64,.563,31,49,.633,5,15,.333,20,27,.741,97,39,85,.459,34,72,.472,5,13,.385,12,16,.750,95,2013-03-17,MIN,NOH
42,@,W 97-89 ,240,34,80,.425,29,59,.492,5,21,.238,24,33,.727,97,38,92,.413,33,76,.434,5,16,.313,8,10,.800,89,2013-03-22,OKC,ORL
43,@,L 97-104 (OT),265,41,96,.427,33,79,.418,8,17,.471,7,12,.583,97,39,84,.464,31,64,.484,8,20,.400,18,24,.750,104,2013-03-22,UTA,SAS
44,Home,L 97-104 ,240,39,78,.500,33,66,.500,6,12,.500,13,19,.684,97,41,89,.461,31,63,.492,10,26,.385,12,17,.706,104,2013-03-24,MIN,CHI
45,@,L 97-101 ,240,37,77,.481,30,57,.526,7,20,.350,16,23,.696,97,40,85,.471,32,63,.508,8,22,.364,13,18,.722,101,2013-03-27,MIA,CHI
46,@,W 97-87 ,240,42,86,.488,35,68,.515,7,18,.389,6,10,.600,97,37,86,.430,33,68,.485,4,18,.222,9,15,.600,87,2013-03-29,PHI,CLE
47,Home,W 97-92 ,240,37,86,.430,32,71,.451,5,15,.333,18,22,.818,97,30,81,.370,26,61,.426,4,20,.200,28,32,.875,92,2013-03-29,ORL,WAS
48,Home,W 97-88 ,240,34,78,.436,28,57,.491,6,21,.286,23,31,.742,97,34,87,.391,30,74,.405,4,13,.308,16,27,.593,88,2013-03-30,ATL,ORL
49,@,W 97-91 ,240,36,89,.404,33,76,.434,3,13,.231,22,26,.846,97,36,89,.404,30,67,.448,6,22,.273,13,22,.591,91,2013-04-05,CLE,BOS
50,@,W 97-75 ,240,37,78,.474,33,66,.500,4,12,.333,19,23,.826,97,27,72,.375,25,51,.490,2,21,.095,19,24,.792,75,2013-04-05,OKC,IND
51,@,L 97-99 ,240,35,83,.422,30,71,.423,5,12,.417,22,25,.880,97,36,80,.450,33,65,.508,3,15,.200,24,29,.828,99,2013-04-06,ATL,SAS
52,@,W 97-90 ,240,40,88,.455,29,63,.460,11,25,.440,6,7,.857,97,35,74,.473,28,57,.491,7,17,.412,13,18,.722,90,2013-04-07,UTA,GSW
53,Home,L 97-116 ,240,37,84,.440,30,68,.441,7,16,.438,16,26,.615,97,42,83,.506,30,56,.536,12,27,.444,20,23,.870,116,2013-04-11,GSW,OKC
54,Home,W 97-88 ,240,34,72,.472,32,64,.500,2,8,.250,27,33,.818,97,34,77,.442,25,59,.424,9,18,.500,11,14,.786,88,2013-04-12,TOR,CHI
55,@,W 97-86 ,240,40,93,.430,33,71,.465,7,22,.318,10,11,.909,97,36,87,.414,35,74,.473,1,13,.077,13,21,.619,86,2013-04-12,PHI,WAS
56,Home,L 97-103 ,240,34,76,.447,25,57,.439,9,19,.474,20,25,.800,97,38,80,.475,31,59,.525,7,21,.333,20,25,.800,103,2013-04-15,DAL,MEM
57,Home,W 97-87 ,240,34,71,.479,27,54,.500,7,17,.412,22,32,.688,97,36,93,.387,27,74,.365,9,19,.474,6,10,.600,87,2013-10-29,IND,ORL
58,@,W 97-90 ,240,31,78,.397,24,55,.436,7,23,.304,28,38,.737,97,37,84,.440,31,67,.463,6,17,.353,10,18,.556,90,2013-11-02,TOR,MIL
59,Home,L 97-102 ,240,35,82,.427,27,54,.500,8,28,.286,19,23,.826,97,30,71,.423,22,50,.440,8,21,.381,34,42,.810,102,2013-11-05,NYK,CHA
60,Home,W 97-87 ,240,40,89,.449,33,69,.478,7,20,.350,10,14,.714,97,37,80,.463,36,70,.514,1,10,.100,12,18,.667,87,2013-11-06,BOS,UTA
61,Home,W 97-80 ,240,36,86,.419,29,68,.426,7,18,.389,18,21,.857,97,26,73,.356,21,58,.362,5,15,.333,23,27,.852,80,2013-11-06,IND,CHI
62,@,L 97-102 ,240,36,73,.493,28,49,.571,8,24,.333,17,21,.810,97,38,71,.535,33,55,.600,5,16,.313,21,33,.636,102,2013-11-07,LAC,MIA
63,Home,W 97-73 ,240,38,72,.528,35,64,.547,3,8,.375,18,25,.720,97,25,85,.294,18,65,.277,7,20,.350,16,25,.640,73,2013-11-08,CHI,UTA
64,@,W 97-90 ,240,38,85,.447,32,62,.516,6,23,.261,15,24,.625,97,34,80,.425,24,55,.436,10,25,.400,12,17,.706,90,2013-11-15,DET,SAC
65,@,W 97-81 ,240,35,69,.507,29,54,.537,6,15,.400,21,23,.913,97,29,83,.349,21,56,.375,8,27,.296,15,20,.750,81,2013-11-16,MIA,CHA
66,@,W 97-86 ,240,40,72,.556,36,59,.610,4,13,.308,13,18,.722,97,33,87,.379,26,64,.406,7,23,.304,13,17,.765,86,2013-11-17,MEM,SAC
67,Home,W 97-94 ,240,34,78,.436,25,49,.510,9,29,.310,20,26,.769,97,38,99,.384,32,78,.410,6,21,.286,12,22,.545,94,2013-11-18,DAL,PHI
68,Home,W 97-87 ,240,38,84,.452,29,63,.460,9,21,.429,12,22,.545,97,38,98,.388,35,88,.398,3,10,.300,8,14,.571,87,2013-11-21,DEN,CHI
69,@,W 97-82 ,240,38,81,.469,32,64,.500,6,17,.353,15,18,.833,97,35,69,.507,30,58,.517,5,11,.455,7,9,.778,82,2013-11-22,IND,BOS
70,Home,L 97-109 ,240,35,77,.455,21,51,.412,14,26,.538,13,18,.722,97,38,80,.475,33,63,.524,5,17,.294,28,40,.700,109,2013-11-24,BRK,DET
71,Home,W 97-95 ,240,31,71,.437,22,47,.468,9,24,.375,26,34,.765,97,34,83,.410,28,61,.459,6,22,.273,21,25,.840,95,2013-11-29,DEN,NYK
72,Home,W 97-93 ,240,37,78,.474,30,63,.476,7,15,.467,16,19,.842,97,39,82,.476,33,67,.493,6,15,.400,9,15,.600,93,2013-11-30,CLE,CHI
73,@,W 97-88 ,240,34,73,.466,25,55,.455,9,18,.500,20,26,.769,97,36,77,.468,29,62,.468,7,15,.467,9,12,.750,88,2013-11-30,BRK,MEM
74,Home,L 97-107 ,240,36,82,.439,27,54,.500,9,28,.321,16,23,.696,97,41,80,.513,34,64,.531,7,16,.438,18,26,.692,107,2013-12-03,MIA,DET
75,@,W 97-95 ,240,36,83,.434,29,63,.460,7,20,.350,18,20,.900,97,35,89,.393,25,60,.417,10,29,.345,15,19,.789,95,2013-12-03,OKC,SAC
76,@,L 97-107 ,240,39,83,.470,35,64,.547,4,19,.211,15,20,.750,97,42,82,.512,30,59,.508,12,23,.522,11,16,.688,107,2013-12-04,LAC,ATL
77,@,W 97-88 ,240,36,79,.456,25,55,.455,11,24,.458,14,19,.737,97,31,88,.352,22,57,.386,9,31,.290,17,19,.895,88,2013-12-04,PHO,HOU
78,Home,L 97-100 ,240,38,94,.404,31,72,.431,7,22,.318,14,15,.933,97,37,86,.430,26,62,.419,11,24,.458,15,22,.682,100,2013-12-04,NOP,DAL
79,@,L 97-106 ,240,35,87,.402,30,68,.441,5,19,.263,22,25,.880,97,37,82,.451,28,59,.475,9,23,.391,23,32,.719,106,2013-12-06,TOR,PHO
80,@,L 97-112 ,240,37,95,.389,32,68,.471,5,27,.185,18,20,.900,97,38,81,.469,29,56,.518,9,25,.360,27,34,.794,112,2013-12-09,DAL,SAC
81,@,L 97-122 ,240,36,87,.414,29,62,.468,7,25,.280,18,31,.581,97,47,99,.475,39,74,.527,8,25,.320,20,23,.870,122,2013-12-13,LAL,OKC
82,Home,L 97-113 ,240,40,81,.494,37,67,.552,3,14,.214,14,20,.700,97,39,69,.565,30,48,.625,9,21,.429,26,31,.839,113,2013-12-14,WAS,LAC
83,@,L 97-101 ,240,37,98,.378,29,69,.420,8,29,.276,15,26,.577,97,38,86,.442,31,65,.477,7,21,.333,18,23,.783,101,2013-12-16,MIN,BOS
84,Home,W 97-94 ,240,37,77,.481,32,56,.571,5,21,.238,18,22,.818,97,32,73,.438,27,59,.458,5,14,.357,25,28,.893,94,2013-12-18,MIA,IND
85,Home,L 97-114 ,240,40,89,.449,39,77,.506,1,12,.083,16,26,.615,97,44,79,.557,35,56,.625,9,23,.391,17,23,.739,114,2013-12-21,DET,HOU
86,@,W 97-94 ,240,34,67,.507,23,44,.523,11,23,.478,18,28,.643,97,38,81,.469,30,61,.492,8,20,.400,10,11,.909,94,2013-12-30,MIA,DEN
87,@,L 97-102 ,240,39,77,.506,32,55,.582,7,22,.318,12,21,.571,97,38,81,.469,35,70,.500,3,11,.273,23,27,.852,102,2014-01-05,TOR,MIA
88,@,W 97-83 ,240,40,85,.471,35,68,.515,5,17,.294,12,15,.800,97,31,72,.431,25,56,.446,6,16,.375,15,24,.625,83,2014-01-07,WAS,CHA
89,@,L 97-110 ,240,34,81,.420,23,50,.460,11,31,.355,18,26,.692,97,48,90,.533,43,73,.589,5,17,.294,9,15,.600,110,2014-01-07,LAL,DAL
90,Home,W 97-87 ,240,34,75,.453,24,52,.462,10,23,.435,19,22,.864,97,35,87,.402,26,60,.433,9,27,.333,8,9,.889,87,2014-01-08,ATL,IND
91,@,L 97-99 ,240,38,85,.447,31,66,.470,7,19,.368,14,16,.875,97,38,92,.413,30,66,.455,8,26,.308,15,21,.714,99,2014-01-10,BOS,GSW
92,@,L 97-103 ,240,37,79,.468,33,68,.485,4,11,.364,19,20,.950,97,38,81,.469,32,67,.478,6,14,.429,21,26,.808,103,2014-01-11,CHA,CHI
93,@,L 97-114 ,240,37,84,.440,30,59,.508,7,25,.280,16,17,.941,97,41,75,.547,31,53,.585,10,22,.455,22,26,.846,114,2014-01-15,MIA,WAS
94,@,W 97-87 ,240,37,84,.440,31,62,.500,6,22,.273,17,19,.895,97,32,83,.386,30,72,.417,2,11,.182,21,28,.750,87,2014-01-18,GSW,NOP
95,Home,L 97-102 ,240,33,81,.407,28,58,.483,5,23,.217,26,33,.788,97,38,83,.458,34,63,.540,4,20,.200,22,28,.786,102,2014-01-20,CLE,DAL
96,Home,L 97-114 ,240,33,69,.478,28,58,.483,5,11,.455,26,38,.684,97,42,82,.512,33,61,.541,9,21,.429,21,31,.677,114,2014-01-21,NOP,SAC
97,@,L 97-105 ,240,40,86,.465,33,67,.493,7,19,.368,10,16,.625,97,42,87,.483,32,72,.444,10,15,.667,11,17,.647,105,2014-01-21,POR,OKC
98,Home,L 97-112 ,240,41,87,.471,36,70,.514,5,17,.294,10,12,.833,97,41,90,.456,33,69,.478,8,21,.381,22,24,.917,112,2014-01-21,UTA,MIN
99,Home,W 97-90 ,240,33,75,.440,28,57,.491,5,18,.278,26,47,.553,97,35,82,.427,29,59,.492,6,23,.261,14,21,.667,90,2014-01-28,HOU,SAS
0,Home,W 97-96 ,240,31,73,.425,28,58,.483,3,15,.200,32,37,.865,97,34,77,.442,27,54,.500,7,23,.304,21,23,.913,96,2014-02-01,IND,BRK
1,@,L 97-106 ,240,37,78,.474,31,58,.534,6,20,.300,17,23,.739,97,44,91,.484,34,64,.531,10,27,.370,8,11,.727,106,2014-02-05,MIN,OKC
2,Home,L 97-103 ,240,35,76,.461,23,48,.479,12,28,.429,15,17,.882,97,36,76,.474,27,49,.551,9,27,.333,22,30,.733,103,2014-02-11,PHO,MIA
3,Home,L 97-114 ,240,33,73,.452,27,57,.474,6,16,.375,25,30,.833,97,46,89,.517,33,65,.508,13,24,.542,9,11,.818,114,2014-02-19,ATL,WAS
4,@,L 97-108 ,240,37,94,.394,28,66,.424,9,28,.321,14,20,.700,97,40,83,.482,27,55,.491,13,28,.464,15,16,.938,108,2014-02-23,MIN,POR
5,Home,L 97-102 ,240,38,89,.427,31,68,.456,7,21,.333,14,17,.824,97,39,77,.506,34,64,.531,5,13,.385,19,23,.826,102,2014-03-01,BOS,IND
6,Home,L 97-108 ,240,37,82,.451,30,60,.500,7,22,.318,16,21,.762,97,37,81,.457,32,60,.533,5,21,.238,29,38,.763,108,2014-03-01,SAC,MIN
7,@,L 97-111 ,240,39,86,.453,31,52,.596,8,34,.235,11,13,.846,97,43,80,.538,37,61,.607,6,19,.316,19,24,.792,111,2014-03-07,ATL,GSW
8,Home,L 97-107 ,240,36,87,.414,27,64,.422,9,23,.391,16,18,.889,97,38,88,.432,24,57,.421,14,31,.452,17,23,.739,107,2014-03-08,CLE,NYK
9,@,L 97-101 ,240,35,71,.493,29,48,.604,6,23,.261,21,24,.875,97,34,70,.486,23,50,.460,11,20,.550,22,31,.710,101,2014-03-10,TOR,BRK
10,@,L 97-102 ,240,37,89,.416,34,70,.486,3,19,.158,20,26,.769,97,36,74,.486,23,45,.511,13,29,.448,17,20,.850,102,2014-03-13,MIL,ATL
11,Home,W 97-92 ,240,33,81,.407,19,49,.388,14,32,.438,17,29,.586,97,34,83,.410,26,58,.448,8,25,.320,16,25,.640,92,2014-03-15,ATL,DEN
12,@,W 97-83 ,240,39,85,.459,26,51,.510,13,34,.382,6,7,.857,97,30,85,.353,21,60,.350,9,25,.360,14,16,.875,83,2014-03-17,ATL,CHA
13,@,W 97-85 ,240,31,75,.413,18,50,.360,13,25,.520,22,28,.786,97,29,84,.345,24,62,.387,5,22,.227,22,31,.710,85,2014-03-17,OKC,CHI
14,@,W 97-96 ,240,37,85,.435,28,59,.475,9,26,.346,14,24,.583,97,39,84,.464,28,58,.483,11,26,.423,7,13,.538,96,2014-03-26,CLE,DET
15,@,L 97-108 ,240,37,87,.425,27,63,.429,10,24,.417,13,16,.813,97,39,71,.549,25,42,.595,14,29,.483,16,21,.762,108,2014-03-28,CLE,BRK
16,@,L 97-101 ,240,34,80,.425,25,49,.510,9,31,.290,20,28,.714,97,39,79,.494,33,65,.508,6,14,.429,17,25,.680,101,2014-03-29,ATL,WAS
17,Home,L 97-102 ,240,36,73,.493,31,59,.525,5,14,.357,20,26,.769,97,38,80,.475,35,69,.507,3,11,.273,23,31,.742,102,2014-03-31,NOP,SAC
18,@,L 97-120 ,240,36,86,.419,29,55,.527,7,31,.226,18,23,.783,97,47,83,.566,37,64,.578,10,19,.526,16,26,.615,120,2014-04-06,LAL,LAC
19,@,L 97-105 ,240,37,84,.440,25,58,.431,12,26,.462,11,14,.786,97,40,76,.526,31,53,.585,9,23,.391,16,22,.727,105,2014-04-09,BOS,ATL
20,Home,W 97-88 ,240,34,73,.466,22,44,.500,12,29,.414,17,23,.739,97,35,74,.473,27,54,.500,8,20,.400,10,14,.714,88,2014-04-13,BRK,ORL
21,@,L 97-102 ,240,36,84,.429,29,56,.518,7,28,.250,18,19,.947,97,38,72,.528,29,52,.558,9,20,.450,17,23,.739,102,2014-04-13,OKC,IND
22,@,W 97-91 ,240,40,77,.519,34,62,.548,6,15,.400,11,15,.733,97,38,80,.475,33,54,.611,5,26,.192,10,14,.714,91,2014-04-14,MEM,PHO
23,Home,W 97-91 ,240,37,76,.487,33,66,.500,4,10,.400,19,28,.679,97,38,91,.418,31,70,.443,7,21,.333,8,13,.615,91,2014-10-30,MIN,DET
24,@,W 97-89 ,240,35,79,.443,28,60,.467,7,19,.368,20,27,.741,97,34,74,.459,26,53,.491,8,21,.381,13,16,.813,89,2014-10-31,MEM,IND
25,@,L 97-108 ,240,34,80,.425,25,58,.431,9,22,.409,20,24,.833,97,40,73,.548,36,60,.600,4,13,.308,24,33,.727,108,2014-11-01,MIL,WAS
26,@,W 97-90 ,240,39,81,.481,37,70,.529,2,11,.182,17,23,.739,97,33,77,.429,25,53,.472,8,24,.333,16,25,.640,90,2014-11-08,WAS,IND
27,@,W 97-96 ,240,33,72,.458,27,57,.474,6,15,.400,25,35,.714,97,36,93,.387,30,70,.429,6,23,.261,18,25,.720,96,2014-11-09,UTA,DET
28,Home,W 97-86 ,240,39,90,.433,33,75,.440,6,15,.400,13,15,.867,97,32,74,.432,26,53,.491,6,21,.286,16,21,.762,86,2014-11-10,IND,UTA
29,@,L 97-100 ,240,43,86,.500,38,63,.603,5,23,.217,6,12,.500,97,39,76,.513,30,56,.536,9,20,.450,13,18,.722,100,2014-11-12,UTA,ATL
30,@,W 97-95 ,240,33,70,.471,27,58,.466,6,12,.500,25,32,.781,97,37,86,.430,29,63,.460,8,23,.348,13,14,.929,95,2014-11-12,ORL,NYK
31,Home,W 97-87 ,240,33,78,.423,22,52,.423,11,26,.423,20,27,.741,97,35,89,.393,34,70,.486,1,19,.053,16,17,.941,87,2014-11-15,POR,BRK
32,Home,L 97-106 ,240,34,79,.430,24,50,.480,10,29,.345,19,23,.826,97,41,85,.482,29,54,.537,12,31,.387,12,15,.800,106,2014-11-17,CLE,DEN
33,@,L 97-117 ,240,31,78,.397,26,62,.419,5,16,.313,30,34,.882,97,43,82,.524,32,58,.552,11,24,.458,20,25,.800,117,2014-11-21,NOP,DEN
34,@,W 97-95 ,240,36,72,.500,27,52,.519,9,20,.450,16,23,.696,97,42,86,.488,39,77,.506,3,9,.333,8,10,.800,95,2014-11-24,CHI,UTA
35,Home,L 97-114 ,240,33,85,.388,23,62,.371,10,23,.435,21,27,.778,97,43,75,.573,30,47,.638,13,28,.464,15,23,.652,114,2014-11-25,MIA,GSW
36,Home,L 97-105 ,240,41,94,.436,36,79,.456,5,15,.333,10,15,.667,97,39,92,.424,27,65,.415,12,27,.444,15,20,.750,105,2014-11-26,CHO,POR
37,Home,W 97-82 ,240,40,83,.482,28,57,.491,12,26,.462,5,10,.500,97,31,70,.443,28,54,.519,3,16,.188,17,28,.607,82,2014-11-26,OKC,UTA
38,@,L 97-122 ,240,33,85,.388,25,62,.403,8,23,.348,23,29,.793,97,41,88,.466,33,67,.493,8,21,.381,32,36,.889,122,2014-11-28,PHO,DEN
39,@,L 97-109 ,240,35,89,.393,28,67,.418,7,22,.318,20,26,.769,97,41,78,.526,34,62,.548,7,16,.438,20,32,.625,109,2014-11-29,IND,CLE
40,@,W 97-85 ,240,38,79,.481,35,66,.530,3,13,.231,18,28,.643,97,33,70,.471,32,59,.542,1,11,.091,18,27,.667,85,2014-11-30,MEM,SAC
41,@,L 97-98 ,240,39,87,.448,33,70,.471,6,17,.353,13,14,.929,97,38,82,.463,30,55,.545,8,27,.296,14,18,.778,98,2014-12-02,ORL,GSW
42,Home,L 97-103 ,240,37,77,.481,20,42,.476,17,35,.486,6,9,.667,97,43,80,.538,34,63,.540,9,17,.529,8,12,.667,103,2014-12-09,PHO,MIA
43,Home,W 97-88 ,240,38,83,.458,29,59,.492,9,24,.375,12,17,.706,97,38,83,.458,33,67,.493,5,16,.313,7,14,.500,88,2014-12-15,CLE,CHO
44,@,L 97-104 ,240,37,77,.481,30,58,.517,7,19,.368,16,22,.727,97,41,87,.471,34,64,.531,7,23,.304,15,29,.517,104,2014-12-17,MIL,POR
45,@,L 97-103 ,240,38,82,.463,32,73,.438,6,9,.667,15,19,.789,97,34,75,.453,22,52,.423,12,23,.522,23,30,.767,103,2014-12-18,NYK,CHI
46,Home,L 97-103 ,240,37,94,.394,35,81,.432,2,13,.154,21,24,.875,97,32,73,.438,22,47,.468,10,26,.385,29,33,.879,103,2014-12-19,MEM,CHI
47,Home,L 97-104 ,240,34,86,.395,19,43,.442,15,43,.349,14,18,.778,97,38,74,.514,28,48,.583,10,26,.385,18,24,.750,104,2014-12-20,HOU,ATL
48,@,W 97-91 ,240,34,75,.453,25,56,.446,9,19,.474,20,27,.741,97,38,86,.442,31,63,.492,7,23,.304,8,9,.889,91,2014-12-22,UTA,MEM
49,Home,W 97-90 ,240,35,84,.417,29,67,.433,6,17,.353,21,24,.875,97,37,75,.493,31,61,.508,6,14,.429,10,14,.714,90,2014-12-26,NOP,SAS
50,@,L 97-110 ,240,34,77,.442,26,58,.448,8,19,.421,21,36,.583,97,41,88,.466,30,60,.500,11,28,.393,17,21,.810,110,2014-12-27,MIN,GSW
51,@,L 97-101 ,240,38,92,.413,30,73,.411,8,19,.421,13,22,.591,97,37,81,.457,27,58,.466,10,23,.435,17,22,.773,101,2014-12-29,UTA,LAC
52,@,L 97-102 (OT),265,40,99,.404,36,77,.468,4,22,.182,13,15,.867,97,38,95,.400,26,59,.441,12,36,.333,14,18,.778,102,2014-12-30,TOR,POR
53,@,W 97-81 ,240,38,76,.500,25,43,.581,13,33,.394,8,14,.571,97,32,91,.352,22,67,.328,10,24,.417,7,14,.500,81,2015-01-02,DET,NYK
54,@,W 97-77 ,240,37,78,.474,32,62,.516,5,16,.313,18,24,.750,97,28,84,.333,22,64,.344,6,20,.300,15,20,.750,77,2015-01-07,UTA,CHI
55,@,W 97-77 ,240,41,76,.539,33,59,.559,8,17,.471,7,11,.636,97,25,83,.301,23,58,.397,2,25,.080,25,29,.862,77,2015-01-07,MIL,PHI
56,Home,W 97-82 ,240,33,77,.429,20,43,.465,13,34,.382,18,21,.857,97,29,70,.414,24,53,.453,5,17,.294,19,21,.905,82,2015-01-10,HOU,UTA
57,Home,W 97-89 ,240,33,79,.418,25,54,.463,8,25,.320,23,29,.793,97,34,83,.410,25,58,.431,9,25,.360,12,25,.480,89,2015-01-16,DAL,DEN
58,Home,W 97-84 ,240,35,78,.449,23,51,.451,12,27,.444,15,22,.682,97,31,78,.397,19,45,.422,12,33,.364,10,14,.714,84,2015-02-02,CLE,PHI
59,@,L 97-104 ,240,38,90,.422,32,67,.478,6,23,.261,15,18,.833,97,37,75,.493,29,55,.527,8,20,.400,22,26,.846,104,2015-02-02,ORL,OKC
60,Home,L 97-108 ,240,41,83,.494,34,63,.540,7,20,.350,8,11,.727,97,42,77,.545,36,53,.679,6,24,.250,18,23,.783,108,2015-02-03,NYK,BOS
61,@,L 97-103 (OT),265,39,97,.402,28,71,.394,11,26,.423,8,13,.615,97,43,83,.518,38,68,.559,5,15,.333,12,14,.857,103,2015-02-06,LAL,ORL
62,Home,L 97-98 ,240,39,83,.470,30,58,.517,9,25,.360,10,13,.769,97,37,77,.481,29,55,.527,8,22,.364,16,18,.889,98,2015-02-08,ORL,CHI
63,@,L 97-103 ,240,38,76,.500,29,51,.569,9,25,.360,12,19,.632,97,37,89,.416,30,71,.423,7,18,.389,22,25,.880,103,2015-02-09,BRK,MIL
64,@,W 97-86 ,240,35,87,.402,26,57,.456,9,30,.300,18,21,.857,97,32,72,.444,28,56,.500,4,16,.250,18,18,1.000,86,2015-02-22,ATL,MIL
65,@,L 97-100 ,240,35,84,.417,30,61,.492,5,23,.217,22,31,.710,97,40,78,.513,30,56,.536,10,22,.455,10,16,.625,100,2015-02-23,TOR,NOP
66,Home,W 97-77 ,240,35,81,.432,31,68,.456,4,13,.308,23,28,.821,97,33,87,.379,29,69,.420,4,18,.222,7,8,.875,77,2015-02-25,MIN,WAS
67,Home,L 97-100 ,240,34,73,.466,27,61,.443,7,12,.583,22,34,.647,97,40,89,.449,38,78,.487,2,11,.182,18,21,.857,100,2015-02-25,UTA,LAL
68,@,W 97-79 ,240,36,78,.462,27,52,.519,9,26,.346,16,28,.571,97,33,87,.379,30,75,.400,3,12,.250,10,15,.667,79,2015-02-27,LAC,MEM
69,Home,L 97-101 ,240,34,88,.386,27,69,.391,7,19,.368,22,27,.815,97,38,64,.594,34,53,.642,4,11,.364,21,29,.724,101,2015-02-28,MIN,MEM
70,Home,W 97-92 ,240,33,78,.423,24,49,.490,9,29,.310,22,30,.733,97,35,84,.417,27,62,.435,8,22,.364,14,19,.737,92,2015-03-03,CHI,WAS
71,@,L 97-106 ,240,29,69,.420,16,31,.516,13,38,.342,26,33,.788,97,43,84,.512,37,63,.587,6,21,.286,14,17,.824,106,2015-03-06,CLE,ATL
72,Home,W 97-90 ,240,34,77,.442,33,66,.500,1,11,.091,28,33,.848,97,39,84,.464,34,72,.472,5,12,.417,7,9,.778,90,2015-03-06,MEM,LAL
73,@,L 97-99 ,240,37,79,.468,27,52,.519,10,27,.370,13,19,.684,97,38,82,.463,31,59,.525,7,23,.304,16,18,.889,99,2015-03-06,MIA,WAS
74,Home,W 97-91 ,240,39,79,.494,31,61,.508,8,18,.444,11,16,.688,97,34,85,.400,24,67,.358,10,18,.556,13,13,1.000,91,2015-03-11,MIL,ORL
75,@,L 97-106 ,240,36,81,.444,35,68,.515,1,13,.077,24,26,.923,97,45,90,.500,39,66,.591,6,24,.250,10,13,.769,106,2015-03-11,MIN,PHO
76,@,L 97-113 ,240,35,77,.455,29,58,.500,6,19,.316,21,28,.750,97,43,81,.531,30,55,.545,13,26,.500,14,17,.824,113,2015-03-14,SAC,WAS
77,@,L 97-123 ,240,38,86,.442,31,71,.437,7,15,.467,14,18,.778,97,49,84,.583,37,62,.597,12,22,.545,13,15,.867,123,2015-03-15,MIN,SAS
78,Home,L 97-113 ,240,37,78,.474,32,60,.533,5,18,.278,18,23,.783,97,45,86,.523,32,57,.561,13,29,.448,10,16,.625,113,2015-03-15,TOR,POR
79,@,L 97-105 ,240,36,89,.404,28,61,.459,8,28,.286,17,20,.850,97,41,82,.500,34,70,.486,7,12,.583,16,26,.615,105,2015-03-16,POR,WAS
80,Home,W 97-81 ,240,37,88,.420,26,58,.448,11,30,.367,12,15,.800,97,25,69,.362,17,53,.321,8,16,.500,23,26,.885,81,2015-03-20,PHI,NYK
81,Home,W 97-86 ,240,37,89,.416,26,71,.366,11,18,.611,12,16,.750,97,33,76,.434,27,54,.500,6,22,.273,14,15,.933,86,2015-03-21,MEM,POR
82,Home,L 97-105 (OT),265,38,105,.362,30,78,.385,8,27,.296,13,17,.765,97,39,89,.438,30,63,.476,9,26,.346,18,30,.600,105,2015-03-22,BOS,DET
83,Home,L 97-111 ,240,43,82,.524,40,67,.597,3,15,.200,8,8,1.000,97,42,90,.467,35,72,.486,7,18,.389,20,27,.741,111,2015-03-27,ORL,DET
84,Home,L 97-109 ,240,37,82,.451,32,60,.533,5,22,.227,18,24,.750,97,40,86,.465,30,60,.500,10,26,.385,19,26,.731,109,2015-03-29,PHO,OKC
85,Home,W 97-83 ,240,38,83,.458,30,60,.500,8,23,.348,13,17,.765,97,33,81,.407,28,65,.431,5,16,.313,12,20,.600,83,2015-03-30,MEM,SAC
86,@,W 97-84 ,240,40,92,.435,34,71,.479,6,21,.286,11,17,.647,97,29,64,.453,28,53,.528,1,11,.091,25,32,.781,84,2015-04-03,ORL,MIN
87,@,W 97-90 ,240,40,86,.465,32,65,.492,8,21,.381,9,13,.692,97,39,89,.438,34,73,.466,5,16,.313,7,13,.538,90,2015-04-04,ORL,MIL
88,@,L 97-109 ,240,38,83,.458,29,58,.500,9,25,.360,12,20,.600,97,43,85,.506,26,53,.491,17,32,.531,6,12,.500,109,2015-04-13,DET,CLE
89,Home,L 97-107 ,240,32,81,.395,26,53,.491,6,28,.214,27,34,.794,97,40,81,.494,36,72,.500,4,9,.444,23,36,.639,107,2015-04-13,PHI,MIL
90,Home,W 97-95 ,240,37,87,.425,30,68,.441,7,19,.368,16,23,.696,97,38,94,.404,29,65,.446,9,29,.310,10,17,.588,95,2015-10-27,CHI,CLE
91,Home,L 97-122 ,240,30,86,.349,21,68,.309,9,18,.500,28,31,.903,97,42,93,.452,33,70,.471,9,23,.391,29,35,.829,122,2015-10-28,MIL,NYK
92,Home,W 97-94 ,240,36,83,.434,28,60,.467,8,23,.348,17,22,.773,97,36,88,.409,24,58,.414,12,30,.400,10,13,.769,94,2015-10-30,ATL,CHO
93,@,W 97-76 ,240,39,88,.443,33,73,.452,6,15,.400,13,18,.722,97,28,70,.400,24,53,.453,4,17,.235,16,21,.762,76,2015-10-31,UTA,IND
94,@,L 97-118 ,240,40,84,.476,29,60,.483,11,24,.458,6,12,.500,97,45,83,.542,31,60,.517,14,23,.609,14,22,.636,118,2015-11-04,SAC,PHO
95,Home,L 97-105 ,240,36,80,.450,25,47,.532,11,33,.333,14,26,.538,97,39,83,.470,33,70,.471,6,13,.462,21,24,.875,105,2015-11-07,PHI,ORL
96,@,L 97-101 ,240,39,90,.433,33,72,.458,6,18,.333,13,19,.684,97,38,83,.458,30,59,.508,8,24,.333,17,25,.680,101,2015-11-08,IND,CLE
97,Home,W 97-84 ,240,34,77,.442,23,52,.442,11,25,.440,18,22,.818,97,31,78,.397,21,45,.467,10,33,.303,12,17,.706,84,2015-11-09,IND,ORL
98,@,L 97-102 ,240,36,95,.379,21,62,.339,15,33,.455,10,12,.833,97,37,84,.440,33,68,.485,4,16,.250,24,31,.774,102,2015-11-13,CHO,CHI
99,@,W 97-96 ,240,39,76,.513,32,55,.582,7,21,.333,12,17,.706,97,37,76,.487,29,54,.537,8,22,.364,14,17,.824,96,2015-11-15,UTA,ATL
0,Home,W 97-85 ,240,31,75,.413,25,56,.446,6,19,.316,29,39,.744,97,35,96,.365,28,69,.406,7,27,.259,8,15,.533,85,2015-11-15,LAL,DET
1,@,L 97-103 ,240,38,86,.442,33,70,.471,5,16,.313,16,18,.889,97,38,89,.427,29,59,.492,9,30,.300,18,24,.750,103,2015-11-18,SAC,ATL
2,Home,L 97-103 ,240,37,91,.407,29,64,.453,8,27,.296,15,21,.714,97,41,83,.494,32,64,.500,9,19,.474,12,14,.857,103,2015-11-18,PHO,CHI
3,@,L 97-109 ,240,32,86,.372,21,58,.362,11,28,.393,22,25,.880,97,41,85,.482,30,56,.536,11,29,.379,16,19,.842,109,2015-11-21,ATL,CLE
4,@,W 97-95 ,240,38,78,.487,31,59,.525,7,19,.368,14,20,.700,97,36,79,.456,28,53,.528,8,26,.308,15,21,.714,95,2015-11-21,WAS,DET
5,@,W 97-91 ,240,31,81,.383,24,61,.393,7,20,.350,28,31,.903,97,38,92,.413,29,61,.475,9,31,.290,6,8,.750,91,2015-11-21,SAC,ORL
6,@,L 97-121 ,240,34,82,.415,25,61,.410,9,21,.429,20,26,.769,97,45,80,.563,33,56,.589,12,24,.500,19,22,.864,121,2015-11-24,BOS,ATL
7,@,W 97-78 ,240,33,76,.434,26,59,.441,7,17,.412,24,28,.857,97,32,85,.376,29,71,.408,3,14,.214,11,15,.733,78,2015-11-27,MIA,NYK
8,@,W 97-85 ,240,39,83,.470,32,55,.582,7,28,.250,12,16,.750,97,28,83,.337,19,53,.358,9,30,.300,20,23,.870,85,2015-12-01,WAS,CLE
9,Home,W 97-95 ,240,40,81,.494,37,68,.544,3,13,.231,14,24,.583,97,35,79,.443,31,63,.492,4,16,.250,21,24,.875,95,2015-12-03,MIA,OKC
10,Home,L 97-114 ,240,29,77,.377,22,56,.393,7,21,.333,32,41,.780,97,40,84,.476,26,51,.510,14,33,.424,20,24,.833,114,2015-12-03,SAC,BOS
11,Home,L 97-104 ,240,40,84,.476,31,59,.525,9,25,.360,8,9,.889,97,37,82,.451,24,51,.471,13,31,.419,17,20,.850,104,2015-12-07,NYK,DAL
12,Home,W 97-94 ,240,37,64,.578,34,54,.630,3,10,.300,20,22,.909,97,34,76,.447,27,51,.529,7,25,.280,19,24,.792,94,2015-12-09,TOR,SAS
13,@,L 97-99 ,240,33,83,.398,24,54,.444,9,29,.310,22,28,.786,97,42,93,.452,39,77,.506,3,16,.188,12,16,.750,99,2015-12-10,NYK,SAC
14,@,L 97-126 ,240,35,88,.398,25,56,.446,10,32,.313,17,20,.850,97,47,90,.522,32,57,.561,15,33,.455,17,28,.607,126,2015-12-12,LAL,HOU
15,@,L 97-100 ,240,40,77,.519,33,58,.569,7,19,.368,10,14,.714,97,37,77,.481,30,55,.545,7,22,.318,19,23,.826,100,2015-12-13,MEM,MIA
16,@,L 97-107 ,240,34,82,.415,22,43,.512,12,39,.308,17,23,.739,97,38,75,.507,27,51,.529,11,24,.458,20,29,.690,107,2015-12-15,HOU,SAC
17,Home,W 97-88 ,240,34,78,.436,24,49,.490,10,29,.345,19,21,.905,97,30,80,.375,24,63,.381,6,17,.353,22,24,.917,88,2015-12-18,DAL,MEM
18,@,L 97-104 ,240,36,86,.419,28,70,.400,8,16,.500,17,17,1.000,97,37,89,.416,30,61,.492,7,28,.250,23,26,.885,104,2015-12-18,BRK,IND
19,Home,L 97-107 ,240,37,77,.481,31,53,.585,6,24,.250,17,30,.567,97,40,85,.471,34,66,.515,6,19,.316,21,28,.750,107,2015-12-18,PHI,NYK
20,Home,W 97-88 ,240,34,73,.466,24,48,.500,10,25,.400,19,25,.760,97,31,79,.392,25,51,.490,6,28,.214,20,25,.800,88,2015-12-18,UTA,DEN
21,@,L 97-107 ,240,34,86,.395,23,48,.479,11,38,.289,18,29,.621,97,34,76,.447,26,51,.510,8,25,.320,31,49,.633,107,2015-12-19,LAC,HOU
22,@,L 97-106 ,240,38,81,.469,33,57,.579,5,24,.208,16,22,.727,97,37,77,.481,28,48,.583,9,29,.310,23,28,.821,106,2015-12-21,POR,ATL
23,@,L 97-104 ,240,38,88,.432,32,68,.471,6,20,.300,15,24,.625,97,40,87,.460,32,66,.485,8,21,.381,16,24,.667,104,2015-12-28,TOR,CHI
24,Home,L 97-101 ,240,36,79,.456,25,54,.463,11,25,.440,14,20,.700,97,33,71,.465,16,30,.533,17,41,.415,18,25,.720,101,2015-12-28,PHO,CLE
25,Home,L 97-100 ,240,34,88,.386,27,56,.482,7,32,.219,22,28,.786,97,38,93,.409,35,75,.467,3,18,.167,21,22,.955,100,2016-01-02,BOS,BRK
26,Home,W 97-77 ,240,38,84,.452,30,62,.484,8,22,.364,13,17,.765,97,32,89,.360,26,62,.419,6,27,.222,7,9,.778,77,2016-01-03,LAL,PHO
27,@,L 97-111 ,240,37,84,.440,29,58,.500,8,26,.308,15,20,.750,97,44,88,.500,33,62,.532,11,26,.423,12,14,.857,111,2016-01-03,ATL,NYK
28,@,W 97-75 ,240,39,86,.453,30,63,.476,9,23,.391,10,12,.833,97,31,91,.341,27,61,.443,4,30,.133,9,13,.692,75,2016-01-03,MIA,WAS
29,@,W 97-88 ,240,34,75,.453,29,61,.475,5,14,.357,24,26,.923,97,33,84,.393,25,59,.424,8,25,.320,14,15,.933,88,2016-01-08,TOR,WAS
30,Home,W 97-83 ,240,40,91,.440,32,60,.533,8,31,.258,9,10,.900,97,31,84,.369,24,61,.393,7,23,.304,14,19,.737,83,2016-01-09,LAC,CHO
31,@,L 97-116 ,240,36,89,.404,28,64,.438,8,25,.320,17,27,.630,97,41,79,.519,31,55,.564,10,24,.417,24,31,.774,116,2016-01-12,PHO,IND
32,Home,L 97-109 ,240,41,84,.488,35,61,.574,6,23,.261,9,14,.643,97,42,100,.420,26,67,.388,16,33,.485,9,11,.818,109,2016-01-13,SAC,NOP
33,@,W 97-94 ,240,34,83,.410,30,63,.476,4,20,.200,25,34,.735,97,28,81,.346,17,46,.370,11,35,.314,27,29,.931,94,2016-01-19,IND,PHO
34,Home,W 97-84 ,240,28,82,.341,19,51,.373,9,31,.290,32,37,.865,97,29,77,.377,22,53,.415,7,24,.292,19,32,.594,84,2016-01-23,CHO,NYK
35,@,L 97-108 ,240,36,86,.419,29,67,.433,7,19,.368,18,25,.720,97,38,85,.447,33,69,.478,5,16,.313,27,36,.750,108,2016-01-23,IND,SAC
36,@,L 97-112 ,240,36,86,.419,29,67,.433,7,19,.368,18,32,.563,97,44,90,.489,35,60,.583,9,30,.300,15,19,.789,112,2016-01-26,SAC,POR
37,@,L 97-110 ,240,39,82,.476,32,63,.508,7,19,.368,12,17,.706,97,39,91,.429,34,70,.486,5,21,.238,27,38,.711,110,2016-01-27,PHI,DET
38,@,L 97-112 ,240,31,85,.365,24,59,.407,7,26,.269,28,38,.737,97,42,80,.525,28,45,.622,14,35,.400,14,19,.737,112,2016-02-01,DAL,ATL
39,@,W 97-89 ,240,40,90,.444,37,71,.521,3,19,.158,14,17,.824,97,31,82,.378,25,62,.403,6,20,.300,21,28,.750,89,2016-02-02,BOS,NYK
40,Home,L 97-104 ,240,37,79,.468,25,48,.521,12,31,.387,11,15,.733,97,35,74,.473,26,47,.553,9,27,.333,25,32,.781,104,2016-02-02,PHO,TOR
41,@,L 97-106 ,240,38,83,.458,28,55,.509,10,28,.357,11,14,.786,97,39,79,.494,30,52,.577,9,27,.333,19,23,.826,106,2016-02-03,CLE,CHO
42,@,L 97-110 ,240,41,90,.456,38,71,.535,3,19,.158,12,14,.857,97,42,81,.519,33,66,.500,9,15,.600,17,18,.944,110,2016-02-03,NOP,SAS
43,@,L 97-99 ,240,35,74,.473,23,50,.460,12,24,.500,15,21,.714,97,37,73,.507,31,56,.554,6,17,.353,19,26,.731,99,2016-02-26,CLE,TOR
44,Home,W 97-81 ,240,43,84,.512,40,70,.571,3,14,.214,8,9,.889,97,31,78,.397,25,59,.424,6,19,.316,13,23,.565,81,2016-03-02,SAS,DET
45,Home,L 97-107 ,240,34,79,.430,22,47,.468,12,32,.375,17,28,.607,97,40,89,.449,30,62,.484,10,27,.370,17,20,.850,107,2016-03-05,LAC,ATL
46,Home,L 97-128 ,240,39,89,.438,30,60,.500,9,29,.310,10,15,.667,97,46,82,.561,30,58,.517,16,24,.667,20,24,.833,128,2016-03-09,PHO,NYK
47,Home,L 97-111 ,240,35,89,.393,25,60,.417,10,29,.345,17,27,.630,97,45,89,.506,38,67,.567,7,22,.318,14,18,.778,111,2016-03-18,PHI,OKC
48,@,L 97-109 ,240,33,84,.393,28,61,.459,5,23,.217,26,31,.839,97,44,88,.500,30,50,.600,14,38,.368,7,12,.583,109,2016-03-19,HOU,ATL
49,Home,L 97-103 ,240,30,76,.395,19,48,.396,11,28,.393,26,34,.765,97,39,90,.433,31,70,.443,8,20,.400,17,19,.895,103,2016-03-21,PHO,MEM
50,@,L 97-108 ,240,36,84,.429,30,66,.455,6,18,.333,19,28,.679,97,40,80,.500,35,65,.538,5,15,.333,23,33,.697,108,2016-03-25,ORL,MIA
51,@,W 97-88 ,240,36,88,.409,25,56,.446,11,32,.344,14,15,.933,97,31,70,.443,22,46,.478,9,24,.375,17,19,.895,88,2016-03-28,DAL,DEN
52,@,L 97-105 ,240,37,83,.446,23,50,.460,14,33,.424,9,13,.692,97,36,80,.450,25,57,.439,11,23,.478,22,28,.786,105,2016-03-30,ATL,TOR
53,@,L 97-104 ,240,34,78,.436,25,54,.463,9,24,.375,20,23,.870,97,36,87,.414,26,53,.491,10,34,.294,22,27,.815,104,2016-04-06,NOP,BOS
54,Home,L 97-111 ,240,37,78,.474,27,52,.519,10,26,.385,13,15,.867,97,42,90,.467,30,64,.469,12,26,.462,15,17,.882,111,2016-04-06,NYK,CHO
55,Home,L 97-105 ,240,36,85,.424,30,68,.441,6,17,.353,19,21,.905,97,36,80,.450,25,59,.424,11,21,.524,22,31,.710,105,2016-04-07,SAC,MIN
56,@,W 97-92 ,240,39,90,.433,28,66,.424,11,24,.458,8,10,.800,97,37,87,.425,30,64,.469,7,23,.304,11,13,.846,92,2016-04-13,IND,MIL
57,Home,L 97-103 ,240,36,84,.429,29,60,.483,7,24,.292,18,25,.720,97,39,94,.415,33,72,.458,6,22,.273,19,26,.731,103,2016-10-26,PHI,OKC
58,@,W 97-91 ,240,35,92,.380,28,70,.400,7,22,.318,20,24,.833,97,32,86,.372,18,52,.346,14,34,.412,13,20,.650,91,2016-10-28,CHO,MIA
59,Home,W 97-81 ,240,35,77,.455,23,52,.442,12,25,.480,15,26,.577,97,33,77,.429,26,51,.510,7,26,.269,8,10,.800,81,2016-11-02,UTA,DAL
60,@,L 97-117 ,240,39,86,.453,34,54,.630,5,32,.156,14,20,.700,97,45,95,.474,37,65,.569,8,30,.267,19,21,.905,117,2016-11-04,GSW,LAL
61,@,L 97-112 ,240,37,85,.435,25,49,.510,12,36,.333,11,13,.846,97,45,85,.529,37,65,.569,8,20,.400,14,24,.583,112,2016-11-05,HOU,ATL
62,Home,W 97-85 ,240,37,85,.435,28,57,.491,9,28,.321,14,17,.824,97,31,84,.369,27,67,.403,4,17,.235,19,22,.864,85,2016-11-07,OKC,MIA
63,Home,L 97-109 ,240,38,78,.487,28,52,.538,10,26,.385,11,14,.786,97,43,82,.524,33,59,.559,10,23,.435,13,15,.867,109,2016-11-08,LAL,DAL
64,@,L 97-108 ,240,35,73,.479,28,52,.538,7,21,.333,20,26,.769,97,47,90,.522,38,71,.535,9,19,.474,5,7,.714,108,2016-11-25,LAC,DET
65,@,L 97-118 ,240,36,79,.456,25,45,.556,11,34,.324,14,23,.609,97,48,87,.552,37,61,.607,11,26,.423,11,16,.688,118,2016-11-25,BRK,IND
66,Home,W 97-87 ,240,35,74,.473,30,56,.536,5,18,.278,22,31,.710,97,32,86,.372,23,55,.418,9,31,.290,14,18,.778,87,2016-12-01,CHO,DAL
67,Home,W 97-92 ,240,36,88,.409,25,60,.417,11,28,.393,14,15,.933,97,33,88,.375,27,62,.435,6,26,.231,20,25,.800,92,2016-12-02,BOS,SAC
68,@,W 97-96 ,240,40,93,.430,32,65,.492,8,28,.286,9,14,.643,97,30,73,.411,24,49,.490,6,24,.250,30,34,.882,96,2016-12-05,SAS,MIL
69,@,W 97-79 ,240,38,68,.559,31,51,.608,7,17,.412,14,17,.824,97,32,82,.390,27,63,.429,5,19,.263,10,14,.714,79,2016-12-11,PHI,DET
70,@,L 97-107 ,240,35,91,.385,29,64,.453,6,27,.222,21,34,.618,97,33,86,.384,22,51,.431,11,35,.314,30,40,.750,107,2016-12-14,LAL,BRK
71,@,L 97-108 ,240,35,74,.473,30,55,.545,5,19,.263,22,29,.759,97,45,95,.474,34,75,.453,11,20,.550,7,13,.538,108,2016-12-15,CHI,MIL
72,Home,L 97-107 ,240,38,95,.400,32,74,.432,6,21,.286,15,19,.789,97,43,82,.524,40,64,.625,3,18,.167,18,25,.720,107,2016-12-21,CHI,WAS
73,@,W 97-82 ,240,30,74,.405,19,52,.365,11,22,.500,26,32,.813,97,32,82,.390,23,46,.500,9,36,.250,9,10,.900,82,2017-01-07,ATL,DAL
74,Home,L 97-117 ,240,35,87,.402,25,58,.431,10,29,.345,17,23,.739,97,44,92,.478,37,69,.536,7,23,.304,22,38,.579,117,2017-01-10,BRK,ATL
75,@,L 97-98 ,240,42,86,.488,38,64,.594,4,22,.182,9,10,.900,97,37,95,.389,30,67,.448,7,28,.250,17,21,.810,98,2017-01-11,NYK,PHI
76,@,L 97-113 ,240,36,80,.450,26,59,.441,10,21,.476,15,27,.556,97,48,92,.522,38,64,.594,10,28,.357,7,8,.875,113,2017-01-14,LAL,LAC
77,Home,L 97-102 ,240,36,83,.434,30,57,.526,6,26,.231,19,24,.792,97,41,95,.432,32,70,.457,9,25,.360,11,16,.688,102,2017-01-15,LAL,DET
78,@,L 97-109 ,240,33,79,.418,27,61,.443,6,18,.333,25,32,.781,97,41,77,.532,28,47,.596,13,30,.433,14,22,.636,109,2017-01-21,MIL,MIA
79,@,W 97-95 ,240,36,83,.434,30,63,.476,6,20,.300,19,25,.760,97,36,84,.429,31,63,.492,5,21,.238,18,26,.692,95,2017-01-23,OKC,UTA
80,@,L 97-104 ,240,35,75,.467,23,43,.535,12,32,.375,15,21,.714,97,39,86,.453,30,54,.556,9,32,.281,17,18,.944,104,2017-01-30,CLE,DAL
81,@,L 97-125 ,240,41,94,.436,34,73,.466,7,21,.333,8,10,.800,97,48,89,.539,33,52,.635,15,37,.405,14,22,.636,125,2017-02-01,MIN,CLE
82,Home,L 97-106 ,240,32,86,.372,21,58,.362,11,28,.393,22,23,.957,97,37,86,.430,29,66,.439,8,20,.400,24,31,.774,106,2017-02-03,BRK,IND
83,@,L 97-121 ,240,41,92,.446,31,66,.470,10,26,.385,5,10,.500,97,45,79,.570,35,58,.603,10,21,.476,21,26,.808,121,2017-02-04,DEN,SAS
84,@,L 97-115 ,240,37,86,.430,32,67,.478,5,19,.263,18,22,.818,97,48,95,.505,40,76,.526,8,19,.421,11,13,.846,115,2017-02-10,CHI,PHO
85,@,W 97-96 ,240,36,73,.493,29,49,.592,7,24,.292,18,25,.720,97,38,83,.458,26,54,.481,12,29,.414,8,15,.533,96,2017-02-14,SAC,LAL
86,Home,L 97-105 ,240,35,79,.443,28,56,.500,7,23,.304,20,24,.833,97,35,82,.427,26,56,.464,9,26,.346,26,30,.867,105,2017-02-24,LAC,SAS
87,Home,W 97-84 ,240,41,78,.526,36,65,.554,5,13,.385,10,14,.714,97,35,83,.422,27,50,.540,8,33,.242,6,9,.667,84,2017-02-24,MIN,DAL
88,@,L 97-107 ,240,33,78,.423,21,40,.525,12,38,.316,19,22,.864,97,40,81,.494,35,66,.530,5,15,.333,22,29,.759,107,2017-02-24,BOS,TOR
89,@,L 97-112 ,240,36,89,.404,29,59,.492,7,30,.233,18,24,.750,97,38,74,.514,26,48,.542,12,26,.462,24,34,.706,112,2017-03-03,BRK,UTA
90,Home,W 97-90 (OT),265,38,94,.404,32,70,.457,6,24,.250,15,24,.625,97,35,89,.393,31,73,.425,4,16,.250,16,22,.727,90,2017-03-04,SAS,MIN
91,@,W 97-96 ,240,35,78,.449,20,45,.444,15,33,.455,12,21,.571,97,34,77,.442,25,50,.500,9,27,.333,19,31,.613,96,2017-03-05,IND,ATL
92,Home,L 97-105 ,240,38,83,.458,28,55,.509,10,28,.357,11,15,.733,97,36,89,.404,27,65,.415,9,24,.375,24,35,.686,105,2017-03-05,LAL,NOP
93,Home,W 96-95 ,240,38,86,.442,34,67,.507,4,19,.211,16,21,.762,96,34,84,.405,26,61,.426,8,23,.348,19,23,.826,95,2011-12-26,CHA,MIL
94,Home,L 96-104 ,240,35,85,.412,29,65,.446,6,20,.300,20,28,.714,96,42,79,.532,33,58,.569,9,21,.429,11,13,.846,104,2011-12-26,CLE,TOR
95,Home,W 96-71 ,240,30,71,.423,24,55,.436,6,16,.375,30,37,.811,96,29,90,.322,28,77,.364,1,13,.077,12,17,.706,71,2011-12-27,LAL,UTA
96,@,W 96-95 ,240,36,78,.462,35,72,.486,1,6,.167,23,28,.821,96,39,82,.476,32,64,.500,7,18,.389,10,16,.625,95,2011-12-28,MIA,CHA
97,Home,W 96-85 ,240,35,67,.522,28,51,.549,7,16,.438,19,19,1.000,96,34,79,.430,31,63,.492,3,16,.188,14,15,.933,85,2011-12-30,BOS,DET
98,Home,W 96-88 ,240,39,82,.476,31,67,.463,8,15,.533,10,13,.769,96,30,76,.395,25,61,.410,5,15,.333,23,28,.821,88,2011-12-31,DET,IND
99,@,L 96-102 ,240,32,70,.457,27,57,.474,5,13,.385,27,29,.931,96,37,75,.493,25,48,.521,12,27,.444,16,24,.667,102,2012-01-01,TOR,ORL
0,Home,W 96-80 ,240,35,85,.412,27,62,.435,8,23,.348,18,21,.857,96,36,89,.404,36,74,.486,0,15,.000,8,16,.500,80,2012-01-01,SAC,NOH
1,@,L 96-106 ,240,36,82,.439,29,62,.468,7,20,.350,17,21,.810,96,41,71,.577,29,50,.580,12,21,.571,12,15,.800,106,2012-01-02,SAS,MIN
2,@,L 96-113 ,240,34,83,.410,25,59,.424,9,24,.375,19,23,.826,96,50,91,.549,48,83,.578,2,8,.250,11,16,.688,113,2012-01-03,SAC,MEM
3,@,L 96-107 ,240,37,79,.468,37,68,.544,0,11,.000,22,27,.815,96,41,89,.461,36,77,.468,5,12,.417,20,26,.769,107,2012-01-05,LAL,POR
4,Home,L 96-102 (OT),265,40,87,.460,33,69,.478,7,18,.389,9,13,.692,96,42,95,.442,35,75,.467,7,20,.350,11,16,.688,102,2012-01-06,CHA,ATL
5,@,W 96-88 ,240,37,79,.468,32,58,.552,5,21,.238,17,22,.773,96,36,77,.468,28,60,.467,8,17,.471,8,10,.800,88,2012-01-06,DEN,NOH
6,Home,W 96-73 ,240,39,85,.459,34,67,.507,5,18,.278,13,16,.813,96,31,86,.360,31,76,.408,0,10,.000,11,14,.786,73,2012-01-06,PHI,DET
7,Home,L 96-99 ,240,41,85,.482,35,71,.493,6,14,.429,8,13,.615,96,39,89,.438,33,71,.465,6,18,.333,15,21,.714,99,2012-01-06,WAS,NYK
8,Home,W 96-81 ,240,32,74,.432,24,55,.436,8,19,.421,24,29,.828,96,26,64,.406,20,53,.377,6,11,.545,23,28,.821,81,2012-01-07,DAL,NOH
9,@,L 96-108 ,240,35,84,.417,28,72,.389,7,12,.583,19,25,.760,96,38,75,.507,31,56,.554,7,19,.368,25,29,.862,108,2012-01-08,SAS,OKC
10,Home,W 96-86 ,240,38,76,.500,32,59,.542,6,17,.353,14,19,.737,96,30,82,.366,26,69,.377,4,13,.308,22,30,.733,86,2012-01-09,PHI,IND
11,Home,W 96-84 ,240,39,85,.459,33,71,.465,6,14,.429,12,16,.750,96,30,80,.375,25,67,.373,5,13,.385,19,27,.704,84,2012-01-11,IND,ATL
12,Home,L 96-106 ,240,32,75,.427,26,59,.441,6,16,.375,26,39,.667,96,44,85,.518,40,73,.548,4,12,.333,14,20,.700,106,2012-01-15,DEN,UTA
13,Home,W 96-89 ,240,36,78,.462,29,56,.518,7,22,.318,17,26,.654,96,36,77,.468,31,60,.517,5,17,.294,12,17,.706,89,2012-01-17,ORL,CHA
14,Home,W 96-73 ,240,34,71,.479,28,55,.509,6,16,.375,22,32,.688,96,26,69,.377,22,54,.407,4,15,.267,17,20,.850,73,2012-01-18,BOS,TOR
15,Home,L 96-98 ,240,36,86,.419,34,77,.442,2,9,.222,22,33,.667,96,36,77,.468,26,59,.441,10,18,.556,16,19,.842,98,2012-01-22,LAL,IND
16,Home,L 96-99 ,240,39,82,.476,34,66,.515,5,16,.313,13,17,.765,96,34,82,.415,26,67,.388,8,15,.533,23,25,.920,99,2012-01-24,PHO,TOR
17,Home,W 96-91 ,240,32,66,.485,24,50,.480,8,16,.500,24,32,.750,96,37,87,.425,29,64,.453,8,23,.348,9,14,.643,91,2012-01-25,LAL,LAC
18,Home,L 96-99 ,240,38,81,.469,32,62,.516,6,19,.316,14,24,.583,96,36,79,.456,25,51,.490,11,28,.393,16,21,.762,99,2012-01-27,CLE,NJN
19,Home,W 96-81 ,240,32,70,.457,24,43,.558,8,27,.296,24,32,.750,96,32,82,.390,25,63,.397,7,19,.368,10,14,.714,81,2012-01-27,DEN,TOR
20,Home,W 96-93 ,240,35,79,.443,28,61,.459,7,18,.389,19,23,.826,96,37,80,.463,31,67,.463,6,13,.462,13,14,.929,93,2012-01-28,UTA,SAC
21,@,L 96-99 ,240,40,82,.488,35,64,.547,5,18,.278,11,14,.786,96,38,79,.481,30,56,.536,8,23,.348,15,25,.600,99,2012-02-01,DET,NJN
22,@,W 96-77 ,240,41,85,.482,39,78,.500,2,7,.286,12,19,.632,96,33,75,.440,28,60,.467,5,15,.333,6,9,.667,77,2012-02-02,MEM,ATL
23,@,L 96-107 ,240,36,77,.468,29,56,.518,7,21,.333,17,28,.607,96,37,88,.420,25,65,.385,12,23,.522,21,25,.840,107,2012-02-04,OKC,SAS
24,Home,W 96-87 ,240,39,87,.448,35,75,.467,4,12,.333,14,20,.700,96,29,75,.387,25,61,.410,4,14,.286,25,30,.833,87,2012-02-04,UTA,LAL
25,Home,L 96-103 ,240,35,74,.473,28,56,.500,7,18,.389,19,22,.864,96,41,78,.526,31,55,.564,10,23,.435,11,19,.579,103,2012-02-08,POR,HOU
26,@,W 96-89 ,240,42,86,.488,34,70,.486,8,16,.500,4,6,.667,96,35,74,.473,26,47,.553,9,27,.333,10,16,.625,89,2012-02-09,HOU,PHO
27,Home,W 96-92 ,240,35,79,.443,29,61,.475,6,18,.333,20,28,.714,96,33,74,.446,23,47,.489,10,27,.370,16,25,.640,92,2012-02-13,DAL,LAC
28,@,L 96-102 ,240,38,82,.463,33,57,.579,5,25,.200,15,19,.789,96,39,86,.453,32,68,.471,7,18,.389,17,21,.810,102,2012-02-13,PHO,GSW
29,Home,L 96-114 ,240,33,84,.393,24,61,.393,9,23,.391,21,25,.840,96,43,83,.518,36,69,.522,7,14,.500,21,25,.840,114,2012-02-13,MIL,MIA
30,Home,W 96-95 ,240,37,87,.425,29,69,.420,8,18,.444,14,18,.778,96,36,83,.434,29,60,.483,7,23,.304,16,18,.889,95,2012-02-15,HOU,OKC
31,Home,W 96-81 ,240,31,82,.378,26,73,.356,5,9,.556,29,46,.630,96,32,72,.444,26,56,.464,6,16,.375,11,15,.733,81,2012-02-19,DET,BOS
32,@,W 96-91 ,240,35,76,.461,27,56,.482,8,20,.400,18,31,.581,96,36,90,.400,28,58,.483,8,32,.250,11,16,.688,91,2012-02-22,LAL,DAL
33,@,L 96-103 ,240,40,85,.471,35,72,.486,5,13,.385,11,22,.500,96,37,84,.440,32,64,.500,5,20,.250,24,29,.828,103,2012-02-28,UTA,SAC
34,@,L 96-102 ,240,39,96,.406,35,81,.432,4,15,.267,14,16,.875,96,40,87,.460,37,71,.521,3,16,.188,19,28,.679,102,2012-02-29,MIL,BOS
35,Home,W 96-85 ,240,39,80,.488,37,68,.544,2,12,.167,16,19,.842,96,35,79,.443,31,56,.554,4,23,.174,11,14,.786,85,2012-02-29,MEM,DAL
36,@,W 96-89 ,240,37,88,.420,30,73,.411,7,15,.467,15,21,.714,96,37,86,.430,29,66,.439,8,20,.400,7,12,.583,89,2012-02-29,CHI,SAS
37,@,L 96-102 ,240,38,85,.447,34,69,.493,4,16,.250,16,21,.762,96,36,75,.480,26,52,.500,10,23,.435,20,24,.833,102,2012-03-03,UTA,DAL
38,@,W 96-91 ,240,39,82,.476,32,66,.485,7,16,.438,11,16,.688,96,38,97,.392,37,86,.430,1,11,.091,14,17,.824,91,2012-03-04,CHI,PHI
39,Home,W 96-88 ,240,40,88,.455,35,76,.461,5,12,.417,11,16,.688,96,38,99,.384,36,86,.419,2,13,.154,10,14,.714,88,2012-03-04,PHO,SAC
40,Home,L 96-101 ,240,31,70,.443,26,55,.473,5,15,.333,29,40,.725,96,38,83,.458,30,64,.469,8,19,.421,17,22,.773,101,2012-03-06,IND,ATL
41,Home,W 96-94 ,240,37,76,.487,34,62,.548,3,14,.214,19,27,.704,96,38,87,.437,30,65,.462,8,22,.364,10,13,.769,94,2012-03-08,PHO,DAL
42,@,W 96-90 ,240,38,91,.418,33,74,.446,5,17,.294,15,24,.625,96,37,76,.487,31,52,.596,6,24,.250,10,17,.588,90,2012-03-09,CLE,OKC
43,@,W 96-88 ,240,37,74,.500,29,55,.527,8,19,.421,14,21,.667,96,29,76,.382,26,61,.426,3,15,.200,27,33,.818,88,2012-03-13,TOR,CLE
44,Home,W 96-82 ,240,38,70,.543,28,50,.560,10,20,.500,10,17,.588,96,29,68,.426,21,43,.488,8,25,.320,16,20,.800,82,2012-03-14,LAC,ATL
45,@,L 96-101 ,240,35,84,.417,27,63,.429,8,21,.381,18,20,.900,96,38,84,.452,29,59,.492,9,25,.360,16,21,.762,101,2012-03-15,CHA,DAL
46,@,L 96-103 ,240,36,82,.439,28,62,.452,8,20,.400,16,19,.842,96,40,85,.471,34,66,.515,6,19,.316,17,26,.654,103,2012-03-23,POR,LAL
47,Home,W 96-79 ,240,38,83,.458,37,70,.529,1,13,.077,19,26,.731,96,32,85,.376,27,57,.474,5,28,.179,10,18,.556,79,2012-03-23,TOR,NYK
48,Home,L 96-102 ,240,31,73,.425,24,55,.436,7,18,.389,27,30,.900,96,44,86,.512,38,73,.521,6,13,.462,8,10,.800,102,2012-03-25,LAL,MEM
49,@,L 96-105 ,240,33,80,.413,28,60,.467,5,20,.250,25,30,.833,96,35,86,.407,23,64,.359,12,22,.545,23,33,.697,105,2012-03-28,DEN,TOR
50,@,L 96-105 ,240,35,77,.455,31,65,.477,4,12,.333,22,31,.710,96,39,72,.542,29,51,.569,10,21,.476,17,24,.708,105,2012-03-31,UTA,LAC
51,Home,L 96-109 ,240,39,84,.464,33,66,.500,6,18,.333,12,19,.632,96,44,76,.579,40,65,.615,4,11,.364,17,19,.895,109,2012-04-04,WAS,IND
52,@,W 96-80 ,240,38,78,.487,25,53,.472,13,25,.520,7,15,.467,96,30,72,.417,21,48,.438,9,24,.375,11,16,.688,80,2012-04-05,NYK,ORL
53,@,L 96-101 ,240,37,78,.474,30,63,.476,7,15,.467,15,22,.682,96,39,81,.481,35,66,.530,4,15,.267,19,27,.704,101,2012-04-06,DET,ATL
54,Home,L 96-116 ,240,38,81,.469,35,74,.473,3,7,.429,17,24,.708,96,43,82,.524,34,62,.548,9,20,.450,21,23,.913,116,2012-04-07,CHA,ATL
55,@,L 96-105 ,240,36,83,.434,29,61,.475,7,22,.318,17,23,.739,96,38,68,.559,34,59,.576,4,9,.444,25,36,.694,105,2012-04-11,SAC,NOH
56,Home,W 96-86 (OT),265,37,86,.430,26,64,.406,11,22,.500,11,19,.579,96,36,82,.439,32,71,.451,4,11,.364,10,16,.625,86,2012-04-12,CHI,MIA
57,Home,W 96-85 ,240,38,69,.551,32,56,.571,6,13,.462,14,21,.667,96,33,73,.452,31,62,.500,2,11,.182,17,21,.810,85,2012-04-13,NOH,UTA
58,Home,W 96-72 ,240,40,76,.526,33,59,.559,7,17,.412,9,15,.600,96,30,72,.417,29,56,.518,1,16,.063,11,15,.733,72,2012-04-18,MIA,TOR
59,@,L 96-99 ,240,36,73,.493,31,57,.544,5,16,.313,19,22,.864,96,40,84,.476,30,58,.517,10,26,.385,9,15,.600,99,2012-04-21,GSW,HOU
60,@,W 96-85 ,240,40,91,.440,36,75,.480,4,16,.250,12,16,.750,96,34,77,.442,30,60,.500,4,17,.235,13,18,.722,85,2012-04-25,WAS,CLE
61,@,L 96-113 ,240,41,91,.451,34,76,.447,7,15,.467,7,9,.778,96,47,92,.511,41,77,.532,6,15,.400,13,18,.722,113,2012-04-26,LAL,SAC
62,Home,W 96-94 ,240,35,83,.422,29,64,.453,6,19,.316,20,27,.741,96,36,80,.450,30,55,.545,6,25,.240,16,19,.842,94,2012-04-26,UTA,POR
63,Home,L 96-105 ,240,35,79,.443,29,63,.460,6,16,.375,20,26,.769,96,39,79,.494,29,52,.558,10,27,.370,17,23,.739,105,2012-10-31,DET,HOU
64,Home,L 96-107 ,240,35,73,.479,22,50,.440,13,23,.565,13,18,.722,96,44,88,.500,37,68,.544,7,20,.350,12,15,.800,107,2012-11-05,BRK,MIN
65,@,L 96-106 ,240,36,86,.419,25,54,.463,11,32,.344,13,21,.619,96,42,78,.538,37,60,.617,5,18,.278,17,23,.739,106,2012-11-07,CLE,GSW
66,Home,W 96-94 ,240,35,70,.500,33,61,.541,2,9,.222,24,28,.857,96,37,84,.440,32,66,.485,5,18,.278,15,17,.882,94,2012-11-09,MIN,IND
67,Home,W 96-82 ,240,33,82,.402,24,56,.429,9,26,.346,21,26,.808,96,32,80,.400,25,60,.417,7,20,.350,11,16,.688,82,2012-11-10,HOU,DET
68,@,W 96-92 ,240,32,72,.444,27,57,.474,5,15,.333,27,34,.794,96,35,88,.398,32,69,.464,3,19,.158,19,26,.731,92,2012-11-10,BOS,MIL
69,Home,L 96-105 ,240,37,85,.435,27,61,.443,10,24,.417,12,16,.750,96,41,80,.513,34,60,.567,7,20,.350,16,18,.889,105,2012-11-12,PHI,MIL
70,@,L 96-100 ,240,34,84,.405,26,60,.433,8,24,.333,20,21,.952,96,36,80,.450,26,51,.510,10,29,.345,18,22,.818,100,2012-11-14,NOH,HOU
71,Home,L 96-112 ,240,39,85,.459,31,65,.477,8,20,.400,10,14,.714,96,42,76,.553,34,61,.557,8,15,.533,20,27,.741,112,2012-11-16,SAC,ATL
72,@,W 96-89 ,240,34,70,.486,31,51,.608,3,19,.158,25,29,.862,96,31,87,.356,27,70,.386,4,17,.235,23,31,.742,89,2012-11-19,IND,WAS
73,Home,W 96-85 ,240,33,78,.423,27,57,.474,6,21,.286,24,29,.828,96,33,86,.384,28,59,.475,5,27,.185,14,19,.737,85,2012-11-24,GSW,MIN
74,Home,W 96-89 (OT),265,37,91,.407,28,63,.444,9,28,.321,13,19,.684,96,33,85,.388,27,64,.422,6,21,.286,17,24,.708,89,2012-11-26,BRK,NYK
75,@,W 96-84 ,240,31,63,.492,25,52,.481,6,11,.545,28,38,.737,96,31,73,.425,26,52,.500,5,21,.238,17,21,.810,84,2012-11-28,UTA,NOH
76,Home,W 96-78 ,240,36,73,.493,30,57,.526,6,16,.375,18,20,.900,96,24,69,.348,21,54,.389,3,15,.200,27,37,.730,78,2012-11-30,BOS,POR
77,@,W 96-89 ,240,36,72,.500,28,55,.509,8,17,.471,16,22,.727,96,36,75,.480,28,59,.475,8,16,.500,9,12,.750,89,2012-12-07,MEM,NOH
78,Home,L 96-104 ,240,31,83,.373,22,57,.386,9,26,.346,25,32,.781,96,38,84,.452,30,64,.469,8,20,.400,20,23,.870,104,2012-12-10,CHA,GSW
79,@,L 96-119 ,240,37,84,.440,25,57,.439,12,27,.444,10,16,.625,96,48,87,.552,41,67,.612,7,20,.350,16,21,.762,119,2012-12-10,SAC,DAL
80,Home,W 96-81 ,240,34,83,.410,29,65,.446,5,18,.278,23,28,.821,96,27,81,.333,18,59,.305,9,22,.409,18,25,.720,81,2012-12-12,IND,CLE
81,@,W 96-89 ,240,34,78,.436,30,67,.448,4,11,.364,24,26,.923,96,41,91,.451,39,77,.506,2,14,.143,5,11,.455,89,2012-12-12,CHI,PHI
82,@,L 96-99 ,240,37,87,.425,29,68,.426,8,19,.421,14,18,.778,96,41,84,.488,33,65,.508,8,19,.421,9,15,.600,99,2012-12-12,SAS,UTA
83,Home,L 96-102 ,240,36,83,.434,28,62,.452,8,21,.381,16,20,.800,96,37,82,.451,29,53,.547,8,29,.276,20,28,.714,102,2012-12-14,WAS,LAL
84,@,L 96-103 ,240,32,78,.410,25,55,.455,7,23,.304,25,32,.781,96,39,85,.459,31,55,.564,8,30,.267,17,20,.850,103,2012-12-16,HOU,TOR
85,Home,L 96-109 ,240,39,90,.433,30,59,.508,9,31,.290,9,16,.563,96,40,78,.513,30,49,.612,10,29,.345,19,24,.792,109,2012-12-17,NYK,HOU
86,@,L 96-103 ,240,35,75,.467,26,48,.542,9,27,.333,17,17,1.000,96,34,78,.436,28,60,.467,6,18,.333,29,34,.853,103,2012-12-18,NOH,GSW
87,@,L 96-121 ,240,42,79,.532,40,66,.606,2,13,.154,10,14,.714,96,44,82,.537,32,54,.593,12,28,.429,21,26,.808,121,2012-12-22,MEM,HOU
88,Home,W 96-93 ,240,33,69,.478,26,49,.531,7,20,.350,23,28,.821,96,40,89,.449,35,70,.500,5,19,.263,8,11,.727,93,2012-12-22,POR,PHO
89,@,W 96-87 ,240,36,88,.409,28,69,.406,8,19,.421,16,20,.800,96,29,77,.377,25,56,.446,4,21,.190,25,32,.781,87,2012-12-22,DET,WAS
90,@,L 96-108 ,240,37,85,.435,30,61,.492,7,24,.292,15,17,.882,96,45,81,.556,36,62,.581,9,19,.474,9,11,.818,108,2012-12-23,POR,SAC
91,Home,W 96-89 ,240,34,80,.425,27,63,.429,7,17,.412,21,26,.808,96,35,87,.402,30,67,.448,5,20,.250,14,23,.609,89,2012-12-28,GSW,PHI
92,Home,W 96-94 ,240,39,82,.476,33,64,.516,6,18,.333,12,15,.800,96,36,77,.468,26,54,.481,10,23,.435,12,17,.706,94,2012-12-30,DET,MIL
93,@,L 96-107 ,240,33,80,.413,28,67,.418,5,13,.385,25,34,.735,96,39,78,.500,31,60,.517,8,18,.444,21,29,.724,107,2012-12-30,UTA,LAC
94,@,L 96-118 ,240,36,86,.419,29,64,.453,7,22,.318,17,19,.895,96,44,82,.537,34,62,.548,10,20,.500,20,25,.800,118,2012-12-30,BOS,SAC
95,@,L 96-114 ,240,37,78,.474,29,54,.537,8,24,.333,14,17,.824,96,44,87,.506,39,72,.542,5,15,.333,21,24,.875,114,2012-12-31,PHO,OKC
96,@,W 96-94 ,240,36,77,.468,31,65,.477,5,12,.417,19,25,.760,96,37,78,.474,28,54,.519,9,24,.375,11,14,.786,94,2013-01-02,CHI,ORL
97,@,W 96-89 ,240,36,80,.450,31,66,.470,5,14,.357,19,24,.792,96,30,65,.462,25,45,.556,5,20,.250,24,31,.774,89,2013-01-04,CHI,MIA
98,Home,L 96-105 ,240,30,79,.380,19,46,.413,11,33,.333,25,37,.676,96,40,76,.526,36,64,.563,4,12,.333,21,30,.700,105,2013-01-04,TOR,SAC
99,Home,L 96-99 (OT),265,39,85,.459,32,66,.485,7,19,.368,11,13,.846,96,39,86,.453,31,65,.477,8,21,.381,13,16,.813,99,2013-01-05,DAL,NOH
0,Home,L 96-102 ,240,31,76,.408,17,44,.386,14,32,.438,20,26,.769,96,39,74,.527,33,56,.589,6,18,.333,18,20,.900,102,2013-01-07,NYK,BOS
1,Home,L 96-104 ,240,39,95,.411,35,85,.412,4,10,.400,14,20,.700,96,39,84,.464,29,62,.468,10,22,.455,16,21,.762,104,2013-01-09,CHI,MIL
2,Home,W 96-88 ,240,38,89,.427,27,61,.443,11,28,.393,9,12,.750,96,36,78,.462,33,71,.465,3,7,.429,13,16,.813,88,2013-01-12,IND,CHA
3,Home,L 96-107 ,240,36,85,.424,33,72,.458,3,13,.231,21,27,.778,96,40,77,.519,32,58,.552,8,19,.421,19,23,.826,107,2013-01-13,TOR,MIL
4,@,L 96-104 ,240,36,74,.486,31,60,.517,5,14,.357,19,26,.731,96,41,71,.577,31,55,.564,10,16,.625,12,21,.571,104,2013-01-21,MIN,ATL
5,Home,L 96-106 ,240,38,79,.481,33,68,.485,5,11,.455,15,24,.625,96,43,90,.478,37,71,.521,6,19,.316,14,16,.875,106,2013-01-23,SAC,PHO
6,Home,W 96-83 ,240,42,82,.512,36,65,.554,6,17,.353,6,9,.667,96,29,66,.439,26,51,.510,3,15,.200,22,29,.759,83,2013-01-27,LAC,POR
7,@,L 96-105 ,240,36,81,.444,32,65,.492,4,16,.250,20,26,.769,96,41,74,.554,34,57,.596,7,17,.412,16,29,.552,105,2013-01-27,OKC,LAL
8,@,W 96-94 ,240,36,82,.439,27,59,.458,9,23,.391,15,25,.600,96,37,77,.481,34,66,.515,3,11,.273,17,21,.810,94,2013-01-28,SAC,WAS
9,@,W 96-90 ,240,35,76,.461,32,67,.478,3,9,.333,23,36,.639,96,33,76,.434,28,57,.491,5,19,.263,19,27,.704,90,2013-01-30,LAC,MIN
10,Home,W 96-86 ,240,32,76,.421,19,41,.463,13,35,.371,19,26,.731,96,33,83,.398,25,63,.397,8,20,.400,12,17,.706,86,2013-02-01,NYK,MIL
11,Home,W 96-86 ,240,38,78,.487,33,58,.569,5,20,.250,15,16,.938,96,36,88,.409,30,66,.455,6,22,.273,8,17,.471,86,2013-02-02,SAS,WAS
12,@,W 96-90 ,240,37,73,.507,33,63,.524,4,10,.400,18,22,.818,96,36,82,.439,33,73,.452,3,9,.333,15,17,.882,90,2013-02-05,PHO,MEM
13,@,L 96-106 ,240,34,84,.405,25,56,.446,9,28,.321,19,23,.826,96,42,79,.532,31,59,.525,11,20,.550,11,14,.786,106,2013-02-06,NYK,WAS
14,@,L 96-128 ,240,38,91,.418,28,64,.438,10,27,.370,10,14,.714,96,50,86,.581,41,67,.612,9,19,.474,19,23,.826,128,2013-02-07,CHI,DEN
15,@,L 96-127 ,240,39,83,.470,32,65,.492,7,18,.389,11,15,.733,96,50,87,.575,36,66,.545,14,21,.667,13,18,.722,127,2013-02-08,PHO,OKC
16,@,W 96-95 ,240,38,84,.452,33,65,.508,5,19,.263,15,18,.833,96,40,97,.412,38,86,.442,2,11,.182,13,15,.867,95,2013-02-13,SAS,CLE
17,Home,W 96-85 ,240,35,79,.443,26,61,.426,9,18,.500,17,25,.680,96,34,70,.486,31,59,.525,3,11,.273,14,22,.636,85,2013-02-13,DET,WAS
18,@,L 96-106 ,240,36,82,.439,31,58,.534,5,24,.208,19,22,.864,96,37,75,.493,24,43,.558,13,32,.406,19,26,.731,106,2013-02-13,HOU,LAC
19,@,W 96-87 ,240,39,84,.464,34,71,.479,5,13,.385,13,17,.765,96,35,84,.417,31,67,.463,4,17,.235,13,20,.650,87,2013-02-19,CHI,NOH
20,@,W 96-88 ,240,35,78,.449,27,58,.466,8,20,.400,18,20,.900,96,30,78,.385,24,63,.381,6,15,.400,22,27,.815,88,2013-02-19,TOR,WAS
21,@,L 96-111 ,240,39,85,.459,34,69,.493,5,16,.313,13,22,.591,96,42,88,.477,31,59,.525,11,29,.379,16,18,.889,111,2013-02-20,ORL,DAL
22,Home,L 96-106 ,240,40,91,.440,30,61,.492,10,30,.333,6,11,.545,96,41,77,.532,25,47,.532,16,30,.533,8,12,.667,106,2013-02-22,BRK,HOU
23,@,W 96-95 ,240,39,72,.542,30,57,.526,9,15,.600,9,16,.563,96,40,84,.476,32,65,.492,8,19,.421,7,10,.700,95,2013-02-27,DET,WAS
24,@,W 96-88 ,240,35,81,.432,27,53,.509,8,28,.286,18,21,.857,96,31,74,.419,24,58,.414,7,16,.438,19,29,.655,88,2013-03-01,NYK,WAS
25,Home,W 96-85 ,240,38,73,.521,32,58,.552,6,15,.400,14,14,1.000,96,32,72,.444,27,57,.474,5,15,.333,16,23,.696,85,2013-03-02,CHI,BRK
26,@,L 96-107 ,240,37,86,.430,31,69,.449,6,17,.353,16,21,.762,96,43,80,.538,32,56,.571,11,24,.458,10,17,.588,107,2013-03-06,PHI,ATL
27,@,L 96-97 ,240,40,89,.449,34,61,.557,6,28,.214,10,12,.833,96,32,74,.432,26,46,.565,6,28,.214,27,31,.871,97,2013-03-06,ORL,MIA
28,Home,W 96-85 ,240,38,81,.469,34,68,.500,4,13,.308,16,20,.800,96,34,79,.430,32,67,.478,2,12,.167,15,17,.882,85,2013-03-09,MEM,NOH
29,@,L 96-98 ,240,37,76,.487,26,51,.510,11,25,.440,11,12,.917,96,40,86,.465,29,66,.439,11,20,.550,7,9,.778,98,2013-03-10,POR,NOH
30,@,L 96-100 ,240,36,86,.419,29,65,.446,7,21,.333,17,27,.630,96,33,84,.393,25,61,.410,8,23,.348,26,34,.765,100,2013-03-10,CLE,TOR
31,Home,W 96-92 ,240,37,79,.468,29,57,.509,8,22,.364,14,21,.667,96,36,92,.391,28,63,.444,8,29,.276,12,16,.750,92,2013-03-13,ATL,LAL
32,@,W 96-85 ,240,37,68,.544,31,56,.554,6,12,.500,16,21,.762,96,31,72,.431,25,46,.543,6,26,.231,17,18,.944,85,2013-03-13,MEM,LAC
33,Home,W 96-86 ,240,41,82,.500,34,61,.557,7,21,.333,7,11,.636,96,34,78,.436,27,62,.435,7,16,.438,11,18,.611,86,2013-03-15,DAL,CLE
34,Home,W 96-87 ,240,36,72,.500,27,52,.519,9,20,.450,15,19,.789,96,35,80,.438,32,61,.525,3,19,.158,14,19,.737,87,2013-03-15,WAS,NOH
35,Home,L 96-113 ,240,40,80,.500,33,61,.541,7,19,.368,9,15,.600,96,45,89,.506,38,68,.559,7,21,.333,16,21,.762,113,2013-03-20,DAL,BRK
36,Home,W 96-95 ,240,32,80,.400,23,54,.426,9,26,.346,23,27,.852,96,33,78,.423,23,56,.411,10,22,.455,19,21,.905,95,2013-03-24,HOU,SAS
37,Home,L 96-113 ,240,39,84,.464,33,64,.516,6,20,.300,12,18,.667,96,41,73,.562,34,55,.618,7,18,.389,24,32,.750,113,2013-04-03,UTA,DEN
38,@,L 96-105 ,240,36,80,.450,29,59,.492,7,21,.333,17,23,.739,96,39,80,.488,34,59,.576,5,21,.238,22,30,.733,105,2013-04-06,CHA,BRK
39,@,L 96-107 ,240,39,88,.443,29,62,.468,10,26,.385,8,12,.667,96,43,77,.558,39,66,.591,4,11,.364,17,21,.810,107,2013-04-07,WAS,BOS
40,@,W 96-91 ,240,42,90,.467,39,77,.506,3,13,.231,9,12,.750,96,37,80,.463,33,58,.569,4,22,.182,13,16,.813,91,2013-04-07,DAL,POR
41,@,L 96-104 ,240,37,84,.440,32,64,.500,5,20,.250,17,18,.944,96,40,79,.506,33,54,.611,7,25,.280,17,22,.773,104,2013-04-09,NOH,LAL
42,Home,W 96-86 ,240,39,86,.453,33,71,.465,6,15,.400,12,21,.571,96,35,87,.402,31,66,.470,4,21,.190,12,17,.706,86,2013-04-10,DEN,SAS
43,@,W 96-93 ,240,35,78,.449,28,52,.538,7,26,.269,19,28,.679,96,35,83,.422,29,64,.453,6,19,.316,17,32,.531,93,2013-04-12,LAC,NOH
44,@,W 96-95 ,240,33,66,.500,20,38,.526,13,28,.464,17,27,.630,96,39,86,.453,34,73,.466,5,13,.385,12,19,.632,95,2013-04-15,MIA,CLE
45,@,W 96-80 ,240,36,77,.468,33,67,.493,3,10,.300,21,23,.913,96,32,75,.427,30,58,.517,2,17,.118,14,18,.778,80,2013-04-15,UTA,MIN
46,Home,L 96-113 ,240,35,88,.398,26,60,.433,9,28,.321,17,23,.739,96,40,78,.513,30,51,.588,10,27,.370,23,27,.852,113,2013-04-16,ATL,TOR
47,Home,W 96-83 ,240,36,76,.474,27,51,.529,9,25,.360,15,24,.625,96,33,90,.367,29,80,.363,4,10,.400,13,20,.650,83,2013-10-30,HOU,CHA
48,@,L 96-103 ,240,32,80,.400,18,43,.419,14,37,.378,18,22,.818,96,35,82,.427,33,64,.516,2,18,.111,31,37,.838,103,2013-11-03,PHO,OKC
49,@,L 96-99 ,240,42,85,.494,35,66,.530,7,19,.368,5,9,.556,96,41,85,.482,35,69,.507,6,16,.375,11,15,.733,99,2013-11-06,PHO,SAS
50,Home,W 96-85 ,240,38,87,.437,35,78,.449,3,9,.333,17,22,.773,96,31,80,.388,25,61,.410,6,19,.316,17,26,.654,85,2013-11-08,NOP,LAL
51,@,W 96-91 ,240,37,80,.463,30,66,.455,7,14,.500,15,20,.750,96,35,76,.461,27,57,.474,8,19,.421,13,16,.813,91,2013-11-09,IND,BRK
52,@,W 96-85 ,240,36,82,.439,27,62,.435,9,20,.450,15,22,.682,96,36,78,.462,33,66,.500,3,12,.250,10,14,.714,85,2013-11-09,POR,SAC
53,Home,W 96-81 ,240,34,83,.410,30,67,.448,4,16,.250,24,26,.923,96,31,75,.413,26,61,.426,5,14,.357,14,20,.700,81,2013-11-11,CHI,CLE
54,Home,L 96-109 ,240,37,81,.457,30,63,.476,7,18,.389,15,19,.789,96,40,82,.488,31,56,.554,9,26,.346,20,22,.909,109,2013-11-15,BOS,POR
55,@,W 96-80 ,240,36,80,.450,29,64,.453,7,16,.438,17,19,.895,96,29,82,.354,24,61,.393,5,21,.238,17,22,.773,80,2013-11-15,CHI,TOR
56,Home,L 96-103 (OT),265,37,93,.398,31,68,.456,6,25,.240,16,22,.727,96,36,81,.444,26,60,.433,10,21,.476,21,22,.955,103,2013-11-16,WAS,CLE
57,Home,L 96-103 (OT),265,37,100,.370,29,70,.414,8,30,.267,14,17,.824,96,33,87,.379,24,57,.421,9,30,.300,28,36,.778,103,2013-11-20,NYK,IND
58,@,W 96-89 ,240,37,85,.435,29,62,.468,8,23,.348,14,21,.667,96,36,84,.429,33,71,.465,3,13,.231,14,22,.636,89,2013-11-22,ATL,DET
59,Home,W 96-88 ,240,37,78,.474,32,60,.533,5,18,.278,17,23,.739,96,36,86,.419,30,69,.435,6,17,.353,10,13,.769,88,2013-11-22,TOR,WAS
60,@,W 96-72 ,240,38,77,.494,33,63,.524,5,14,.357,15,27,.556,96,30,85,.353,25,67,.373,5,18,.278,7,9,.778,72,2013-11-23,CHA,MIL
61,@,L 96-126 ,240,39,83,.470,35,70,.500,4,13,.308,14,20,.700,96,46,80,.575,30,56,.536,16,24,.667,18,23,.783,126,2013-11-23,CLE,SAS
62,Home,L 96-104 ,240,39,84,.464,33,63,.524,6,21,.286,12,14,.857,96,46,95,.484,35,66,.530,11,29,.379,1,3,.333,104,2013-11-24,ORL,PHO
63,@,W 96-86 ,240,35,80,.438,26,60,.433,9,20,.450,17,21,.810,96,33,74,.446,30,65,.462,3,9,.333,17,20,.850,86,2013-11-25,BOS,CHA
64,Home,L 96-110 ,240,38,82,.463,33,63,.524,5,19,.263,15,19,.789,96,41,75,.547,33,55,.600,8,20,.400,20,28,.714,110,2013-11-25,DAL,DEN
65,@,L 96-104 ,240,35,80,.438,24,58,.414,11,22,.500,15,21,.714,96,39,70,.557,36,58,.621,3,12,.250,23,28,.821,104,2013-12-10,BOS,BRK
66,@,W 96-88 ,240,34,76,.447,28,59,.475,6,17,.353,22,34,.647,96,33,80,.413,27,63,.429,6,17,.353,16,19,.842,88,2013-12-11,LAC,BOS
67,Home,L 96-101 ,240,35,81,.432,29,64,.453,6,17,.353,20,27,.741,96,38,88,.432,31,68,.456,7,20,.350,18,28,.643,101,2013-12-16,IND,DET
68,@,W 96-92 ,240,37,75,.493,30,53,.566,7,22,.318,15,19,.789,96,37,91,.407,32,75,.427,5,16,.313,13,17,.765,92,2013-12-17,LAL,MEM
69,Home,W 96-87 ,240,36,81,.444,29,65,.446,7,16,.438,17,17,1.000,96,36,76,.474,32,54,.593,4,22,.182,11,14,.786,87,2014-01-02,UTA,MIL
70,@,L 96-119 ,240,35,80,.438,24,57,.421,11,23,.478,15,24,.625,96,43,83,.518,34,64,.531,9,19,.474,24,31,.774,119,2014-01-05,BOS,OKC
71,Home,L 96-112 ,240,37,86,.430,31,66,.470,6,20,.300,16,16,1.000,96,43,85,.506,34,63,.540,9,22,.409,17,20,.850,112,2014-01-05,WAS,GSW
72,Home,L 96-102 ,240,35,78,.449,31,65,.477,4,13,.308,22,27,.815,96,38,80,.475,28,59,.475,10,21,.476,16,26,.615,102,2014-01-08,NOP,WAS
73,Home,W 96-80 ,240,32,79,.405,21,54,.389,11,25,.440,21,28,.750,96,30,75,.400,22,50,.440,8,25,.320,12,18,.667,80,2014-01-11,TOR,BRK
74,@,L 96-98 (OT),265,33,93,.355,26,63,.413,7,30,.233,23,28,.821,96,35,81,.432,28,61,.459,7,20,.350,21,27,.778,98,2014-01-13,PHO,NYK
75,@,L 96-108 ,240,39,89,.438,33,66,.500,6,23,.261,12,18,.667,96,42,88,.477,31,61,.508,11,27,.407,13,17,.765,108,2014-01-15,CLE,POR
76,Home,W 96-93 ,240,40,79,.506,34,68,.500,6,11,.545,10,13,.769,96,35,76,.461,26,52,.500,9,24,.375,14,16,.875,93,2014-01-17,WAS,CHI
77,Home,L 96-104 (OT),265,36,75,.480,29,58,.500,7,17,.412,17,23,.739,96,39,79,.494,32,58,.552,7,21,.333,19,29,.655,104,2014-01-18,CHA,MIA
78,@,L 96-125 ,240,37,76,.487,27,52,.519,10,24,.417,12,14,.857,96,50,90,.556,36,63,.571,14,27,.519,11,11,1.000,125,2014-01-24,CHA,NYK
79,@,L 96-109 ,240,37,88,.420,32,76,.421,5,12,.417,17,27,.630,96,40,83,.482,32,63,.508,8,20,.400,21,37,.568,109,2014-01-25,IND,DEN
80,@,W 96-86 ,240,37,83,.446,33,71,.465,4,12,.333,18,23,.783,96,33,71,.465,28,58,.483,5,13,.385,15,16,.938,86,2014-01-29,CHI,SAS
81,@,L 96-113 ,240,38,89,.427,33,68,.485,5,21,.238,15,23,.652,96,41,92,.446,34,67,.507,7,25,.280,24,40,.600,113,2014-02-01,PHI,DET
82,@,L 96-97 ,240,34,77,.442,27,54,.500,7,23,.304,21,23,.913,96,31,73,.425,28,58,.483,3,15,.200,32,37,.865,97,2014-02-01,BRK,IND
83,Home,W 96-81 ,240,41,89,.461,33,65,.508,8,24,.333,6,9,.667,96,31,78,.397,27,54,.500,4,24,.167,15,17,.882,81,2014-02-01,WAS,OKC
84,Home,W 96-89 ,240,41,82,.500,37,68,.544,4,14,.286,10,12,.833,96,33,80,.413,28,66,.424,5,14,.357,18,22,.818,89,2014-02-02,BOS,ORL
85,@,L 96-102 ,240,34,83,.410,28,65,.431,6,18,.333,22,29,.759,96,39,85,.459,32,65,.492,7,20,.350,17,21,.810,102,2014-02-03,DET,MIA
86,Home,L 96-110 ,240,37,69,.536,31,53,.585,6,16,.375,16,22,.727,96,42,78,.538,34,60,.567,8,18,.444,18,25,.720,110,2014-02-05,MEM,DAL
87,@,W 96-79 ,240,37,85,.435,31,68,.456,6,17,.353,16,25,.640,96,33,85,.388,29,69,.420,4,16,.250,9,13,.692,79,2014-02-11,UTA,LAL
88,Home,L 96-108 ,240,39,98,.398,34,82,.415,5,16,.313,13,23,.565,96,39,75,.520,32,58,.552,7,17,.412,23,37,.622,108,2014-02-18,DET,CHA
89,@,L 96-102 ,240,31,80,.388,24,56,.429,7,24,.292,27,43,.628,96,42,87,.483,37,72,.514,5,15,.333,13,15,.867,102,2014-02-21,LAC,MEM
90,@,W 96-83 ,240,41,96,.427,33,76,.434,8,20,.400,6,10,.600,96,30,78,.385,28,60,.467,2,18,.111,21,26,.808,83,2014-02-23,WAS,CLE
91,Home,L 96-104 ,240,40,99,.404,36,86,.419,4,13,.308,12,18,.667,96,38,82,.463,25,51,.490,13,31,.419,15,22,.682,104,2014-02-24,DET,GSW
92,@,L 96-101 ,240,38,87,.437,26,63,.413,12,24,.500,8,11,.727,96,38,74,.514,32,59,.542,6,15,.400,19,22,.864,101,2014-02-27,MIL,IND
93,@,L 96-110 ,240,39,79,.494,32,61,.525,7,18,.389,11,15,.733,96,44,81,.543,35,62,.565,9,19,.474,13,18,.722,110,2014-03-01,CLE,MEM
94,@,L 96-102 ,240,33,83,.398,26,60,.433,7,23,.304,23,35,.657,96,37,81,.457,32,54,.593,5,27,.185,23,24,.958,102,2014-03-01,DEN,POR
95,Home,W 96-80 ,240,34,73,.466,27,48,.563,7,25,.280,21,28,.750,96,30,65,.462,26,52,.500,4,13,.308,16,23,.696,80,2014-03-03,BRK,CHI
96,Home,W 96-85 ,240,35,83,.422,31,71,.437,4,12,.333,22,30,.733,96,32,83,.386,22,55,.400,10,28,.357,11,14,.786,85,2014-03-03,DET,NYK
97,Home,W 96-89 ,240,32,68,.471,31,61,.508,1,7,.143,31,41,.756,96,32,75,.427,26,55,.473,6,20,.300,19,28,.679,89,2014-03-03,SAC,NOP
98,Home,L 96-98 ,240,36,86,.419,33,70,.471,3,16,.188,21,22,.955,96,37,84,.440,27,64,.422,10,20,.500,14,21,.667,98,2014-03-04,IND,GSW
99,Home,L 96-104 ,240,39,86,.453,32,67,.478,7,19,.368,11,19,.579,96,40,78,.513,32,58,.552,8,20,.400,16,22,.727,104,2014-03-04,PHO,LAC
0,Home,L 96-104 ,240,32,75,.427,24,57,.421,8,18,.444,24,28,.857,96,40,79,.506,28,58,.483,12,21,.571,12,15,.800,104,2014-03-11,CHI,SAS
1,@,W 96-95 ,240,34,78,.436,22,49,.449,12,29,.414,16,19,.842,96,33,68,.485,24,41,.585,9,27,.333,20,26,.769,95,2014-03-12,BRK,MIA
2,@,W 96-87 ,240,37,76,.487,28,53,.528,9,23,.391,13,20,.650,96,35,77,.455,28,63,.444,7,14,.500,10,13,.769,87,2014-03-14,LAC,UTA
3,Home,L 96-100 ,240,37,72,.514,30,50,.600,7,22,.318,15,22,.682,96,34,75,.453,22,45,.489,12,30,.400,20,31,.645,100,2014-03-18,CLE,MIA
4,@,L 96-101 ,240,40,81,.494,36,64,.563,4,17,.235,12,15,.800,96,39,77,.506,26,49,.531,13,28,.464,10,12,.833,101,2014-03-19,MIA,BOS
5,Home,W 96-86 ,240,36,81,.444,34,70,.486,2,11,.182,22,25,.880,96,37,84,.440,30,66,.455,7,18,.389,5,10,.500,86,2014-03-19,MEM,UTA
6,Home,W 96-86 ,240,34,80,.425,26,56,.464,8,24,.333,20,28,.714,96,33,76,.434,28,56,.500,5,20,.250,15,20,.750,86,2014-03-23,TOR,ATL
7,@,L 96-117 ,240,30,77,.390,21,49,.429,9,28,.321,27,40,.675,96,45,89,.506,34,67,.507,11,22,.500,16,21,.762,117,2014-03-24,DEN,OKC
8,@,L 96-127 ,240,36,74,.486,32,59,.542,4,15,.267,20,27,.741,96,48,83,.578,30,55,.545,18,28,.643,13,15,.867,127,2014-03-25,NYK,LAL
9,Home,L 96-97 ,240,39,84,.464,28,58,.483,11,26,.423,7,13,.538,96,37,85,.435,28,59,.475,9,26,.346,14,24,.583,97,2014-03-26,DET,CLE
10,@,L 96-98 ,240,33,80,.413,20,50,.400,13,30,.433,17,28,.607,96,38,90,.422,35,78,.449,3,12,.250,19,25,.760,98,2014-03-26,LAC,NOP
11,Home,W 96-80 ,240,37,78,.474,28,57,.491,9,21,.429,13,20,.650,96,32,81,.395,29,69,.420,3,12,.250,13,16,.813,80,2014-03-29,SAS,NOP
12,@,L 96-116 ,240,36,86,.419,30,65,.462,6,21,.286,18,24,.750,96,41,74,.554,30,56,.536,11,18,.611,23,26,.885,116,2014-03-30,UTA,OKC
13,@,L 96-105 ,240,32,84,.381,22,49,.449,10,35,.286,22,28,.786,96,44,83,.530,38,58,.655,6,25,.240,11,17,.647,105,2014-04-01,HOU,BRK
14,Home,W 96-77 ,240,39,77,.506,30,51,.588,9,26,.346,9,14,.643,96,32,73,.438,28,55,.509,4,18,.222,9,9,1.000,77,2014-04-02,MIA,MIL
15,@,L 96-100 ,240,34,73,.466,26,54,.481,8,19,.421,20,29,.690,96,33,64,.516,29,53,.547,4,11,.364,30,35,.857,100,2014-04-04,NOP,UTA
16,@,W 96-94 (OT),265,34,91,.374,25,65,.385,9,26,.346,19,27,.704,96,35,96,.365,28,74,.378,7,22,.318,17,21,.810,94,2014-04-05,CHA,CLE
17,@,W 96-78 ,240,35,79,.443,26,56,.464,9,23,.391,17,21,.810,96,34,86,.395,31,70,.443,3,16,.188,7,12,.583,78,2014-04-05,CHI,WAS
18,@,W 96-86 ,240,35,82,.427,33,63,.524,2,19,.105,24,33,.727,96,32,77,.416,28,58,.483,4,19,.211,18,24,.750,86,2014-04-11,WAS,ORL
19,Home,L 96-114 ,240,35,67,.522,28,44,.636,7,23,.304,19,26,.731,96,41,83,.494,29,59,.492,12,24,.500,20,29,.690,114,2014-11-01,PHI,MIA
20,Home,W 96-93 ,240,39,78,.500,31,62,.500,8,16,.500,10,17,.588,96,33,70,.471,27,55,.491,6,15,.400,21,29,.724,93,2014-11-02,NYK,CHO
21,Home,W 96-89 ,240,35,82,.427,30,64,.469,5,18,.278,21,29,.724,96,30,77,.390,26,55,.473,4,22,.182,25,31,.806,89,2014-11-05,CHO,MIA
22,Home,W 96-94 (OT),265,34,91,.374,27,74,.365,7,17,.412,21,23,.913,96,35,90,.389,27,63,.429,8,27,.296,16,20,.800,94,2014-11-05,WAS,IND
23,@,L 96-103 ,240,40,84,.476,32,63,.508,8,21,.381,8,11,.727,96,33,81,.407,24,59,.407,9,22,.409,28,36,.778,103,2014-11-08,NYK,ATL
24,@,L 96-104 ,240,39,75,.520,31,60,.517,8,15,.533,10,16,.625,96,40,83,.482,36,69,.522,4,14,.286,20,23,.870,104,2014-11-09,ORL,BRK
25,Home,L 96-105 ,240,35,83,.422,26,54,.481,9,29,.310,17,24,.708,96,42,76,.553,33,53,.623,9,23,.391,12,20,.600,105,2014-11-09,DAL,MIA
26,Home,L 96-97 ,240,36,93,.387,30,70,.429,6,23,.261,18,25,.720,96,33,72,.458,27,57,.474,6,15,.400,25,35,.714,97,2014-11-09,DET,UTA
27,@,W 96-89 (OT),265,38,89,.427,27,58,.466,11,31,.355,9,15,.600,96,38,96,.396,26,60,.433,12,36,.333,1,6,.167,89,2014-11-14,DET,OKC
28,Home,W 96-92 ,240,38,83,.458,29,57,.509,9,26,.346,11,13,.846,96,35,80,.438,32,70,.457,3,10,.300,19,26,.731,92,2014-11-19,TOR,MEM
29,Home,L 96-122 ,240,36,78,.462,32,55,.582,4,23,.174,20,33,.606,96,44,86,.512,31,55,.564,13,31,.419,21,23,.913,122,2014-11-21,PHI,PHO
30,Home,L 96-111 ,240,36,87,.414,30,67,.448,6,20,.300,18,24,.750,96,44,85,.518,32,59,.542,12,26,.462,11,19,.579,111,2014-11-26,ORL,GSW
31,Home,L 96-112 ,240,34,75,.453,27,54,.500,7,21,.333,21,33,.636,96,45,80,.563,34,52,.654,11,28,.393,11,15,.733,112,2014-11-29,UTA,LAC
32,Home,L 96-106 ,240,33,90,.367,27,69,.391,6,21,.286,24,31,.774,96,39,81,.481,29,64,.453,10,17,.588,18,24,.750,106,2014-12-02,DET,LAL
33,@,L 96-105 ,240,39,76,.513,37,63,.587,2,13,.154,16,27,.593,96,41,93,.441,31,65,.477,10,28,.357,13,20,.650,105,2014-12-03,MEM,HOU
34,@,L 96-113 ,240,38,92,.413,32,76,.421,6,16,.375,14,19,.737,96,46,90,.511,38,70,.543,8,20,.400,13,22,.591,113,2014-12-05,LAL,BOS
35,Home,L 96-105 ,240,35,79,.443,31,64,.484,4,15,.267,22,28,.786,96,42,83,.506,33,57,.579,9,26,.346,12,14,.857,105,2014-12-06,SAC,ORL
36,Home,W 96-84 ,240,36,87,.414,26,60,.433,10,27,.370,14,19,.737,96,34,93,.366,28,58,.483,6,35,.171,10,13,.769,84,2014-12-07,ATL,DEN
37,@,W 96-94 ,240,39,87,.448,33,66,.500,6,21,.286,12,17,.706,96,34,76,.447,27,53,.509,7,23,.304,19,28,.679,94,2014-12-07,OKC,DET
38,@,L 96-100 ,240,39,84,.464,35,64,.547,4,20,.200,14,23,.609,96,40,80,.500,36,66,.545,4,14,.286,16,22,.727,100,2014-12-09,SAS,UTA
39,Home,W 96-87 ,240,35,84,.417,32,70,.457,3,14,.214,23,29,.793,96,38,87,.437,33,64,.516,5,23,.217,6,10,.600,87,2014-12-10,CHO,BOS
40,Home,L 96-103 ,240,35,89,.393,26,62,.419,9,27,.333,17,22,.773,96,42,88,.477,35,64,.547,7,24,.292,12,14,.857,103,2014-12-10,IND,LAC
41,@,L 96-104 ,240,32,75,.427,26,55,.473,6,20,.300,26,31,.839,96,39,80,.488,30,64,.469,9,16,.563,17,21,.810,104,2014-12-12,LAC,WAS
42,@,L 96-108 ,240,36,96,.375,29,68,.426,7,28,.250,17,26,.654,96,39,88,.443,29,54,.537,10,34,.294,20,34,.588,108,2014-12-13,DEN,HOU
43,@,W 96-94 ,240,35,73,.479,27,57,.474,8,16,.500,18,22,.818,96,30,75,.400,18,37,.486,12,38,.316,22,27,.815,94,2014-12-15,MIL,PHO
44,Home,L 96-100 ,240,36,77,.468,31,66,.470,5,11,.455,19,24,.792,96,42,84,.500,36,65,.554,6,19,.316,10,14,.714,100,2014-12-21,MIN,IND
45,@,W 96-88 ,240,35,82,.427,29,59,.492,6,23,.261,20,25,.800,96,35,84,.417,28,61,.459,7,23,.304,11,20,.550,88,2014-12-21,PHI,ORL
46,@,L 96-102 ,240,36,82,.439,29,57,.509,7,25,.280,17,22,.773,96,43,91,.473,37,68,.544,6,23,.261,10,14,.714,102,2014-12-23,DEN,BRK
47,Home,W 96-84 ,240,39,78,.500,34,63,.540,5,15,.333,13,18,.722,96,33,83,.398,29,63,.460,4,20,.200,14,19,.737,84,2014-12-23,IND,NOP
48,@,W 96-82 ,240,36,83,.434,30,69,.435,6,14,.429,18,21,.857,96,33,86,.384,25,61,.410,8,25,.320,8,15,.533,82,2014-12-30,BRK,CHI
49,@,W 96-80 ,240,40,90,.444,29,65,.446,11,25,.440,5,10,.500,96,29,85,.341,21,54,.389,8,31,.258,14,16,.875,80,2014-12-31,MIL,CLE
50,@,L 96-112 ,240,37,87,.425,30,61,.492,7,26,.269,15,25,.600,96,42,84,.500,28,52,.538,14,32,.438,14,16,.875,112,2015-01-02,PHI,PHO
51,@,W 96-88 (OT),265,37,94,.394,27,67,.403,10,27,.370,12,19,.632,96,33,84,.393,30,59,.508,3,25,.120,19,23,.826,88,2015-01-05,DAL,BRK
52,Home,L 96-102 ,240,37,88,.420,34,68,.500,3,20,.150,19,22,.864,96,37,81,.457,30,56,.536,7,25,.280,21,27,.778,102,2015-01-06,MIL,PHO
53,Home,W 96-86 ,240,32,72,.444,19,47,.404,13,25,.520,19,23,.826,96,35,79,.443,30,62,.484,5,17,.294,11,11,1.000,86,2015-01-07,ATL,MEM
54,Home,L 96-120 ,240,37,80,.463,26,54,.481,11,26,.423,11,21,.524,96,41,77,.532,25,41,.610,16,36,.444,22,32,.688,120,2015-01-08,NYK,HOU
55,@,L 96-109 ,240,39,83,.470,33,65,.508,6,18,.333,12,20,.600,96,41,91,.451,28,61,.459,13,30,.433,14,19,.737,109,2015-01-10,BOS,TOR
56,Home,L 96-98 ,240,40,89,.449,34,71,.479,6,18,.333,10,12,.833,96,32,85,.376,19,54,.352,13,31,.419,21,24,.875,98,2015-01-16,IND,DET
57,Home,L 96-106 ,240,36,79,.456,27,55,.491,9,24,.375,15,20,.750,96,40,87,.460,37,73,.507,3,14,.214,23,29,.793,106,2015-01-16,ORL,MEM
58,Home,W 96-81 ,240,36,80,.450,29,58,.500,7,22,.318,17,27,.630,96,29,75,.387,25,58,.431,4,17,.235,19,29,.655,81,2015-01-16,PHI,NOP
59,@,L 96-110 ,240,37,74,.500,31,55,.564,6,19,.316,16,20,.800,96,42,94,.447,31,65,.477,11,29,.379,15,17,.882,110,2015-01-16,POR,SAS
60,Home,W 96-80 ,240,38,83,.458,35,67,.522,3,16,.188,17,21,.810,96,28,77,.364,22,57,.386,6,20,.300,18,21,.857,80,2015-01-21,NOP,LAL
61,@,L 96-103 ,240,40,82,.488,35,67,.522,5,15,.333,11,14,.786,96,35,87,.402,22,56,.393,13,31,.419,20,20,1.000,103,2015-01-24,WAS,POR
62,@,W 96-84 ,240,38,84,.452,37,71,.521,1,13,.077,19,23,.826,96,31,87,.356,24,63,.381,7,24,.292,15,19,.789,84,2015-01-25,MIA,CHI
63,Home,L 96-121 ,240,35,79,.443,28,63,.444,7,16,.438,19,24,.792,96,46,91,.505,36,68,.529,10,23,.435,19,26,.731,121,2015-02-03,SAC,GSW
64,@,L 96-105 ,240,34,77,.442,30,61,.492,4,16,.250,24,30,.800,96,38,80,.475,27,55,.491,11,25,.440,18,27,.667,105,2015-02-04,WAS,ATL
65,@,L 96-107 ,240,35,79,.443,24,54,.444,11,25,.440,15,31,.484,96,39,86,.453,29,59,.492,10,27,.370,19,25,.760,107,2015-02-06,PHI,BOS
66,Home,W 96-93 ,240,37,75,.493,29,55,.527,8,20,.400,14,19,.737,96,36,86,.419,29,57,.509,7,29,.241,14,20,.700,93,2015-02-07,MIL,BOS
67,Home,L 96-100 ,240,33,79,.418,20,57,.351,13,22,.591,17,20,.850,96,39,93,.419,30,72,.417,9,21,.429,13,19,.684,100,2015-02-09,NOP,UTA
68,Home,W 96-80 ,240,33,77,.429,26,52,.500,7,25,.280,23,27,.852,96,33,83,.398,29,61,.475,4,22,.182,10,15,.667,80,2015-02-09,WAS,ORL
69,Home,L 96-106 ,240,37,85,.435,31,67,.463,6,18,.333,16,27,.593,96,43,79,.544,39,63,.619,4,16,.250,16,23,.696,106,2015-02-10,LAL,DEN
70,Home,L 96-110 ,240,31,81,.383,19,47,.404,12,34,.353,22,33,.667,96,39,91,.429,31,67,.463,8,24,.333,24,32,.750,110,2015-02-25,DEN,PHO
71,@,L 96-102 ,240,39,92,.424,32,71,.451,7,21,.333,11,15,.733,96,38,74,.514,27,49,.551,11,25,.440,15,19,.789,102,2015-02-25,BRK,NOP
72,Home,W 96-89 ,240,37,96,.385,28,65,.431,9,31,.290,13,16,.813,96,33,77,.429,31,63,.492,2,14,.143,21,31,.677,89,2015-02-27,CHI,MIN
73,Home,L 96-107 ,240,38,79,.481,37,75,.493,1,4,.250,19,23,.826,96,35,88,.398,27,65,.415,8,23,.348,29,32,.906,107,2015-02-27,SAC,SAS
74,@,W 96-86 ,240,38,87,.437,31,60,.517,7,27,.259,13,24,.542,96,27,87,.310,17,61,.279,10,26,.385,22,30,.733,86,2015-03-01,LAC,CHI
75,@,L 96-104 ,240,39,90,.433,25,49,.510,14,41,.341,4,9,.444,96,39,86,.453,31,57,.544,8,29,.276,18,21,.857,104,2015-03-03,HOU,ATL
76,@,W 96-87 ,240,39,83,.470,31,65,.477,8,18,.444,10,12,.833,96,32,78,.410,22,52,.423,10,26,.385,13,21,.619,87,2015-03-13,ATL,PHO
77,Home,W 96-83 ,240,37,78,.474,29,64,.453,8,14,.571,14,16,.875,96,30,72,.417,25,53,.472,5,19,.263,18,27,.667,83,2015-03-14,MEM,MIL
78,@,L 96-112 ,240,33,77,.429,22,55,.400,11,22,.500,19,22,.864,96,44,88,.500,39,69,.565,5,19,.263,19,23,.826,112,2015-03-20,NOP,GSW
79,@,W 96-92 ,240,29,69,.420,25,49,.510,4,20,.200,34,43,.791,96,38,87,.437,31,63,.492,7,24,.292,9,14,.643,92,2015-03-27,BOS,NYK
80,@,L 96-99 ,240,35,84,.417,27,57,.474,8,27,.296,18,31,.581,96,35,78,.449,27,56,.482,8,22,.364,21,27,.778,99,2015-03-30,HOU,TOR
81,@,L 96-106 ,240,39,87,.448,28,61,.459,11,26,.423,7,9,.778,96,41,91,.451,35,77,.455,6,14,.429,18,23,.783,106,2015-04-06,POR,BRK
82,Home,W 96-69 ,240,41,83,.494,37,58,.638,4,25,.160,10,14,.714,96,26,83,.313,22,63,.349,4,20,.200,13,18,.722,69,2015-04-07,ATL,PHO
83,Home,W 96-73 ,240,41,83,.494,35,63,.556,6,20,.300,8,12,.667,96,27,83,.325,24,65,.369,3,18,.167,16,22,.727,73,2015-04-12,MIL,BRK
84,Home,L 96-103 ,240,36,79,.456,30,60,.500,6,19,.316,18,22,.818,96,38,73,.521,29,50,.580,9,23,.391,18,26,.692,103,2015-11-02,BRK,MIL
85,@,L 96-102 ,240,36,98,.367,27,68,.397,9,30,.300,15,21,.714,96,37,81,.457,29,55,.527,8,26,.308,20,23,.870,102,2015-11-02,PHO,LAC
86,Home,W 96-86 ,240,33,83,.398,26,56,.464,7,27,.259,23,32,.719,96,33,84,.393,25,60,.417,8,24,.333,12,15,.800,86,2015-11-04,CLE,NYK
87,@,W 96-84 ,240,37,85,.435,26,61,.426,11,24,.458,11,17,.647,96,28,72,.389,23,52,.442,5,20,.250,23,34,.676,84,2015-11-05,UTA,DEN
88,@,W 96-84 ,240,37,76,.487,33,62,.532,4,14,.286,18,25,.720,96,30,85,.353,26,73,.356,4,12,.333,20,22,.909,84,2015-11-05,MIA,MIN
89,@,L 96-115 ,240,37,77,.481,30,57,.526,7,20,.350,15,21,.714,96,44,87,.506,29,57,.509,15,30,.500,12,20,.600,115,2015-11-05,MEM,POR
90,Home,W 96-76 ,240,35,83,.422,27,63,.429,8,20,.400,18,25,.720,96,28,71,.394,25,52,.481,3,19,.158,17,22,.773,76,2015-11-08,MIA,TOR
91,@,L 96-101 ,240,33,74,.446,26,47,.553,7,27,.259,23,35,.657,96,37,79,.468,30,60,.500,7,19,.368,20,26,.769,101,2015-11-14,DET,LAC
92,Home,L 96-97 ,240,37,76,.487,29,54,.537,8,22,.364,14,17,.824,96,39,76,.513,32,55,.582,7,21,.333,12,17,.706,97,2015-11-15,ATL,UTA
93,Home,W 96-95 ,240,35,86,.407,29,71,.408,6,15,.400,20,32,.625,96,35,87,.402,26,66,.394,9,21,.429,16,24,.667,95,2015-11-16,CHI,IND
94,Home,W 96-84 ,240,36,85,.424,28,61,.459,8,24,.333,16,19,.842,96,28,74,.378,22,45,.489,6,29,.207,22,37,.595,84,2015-11-20,MEM,HOU
95,@,W 96-86 ,240,40,87,.460,34,59,.576,6,28,.214,10,13,.769,96,33,77,.429,30,64,.469,3,13,.231,17,25,.680,86,2015-11-20,DET,MIN
96,Home,W 96-91 ,240,30,69,.435,25,51,.490,5,18,.278,31,45,.689,96,31,82,.378,21,51,.412,10,31,.323,19,24,.792,91,2015-11-21,MIA,PHI
97,@,L 96-110 ,240,30,77,.390,19,43,.442,11,34,.324,25,28,.893,96,37,86,.430,30,65,.462,7,21,.333,29,37,.784,110,2015-11-24,DAL,MEM
98,@,L 96-108 ,240,36,82,.439,29,59,.492,7,23,.304,17,23,.739,96,38,78,.487,26,48,.542,12,30,.400,20,26,.769,108,2015-11-28,LAL,POR
99,@,W 96-93 ,240,38,86,.442,33,69,.478,5,17,.294,15,20,.750,96,29,77,.377,25,58,.431,4,19,.211,31,38,.816,93,2015-12-01,ORL,MIN
0,@,W 96-86 ,240,36,79,.456,30,54,.556,6,25,.240,18,24,.750,96,33,90,.367,25,63,.397,8,27,.296,12,16,.750,86,2015-12-02,TOR,ATL
1,Home,L 96-100 ,240,37,81,.457,29,52,.558,8,29,.276,14,20,.700,96,39,84,.464,27,58,.466,12,26,.462,10,18,.556,100,2015-12-04,DAL,HOU
2,Home,L 96-102 ,240,37,89,.416,28,64,.438,9,25,.360,13,19,.684,96,37,89,.416,27,55,.491,10,34,.294,18,25,.720,102,2015-12-05,CHI,CHO
3,Home,W 96-83 ,240,36,86,.419,30,58,.517,6,28,.214,18,20,.900,96,35,81,.432,30,61,.492,5,20,.250,8,13,.615,83,2015-12-11,IND,MIA
4,Home,L 96-106 ,240,36,83,.434,23,48,.479,13,35,.371,11,18,.611,96,45,96,.469,33,62,.532,12,34,.353,4,7,.571,106,2015-12-11,PHO,POR
5,@,L 96-118 ,240,41,82,.500,38,66,.576,3,16,.188,11,18,.611,96,45,90,.500,32,61,.525,13,29,.448,15,19,.789,118,2015-12-12,IND,DET
6,Home,W 96-76 ,240,32,78,.410,25,56,.446,7,22,.318,25,34,.735,96,28,84,.333,18,56,.321,10,28,.357,10,14,.714,76,2015-12-13,TOR,PHI
7,@,L 96-115 ,240,38,92,.413,27,61,.443,11,31,.355,9,13,.692,96,43,85,.506,35,63,.556,8,22,.364,21,26,.808,115,2015-12-14,PHI,CHI
8,Home,W 96-84 ,240,37,83,.446,32,64,.500,5,19,.263,17,21,.810,96,30,77,.390,25,49,.510,5,28,.179,19,25,.760,84,2015-12-19,MEM,IND
9,Home,L 96-104 ,240,36,87,.414,23,62,.371,13,25,.520,11,17,.647,96,42,91,.462,28,56,.500,14,35,.400,6,13,.462,104,2015-12-23,PHO,DEN
10,Home,L 96-105 ,240,37,96,.385,31,72,.431,6,24,.250,16,23,.696,96,40,92,.435,33,74,.446,7,18,.389,18,20,.900,105,2015-12-25,OKC,CHI
11,Home,L 96-111 ,240,43,89,.483,38,72,.528,5,17,.294,5,16,.313,96,42,84,.500,30,57,.526,12,27,.444,15,22,.682,111,2015-12-26,BRK,WAS
12,@,L 96-112 ,240,32,84,.381,24,55,.436,8,29,.276,24,32,.750,96,45,80,.563,39,64,.609,6,16,.375,16,22,.727,112,2015-12-27,LAL,MEM
13,@,L 96-108 ,240,37,89,.416,27,62,.435,10,27,.370,12,17,.706,96,43,79,.544,35,63,.556,8,16,.500,14,17,.824,108,2015-12-29,DET,NYK
14,@,L 96-109 ,240,35,78,.449,19,42,.452,16,36,.444,10,14,.714,96,43,86,.500,28,53,.528,15,33,.455,8,11,.727,109,2015-12-31,POR,UTA
15,Home,W 96-95 ,240,37,80,.463,33,71,.465,4,9,.444,18,29,.621,96,35,84,.417,21,40,.525,14,44,.318,11,16,.688,95,2016-01-08,MIL,DAL
16,Home,L 96-101 ,240,36,81,.444,29,63,.460,7,18,.389,17,23,.739,96,39,84,.464,30,62,.484,9,22,.409,14,18,.778,101,2016-01-12,MIN,OKC
17,@,W 96-87 ,240,36,74,.486,27,55,.491,9,19,.474,15,21,.714,96,33,84,.393,29,67,.433,4,17,.235,17,26,.654,87,2016-01-20,PHI,ORL
18,@,W 96-83 ,240,38,87,.437,31,70,.443,7,17,.412,13,15,.867,96,35,94,.372,31,70,.443,4,24,.167,9,22,.409,83,2016-01-23,CHI,CLE
19,Home,W 96-93 ,240,32,76,.421,26,49,.531,6,27,.222,26,30,.867,96,35,80,.438,31,64,.484,4,16,.250,19,28,.679,93,2016-01-31,POR,MIN
20,@,L 96-105 (OT),265,39,90,.433,34,69,.493,5,21,.238,13,20,.650,96,38,85,.447,31,67,.463,7,18,.389,22,33,.667,105,2016-02-01,CHI,UTA
21,Home,L 96-99 ,240,39,85,.459,35,65,.538,4,20,.200,14,26,.538,96,39,81,.481,32,61,.525,7,20,.350,14,20,.700,99,2016-02-04,NOP,LAL
22,@,L 96-102 ,240,38,91,.418,25,60,.417,13,31,.419,7,9,.778,96,39,76,.513,29,49,.592,10,27,.370,14,20,.700,102,2016-02-05,IND,ATL
23,@,W 96-79 ,240,35,87,.402,24,52,.462,11,35,.314,15,23,.652,96,25,77,.325,18,41,.439,7,36,.194,22,30,.733,79,2016-02-06,POR,HOU
24,Home,L 96-101 ,240,37,84,.440,29,62,.468,8,22,.364,14,20,.700,96,37,86,.430,32,65,.492,5,21,.238,22,28,.786,101,2016-02-07,NYK,DEN
25,Home,W 96-94 ,240,39,85,.459,32,60,.533,7,25,.280,11,12,.917,96,35,91,.385,22,63,.349,13,28,.464,11,15,.733,94,2016-02-07,ORL,ATL
26,@,L 96-100 ,240,33,70,.471,26,49,.531,7,21,.333,23,30,.767,96,39,82,.476,31,63,.492,8,19,.421,14,21,.667,100,2016-02-10,UTA,NOP
27,Home,L 96-98 ,240,37,91,.407,29,71,.408,8,20,.400,14,16,.875,96,38,89,.427,30,69,.435,8,20,.400,14,15,.933,98,2016-02-10,ORL,SAS
28,Home,L 96-104 ,240,35,81,.432,30,59,.508,5,22,.227,21,24,.875,96,40,79,.506,30,52,.577,10,27,.370,14,15,.933,104,2016-02-21,BRK,CHO
29,@,W 96-88 ,240,37,80,.463,29,55,.527,8,25,.320,14,21,.667,96,34,79,.430,26,53,.491,8,26,.308,12,13,.923,88,2016-02-22,DET,CLE
30,@,W 96-78 ,240,38,79,.481,29,61,.475,9,18,.500,11,12,.917,96,33,77,.429,30,60,.500,3,17,.176,9,12,.750,78,2016-02-25,SAS,UTA
31,@,W 96-95 ,240,36,83,.434,25,55,.455,11,28,.393,13,19,.684,96,35,85,.412,31,66,.470,4,19,.211,21,24,.875,95,2016-02-26,CHO,IND
32,Home,L 96-98 ,240,37,89,.416,32,69,.464,5,20,.250,17,25,.680,96,40,84,.476,33,69,.478,7,15,.467,11,17,.647,98,2016-02-27,UTA,BRK
33,@,L 96-100 ,240,37,80,.463,29,62,.468,8,18,.444,14,15,.933,96,35,83,.422,26,54,.481,9,29,.310,21,25,.840,100,2016-02-29,IND,CLE
34,Home,L 96-103 ,240,40,75,.533,32,50,.640,8,25,.320,8,10,.800,96,36,75,.480,33,55,.600,3,20,.150,28,36,.778,103,2016-02-29,DEN,MEM
35,Home,L 96-104 ,240,34,90,.378,31,71,.437,3,19,.158,25,30,.833,96,32,76,.421,25,51,.490,7,25,.280,33,43,.767,104,2016-03-06,MIL,OKC
36,@,L 96-116 ,240,32,84,.381,25,58,.431,7,26,.269,25,31,.806,96,41,87,.471,26,55,.473,15,32,.469,19,24,.792,116,2016-03-09,MEM,BOS
37,Home,L 96-102 ,240,39,86,.453,30,56,.536,9,30,.300,9,11,.818,96,38,85,.447,29,58,.500,9,27,.333,17,30,.567,102,2016-03-09,DAL,DET
38,@,L 96-104 ,240,35,82,.427,28,59,.475,7,23,.304,19,27,.704,96,38,82,.463,31,58,.534,7,24,.292,21,29,.724,104,2016-03-10,ATL,TOR
39,Home,L 96-118 ,240,38,81,.469,30,60,.500,8,21,.381,12,15,.800,96,47,91,.516,37,73,.507,10,18,.556,14,20,.700,118,2016-03-11,CHI,MIA
40,Home,L 96-99 ,240,36,84,.429,30,57,.526,6,27,.222,18,25,.720,96,37,86,.430,30,65,.462,7,21,.333,18,21,.857,99,2016-03-11,OKC,MIN
41,Home,L 96-107 ,240,32,76,.421,22,46,.478,10,30,.333,22,34,.647,96,42,87,.483,33,57,.579,9,30,.300,14,18,.778,107,2016-03-14,CHO,DAL
42,@,L 96-117 ,240,35,87,.402,29,67,.433,6,20,.300,20,23,.870,96,43,88,.489,30,67,.448,13,21,.619,18,24,.750,117,2016-03-16,CHI,WAS
43,Home,W 96-86 ,240,37,75,.493,32,56,.571,5,19,.263,17,25,.680,96,34,92,.370,31,79,.392,3,13,.231,15,17,.882,86,2016-03-17,MIL,MEM
44,@,L 96-107 ,240,39,93,.419,34,74,.459,5,19,.263,13,19,.684,96,40,85,.471,33,63,.524,7,22,.318,20,24,.833,107,2016-03-21,ORL,BOS
45,Home,W 96-94 ,240,37,82,.451,33,63,.524,4,19,.211,18,28,.643,96,32,80,.400,26,56,.464,6,24,.250,24,32,.750,94,2016-03-24,LAC,POR
46,Home,L 96-98 ,240,39,90,.433,36,71,.507,3,19,.158,15,17,.882,96,37,87,.425,27,61,.443,10,26,.385,14,16,.875,98,2016-03-29,IND,CHI
47,Home,L 96-103 (OT),265,37,92,.402,28,60,.467,9,32,.281,13,29,.448,96,39,89,.438,27,54,.500,12,35,.343,13,18,.722,103,2016-03-30,UTA,GSW
48,Home,W 96-90 ,240,34,78,.436,28,55,.509,6,23,.261,22,31,.710,96,32,88,.364,21,53,.396,11,35,.314,15,21,.714,90,2016-04-05,TOR,CHO
49,@,L 96-118 ,240,37,83,.446,30,65,.462,7,18,.389,15,19,.789,96,43,77,.558,37,57,.649,6,20,.300,26,30,.867,118,2016-04-10,ORL,MIA
50,Home,L 96-103 ,240,39,89,.438,29,63,.460,10,26,.385,8,12,.667,96,41,93,.441,28,56,.500,13,37,.351,8,15,.533,103,2016-04-13,BRK,TOR
51,@,W 96-91 ,240,35,74,.473,29,51,.569,6,23,.261,20,26,.769,96,31,77,.403,19,38,.500,12,39,.308,17,21,.810,91,2016-04-13,SAS,DAL
52,@,L 96-101 ,240,39,83,.470,30,53,.566,9,30,.300,9,15,.600,96,41,85,.482,35,60,.583,6,25,.240,13,15,.867,101,2016-04-13,UTA,LAL
53,Home,L 96-107 ,240,39,92,.424,36,76,.474,3,16,.188,15,20,.750,96,40,89,.449,33,66,.500,7,23,.304,20,24,.833,107,2016-10-26,MIL,CHO
54,Home,L 96-108 ,240,34,89,.382,28,71,.394,6,18,.333,22,28,.786,96,47,97,.485,43,81,.531,4,16,.250,10,16,.625,108,2016-10-26,ORL,MIA
55,Home,W 96-89 ,240,31,75,.413,25,50,.500,6,25,.240,28,40,.700,96,32,84,.381,23,61,.377,9,23,.391,16,21,.762,89,2016-10-28,UTA,LAL
56,@,L 96-113 ,240,35,87,.402,28,55,.509,7,32,.219,19,24,.792,96,45,95,.474,36,69,.522,9,26,.346,14,17,.824,113,2016-10-30,LAL,OKC
57,@,L 96-108 (OT),265,34,89,.382,29,66,.439,5,23,.217,23,27,.852,96,37,86,.430,24,57,.421,13,29,.448,21,29,.724,108,2016-11-01,SAC,MIA
58,@,L 96-122 ,240,35,87,.402,25,60,.417,10,27,.370,16,28,.571,96,46,89,.517,32,59,.542,14,30,.467,16,20,.800,122,2016-11-03,OKC,GSW
59,Home,W 96-87 ,240,37,84,.440,31,59,.525,6,25,.240,16,18,.889,96,34,88,.386,25,60,.417,9,28,.321,10,15,.667,87,2016-11-04,TOR,MIA
60,@,W 96-91 ,240,34,78,.436,29,62,.468,5,16,.313,23,31,.742,96,30,84,.357,23,54,.426,7,30,.233,24,31,.774,91,2016-11-06,SAC,TOR
61,@,L 96-110 ,240,33,79,.418,22,46,.478,11,33,.333,19,27,.704,96,44,92,.478,34,62,.548,10,30,.333,12,17,.706,110,2016-11-09,BRK,NYK
62,Home,W 96-86 ,240,36,81,.444,27,61,.443,9,20,.450,15,19,.789,96,32,76,.421,27,51,.529,5,25,.200,17,21,.810,86,2016-11-11,SAS,DET
63,@,L 96-117 ,240,36,83,.434,25,54,.463,11,29,.379,13,20,.650,96,48,95,.505,35,63,.556,13,32,.406,8,14,.571,117,2016-11-12,PHI,ATL
64,@,L 96-106 ,240,35,78,.449,29,48,.604,6,30,.200,20,21,.952,96,36,68,.529,29,50,.580,7,18,.389,27,36,.750,106,2016-11-12,MEM,MIL
65,Home,L 96-102 ,240,35,73,.479,27,45,.600,8,28,.286,18,22,.818,96,36,76,.474,28,55,.509,8,21,.381,22,26,.846,102,2016-11-14,UTA,MEM
66,Home,W 96-73 ,240,39,97,.402,32,67,.478,7,30,.233,11,21,.524,96,28,85,.329,21,62,.339,7,23,.304,10,13,.769,73,2016-11-17,MIA,MIL
67,@,L 96-100 ,240,39,84,.464,32,56,.571,7,28,.250,11,17,.647,96,37,90,.411,27,61,.443,10,29,.345,16,24,.667,100,2016-11-18,ATL,CHO
68,Home,L 96-116 ,240,36,76,.474,35,69,.507,1,7,.143,23,29,.793,96,46,97,.474,37,71,.521,9,26,.346,15,18,.833,116,2016-11-18,IND,PHO
69,Home,L 96-99 ,240,36,87,.414,29,70,.414,7,17,.412,17,24,.708,96,35,78,.449,25,47,.532,10,31,.323,19,27,.704,99,2016-11-21,DET,HOU
70,Home,W 96-91 ,240,35,75,.467,27,55,.491,8,20,.400,18,25,.720,96,35,74,.473,27,47,.574,8,27,.296,13,20,.650,91,2016-11-21,SAS,DAL
71,@,W 96-85 ,240,36,85,.424,31,65,.477,5,20,.250,19,22,.864,96,34,84,.405,27,57,.474,7,27,.259,10,14,.714,85,2016-11-23,ATL,IND
72,@,L 96-117 ,240,33,86,.384,30,69,.435,3,17,.176,27,33,.818,96,45,83,.542,36,59,.610,9,24,.375,18,23,.783,117,2016-11-23,MIN,NOP
73,Home,L 96-104 ,240,38,92,.413,31,64,.484,7,28,.250,13,17,.765,96,41,86,.477,33,62,.532,8,24,.333,14,20,.700,104,2016-11-27,ORL,MIL
74,@,W 96-90 ,240,33,81,.407,31,73,.425,2,8,.250,28,41,.683,96,32,91,.352,28,70,.400,4,21,.190,22,29,.759,90,2016-11-30,LAL,CHI
75,Home,L 96-114 ,240,39,85,.459,34,65,.523,5,20,.250,13,21,.619,96,45,88,.511,35,64,.547,10,24,.417,14,16,.875,114,2016-12-02,NOP,LAC
76,Home,L 96-97 ,240,30,73,.411,24,49,.490,6,24,.250,30,34,.882,96,40,93,.430,32,65,.492,8,28,.286,9,14,.643,97,2016-12-05,MIL,SAS
77,Home,W 96-91 ,240,33,86,.384,31,69,.449,2,17,.118,28,35,.800,96,32,82,.390,18,41,.439,14,41,.341,13,26,.500,91,2016-12-06,MEM,PHI
78,@,L 96-99 ,240,40,90,.444,29,58,.500,11,32,.344,5,8,.625,96,41,83,.494,38,62,.613,3,21,.143,14,27,.519,99,2016-12-11,BOS,OKC
79,Home,W 96-88 ,240,34,78,.436,25,50,.500,9,28,.321,19,26,.731,96,32,98,.327,24,68,.353,8,30,.267,16,19,.842,88,2016-12-16,BOS,CHO
80,@,W 96-92 ,240,31,80,.388,24,56,.429,7,24,.292,27,37,.730,96,29,77,.377,24,52,.462,5,25,.200,29,36,.806,92,2016-12-16,SAC,MEM
81,@,W 96-95 ,240,35,83,.422,28,52,.538,7,31,.226,19,23,.826,96,32,72,.444,22,45,.489,10,27,.370,21,28,.750,95,2016-12-21,DAL,POR
82,@,L 96-123 ,240,37,79,.468,30,55,.545,7,24,.292,15,18,.833,96,45,80,.563,36,55,.655,9,25,.360,24,27,.889,123,2016-12-23,WAS,MIL
83,Home,L 96-116 ,240,33,83,.398,23,56,.411,10,27,.370,20,28,.714,96,43,76,.566,34,61,.557,9,15,.600,21,27,.778,116,2016-12-31,CHI,MIL
84,Home,L 96-110 ,240,36,85,.424,25,56,.446,11,29,.379,13,16,.813,96,41,84,.488,29,57,.509,12,27,.444,16,19,.842,110,2017-01-09,NYK,NOP
85,@,L 96-105 ,240,39,92,.424,33,65,.508,6,27,.222,12,18,.667,96,39,76,.513,30,50,.600,9,26,.346,18,26,.692,105,2017-01-11,ORL,LAC
86,Home,W 96-86 ,240,39,86,.453,34,68,.500,5,18,.278,13,14,.929,96,33,85,.388,30,65,.462,3,20,.150,17,21,.810,86,2017-01-13,MIN,OKC
87,@,L 96-112 ,240,34,84,.405,24,59,.407,10,25,.400,18,26,.692,96,40,87,.460,32,59,.542,8,28,.286,24,31,.774,112,2017-01-20,MIL,ORL
88,Home,W 96-88 ,240,33,81,.407,27,55,.491,6,26,.231,24,28,.857,96,36,84,.429,32,70,.457,4,14,.286,12,13,.923,88,2017-01-26,UTA,LAL
89,@,L 96-104 ,240,37,87,.425,33,61,.541,4,26,.154,18,22,.818,96,39,82,.476,28,56,.500,11,26,.423,15,23,.652,104,2017-01-30,BRK,MIA
90,Home,L 96-115 ,240,31,74,.419,26,55,.473,5,19,.263,29,39,.744,96,39,80,.488,23,52,.442,16,28,.571,21,24,.875,115,2017-01-30,PHO,MEM
91,@,L 96-113 ,240,36,85,.424,31,57,.544,5,28,.179,19,28,.679,96,46,99,.465,41,77,.532,5,22,.227,16,17,.941,113,2017-02-06,PHI,DET
92,Home,L 96-97 ,240,38,83,.458,26,54,.481,12,29,.414,8,15,.533,96,36,73,.493,29,49,.592,7,24,.292,18,25,.720,97,2017-02-14,LAL,SAC
93,Home,W 96-83 ,240,36,78,.462,24,52,.462,12,26,.462,12,16,.750,96,31,77,.403,26,54,.481,5,23,.217,16,25,.640,83,2017-02-25,DAL,NOP
94,@,L 96-100 ,240,40,83,.482,35,69,.507,5,14,.357,11,16,.688,96,39,76,.513,33,56,.589,6,20,.300,16,18,.889,100,2017-02-26,PHO,MIL
95,Home,W 96-89 ,240,33,76,.434,24,58,.414,9,18,.500,21,23,.913,96,37,83,.446,28,57,.491,9,26,.346,6,13,.462,89,2017-02-27,DAL,MIA
96,Home,L 96-105 ,240,33,90,.367,26,70,.371,7,20,.350,23,26,.885,96,40,84,.476,31,59,.525,9,25,.360,16,19,.842,105,2017-03-01,TOR,WAS
97,Home,L 96-97 ,240,34,77,.442,25,50,.500,9,27,.333,19,31,.613,96,35,78,.449,20,45,.444,15,33,.455,12,21,.571,97,2017-03-05,ATL,IND
98,@,L 96-108 ,240,36,83,.434,30,67,.448,6,16,.375,18,21,.857,96,37,75,.493,24,45,.533,13,30,.433,21,28,.750,108,2017-03-06,SAC,DEN
99,@,L 95-96 ,240,34,84,.405,26,61,.426,8,23,.348,19,23,.826,95,38,86,.442,34,67,.507,4,19,.211,16,21,.762,96,2011-12-26,MIL,CHA
0,@,L 95-104 ,240,36,82,.439,30,55,.545,6,27,.222,17,20,.850,95,44,83,.530,35,61,.574,9,22,.409,7,10,.700,104,2011-12-26,HOU,ORL
1,Home,W 95-82 ,240,35,88,.398,25,55,.455,10,33,.303,15,22,.682,95,34,73,.466,31,66,.470,3,7,.429,11,19,.579,82,2011-12-26,SAS,MEM
2,@,L 95-98 ,240,28,70,.400,22,56,.393,6,14,.429,33,45,.733,95,40,94,.426,38,78,.487,2,16,.125,16,20,.800,98,2011-12-27,MIN,MIL
3,Home,L 95-96 ,240,39,82,.476,32,64,.500,7,18,.389,10,16,.625,95,36,78,.462,35,72,.486,1,6,.167,23,28,.821,96,2011-12-28,CHA,MIA
4,Home,L 95-98 ,240,34,87,.391,32,71,.451,2,16,.125,25,33,.758,95,29,77,.377,19,52,.365,10,25,.400,30,38,.789,98,2011-12-28,MEM,OKC
5,Home,W 95-84 ,240,38,82,.463,29,63,.460,9,19,.474,10,13,.769,95,35,80,.438,31,64,.484,4,16,.250,10,16,.625,84,2011-12-31,HOU,ATL
6,@,L 95-101 ,240,37,80,.463,28,60,.467,9,20,.450,12,19,.632,95,37,78,.474,27,61,.443,10,17,.588,17,24,.708,101,2012-01-04,GSW,SAS
7,Home,L 95-98 ,240,38,87,.437,33,73,.452,5,14,.357,14,15,.933,95,36,85,.424,29,64,.453,7,21,.333,19,22,.864,98,2012-01-07,HOU,OKC
8,Home,L 95-100 ,240,39,85,.459,34,73,.466,5,12,.417,12,20,.600,95,34,74,.459,28,59,.475,6,15,.400,26,32,.813,100,2012-01-10,MEM,OKC
9,Home,W 95-89 (OT),265,36,86,.419,30,69,.435,6,17,.353,17,23,.739,95,32,81,.395,27,65,.415,5,16,.313,20,34,.588,89,2012-01-11,LAC,MIA
10,@,W 95-85 ,240,35,73,.479,28,53,.528,7,20,.350,18,26,.692,95,36,80,.450,35,64,.547,1,16,.063,12,17,.706,85,2012-01-11,OKC,NOH
11,@,L 95-101 (OT),265,41,96,.427,38,75,.507,3,21,.143,10,12,.833,95,42,92,.457,37,76,.487,5,16,.313,12,17,.706,101,2012-01-11,HOU,SAS
12,@,W 95-90 ,240,30,66,.455,27,58,.466,3,8,.375,32,38,.842,95,33,74,.446,29,57,.509,4,17,.235,20,32,.625,90,2012-01-13,IND,TOR
13,Home,L 95-105 ,240,35,82,.427,30,67,.448,5,15,.333,20,28,.714,95,41,94,.436,32,75,.427,9,19,.474,14,19,.737,105,2012-01-17,CLE,GSW
14,Home,L 95-105 ,240,38,91,.418,31,68,.456,7,23,.304,12,14,.857,95,32,75,.427,20,50,.400,12,25,.480,29,37,.784,105,2012-01-17,MIL,DEN
15,Home,W 95-89 ,240,40,85,.471,34,70,.486,6,15,.400,9,15,.600,95,35,74,.473,33,63,.524,2,11,.182,17,23,.739,89,2012-01-21,CHI,CHA
16,@,L 95-128 ,240,36,87,.414,30,68,.441,6,19,.316,17,22,.773,95,50,92,.543,42,76,.553,8,16,.500,20,27,.741,128,2012-01-21,SAC,MEM
17,@,L 95-110 ,240,37,77,.481,30,58,.517,7,19,.368,14,21,.667,95,43,75,.573,36,56,.643,7,19,.368,17,23,.739,110,2012-01-23,NJN,CHI
18,@,W 95-90 ,240,38,80,.475,33,70,.471,5,10,.500,14,21,.667,95,36,90,.400,33,77,.429,3,13,.231,15,21,.714,90,2012-01-25,IND,CHI
19,Home,W 95-74 ,240,38,78,.487,29,63,.460,9,15,.600,10,15,.667,95,29,83,.349,26,72,.361,3,11,.273,13,17,.765,74,2012-01-28,PHI,DET
20,@,L 95-109 ,240,40,75,.533,36,62,.581,4,13,.308,11,19,.579,95,43,78,.551,37,63,.587,6,15,.400,17,21,.810,109,2012-01-30,NOH,MIA
21,@,W 95-86 ,240,33,81,.407,28,61,.459,5,20,.250,24,33,.727,95,30,84,.357,26,65,.400,4,19,.211,22,25,.880,86,2012-02-01,OKC,DAL
22,Home,W 95-92 ,240,34,76,.447,29,59,.492,5,17,.294,22,29,.759,95,40,88,.455,36,70,.514,4,18,.222,8,16,.500,92,2012-02-02,SAC,POR
23,Home,W 95-89 ,240,34,85,.400,24,63,.381,10,22,.455,17,24,.708,95,33,75,.440,24,56,.429,9,19,.474,14,19,.737,89,2012-02-04,PHO,CHA
24,Home,W 95-89 ,240,31,69,.449,27,57,.474,4,12,.333,29,34,.853,95,34,79,.430,28,57,.491,6,22,.273,15,21,.714,89,2012-02-05,MIA,TOR
25,Home,W 95-90 ,240,38,81,.469,30,64,.469,8,17,.471,11,17,.647,95,34,81,.420,27,57,.474,7,24,.292,15,20,.750,90,2012-02-06,PHI,LAL
26,Home,L 95-105 ,240,33,72,.458,24,46,.522,9,26,.346,20,27,.741,95,44,90,.489,35,62,.565,9,28,.321,8,9,.889,105,2012-02-08,DEN,DAL
27,@,W 95-64 ,240,39,90,.433,33,75,.440,6,15,.400,11,20,.550,95,25,76,.329,24,68,.353,1,8,.125,13,19,.684,64,2012-02-10,CHI,CHA
28,Home,W 95-91 ,240,37,75,.493,34,62,.548,3,13,.231,18,26,.692,95,34,88,.386,28,68,.412,6,20,.300,17,24,.708,91,2012-02-12,BOS,CHI
29,Home,L 95-99 ,240,39,84,.464,36,71,.507,3,13,.231,14,25,.560,95,36,83,.434,30,69,.435,6,14,.429,21,32,.656,99,2012-02-14,DET,SAS
30,@,L 95-96 ,240,36,83,.434,29,60,.483,7,23,.304,16,18,.889,95,37,87,.425,29,69,.420,8,18,.444,14,18,.778,96,2012-02-15,OKC,HOU
31,@,L 95-103 ,240,33,82,.402,27,59,.458,6,23,.261,23,31,.742,95,38,86,.442,31,59,.525,7,27,.259,20,28,.714,103,2012-02-22,DEN,LAC
32,@,L 95-99 ,240,36,89,.404,32,80,.400,4,9,.444,19,22,.864,95,41,90,.456,38,72,.528,3,18,.167,14,20,.700,99,2012-02-28,NOH,CHI
33,@,L 95-104 ,240,38,87,.437,29,63,.460,9,24,.375,10,11,.909,95,44,91,.484,38,70,.543,6,21,.286,10,16,.625,104,2012-02-29,POR,DEN
34,@,W 95-84 ,240,34,77,.442,25,62,.403,9,15,.600,18,23,.783,95,30,80,.375,27,64,.422,3,16,.188,21,27,.778,84,2012-02-29,TOR,NOH
35,Home,L 95-102 ,240,37,90,.411,31,74,.419,6,16,.375,15,19,.789,95,34,75,.453,19,39,.487,15,36,.417,19,27,.704,102,2012-02-29,WAS,ORL
36,@,L 95-104 ,240,34,86,.395,33,73,.452,1,13,.077,26,32,.813,95,42,79,.532,39,71,.549,3,8,.375,17,21,.810,104,2012-03-01,MIN,PHO
37,Home,W 95-94 ,240,32,80,.400,21,52,.404,11,28,.393,20,27,.741,95,34,84,.405,29,61,.475,5,23,.217,21,32,.656,94,2012-03-05,MIN,LAC
38,Home,W 95-91 ,240,29,76,.382,21,49,.429,8,27,.296,29,33,.879,95,36,84,.429,27,63,.429,9,21,.429,10,10,1.000,91,2012-03-05,OKC,DAL
39,Home,W 95-85 ,240,31,80,.388,24,54,.444,7,26,.269,26,30,.867,95,32,84,.381,26,61,.426,6,23,.261,15,23,.652,85,2012-03-06,DAL,NYK
40,@,W 95-89 ,240,39,85,.459,36,78,.462,3,7,.429,14,16,.875,95,33,80,.413,28,57,.491,5,23,.217,18,25,.720,89,2012-03-10,NOH,MIN
41,@,L 95-122 ,240,36,88,.409,29,74,.392,7,14,.500,16,19,.842,95,46,73,.630,36,50,.720,10,23,.435,20,26,.769,122,2012-03-10,CHA,OKC
42,@,L 95-120 ,240,36,80,.450,30,61,.492,6,19,.316,17,21,.810,95,46,86,.535,37,65,.569,9,21,.429,19,21,.905,120,2012-03-16,BOS,SAC
43,Home,W 95-91 ,240,35,86,.407,29,63,.460,6,23,.261,19,27,.704,95,35,72,.486,29,52,.558,6,20,.300,15,18,.833,91,2012-03-17,LAC,HOU
44,@,L 95-111 ,240,39,84,.464,31,63,.492,8,21,.381,9,14,.643,95,41,74,.554,30,56,.536,11,18,.611,18,28,.643,111,2012-03-18,POR,OKC
45,Home,L 95-112 ,240,36,83,.434,30,62,.484,6,21,.286,17,20,.850,95,45,84,.536,35,59,.593,10,25,.400,12,15,.800,112,2012-03-19,DEN,DAL
46,@,L 95-99 ,240,36,80,.450,30,65,.462,6,15,.400,17,24,.708,95,36,76,.474,35,67,.522,1,9,.111,26,35,.743,99,2012-03-20,PHO,MIA
47,@,W 95-92 ,240,37,76,.487,30,53,.566,7,23,.304,14,21,.667,95,38,85,.447,34,67,.507,4,18,.222,12,14,.857,92,2012-03-24,ATL,WAS
48,Home,L 95-102 ,240,33,79,.418,29,67,.433,4,12,.333,25,35,.714,95,33,73,.452,31,61,.508,2,12,.167,34,45,.756,102,2012-03-26,CHA,BOS
49,Home,L 95-109 ,240,34,79,.430,27,63,.429,7,16,.438,20,25,.800,95,45,79,.570,39,62,.629,6,17,.353,13,16,.813,109,2012-03-27,POR,OKC
50,Home,L 95-99 ,240,34,82,.415,29,65,.446,5,17,.294,22,28,.786,95,37,88,.420,33,73,.452,4,15,.267,21,28,.750,99,2012-03-31,MIL,MEM
51,Home,W 95-90 ,240,37,77,.481,31,65,.477,6,12,.500,15,19,.789,95,35,74,.473,31,60,.517,4,14,.286,16,22,.727,90,2012-03-31,PHI,ATL
52,@,L 95-102 ,240,33,72,.458,23,48,.479,10,24,.417,19,24,.792,95,43,76,.566,40,65,.615,3,11,.273,13,19,.684,102,2012-04-03,ORL,DET
53,Home,W 95-85 ,240,40,80,.500,36,65,.554,4,15,.267,11,16,.688,95,35,83,.422,28,67,.418,7,16,.438,8,14,.571,85,2012-04-04,DAL,MEM
54,Home,W 95-90 ,240,37,91,.407,32,76,.421,5,15,.333,16,24,.667,95,36,85,.424,34,73,.466,2,12,.167,16,24,.667,90,2012-04-06,MIL,CHA
55,@,W 95-82 ,240,39,91,.429,27,60,.450,12,31,.387,5,10,.500,95,31,77,.403,26,56,.464,5,21,.238,15,22,.682,82,2012-04-12,LAC,MIN
56,@,W 95-89 ,240,34,81,.420,28,65,.431,6,16,.375,21,27,.778,95,34,81,.420,33,71,.465,1,10,.100,20,27,.741,89,2012-04-13,NJN,PHI
57,Home,L 95-104 ,240,35,78,.449,25,53,.472,10,25,.400,15,17,.882,95,36,83,.434,23,48,.479,13,35,.371,19,24,.792,104,2012-04-18,NJN,NYK
58,@,L 95-106 ,240,40,86,.465,36,74,.486,4,12,.333,11,15,.733,95,38,84,.452,34,71,.479,4,13,.308,26,37,.703,106,2012-04-21,NJN,MIL
59,@,L 95-102 ,240,31,70,.443,26,53,.491,5,17,.294,28,32,.875,95,33,82,.402,19,44,.432,14,38,.368,22,28,.786,102,2012-04-25,CHA,ORL
60,Home,L 95-99 ,240,35,80,.438,31,63,.492,4,17,.235,21,23,.913,95,38,80,.475,32,60,.533,6,20,.300,17,26,.654,99,2012-10-31,NOH,SAS
61,Home,L 95-105 ,240,34,68,.500,27,52,.519,7,16,.438,20,28,.714,95,38,84,.452,30,62,.484,8,22,.364,21,27,.778,105,2012-11-02,LAL,LAC
62,@,W 95-85 (OT),265,39,93,.419,29,69,.420,10,24,.417,7,12,.583,95,34,96,.354,29,70,.414,5,26,.192,12,18,.667,85,2012-11-03,POR,HOU
63,Home,L 95-104 ,240,33,71,.465,24,49,.490,9,22,.409,20,22,.909,95,41,83,.494,33,58,.569,8,25,.320,14,20,.700,104,2012-11-04,OKC,ATL
64,Home,W 95-86 ,240,37,83,.446,32,66,.485,5,17,.294,16,18,.889,95,25,74,.338,21,51,.412,4,23,.174,32,46,.696,86,2012-11-07,UTA,LAL
65,@,W 95-89 ,240,37,76,.487,30,54,.556,7,22,.318,14,16,.875,95,34,81,.420,25,56,.446,9,25,.360,12,16,.750,89,2012-11-09,MIA,ATL
66,Home,L 95-101 ,240,34,74,.459,31,65,.477,3,9,.333,24,31,.774,95,41,81,.506,38,65,.585,3,16,.188,16,16,1.000,101,2012-11-12,CHI,BOS
67,@,W 95-87 ,240,35,79,.443,28,61,.459,7,18,.389,18,22,.818,95,30,83,.361,24,60,.400,6,23,.261,21,26,.808,87,2012-11-12,ATL,POR
68,@,L 95-105 ,240,37,72,.514,32,53,.604,5,19,.263,16,21,.762,95,37,76,.487,32,61,.525,5,15,.333,26,32,.813,105,2012-11-16,NYK,MEM
69,Home,L 95-110 ,240,33,78,.423,26,66,.394,7,12,.583,22,28,.786,95,40,74,.541,26,45,.578,14,29,.483,16,20,.800,110,2012-11-16,NOH,OKC
70,Home,L 95-103 ,240,36,96,.375,28,71,.394,8,25,.320,15,20,.750,95,38,74,.514,28,51,.549,10,23,.435,17,20,.850,103,2012-11-17,CLE,DAL
71,Home,W 95-90 ,240,35,73,.479,29,52,.558,6,21,.286,19,37,.514,95,34,82,.415,27,59,.458,7,23,.304,15,21,.714,90,2012-11-20,LAL,BRK
72,@,L 95-103 ,240,32,78,.410,29,60,.483,3,18,.167,28,37,.757,95,42,78,.538,31,53,.585,11,25,.440,8,18,.444,103,2012-11-23,MIN,POR
73,@,W 95-83 ,240,33,82,.402,23,58,.397,10,24,.417,19,29,.655,95,32,75,.427,31,68,.456,1,7,.143,18,24,.750,83,2012-11-28,BRK,BOS
74,@,L 95-101 ,240,31,82,.378,25,60,.417,6,22,.273,27,35,.771,95,37,81,.457,33,62,.532,4,19,.211,23,26,.885,101,2012-11-28,MIN,LAC
75,Home,W 95-85 ,240,34,87,.391,26,68,.382,8,19,.421,19,27,.704,95,34,93,.366,29,75,.387,5,18,.278,12,16,.750,85,2012-11-30,MIN,MIL
76,@,L 95-99 (OT),265,36,99,.364,32,84,.381,4,15,.267,19,22,.864,95,37,89,.416,30,60,.500,7,29,.241,18,24,.750,99,2012-12-01,MEM,SAS
77,@,W 95-85 ,240,34,72,.472,30,57,.526,4,15,.267,23,27,.852,95,31,85,.365,26,69,.377,5,16,.313,18,25,.720,85,2012-12-05,CHI,CLE
78,@,L 95-104 ,240,36,79,.456,29,63,.460,7,16,.438,16,20,.800,95,41,85,.482,31,59,.525,10,26,.385,12,19,.632,104,2012-12-07,WAS,ATL
79,Home,W 95-94 (OT),265,37,99,.374,35,88,.398,2,11,.182,19,26,.731,95,35,81,.432,29,59,.492,6,22,.273,18,25,.720,94,2012-12-07,PHI,BOS
80,Home,L 95-97 ,240,38,80,.475,31,58,.534,7,22,.318,12,15,.800,95,38,82,.463,29,58,.500,9,24,.375,12,14,.857,97,2012-12-12,MIA,GSW
81,Home,W 95-85 ,240,35,77,.455,27,63,.429,8,14,.571,17,27,.630,95,35,81,.432,32,69,.464,3,12,.250,12,16,.750,85,2012-12-14,IND,PHI
82,Home,W 95-74 ,240,34,84,.405,22,48,.458,12,36,.333,15,22,.682,95,27,69,.391,27,56,.482,0,13,.000,20,23,.870,74,2012-12-14,TOR,DAL
83,Home,W 95-94 ,240,37,80,.463,26,51,.510,11,29,.379,10,12,.833,95,36,80,.450,25,60,.417,11,20,.550,11,15,.733,94,2012-12-16,POR,NOH
84,Home,L 95-100 (OT),265,36,95,.379,30,77,.390,6,18,.333,17,22,.773,95,34,78,.436,25,54,.463,9,24,.375,23,34,.676,100,2012-12-18,WAS,ATL
85,Home,L 95-110 ,240,37,96,.385,34,74,.459,3,22,.136,18,21,.857,95,42,78,.538,32,50,.640,10,28,.357,16,18,.889,110,2012-12-20,DAL,MIA
86,Home,W 95-92 ,240,33,74,.446,25,52,.481,8,22,.364,21,30,.700,95,38,88,.432,30,70,.429,8,18,.444,8,10,.800,92,2012-12-23,BRK,PHI
87,Home,L 95-98 ,240,39,79,.494,35,69,.507,4,10,.400,13,20,.650,95,35,82,.427,24,58,.414,11,24,.458,17,23,.739,98,2012-12-29,CHA,NOH
88,@,W 95-86 ,240,41,83,.494,32,61,.525,9,22,.409,4,8,.500,95,36,82,.439,26,62,.419,10,20,.500,4,12,.333,86,2013-01-01,ATL,NOH
89,Home,W 95-89 ,240,39,85,.459,36,72,.500,3,13,.231,14,20,.700,95,37,84,.440,32,70,.457,5,14,.357,10,12,.833,89,2013-01-02,PHO,PHI
90,Home,W 95-80 ,240,40,92,.435,37,72,.514,3,20,.150,12,20,.600,95,31,82,.378,26,64,.406,5,18,.278,13,18,.722,80,2013-01-05,IND,MIL
91,Home,W 95-88 ,240,40,83,.482,35,70,.500,5,13,.385,10,12,.833,95,33,73,.452,27,52,.519,6,21,.286,16,20,.800,88,2013-01-07,NOH,SAS
92,@,L 95-103 ,240,36,76,.474,28,56,.500,8,20,.400,15,19,.789,95,40,72,.556,31,53,.585,9,19,.474,14,23,.609,103,2013-01-11,UTA,ATL
93,@,L 95-109 ,240,37,87,.425,33,61,.541,4,26,.154,17,17,1.000,95,45,78,.577,37,57,.649,8,21,.381,11,17,.647,109,2013-01-16,BRK,ATL
94,Home,W 95-94 ,240,41,85,.482,36,74,.486,5,11,.455,8,13,.615,95,39,86,.453,31,69,.449,8,17,.471,8,11,.727,94,2013-01-16,SAC,WAS
95,@,L 95-105 ,240,34,83,.410,21,53,.396,13,30,.433,14,16,.875,95,40,87,.460,29,68,.426,11,19,.579,14,17,.824,105,2013-01-18,HOU,IND
96,Home,W 95-88 ,240,36,80,.450,31,58,.534,5,22,.227,18,20,.900,95,36,84,.429,32,68,.471,4,16,.250,12,14,.857,88,2013-01-18,SAS,GSW
97,Home,W 95-83 ,240,39,93,.419,30,76,.395,9,17,.529,8,12,.667,95,32,81,.395,29,64,.453,3,17,.176,16,23,.696,83,2013-01-21,CHI,LAL
98,Home,L 95-98 ,240,37,81,.457,30,57,.526,7,24,.292,14,18,.778,95,39,84,.464,31,65,.477,8,19,.421,12,17,.706,98,2013-01-21,POR,WAS
99,Home,W 95-90 ,240,37,82,.451,35,70,.500,2,12,.167,19,22,.864,95,32,84,.381,25,67,.373,7,17,.412,19,22,.864,90,2013-01-22,CLE,BOS
0,Home,L 95-105 ,240,37,83,.446,26,49,.531,11,34,.324,10,13,.769,95,40,86,.465,32,65,.492,8,21,.381,17,25,.680,105,2013-01-23,HOU,DEN
1,Home,L 95-97 ,240,35,81,.432,27,63,.429,8,18,.444,17,20,.850,95,39,78,.500,35,62,.565,4,16,.250,15,19,.789,97,2013-01-24,ORL,TOR
2,Home,L 95-105 ,240,36,86,.419,28,71,.394,8,15,.533,15,21,.714,95,37,76,.487,31,53,.585,6,23,.261,25,30,.833,105,2013-01-25,SAC,OKC
3,@,L 95-110 ,240,34,77,.442,30,60,.500,4,17,.235,23,28,.821,95,45,88,.511,40,77,.519,5,11,.455,15,18,.833,110,2013-01-27,PHO,DAL
4,Home,L 95-108 ,240,36,84,.429,32,66,.485,4,18,.222,19,25,.760,95,45,84,.536,34,68,.500,11,16,.688,7,10,.700,108,2013-01-29,CLE,GSW
5,@,L 95-109 ,240,33,79,.418,25,60,.417,8,19,.421,21,24,.875,95,42,82,.512,35,62,.565,7,20,.350,18,23,.783,109,2013-02-02,CHA,HOU
6,@,L 95-122 ,240,37,79,.468,31,64,.484,6,15,.400,15,25,.600,95,52,92,.565,43,68,.632,9,24,.375,9,13,.692,122,2013-02-06,CHA,CLE
7,Home,L 95-99 ,240,34,82,.415,30,64,.469,4,18,.222,23,26,.885,95,35,73,.479,31,54,.574,4,19,.211,25,30,.833,99,2013-02-06,TOR,BOS
8,@,L 95-116 ,240,36,87,.414,31,64,.484,5,23,.217,18,30,.600,95,46,87,.529,41,76,.539,5,11,.455,19,25,.760,116,2013-02-07,LAL,BOS
9,Home,L 95-96 ,240,40,97,.412,38,86,.442,2,11,.182,13,15,.867,95,38,84,.452,33,65,.508,5,19,.263,15,18,.833,96,2013-02-13,CLE,SAS
10,@,L 95-110 ,240,35,83,.422,23,64,.359,12,19,.632,13,13,1.000,95,45,89,.506,39,73,.534,6,16,.375,14,15,.933,110,2013-02-24,SAC,NOH
11,@,W 95-90 ,240,34,82,.415,27,64,.422,7,18,.389,20,26,.769,95,36,85,.424,35,68,.515,1,17,.059,17,21,.810,90,2013-02-26,MIL,DAL
12,Home,L 95-96 ,240,40,84,.476,32,65,.492,8,19,.421,7,10,.700,95,39,72,.542,30,57,.526,9,15,.600,9,16,.563,96,2013-02-27,WAS,DET
13,@,L 95-100 ,240,39,78,.500,32,59,.542,7,19,.368,10,16,.625,95,35,81,.432,28,61,.459,7,20,.350,23,31,.742,100,2013-03-01,DET,NOH
14,@,W 95-94 ,240,31,70,.443,23,49,.469,8,21,.381,25,29,.862,95,35,86,.407,25,55,.455,10,31,.323,14,14,1.000,94,2013-03-07,OKC,NYK
15,Home,W 95-78 ,240,32,81,.395,20,54,.370,12,27,.444,19,33,.576,95,32,90,.356,29,73,.397,3,17,.176,11,17,.647,78,2013-03-08,BRK,WAS
16,Home,W 95-90 ,240,34,83,.410,26,57,.456,8,26,.308,19,25,.760,95,31,76,.408,26,59,.441,5,17,.294,23,28,.821,90,2013-03-12,CLE,WAS
17,Home,L 95-113 ,240,34,76,.447,31,62,.500,3,14,.214,24,30,.800,95,43,83,.518,35,67,.522,8,16,.500,19,22,.864,113,2013-03-15,GSW,CHI
18,@,L 95-97 ,240,39,85,.459,34,72,.472,5,13,.385,12,16,.750,95,36,64,.563,31,49,.633,5,15,.333,20,27,.741,97,2013-03-17,NOH,MIN
19,Home,W 95-73 ,240,34,87,.391,28,64,.438,6,23,.261,21,24,.875,95,28,88,.318,25,73,.342,3,15,.200,14,21,.667,73,2013-03-19,IND,ORL
20,@,L 95-102 ,240,36,83,.434,23,57,.404,13,26,.500,10,13,.769,95,42,87,.483,33,68,.485,9,19,.474,9,13,.692,102,2013-03-19,POR,MIL
21,Home,L 95-98 ,240,37,81,.457,30,60,.500,7,21,.333,14,17,.824,95,32,72,.444,20,43,.465,12,29,.414,22,30,.733,98,2013-03-20,CLE,MIA
22,@,L 95-101 ,240,39,86,.453,31,58,.534,8,28,.286,9,17,.529,95,37,85,.435,33,71,.465,4,14,.286,23,32,.719,101,2013-03-23,SAC,DEN
23,@,L 95-101 ,240,34,74,.459,25,49,.510,9,25,.360,18,24,.750,95,37,79,.468,28,53,.528,9,26,.346,18,24,.750,101,2013-03-23,BRK,LAC
24,@,L 95-96 ,240,33,78,.423,23,56,.411,10,22,.455,19,21,.905,95,32,80,.400,23,54,.426,9,26,.346,23,27,.852,96,2013-03-24,SAS,HOU
25,Home,L 95-105 ,240,33,67,.493,27,54,.500,6,13,.462,23,32,.719,95,43,86,.500,39,67,.582,4,19,.211,15,18,.833,105,2013-03-29,POR,UTA
26,Home,W 95-94 ,240,30,76,.395,22,53,.415,8,23,.348,27,40,.675,95,36,72,.500,29,56,.518,7,16,.438,15,22,.682,94,2013-03-31,CHI,DET
27,@,W 95-82 ,240,40,77,.519,33,55,.600,7,22,.318,8,12,.667,95,32,66,.485,23,40,.575,9,26,.346,9,19,.474,82,2013-04-03,NYK,ATL
28,Home,L 95-113 ,240,34,89,.382,30,75,.400,4,14,.286,23,26,.885,95,43,76,.566,33,55,.600,10,21,.476,17,22,.773,113,2013-04-03,CLE,BRK
29,Home,W 95-94 ,240,35,89,.393,29,72,.403,6,17,.353,19,30,.633,95,41,88,.466,37,70,.529,4,18,.222,8,10,.800,94,2013-04-04,DEN,DAL
30,@,W 95-93 ,240,40,85,.471,36,70,.514,4,15,.267,11,16,.688,95,30,67,.448,27,52,.519,3,15,.200,30,40,.750,93,2013-04-05,TOR,MIN
31,Home,W 95-83 ,240,39,77,.506,28,51,.549,11,26,.423,6,11,.545,95,32,77,.416,30,65,.462,2,12,.167,17,20,.850,83,2013-04-05,UTA,NOH
32,@,L 95-109 ,240,33,76,.434,26,52,.500,7,24,.292,22,30,.733,95,42,84,.500,34,63,.540,8,21,.381,17,21,.810,109,2013-04-07,LAL,LAC
33,@,W 95-92 ,240,32,80,.400,28,65,.431,4,15,.267,27,29,.931,95,34,80,.425,27,59,.458,7,21,.333,17,19,.895,92,2013-04-07,NOH,PHO
34,@,L 95-111 ,240,35,90,.389,29,67,.433,6,23,.261,19,22,.864,95,44,77,.571,33,56,.589,11,21,.524,12,16,.750,111,2013-04-10,MIN,LAC
35,Home,W 95-85 ,240,37,80,.463,33,71,.465,4,9,.444,17,24,.708,95,34,87,.391,25,58,.431,9,29,.310,8,12,.667,85,2013-04-13,CHA,MIL
36,@,L 95-106 ,240,34,79,.430,20,42,.476,14,37,.378,13,13,1.000,95,43,74,.581,36,56,.643,7,18,.389,13,14,.929,106,2013-04-15,NYK,CHA
37,Home,L 95-96 ,240,39,86,.453,34,73,.466,5,13,.385,12,19,.632,95,33,66,.500,20,38,.526,13,28,.464,17,27,.630,96,2013-04-15,CLE,MIA
38,@,L 95-104 ,240,38,87,.437,31,60,.517,7,27,.259,12,21,.571,95,42,92,.457,37,69,.536,5,23,.217,15,20,.750,104,2013-04-15,SAC,OKC
39,Home,W 95-92 ,240,37,78,.474,30,60,.500,7,18,.389,14,19,.737,95,36,85,.424,29,69,.420,7,16,.438,13,17,.765,92,2013-04-17,CHI,WAS
40,Home,L 95-105 ,240,36,80,.450,30,54,.556,6,26,.231,17,27,.630,95,43,85,.506,35,66,.530,8,19,.421,11,14,.786,105,2013-04-17,IND,PHI
41,@,L 95-99 (OT),265,35,84,.417,27,51,.529,8,33,.242,17,24,.708,95,33,90,.367,23,58,.397,10,32,.313,23,34,.676,99,2013-04-17,HOU,LAL
42,@,W 95-89 ,240,36,85,.424,26,58,.448,10,27,.370,13,18,.722,95,37,89,.416,34,68,.500,3,21,.143,12,14,.857,89,2013-04-17,MIL,OKC
43,Home,L 95-108 ,240,33,79,.418,26,61,.426,7,18,.389,22,22,1.000,95,42,91,.462,30,62,.484,12,29,.414,12,16,.750,108,2013-04-17,SAS,MIN
44,@,L 95-107 ,240,35,83,.422,28,57,.491,7,26,.269,18,23,.783,95,37,72,.514,26,52,.500,11,20,.550,22,29,.759,107,2013-10-29,CHI,MIA
45,@,W 95-90 ,240,30,70,.429,20,47,.426,10,23,.435,25,30,.833,95,34,85,.400,29,74,.392,5,11,.455,17,21,.810,90,2013-10-30,IND,NOP
46,@,L 95-102 ,240,40,88,.455,33,65,.508,7,23,.304,8,14,.571,95,36,77,.468,26,54,.481,10,23,.435,20,31,.645,102,2013-11-01,TOR,ATL
47,Home,W 95-88 ,240,36,74,.486,31,59,.525,5,15,.333,18,22,.818,95,33,70,.471,26,50,.520,7,20,.350,15,18,.833,88,2013-11-04,MEM,BOS
48,Home,L 95-104 ,240,31,72,.431,25,51,.490,6,21,.286,27,33,.818,95,41,83,.494,31,60,.517,10,23,.435,12,14,.857,104,2013-11-05,TOR,MIA
49,Home,W 95-79 ,240,37,76,.487,31,57,.544,6,19,.316,15,18,.833,95,31,75,.413,27,67,.403,4,8,.500,13,19,.684,79,2013-11-11,IND,MEM
50,@,L 95-105 ,240,33,75,.440,24,49,.490,9,26,.346,20,29,.690,95,41,84,.488,31,58,.534,10,26,.385,13,19,.684,105,2013-11-12,WAS,DAL
51,@,L 95-113 ,240,37,87,.425,34,69,.493,3,18,.167,18,27,.667,95,42,70,.600,34,54,.630,8,16,.500,21,26,.808,113,2013-11-12,DET,GSW
52,@,L 95-116 ,240,34,84,.405,31,74,.419,3,10,.300,24,33,.727,95,44,79,.557,33,59,.559,11,20,.550,17,21,.810,116,2013-11-12,NOP,LAL
53,@,L 95-118 ,240,33,79,.418,22,49,.449,11,30,.367,18,21,.857,95,46,79,.582,34,56,.607,12,23,.522,14,24,.583,118,2013-11-12,MIL,MIA
54,@,W 95-91 ,240,37,88,.420,25,54,.463,12,34,.353,9,13,.692,95,35,77,.455,30,53,.566,5,24,.208,16,21,.762,91,2013-11-13,NYK,ATL
55,@,L 95-124 ,240,36,87,.414,31,71,.437,5,16,.313,18,21,.857,95,45,82,.549,34,60,.567,11,22,.500,23,26,.885,124,2013-11-13,CLE,MIN
56,Home,W 95-91 ,240,36,81,.444,31,68,.456,5,13,.385,18,30,.600,95,32,67,.478,23,48,.479,9,19,.474,18,25,.720,91,2013-11-20,CHA,BRK
57,@,L 95-102 ,240,34,82,.415,25,60,.417,9,22,.409,18,28,.643,95,39,82,.476,28,58,.483,11,24,.458,13,17,.765,102,2013-11-22,GSW,LAL
58,@,L 95-98 ,240,32,83,.386,27,69,.391,5,14,.357,26,29,.897,95,36,88,.409,24,62,.387,12,26,.462,14,15,.933,98,2013-11-22,CHI,POR
59,Home,W 95-73 ,240,36,71,.507,31,59,.525,5,12,.417,18,22,.818,95,28,71,.394,24,53,.453,4,18,.222,13,29,.448,73,2013-11-24,OKC,UTA
60,@,W 95-84 ,240,35,72,.486,31,53,.585,4,19,.211,21,25,.840,95,29,83,.349,19,55,.345,10,28,.357,16,24,.667,84,2013-11-27,MIA,CLE
61,@,L 95-97 ,240,34,83,.410,28,61,.459,6,22,.273,21,25,.840,95,31,71,.437,22,47,.468,9,24,.375,26,34,.765,97,2013-11-29,NYK,DEN
62,@,L 95-114 ,240,37,89,.416,31,67,.463,6,22,.273,15,23,.652,95,39,74,.527,20,42,.476,19,32,.594,17,20,.850,114,2013-11-29,BRK,HOU
63,Home,L 95-97 ,240,35,89,.393,25,60,.417,10,29,.345,15,19,.789,95,36,83,.434,29,63,.460,7,20,.350,18,20,.900,97,2013-12-03,SAC,OKC
64,@,W 95-86 ,240,40,84,.476,37,68,.544,3,16,.188,12,15,.800,95,33,80,.413,29,69,.420,4,11,.364,16,18,.889,86,2013-12-04,IND,UTA
65,Home,L 95-109 ,240,33,88,.375,30,72,.417,3,16,.188,26,34,.765,95,39,77,.506,32,56,.571,7,21,.333,24,30,.800,109,2013-12-06,NOP,OKC
66,Home,L 95-110 ,240,36,85,.424,29,65,.446,7,20,.350,16,22,.727,95,40,72,.556,29,44,.659,11,28,.393,19,21,.905,110,2013-12-08,DET,MIA
67,Home,W 95-93 ,240,37,86,.430,25,58,.431,12,28,.429,9,15,.600,95,37,88,.420,29,65,.446,8,23,.348,11,14,.786,93,2013-12-11,GSW,DAL
68,Home,W 95-87 ,240,35,78,.449,27,61,.443,8,17,.471,17,24,.708,95,30,80,.375,26,65,.400,4,15,.267,23,28,.821,87,2013-12-17,CHA,SAC
69,@,L 95-108 ,240,37,93,.398,30,73,.411,7,20,.350,14,20,.700,95,33,78,.423,22,49,.449,11,29,.379,31,36,.861,108,2013-12-18,NOP,LAC
70,@,L 95-107 ,240,29,77,.377,21,48,.438,8,29,.276,29,39,.744,95,43,84,.512,34,69,.493,9,15,.600,12,14,.857,107,2013-12-19,CHI,OKC
71,@,W 95-87 ,240,39,82,.476,38,73,.521,1,9,.111,16,19,.842,95,33,79,.418,27,57,.474,6,22,.273,15,23,.652,87,2013-12-21,MEM,NYK
72,@,W 95-78 ,240,36,74,.486,31,57,.544,5,17,.294,18,20,.900,95,25,71,.352,20,54,.370,5,17,.294,23,31,.742,78,2013-12-25,CHI,BRK
73,Home,L 95-101 ,240,33,79,.418,19,43,.442,14,36,.389,15,26,.577,95,41,80,.513,32,53,.604,9,27,.333,10,17,.588,101,2013-12-25,LAL,MIA
74,@,W 95-83 ,240,31,73,.425,21,45,.467,10,28,.357,23,33,.697,95,30,79,.380,20,60,.333,10,19,.526,13,21,.619,83,2013-12-27,TOR,NYK
75,Home,L 95-117 ,240,40,89,.449,35,67,.522,5,22,.227,10,17,.588,95,43,90,.478,32,66,.485,11,24,.458,20,29,.690,117,2013-12-28,MIL,MIN
76,@,W 95-91 ,240,28,65,.431,22,50,.440,6,15,.400,33,42,.786,95,35,78,.449,35,73,.479,0,5,.000,21,28,.750,91,2013-12-30,CHI,MEM
77,Home,W 95-82 ,240,34,78,.436,27,59,.458,7,19,.368,20,23,.870,95,32,74,.432,27,60,.450,5,14,.357,13,20,.650,82,2014-01-01,TOR,IND
78,@,W 95-93 ,240,31,70,.443,22,46,.478,9,24,.375,24,31,.774,95,34,68,.500,25,46,.543,9,22,.409,16,19,.842,93,2014-01-02,BRK,OKC
79,@,W 95-92 ,240,38,77,.494,36,71,.507,2,6,.333,17,22,.773,95,31,89,.348,24,60,.400,7,29,.241,23,28,.821,92,2014-01-03,NOP,BOS
80,Home,L 95-126 ,240,38,80,.475,30,62,.484,8,18,.444,11,16,.688,95,46,100,.460,30,74,.405,16,26,.615,18,23,.783,126,2014-01-06,PHI,MIN
81,@,L 95-104 (2OT),290,34,80,.425,28,57,.491,6,23,.261,21,27,.778,95,40,86,.465,33,66,.500,7,20,.350,17,21,.810,104,2014-01-10,MIA,BRK
82,Home,L 95-101 ,240,38,87,.437,31,76,.408,7,11,.636,12,17,.706,95,35,67,.522,30,55,.545,5,12,.417,26,31,.839,101,2014-01-13,NOP,SAS
83,Home,W 95-92 ,240,39,77,.506,33,62,.532,6,15,.400,11,20,.550,95,35,88,.398,30,68,.441,5,20,.250,17,26,.654,92,2014-01-15,PHI,CHA
84,Home,L 95-109 ,240,29,83,.349,22,60,.367,7,23,.304,30,36,.833,95,33,78,.423,25,48,.521,8,30,.267,35,42,.833,109,2014-01-17,NYK,LAC
85,@,L 95-100 ,240,39,95,.411,29,66,.439,10,29,.345,7,10,.700,95,32,65,.492,23,49,.469,9,16,.563,27,33,.818,100,2014-01-20,TOR,CHA
86,@,W 95-92 ,240,35,77,.455,30,68,.441,5,9,.556,20,23,.870,95,31,74,.419,24,55,.436,7,19,.368,23,28,.821,92,2014-01-20,NOP,MEM
87,Home,W 95-91 ,240,39,84,.464,34,69,.493,5,15,.333,12,20,.600,95,39,90,.433,33,64,.516,6,26,.231,7,9,.778,91,2014-01-22,CHA,LAC
88,Home,L 95-112 ,240,40,93,.430,34,74,.459,6,19,.316,9,11,.818,95,41,76,.539,28,55,.509,13,21,.619,17,26,.654,112,2014-01-24,CHI,LAC
89,Home,L 95-104 ,240,38,89,.427,32,69,.464,6,20,.300,13,16,.813,95,40,84,.476,32,64,.500,8,20,.400,16,22,.727,104,2014-01-24,PHI,TOR
90,Home,L 95-101 ,240,34,71,.479,27,49,.551,7,22,.318,20,25,.800,95,39,86,.453,33,70,.471,6,16,.375,17,23,.739,101,2014-01-24,PHO,WAS
91,@,W 95-86 ,240,34,73,.466,29,56,.518,5,17,.294,22,26,.846,95,32,85,.376,24,61,.393,8,24,.333,14,16,.875,86,2014-01-27,MIN,CHI
92,@,W 95-94 ,240,37,86,.430,30,65,.462,7,21,.333,14,25,.560,95,32,87,.368,25,68,.368,7,19,.368,23,30,.767,94,2014-01-29,PHI,BOS
93,Home,L 95-112 ,240,37,72,.514,34,53,.642,3,19,.158,18,22,.818,95,41,80,.513,25,53,.472,16,27,.593,14,19,.737,112,2014-01-29,MIA,OKC
94,Home,L 95-120 ,240,35,74,.473,24,50,.480,11,24,.458,14,17,.824,95,49,77,.636,44,62,.710,5,15,.333,17,20,.850,120,2014-01-31,BRK,OKC
95,@,W 95-90 ,240,33,88,.375,23,62,.371,10,26,.385,19,24,.792,95,35,73,.479,32,64,.500,3,9,.333,17,21,.810,90,2014-01-31,GSW,UTA
96,@,L 95-105 ,240,33,79,.418,25,56,.446,8,23,.348,21,29,.724,95,39,80,.488,32,59,.542,7,21,.333,20,23,.870,105,2014-02-01,CHA,PHO
97,Home,W 95-93 ,240,36,75,.480,30,53,.566,6,22,.273,17,26,.654,95,34,83,.410,29,69,.420,5,14,.357,20,25,.800,93,2014-02-01,SAS,SAC
98,Home,L 95-102 ,240,36,79,.456,30,65,.462,6,14,.429,17,20,.850,95,38,81,.469,33,63,.524,5,18,.278,21,25,.840,102,2014-02-03,NOP,SAS
99,@,L 95-111 ,240,32,89,.360,20,58,.345,12,31,.387,19,29,.655,95,43,84,.512,34,67,.507,9,17,.529,16,24,.667,111,2014-02-07,BRK,DET
0,Home,L 95-101 ,240,40,90,.444,34,75,.453,6,15,.400,9,11,.818,95,42,85,.494,34,61,.557,8,24,.333,9,13,.692,101,2014-02-08,MIL,HOU
1,Home,L 95-98 ,240,32,85,.376,25,62,.403,7,23,.304,24,27,.889,95,40,83,.482,33,69,.478,7,14,.500,11,12,.917,98,2014-02-11,POR,OKC
2,Home,L 95-109 ,240,33,88,.375,18,56,.321,15,32,.469,14,21,.667,95,37,78,.474,32,65,.492,5,13,.385,30,36,.833,109,2014-02-23,DEN,SAC
3,Home,L 95-100 ,240,37,103,.359,33,83,.398,4,20,.200,17,26,.654,95,28,76,.368,16,45,.356,12,31,.387,32,38,.842,100,2014-02-25,DEN,POR
4,Home,W 95-88 (OT),265,38,90,.422,31,71,.437,7,19,.368,12,17,.706,95,30,74,.405,23,54,.426,7,20,.350,21,22,.955,88,2014-03-09,CHI,MIA
5,Home,L 95-96 ,240,33,68,.485,24,41,.585,9,27,.333,20,26,.769,95,34,78,.436,22,49,.449,12,29,.414,16,19,.842,96,2014-03-12,MIA,BRK
6,@,L 95-108 ,240,37,80,.463,31,58,.534,6,22,.273,15,28,.536,95,41,70,.586,32,49,.653,9,21,.429,17,27,.630,108,2014-03-17,PHO,BRK
7,Home,L 95-102 ,240,36,81,.444,28,59,.475,8,22,.364,15,24,.625,95,38,89,.427,28,58,.483,10,31,.323,16,20,.800,102,2014-03-20,CLE,OKC
8,@,L 95-105 ,240,37,73,.507,29,47,.617,8,26,.308,13,17,.765,95,43,84,.512,36,67,.537,7,17,.412,12,17,.706,105,2014-03-22,MIA,NOP
9,Home,L 95-102 ,240,30,72,.417,22,49,.449,8,23,.348,27,33,.818,95,38,74,.514,26,50,.520,12,24,.500,14,16,.875,102,2014-03-24,ATL,PHO
10,Home,W 95-85 ,240,37,85,.435,31,68,.456,6,17,.353,15,22,.682,95,32,86,.372,25,60,.417,7,26,.269,14,17,.824,85,2014-03-25,ORL,POR
11,@,L 95-102 ,240,33,68,.485,26,47,.553,7,21,.333,22,27,.815,95,36,71,.507,30,57,.526,6,14,.429,24,32,.750,102,2014-03-28,UTA,NOP
12,@,L 95-103 ,240,36,77,.468,25,47,.532,11,30,.367,12,20,.600,95,36,84,.429,29,53,.547,7,31,.226,24,30,.800,103,2014-03-31,PHI,ATL
13,Home,L 95-107 ,240,35,83,.422,28,55,.509,7,28,.250,18,24,.750,95,44,92,.478,39,71,.549,5,21,.238,14,15,.933,107,2014-04-04,LAL,DAL
14,Home,L 95-102 ,240,34,89,.382,25,54,.463,9,35,.257,18,24,.750,95,37,86,.430,31,69,.449,6,17,.353,22,32,.688,102,2014-04-08,ATL,DET
15,@,W 95-83 ,240,40,72,.556,31,49,.633,9,23,.391,6,11,.545,95,36,87,.414,32,63,.508,4,24,.167,7,13,.538,83,2014-04-08,DAL,UTA
16,Home,L 95-112 ,240,35,89,.393,26,61,.426,9,28,.321,16,20,.800,95,45,92,.489,32,67,.478,13,25,.520,9,13,.692,112,2014-04-11,LAL,GSW
17,@,L 95-117 ,240,39,88,.443,33,70,.471,6,18,.333,11,17,.647,95,44,81,.543,39,68,.574,5,13,.385,24,32,.750,117,2014-04-11,PHI,MEM
18,@,W 95-93 ,240,35,80,.438,29,55,.527,6,25,.240,19,31,.613,95,34,79,.430,26,49,.531,8,30,.267,17,23,.739,93,2014-04-14,CHA,ATL
19,@,L 95-108 ,240,36,72,.500,29,57,.509,7,15,.467,16,19,.842,95,39,77,.506,34,64,.531,5,13,.385,25,32,.781,108,2014-04-14,ORL,CHI
20,Home,W 95-92 ,240,37,81,.457,29,64,.453,8,17,.471,13,19,.684,95,36,80,.450,27,51,.529,9,29,.310,11,18,.611,92,2014-04-16,NYK,TOR
21,@,L 95-107 ,240,36,75,.480,30,56,.536,6,19,.316,17,24,.708,95,39,81,.481,30,53,.566,9,28,.321,20,23,.870,107,2014-10-29,WAS,MIA
22,@,W 95-77 ,240,33,75,.440,27,48,.563,6,27,.222,23,32,.719,95,24,78,.308,21,60,.350,3,18,.167,26,35,.743,77,2014-10-29,GSW,SAC
23,@,W 95-90 ,240,37,69,.536,31,57,.544,6,12,.500,15,18,.833,95,32,70,.457,23,46,.500,9,24,.375,17,20,.850,90,2014-10-30,NYK,CLE
24,Home,L 95-108 ,240,38,81,.469,31,61,.508,7,20,.350,12,24,.500,95,33,83,.398,29,62,.468,4,21,.190,38,48,.792,108,2014-11-01,ORL,TOR
25,@,W 95-90 ,240,36,81,.444,30,62,.484,6,19,.316,17,21,.810,95,37,92,.402,30,65,.462,7,27,.259,9,14,.643,90,2014-11-02,GSW,POR
26,@,L 95-98 ,240,39,90,.433,30,70,.429,9,20,.450,8,10,.800,95,32,87,.368,21,64,.328,11,23,.478,23,33,.697,98,2014-11-05,NYK,DET
27,@,W 95-86 ,240,34,73,.466,29,57,.509,5,16,.313,22,30,.733,95,33,89,.371,30,74,.405,3,15,.200,17,20,.850,86,2014-11-05,CHI,MIL
28,@,L 95-98 ,240,36,77,.468,31,57,.544,5,20,.250,18,23,.783,95,37,75,.493,26,52,.500,11,23,.478,13,24,.542,98,2014-11-07,MIL,DET
29,@,L 95-107 ,240,33,69,.478,22,45,.489,11,24,.458,18,21,.857,95,34,79,.430,22,49,.449,12,30,.400,27,33,.818,107,2014-11-09,GSW,PHO
30,Home,L 95-97 ,240,37,86,.430,29,63,.460,8,23,.348,13,14,.929,95,33,70,.471,27,58,.466,6,12,.500,25,32,.781,97,2014-11-12,NYK,ORL
31,Home,L 95-103 ,240,37,86,.430,29,57,.509,8,29,.276,13,14,.929,95,39,91,.429,32,75,.427,7,16,.438,18,19,.947,103,2014-11-14,PHO,CHO
32,Home,W 95-88 ,240,32,86,.372,28,71,.394,4,15,.267,27,33,.818,95,34,82,.415,24,56,.429,10,26,.385,10,17,.588,88,2014-11-15,MEM,DET
33,@,W 95-83 ,240,31,72,.431,22,45,.489,9,27,.333,24,27,.889,95,29,70,.414,20,47,.426,9,23,.391,16,26,.615,83,2014-11-17,MIA,BRK
34,Home,W 95-92 ,240,30,82,.366,15,36,.417,15,46,.326,20,23,.870,95,35,88,.398,29,53,.547,6,35,.171,16,22,.727,92,2014-11-22,HOU,DAL
35,Home,L 95-97 ,240,42,86,.488,39,77,.506,3,9,.333,8,10,.800,95,36,72,.500,27,52,.519,9,20,.450,16,23,.696,97,2014-11-24,UTA,CHI
36,Home,W 95-93 (OT),265,37,90,.411,28,71,.394,9,19,.474,12,18,.667,95,36,101,.356,24,69,.348,12,32,.375,9,12,.750,93,2014-12-03,BRK,SAS
37,Home,L 95-102 ,240,36,90,.400,34,75,.453,2,15,.133,21,23,.913,95,37,80,.463,25,52,.481,12,28,.429,16,21,.762,102,2014-12-03,CHO,CHI
38,@,L 95-111 ,240,33,85,.388,21,56,.375,12,29,.414,17,21,.810,95,45,93,.484,39,74,.527,6,19,.316,15,19,.789,111,2014-12-03,LAL,WAS
39,@,L 95-100 ,240,34,93,.366,27,65,.415,7,28,.250,20,26,.769,95,33,81,.407,22,54,.407,11,27,.407,23,31,.742,100,2014-12-06,PHO,HOU
40,@,L 95-98 ,240,32,70,.457,25,55,.455,7,15,.467,24,37,.649,95,38,96,.396,33,71,.465,5,25,.200,17,25,.680,98,2014-12-09,SAC,LAL
41,Home,W 95-79 ,240,38,91,.418,28,61,.459,10,30,.333,9,13,.692,95,30,72,.417,24,47,.511,6,25,.240,13,22,.591,79,2014-12-10,ATL,PHI
42,@,L 95-109 ,240,37,76,.487,31,61,.508,6,15,.400,15,17,.882,95,37,73,.507,27,54,.500,10,19,.526,25,30,.833,109,2014-12-10,NYK,SAS
43,Home,L 95-101 ,240,37,85,.435,30,63,.476,7,22,.318,14,18,.778,95,40,81,.494,34,65,.523,6,16,.375,15,18,.833,101,2014-12-12,BOS,NYK
44,Home,L 95-100 ,240,34,77,.442,26,49,.531,8,28,.286,19,22,.864,95,36,72,.500,29,52,.558,7,20,.350,21,31,.677,100,2014-12-12,UTA,MIA
45,@,W 95-85 ,240,40,90,.444,35,73,.479,5,17,.294,10,12,.833,95,34,88,.386,30,73,.411,4,15,.267,13,16,.813,85,2014-12-13,POR,IND
46,@,W 95-90 ,240,35,79,.443,29,59,.492,6,20,.300,19,23,.826,95,33,93,.355,22,64,.344,11,29,.379,13,19,.684,90,2014-12-13,DET,SAC
47,@,W 95-90 (OT),265,36,78,.462,27,54,.500,9,24,.375,14,18,.778,95,29,78,.372,20,49,.408,9,29,.310,23,28,.821,90,2014-12-14,TOR,NYK
48,@,L 95-108 ,240,38,78,.487,34,67,.507,4,11,.364,15,22,.682,95,41,89,.461,34,71,.479,7,18,.389,19,22,.864,108,2014-12-15,SAS,POR
49,Home,W 95-82 ,240,37,83,.446,26,53,.491,11,30,.367,10,15,.667,95,36,74,.486,32,59,.542,4,15,.267,6,8,.750,82,2014-12-15,TOR,ORL
50,@,W 95-91 ,240,33,72,.458,24,48,.500,9,24,.375,20,26,.769,95,30,77,.390,22,49,.449,8,28,.286,23,32,.719,91,2014-12-16,MIA,BRK
51,@,L 95-109 ,240,36,81,.444,33,73,.452,3,8,.375,20,35,.571,95,43,86,.500,33,69,.478,10,17,.588,13,18,.722,109,2014-12-16,MIN,WAS
52,Home,W 95-91 ,240,31,77,.403,22,53,.415,9,24,.375,24,29,.828,95,37,78,.474,28,54,.519,9,24,.375,8,12,.667,91,2014-12-19,CLE,BRK
53,@,L 95-110 ,240,34,76,.447,24,49,.490,10,27,.370,17,18,.944,95,41,87,.471,28,51,.549,13,36,.361,15,20,.750,110,2014-12-22,POR,HOU
54,@,L 95-100 ,240,33,85,.388,26,62,.419,7,23,.304,22,29,.759,95,39,83,.470,32,65,.492,7,18,.389,15,23,.652,100,2014-12-23,BOS,ORL
55,Home,L 95-103 ,240,37,72,.514,31,52,.596,6,20,.300,15,21,.714,95,34,73,.466,27,57,.474,7,16,.438,28,37,.757,103,2014-12-27,MIA,MEM
56,Home,W 95-87 ,240,35,72,.486,28,57,.491,7,15,.467,18,22,.818,95,35,78,.449,30,56,.536,5,22,.227,12,17,.706,87,2014-12-30,MEM,SAS
57,@,L 95-106 ,240,38,77,.494,33,61,.541,5,16,.313,14,18,.778,95,35,79,.443,25,61,.410,10,18,.556,26,30,.867,106,2014-12-31,MIA,IND
58,Home,W 95-93 (OT),265,39,89,.438,33,65,.508,6,24,.250,11,18,.611,95,34,89,.382,26,61,.426,8,28,.286,17,20,.850,93,2014-12-31,SAS,NOP
59,@,L 95-114 ,240,32,75,.427,29,60,.483,3,15,.200,28,36,.778,95,45,91,.495,33,60,.550,12,31,.387,12,16,.750,114,2015-01-04,SAC,DET
60,@,W 95-82 ,240,35,77,.455,31,61,.508,4,16,.250,21,27,.778,95,31,76,.408,22,51,.431,9,25,.360,11,14,.786,82,2015-01-04,MIL,NYK
61,Home,L 95-104 ,240,36,91,.396,29,73,.397,7,18,.389,16,23,.696,95,38,78,.487,32,59,.542,6,19,.316,22,23,.957,104,2015-01-05,BOS,CHO
62,Home,W 95-92 ,240,38,79,.481,31,56,.554,7,23,.304,12,15,.800,95,33,85,.388,22,55,.400,11,30,.367,15,22,.682,92,2015-01-05,PHI,CLE
63,Home,L 95-108 ,240,38,87,.437,32,65,.492,6,22,.273,13,18,.722,95,43,97,.443,33,76,.434,10,21,.476,12,14,.857,108,2015-01-07,DAL,DET
64,Home,L 95-103 ,240,33,83,.398,23,52,.442,10,31,.323,19,25,.760,95,42,88,.477,38,72,.528,4,16,.250,15,22,.682,103,2015-01-08,TOR,CHO
65,@,L 95-106 ,240,36,82,.439,30,65,.462,6,17,.353,17,22,.773,95,37,81,.457,27,61,.443,10,20,.500,22,26,.846,106,2015-01-09,MEM,NOP
66,@,L 95-100 ,240,37,83,.446,30,57,.526,7,26,.269,14,21,.667,95,38,89,.427,27,66,.409,11,23,.478,13,18,.722,100,2015-01-09,PHO,SAS
67,Home,W 95-87 ,240,35,88,.398,31,71,.437,4,17,.235,21,24,.875,95,36,81,.444,33,70,.471,3,11,.273,12,16,.750,87,2015-01-10,CHI,MIL
68,Home,W 95-79 ,240,28,72,.389,20,54,.370,8,18,.444,31,42,.738,95,28,68,.412,20,46,.435,8,22,.364,15,20,.750,79,2015-01-15,MIL,NYK
69,@,W 95-83 ,240,35,74,.473,27,57,.474,8,17,.471,17,21,.810,95,32,75,.427,25,59,.424,7,16,.438,12,14,.857,83,2015-01-16,MIA,SAC
70,@,W 95-93 ,240,39,82,.476,34,65,.523,5,17,.294,12,20,.600,95,31,72,.431,24,47,.511,7,25,.280,24,29,.828,93,2015-01-18,NOP,TOR
71,Home,L 95-103 ,240,36,85,.424,33,63,.524,3,22,.136,20,22,.909,95,34,76,.447,24,51,.471,10,25,.400,25,33,.758,103,2015-01-19,MEM,DAL
72,@,L 95-101 ,240,39,82,.476,31,65,.477,8,17,.471,9,13,.692,95,35,83,.422,30,61,.492,5,22,.227,26,30,.867,101,2015-01-25,MIL,SAS
73,Home,L 95-103 ,240,35,83,.422,27,59,.458,8,24,.333,17,23,.739,95,39,93,.419,30,59,.508,9,34,.265,16,17,.941,103,2015-01-27,DET,CLE
74,Home,W 95-86 ,240,35,83,.422,25,54,.463,10,29,.345,15,18,.833,95,34,83,.410,28,65,.431,6,18,.333,12,14,.857,86,2015-01-28,SAS,CHO
75,Home,W 95-88 ,240,37,82,.451,29,61,.475,8,21,.381,13,14,.929,95,33,89,.371,24,58,.414,9,31,.290,13,18,.722,88,2015-01-31,MIL,POR
76,@,W 95-93 ,240,37,89,.416,31,64,.484,6,25,.240,15,17,.882,95,36,88,.409,28,67,.418,8,21,.381,13,13,1.000,93,2015-02-09,SAS,IND
77,@,L 95-109 ,240,36,84,.429,29,64,.453,7,20,.350,16,19,.842,95,36,74,.486,24,52,.462,12,22,.545,25,29,.862,109,2015-02-09,NYK,MIA
78,Home,W 95-86 ,240,36,81,.444,30,62,.484,6,19,.316,17,25,.680,95,35,81,.432,32,69,.464,3,12,.250,13,17,.765,86,2015-02-10,MEM,BRK
79,@,L 95-110 ,240,34,87,.391,25,42,.595,9,45,.200,18,22,.818,95,39,81,.481,35,59,.593,4,22,.182,28,45,.622,110,2015-02-11,HOU,LAC
80,Home,W 95-93 ,240,31,76,.408,20,50,.400,11,26,.423,22,26,.846,95,39,85,.459,34,64,.531,5,21,.238,10,16,.625,93,2015-02-11,TOR,WAS
81,Home,W 95-84 ,240,44,88,.500,40,70,.571,4,18,.222,3,6,.500,95,29,69,.420,24,50,.480,5,19,.263,21,28,.750,84,2015-02-20,ORL,NOP
82,Home,L 95-106 ,240,34,84,.405,26,59,.441,8,25,.320,19,29,.655,95,40,83,.482,32,61,.525,8,22,.364,18,22,.818,106,2015-02-20,PHI,IND
83,@,L 95-111 ,240,37,85,.435,29,64,.453,8,21,.381,13,14,.929,95,43,85,.506,30,59,.508,13,26,.500,12,15,.800,111,2015-02-25,SAS,POR
84,Home,W 95-88 ,240,36,81,.444,22,50,.440,14,31,.452,9,12,.750,95,36,80,.450,27,54,.500,9,26,.346,7,13,.538,88,2015-02-27,ATL,ORL
85,@,L 95-99 ,240,38,79,.481,30,53,.566,8,26,.308,11,21,.524,95,37,78,.474,30,58,.517,7,20,.350,18,25,.720,99,2015-02-28,DET,WAS
86,@,L 95-106 ,240,35,86,.407,25,62,.403,10,24,.417,15,22,.682,95,39,86,.453,27,52,.519,12,34,.353,16,20,.800,106,2015-03-03,MIL,DEN
87,Home,W 95-89 ,240,38,80,.475,30,57,.526,8,23,.348,11,13,.846,95,32,74,.432,26,58,.448,6,16,.375,19,29,.655,89,2015-03-07,NOP,MEM
88,@,W 95-88 ,240,34,72,.472,24,50,.480,10,22,.455,17,21,.810,95,38,76,.500,30,61,.492,8,15,.533,4,11,.364,88,2015-03-08,UTA,BRK
89,@,W 95-69 ,240,44,85,.518,42,71,.592,2,14,.143,5,5,1.000,95,25,77,.325,21,55,.382,4,22,.182,15,20,.750,69,2015-03-09,WAS,CHO
90,Home,W 95-92 ,240,37,85,.435,29,58,.500,8,27,.296,13,17,.765,95,37,78,.474,32,66,.485,5,12,.417,13,13,1.000,92,2015-03-11,BOS,MEM
91,Home,L 95-104 (OT),265,36,104,.346,25,63,.397,11,41,.268,12,25,.480,95,40,87,.460,30,63,.476,10,24,.417,14,20,.700,104,2015-03-11,PHI,CHI
92,Home,W 95-88 ,240,37,86,.430,27,60,.450,10,26,.385,11,20,.550,95,34,80,.425,28,60,.467,6,20,.300,14,28,.500,88,2015-03-13,BOS,ORL
93,@,L 95-105 ,240,35,80,.438,25,62,.403,10,18,.556,15,17,.882,95,39,83,.470,27,50,.540,12,33,.364,15,22,.682,105,2015-03-17,MEM,DET
94,@,L 95-114 ,240,31,87,.356,23,65,.354,8,22,.364,25,30,.833,95,44,84,.524,30,54,.556,14,30,.467,12,20,.600,114,2015-03-18,ATL,GSW
95,@,W 95-92 (OT),265,34,83,.410,32,71,.451,2,12,.167,25,30,.833,95,40,97,.412,36,77,.468,4,20,.200,8,10,.800,92,2015-03-19,MIN,NYK
96,Home,W 95-92 ,240,35,82,.427,26,56,.464,9,26,.346,16,21,.762,95,36,84,.429,28,64,.438,8,20,.400,12,13,.923,92,2015-03-20,CLE,IND
97,Home,L 95-114 ,240,38,80,.475,26,56,.464,12,24,.500,7,7,1.000,95,46,82,.561,39,65,.600,7,17,.412,15,17,.882,114,2015-03-22,ATL,SAS
98,@,W 95-93 ,240,40,81,.494,34,59,.576,6,22,.273,9,12,.750,95,34,75,.453,29,60,.483,5,15,.333,20,32,.625,93,2015-03-25,HOU,NOP
99,@,W 95-83 ,240,39,90,.433,29,59,.492,10,31,.323,7,10,.700,95,32,78,.410,29,62,.468,3,16,.188,16,20,.800,83,2015-03-25,ATL,ORL
0,Home,L 95-108 ,240,33,87,.379,31,72,.431,2,15,.133,27,32,.844,95,42,82,.512,30,57,.526,12,25,.480,12,14,.857,108,2015-03-28,MIL,GSW
1,@,L 95-105 ,240,40,84,.476,32,59,.542,8,25,.320,7,10,.700,95,41,83,.494,30,54,.556,11,29,.379,12,17,.706,105,2015-03-31,ATL,DET
2,@,W 95-81 ,240,37,74,.500,29,56,.518,8,18,.444,13,17,.765,95,32,79,.405,27,64,.422,5,15,.333,12,12,1.000,81,2015-03-31,SAS,MIA
3,Home,W 95-91 ,240,37,89,.416,29,68,.426,8,21,.381,13,18,.722,95,31,74,.419,26,48,.542,5,26,.192,24,37,.649,91,2015-04-01,MIL,CHI
4,Home,L 95-101 ,240,37,78,.474,31,61,.508,6,17,.353,15,25,.600,95,34,87,.391,20,58,.345,14,29,.483,19,28,.679,101,2015-04-03,SAC,NOP
5,Home,L 95-101 ,240,38,79,.481,33,64,.516,5,15,.333,14,24,.583,95,40,87,.460,32,63,.508,8,24,.333,13,18,.722,101,2015-04-05,SAC,UTA
6,Home,W 95-93 ,240,38,99,.384,32,72,.444,6,27,.222,13,15,.867,95,35,80,.438,26,56,.464,9,24,.375,14,20,.700,93,2015-04-14,BOS,TOR
7,@,L 95-99 (2OT),290,37,104,.356,30,80,.375,7,24,.292,14,17,.824,95,40,105,.381,31,75,.413,9,30,.300,10,17,.588,99,2015-04-14,WAS,IND
8,Home,W 95-83 ,240,36,76,.474,34,67,.507,2,9,.222,21,26,.808,95,32,78,.410,24,54,.444,8,24,.333,11,15,.733,83,2015-04-15,MEM,IND
9,@,L 95-97 ,240,38,94,.404,29,65,.446,9,29,.310,10,17,.588,95,37,87,.425,30,68,.441,7,19,.368,16,23,.696,97,2015-10-27,CLE,CHI
10,@,L 95-111 ,240,35,83,.422,29,65,.446,6,18,.333,19,27,.704,95,41,96,.427,32,66,.485,9,30,.300,20,22,.909,111,2015-10-27,NOP,GSW
11,@,L 95-112 ,240,34,83,.410,27,61,.443,7,22,.318,20,23,.870,95,39,85,.459,31,61,.508,8,24,.333,26,27,.963,112,2015-10-28,PHI,BOS
12,Home,L 95-111 ,240,34,87,.391,28,63,.444,6,24,.250,21,33,.636,95,40,85,.471,30,64,.469,10,21,.476,21,31,.677,111,2015-10-28,PHO,DAL
13,@,W 95-78 ,240,30,71,.423,28,60,.467,2,11,.182,33,41,.805,95,29,95,.305,24,70,.343,5,25,.200,15,20,.750,78,2015-10-30,MIN,DEN
14,@,W 95-87 ,240,36,83,.434,31,64,.484,5,19,.263,18,25,.720,95,35,98,.357,29,69,.420,6,29,.207,11,14,.786,87,2015-11-01,SAS,BOS
15,@,L 95-99 ,240,36,94,.383,27,67,.403,9,27,.333,14,23,.609,95,33,84,.393,24,57,.421,9,27,.333,24,29,.828,99,2015-11-08,LAL,NYK
16,@,L 95-109 ,240,40,85,.471,34,66,.515,6,19,.316,9,15,.600,95,43,91,.473,31,70,.443,12,21,.571,11,13,.846,109,2015-11-09,DET,GSW
17,Home,L 95-104 ,240,36,80,.450,27,61,.443,9,19,.474,14,19,.737,95,38,78,.487,30,52,.577,8,26,.308,20,27,.741,104,2015-11-10,MIN,CHO
18,Home,W 95-93 ,240,35,84,.417,27,61,.443,8,23,.348,17,28,.607,95,42,86,.488,38,65,.585,4,21,.190,5,7,.714,93,2015-11-11,CHO,NYK
19,Home,W 95-87 ,240,38,88,.432,34,70,.486,4,18,.222,15,19,.789,95,32,71,.451,26,50,.520,6,21,.286,17,19,.895,87,2015-11-15,NYK,NOP
20,@,L 95-96 ,240,35,87,.402,26,66,.394,9,21,.429,16,24,.667,95,35,86,.407,29,71,.408,6,15,.400,20,32,.625,96,2015-11-16,IND,CHI
21,Home,L 95-111 ,240,36,85,.424,25,53,.472,11,32,.344,12,23,.522,95,44,93,.473,33,57,.579,11,36,.306,12,17,.706,111,2015-11-16,HOU,BOS
22,@,L 95-120 ,240,35,89,.393,27,70,.386,8,19,.421,17,24,.708,95,51,87,.586,41,58,.707,10,29,.345,8,10,.800,120,2015-11-20,BRK,BOS
23,Home,L 95-97 ,240,36,79,.456,28,53,.528,8,26,.308,15,21,.714,95,38,78,.487,31,59,.525,7,19,.368,14,20,.700,97,2015-11-21,DET,WAS
24,Home,W 95-78 ,240,31,81,.383,26,62,.419,5,19,.263,28,36,.778,95,28,87,.322,24,63,.381,4,24,.167,18,21,.857,78,2015-11-23,MIA,NYK
25,@,L 95-100 ,240,32,78,.410,22,47,.468,10,31,.323,21,27,.778,95,36,78,.462,33,66,.500,3,12,.250,25,27,.926,100,2015-11-23,PHI,MIN
26,@,L 95-99 ,240,31,82,.378,23,51,.451,8,31,.258,25,35,.714,95,34,82,.415,25,61,.410,9,21,.429,22,29,.759,99,2015-11-25,ATL,MIN
27,@,W 95-90 ,240,34,81,.420,26,56,.464,8,25,.320,19,25,.760,95,33,80,.413,28,55,.509,5,25,.200,19,25,.760,90,2015-11-27,CLE,CHO
28,Home,L 95-105 ,240,36,75,.480,31,58,.534,5,17,.294,18,24,.750,95,38,80,.475,30,60,.500,8,20,.400,21,25,.840,105,2015-11-30,MIA,BOS
29,Home,W 95-70 ,240,37,90,.411,30,69,.435,7,21,.333,14,20,.700,95,26,78,.333,23,64,.359,3,14,.214,15,18,.833,70,2015-12-02,SAS,MIL
30,@,L 95-97 ,240,35,79,.443,31,63,.492,4,16,.250,21,24,.875,95,40,81,.494,37,68,.544,3,13,.231,14,24,.583,97,2015-12-03,OKC,MIA
31,@,L 95-102 ,240,39,87,.448,35,69,.507,4,18,.222,13,14,.929,95,34,82,.415,27,59,.458,7,23,.304,27,39,.692,102,2015-12-04,MIL,DET
32,Home,W 95-93 ,240,36,90,.400,31,75,.413,5,15,.333,18,24,.750,95,36,82,.439,27,51,.529,9,31,.290,12,17,.706,93,2015-12-06,MEM,PHO
33,@,L 95-98 ,240,35,88,.398,28,64,.438,7,24,.292,18,30,.600,95,35,86,.407,29,64,.453,6,22,.273,22,31,.710,98,2015-12-06,SAC,OKC
34,Home,L 95-98 ,240,36,100,.360,29,69,.420,7,31,.226,16,19,.842,95,39,81,.481,33,61,.541,6,20,.300,14,18,.778,98,2015-12-09,DAL,ATL
35,Home,L 95-109 ,240,42,90,.467,40,80,.500,2,10,.200,9,12,.750,95,38,81,.469,26,53,.491,12,28,.429,21,36,.583,109,2015-12-09,MIL,LAC
36,Home,L 95-107 ,240,36,80,.450,30,62,.484,6,18,.333,17,24,.708,95,43,93,.462,33,66,.500,10,27,.370,11,16,.688,107,2015-12-11,PHI,DET
37,@,L 95-108 ,240,36,89,.404,30,62,.484,6,27,.222,17,25,.680,95,44,90,.489,38,76,.500,6,14,.429,14,18,.778,108,2015-12-12,GSW,MIL
38,@,L 95-112 ,240,37,86,.430,28,62,.452,9,24,.375,12,20,.600,95,44,78,.564,34,63,.540,10,15,.667,14,15,.933,112,2015-12-14,WAS,MEM
39,@,L 95-113 ,240,40,85,.471,36,72,.500,4,13,.308,11,20,.550,95,41,89,.461,31,62,.500,10,27,.370,21,25,.840,113,2015-12-15,MIL,LAL
40,@,L 95-114 ,240,35,84,.417,32,69,.464,3,15,.200,22,25,.880,95,44,83,.530,36,61,.590,8,22,.364,18,23,.783,114,2015-12-16,WAS,SAS
41,@,L 95-99 ,240,38,81,.469,31,58,.534,7,23,.304,12,17,.706,95,39,82,.476,33,64,.516,6,18,.333,15,16,.938,99,2015-12-18,SAC,MIN
42,Home,L 95-101 ,240,33,74,.446,25,56,.446,8,18,.444,21,24,.875,95,41,79,.519,36,63,.571,5,16,.313,14,24,.583,101,2015-12-20,PHO,MIL
43,@,L 95-102 ,240,29,83,.349,17,42,.405,12,41,.293,25,31,.806,95,33,71,.465,26,43,.605,7,28,.250,29,41,.707,102,2015-12-21,CHO,HOU
44,@,L 95-101 ,240,39,82,.476,36,71,.507,3,11,.273,14,24,.583,95,37,72,.514,32,55,.582,5,17,.294,22,28,.786,101,2015-12-28,MIN,SAS
45,Home,W 95-91 ,240,28,84,.333,21,58,.362,7,26,.269,32,36,.889,95,36,86,.419,31,65,.477,5,21,.238,14,19,.737,91,2015-12-28,UTA,PHI
46,@,W 95-89 ,240,35,90,.389,25,56,.446,10,34,.294,15,19,.789,95,36,82,.439,29,57,.509,7,25,.280,10,15,.667,89,2015-12-31,LAC,NOP
47,@,W 95-85 ,240,32,75,.427,24,59,.407,8,16,.500,23,28,.821,95,33,84,.393,30,70,.429,3,14,.214,16,24,.667,85,2016-01-02,MIL,MIN
48,@,W 95-86 ,240,32,76,.421,26,54,.481,6,22,.273,25,29,.862,95,32,79,.405,26,48,.542,6,31,.194,16,17,.941,86,2016-01-06,IND,ORL
49,@,L 95-96 ,240,35,84,.417,21,40,.525,14,44,.318,11,16,.688,95,37,80,.463,33,71,.465,4,9,.444,18,29,.621,96,2016-01-08,DAL,MIL
50,Home,L 95-103 ,240,40,92,.435,34,68,.500,6,24,.250,9,13,.692,95,36,73,.493,29,55,.527,7,18,.389,24,30,.800,103,2016-01-08,PHO,MIA
51,Home,L 95-108 ,240,39,80,.488,28,63,.444,11,17,.647,6,14,.429,95,41,75,.547,36,58,.621,5,17,.294,21,27,.778,108,2016-01-09,PHI,TOR
52,Home,W 95-92 ,240,32,77,.416,20,50,.400,12,27,.444,19,23,.826,95,30,83,.361,18,47,.383,12,36,.333,20,24,.833,92,2016-01-10,DEN,CHO
53,@,W 95-85 ,240,35,90,.389,26,58,.448,9,32,.281,16,23,.696,95,35,77,.455,29,59,.492,6,18,.333,9,19,.474,85,2016-01-10,CLE,PHI
54,Home,W 95-91 ,240,32,87,.368,26,58,.448,6,29,.207,25,32,.781,95,38,91,.418,32,68,.471,6,23,.261,9,14,.643,91,2016-01-12,LAL,NOP
55,@,L 95-99 ,240,38,82,.463,28,56,.500,10,26,.385,9,11,.818,95,38,83,.458,33,66,.500,5,17,.294,18,22,.818,99,2016-01-14,CLE,SAS
56,Home,L 95-98 ,240,32,78,.410,26,60,.433,6,18,.333,25,26,.962,95,40,81,.494,36,69,.522,4,12,.333,14,19,.737,98,2016-01-15,DEN,MIA
57,@,L 95-113 ,240,34,94,.362,24,69,.348,10,25,.400,17,23,.739,95,47,101,.465,39,78,.500,8,23,.348,11,20,.550,113,2016-01-16,GSW,DET
58,@,L 95-103 ,240,35,77,.455,30,57,.526,5,20,.250,20,24,.833,95,39,82,.476,34,72,.472,5,10,.500,20,26,.769,103,2016-01-16,NYK,MEM
59,Home,L 95-112 ,240,37,82,.451,31,63,.492,6,19,.316,15,19,.789,95,44,91,.484,38,70,.543,6,21,.286,18,24,.750,112,2016-01-17,LAL,HOU
60,@,L 95-109 ,240,34,81,.420,25,54,.463,9,27,.333,18,21,.857,95,39,83,.470,30,59,.508,9,24,.375,22,30,.733,109,2016-01-20,CHO,OKC
61,Home,L 95-108 ,240,38,84,.452,32,68,.471,6,16,.375,13,18,.722,95,43,85,.506,32,64,.500,11,21,.524,11,13,.846,108,2016-01-22,LAL,SAS
62,@,L 95-98 ,240,34,84,.405,22,50,.440,12,34,.353,15,18,.833,95,34,85,.400,24,61,.393,10,24,.417,20,26,.769,98,2016-01-23,ATL,PHO
63,@,W 95-92 ,240,34,75,.453,23,53,.434,11,22,.500,16,33,.485,95,34,85,.400,25,56,.446,9,29,.310,15,18,.833,92,2016-01-25,DET,UTA
64,Home,L 95-116 ,240,33,90,.367,27,72,.375,6,18,.333,23,26,.885,95,42,73,.575,26,44,.591,16,29,.552,16,23,.696,116,2016-01-31,NYK,GSW
65,Home,L 95-110 ,240,36,88,.409,26,62,.419,10,26,.385,13,21,.619,95,43,71,.606,34,55,.618,9,16,.563,15,18,.833,110,2016-02-01,NOP,MEM
66,@,L 95-107 ,240,38,86,.442,33,72,.458,5,14,.357,14,24,.583,95,39,85,.459,28,54,.519,11,31,.355,18,25,.720,107,2016-02-02,MIL,POR
67,@,L 95-102 ,240,32,85,.376,21,51,.412,11,34,.324,20,28,.714,95,42,96,.438,35,75,.467,7,21,.333,11,13,.846,102,2016-02-03,DET,BOS
68,Home,L 95-98 ,240,36,81,.444,26,55,.473,10,26,.385,13,15,.867,95,43,94,.457,43,85,.506,0,9,.000,12,18,.667,98,2016-02-05,CHO,MIA
69,Home,L 95-117 ,240,40,92,.435,36,74,.486,4,18,.222,11,15,.733,95,45,87,.517,33,59,.559,12,28,.429,15,19,.789,117,2016-02-10,IND,CHO
70,@,L 95-121 ,240,38,88,.432,35,72,.486,3,16,.188,16,24,.667,95,45,86,.523,33,54,.611,12,32,.375,19,23,.826,121,2016-02-11,NOP,OKC
71,@,L 95-106 ,240,37,93,.398,29,72,.403,8,21,.381,13,22,.591,95,42,91,.462,35,67,.522,7,24,.292,15,17,.882,106,2016-02-18,CHI,CLE
72,Home,L 95-98 ,240,36,81,.444,29,62,.468,7,19,.368,16,21,.762,95,37,86,.430,28,55,.509,9,31,.290,15,18,.833,98,2016-02-19,MIL,CHO
73,Home,L 95-103 ,240,36,84,.429,31,72,.431,5,12,.417,18,25,.720,95,42,83,.506,37,66,.561,5,17,.294,14,16,.875,103,2016-02-20,MIN,NYK
74,Home,L 95-122 ,240,37,84,.440,31,64,.484,6,20,.300,15,23,.652,95,46,87,.529,35,62,.565,11,25,.440,19,25,.760,122,2016-02-22,NYK,TOR
75,Home,L 95-96 ,240,35,85,.412,31,66,.470,4,19,.211,21,24,.875,95,36,83,.434,25,55,.455,11,28,.393,13,19,.684,96,2016-02-26,IND,CHO
76,Home,L 95-112 ,240,32,78,.410,27,55,.491,5,23,.217,26,39,.667,95,43,85,.506,30,53,.566,13,32,.406,13,15,.867,112,2016-02-26,LAL,MEM
77,@,L 95-108 ,240,39,93,.419,33,66,.500,6,27,.222,11,16,.688,95,37,80,.463,33,64,.516,4,16,.250,30,36,.833,108,2016-02-26,ORL,NYK
78,Home,L 95-103 ,240,39,94,.415,32,72,.444,7,22,.318,10,12,.833,95,38,87,.437,33,66,.500,5,21,.238,22,27,.815,103,2016-02-27,CHI,POR
79,@,L 95-100 ,240,38,101,.376,31,77,.403,7,24,.292,12,17,.706,95,37,84,.440,31,66,.470,6,18,.333,20,29,.690,100,2016-02-29,UTA,BOS
80,@,L 95-105 ,240,32,77,.416,24,58,.414,8,19,.421,23,33,.697,95,41,83,.494,32,60,.533,9,23,.391,14,16,.875,105,2016-02-29,BRK,LAC
81,@,L 95-100 ,240,36,90,.400,22,53,.415,14,37,.378,9,13,.692,95,36,81,.444,33,46,.717,3,35,.086,25,38,.658,100,2016-03-02,NOP,HOU
82,@,L 95-112 ,240,37,92,.402,33,62,.532,4,30,.133,17,21,.810,95,41,87,.471,32,62,.516,9,25,.360,21,22,.955,112,2016-03-06,GSW,LAL
83,Home,W 95-89 ,240,38,84,.452,29,56,.518,9,28,.321,10,15,.667,95,33,87,.379,28,70,.400,5,17,.294,18,22,.818,89,2016-03-11,PHI,BRK
84,Home,W 95-83 ,240,36,84,.429,25,50,.500,11,34,.324,12,17,.706,95,33,95,.347,27,72,.375,6,23,.261,11,14,.786,83,2016-03-12,ATL,MEM
85,@,W 95-90 ,240,32,89,.360,24,59,.407,8,30,.267,23,26,.885,95,31,86,.360,25,63,.397,6,23,.261,22,26,.846,90,2016-03-18,PHO,LAL
86,@,L 95-104 ,240,39,89,.438,29,51,.569,10,38,.263,7,9,.778,95,41,89,.461,33,67,.493,8,22,.364,14,19,.737,104,2016-03-24,CLE,BRK
87,Home,L 95-112 ,240,34,88,.386,27,59,.458,7,29,.241,20,28,.714,95,43,95,.453,30,61,.492,13,34,.382,13,14,.929,112,2016-03-26,DET,ATL
88,@,L 95-101 ,240,36,83,.434,26,56,.464,10,27,.370,13,17,.765,95,40,90,.444,27,61,.443,13,29,.448,8,9,.889,101,2016-03-31,DEN,NOP
89,Home,L 95-99 ,240,37,91,.407,30,72,.417,7,19,.368,14,17,.824,95,30,71,.423,18,43,.419,12,28,.429,27,29,.931,99,2016-04-01,MEM,TOR
90,@,L 95-102 ,240,40,80,.500,34,62,.548,6,18,.333,9,10,.900,95,35,77,.455,30,57,.526,5,20,.250,27,30,.900,102,2016-04-02,TOR,SAS
91,Home,W 95-87 ,240,33,76,.434,21,44,.477,12,32,.375,17,21,.810,95,32,84,.381,24,63,.381,8,21,.381,15,20,.750,87,2016-04-07,ATL,TOR
92,@,L 95-106 ,240,36,75,.480,26,52,.500,10,23,.435,13,19,.684,95,33,79,.418,22,49,.449,11,30,.367,29,47,.617,106,2016-10-31,SAC,ATL
93,Home,L 95-99 ,240,35,87,.402,26,51,.510,9,36,.250,16,21,.762,95,36,86,.419,26,56,.464,10,30,.333,17,24,.708,99,2016-11-04,BRK,CHO
94,Home,L 95-105 ,240,34,83,.410,24,55,.436,10,28,.357,17,20,.850,95,36,80,.450,24,49,.490,12,31,.387,21,26,.808,105,2016-11-04,DAL,POR
95,Home,W 95-92 ,240,31,80,.388,26,60,.433,5,20,.250,28,35,.800,95,32,83,.386,27,58,.466,5,25,.200,23,36,.639,92,2016-11-04,WAS,ATL
96,@,L 95-116 ,240,34,86,.395,28,58,.483,6,28,.214,21,28,.750,95,43,74,.581,26,41,.634,17,33,.515,13,22,.591,116,2016-11-09,DAL,GSW
97,Home,L 95-98 ,240,36,88,.409,23,59,.390,13,29,.448,10,15,.667,95,37,89,.416,31,73,.425,6,16,.375,18,20,.900,98,2016-11-10,MIA,CHI
98,@,L 95-106 ,240,38,91,.418,34,78,.436,4,13,.308,15,18,.833,95,39,97,.402,34,82,.415,5,15,.333,23,25,.920,106,2016-11-12,WAS,CHI
99,Home,L 95-106 ,240,36,84,.429,27,59,.458,9,25,.360,14,19,.737,95,46,90,.511,42,72,.583,4,18,.222,10,14,.714,106,2016-11-12,DEN,DET
0,@,L 95-127 ,240,34,77,.442,24,44,.545,10,33,.303,17,22,.773,95,48,90,.533,34,65,.523,14,25,.560,17,21,.810,127,2016-11-14,BRK,LAC
1,@,L 95-102 ,240,33,77,.429,24,47,.511,9,30,.300,20,24,.833,95,36,77,.468,25,50,.500,11,27,.407,19,23,.826,102,2016-11-19,CHI,LAC
2,Home,W 95-87 ,240,34,78,.436,26,57,.456,8,21,.381,19,22,.864,95,26,77,.338,13,49,.265,13,28,.464,22,27,.815,87,2016-11-19,ORL,DAL
3,Home,W 95-68 ,240,35,80,.438,25,46,.543,10,34,.294,15,18,.833,95,26,83,.313,18,58,.310,8,25,.320,8,12,.667,68,2016-11-25,UTA,ATL
4,@,L 95-122 ,240,36,86,.419,22,52,.423,14,34,.412,9,13,.692,95,42,77,.545,29,58,.500,13,19,.684,25,31,.806,122,2016-11-28,PHI,TOR
5,@,L 95-101 (OT),265,38,93,.409,35,72,.486,3,21,.143,16,26,.615,95,35,85,.412,25,60,.417,10,25,.400,21,26,.808,101,2016-11-28,SAC,WAS
6,@,W 95-83 ,240,39,86,.453,33,71,.465,6,15,.400,11,12,.917,95,28,76,.368,23,56,.411,5,20,.250,22,26,.846,83,2016-11-29,ORL,SAS
7,Home,W 95-94 ,240,33,79,.418,26,61,.426,7,18,.389,22,28,.786,95,33,74,.446,27,50,.540,6,24,.250,22,31,.710,94,2016-12-01,MEM,ORL
8,@,L 95-103 ,240,34,80,.425,23,53,.434,11,27,.407,16,20,.800,95,43,88,.489,39,69,.565,4,19,.211,13,15,.867,103,2016-12-07,MIA,ATL
9,@,L 95-134 ,240,34,87,.391,29,67,.433,5,20,.250,22,27,.815,95,51,94,.543,36,58,.621,15,36,.417,17,21,.810,134,2016-12-07,LAL,HOU
10,Home,W 95-91 ,240,35,80,.438,31,63,.492,4,17,.235,21,27,.778,95,39,97,.402,30,69,.435,9,28,.321,4,5,.800,91,2016-12-08,CHI,SAS
11,@,L 95-114 ,240,33,87,.379,25,60,.417,8,27,.296,21,28,.750,95,43,80,.538,35,57,.614,8,23,.348,20,27,.741,114,2016-12-13,OKC,POR
12,@,W 95-85 ,240,36,71,.507,31,54,.574,5,17,.294,18,22,.818,95,32,78,.410,24,53,.453,8,25,.320,13,16,.813,85,2016-12-14,DET,DAL
13,Home,W 95-89 ,240,37,82,.451,30,57,.526,7,25,.280,14,25,.560,95,33,89,.371,24,62,.387,9,27,.333,14,17,.824,89,2016-12-14,MIA,IND
14,@,L 95-102 ,240,36,87,.414,33,66,.500,3,21,.143,20,24,.833,95,36,86,.419,26,59,.441,10,27,.370,20,28,.714,102,2016-12-15,IND,NOP
15,@,W 95-69 ,240,38,82,.463,28,57,.491,10,25,.400,9,13,.692,95,28,92,.304,23,71,.324,5,21,.238,8,15,.533,69,2016-12-16,MIL,CHI
16,Home,L 95-105 ,240,36,69,.522,27,45,.600,9,24,.375,14,25,.560,95,41,90,.456,32,62,.516,9,28,.321,14,19,.737,105,2016-12-18,MIA,BOS
17,Home,L 95-96 ,240,32,72,.444,22,45,.489,10,27,.370,21,28,.750,95,35,83,.422,28,52,.538,7,31,.226,19,23,.826,96,2016-12-21,POR,DAL
18,@,L 95-106 ,240,39,90,.433,34,63,.540,5,27,.185,12,16,.750,95,41,96,.427,32,76,.421,9,20,.450,15,17,.882,106,2016-12-22,ORL,NYK
19,@,W 95-91 ,240,32,95,.337,20,61,.328,12,34,.353,19,24,.792,95,35,83,.422,27,60,.450,8,23,.348,13,18,.722,91,2016-12-26,TOR,POR
20,@,L 95-118 ,240,32,74,.432,22,49,.449,10,25,.400,21,25,.840,95,47,83,.566,36,61,.590,11,22,.500,13,14,.929,118,2016-12-30,BRK,WAS
21,@,W 95-89 ,240,36,73,.493,30,51,.588,6,22,.273,17,28,.607,95,35,87,.402,28,64,.438,7,23,.304,12,18,.667,89,2017-01-01,POR,MIN
22,Home,L 95-102 ,240,36,79,.456,27,50,.540,9,29,.310,14,17,.824,95,38,85,.447,31,68,.456,7,17,.412,19,22,.864,102,2017-01-05,DAL,PHO
23,Home,L 95-105 ,240,36,78,.462,26,51,.510,10,27,.370,13,17,.765,95,37,94,.394,29,67,.433,8,27,.296,23,27,.852,105,2017-01-08,BRK,PHI
24,@,L 95-111 ,240,34,90,.378,27,64,.422,7,26,.269,20,29,.690,95,42,87,.483,34,55,.618,8,32,.250,19,24,.792,111,2017-01-08,ORL,LAL
25,@,L 95-107 ,240,38,90,.422,32,60,.533,6,30,.200,13,17,.765,95,39,86,.453,28,59,.475,11,27,.407,18,22,.818,107,2017-01-10,MIA,GSW
26,@,L 95-103 ,240,38,92,.413,31,68,.456,7,24,.292,12,21,.571,95,36,81,.444,28,55,.509,8,26,.308,23,29,.793,103,2017-01-11,MEM,OKC
27,Home,L 95-104 ,240,40,97,.412,31,55,.564,9,42,.214,6,11,.545,95,38,90,.422,27,58,.466,11,32,.344,17,25,.680,104,2017-01-12,BRK,NOP
28,@,L 95-98 ,240,36,83,.434,26,58,.448,10,25,.400,13,18,.722,95,41,81,.506,36,62,.581,5,19,.263,11,16,.688,98,2017-01-16,NOP,IND
29,@,L 95-118 ,240,30,78,.385,24,53,.453,6,25,.240,29,37,.784,95,45,91,.495,35,66,.530,10,25,.400,18,28,.643,118,2017-01-18,ATL,DET
30,@,L 95-99 ,240,37,82,.451,23,46,.500,14,36,.389,7,11,.636,95,35,73,.479,26,53,.491,9,20,.450,20,29,.690,99,2017-01-19,DAL,MIA
31,@,L 95-108 ,240,34,80,.425,25,57,.439,9,23,.391,18,25,.720,95,41,87,.471,27,54,.500,14,33,.424,12,15,.800,108,2017-01-20,IND,LAL
32,Home,L 95-119 ,240,33,89,.371,24,55,.436,9,34,.265,20,28,.714,95,41,80,.513,25,38,.658,16,42,.381,21,25,.840,119,2017-01-21,MEM,HOU
33,Home,L 95-97 ,240,36,84,.429,31,63,.492,5,21,.238,18,26,.692,95,36,83,.434,30,63,.476,6,20,.300,19,25,.760,97,2017-01-23,UTA,OKC
34,@,L 95-103 ,240,39,92,.424,32,69,.464,7,23,.304,10,12,.833,95,39,83,.470,33,57,.579,6,26,.231,19,24,.792,103,2017-01-25,NYK,DAL
35,Home,L 95-102 ,240,29,62,.468,19,37,.514,10,25,.400,27,29,.931,95,41,80,.513,30,54,.556,11,26,.423,9,10,.900,102,2017-01-28,UTA,MEM
36,@,W 95-90 ,240,35,99,.354,29,72,.403,6,27,.222,19,31,.613,95,37,88,.420,32,63,.508,5,25,.200,11,16,.688,90,2017-02-01,NYK,BRK
37,@,L 95-113 ,240,35,77,.455,29,55,.527,6,22,.273,19,26,.731,95,40,86,.465,30,60,.500,10,26,.385,23,28,.821,113,2017-02-01,PHI,DAL
38,Home,L 95-103 ,240,32,76,.421,19,42,.452,13,34,.382,18,21,.857,95,40,87,.460,35,68,.515,5,19,.263,18,20,.900,103,2017-02-05,BRK,TOR
39,Home,L 95-120 ,240,33,74,.446,27,57,.474,6,17,.353,23,32,.719,95,49,80,.613,39,54,.722,10,26,.385,12,18,.667,120,2017-02-06,ATL,UTA
40,Home,L 95-107 ,240,37,85,.435,29,59,.492,8,26,.308,13,14,.929,95,39,87,.448,26,47,.553,13,40,.325,16,20,.800,107,2017-02-09,CHO,HOU
41,@,W 95-91 ,240,37,75,.493,29,57,.509,8,18,.444,13,22,.591,95,33,89,.371,27,56,.482,6,33,.182,19,25,.760,91,2017-02-15,NOP,MEM
42,Home,L 95-109 ,240,32,74,.432,25,56,.446,7,18,.389,24,29,.828,95,37,74,.500,29,51,.569,8,23,.348,27,30,.900,109,2017-02-24,MIL,UTA
43,@,L 95-112 ,240,38,94,.404,30,66,.455,8,28,.286,11,17,.647,95,42,100,.420,31,69,.449,11,31,.355,17,22,.773,112,2017-02-25,BRK,GSW
44,@,L 95-113 ,240,34,85,.400,30,73,.411,4,12,.333,23,26,.885,95,38,78,.487,25,47,.532,13,31,.419,24,31,.774,113,2017-02-25,IND,MIA
45,@,L 95-102 ,240,37,83,.446,26,53,.491,11,30,.367,10,16,.625,95,35,70,.500,25,42,.595,10,28,.357,22,26,.846,102,2017-02-27,MIL,CLE
46,@,L 95-100 ,240,35,77,.455,21,44,.477,14,33,.424,11,13,.846,95,36,64,.563,26,43,.605,10,21,.476,18,24,.750,100,2017-03-01,DAL,ATL
47,Home,L 95-115 ,240,37,87,.425,31,63,.492,6,24,.250,15,20,.750,95,43,84,.512,33,51,.647,10,33,.303,19,25,.760,115,2017-03-03,LAL,BOS
48,@,L 95-109 ,240,34,83,.410,26,55,.473,8,28,.286,19,21,.905,95,45,92,.489,39,71,.549,6,21,.286,13,20,.650,109,2017-03-06,CHI,DET
49,Home,L 94-105 ,240,31,82,.378,22,54,.407,9,28,.321,23,30,.767,94,38,78,.487,34,71,.479,4,7,.571,25,36,.694,105,2011-12-25,DAL,MIA
50,Home,W 94-78 ,240,36,81,.444,27,60,.450,9,21,.429,13,25,.520,94,29,77,.377,23,60,.383,6,17,.353,14,21,.667,78,2011-12-29,ORL,NJN
51,@,W 94-86 ,240,37,74,.500,32,62,.516,5,12,.417,15,23,.652,94,32,78,.410,30,62,.484,2,16,.125,20,23,.870,86,2012-01-01,BOS,WAS
52,Home,L 94-108 ,240,33,89,.371,26,61,.426,7,28,.250,21,26,.808,94,41,78,.526,28,57,.491,13,21,.619,13,18,.722,108,2012-01-02,NJN,IND
53,Home,W 94-90 ,240,37,76,.487,32,61,.525,5,15,.333,15,23,.652,94,37,74,.500,34,64,.531,3,10,.300,13,16,.813,90,2012-01-02,UTA,NOH
54,@,L 94-109 ,240,36,78,.462,33,65,.508,3,13,.231,19,27,.704,94,42,80,.525,36,66,.545,6,14,.429,19,25,.760,109,2012-01-06,HOU,OKC
55,Home,W 94-85 ,240,36,71,.507,34,63,.540,2,8,.250,20,30,.667,94,33,80,.413,29,63,.460,4,17,.235,15,21,.714,85,2012-01-06,UTA,MEM
56,@,L 94-109 ,240,36,82,.439,30,68,.441,6,14,.429,16,20,.800,94,47,83,.566,38,71,.535,9,12,.750,6,6,1.000,109,2012-01-07,CHI,ATL
57,@,W 94-81 ,240,39,75,.520,33,65,.508,6,10,.600,10,14,.714,94,29,71,.408,21,48,.438,8,23,.348,15,21,.714,81,2012-01-09,NOH,DEN
58,Home,W 94-83 ,240,34,75,.453,28,63,.444,6,12,.500,20,30,.667,94,31,83,.373,20,57,.351,11,26,.423,10,11,.909,83,2012-01-12,MEM,NYK
59,@,L 94-102 ,240,35,77,.455,30,65,.462,5,12,.417,19,25,.760,94,35,85,.412,26,64,.406,9,21,.429,23,30,.767,102,2012-01-14,LAL,LAC
60,@,L 94-107 ,240,32,74,.432,23,47,.489,9,27,.333,21,27,.778,94,42,81,.519,39,73,.534,3,8,.375,20,26,.769,107,2012-01-14,NJN,UTA
61,Home,L 94-102 ,240,38,86,.442,34,69,.493,4,17,.235,14,26,.538,94,39,80,.488,35,65,.538,4,15,.267,20,29,.690,102,2012-01-16,CHA,CLE
62,Home,W 94-82 ,240,37,84,.440,26,61,.426,11,23,.478,9,13,.692,94,35,75,.467,32,61,.525,3,14,.214,9,14,.643,82,2012-01-16,PHI,MIL
63,@,W 94-91 ,240,37,71,.521,32,51,.627,5,20,.250,15,19,.789,94,31,80,.388,28,68,.412,3,12,.250,26,29,.897,91,2012-01-19,DAL,UTA
64,@,W 94-91 ,240,35,83,.422,27,67,.403,8,16,.500,16,21,.762,94,37,80,.463,27,57,.474,10,23,.435,7,8,.875,91,2012-01-20,IND,GSW
65,@,W 94-84 ,240,33,82,.402,28,67,.418,5,15,.333,23,31,.742,94,30,82,.366,25,67,.373,5,15,.333,19,25,.760,84,2012-01-20,POR,TOR
66,@,L 94-121 ,240,34,70,.486,27,50,.540,7,20,.350,19,27,.704,94,46,83,.554,35,59,.593,11,24,.458,18,24,.750,121,2012-01-21,CLE,ATL
67,Home,W 94-91 ,240,30,67,.448,23,52,.442,7,15,.467,27,32,.844,94,34,81,.420,31,61,.508,3,20,.150,20,24,.833,91,2012-01-21,DET,POR
68,Home,L 94-100 ,240,37,77,.481,35,62,.565,2,15,.133,18,21,.857,94,37,72,.514,32,60,.533,5,12,.417,21,30,.700,100,2012-01-22,WAS,BOS
69,Home,W 94-87 ,240,38,83,.458,32,69,.464,6,14,.429,12,14,.857,94,28,80,.350,27,61,.443,1,19,.053,30,31,.968,87,2012-01-27,BOS,IND
70,@,W 94-73 ,240,35,68,.515,32,54,.593,3,14,.214,21,29,.724,94,27,74,.365,20,52,.385,7,22,.318,12,18,.667,73,2012-01-29,TOR,NJN
71,@,W 94-72 ,240,36,81,.444,24,58,.414,12,23,.522,10,17,.588,94,27,73,.370,24,63,.381,3,10,.300,15,19,.789,72,2012-01-29,ATL,NOH
72,@,L 94-101 ,240,37,87,.425,33,74,.446,4,13,.308,16,20,.800,94,34,71,.479,27,54,.500,7,17,.412,26,33,.788,101,2012-02-03,MEM,OKC
73,@,L 94-102 ,240,33,90,.367,26,72,.361,7,18,.389,21,27,.778,94,34,80,.425,25,54,.463,9,26,.346,25,36,.694,102,2012-02-03,CLE,ORL
74,Home,W 94-84 ,240,41,81,.506,37,58,.638,4,23,.174,8,8,1.000,94,32,71,.451,28,55,.509,4,16,.250,16,20,.800,84,2012-02-07,BOS,CHA
75,@,W 94-86 ,240,35,68,.515,31,51,.608,4,17,.235,20,25,.800,94,33,75,.440,30,59,.508,3,16,.188,17,25,.680,86,2012-02-10,POR,NOH
76,@,L 94-97 (2OT),290,36,97,.371,33,77,.429,3,20,.150,19,21,.905,94,39,84,.464,33,65,.508,6,19,.316,13,19,.684,97,2012-02-11,POR,DAL
77,Home,L 94-99 ,240,39,93,.419,30,71,.423,9,22,.409,7,7,1.000,94,35,81,.432,20,44,.455,15,37,.405,14,21,.667,99,2012-02-11,MIL,ORL
78,@,W 94-92 ,240,35,81,.432,25,58,.431,10,23,.435,14,20,.700,94,37,78,.474,31,67,.463,6,11,.545,12,17,.706,92,2012-02-12,LAL,TOR
79,Home,W 94-85 ,240,33,76,.434,24,47,.511,9,29,.310,19,26,.731,94,33,90,.367,27,69,.391,6,21,.286,13,17,.765,85,2012-02-17,ORL,MIL
80,@,L 94-109 ,240,36,82,.439,33,73,.452,3,9,.333,19,29,.655,94,42,84,.500,41,74,.554,1,10,.100,24,32,.750,109,2012-02-29,CHA,DET
81,@,L 94-99 ,240,32,85,.376,26,67,.388,6,18,.333,24,28,.857,94,39,86,.453,31,63,.492,8,23,.348,13,15,.867,99,2012-03-02,MIL,ATL
82,@,L 94-107 ,240,34,76,.447,29,57,.509,5,19,.263,21,28,.750,94,45,87,.517,41,71,.577,4,16,.250,13,17,.765,107,2012-03-02,NJN,BOS
83,Home,L 94-99 ,240,32,72,.444,22,45,.489,10,27,.370,20,27,.741,94,36,86,.419,30,69,.435,6,17,.353,21,28,.750,99,2012-03-04,SAS,DEN
84,@,L 94-95 ,240,34,84,.405,29,61,.475,5,23,.217,21,32,.656,94,32,80,.400,21,52,.404,11,28,.393,20,27,.741,95,2012-03-05,LAC,MIN
85,@,L 94-106 ,240,44,93,.473,41,70,.586,3,23,.130,3,4,.750,94,37,78,.474,24,55,.436,13,23,.565,19,26,.731,106,2012-03-07,POR,MIN
86,Home,L 94-99 ,240,35,86,.407,30,64,.469,5,22,.227,19,26,.731,94,32,76,.421,21,50,.420,11,26,.423,24,31,.774,99,2012-03-08,CHI,ORL
87,@,L 94-96 ,240,38,87,.437,30,65,.462,8,22,.364,10,13,.769,94,37,76,.487,34,62,.548,3,14,.214,19,27,.704,96,2012-03-08,DAL,PHO
88,@,W 94-91 ,240,37,73,.507,32,58,.552,5,15,.333,15,23,.652,94,32,79,.405,28,70,.400,4,9,.444,23,30,.767,91,2012-03-11,MEM,DEN
89,@,L 94-97 ,240,39,83,.470,33,66,.500,6,17,.353,10,12,.833,94,36,71,.507,28,55,.509,8,16,.500,17,26,.654,97,2012-03-11,BOS,LAL
90,Home,L 94-106 ,240,33,80,.413,26,63,.413,7,17,.412,21,26,.808,94,40,79,.506,35,70,.500,5,9,.556,21,26,.808,106,2012-03-11,NYK,PHI
91,@,L 94-107 ,240,39,82,.476,38,70,.543,1,12,.083,15,18,.833,94,37,79,.468,27,52,.519,10,27,.370,23,30,.767,107,2012-03-11,IND,ORL
92,@,W 94-85 ,240,33,67,.493,28,54,.519,5,13,.385,23,27,.852,94,31,83,.373,26,60,.433,5,23,.217,18,21,.857,85,2012-03-12,BOS,LAC
93,@,L 94-111 ,240,40,76,.526,34,63,.540,6,13,.462,8,10,.800,94,43,76,.566,36,59,.610,7,17,.412,18,22,.818,111,2012-03-14,PHI,IND
94,Home,L 94-102 ,240,36,86,.419,26,63,.413,10,23,.435,12,14,.857,94,41,81,.506,33,65,.508,8,16,.500,12,13,.923,102,2012-03-17,NJN,NOH
95,@,W 94-82 ,240,36,82,.439,29,66,.439,7,16,.438,15,23,.652,94,35,85,.412,34,77,.442,1,8,.125,11,11,1.000,82,2012-03-21,CHI,TOR
96,Home,W 94-82 ,240,36,77,.468,32,62,.516,4,15,.267,18,21,.857,94,32,82,.390,29,72,.403,3,10,.300,15,24,.625,82,2012-03-28,BOS,UTA
97,@,W 94-75 ,240,39,83,.470,28,51,.549,11,32,.344,5,12,.417,94,30,77,.390,25,54,.463,5,23,.217,10,17,.588,75,2012-04-02,LAC,DAL
98,@,W 94-88 ,240,34,87,.391,30,71,.423,4,16,.250,22,24,.917,94,33,73,.452,28,52,.538,5,21,.238,17,24,.708,88,2012-04-02,MEM,OKC
99,@,L 94-98 ,240,38,82,.463,31,64,.484,7,18,.389,11,16,.688,94,37,80,.463,28,63,.444,9,17,.529,15,24,.625,98,2012-04-03,GSW,MEM
0,Home,L 94-97 ,240,37,87,.425,28,56,.500,9,31,.290,11,16,.688,94,41,86,.477,37,70,.529,4,16,.250,11,16,.688,97,2012-04-04,MIN,GSW
1,Home,W 94-92 ,240,35,67,.522,30,57,.526,5,10,.500,19,27,.704,94,35,83,.422,29,63,.460,6,20,.300,16,22,.727,92,2012-04-04,NOH,DEN
2,@,L 94-99 ,240,33,78,.423,26,57,.456,7,21,.333,21,29,.724,94,36,68,.529,32,58,.552,4,10,.400,23,39,.590,99,2012-04-05,WAS,DET
3,@,L 94-109 ,240,34,82,.415,27,60,.450,7,22,.318,19,28,.679,94,44,89,.494,33,62,.532,11,27,.407,10,19,.526,109,2012-04-07,SAC,LAC
4,Home,W 94-89 ,240,31,80,.388,22,60,.367,9,20,.450,23,27,.852,94,34,73,.466,25,52,.481,9,21,.429,12,17,.706,89,2012-04-07,MEM,DAL
5,@,L 94-116 ,240,34,78,.436,28,56,.500,6,22,.273,20,23,.870,94,47,94,.500,35,69,.507,12,25,.480,10,11,.909,116,2012-04-07,POR,MIL
6,Home,W 94-85 ,240,37,74,.500,33,61,.541,4,13,.308,16,20,.800,94,34,84,.405,30,66,.455,4,18,.222,13,18,.722,85,2012-04-09,MEM,LAC
7,@,W 94-89 ,240,37,80,.463,27,61,.443,10,19,.526,10,13,.769,94,33,83,.398,27,62,.435,6,21,.286,17,19,.895,89,2012-04-09,HOU,POR
8,Home,L 94-97 ,240,35,83,.422,29,58,.500,6,25,.240,18,23,.783,94,40,83,.482,31,63,.492,9,20,.450,8,10,.800,97,2012-04-13,POR,DAL
9,@,W 94-82 ,240,37,81,.457,32,67,.478,5,14,.357,15,22,.682,94,32,87,.368,26,65,.400,6,22,.273,12,14,.857,82,2012-04-14,BOS,NJN
10,@,W 94-82 ,240,39,80,.488,34,65,.523,5,15,.333,11,17,.647,94,32,79,.405,29,66,.439,3,13,.231,15,20,.750,82,2012-04-15,BOS,CHA
11,Home,L 94-100 (OT),265,33,84,.393,27,69,.391,6,15,.400,22,28,.786,94,39,91,.429,34,74,.459,5,17,.294,17,23,.739,100,2012-04-15,DET,CHI
12,@,L 94-104 ,240,37,83,.446,28,64,.438,9,19,.474,11,21,.524,94,38,81,.469,35,62,.565,3,19,.158,25,26,.962,104,2012-04-20,GSW,DAL
13,@,L 94-96 ,240,36,80,.450,30,55,.545,6,25,.240,16,19,.842,94,35,83,.422,29,64,.453,6,19,.316,20,27,.741,96,2012-04-26,POR,UTA
14,Home,W 94-84 ,240,36,79,.456,29,59,.492,7,20,.350,15,22,.682,94,32,90,.356,24,58,.414,8,32,.250,12,20,.600,84,2012-10-30,CLE,WAS
15,@,L 94-113 ,240,32,85,.376,21,63,.333,11,22,.500,19,26,.731,94,38,89,.427,32,75,.427,6,14,.429,31,42,.738,113,2012-10-31,DAL,UTA
16,Home,L 94-104 ,240,36,80,.450,26,60,.433,10,20,.500,12,17,.706,94,35,77,.455,29,64,.453,6,13,.462,28,34,.824,104,2012-11-02,GSW,MEM
17,@,L 94-115 ,240,39,91,.429,34,72,.472,5,19,.263,11,18,.611,94,45,92,.489,36,81,.444,9,11,.818,16,19,.842,115,2012-11-04,PHO,ORL
18,@,L 94-103 ,240,40,90,.444,35,75,.467,5,15,.333,9,13,.692,94,38,91,.418,33,77,.429,5,14,.357,22,25,.880,103,2012-11-05,UTA,MEM
19,Home,W 94-92 ,240,37,81,.457,33,62,.532,4,19,.211,16,23,.696,94,31,78,.397,25,57,.439,6,21,.286,24,28,.857,92,2012-11-05,SAC,GSW
20,@,L 94-100 (OT),265,39,95,.411,29,66,.439,10,29,.345,6,7,.857,94,34,81,.420,30,68,.441,4,13,.308,28,34,.824,100,2012-11-07,WAS,BOS
21,@,L 94-96 ,240,37,84,.440,32,66,.485,5,18,.278,15,17,.882,94,35,70,.500,33,61,.541,2,9,.222,24,28,.857,96,2012-11-09,IND,MIN
22,@,L 94-104 ,240,33,81,.407,25,53,.472,8,28,.286,20,23,.870,94,35,84,.417,27,62,.435,8,22,.364,26,38,.684,104,2012-11-09,DAL,NYK
23,@,L 94-105 ,240,36,87,.414,30,68,.441,6,19,.316,16,22,.727,94,38,71,.535,30,51,.588,8,20,.400,21,26,.808,105,2012-11-09,DET,OKC
24,Home,W 94-81 ,240,38,78,.487,36,64,.563,2,14,.143,16,24,.667,94,32,87,.368,28,71,.394,4,16,.250,13,17,.765,81,2012-11-10,UTA,PHO
25,@,W 94-76 ,240,35,73,.479,32,66,.485,3,7,.429,21,31,.677,94,25,84,.298,20,68,.294,5,16,.313,21,32,.656,76,2012-11-14,DET,PHI
26,@,W 94-87 ,240,31,80,.388,29,66,.439,2,14,.143,30,34,.882,94,32,85,.376,28,72,.389,4,13,.308,19,28,.679,87,2012-11-17,MEM,CHA
27,@,L 94-102 ,240,37,75,.493,33,59,.559,4,16,.250,16,18,.889,94,39,79,.494,30,57,.526,9,22,.409,15,20,.750,102,2012-11-18,CHI,POR
28,Home,L 94-101 ,240,34,89,.382,24,61,.393,10,28,.357,16,25,.640,94,35,79,.443,26,58,.448,9,21,.429,22,26,.846,101,2012-11-21,MIN,DEN
29,Home,W 94-91 ,240,36,90,.400,24,58,.414,12,32,.375,10,15,.667,94,30,76,.395,18,52,.346,12,24,.500,19,23,.826,91,2012-11-28,ATL,CHA
30,@,L 94-106 ,240,38,92,.413,31,69,.449,7,23,.304,11,12,.917,94,39,75,.520,35,66,.530,4,9,.444,24,33,.727,106,2012-11-30,UTA,OKC
31,Home,L 94-102 ,240,37,81,.457,30,64,.469,7,17,.412,13,18,.722,94,40,92,.435,32,69,.464,8,23,.348,14,16,.875,102,2012-12-03,GSW,ORL
32,@,L 94-104 ,240,37,84,.440,31,65,.477,6,19,.316,14,30,.467,94,41,78,.526,37,61,.607,4,17,.235,18,26,.692,104,2012-12-05,MIN,BOS
33,Home,L 94-97 ,240,34,85,.400,26,64,.406,8,21,.381,18,25,.720,94,37,78,.474,33,66,.500,4,12,.333,19,24,.792,97,2012-12-06,PHO,DAL
34,@,L 94-95 (OT),265,35,81,.432,29,59,.492,6,22,.273,18,25,.720,94,37,99,.374,35,88,.398,2,11,.182,19,26,.731,95,2012-12-07,BOS,PHI
35,@,W 94-89 ,240,37,80,.463,33,69,.478,4,11,.364,16,23,.696,94,35,87,.402,25,67,.373,10,20,.500,9,12,.750,89,2012-12-11,LAC,CHI
36,@,L 94-100 ,240,31,75,.413,24,48,.500,7,27,.259,25,40,.625,94,37,84,.440,26,57,.456,11,27,.407,15,26,.577,100,2012-12-11,LAL,CLE
37,Home,L 94-101 ,240,34,81,.420,29,68,.426,5,13,.385,21,31,.677,94,37,80,.463,31,63,.492,6,17,.353,21,34,.618,101,2012-12-11,DET,DEN
38,Home,L 94-100 ,240,35,82,.427,30,66,.455,5,16,.313,19,24,.792,94,37,85,.435,28,62,.452,9,23,.391,17,25,.680,100,2012-12-12,CHA,LAC
39,@,W 94-88 ,240,29,64,.453,19,45,.422,10,19,.526,26,35,.743,94,37,75,.493,33,57,.579,4,18,.222,10,17,.588,88,2012-12-12,BRK,TOR
40,@,L 94-99 ,240,39,94,.415,32,75,.427,7,19,.368,9,10,.900,94,36,69,.522,32,59,.542,4,10,.400,23,26,.885,99,2012-12-14,MEM,DEN
41,@,L 94-95 ,240,36,80,.450,25,60,.417,11,20,.550,11,15,.733,94,37,80,.463,26,51,.510,11,29,.379,10,12,.833,95,2012-12-16,NOH,POR
42,Home,L 94-99 (OT),265,36,94,.383,31,70,.443,5,24,.208,17,20,.850,94,36,83,.434,31,67,.463,5,16,.313,22,36,.611,99,2012-12-21,BOS,MIL
43,@,L 94-99 ,240,39,86,.453,37,70,.529,2,16,.125,14,16,.875,94,39,76,.513,35,58,.603,4,18,.222,17,23,.739,99,2012-12-21,NOH,SAS
44,@,W 94-82 ,240,38,88,.432,33,71,.465,5,17,.294,13,16,.813,94,31,79,.392,27,59,.458,4,20,.200,16,23,.696,82,2012-12-22,CLE,MIL
45,Home,W 94-91 ,240,32,72,.444,26,46,.565,6,26,.231,24,28,.857,94,34,84,.405,27,62,.435,7,22,.318,16,18,.889,91,2012-12-23,NYK,MIN
46,@,L 94-100 ,240,38,89,.427,29,63,.460,9,26,.346,9,16,.563,94,37,77,.481,32,56,.571,5,21,.238,21,31,.677,100,2012-12-25,NYK,LAL
47,Home,L 94-97 ,240,36,79,.456,25,49,.510,11,30,.367,11,13,.846,94,38,76,.500,36,64,.563,2,12,.167,19,20,.950,97,2012-12-26,ORL,NOH
48,@,W 94-83 ,240,33,82,.402,24,64,.375,9,18,.500,19,20,.950,94,32,83,.386,28,66,.424,4,17,.235,15,22,.682,83,2012-12-26,GSW,UTA
49,Home,L 94-102 ,240,36,86,.419,28,65,.431,8,21,.381,14,14,1.000,94,38,78,.487,25,54,.463,13,24,.542,13,16,.813,102,2012-12-28,CLE,ATL
50,Home,L 94-124 ,240,33,83,.398,25,53,.472,8,30,.267,20,27,.741,94,45,94,.479,32,65,.492,13,29,.448,21,23,.913,124,2012-12-29,HOU,OKC
51,@,L 94-96 ,240,36,77,.468,26,54,.481,10,23,.435,12,17,.706,94,39,82,.476,33,64,.516,6,18,.333,12,15,.800,96,2012-12-30,MIL,DET
52,Home,L 94-103 ,240,32,79,.405,22,53,.415,10,26,.385,20,26,.769,94,41,82,.500,31,60,.517,10,22,.455,11,17,.647,103,2013-01-01,WAS,DAL
53,Home,L 94-97 ,240,34,87,.391,29,66,.439,5,21,.238,21,24,.875,94,38,88,.432,35,72,.486,3,16,.188,18,23,.783,97,2013-01-02,CLE,SAC
54,@,L 94-115 ,240,29,80,.363,21,51,.412,8,29,.276,28,39,.718,94,42,84,.500,30,61,.492,12,23,.522,19,22,.864,115,2013-01-02,LAC,GSW
55,Home,L 94-96 ,240,37,78,.474,28,54,.519,9,24,.375,11,14,.786,94,36,77,.468,31,65,.477,5,12,.417,19,25,.760,96,2013-01-02,ORL,CHI
56,Home,W 94-75 ,240,40,89,.449,36,80,.450,4,9,.444,10,18,.556,94,27,85,.318,23,68,.338,4,17,.235,17,28,.607,75,2013-01-04,BOS,IND
57,@,L 94-100 ,240,35,81,.432,29,62,.468,6,19,.316,18,20,.900,94,31,78,.397,21,59,.356,10,19,.526,28,36,.778,100,2013-01-07,DAL,UTA
58,@,W 94-87 ,240,40,88,.455,38,71,.535,2,17,.118,12,16,.750,94,33,71,.465,26,54,.481,7,17,.412,14,20,.700,87,2013-01-09,MEM,GSW
59,@,L 94-95 ,240,39,86,.453,31,69,.449,8,17,.471,8,11,.727,94,41,85,.482,36,74,.486,5,11,.455,8,13,.615,95,2013-01-16,WAS,SAC
60,Home,L 94-98 ,240,34,89,.382,30,75,.400,4,14,.286,22,29,.759,94,39,92,.424,33,76,.434,6,16,.375,14,20,.700,98,2013-01-17,PHO,MIL
61,Home,W 94-89 ,240,30,74,.405,21,48,.438,9,26,.346,25,38,.658,94,35,80,.438,26,59,.441,9,21,.429,10,14,.714,89,2013-01-18,BRK,ATL
62,Home,W 94-87 ,240,34,93,.366,29,72,.403,5,21,.238,21,31,.677,94,32,77,.416,24,57,.421,8,20,.400,15,27,.556,87,2013-01-19,LAC,WAS
63,Home,L 94-100 ,240,34,81,.420,28,66,.424,6,15,.400,20,24,.833,94,29,74,.392,19,45,.422,10,29,.345,32,41,.780,100,2013-01-21,CHA,HOU
64,Home,L 94-96 ,240,37,77,.481,34,66,.515,3,11,.273,17,21,.810,94,36,82,.439,27,59,.458,9,23,.391,15,25,.600,96,2013-01-28,WAS,SAC
65,@,L 94-99 ,240,34,80,.425,26,55,.473,8,25,.320,18,20,.900,94,41,81,.506,40,69,.580,1,12,.083,16,24,.667,99,2013-02-04,CHA,MIA
66,Home,L 94-104 ,240,33,81,.407,25,63,.397,8,18,.444,20,23,.870,94,37,81,.457,27,56,.482,10,25,.400,20,21,.952,104,2013-02-06,MIN,SAS
67,Home,L 94-100 ,240,37,80,.463,36,67,.537,1,13,.077,19,27,.704,94,38,81,.469,30,55,.545,8,26,.308,16,20,.800,100,2013-02-08,MIN,NYK
68,Home,W 94-91 ,240,33,77,.429,25,59,.424,8,18,.444,20,30,.667,94,32,77,.416,26,63,.413,6,14,.429,21,26,.808,91,2013-02-11,CHA,BOS
69,@,L 94-109 ,240,38,68,.559,33,53,.623,5,15,.333,13,23,.565,94,42,87,.483,35,68,.515,7,19,.368,18,22,.818,109,2013-02-12,OKC,UTA
70,Home,W 94-92 ,240,37,88,.420,33,70,.471,4,18,.222,16,21,.762,94,34,76,.447,30,63,.476,4,13,.308,20,24,.833,92,2013-02-13,MIL,PHI
71,Home,L 94-97 ,240,35,75,.467,29,61,.475,6,14,.429,18,31,.581,94,34,85,.400,25,59,.424,9,26,.346,20,26,.769,97,2013-02-20,MIL,BRK
72,Home,W 94-87 ,240,28,70,.400,23,57,.404,5,13,.385,33,44,.750,94,31,81,.383,27,68,.397,4,13,.308,21,32,.656,87,2013-02-20,MIN,PHI
73,@,L 94-107 ,240,35,84,.417,34,69,.493,1,15,.067,23,28,.821,94,40,78,.513,32,58,.552,8,20,.400,19,24,.792,107,2013-02-23,UTA,LAC
74,Home,L 94-118 ,240,38,79,.481,34,65,.523,4,14,.286,14,22,.636,94,43,87,.494,34,66,.515,9,21,.429,23,28,.821,118,2013-02-23,ORL,CLE
75,@,L 94-116 ,240,37,81,.457,30,60,.500,7,21,.333,13,15,.867,94,44,83,.530,28,51,.549,16,32,.500,12,21,.571,116,2013-02-28,MIN,LAL
76,Home,W 94-86 ,240,36,75,.480,33,60,.550,3,15,.200,19,28,.679,94,32,94,.340,27,71,.380,5,23,.217,17,22,.773,86,2013-03-01,BOS,GSW
77,@,L 94-109 ,240,34,87,.391,33,75,.440,1,12,.083,25,36,.694,94,44,90,.489,37,70,.529,7,20,.350,14,22,.636,109,2013-03-02,MIN,POR
78,Home,L 94-95 ,240,35,86,.407,25,55,.455,10,31,.323,14,14,1.000,94,31,70,.443,23,49,.469,8,21,.381,25,29,.862,95,2013-03-07,NYK,OKC
79,Home,L 94-116 ,240,35,85,.412,28,62,.452,7,23,.304,17,25,.680,94,46,81,.568,34,57,.596,12,24,.500,12,16,.750,116,2013-03-08,CHA,OKC
80,@,W 94-88 ,240,27,74,.365,12,39,.308,15,35,.429,25,34,.735,94,33,87,.379,24,66,.364,9,21,.429,13,20,.650,88,2013-03-08,HOU,GSW
81,@,L 94-117 ,240,34,79,.430,23,51,.451,11,28,.393,15,22,.682,94,41,84,.488,32,63,.508,9,21,.429,26,37,.703,117,2013-03-13,NYK,DEN
82,Home,L 94-98 ,240,40,85,.471,33,67,.493,7,18,.389,7,12,.583,94,35,75,.467,30,55,.545,5,20,.250,23,27,.852,98,2013-03-13,PHI,MIA
83,@,L 94-107 ,240,35,79,.443,32,60,.533,3,19,.158,21,31,.677,94,41,84,.488,29,61,.475,12,23,.522,13,16,.813,107,2013-03-15,PHO,ATL
84,Home,L 94-107 ,240,33,89,.371,24,64,.375,9,25,.360,19,21,.905,94,41,79,.519,34,64,.531,7,15,.467,18,22,.818,107,2013-03-15,MIL,MIA
85,@,L 94-106 ,240,38,79,.481,33,62,.532,5,17,.294,13,18,.722,94,40,76,.526,25,42,.595,15,34,.441,11,16,.688,106,2013-03-20,ORL,NYK
86,@,L 94-104 ,240,32,77,.416,27,60,.450,5,17,.294,25,27,.926,94,38,82,.463,32,63,.508,6,19,.316,22,28,.786,104,2013-03-22,BOS,DAL
87,Home,L 94-99 ,240,36,79,.456,25,47,.532,11,32,.344,11,14,.786,94,38,71,.535,28,49,.571,10,22,.455,13,24,.542,99,2013-03-22,TOR,NYK
88,@,L 94-100 ,240,36,80,.450,29,59,.492,7,21,.333,15,25,.600,94,40,84,.476,32,61,.525,8,23,.348,12,15,.800,100,2013-03-25,ATL,IND
89,Home,L 94-108 ,240,37,86,.430,28,62,.452,9,24,.375,11,18,.611,94,37,78,.474,22,50,.440,15,28,.536,19,29,.655,108,2013-03-25,ORL,MIA
90,@,L 94-107 ,240,34,77,.442,28,61,.459,6,16,.375,20,22,.909,94,36,72,.500,31,59,.525,5,13,.385,30,44,.682,107,2013-03-25,MEM,WAS
91,@,L 94-103 ,240,34,81,.420,25,54,.463,9,27,.333,17,21,.810,94,40,79,.506,36,68,.529,4,11,.364,19,21,.905,103,2013-03-29,HOU,MEM
92,@,L 94-95 ,240,36,72,.500,29,56,.518,7,16,.438,15,22,.682,94,30,76,.395,22,53,.415,8,23,.348,27,40,.675,95,2013-03-31,DET,CHI
93,@,L 94-102 ,240,41,81,.506,38,69,.551,3,12,.250,9,15,.600,94,37,81,.457,28,51,.549,9,30,.300,19,26,.731,102,2013-04-01,CLE,ATL
94,@,W 94-76 ,240,34,67,.507,30,55,.545,4,12,.333,22,28,.786,94,33,80,.413,29,51,.569,4,29,.138,6,10,.600,76,2013-04-03,MEM,POR
95,@,L 94-95 ,240,41,88,.466,37,70,.529,4,18,.222,8,10,.800,94,35,89,.393,29,72,.403,6,17,.353,19,30,.633,95,2013-04-04,DAL,DEN
96,@,L 94-99 ,240,39,85,.459,36,75,.480,3,10,.300,13,15,.867,94,32,79,.405,28,63,.444,4,16,.250,31,46,.674,99,2013-04-09,CLE,IND
97,Home,W 94-75 ,240,39,82,.476,36,69,.522,3,13,.231,13,20,.650,94,30,80,.375,28,66,.424,2,14,.143,13,18,.722,75,2013-04-09,MEM,CHA
98,Home,W 94-83 ,240,38,88,.432,30,53,.566,8,35,.229,10,10,1.000,94,33,75,.440,24,50,.480,9,25,.360,8,14,.571,83,2013-04-09,MIA,MIL
99,@,L 94-98 ,240,33,82,.402,24,58,.414,9,24,.375,19,24,.792,94,35,84,.417,30,69,.435,5,15,.333,23,34,.676,98,2013-10-30,BRK,CLE
0,@,L 94-125 ,240,35,89,.393,27,71,.380,8,18,.444,16,21,.762,94,46,86,.535,31,59,.525,15,27,.556,18,23,.783,125,2013-10-30,LAL,GSW
1,@,L 94-101 ,240,39,93,.419,31,78,.397,8,15,.533,8,15,.533,94,40,76,.526,29,56,.518,11,20,.550,10,16,.625,101,2013-10-30,MEM,SAS
2,Home,L 94-102 ,240,35,83,.422,26,64,.406,9,19,.474,15,20,.750,94,40,86,.465,36,70,.514,4,16,.250,18,20,.900,102,2013-11-05,DEN,SAS
3,Home,W 94-79 ,240,40,84,.476,33,63,.524,7,21,.333,7,9,.778,94,30,90,.333,21,64,.328,9,26,.346,10,14,.714,79,2013-11-08,PHI,CLE
4,@,L 94-104 ,240,38,82,.463,30,65,.462,8,17,.471,10,18,.556,94,43,90,.478,37,71,.521,6,19,.316,12,17,.706,104,2013-11-09,ORL,ATL
5,Home,L 94-107 ,240,35,78,.449,28,52,.538,7,26,.269,17,27,.630,94,42,88,.477,33,64,.516,9,24,.375,14,23,.609,107,2013-11-09,HOU,LAC
6,@,L 94-101 ,240,39,88,.443,35,75,.467,4,13,.308,12,13,.923,94,38,78,.487,31,56,.554,7,22,.318,18,23,.783,101,2013-11-10,NOP,PHO
7,Home,L 94-103 ,240,33,81,.407,28,68,.412,5,13,.385,23,29,.793,94,35,76,.461,25,49,.510,10,27,.370,23,28,.821,103,2013-11-11,CHA,ATL
8,Home,W 94-91 ,240,35,82,.427,26,56,.464,9,26,.346,15,21,.714,94,33,74,.446,28,61,.459,5,13,.385,20,22,.909,91,2013-11-13,ORL,MIL
9,@,L 94-110 ,240,34,85,.400,30,69,.435,4,16,.250,22,28,.786,94,40,79,.506,29,60,.483,11,19,.579,19,24,.792,110,2013-11-16,IND,CHI
10,@,L 94-97 ,240,38,99,.384,32,78,.410,6,21,.286,12,22,.545,94,34,78,.436,25,49,.510,9,29,.310,20,26,.769,97,2013-11-18,PHI,DAL
11,@,W 94-87 ,240,33,72,.458,29,56,.518,4,16,.250,24,31,.774,94,36,93,.387,31,73,.425,5,20,.250,10,12,.833,87,2013-11-23,BOS,ATL
12,@,L 94-113 ,240,33,73,.452,27,54,.500,6,19,.316,22,26,.846,94,43,80,.538,31,51,.608,12,29,.414,15,23,.652,113,2013-11-25,MIL,DET
13,Home,L 94-99 ,240,31,83,.373,20,53,.377,11,30,.367,21,26,.808,94,34,85,.400,21,55,.382,13,30,.433,18,22,.818,99,2013-11-27,BRK,LAL
14,Home,W 94-88 ,240,39,84,.464,35,69,.507,4,15,.267,12,15,.800,94,36,92,.391,29,65,.446,7,27,.259,9,14,.643,88,2013-11-27,OKC,SAS
15,@,L 94-105 ,240,38,85,.447,31,63,.492,7,22,.318,11,17,.647,94,43,82,.524,39,63,.619,4,19,.211,15,21,.714,105,2013-11-27,PHI,ORL
16,Home,L 94-106 ,240,34,79,.430,25,51,.490,9,28,.321,17,20,.850,94,40,82,.488,36,56,.643,4,26,.154,22,25,.880,106,2013-12-08,LAL,TOR
17,@,L 94-118 ,240,34,85,.400,27,64,.422,7,21,.333,19,21,.905,94,47,77,.610,42,64,.656,5,13,.385,19,20,.950,118,2013-12-08,IND,OKC
18,Home,W 94-85 ,240,36,86,.419,26,69,.377,10,17,.588,12,17,.706,94,30,75,.400,24,53,.453,6,22,.273,19,20,.950,85,2013-12-09,MEM,ORL
19,@,W 94-83 ,240,35,82,.427,30,55,.545,5,27,.185,19,29,.655,94,33,92,.359,30,71,.423,3,21,.143,14,19,.737,83,2013-12-09,LAC,PHI
20,Home,L 94-105 ,240,36,82,.439,35,75,.467,1,7,.143,21,23,.913,94,40,85,.471,34,66,.515,6,19,.316,19,20,.950,105,2013-12-09,UTA,POR
21,@,L 94-109 ,240,40,87,.460,30,56,.536,10,31,.323,4,5,.800,94,42,74,.568,33,55,.600,9,19,.474,16,22,.727,109,2013-12-10,NYK,CLE
22,Home,L 94-121 ,240,39,83,.470,31,55,.564,8,28,.286,8,16,.500,94,41,85,.482,30,61,.492,11,24,.458,28,33,.848,121,2013-12-10,DET,MIN
23,@,L 94-99 ,240,39,83,.470,35,71,.493,4,12,.333,12,17,.706,94,36,76,.474,28,55,.509,8,21,.381,19,25,.760,99,2013-12-13,CHA,IND
24,@,L 94-130 ,240,37,90,.411,29,60,.483,8,30,.267,12,20,.600,94,47,78,.603,26,43,.605,21,35,.600,15,26,.577,130,2013-12-16,PHI,BRK
25,@,L 94-117 ,240,39,84,.464,34,66,.515,5,18,.278,11,17,.647,94,45,71,.634,39,56,.696,6,15,.400,21,26,.808,117,2013-12-16,UTA,MIA
26,@,L 94-109 ,240,38,79,.481,33,67,.493,5,12,.417,13,23,.565,94,44,82,.537,36,60,.600,8,22,.364,13,16,.813,109,2013-12-18,CHI,HOU
27,@,L 94-97 ,240,32,73,.438,27,59,.458,5,14,.357,25,28,.893,94,37,77,.481,32,56,.571,5,21,.238,18,22,.818,97,2013-12-18,IND,MIA
28,@,L 94-104 ,240,35,75,.467,24,51,.471,11,24,.458,13,15,.867,94,39,83,.470,28,63,.444,11,20,.550,15,20,.750,104,2013-12-23,UTA,MEM
29,Home,L 94-123 ,240,38,90,.422,32,67,.478,6,23,.261,12,19,.632,94,45,84,.536,32,60,.533,13,24,.542,20,26,.769,123,2013-12-25,NYK,OKC
30,Home,L 94-97 ,240,38,81,.469,30,61,.492,8,20,.400,10,11,.909,94,34,67,.507,23,44,.523,11,23,.478,18,28,.643,97,2013-12-30,DEN,MIA
31,@,W 94-79 ,240,40,91,.440,34,68,.500,6,23,.261,8,14,.571,94,29,81,.358,22,57,.386,7,24,.292,14,18,.778,79,2013-12-31,MIL,LAL
32,Home,L 94-98 ,240,36,82,.439,33,68,.485,3,14,.214,19,26,.731,94,36,91,.396,28,58,.483,8,33,.242,18,21,.857,98,2013-12-31,OKC,POR
33,@,W 94-81 ,240,41,85,.482,35,58,.603,6,27,.222,6,10,.600,94,34,89,.382,29,70,.414,5,19,.263,8,13,.615,81,2013-12-31,GSW,ORL
34,Home,W 94-82 ,240,35,84,.417,33,69,.478,2,15,.133,22,28,.786,94,32,81,.395,30,69,.435,2,12,.167,16,23,.696,82,2014-01-02,CHI,BOS
35,Home,L 94-110 ,240,33,80,.413,25,54,.463,8,26,.308,20,24,.833,94,40,74,.541,34,58,.586,6,16,.375,24,31,.774,110,2014-01-04,ORL,MIA
36,@,L 94-110 ,240,33,83,.398,26,63,.413,7,20,.350,21,27,.778,94,45,95,.474,36,65,.554,9,30,.300,11,13,.846,110,2014-01-08,ORL,POR
37,@,L 94-120 ,240,37,84,.440,33,64,.516,4,20,.200,16,23,.696,94,44,87,.506,32,59,.542,12,28,.429,20,26,.769,120,2014-01-11,ORL,DEN
38,@,L 94-116 ,240,35,83,.422,26,64,.406,9,19,.474,15,22,.682,94,40,79,.506,28,56,.500,12,23,.522,24,30,.800,116,2014-01-13,MIL,TOR
39,Home,W 94-89 ,240,34,78,.436,23,54,.426,11,24,.458,15,20,.750,94,36,82,.439,33,64,.516,3,18,.167,14,20,.700,89,2014-01-17,TOR,MIN
40,Home,L 94-102 ,240,35,86,.407,25,56,.446,10,30,.333,14,20,.700,94,41,91,.451,33,72,.458,8,19,.421,12,15,.800,102,2014-01-20,GSW,IND
41,Home,L 94-95 ,240,32,87,.368,25,68,.368,7,19,.368,23,30,.767,94,37,86,.430,30,65,.462,7,21,.333,14,25,.560,95,2014-01-29,BOS,PHI
42,Home,L 94-102 ,240,38,87,.437,37,72,.514,1,15,.067,17,24,.708,94,39,91,.429,31,74,.419,8,17,.471,16,20,.800,102,2014-01-30,IND,PHO
43,@,W 94-90 ,240,38,80,.475,34,68,.500,4,12,.333,14,22,.636,94,39,84,.464,33,62,.532,6,22,.273,6,7,.857,90,2014-01-31,MEM,MIN
44,@,W 94-79 ,240,37,84,.440,31,63,.492,6,21,.286,14,16,.875,94,32,78,.410,29,61,.475,3,17,.176,12,13,.923,79,2014-02-03,TOR,UTA
45,@,W 94-90 ,240,30,79,.380,22,58,.379,8,21,.381,26,33,.788,94,36,90,.400,32,69,.464,4,21,.190,14,20,.700,90,2014-02-05,POR,NYK
46,Home,W 94-89 ,240,36,74,.486,26,49,.531,10,25,.400,12,19,.632,94,29,67,.433,22,44,.500,7,23,.304,24,30,.800,89,2014-02-08,UTA,MIA
47,@,L 94-100 ,240,34,87,.391,29,70,.414,5,17,.294,21,28,.750,94,36,82,.439,25,54,.463,11,28,.393,17,26,.654,100,2014-02-19,BOS,PHO
48,@,W 94-92 ,240,36,72,.500,29,60,.483,7,12,.583,15,20,.750,94,35,83,.422,32,66,.485,3,17,.176,19,23,.826,92,2014-02-19,CHI,TOR
49,@,L 94-102 ,240,37,82,.451,31,69,.449,6,13,.462,14,18,.778,94,39,91,.429,32,71,.451,7,20,.350,17,17,1.000,102,2014-02-21,UTA,POR
50,Home,W 94-93 ,240,36,74,.486,33,60,.550,3,14,.214,19,26,.731,94,35,81,.432,29,68,.426,6,13,.462,17,21,.810,93,2014-02-22,WAS,NOP
51,Home,W 94-91 ,240,34,82,.415,29,67,.433,5,15,.333,21,28,.750,94,36,78,.462,30,64,.469,6,14,.429,13,18,.722,91,2014-03-02,IND,UTA
52,@,L 94-103 ,240,34,79,.430,28,64,.438,6,15,.400,20,25,.800,94,38,74,.514,23,48,.479,15,26,.577,12,13,.923,103,2014-03-05,MEM,BRK
53,Home,L 94-105 ,240,39,87,.448,37,76,.487,2,11,.182,14,17,.824,94,43,80,.538,38,61,.623,5,19,.263,14,17,.824,105,2014-03-05,DET,CHI
54,Home,L 94-142 ,240,34,86,.395,26,56,.464,8,30,.267,18,26,.692,94,57,103,.553,45,77,.584,12,26,.462,16,22,.727,142,2014-03-06,LAL,LAC
55,@,L 94-105 ,240,32,67,.478,25,51,.490,7,16,.438,23,29,.793,94,36,81,.444,28,61,.459,8,20,.400,25,31,.806,105,2014-03-09,IND,DAL
56,Home,W 94-83 ,240,40,73,.548,36,57,.632,4,16,.250,10,13,.769,94,32,91,.352,29,72,.403,3,19,.158,16,19,.842,83,2014-03-11,IND,BOS
57,Home,L 94-103 ,240,35,77,.455,24,48,.500,11,29,.379,13,19,.684,94,40,82,.488,30,60,.500,10,22,.455,13,18,.722,103,2014-03-14,GSW,CLE
58,Home,L 94-101 ,240,35,90,.389,27,64,.422,8,26,.308,16,18,.889,94,39,67,.582,30,46,.652,9,21,.429,14,22,.636,101,2014-03-14,PHI,IND
59,Home,W 94-87 ,240,31,78,.397,25,58,.431,6,20,.300,26,33,.788,94,31,85,.365,29,71,.408,2,14,.143,23,37,.622,87,2014-03-15,CHI,SAC
60,@,L 94-115 ,240,35,81,.432,31,71,.437,4,10,.400,20,27,.741,94,42,76,.553,34,56,.607,8,20,.400,23,28,.821,115,2014-03-15,MIL,NYK
61,@,L 94-101 ,240,34,71,.479,23,50,.460,11,21,.524,15,22,.682,94,36,77,.468,28,51,.549,8,26,.308,21,25,.840,101,2014-03-15,BRK,WAS
62,Home,W 94-89 ,240,33,78,.423,24,51,.471,9,27,.333,19,21,.905,94,34,93,.366,25,71,.352,9,22,.409,12,14,.857,89,2014-03-17,DAL,BOS
63,Home,L 94-102 ,240,37,81,.457,26,57,.456,11,24,.458,9,19,.474,94,36,83,.434,28,68,.412,8,15,.533,22,27,.815,102,2014-03-19,PHI,CHI
64,@,L 94-124 ,240,34,84,.405,25,57,.439,9,27,.333,17,22,.773,94,49,94,.521,41,75,.547,8,19,.421,18,19,.947,124,2014-03-22,POR,CHA
65,@,L 94-103 ,240,37,82,.451,31,63,.492,6,19,.316,14,17,.824,94,37,80,.463,31,64,.484,6,16,.375,23,29,.793,103,2014-03-23,ORL,LAL
66,Home,L 94-114 ,240,34,83,.410,27,56,.482,7,27,.259,19,28,.679,94,46,83,.554,37,66,.561,9,17,.529,13,18,.722,114,2014-03-24,UTA,DET
67,Home,W 94-81 ,240,33,69,.478,24,46,.522,9,23,.391,19,25,.760,94,31,85,.365,22,67,.328,9,18,.500,10,16,.625,81,2014-03-28,OKC,SAC
68,@,L 94-100 ,240,38,79,.481,29,62,.468,9,17,.529,9,13,.692,94,34,78,.436,31,57,.544,3,21,.143,29,34,.853,100,2014-03-31,WAS,CHA
69,Home,W 94-80 ,240,38,80,.475,35,64,.547,3,16,.188,15,16,.938,94,31,77,.403,24,52,.462,7,25,.280,11,15,.733,80,2014-03-31,CHI,BOS
70,@,W 94-92 ,240,38,85,.447,33,76,.434,5,9,.556,13,23,.565,94,36,73,.493,30,53,.566,6,20,.300,14,24,.583,92,2014-03-31,MEM,DEN
71,@,L 94-101 ,240,34,93,.366,27,77,.351,7,16,.438,19,28,.679,94,39,79,.494,34,61,.557,5,18,.278,18,24,.750,101,2014-04-02,DET,IND
72,@,L 94-106 ,240,38,88,.432,29,66,.439,9,22,.409,9,12,.750,94,40,81,.494,34,63,.540,6,18,.333,20,23,.870,106,2014-04-03,SAS,OKC
73,@,L 94-102 ,240,33,78,.423,27,67,.403,6,11,.545,22,28,.786,94,40,84,.476,30,62,.484,10,22,.455,12,16,.750,102,2014-04-04,IND,TOR
74,Home,L 94-96 (OT),265,35,96,.365,28,74,.378,7,22,.318,17,21,.810,94,34,91,.374,25,65,.385,9,26,.346,19,27,.704,96,2014-04-05,CLE,CHA
75,@,L 94-100 ,240,38,90,.422,34,78,.436,4,12,.333,14,18,.778,94,41,87,.471,36,65,.554,5,22,.227,13,15,.867,100,2014-04-06,NOP,POR
76,@,W 94-88 ,240,39,80,.488,30,61,.492,9,19,.474,7,10,.700,94,34,80,.425,28,66,.424,6,14,.429,14,17,.824,88,2014-04-09,PHO,NOP
77,@,W 94-88 (OT),265,35,92,.380,24,67,.358,11,25,.440,13,15,.867,94,37,82,.451,36,67,.537,1,15,.067,13,20,.650,88,2014-04-09,CHA,WAS
78,@,L 94-116 ,240,35,86,.407,26,68,.382,9,18,.500,15,19,.789,94,44,82,.537,39,69,.565,5,13,.385,23,27,.852,116,2014-04-11,NOP,OKC
79,@,L 94-101 ,240,34,79,.430,32,66,.485,2,13,.154,24,32,.750,94,35,84,.417,28,62,.452,7,22,.318,24,29,.828,101,2014-04-12,UTA,DEN
80,Home,W 94-89 ,240,35,87,.402,33,69,.478,2,18,.111,22,26,.846,94,32,78,.410,24,53,.453,8,25,.320,17,23,.739,89,2014-10-31,PHO,SAS
81,@,L 94-103 ,240,34,83,.410,25,57,.439,9,26,.346,17,19,.895,94,34,81,.420,30,71,.423,4,10,.400,31,35,.886,103,2014-10-31,POR,SAC
82,Home,W 94-92 ,240,31,69,.449,26,52,.500,5,17,.294,27,38,.711,94,38,92,.413,30,67,.448,8,25,.320,8,11,.727,92,2014-11-05,SAS,ATL
83,@,L 94-96 (OT),265,35,90,.389,27,63,.429,8,27,.296,16,20,.800,94,34,91,.374,27,74,.365,7,17,.412,21,23,.913,96,2014-11-05,IND,WAS
84,Home,L 94-109 ,240,37,83,.446,28,50,.560,9,33,.273,11,13,.846,94,40,82,.488,30,58,.517,10,24,.417,19,22,.864,109,2014-11-12,BOS,OKC
85,@,L 94-127 ,240,40,90,.444,37,68,.544,3,22,.136,11,13,.846,94,49,90,.544,30,59,.508,19,31,.613,10,13,.769,127,2014-11-15,ATL,CLE
86,Home,W 94-91 ,240,37,86,.430,37,74,.500,0,12,.000,20,24,.833,94,34,80,.425,27,56,.482,7,24,.292,16,18,.889,91,2014-11-15,SAC,SAS
87,@,W 94-92 ,240,31,67,.463,26,52,.500,5,15,.333,27,30,.900,94,38,85,.447,34,65,.523,4,20,.200,12,19,.632,92,2014-11-21,BRK,OKC
88,Home,L 94-106 ,240,33,71,.465,28,57,.491,5,14,.357,23,29,.793,94,42,93,.452,38,76,.500,4,17,.235,18,22,.818,106,2014-11-22,UTA,NOP
89,@,W 94-88 ,240,37,86,.430,30,67,.448,7,19,.368,13,15,.867,94,37,95,.389,32,72,.444,5,23,.217,9,12,.750,88,2014-11-23,POR,BOS
90,Home,L 94-101 (OT),265,33,89,.371,30,65,.462,3,24,.125,25,34,.735,94,34,90,.378,24,53,.453,10,37,.270,23,38,.605,101,2014-11-23,LAL,DEN
91,Home,W 94-93 ,240,33,66,.500,22,43,.512,11,23,.478,17,19,.895,94,37,79,.468,30,58,.517,7,21,.333,12,16,.750,93,2014-11-23,MIA,CHO
92,Home,L 94-96 ,240,34,76,.447,27,53,.509,7,23,.304,19,28,.679,94,39,87,.448,33,66,.500,6,21,.286,12,17,.706,96,2014-12-07,DET,OKC
93,@,L 94-103 ,240,31,85,.365,22,57,.386,9,28,.321,23,30,.767,94,38,87,.437,31,61,.508,7,26,.269,20,22,.909,103,2014-12-11,CLE,OKC
94,@,L 94-106 ,240,33,80,.413,25,58,.431,8,22,.364,20,23,.870,94,38,91,.418,28,65,.431,10,26,.385,20,22,.909,106,2014-12-12,IND,TOR
95,Home,L 94-100 ,240,38,90,.422,35,80,.438,3,10,.300,15,20,.750,94,34,81,.420,29,64,.453,5,17,.294,27,34,.794,100,2014-12-14,MIN,LAL
96,Home,L 94-96 ,240,30,75,.400,18,37,.486,12,38,.316,22,27,.815,94,35,73,.479,27,57,.474,8,16,.500,18,22,.818,96,2014-12-15,PHO,MIL
97,Home,L 94-101 ,240,37,83,.446,25,61,.410,12,22,.545,8,12,.667,94,39,73,.534,35,62,.565,4,11,.364,19,24,.792,101,2014-12-19,ORL,UTA
98,Home,L 94-102 ,240,36,86,.419,28,62,.452,8,24,.333,14,18,.778,94,38,83,.458,30,63,.476,8,20,.400,18,24,.750,102,2014-12-27,CHO,ORL
99,Home,L 94-104 (OT),265,33,90,.367,26,65,.400,7,25,.280,21,26,.808,94,40,85,.471,34,64,.531,6,21,.286,18,21,.857,104,2014-12-29,CHO,MIL
0,@,L 94-100 ,240,38,82,.463,30,65,.462,8,17,.471,10,14,.714,94,38,79,.481,31,60,.517,7,19,.368,17,22,.773,100,2014-12-30,MIN,UTA
1,@,W 94-91 ,240,35,81,.432,27,61,.443,8,20,.400,16,20,.800,94,38,89,.427,31,65,.477,7,24,.292,8,10,.800,91,2015-01-02,IND,MIL
2,@,L 94-98 ,240,37,88,.420,33,74,.446,4,14,.286,16,20,.800,94,33,83,.398,22,57,.386,11,26,.423,21,24,.875,98,2015-01-05,LAL,POR
3,@,L 94-98 ,240,36,80,.450,30,62,.484,6,18,.333,16,24,.667,94,37,86,.430,33,72,.458,4,14,.286,20,26,.769,98,2015-01-07,NOP,CHO
4,@,L 94-112 ,240,35,86,.407,28,63,.444,7,23,.304,17,23,.739,94,43,86,.500,33,56,.589,10,30,.333,16,17,.941,112,2015-01-09,CLE,GSW
5,@,L 94-99 ,240,36,74,.486,29,53,.547,7,21,.333,15,22,.682,94,42,91,.462,35,70,.500,7,21,.333,8,9,.889,99,2015-01-09,UTA,OKC
6,Home,L 94-106 ,240,36,81,.444,29,59,.492,7,22,.318,15,19,.789,94,41,86,.477,28,55,.509,13,31,.419,11,17,.647,106,2015-01-11,LAL,POR
7,Home,L 94-105 ,240,34,73,.466,26,51,.510,8,22,.364,18,23,.783,94,39,80,.488,31,59,.525,8,21,.381,19,23,.826,105,2015-01-14,DET,NOP
8,Home,L 94-100 ,240,35,87,.402,29,61,.475,6,26,.231,18,20,.900,94,37,88,.420,29,65,.446,8,23,.348,18,19,.947,100,2015-01-14,POR,LAC
9,Home,W 94-85 ,240,36,85,.424,24,54,.444,12,31,.387,10,10,1.000,94,31,65,.477,28,58,.483,3,7,.429,20,27,.741,85,2015-01-16,UTA,LAL
10,@,L 94-108 ,240,30,80,.375,22,64,.344,8,16,.500,26,32,.813,94,41,90,.456,33,72,.458,8,18,.444,18,25,.720,108,2015-01-19,CHI,CLE
11,@,L 94-98 ,240,34,76,.447,30,64,.469,4,12,.333,22,30,.733,94,35,88,.398,24,52,.462,11,36,.306,17,26,.654,98,2015-01-19,SAC,POR
12,@,W 94-86 ,240,41,92,.446,35,66,.530,6,26,.231,6,10,.600,94,32,68,.471,24,46,.522,8,22,.364,14,19,.737,86,2015-01-20,OKC,MIA
13,@,L 94-103 ,240,37,78,.474,33,66,.500,4,12,.333,16,25,.640,94,36,76,.474,29,58,.500,7,18,.389,24,26,.923,103,2015-01-26,ORL,MEM
14,@,L 94-99 ,240,35,80,.438,25,49,.510,10,31,.323,14,17,.824,94,34,85,.400,19,48,.396,15,37,.405,16,18,.889,99,2015-01-28,POR,CLE
15,@,L 94-99 ,240,35,82,.427,25,57,.439,10,25,.400,14,16,.875,94,36,88,.409,22,53,.415,14,35,.400,13,15,.867,99,2015-01-28,DAL,HOU
16,@,W 94-89 ,240,34,76,.447,25,50,.500,9,26,.346,17,25,.680,94,35,81,.432,30,57,.526,5,24,.208,14,20,.700,89,2015-01-28,LAC,UTA
17,@,L 94-103 ,240,34,76,.447,29,62,.468,5,14,.357,21,25,.840,94,37,74,.500,29,51,.569,8,23,.348,21,25,.840,103,2015-01-30,MIN,PHI
18,Home,L 94-99 ,240,33,80,.413,28,55,.509,5,25,.200,23,25,.920,94,34,80,.425,29,65,.446,5,15,.333,26,29,.897,99,2015-01-31,IND,SAC
19,@,L 94-100 ,240,34,82,.415,31,69,.449,3,13,.231,23,26,.885,94,39,84,.464,29,53,.547,10,31,.323,12,18,.667,100,2015-02-02,MIN,DAL
20,Home,W 94-87 ,240,33,76,.434,27,51,.529,6,25,.240,22,27,.815,94,35,84,.417,30,74,.405,5,10,.500,12,17,.706,87,2015-02-05,CHO,WAS
21,@,L 94-105 ,240,38,91,.418,33,69,.478,5,22,.227,13,20,.650,94,31,72,.431,23,42,.548,8,30,.267,35,44,.795,105,2015-02-05,LAC,CLE
22,Home,W 94-88 ,240,36,92,.391,33,79,.418,3,13,.231,19,21,.905,94,33,80,.413,21,50,.420,12,30,.400,10,11,.909,88,2015-02-08,MEM,ATL
23,@,W 94-91 ,240,40,90,.444,33,63,.524,7,27,.259,7,9,.778,94,33,86,.384,28,72,.389,5,14,.357,20,27,.741,91,2015-02-11,GSW,MIN
24,@,L 94-119 ,240,35,97,.361,28,70,.400,7,27,.259,17,20,.850,94,48,92,.522,40,72,.556,8,20,.400,15,23,.652,119,2015-02-22,DEN,OKC
25,@,L 94-115 ,240,34,82,.415,32,61,.525,2,21,.095,24,31,.774,94,42,83,.506,28,52,.538,14,31,.452,17,20,.850,115,2015-02-25,NYK,BOS
26,Home,L 94-104 ,240,35,82,.427,26,54,.481,9,28,.321,15,18,.833,94,40,77,.519,30,54,.556,10,23,.435,14,23,.609,104,2015-02-28,DAL,BRK
27,Home,W 94-74 ,240,36,88,.409,33,70,.471,3,18,.167,19,25,.760,94,29,84,.345,24,60,.400,5,24,.208,11,17,.647,74,2015-03-01,IND,PHI
28,@,L 94-100 ,240,38,88,.432,31,70,.443,7,18,.389,11,17,.647,94,32,79,.405,29,63,.460,3,16,.188,33,43,.767,100,2015-03-04,LAL,MIA
29,Home,W 94-75 ,240,34,82,.415,27,60,.450,7,22,.318,19,21,.905,94,33,88,.375,31,72,.431,2,16,.125,7,8,.875,75,2015-03-05,POR,DAL
30,@,L 94-103 ,240,37,91,.407,30,69,.435,7,22,.318,13,15,.867,94,40,85,.471,35,65,.538,5,20,.250,18,20,.900,103,2015-03-06,TOR,CHO
31,Home,L 94-127 ,240,33,81,.407,28,61,.459,5,20,.250,23,33,.697,94,44,87,.506,29,55,.527,15,32,.469,24,29,.828,127,2015-03-10,DAL,CLE
32,Home,L 94-101 ,240,38,90,.422,33,72,.458,5,18,.278,13,21,.619,94,36,77,.468,27,59,.458,9,18,.500,20,26,.769,101,2015-03-12,LAL,NYK
33,@,L 94-125 ,240,38,96,.396,29,71,.408,9,25,.360,9,16,.563,94,45,90,.500,26,56,.464,19,34,.559,16,17,.941,125,2015-03-14,NYK,GSW
34,@,W 94-87 ,240,37,84,.440,35,67,.522,2,17,.118,18,26,.692,94,35,94,.372,27,57,.474,8,37,.216,9,14,.643,87,2015-03-14,BRK,PHI
35,Home,W 94-66 ,240,33,78,.423,18,54,.333,15,24,.625,13,19,.684,94,23,78,.295,18,59,.305,5,19,.263,15,18,.833,66,2015-03-16,UTA,CHO
36,@,L 94-107 ,240,38,89,.427,32,67,.478,6,22,.273,12,17,.706,94,39,78,.500,28,51,.549,11,27,.407,18,27,.667,107,2015-03-17,ORL,HOU
37,Home,W 94-83 ,240,36,84,.429,25,57,.439,11,27,.407,11,18,.611,94,29,88,.330,21,62,.339,8,26,.308,17,19,.895,83,2015-03-18,PHI,DET
38,@,L 94-101 ,240,36,85,.424,28,57,.491,8,28,.286,14,18,.778,94,42,87,.483,35,65,.538,7,22,.318,10,13,.769,101,2015-03-24,SAS,DAL
39,Home,W 94-76 ,240,37,84,.440,28,58,.483,9,26,.346,11,14,.786,94,31,82,.378,27,64,.422,4,18,.222,10,15,.667,76,2015-03-27,SAS,DAL
40,Home,W 94-83 ,240,36,75,.480,29,57,.509,7,18,.389,15,21,.714,94,29,84,.345,25,67,.373,4,17,.235,21,29,.724,83,2015-03-27,TOR,LAL
41,Home,W 94-89 ,240,32,84,.381,26,55,.473,6,29,.207,24,35,.686,94,31,73,.425,25,57,.439,6,16,.375,21,32,.656,89,2015-03-28,UTA,OKC
42,@,L 94-99 ,240,34,76,.447,23,49,.469,11,27,.407,15,21,.714,94,35,83,.422,19,46,.413,16,37,.432,13,22,.591,99,2015-04-05,CHI,CLE
43,Home,W 94-86 ,240,35,88,.398,29,61,.475,6,27,.222,18,22,.818,94,34,77,.442,32,68,.471,2,9,.222,16,24,.667,86,2015-04-11,LAC,MEM
44,Home,L 94-106 ,240,37,82,.451,29,55,.527,8,27,.296,12,15,.800,94,37,96,.385,25,67,.373,12,29,.414,20,26,.769,106,2015-10-27,ATL,DET
45,@,L 94-104 ,240,33,84,.393,27,60,.450,6,24,.250,22,29,.759,94,36,73,.493,24,53,.453,12,20,.600,20,21,.952,104,2015-10-28,CHO,MIA
46,@,L 94-112 ,240,36,91,.396,25,58,.431,11,33,.333,11,18,.611,94,44,88,.500,32,56,.571,12,32,.375,12,14,.857,112,2015-10-28,NOP,POR
47,@,L 94-97 ,240,36,88,.409,24,58,.414,12,30,.400,10,13,.769,94,36,83,.434,28,60,.467,8,23,.348,17,22,.773,97,2015-10-30,CHO,ATL
48,@,L 94-98 (OT),265,34,84,.405,27,62,.435,7,22,.318,19,26,.731,94,39,104,.375,33,76,.434,6,28,.214,14,28,.500,98,2015-10-30,CHI,DET
49,@,W 94-92 ,240,37,88,.420,30,59,.508,7,29,.241,13,14,.929,94,32,86,.372,18,49,.367,14,37,.378,14,15,.933,92,2015-11-01,ATL,CHO
50,@,W 94-84 ,240,39,79,.494,35,66,.530,4,13,.308,12,17,.706,94,32,89,.360,28,76,.368,4,13,.308,16,21,.762,84,2015-11-02,SAS,NYK
51,@,W 94-82 ,240,38,88,.432,31,65,.477,7,23,.304,11,12,.917,94,33,86,.384,28,64,.438,5,22,.227,11,17,.647,82,2015-11-03,IND,DET
52,Home,L 94-103 ,240,32,90,.356,20,54,.370,12,36,.333,18,25,.720,94,42,90,.467,35,72,.486,7,18,.389,12,12,1.000,103,2015-11-03,NOP,ORL
53,Home,L 94-108 ,240,32,82,.390,26,53,.491,6,29,.207,24,27,.889,94,44,89,.494,38,62,.613,6,27,.222,14,17,.824,108,2015-11-05,DAL,CHO
54,Home,W 94-86 ,240,37,82,.451,29,62,.468,8,20,.400,12,16,.750,94,34,82,.415,31,73,.425,3,9,.333,15,19,.789,86,2015-11-07,MIL,BRK
55,Home,L 94-103 ,240,38,87,.437,32,68,.471,6,19,.316,12,16,.750,94,38,92,.413,30,53,.566,8,39,.205,19,22,.864,103,2015-11-07,SAC,GSW
56,@,L 94-114 ,240,34,73,.466,28,54,.519,6,19,.316,20,31,.645,94,45,81,.556,36,60,.600,9,21,.429,15,23,.652,114,2015-11-07,CHO,SAS
57,Home,W 94-92 ,240,28,68,.412,23,49,.469,5,19,.263,33,37,.892,94,35,80,.438,33,69,.478,2,11,.182,20,29,.690,92,2015-11-09,LAC,MEM
58,@,L 94-106 ,240,35,89,.393,30,68,.441,5,21,.238,19,21,.905,94,41,83,.494,32,52,.615,9,31,.290,15,19,.789,106,2015-11-15,POR,CHO
59,@,L 94-102 ,240,36,82,.439,31,62,.500,5,20,.250,17,25,.680,94,36,89,.404,26,69,.377,10,20,.500,20,21,.952,102,2015-11-17,CHO,NYK
60,@,L 94-106 ,240,35,88,.398,28,66,.424,7,22,.318,17,23,.739,94,39,79,.494,29,50,.580,10,29,.345,18,24,.750,106,2015-11-20,CHI,GSW
61,Home,L 94-111 ,240,31,78,.397,23,53,.434,8,25,.320,24,29,.828,94,37,79,.468,29,59,.492,8,20,.400,29,47,.617,111,2015-11-24,DEN,LAC
62,Home,W 94-91 ,240,41,84,.488,37,71,.521,4,13,.308,8,12,.667,94,33,75,.440,23,47,.489,10,28,.357,15,22,.682,91,2015-12-01,BRK,PHO
63,Home,L 94-103 ,240,31,72,.431,17,39,.436,14,33,.424,18,24,.750,94,40,89,.449,32,66,.485,8,23,.348,15,15,1.000,103,2015-12-03,UTA,ORL
64,@,L 94-97 ,240,34,76,.447,27,51,.529,7,25,.280,19,24,.792,94,37,64,.578,34,54,.630,3,10,.300,20,22,.909,97,2015-12-09,SAS,TOR
65,@,L 94-107 ,240,35,78,.449,25,50,.500,10,28,.357,14,23,.609,94,39,80,.488,30,63,.476,9,17,.529,20,26,.769,107,2015-12-10,ATL,OKC
66,@,W 94-90 ,240,37,79,.468,31,62,.500,6,17,.353,14,16,.875,94,33,78,.423,25,50,.500,8,28,.286,16,24,.667,90,2015-12-11,OKC,UTA
67,@,L 94-98 ,240,40,89,.449,34,73,.466,6,16,.375,8,11,.727,94,33,78,.423,25,58,.431,8,20,.400,24,29,.828,98,2015-12-12,NOP,CHI
68,@,L 94-104 ,240,33,80,.413,24,55,.436,9,25,.360,19,27,.704,94,38,77,.494,26,45,.578,12,32,.375,16,21,.762,104,2015-12-14,PHO,DAL
69,Home,L 94-104 ,240,32,67,.478,25,47,.532,7,20,.350,23,29,.793,94,34,73,.466,24,52,.462,10,21,.476,26,28,.929,104,2015-12-16,UTA,NOP
70,Home,L 94-108 ,240,35,74,.473,26,49,.531,9,25,.360,15,17,.882,94,41,80,.513,33,59,.559,8,21,.381,18,22,.818,108,2015-12-18,MIA,TOR
71,@,L 94-102 ,240,32,73,.438,21,41,.512,11,32,.344,19,26,.731,94,39,84,.464,37,69,.536,2,15,.133,22,31,.710,102,2015-12-18,POR,ORL
72,Home,L 94-104 ,240,35,94,.372,27,65,.415,8,29,.276,16,17,.941,94,40,76,.526,31,55,.564,9,21,.429,15,24,.625,104,2015-12-20,TOR,SAC
73,@,W 94-84 ,240,38,85,.447,28,59,.475,10,26,.385,8,11,.727,94,32,77,.416,25,54,.463,7,23,.304,13,25,.520,84,2015-12-25,LAC,LAL
74,Home,W 94-88 (OT),265,35,88,.398,29,62,.468,6,26,.231,18,27,.667,94,36,90,.400,30,70,.429,6,20,.300,10,11,.909,88,2015-12-25,MIA,NOP
75,Home,L 94-98 ,240,30,76,.395,21,52,.404,9,24,.375,25,31,.806,94,38,92,.413,28,59,.475,10,33,.303,12,16,.750,98,2015-12-27,SAC,POR
76,Home,W 94-80 ,240,36,77,.468,31,67,.463,5,10,.500,17,27,.630,94,28,80,.350,18,41,.439,10,39,.256,14,20,.700,80,2015-12-30,MIN,UTA
77,Home,W 94-91 ,240,28,82,.341,22,58,.379,6,24,.250,32,39,.821,94,35,87,.402,27,65,.415,8,22,.364,13,17,.765,91,2015-12-30,TOR,WAS
78,@,L 94-104 ,240,34,85,.400,24,53,.453,10,32,.313,16,18,.889,94,36,91,.396,21,58,.362,15,33,.455,17,18,.944,104,2016-01-01,CHO,TOR
79,Home,W 94-82 ,240,33,73,.452,26,55,.473,7,18,.389,21,29,.724,94,33,93,.355,30,73,.411,3,20,.150,13,23,.565,82,2016-01-02,IND,DET
80,Home,L 94-103 ,240,32,85,.376,26,57,.456,6,28,.214,24,27,.889,94,41,92,.446,35,71,.493,6,21,.286,15,19,.789,103,2016-01-04,BRK,BOS
81,Home,L 94-99 ,240,34,91,.374,28,63,.444,6,28,.214,20,27,.741,94,33,74,.446,23,47,.489,10,27,.370,23,36,.639,99,2016-01-06,BOS,DET
82,@,L 94-112 ,240,35,90,.389,28,69,.406,7,21,.333,17,24,.708,94,38,83,.458,30,66,.455,8,17,.471,28,33,.848,112,2016-01-06,MEM,OKC
83,@,L 94-103 ,240,38,78,.487,31,50,.620,7,28,.250,11,17,.647,94,39,75,.520,32,52,.615,7,23,.304,18,26,.692,103,2016-01-07,UTA,HOU
84,@,L 94-103 ,240,37,91,.407,32,61,.525,5,30,.167,15,20,.750,94,40,90,.444,31,64,.484,9,26,.346,14,20,.700,103,2016-01-13,IND,BOS
85,Home,L 94-97 ,240,28,81,.346,17,46,.370,11,35,.314,27,29,.931,94,34,83,.410,30,63,.476,4,20,.200,25,34,.735,97,2016-01-19,PHO,IND
86,Home,L 94-125 ,240,37,100,.370,36,80,.450,1,20,.050,19,24,.792,94,50,95,.526,38,63,.603,12,32,.375,13,20,.650,125,2016-01-20,CHI,GSW
87,@,L 94-106 (OT),265,40,91,.440,35,68,.515,5,23,.217,9,11,.818,94,42,97,.433,37,72,.514,5,25,.200,17,22,.773,106,2016-01-20,MIN,DAL
88,@,L 94-112 ,240,34,76,.447,26,50,.520,8,26,.308,18,30,.600,94,41,83,.494,29,61,.475,12,22,.545,18,26,.692,112,2016-01-24,LAC,TOR
89,@,L 94-113 ,240,32,79,.405,25,59,.424,7,20,.350,23,29,.793,94,43,86,.500,33,62,.532,10,24,.417,17,21,.810,113,2016-01-29,ORL,BOS
90,@,L 94-106 ,240,37,87,.425,28,61,.459,9,26,.346,11,14,.786,94,44,84,.524,38,62,.613,6,22,.273,12,20,.600,106,2016-02-05,PHI,WAS
91,@,L 94-96 ,240,35,91,.385,22,63,.349,13,28,.464,11,15,.733,94,39,85,.459,32,60,.533,7,25,.280,11,12,.917,96,2016-02-07,ATL,ORL
92,@,L 94-114 ,240,40,99,.404,37,77,.481,3,22,.136,11,21,.524,94,47,96,.490,45,83,.542,2,13,.154,18,28,.643,114,2016-02-20,WAS,MIA
93,Home,L 94-103 ,240,35,82,.427,27,57,.474,8,25,.320,16,21,.762,94,40,94,.426,33,71,.465,7,23,.304,16,17,.941,103,2016-02-26,PHI,WAS
94,Home,L 94-104 ,240,35,84,.417,27,59,.458,8,25,.320,16,22,.727,94,37,76,.487,29,57,.509,8,19,.421,22,28,.786,104,2016-02-27,HOU,SAS
95,@,L 94-104 ,240,37,83,.446,27,57,.474,10,26,.385,10,16,.625,94,40,80,.500,34,58,.586,6,22,.273,18,21,.857,104,2016-03-02,UTA,TOR
96,@,W 94-86 ,240,36,81,.444,28,60,.467,8,21,.381,14,15,.933,94,35,89,.393,27,65,.415,8,24,.333,8,8,1.000,86,2016-03-03,SAS,NOP
97,Home,W 94-88 ,240,37,81,.457,33,63,.524,4,18,.222,16,19,.842,94,32,75,.427,27,56,.482,5,19,.263,19,29,.655,88,2016-03-04,MEM,UTA
98,Home,L 94-106 ,240,38,92,.413,29,73,.397,9,19,.474,9,11,.818,94,37,78,.474,31,58,.534,6,20,.300,26,27,.963,106,2016-03-05,NOP,UTA
99,@,L 94-104 ,240,37,81,.457,31,65,.477,6,16,.375,14,21,.667,94,40,81,.494,32,58,.552,8,23,.348,16,19,.842,104,2016-03-05,SAC,SAS
0,@,L 94-110 ,240,33,75,.440,27,57,.474,6,18,.333,22,26,.846,94,45,99,.455,39,78,.500,6,21,.286,14,19,.737,110,2016-03-08,NYK,DEN
1,@,L 94-115 ,240,32,79,.405,24,59,.407,8,20,.400,22,31,.710,94,48,84,.571,35,54,.648,13,30,.433,6,10,.600,115,2016-03-09,UTA,GSW
2,@,L 94-101 ,240,34,83,.410,30,63,.476,4,20,.200,22,25,.880,94,38,85,.447,25,56,.446,13,29,.448,12,16,.750,101,2016-03-11,NYK,LAC
3,@,L 94-128 ,240,31,91,.341,24,64,.375,7,27,.259,25,27,.926,94,49,83,.590,40,66,.606,9,17,.529,21,26,.808,128,2016-03-14,POR,OKC
4,Home,W 94-85 ,240,35,71,.493,23,44,.523,12,27,.444,12,14,.857,94,35,88,.398,25,45,.556,10,43,.233,5,8,.625,85,2016-03-14,UTA,CLE
5,Home,L 94-101 (OT),265,35,91,.385,27,63,.429,8,28,.286,16,23,.696,94,32,88,.364,25,66,.379,7,22,.318,30,38,.789,101,2016-03-17,IND,TOR
6,Home,L 94-99 ,240,35,91,.385,29,58,.500,6,33,.182,18,26,.692,94,40,90,.444,34,63,.540,6,27,.222,13,19,.684,99,2016-03-17,PHI,WAS
7,@,W 94-85 ,240,34,83,.410,21,45,.467,13,38,.342,13,14,.929,94,34,65,.523,31,57,.544,3,8,.375,14,17,.824,85,2016-03-20,UTA,MIL
8,@,L 94-96 ,240,32,80,.400,26,56,.464,6,24,.250,24,32,.750,94,37,82,.451,33,63,.524,4,19,.211,18,28,.643,96,2016-03-24,POR,LAC
9,@,L 94-106 ,240,37,89,.416,31,64,.484,6,25,.240,14,18,.778,94,39,76,.513,26,46,.565,13,30,.433,15,16,.938,106,2016-03-24,CHI,NYK
10,@,L 94-116 ,240,35,94,.372,26,62,.419,9,32,.281,15,23,.652,94,40,90,.444,33,68,.485,7,22,.318,29,39,.744,116,2016-03-25,PHO,SAC
11,@,L 94-102 ,240,36,86,.419,31,63,.492,5,23,.217,17,27,.630,94,38,87,.437,27,62,.435,11,25,.440,15,23,.652,102,2016-03-29,WAS,GSW
12,@,L 94-105 ,240,38,84,.452,33,60,.550,5,24,.208,13,17,.765,94,37,77,.481,31,62,.500,6,15,.400,25,34,.735,105,2016-03-30,PHO,MIL
13,Home,L 94-114 ,240,36,86,.419,29,67,.433,7,19,.368,15,21,.714,94,48,90,.533,43,74,.581,5,16,.313,13,18,.722,114,2016-03-31,IND,ORL
14,@,W 94-90 ,240,32,76,.421,22,56,.393,10,20,.500,20,34,.588,94,34,88,.386,25,63,.397,9,25,.360,13,15,.867,90,2016-04-02,DET,CHI
15,@,L 94-109 ,240,39,87,.448,31,57,.544,8,30,.267,8,15,.533,94,40,83,.482,29,54,.537,11,29,.379,18,20,.900,109,2016-04-11,ATL,CLE
16,Home,L 94-113 ,240,36,77,.468,32,61,.525,4,16,.250,18,27,.667,94,44,86,.512,38,65,.585,6,21,.286,19,26,.731,113,2016-10-26,PHO,SAC
17,Home,L 94-102 ,240,28,70,.400,22,50,.440,6,20,.300,32,38,.842,94,36,79,.456,30,61,.492,6,18,.333,24,27,.889,102,2016-10-27,SAC,SAS
18,@,L 94-103 ,240,37,98,.378,30,74,.405,7,24,.292,13,20,.650,94,38,87,.437,28,54,.519,10,33,.303,17,20,.850,103,2016-10-28,IND,BRK
19,@,W 94-91 ,240,33,79,.418,21,47,.447,12,32,.375,16,22,.727,94,35,90,.389,31,74,.419,4,16,.250,17,18,.944,91,2016-10-28,CLE,TOR
20,@,L 94-102 ,240,38,80,.475,31,62,.500,7,18,.389,11,17,.647,94,38,84,.452,28,54,.519,10,30,.333,16,23,.696,102,2016-11-03,SAC,ORL
21,@,L 94-111 ,240,34,79,.430,28,61,.459,6,18,.333,20,25,.800,94,46,86,.535,34,60,.567,12,26,.462,7,12,.583,111,2016-11-05,CHI,IND
22,Home,L 94-100 ,240,31,81,.383,25,55,.455,6,26,.231,26,32,.813,94,32,71,.451,18,38,.474,14,33,.424,22,27,.815,100,2016-11-06,MEM,POR
23,@,L 94-102 ,240,38,84,.452,33,63,.524,5,21,.238,13,18,.722,94,39,81,.481,31,56,.554,8,25,.320,16,20,.800,102,2016-11-08,NOP,SAC
24,Home,L 94-105 ,240,38,87,.437,35,72,.486,3,15,.200,15,19,.789,94,36,86,.419,22,53,.415,14,33,.424,19,26,.731,105,2016-11-11,WAS,CLE
25,Home,W 94-90 ,240,33,82,.402,25,67,.373,8,15,.533,20,27,.741,94,37,84,.440,33,69,.478,4,15,.267,12,21,.571,90,2016-11-14,SAS,MIA
26,@,W 94-92 ,240,33,82,.402,21,51,.412,12,31,.387,16,17,.941,94,37,86,.430,30,66,.455,7,20,.350,11,16,.688,92,2016-11-19,BOS,DET
27,@,L 94-104 ,240,34,85,.400,28,64,.438,6,21,.286,20,29,.690,94,42,88,.477,32,61,.525,10,27,.370,10,14,.714,104,2016-11-20,ATL,NYK
28,@,L 94-101 ,240,34,88,.386,27,57,.474,7,31,.226,19,28,.679,94,37,78,.474,26,52,.500,11,26,.423,16,20,.800,101,2016-11-21,MIA,PHI
29,Home,L 94-112 ,240,39,85,.459,29,56,.518,10,29,.345,6,10,.600,94,45,86,.523,34,61,.557,11,25,.440,11,12,.917,112,2016-11-22,ATL,NOP
30,@,W 94-91 ,240,40,88,.455,34,59,.576,6,29,.207,8,10,.800,94,35,80,.438,28,57,.491,7,23,.304,14,20,.700,91,2016-11-25,WAS,ORL
31,@,L 94-109 ,240,39,88,.443,27,53,.509,12,35,.343,4,10,.400,94,42,95,.442,34,75,.453,8,20,.400,17,20,.850,109,2016-11-27,ATL,LAL
32,@,W 94-87 ,240,33,71,.465,22,52,.423,11,19,.579,17,24,.708,94,33,77,.429,23,47,.489,10,30,.333,11,14,.786,87,2016-11-30,SAS,DAL
33,Home,L 94-113 ,240,28,69,.406,19,45,.422,9,24,.375,29,39,.744,94,42,89,.472,29,58,.500,13,31,.419,16,24,.667,113,2016-12-01,CLE,LAC
34,@,L 94-95 ,240,33,74,.446,27,50,.540,6,24,.250,22,31,.710,94,33,79,.418,26,61,.426,7,18,.389,22,28,.786,95,2016-12-01,ORL,MEM
35,Home,L 94-126 ,240,35,87,.402,24,56,.429,11,31,.355,13,15,.867,94,39,80,.488,17,40,.425,22,40,.550,26,31,.839,126,2016-12-07,NYK,CLE
36,Home,L 94-109 ,240,34,85,.400,25,52,.481,9,33,.273,17,18,.944,94,35,78,.449,28,55,.509,7,23,.304,32,41,.780,109,2016-12-07,PHO,IND
37,Home,L 94-101 ,240,31,83,.373,14,41,.341,17,42,.405,15,22,.682,94,34,82,.415,25,62,.403,9,20,.450,24,27,.889,101,2016-12-09,BOS,TOR
38,@,L 94-110 ,240,28,84,.333,18,58,.310,10,26,.385,28,32,.875,94,43,88,.489,26,52,.500,17,36,.472,7,10,.700,110,2016-12-12,CHO,IND
39,Home,L 94-99 ,240,38,87,.437,34,72,.472,4,15,.267,14,19,.737,94,38,86,.442,32,65,.492,6,21,.286,17,22,.773,99,2016-12-13,CHI,MIN
40,@,W 94-93 ,240,34,74,.459,24,53,.453,10,21,.476,16,24,.667,94,33,74,.446,24,47,.511,9,27,.333,18,22,.818,93,2016-12-21,SAC,UTA
41,Home,L 94-106 ,240,36,82,.439,29,59,.492,7,23,.304,15,21,.714,94,42,82,.512,37,63,.587,5,19,.263,17,25,.680,106,2016-12-27,MIA,OKC
42,Home,L 94-119 ,240,39,88,.443,33,64,.516,6,24,.250,10,16,.625,94,48,84,.571,37,62,.597,11,22,.500,12,16,.750,119,2016-12-28,DET,MIL
43,@,L 94-110 ,240,35,77,.455,29,57,.509,6,20,.300,18,21,.857,94,39,78,.500,28,56,.500,11,22,.500,21,25,.840,110,2016-12-30,POR,SAS
44,@,L 94-98 ,240,36,78,.462,27,51,.529,9,27,.333,13,19,.684,94,38,79,.481,31,60,.517,7,19,.368,15,24,.625,98,2017-01-02,OKC,MIL
45,Home,L 94-106 ,240,34,83,.410,26,58,.448,8,25,.320,18,24,.750,94,41,85,.482,28,55,.509,13,30,.433,11,15,.733,106,2017-01-04,CLE,CHI
46,Home,L 94-99 ,240,34,93,.366,19,58,.328,15,35,.429,11,14,.786,94,38,90,.422,29,67,.433,9,23,.391,14,17,.824,99,2017-01-05,NOP,ATL
47,@,W 94-92 ,240,32,77,.416,24,54,.444,8,23,.348,22,28,.786,94,35,80,.438,28,60,.467,7,20,.350,15,21,.714,92,2017-01-07,UTA,MIN
48,Home,L 94-109 ,240,34,83,.410,27,64,.422,7,19,.368,19,22,.864,94,47,83,.566,40,59,.678,7,24,.292,8,11,.727,109,2017-01-09,CHI,OKC
49,@,L 94-100 ,240,36,82,.439,24,55,.436,12,27,.444,10,16,.625,94,32,73,.438,19,50,.380,13,23,.565,23,29,.793,100,2017-01-10,DET,SAC
50,@,L 94-134 ,240,35,85,.412,29,65,.446,6,20,.300,18,25,.720,94,49,81,.605,39,60,.650,10,21,.476,26,29,.897,134,2017-01-12,LAL,SAS
51,Home,W 94-89 ,240,31,69,.449,23,45,.511,8,24,.333,24,32,.750,94,34,86,.395,28,62,.452,6,24,.250,15,23,.652,89,2017-01-18,PHI,TOR
52,Home,L 94-107 ,240,38,84,.452,28,52,.538,10,32,.313,8,15,.533,94,45,89,.506,35,68,.515,10,21,.476,7,10,.700,107,2017-01-29,NOP,WAS
53,@,L 94-108 ,240,30,85,.353,23,57,.404,7,28,.250,27,32,.844,94,37,86,.430,30,65,.462,7,21,.333,27,38,.711,108,2017-01-31,OKC,SAS
54,@,L 94-102 ,240,34,87,.391,24,59,.407,10,28,.357,16,21,.762,94,37,80,.463,32,66,.485,5,14,.357,23,32,.719,102,2017-02-03,TOR,ORL
55,Home,L 94-127 ,240,35,77,.455,30,53,.566,5,24,.208,19,25,.760,94,48,88,.545,34,56,.607,14,32,.438,17,21,.810,127,2017-02-08,NOP,UTA
56,Home,W 94-90 ,240,34,68,.500,25,54,.463,9,14,.643,17,21,.810,94,33,91,.363,27,62,.435,6,29,.207,18,22,.818,90,2017-02-12,NYK,SAS
57,@,L 94-105 ,240,35,77,.455,30,57,.526,5,20,.250,19,24,.792,94,35,73,.479,28,56,.500,7,17,.412,28,35,.800,105,2017-02-14,TOR,CHI
58,Home,W 94-87 ,240,36,82,.439,31,63,.492,5,19,.263,17,21,.810,94,34,88,.386,28,58,.483,6,30,.200,13,14,.929,87,2017-03-02,CHI,GSW
59,@,L 94-101 ,240,35,75,.467,28,54,.519,7,21,.333,17,20,.850,94,38,87,.437,32,60,.533,6,27,.222,19,23,.826,101,2017-03-04,TOR,MIL
60,@,W 94-87 ,240,36,76,.474,28,55,.509,8,21,.381,14,23,.609,94,34,80,.425,25,51,.490,9,29,.310,10,13,.769,87,2017-03-08,TOR,NOP
61,Home,L 93-115 ,240,32,76,.421,24,49,.490,8,27,.296,21,27,.778,93,39,79,.494,29,52,.558,10,27,.370,27,34,.794,115,2011-12-26,DAL,DEN
62,@,L 93-113 ,240,34,79,.430,23,50,.460,11,29,.379,14,18,.778,93,45,80,.563,45,75,.600,0,5,.000,23,33,.697,113,2011-12-30,HOU,MEM
63,@,W 93-78 ,240,33,78,.423,26,55,.473,7,23,.304,20,22,.909,93,26,90,.289,23,76,.303,3,14,.214,23,28,.821,78,2011-12-30,PHO,NOH
64,Home,W 93-88 ,240,36,75,.480,30,51,.588,6,24,.250,15,24,.625,93,33,78,.423,29,63,.460,4,15,.267,18,22,.818,88,2012-01-01,LAC,POR
65,Home,L 93-103 ,240,36,83,.434,31,63,.492,5,20,.250,16,21,.762,93,34,76,.447,28,61,.459,6,15,.400,29,36,.806,103,2012-01-03,OKC,POR
66,Home,L 93-101 ,240,35,79,.443,32,69,.464,3,10,.300,20,25,.800,93,41,86,.477,37,70,.529,4,16,.250,15,18,.833,101,2012-01-04,NOH,PHI
67,Home,W 93-71 ,240,34,86,.395,18,53,.340,16,33,.485,9,16,.563,93,27,77,.351,26,58,.448,1,19,.053,16,21,.762,71,2012-01-05,SAS,DAL
68,@,L 93-109 ,240,37,86,.430,34,71,.479,3,15,.200,16,24,.667,93,43,77,.558,33,55,.600,10,22,.455,13,17,.765,109,2012-01-08,MIL,PHO
69,@,W 93-72 ,240,36,80,.450,26,54,.481,10,26,.385,11,15,.733,93,30,87,.345,27,77,.351,3,10,.300,9,16,.563,72,2012-01-08,MIN,WAS
70,Home,W 93-78 ,240,40,82,.488,36,69,.522,4,13,.308,9,17,.529,93,30,76,.395,26,56,.464,4,20,.200,14,17,.824,78,2012-01-10,WAS,TOR
71,@,L 93-102 ,240,33,74,.446,30,69,.435,3,5,.600,24,24,1.000,93,37,78,.474,26,56,.464,11,22,.500,17,17,1.000,102,2012-01-12,DET,MIL
72,Home,W 93-91 ,240,32,78,.410,25,57,.439,7,21,.333,22,27,.815,93,38,85,.447,34,64,.531,4,21,.190,11,12,.917,91,2012-01-14,ATL,MIN
73,Home,W 93-84 ,240,32,71,.451,27,58,.466,5,13,.385,24,31,.774,93,33,78,.423,30,66,.455,3,12,.250,15,22,.682,84,2012-01-16,ATL,TOR
74,Home,L 93-102 ,240,30,73,.411,25,53,.472,5,20,.250,28,33,.848,93,36,71,.507,19,36,.528,17,35,.486,13,22,.591,102,2012-01-16,NYK,ORL
75,Home,W 93-85 ,240,30,75,.400,22,52,.423,8,23,.348,25,34,.735,93,35,79,.443,30,68,.441,5,11,.455,10,21,.476,85,2012-01-18,MIN,DET
76,@,W 93-87 ,240,36,73,.493,30,59,.508,6,14,.429,15,17,.882,93,34,70,.486,29,58,.500,5,12,.417,14,16,.875,87,2012-01-18,MEM,NOH
77,Home,W 93-87 ,240,33,81,.407,25,56,.446,8,25,.320,19,29,.655,93,31,83,.373,25,63,.397,6,20,.300,19,22,.864,87,2012-01-23,DAL,PHO
78,@,L 93-101 ,240,34,83,.410,26,62,.419,8,21,.381,17,20,.850,93,41,79,.519,30,59,.508,11,20,.550,8,14,.571,101,2012-01-25,POR,GSW
79,Home,L 93-122 ,240,34,78,.436,25,58,.431,9,20,.450,16,22,.727,93,50,91,.549,48,78,.615,2,13,.154,20,25,.800,122,2012-01-25,SAC,DEN
80,Home,W 93-67 ,240,41,81,.506,36,67,.537,5,14,.357,6,16,.375,93,24,61,.393,18,40,.450,6,21,.286,13,21,.619,67,2012-01-27,NOH,ORL
81,@,L 93-96 ,240,37,80,.463,31,67,.463,6,13,.462,13,14,.929,93,35,79,.443,28,61,.459,7,18,.389,19,23,.826,96,2012-01-28,SAC,UTA
82,@,L 93-97 ,240,35,81,.432,32,70,.457,3,11,.273,20,28,.714,93,32,78,.410,29,70,.414,3,8,.375,30,40,.750,97,2012-01-29,CHI,MIA
83,Home,W 93-89 ,240,32,84,.381,29,72,.403,3,12,.250,26,38,.684,93,37,80,.463,32,60,.533,5,20,.250,10,13,.769,89,2012-01-30,UTA,POR
84,@,W 93-90 ,240,37,73,.507,32,59,.542,5,14,.357,14,19,.737,93,34,75,.453,27,58,.466,7,17,.412,15,21,.714,90,2012-01-31,BOS,CLE
85,Home,W 93-90 ,240,37,91,.407,29,67,.433,8,24,.333,11,13,.846,93,35,82,.427,29,66,.439,6,16,.375,14,19,.737,90,2012-01-31,GSW,SAC
86,Home,W 93-81 ,240,34,74,.459,30,55,.545,4,19,.211,21,27,.778,93,33,74,.446,30,66,.455,3,8,.375,12,16,.750,81,2012-02-02,SAS,NOH
87,@,W 93-89 ,240,37,78,.474,33,65,.508,4,13,.308,15,25,.600,93,33,75,.440,28,52,.538,5,23,.217,18,23,.783,89,2012-02-03,LAL,DEN
88,Home,L 93-107 ,240,38,83,.458,36,66,.545,2,17,.118,15,19,.789,93,37,81,.457,30,53,.566,7,28,.250,26,33,.788,107,2012-02-08,WAS,NYK
89,Home,W 93-83 ,240,35,73,.479,30,64,.469,5,9,.556,18,21,.857,93,30,78,.385,27,68,.397,3,10,.300,20,24,.833,83,2012-02-14,MEM,HOU
90,@,W 93-91 ,240,34,84,.405,24,62,.387,10,22,.455,15,17,.882,93,36,76,.474,29,57,.509,7,19,.368,12,16,.750,91,2012-02-15,POR,GSW
91,Home,W 93-88 ,240,32,81,.395,25,62,.403,7,19,.368,22,26,.846,93,35,75,.467,31,58,.534,4,17,.235,14,16,.875,88,2012-02-16,IND,NJN
92,Home,W 93-92 ,240,32,89,.360,25,67,.373,7,22,.318,22,30,.733,93,35,93,.376,31,74,.419,4,19,.211,18,25,.720,92,2012-02-19,CLE,SAC
93,@,L 93-97 ,240,38,79,.481,35,66,.530,3,13,.231,14,18,.778,93,35,74,.473,28,52,.538,7,22,.318,20,25,.800,97,2012-02-20,MEM,HOU
94,@,W 93-90 ,240,33,76,.434,25,54,.463,8,22,.364,19,25,.760,93,37,91,.407,32,69,.464,5,22,.227,11,13,.846,90,2012-02-20,ORL,MIL
95,@,L 93-101 ,240,33,91,.363,26,77,.338,7,14,.500,20,23,.870,93,36,80,.450,28,54,.519,8,26,.308,21,24,.875,101,2012-02-20,NOH,OKC
96,Home,W 93-87 ,240,36,78,.462,31,60,.517,5,18,.278,16,20,.800,93,33,82,.402,33,73,.452,0,9,.000,21,27,.778,87,2012-02-22,HOU,PHI
97,@,L 93-103 ,240,35,84,.417,33,72,.458,2,12,.167,21,27,.778,93,40,76,.526,37,69,.536,3,7,.429,20,28,.714,103,2012-02-22,DET,TOR
98,@,W 93-92 ,240,37,84,.440,30,59,.508,7,25,.280,12,14,.857,93,32,89,.360,24,64,.375,8,25,.320,20,28,.714,92,2012-02-28,NJN,DAL
99,Home,L 93-107 ,240,36,76,.474,31,60,.517,5,16,.313,16,19,.842,93,39,82,.476,33,71,.465,6,11,.545,23,29,.793,107,2012-03-01,POR,MIA
0,Home,W 93-83 ,240,35,71,.493,30,54,.556,5,17,.294,18,25,.720,93,33,88,.375,26,64,.406,7,24,.292,10,15,.667,83,2012-03-04,LAL,MIA
1,@,L 93-97 ,240,35,94,.372,28,75,.373,7,19,.368,16,23,.696,93,35,88,.398,28,68,.412,7,20,.350,20,23,.870,97,2012-03-05,PHI,MIL
2,Home,L 93-99 ,240,32,68,.471,29,61,.475,3,7,.429,26,37,.703,93,39,87,.448,38,80,.475,1,7,.143,20,24,.833,99,2012-03-07,CHA,UTA
3,Home,W 93-91 (OT),265,35,75,.467,32,62,.516,3,13,.231,20,31,.645,93,33,88,.375,26,71,.366,7,17,.412,18,25,.720,91,2012-03-10,MIA,IND
4,Home,L 93-97 ,240,34,79,.430,28,60,.467,6,19,.316,19,35,.543,93,36,70,.514,28,55,.509,8,15,.533,17,21,.810,97,2012-03-11,LAC,GSW
5,Home,L 93-97 ,240,34,80,.425,24,54,.444,10,26,.385,15,20,.750,93,35,74,.473,26,53,.491,9,21,.429,18,23,.783,97,2012-03-19,GSW,MIN
6,Home,L 93-109 ,240,35,82,.427,27,56,.482,8,26,.308,15,22,.682,93,45,77,.584,36,59,.610,9,18,.500,10,13,.769,109,2012-03-21,DAL,LAL
7,@,L 93-103 ,240,38,79,.481,34,67,.507,4,12,.333,13,19,.684,93,39,83,.470,28,60,.467,11,23,.478,14,21,.667,103,2012-03-21,PHO,ORL
8,@,L 93-97 ,240,37,81,.457,34,73,.466,3,8,.375,16,23,.696,93,31,73,.425,21,48,.438,10,25,.400,25,25,1.000,97,2012-03-22,MEM,POR
9,Home,W 93-84 ,240,36,77,.468,29,56,.518,7,21,.333,14,20,.700,93,32,80,.400,26,55,.473,6,25,.240,14,21,.667,84,2012-03-23,ATL,NJN
10,Home,W 93-80 ,240,37,79,.468,25,44,.568,12,35,.343,7,12,.583,93,31,82,.378,27,64,.422,4,18,.222,14,21,.667,80,2012-03-23,ORL,CLE
11,Home,W 93-76 ,240,37,81,.457,30,53,.566,7,28,.250,12,18,.667,93,35,85,.412,34,76,.447,1,9,.111,5,11,.455,76,2012-03-25,SAS,PHI
12,Home,W 93-86 ,240,34,80,.425,34,69,.493,0,11,.000,25,28,.893,93,33,85,.388,24,56,.429,9,29,.310,11,13,.846,86,2012-03-27,MEM,MIN
13,Home,W 93-89 ,240,31,79,.392,25,63,.397,6,16,.375,25,32,.781,93,33,78,.423,26,56,.464,7,22,.318,16,25,.640,89,2012-03-29,IND,WAS
14,Home,L 93-102 ,240,35,84,.417,31,73,.425,4,11,.364,19,23,.826,93,42,91,.462,37,79,.468,5,12,.417,13,17,.765,102,2012-03-29,LAL,OKC
15,@,L 93-99 ,240,33,71,.465,26,58,.448,7,13,.538,20,21,.952,93,39,80,.488,27,52,.519,12,28,.429,9,13,.692,99,2012-03-29,NOH,POR
16,Home,L 93-99 ,240,40,83,.482,35,66,.530,5,17,.294,8,17,.471,93,42,89,.472,38,76,.500,4,13,.308,11,14,.786,99,2012-04-02,CHI,HOU
17,@,L 93-99 ,240,38,83,.458,35,73,.479,3,10,.300,14,17,.824,93,35,75,.467,32,62,.516,3,13,.231,26,32,.813,99,2012-04-03,PHI,MIA
18,@,L 93-120 ,240,36,79,.456,31,65,.477,5,14,.357,16,20,.800,93,47,83,.566,38,64,.594,9,19,.474,17,19,.895,120,2012-04-04,CHA,ATL
19,@,L 93-98 ,240,35,81,.432,30,64,.469,5,17,.294,18,20,.900,93,31,83,.373,21,59,.356,10,24,.417,26,29,.897,98,2012-04-04,OKC,MIA
20,Home,W 93-86 ,240,33,80,.413,28,64,.438,5,16,.313,22,26,.846,93,33,77,.429,28,64,.438,5,13,.385,15,18,.833,86,2012-04-05,CHI,BOS
21,@,W 93-85 ,240,36,80,.450,31,61,.508,5,19,.263,16,24,.667,93,35,84,.417,31,67,.463,4,17,.235,11,15,.733,85,2012-04-05,LAC,SAC
22,@,W 93-91 ,240,34,73,.466,29,63,.460,5,10,.500,20,26,.769,93,36,80,.450,27,65,.415,9,15,.600,10,10,1.000,91,2012-04-09,LAL,NOH
23,Home,W 93-85 ,240,39,78,.500,36,63,.571,3,15,.200,12,15,.800,93,34,93,.366,23,58,.397,11,35,.314,6,10,.600,85,2012-04-10,WAS,ORL
24,@,L 93-104 ,240,38,79,.481,31,55,.564,7,24,.292,10,14,.714,93,42,84,.500,38,70,.543,4,14,.286,16,19,.842,104,2012-04-11,PHO,MEM
25,@,W 93-75 ,240,41,77,.532,40,67,.597,1,10,.100,10,16,.625,93,29,80,.363,22,62,.355,7,18,.389,10,12,.833,75,2012-04-11,PHI,TOR
26,@,W 93-85 ,240,36,78,.462,32,61,.525,4,17,.235,17,21,.810,93,31,73,.425,22,43,.512,9,30,.300,14,23,.609,85,2012-04-15,MIA,NYK
27,Home,W 93-90 ,240,33,74,.446,24,50,.480,9,24,.375,18,24,.750,93,37,83,.446,32,67,.478,5,16,.313,11,17,.647,90,2012-04-19,PHO,LAC
28,Home,W 93-83 ,240,38,84,.452,29,64,.453,9,20,.450,8,12,.667,93,31,79,.392,27,64,.422,4,15,.267,17,19,.895,83,2012-04-21,CHI,DAL
29,Home,W 93-89 ,240,40,90,.444,36,73,.493,4,17,.235,9,10,.900,93,29,78,.372,23,54,.426,6,24,.250,25,31,.806,89,2012-04-21,MEM,POR
30,@,W 93-88 ,240,41,92,.446,36,76,.474,5,16,.313,6,10,.600,93,30,82,.366,23,56,.411,7,26,.269,21,21,1.000,88,2012-04-22,GSW,MIN
31,@,L 93-99 ,240,34,70,.486,23,45,.511,11,25,.440,14,25,.560,93,36,77,.468,27,53,.509,9,24,.375,18,24,.750,99,2012-04-25,LAC,NYK
32,Home,W 93-87 ,240,33,79,.418,31,70,.443,2,9,.222,25,33,.758,93,34,84,.405,28,67,.418,6,17,.353,13,16,.813,87,2012-10-31,CHI,SAC
33,@,L 93-99 ,240,36,86,.419,28,67,.418,8,19,.421,13,17,.765,93,40,84,.476,38,78,.487,2,6,.333,17,24,.708,99,2012-11-06,ORL,CHI
34,@,W 93-87 ,240,37,82,.451,30,64,.469,7,18,.389,12,21,.571,93,31,84,.369,23,51,.451,8,33,.242,17,23,.739,87,2012-11-07,DEN,HOU
35,Home,W 93-85 ,240,35,94,.372,29,75,.387,6,19,.316,17,23,.739,93,31,76,.408,22,49,.449,9,27,.333,14,15,.933,85,2012-11-09,MEM,HOU
36,@,W 93-83 ,240,34,73,.466,28,59,.475,6,14,.429,19,25,.760,93,30,79,.380,18,53,.340,12,26,.462,11,16,.688,83,2012-11-10,PHI,TOR
37,@,L 93-98 ,240,33,82,.402,26,67,.388,7,15,.467,20,28,.714,93,36,72,.500,32,62,.516,4,10,.400,22,29,.759,98,2012-11-14,UTA,BOS
38,Home,L 93-98 ,240,37,88,.420,31,68,.456,6,20,.300,13,19,.684,93,36,77,.468,23,50,.460,13,27,.481,13,16,.813,98,2012-11-15,DEN,MIA
39,@,L 93-99 ,240,36,81,.444,29,59,.492,7,22,.318,14,18,.778,93,40,87,.460,30,69,.435,10,18,.556,9,10,.900,99,2012-11-16,UTA,PHI
40,@,L 93-102 ,240,38,83,.458,32,60,.533,6,23,.261,11,15,.733,93,40,75,.533,33,60,.550,7,15,.467,15,19,.789,102,2012-11-21,BRK,GSW
41,Home,W 93-89 ,240,32,74,.432,25,55,.455,7,19,.368,22,31,.710,93,38,95,.400,36,79,.456,2,16,.125,11,19,.579,89,2012-11-21,HOU,CHI
42,@,L 93-104 ,240,32,75,.427,24,56,.429,8,19,.421,21,25,.840,93,38,75,.507,31,58,.534,7,17,.412,21,26,.808,104,2012-11-24,LAC,ATL
43,@,W 93-86 ,240,32,82,.390,28,66,.424,4,16,.250,25,26,.962,93,38,88,.432,35,71,.493,3,17,.176,7,10,.700,86,2012-11-24,CHI,MIL
44,@,W 93-92 ,240,39,85,.459,36,70,.514,3,15,.200,12,19,.632,93,35,80,.438,30,69,.435,5,11,.455,17,19,.895,92,2012-11-26,MIL,CHI
45,Home,W 93-88 ,240,38,81,.469,34,74,.459,4,7,.571,13,21,.619,93,36,82,.439,33,70,.471,3,12,.250,13,18,.722,88,2012-12-01,CHI,PHI
46,@,L 93-108 ,240,36,81,.444,33,68,.485,3,13,.231,18,32,.563,93,38,94,.404,32,80,.400,6,14,.429,26,32,.813,108,2012-12-07,CHA,MIL
47,Home,W 93-85 ,240,34,78,.436,27,65,.415,7,13,.538,18,18,1.000,93,27,84,.321,19,61,.311,8,23,.348,23,28,.821,85,2012-12-08,CHI,NYK
48,@,W 93-83 ,240,34,77,.442,27,60,.450,7,17,.412,18,25,.720,93,33,77,.429,27,61,.443,6,16,.375,11,18,.611,83,2012-12-08,ATL,MEM
49,@,L 93-104 ,240,38,82,.463,32,65,.492,6,17,.353,11,13,.846,93,37,76,.487,32,57,.561,5,19,.263,25,30,.833,104,2012-12-09,IND,OKC
50,@,L 93-99 ,240,35,89,.393,28,64,.438,7,25,.280,16,20,.800,93,34,76,.447,25,52,.481,9,24,.375,22,30,.733,99,2012-12-12,WAS,HOU
51,Home,L 93-115 ,240,31,84,.369,26,58,.448,5,26,.192,26,36,.722,93,49,99,.495,39,75,.520,10,24,.417,7,8,.875,115,2012-12-15,ATL,GSW
52,@,L 93-107 ,240,36,79,.456,30,59,.508,6,20,.300,15,21,.714,93,38,85,.447,34,71,.479,4,14,.286,27,30,.900,107,2012-12-17,SAS,OKC
53,@,L 93-102 ,240,39,96,.406,32,71,.451,7,25,.280,8,12,.667,93,44,82,.537,38,68,.559,6,14,.429,8,8,1.000,102,2012-12-17,MIN,ORL
54,@,L 93-98 ,240,32,80,.400,30,72,.417,2,8,.250,27,34,.794,93,37,86,.430,31,72,.431,6,14,.429,18,26,.692,98,2012-12-18,IND,MIL
55,Home,W 93-77 ,240,37,74,.500,33,54,.611,4,20,.200,15,19,.789,93,29,75,.387,27,56,.482,2,19,.105,17,22,.773,77,2012-12-19,LAC,NOH
56,@,L 93-99 ,240,33,82,.402,28,62,.452,5,20,.250,22,26,.846,93,37,84,.440,28,64,.438,9,20,.450,16,23,.696,99,2012-12-20,OKC,MIN
57,@,L 93-101 ,240,38,98,.388,38,76,.500,0,22,.000,17,24,.708,93,33,92,.359,19,56,.339,14,36,.389,21,26,.808,101,2012-12-20,DEN,POR
58,Home,W 93-90 ,240,33,81,.407,25,62,.403,8,19,.421,19,21,.905,93,35,70,.500,31,56,.554,4,14,.286,16,19,.842,90,2012-12-21,TOR,ORL
59,@,L 93-96 ,240,40,89,.449,35,70,.500,5,19,.263,8,11,.727,93,33,69,.478,26,49,.531,7,20,.350,23,28,.821,96,2012-12-22,PHO,POR
60,Home,L 93-97 ,240,38,76,.500,29,56,.518,9,20,.450,8,15,.533,93,36,83,.434,29,65,.446,7,18,.389,18,25,.720,97,2012-12-23,ORL,UTA
61,@,W 93-76 ,240,38,77,.494,32,67,.478,6,10,.600,11,13,.846,93,26,64,.406,19,44,.432,7,20,.350,17,29,.586,76,2012-12-25,BOS,BRK
62,@,L 93-108 ,240,34,88,.386,30,67,.448,4,21,.190,21,24,.875,93,40,84,.476,30,67,.448,10,17,.588,18,19,.947,108,2012-12-26,BRK,MIL
63,@,W 93-83 ,240,34,71,.479,26,53,.491,8,18,.444,17,22,.773,93,32,71,.451,24,49,.490,8,22,.364,11,16,.688,83,2013-01-02,MEM,BOS
64,Home,L 93-110 ,240,36,73,.493,28,54,.519,8,19,.421,13,17,.765,93,38,76,.500,29,59,.492,9,17,.529,25,29,.862,110,2013-01-02,OKC,BRK
65,@,L 93-113 ,240,36,90,.400,30,71,.423,6,19,.316,15,23,.652,93,44,85,.518,37,61,.607,7,24,.292,18,21,.857,113,2013-01-05,SAC,BRK
66,@,L 93-99 ,240,36,84,.429,30,66,.455,6,18,.333,15,18,.833,93,38,79,.481,28,55,.509,10,24,.417,13,21,.619,99,2013-01-09,DAL,LAC
67,Home,W 93-83 ,240,36,79,.456,34,68,.500,2,11,.182,19,27,.704,93,30,78,.385,23,54,.426,7,24,.292,16,25,.640,83,2013-01-12,WAS,ATL
68,@,L 93-113 ,240,39,95,.411,35,74,.473,4,21,.190,11,12,.917,93,40,69,.580,27,44,.614,13,25,.520,20,27,.741,113,2013-01-13,CLE,LAL
69,@,W 93-88 ,240,32,83,.386,28,66,.424,4,17,.235,25,32,.781,93,31,79,.392,22,50,.440,9,29,.310,17,26,.654,88,2013-01-16,CLE,POR
70,Home,L 93-98 ,240,35,85,.412,27,64,.422,8,21,.381,15,22,.682,93,41,86,.477,33,62,.532,8,24,.333,8,11,.727,98,2013-01-19,ATL,SAS
71,Home,L 93-97 ,240,31,72,.431,26,57,.456,5,15,.333,26,38,.684,93,37,81,.457,32,63,.508,5,18,.278,18,21,.857,97,2013-01-19,CHA,SAC
72,@,L 93-106 ,240,31,73,.425,24,56,.429,7,17,.412,24,32,.750,93,47,96,.490,43,83,.518,4,13,.308,8,10,.800,106,2013-01-23,LAL,MEM
73,Home,W 93-88 ,240,30,71,.423,25,55,.455,5,16,.313,28,37,.757,93,33,83,.398,27,65,.415,6,18,.333,16,26,.615,88,2013-01-24,PHO,LAC
74,@,L 93-121 ,240,37,88,.420,29,66,.439,8,22,.364,11,22,.500,93,47,89,.528,34,58,.586,13,31,.419,14,17,.824,121,2013-01-26,SAC,DEN
75,Home,W 93-85 ,240,35,78,.449,28,60,.467,7,18,.389,16,25,.640,93,32,81,.395,26,69,.377,6,12,.500,15,21,.714,85,2013-01-28,CHI,CHA
76,Home,W 93-92 ,240,36,75,.480,26,49,.531,10,26,.385,11,18,.611,93,33,85,.388,24,63,.381,9,22,.409,17,23,.739,92,2013-01-30,ATL,TOR
77,Home,W 93-89 ,240,39,75,.520,34,64,.531,5,11,.455,10,20,.500,93,34,78,.436,33,64,.516,1,14,.071,20,22,.909,89,2013-02-01,BRK,CHI
78,@,W 93-76 ,240,38,93,.409,30,73,.411,8,20,.400,9,13,.692,93,31,79,.392,25,60,.417,6,19,.316,8,15,.533,76,2013-02-02,CHI,ATL
79,@,L 93-113 ,240,35,86,.407,30,71,.423,5,15,.333,18,24,.750,93,45,89,.506,36,70,.514,9,19,.474,14,20,.700,113,2013-02-02,PHO,GSW
80,@,W 93-90 ,240,34,82,.415,28,66,.424,6,16,.375,19,25,.760,93,36,83,.434,33,66,.500,3,17,.176,15,21,.714,90,2013-02-06,BRK,DET
81,Home,W 93-84 ,240,39,75,.520,35,61,.574,4,14,.286,11,17,.647,93,35,78,.449,34,63,.540,1,15,.067,13,15,.867,84,2013-02-06,NOH,PHO
82,Home,L 93-100 ,240,38,89,.427,34,75,.453,4,14,.286,13,19,.684,93,36,80,.450,28,54,.519,8,26,.308,20,25,.800,100,2013-02-08,CHA,LAL
83,@,L 93-99 ,240,36,74,.486,30,57,.526,6,17,.353,15,20,.750,93,36,79,.456,28,59,.475,8,20,.400,19,23,.826,99,2013-02-08,GSW,MEM
84,@,W 93-89 ,240,36,79,.456,31,67,.463,5,12,.417,16,18,.889,93,37,78,.474,33,62,.532,4,16,.250,11,17,.647,89,2013-02-08,CHI,UTA
85,Home,L 93-97 ,240,29,85,.341,24,63,.381,5,22,.227,30,38,.789,93,38,87,.437,36,76,.474,2,11,.182,19,25,.760,97,2013-02-13,MIN,UTA
86,@,L 93-99 ,240,36,85,.424,32,72,.444,4,13,.308,17,20,.850,93,32,75,.427,24,42,.571,8,33,.242,27,35,.771,99,2013-02-24,PHI,NYK
87,Home,W 93-82 ,240,32,83,.386,29,69,.420,3,14,.214,26,33,.788,93,33,85,.388,29,74,.392,4,11,.364,12,21,.571,82,2013-02-28,CHI,PHI
88,@,W 93-81 ,240,34,70,.486,27,50,.540,7,20,.350,18,22,.818,93,29,72,.403,26,61,.426,3,11,.273,20,25,.800,81,2013-03-01,IND,TOR
89,Home,L 93-99 ,240,32,74,.432,24,45,.533,8,29,.276,21,26,.808,93,39,84,.464,31,64,.484,8,20,.400,13,19,.684,99,2013-03-03,NYK,MIA
90,@,L 93-102 ,240,37,77,.481,27,56,.482,10,21,.476,9,11,.818,93,42,79,.532,34,58,.586,8,21,.381,10,13,.769,102,2013-03-08,PHI,MIA
91,@,W 93-80 ,240,36,83,.434,30,60,.500,6,23,.261,15,22,.682,93,32,77,.416,27,59,.458,5,18,.278,11,16,.688,80,2013-03-09,BRK,ATL
92,Home,L 93-103 ,240,37,82,.451,31,67,.463,6,15,.400,13,20,.650,93,38,78,.487,25,50,.500,13,28,.464,14,19,.737,103,2013-03-09,GSW,MIL
93,Home,L 93-108 ,240,35,84,.417,29,64,.453,6,20,.300,17,22,.773,93,44,86,.512,41,74,.554,3,12,.250,17,25,.680,108,2013-03-11,PHO,DEN
94,@,L 93-105 ,240,33,77,.429,27,60,.450,6,17,.353,21,24,.875,93,43,82,.524,35,61,.574,8,21,.381,11,14,.786,105,2013-03-11,OKC,SAS
95,@,L 93-106 ,240,39,85,.459,33,67,.493,6,18,.333,9,12,.750,93,43,86,.500,35,70,.500,8,16,.500,12,24,.500,106,2013-03-13,MIL,WAS
96,Home,L 93-99 ,240,37,99,.374,25,72,.347,12,27,.444,7,9,.778,93,33,78,.423,20,52,.385,13,26,.500,20,30,.667,99,2013-03-15,IND,LAL
97,Home,L 93-105 ,240,36,86,.419,28,63,.444,8,23,.348,13,16,.813,93,44,84,.524,36,63,.571,8,21,.381,9,13,.692,105,2013-03-17,BRK,ATL
98,Home,W 93-80 ,240,34,75,.453,26,47,.553,8,28,.286,17,31,.548,93,29,81,.358,17,55,.309,12,26,.462,10,14,.714,80,2013-03-17,LAC,NYK
99,@,W 93-72 ,240,35,70,.500,25,51,.490,10,19,.526,13,15,.867,93,28,83,.337,25,66,.379,3,17,.176,13,13,1.000,72,2013-03-18,GSW,NOH
0,@,L 93-100 ,240,36,79,.456,31,62,.500,5,17,.294,16,20,.800,93,34,76,.447,28,53,.528,6,23,.261,26,32,.813,100,2013-03-20,UTA,HOU
1,@,L 93-104 ,240,37,84,.440,31,72,.431,6,12,.500,13,15,.867,93,41,85,.482,33,59,.559,8,26,.308,14,15,.933,104,2013-03-20,GSW,SAS
2,Home,L 93-104 ,240,37,83,.446,30,59,.508,7,24,.292,12,16,.750,93,41,87,.471,31,69,.449,10,18,.556,12,16,.750,104,2013-03-22,ATL,POR
3,@,W 93-92 ,240,34,76,.447,29,62,.468,5,14,.357,20,28,.714,93,38,86,.442,31,69,.449,7,17,.412,9,14,.643,92,2013-03-27,BOS,CLE
4,Home,L 93-111 ,240,36,82,.439,28,64,.438,8,18,.444,13,21,.619,93,46,95,.484,41,75,.547,5,20,.250,14,25,.560,111,2013-03-27,POR,BRK
5,@,L 93-101 ,240,36,79,.456,31,63,.492,5,16,.313,16,20,.800,93,37,83,.446,32,68,.471,5,15,.333,22,27,.815,101,2013-03-29,OKC,MIN
6,@,L 93-98 ,240,34,93,.366,30,69,.435,4,24,.167,21,30,.700,93,36,71,.507,29,51,.569,7,20,.350,19,22,.864,98,2013-04-03,DET,BOS
7,Home,L 93-95 ,240,30,67,.448,27,52,.519,3,15,.200,30,40,.750,93,40,85,.471,36,70,.514,4,15,.267,11,16,.688,95,2013-04-05,MIN,TOR
8,Home,L 93-101 ,240,37,81,.457,31,65,.477,6,16,.375,13,17,.765,93,34,74,.459,26,55,.473,8,19,.421,25,28,.893,101,2013-04-10,BOS,BRK
9,@,L 93-113 ,240,35,78,.449,26,54,.481,9,24,.375,14,17,.824,93,43,83,.518,31,65,.477,12,18,.667,15,20,.750,113,2013-04-12,CHA,DET
10,Home,L 93-96 ,240,35,83,.422,29,64,.453,6,19,.316,17,32,.531,93,35,78,.449,28,52,.538,7,26,.269,19,28,.679,96,2013-04-12,NOH,LAC
11,@,L 93-105 ,240,37,73,.507,28,53,.528,9,20,.450,10,14,.714,93,41,83,.494,35,68,.515,6,15,.400,17,19,.895,105,2013-04-13,PHO,MIN
12,@,L 93-105 ,240,29,82,.354,18,56,.321,11,26,.423,24,31,.774,93,36,70,.514,30,53,.566,6,17,.353,27,41,.659,105,2013-04-14,CHI,MIA
13,Home,W 93-87 ,240,36,82,.439,30,67,.448,6,15,.400,15,21,.714,93,34,84,.405,26,54,.481,8,30,.267,11,19,.579,87,2013-04-14,TOR,BRK
14,Home,W 93-77 ,240,37,79,.468,30,52,.577,7,27,.259,12,15,.800,93,30,73,.411,23,52,.442,7,21,.333,10,15,.667,77,2013-04-16,LAC,POR
15,@,L 93-105 ,240,40,77,.519,38,63,.603,2,14,.143,11,25,.440,93,42,78,.538,30,49,.612,12,29,.414,9,19,.474,105,2013-04-17,ORL,MIA
16,Home,W 93-87 ,240,38,86,.442,33,69,.478,5,17,.294,12,23,.522,93,32,66,.485,29,53,.547,3,13,.231,20,29,.690,87,2013-10-30,TOR,BOS
17,Home,L 93-104 ,240,34,81,.420,30,59,.508,4,22,.182,21,27,.778,93,34,67,.507,25,45,.556,9,22,.409,27,35,.771,104,2013-11-02,UTA,HOU
18,@,L 93-103 ,240,35,82,.427,23,52,.442,12,30,.400,11,16,.688,93,37,70,.529,26,43,.605,11,27,.407,18,27,.667,103,2013-11-03,WAS,MIA
19,Home,W 93-92 ,240,39,85,.459,34,69,.493,5,16,.313,10,11,.909,93,34,94,.362,29,66,.439,5,28,.179,19,24,.792,92,2013-11-04,CLE,MIN
20,Home,L 93-106 ,240,34,90,.378,30,74,.405,4,16,.250,21,27,.778,93,42,84,.500,34,64,.531,8,20,.400,14,20,.700,106,2013-11-06,MIN,GSW
21,@,L 93-107 ,240,36,85,.424,27,62,.435,9,23,.391,12,14,.857,93,43,79,.544,38,66,.576,5,13,.385,16,23,.696,107,2013-11-06,DAL,OKC
22,Home,W 93-85 ,240,36,71,.507,32,56,.571,4,15,.267,17,24,.708,93,35,87,.402,29,65,.446,6,22,.273,9,12,.750,85,2013-11-20,ATL,DET
23,@,L 93-104 ,240,39,86,.453,35,71,.493,4,15,.267,11,12,.917,93,39,81,.481,31,60,.517,8,21,.381,18,24,.750,104,2013-11-20,BOS,SAS
24,@,L 93-103 ,240,39,78,.500,32,58,.552,7,20,.350,8,12,.667,93,38,75,.507,31,58,.534,7,17,.412,20,27,.741,103,2013-11-22,UTA,DAL
25,@,W 93-86 ,240,34,69,.493,28,45,.622,6,24,.250,19,27,.704,93,34,82,.415,30,69,.435,4,13,.308,14,18,.778,86,2013-11-25,HOU,MEM
26,@,L 93-112 ,240,37,97,.381,35,82,.427,2,15,.133,17,20,.850,93,44,81,.543,34,56,.607,10,25,.400,14,19,.737,112,2013-11-25,NOP,SAS
27,Home,L 93-100 ,240,38,89,.427,31,69,.449,7,20,.350,10,13,.769,93,36,80,.450,33,71,.465,3,9,.333,25,31,.806,100,2013-11-27,BOS,MEM
28,Home,W 93-80 ,240,32,74,.432,26,49,.531,6,25,.240,23,31,.742,93,32,83,.386,29,63,.460,3,20,.150,13,15,.867,80,2013-11-27,LAC,NYK
29,Home,W 93-73 ,240,38,85,.447,29,63,.460,9,22,.409,8,10,.800,93,29,73,.397,23,55,.418,6,18,.333,9,13,.692,73,2013-11-29,IND,WAS
30,@,L 93-97 ,240,39,82,.476,33,67,.493,6,15,.400,9,15,.600,93,37,78,.474,30,63,.476,7,15,.467,16,19,.842,97,2013-11-30,CHI,CLE
31,@,L 93-95 ,240,37,88,.420,29,65,.446,8,23,.348,11,14,.786,93,37,86,.430,25,58,.431,12,28,.429,9,15,.600,95,2013-12-11,DAL,GSW
32,@,L 93-102 ,240,26,70,.371,20,46,.435,6,24,.250,35,52,.673,93,33,74,.446,25,54,.463,8,20,.400,28,30,.933,102,2013-12-12,LAC,BRK
33,Home,L 93-103 ,240,36,85,.424,29,64,.453,7,21,.333,14,24,.583,93,38,84,.452,30,63,.476,8,21,.381,19,20,.950,103,2013-12-13,DEN,UTA
34,@,L 93-106 ,240,36,81,.444,31,64,.484,5,17,.294,16,19,.842,93,42,88,.477,32,64,.500,10,24,.417,12,18,.667,106,2013-12-14,MIL,DAL
35,@,L 93-102 ,240,37,85,.435,30,61,.492,7,24,.292,12,19,.632,93,37,85,.435,30,61,.492,7,24,.292,21,28,.750,102,2013-12-15,NOP,DEN
36,Home,L 93-101 ,240,37,83,.446,32,68,.471,5,15,.333,14,20,.700,93,35,79,.443,23,53,.434,12,26,.462,19,25,.760,101,2013-12-15,MEM,MIN
37,Home,L 93-105 ,240,36,87,.414,31,68,.456,5,19,.263,16,22,.727,93,43,88,.489,38,66,.576,5,22,.227,14,20,.700,105,2013-12-17,DEN,OKC
38,@,L 93-104 ,240,33,88,.375,28,70,.400,5,18,.278,22,30,.733,93,41,91,.451,36,71,.507,5,20,.250,17,24,.708,104,2013-12-17,NOP,GSW
39,@,L 93-104 ,240,33,88,.375,24,56,.429,9,32,.281,18,25,.720,93,34,79,.430,22,53,.415,12,26,.462,24,32,.750,104,2013-12-27,MIL,BRK
40,Home,L 93-95 ,240,34,68,.500,25,46,.543,9,22,.409,16,19,.842,93,31,70,.443,22,46,.478,9,24,.375,24,31,.774,95,2014-01-02,OKC,BRK
41,@,L 93-111 ,240,34,86,.395,30,67,.448,4,19,.211,21,27,.778,93,44,89,.494,31,61,.508,13,28,.464,10,18,.556,111,2014-01-07,PHI,CLE
42,Home,W 93-66 ,240,37,83,.446,31,70,.443,6,13,.462,13,22,.591,93,26,81,.321,21,67,.313,5,14,.357,9,23,.391,66,2014-01-10,IND,WAS
43,@,L 93-96 ,240,35,76,.461,26,52,.500,9,24,.375,14,16,.875,93,40,79,.506,34,68,.500,6,11,.545,10,13,.769,96,2014-01-17,CHI,WAS
44,@,L 93-108 ,240,33,77,.429,28,60,.467,5,17,.294,22,28,.786,93,39,86,.453,30,65,.462,9,21,.429,21,30,.700,108,2014-01-19,SAC,OKC
45,Home,W 93-91 ,240,30,71,.423,26,56,.464,4,15,.267,29,36,.806,93,33,90,.367,30,77,.390,3,13,.231,22,24,.917,91,2014-01-19,ORL,BOS
46,Home,W 93-86 ,240,38,74,.514,33,54,.611,5,20,.250,12,16,.750,93,33,84,.393,28,57,.491,5,27,.185,15,18,.833,86,2014-01-21,MIA,BOS
47,Home,W 93-85 ,240,32,76,.421,25,53,.472,7,23,.304,22,32,.688,93,34,73,.466,27,53,.509,7,20,.350,10,14,.714,85,2014-01-22,TOR,DAL
48,Home,W 93-78 ,240,37,88,.420,33,74,.446,4,14,.286,15,23,.652,93,30,74,.405,23,50,.460,7,24,.292,11,14,.786,78,2014-01-24,CLE,MIL
49,@,L 93-95 ,240,34,83,.410,29,69,.420,5,14,.357,20,25,.800,93,36,75,.480,30,53,.566,6,22,.273,17,26,.654,95,2014-02-01,SAC,SAS
50,Home,W 93-81 ,240,35,66,.530,29,38,.763,6,28,.214,17,29,.586,93,30,83,.361,24,65,.369,6,18,.333,15,27,.556,81,2014-02-09,BRK,NOP
51,Home,W 93-92 ,240,34,83,.410,29,71,.408,5,12,.417,20,26,.769,93,35,79,.443,24,55,.436,11,24,.458,11,19,.579,92,2014-02-09,ORL,IND
52,Home,W 93-84 ,240,34,79,.430,26,58,.448,8,21,.381,17,22,.773,93,29,82,.354,27,71,.380,2,11,.182,24,28,.857,84,2014-02-09,WAS,SAC
53,@,W 93-89 ,240,34,84,.405,29,69,.420,5,15,.333,20,30,.667,93,33,83,.398,29,60,.483,4,23,.174,19,27,.704,89,2014-02-12,CLE,DET
54,@,L 93-98 ,240,35,85,.412,29,58,.500,6,27,.222,17,20,.850,93,37,75,.493,31,63,.492,6,12,.500,18,24,.750,98,2014-02-18,NYK,MEM
55,Home,L 93-103 ,240,38,81,.469,34,66,.515,4,15,.267,13,21,.619,93,42,74,.568,35,58,.603,7,16,.438,12,15,.800,103,2014-02-18,WAS,TOR
56,@,L 93-101 ,240,35,89,.393,29,67,.433,6,22,.273,17,24,.708,93,33,80,.413,28,60,.467,5,20,.250,30,37,.811,101,2014-02-19,ORL,CLE
57,Home,W 93-86 ,240,37,85,.435,31,65,.477,6,20,.300,13,17,.765,93,32,78,.410,30,57,.526,2,21,.095,20,24,.833,86,2014-02-22,GSW,BRK
58,@,L 93-94 ,240,35,81,.432,29,68,.426,6,13,.462,17,21,.810,93,36,74,.486,33,60,.550,3,14,.214,19,26,.731,94,2014-02-22,NOP,WAS
59,Home,W 93-79 ,240,37,88,.420,28,65,.431,9,23,.391,10,14,.714,93,29,81,.358,23,60,.383,6,21,.286,15,17,.882,79,2014-02-23,MIA,CHI
60,Home,L 93-99 ,240,34,84,.405,29,67,.433,5,17,.294,20,24,.833,93,35,79,.443,25,47,.532,10,32,.313,19,24,.792,99,2014-02-25,CLE,TOR
61,@,L 93-101 ,240,34,77,.442,26,52,.500,8,25,.320,17,24,.708,93,41,93,.441,33,69,.478,8,24,.333,11,13,.846,101,2014-02-26,HOU,LAC
62,@,L 93-105 ,240,35,82,.427,29,67,.433,6,15,.400,17,21,.810,93,44,91,.484,36,72,.500,8,19,.421,9,14,.643,105,2014-03-14,MIN,CHA
63,@,L 93-109 ,240,32,80,.400,26,67,.388,6,13,.462,23,30,.767,93,45,89,.506,34,64,.531,11,25,.440,8,12,.667,109,2014-03-19,ORL,PHO
64,@,W 93-92 ,240,34,82,.415,27,53,.509,7,29,.241,18,25,.720,93,34,91,.374,24,50,.480,10,41,.244,14,21,.667,92,2014-03-21,NYK,PHI
65,Home,W 93-91 ,240,37,84,.440,32,69,.464,5,15,.333,14,23,.609,93,28,74,.378,17,35,.486,11,39,.282,24,27,.889,91,2014-03-24,MIA,POR
66,Home,L 93-99 ,240,37,81,.457,31,62,.500,6,19,.316,13,21,.619,93,37,75,.493,23,47,.489,14,28,.500,11,12,.917,99,2014-03-26,WAS,PHO
67,@,L 93-100 ,240,41,81,.506,39,69,.565,2,12,.167,9,16,.563,93,40,81,.494,31,61,.508,9,20,.450,11,14,.786,100,2014-03-28,MEM,GSW
68,Home,L 93-98 ,240,38,69,.551,31,50,.620,7,19,.368,10,14,.714,93,33,73,.452,27,54,.500,6,19,.316,26,27,.963,98,2014-03-30,ORL,TOR
69,Home,W 93-83 ,240,34,66,.515,27,41,.659,7,25,.280,18,22,.818,93,35,70,.500,27,44,.614,8,26,.308,5,10,.500,83,2014-03-31,MIA,TOR
70,Home,L 93-123 ,240,35,83,.422,31,65,.477,4,18,.222,19,26,.731,93,42,79,.532,30,57,.526,12,22,.545,27,35,.771,123,2014-04-02,PHI,CHA
71,Home,L 93-109 ,240,35,81,.432,29,60,.483,6,21,.286,17,27,.630,93,39,97,.402,33,76,.434,6,21,.286,25,31,.806,109,2014-04-04,POR,PHO
72,@,W 93-91 ,240,36,89,.404,23,58,.397,13,31,.419,8,14,.571,93,36,76,.474,31,58,.534,5,18,.278,14,20,.700,91,2014-04-06,DAL,SAC
73,@,W 93-88 ,240,36,79,.456,35,60,.583,1,19,.053,20,21,.952,93,34,80,.425,28,58,.483,6,22,.273,14,25,.560,88,2014-04-11,ATL,BRK
74,Home,L 93-95 ,240,34,79,.430,26,49,.531,8,30,.267,17,23,.739,93,35,80,.438,29,55,.527,6,25,.240,19,31,.613,95,2014-04-14,ATL,CHA
75,@,L 93-114 ,240,36,80,.450,29,53,.547,7,27,.259,14,16,.875,93,46,78,.590,32,49,.653,14,29,.483,8,15,.533,114,2014-04-14,MIA,WAS
76,Home,L 93-104 ,240,38,81,.469,35,63,.556,3,18,.167,14,17,.824,93,40,77,.519,26,50,.520,14,27,.519,10,14,.714,104,2014-10-29,UTA,HOU
77,Home,W 93-90 ,240,34,87,.391,27,57,.474,7,30,.233,18,25,.720,93,28,65,.431,22,44,.500,6,21,.286,28,34,.824,90,2014-10-30,LAC,OKC
78,Home,W 93-81 ,240,36,88,.409,27,64,.422,9,24,.375,12,21,.571,93,32,86,.372,27,63,.429,5,23,.217,12,22,.545,81,2014-10-31,MIL,PHI
79,@,L 93-96 ,240,33,70,.471,27,55,.491,6,15,.400,21,29,.724,93,39,78,.500,31,62,.500,8,16,.500,10,17,.588,96,2014-11-02,CHO,NYK
80,Home,W 93-81 ,240,31,76,.408,27,62,.435,4,14,.286,27,37,.730,93,29,86,.337,25,62,.403,4,24,.167,19,29,.655,81,2014-11-03,MEM,NOP
81,Home,L 93-104 ,240,33,74,.446,22,52,.423,11,22,.500,16,23,.696,93,32,75,.427,16,41,.390,16,34,.471,24,30,.800,104,2014-11-03,PHI,HOU
82,Home,W 93-92 ,240,40,88,.455,35,70,.500,5,18,.278,8,11,.727,93,29,82,.354,26,68,.382,3,14,.214,31,34,.912,92,2014-11-08,MIL,MEM
83,@,L 93-101 ,240,36,80,.450,30,56,.536,6,24,.250,15,22,.682,93,36,78,.462,30,60,.500,6,18,.333,23,27,.852,101,2014-11-09,SAC,OKC
84,Home,L 93-100 ,240,35,89,.393,27,64,.422,8,25,.320,15,21,.714,93,37,77,.481,33,62,.532,4,15,.267,22,32,.688,100,2014-11-13,TOR,CHI
85,@,W 93-80 ,240,33,80,.413,23,57,.404,10,23,.435,17,20,.850,93,28,75,.373,26,63,.413,2,12,.167,22,31,.710,80,2014-11-14,SAS,LAL
86,@,L 93-111 ,240,33,75,.440,28,59,.475,5,16,.313,22,30,.733,93,43,84,.512,35,63,.556,8,21,.381,17,23,.739,111,2014-11-15,UTA,TOR
87,@,L 93-98 ,240,37,78,.474,30,61,.492,7,17,.412,12,18,.667,93,42,84,.500,39,74,.527,3,10,.300,11,16,.688,98,2014-11-15,ORL,WAS
88,@,L 93-109 ,240,32,82,.390,19,48,.396,13,34,.382,16,26,.615,93,41,76,.539,35,62,.565,6,14,.429,21,27,.778,109,2014-11-16,DEN,NYK
89,Home,L 93-107 ,240,32,80,.400,21,56,.375,11,24,.458,18,24,.750,93,41,79,.519,28,53,.528,13,26,.500,12,15,.800,107,2014-11-17,DET,ORL
90,@,L 93-119 ,240,34,78,.436,26,44,.591,8,34,.235,17,21,.810,93,46,86,.535,39,69,.565,7,17,.412,20,22,.909,119,2014-11-17,HOU,MEM
91,@,L 93-102 ,240,38,85,.447,33,66,.500,5,19,.263,12,19,.632,93,38,76,.500,31,57,.544,7,19,.368,19,23,.826,102,2014-11-17,NOP,POR
92,Home,L 93-110 ,240,30,67,.448,24,41,.585,6,26,.231,27,31,.871,93,43,77,.558,30,46,.652,13,31,.419,11,17,.647,110,2014-11-20,MIA,LAC
93,Home,L 93-110 ,240,35,81,.432,32,65,.492,3,16,.188,20,29,.690,93,32,80,.400,24,56,.429,8,24,.333,38,42,.905,110,2014-11-22,CLE,TOR
94,@,L 93-94 ,240,37,79,.468,30,58,.517,7,21,.333,12,16,.750,93,33,66,.500,22,43,.512,11,23,.478,17,19,.895,94,2014-11-23,CHO,MIA
95,Home,L 93-99 ,240,33,81,.407,25,62,.403,8,19,.421,19,24,.792,93,36,80,.450,31,58,.534,5,22,.227,22,25,.880,99,2014-11-26,LAL,MEM
96,Home,L 93-104 ,240,33,91,.363,22,68,.324,11,23,.478,16,24,.667,93,37,79,.468,28,58,.483,9,21,.429,21,27,.778,104,2014-11-30,DET,GSW
97,@,W 93-90 ,240,35,76,.461,30,61,.492,5,15,.333,18,25,.720,93,34,85,.400,27,59,.458,7,26,.269,15,18,.833,90,2014-11-30,ORL,PHO
98,@,L 93-107 ,240,39,90,.433,37,81,.457,2,9,.222,13,20,.650,93,39,86,.453,27,53,.509,12,33,.364,17,25,.680,107,2014-11-30,MIN,POR
99,Home,L 93-98 ,240,35,81,.432,24,53,.453,11,28,.393,12,14,.857,93,39,89,.438,33,72,.458,6,17,.353,14,20,.700,98,2014-12-02,NYK,BRK
0,@,L 93-95 (OT),265,36,101,.356,24,69,.348,12,32,.375,9,12,.750,93,37,90,.411,28,71,.394,9,19,.474,12,18,.667,95,2014-12-03,SAS,BRK
1,Home,L 93-98 ,240,36,79,.456,28,63,.444,8,16,.500,13,21,.619,93,37,74,.500,30,57,.526,7,17,.412,17,20,.850,98,2014-12-05,UTA,ORL
2,@,L 93-101 ,240,34,93,.366,23,66,.348,11,27,.407,14,21,.667,93,36,88,.409,28,71,.394,8,17,.471,21,26,.808,101,2014-12-07,WAS,BOS
3,@,L 93-104 ,240,37,78,.474,28,59,.475,9,19,.474,10,13,.769,93,40,80,.500,36,65,.554,4,15,.267,20,26,.769,104,2014-12-09,NYK,NOP
4,@,L 93-105 ,240,37,90,.411,28,55,.509,9,35,.257,10,15,.667,93,40,81,.494,32,58,.552,8,23,.348,17,20,.850,105,2014-12-10,HOU,GSW
5,@,W 93-75 ,240,33,71,.465,24,53,.453,9,18,.500,18,21,.857,93,28,80,.350,24,58,.414,4,22,.182,15,18,.833,75,2014-12-14,CHI,MIA
6,Home,W 93-84 ,240,41,84,.488,37,71,.521,4,13,.308,7,12,.583,93,30,78,.385,25,61,.410,5,17,.294,19,28,.679,84,2014-12-14,WAS,UTA
7,Home,W 93-86 ,240,36,83,.434,29,62,.468,7,21,.333,14,17,.824,93,35,93,.376,29,64,.453,6,29,.207,10,14,.714,86,2014-12-15,ATL,CHI
8,@,L 93-99 ,240,32,77,.416,29,64,.453,3,13,.231,26,26,1.000,93,37,86,.430,28,60,.467,9,26,.346,16,20,.800,99,2014-12-20,SAS,DAL
9,@,L 93-113 ,240,36,92,.391,31,76,.408,5,16,.313,16,21,.762,93,42,86,.488,32,62,.516,10,24,.417,19,25,.760,113,2014-12-25,LAL,CHI
10,@,L 93-114 ,240,36,81,.444,33,67,.493,3,14,.214,18,33,.545,93,42,88,.477,24,45,.533,18,43,.419,12,14,.857,114,2014-12-26,PHI,POR
11,@,L 93-95 (OT),265,34,89,.382,26,61,.426,8,28,.286,17,20,.850,93,39,89,.438,33,65,.508,6,24,.250,11,18,.611,95,2014-12-31,NOP,SAS
12,Home,L 93-105 ,240,34,82,.415,24,53,.453,10,29,.345,15,19,.789,93,39,86,.453,27,52,.519,12,34,.353,15,24,.625,105,2015-01-07,CLE,HOU
13,Home,W 93-90 ,240,33,74,.446,26,57,.456,7,17,.412,20,26,.769,93,35,88,.398,27,66,.409,8,22,.364,12,16,.750,90,2015-01-07,DEN,ORL
14,@,L 93-98 ,240,37,88,.420,28,57,.491,9,31,.290,10,10,1.000,93,34,80,.425,23,47,.489,11,33,.333,19,26,.731,98,2015-01-10,BRK,DET
15,Home,L 93-108 ,240,32,81,.395,29,66,.439,3,15,.200,26,26,1.000,93,41,84,.488,32,60,.533,9,24,.375,17,20,.850,108,2015-01-10,MIN,SAS
16,Home,W 93-92 ,240,32,80,.400,21,56,.375,11,24,.458,18,25,.720,93,29,87,.333,25,69,.362,4,18,.222,30,42,.714,92,2015-01-10,PHI,IND
17,@,L 93-101 ,240,38,96,.396,29,67,.433,9,29,.310,8,12,.667,93,37,75,.493,31,63,.492,6,12,.500,21,24,.875,101,2015-01-13,SAS,WAS
18,Home,L 93-98 ,240,33,86,.384,29,73,.397,4,13,.308,23,35,.657,93,37,85,.435,29,64,.453,8,21,.381,16,20,.800,98,2015-01-14,CHO,SAS
19,Home,L 93-95 ,240,31,72,.431,24,47,.511,7,25,.280,24,29,.828,93,39,82,.476,34,65,.523,5,17,.294,12,20,.600,95,2015-01-18,TOR,NOP
20,Home,W 93-82 ,240,37,84,.440,28,54,.519,9,30,.300,10,14,.714,93,29,82,.354,20,47,.426,9,35,.257,15,26,.577,82,2015-01-19,ATL,DET
21,@,L 93-102 ,240,33,84,.393,21,55,.382,12,29,.414,15,21,.714,93,39,82,.476,30,61,.492,9,21,.429,15,19,.789,102,2015-01-19,BOS,LAC
22,@,L 93-103 ,240,36,87,.414,26,61,.426,10,26,.385,11,18,.611,93,40,83,.482,30,58,.517,10,25,.400,13,13,1.000,103,2015-01-23,OKC,ATL
23,@,W 93-85 ,240,39,85,.459,29,68,.426,10,17,.588,5,7,.714,93,32,82,.390,29,67,.433,3,15,.200,18,24,.750,85,2015-01-28,DEN,NOP
24,@,W 93-87 ,240,35,84,.417,27,54,.500,8,30,.267,15,20,.750,93,32,90,.356,25,66,.379,7,24,.292,16,23,.696,87,2015-01-30,HOU,BOS
25,@,W 93-72 ,240,34,82,.415,21,53,.396,13,29,.448,12,20,.600,93,29,88,.330,20,59,.339,9,29,.310,5,10,.500,72,2015-01-30,DAL,MIA
26,@,L 93-99 ,240,36,87,.414,32,69,.464,4,18,.222,17,27,.630,93,39,90,.433,33,68,.485,6,22,.273,15,17,.882,99,2015-01-30,CHI,PHO
27,Home,L 93-108 ,240,33,78,.423,25,54,.463,8,24,.333,19,24,.792,93,42,74,.568,31,53,.585,11,21,.524,13,22,.591,108,2015-01-31,ORL,DAL
28,Home,L 93-109 ,240,35,79,.443,25,46,.543,10,33,.303,13,18,.722,93,40,81,.494,31,62,.500,9,19,.474,20,23,.870,109,2015-02-04,TOR,BRK
29,@,L 93-100 ,240,37,80,.463,30,60,.500,7,20,.350,12,18,.667,93,38,84,.452,24,57,.421,14,27,.519,10,14,.714,100,2015-02-06,UTA,PHO
30,@,L 93-96 ,240,36,86,.419,29,57,.509,7,29,.241,14,20,.700,93,37,75,.493,29,55,.527,8,20,.400,14,19,.737,96,2015-02-07,BOS,MIL
31,Home,L 93-95 ,240,36,88,.409,28,67,.418,8,21,.381,13,13,1.000,93,37,89,.416,31,64,.484,6,25,.240,15,17,.882,95,2015-02-09,IND,SAS
32,@,L 93-113 ,240,34,84,.405,25,60,.417,9,24,.375,16,20,.800,93,44,78,.564,34,53,.642,10,25,.400,15,19,.789,113,2015-02-11,MIA,CLE
33,Home,L 93-106 ,240,34,74,.459,27,59,.458,7,15,.467,18,25,.720,93,40,75,.533,31,55,.564,9,20,.450,17,18,.944,106,2015-02-11,NOP,IND
34,@,L 93-95 ,240,39,85,.459,34,64,.531,5,21,.238,10,16,.625,93,31,76,.408,20,50,.400,11,26,.423,22,26,.846,95,2015-02-11,WAS,TOR
35,Home,L 93-102 ,240,33,82,.402,24,58,.414,9,24,.375,18,30,.600,93,34,77,.442,20,40,.500,14,37,.378,20,24,.833,102,2015-02-24,DET,CLE
36,@,W 93-90 (OT),265,32,84,.381,26,53,.491,6,31,.194,23,32,.719,93,33,78,.423,27,56,.482,6,22,.273,18,31,.581,90,2015-02-25,MIA,ORL
37,Home,W 93-86 ,240,34,80,.425,28,63,.444,6,17,.353,19,29,.655,93,33,92,.359,24,63,.381,9,29,.310,11,14,.786,86,2015-02-27,IND,CLE
38,@,L 93-101 ,240,34,87,.391,30,70,.429,4,17,.235,21,29,.724,93,40,85,.471,34,67,.507,6,18,.333,15,22,.682,101,2015-02-27,MIL,LAL
39,@,W 93-91 ,240,34,79,.430,24,54,.444,10,25,.400,15,20,.750,93,32,81,.395,25,55,.455,7,26,.269,20,21,.952,91,2015-02-28,ATL,MIA
40,@,L 93-102 ,240,35,74,.473,25,53,.472,10,21,.476,13,16,.813,93,38,79,.481,32,63,.508,6,16,.375,20,22,.909,102,2015-03-02,NOP,DAL
41,@,W 93-82 ,240,36,80,.450,31,55,.564,5,25,.200,16,19,.842,93,33,82,.402,30,71,.423,3,11,.273,13,19,.684,82,2015-03-03,UTA,MEM
42,@,L 93-102 ,240,34,80,.425,29,66,.439,5,14,.357,20,25,.800,93,37,73,.507,23,39,.590,14,34,.412,14,25,.560,102,2015-03-04,MIL,GSW
43,Home,L 93-98 (OT),265,37,96,.385,26,65,.400,11,31,.355,8,18,.444,93,34,87,.391,26,55,.473,8,32,.250,22,29,.759,98,2015-03-04,LAC,POR
44,@,L 93-103 ,240,37,102,.363,31,73,.425,6,29,.207,13,17,.765,93,38,91,.418,32,63,.508,6,28,.214,21,25,.840,103,2015-03-06,DET,HOU
45,Home,L 93-100 ,240,38,82,.463,36,68,.529,2,14,.143,15,21,.714,93,38,78,.487,29,52,.558,9,26,.346,15,22,.682,100,2015-03-08,LAL,DAL
46,Home,W 93-85 ,240,32,75,.427,29,62,.468,3,13,.231,26,30,.867,93,32,84,.381,24,49,.490,8,35,.229,13,19,.684,85,2015-03-10,LAL,DET
47,@,W 93-89 ,240,35,83,.422,27,55,.491,8,28,.286,15,21,.714,93,34,85,.400,25,61,.410,9,24,.375,12,15,.800,89,2015-03-14,BOS,IND
48,Home,W 93-75 ,240,40,90,.444,34,72,.472,6,18,.333,7,13,.538,93,32,81,.395,29,63,.460,3,18,.167,8,15,.533,75,2015-03-22,OKC,MIA
49,@,W 93-86 ,240,34,77,.442,25,53,.472,9,24,.375,16,23,.696,93,28,69,.406,23,50,.460,5,19,.263,25,37,.676,86,2015-03-25,MIA,BOS
50,Home,L 93-95 ,240,34,75,.453,29,60,.483,5,15,.333,20,32,.625,93,40,81,.494,34,59,.576,6,22,.273,9,12,.750,95,2015-03-25,NOP,HOU
51,@,L 93-106 ,240,36,91,.396,26,57,.456,10,34,.294,11,17,.647,93,44,76,.579,40,64,.625,4,12,.333,14,22,.636,106,2015-04-01,PHI,WAS
52,Home,W 93-74 ,240,36,83,.434,28,67,.418,8,16,.500,13,18,.722,93,28,80,.350,24,62,.387,4,18,.222,14,20,.700,74,2015-04-03,IND,CHO
53,@,L 93-123 ,240,40,87,.460,34,70,.486,6,17,.353,7,11,.636,93,47,85,.553,33,51,.647,14,34,.412,15,17,.882,123,2015-04-03,DEN,SAS
54,@,L 93-100 ,240,35,85,.412,29,64,.453,6,21,.286,17,28,.607,93,39,83,.470,36,73,.493,3,10,.300,19,23,.826,100,2015-04-13,ORL,MIA
55,@,L 93-95 ,240,35,80,.438,26,56,.464,9,24,.375,14,20,.700,93,38,99,.384,32,72,.444,6,27,.222,13,15,.867,95,2015-04-14,TOR,BOS
56,Home,L 93-103 ,240,31,85,.365,21,51,.412,10,34,.294,21,28,.750,93,40,87,.460,29,57,.509,11,30,.367,12,16,.750,103,2015-11-01,LAL,DAL
57,@,L 93-117 ,240,35,92,.380,26,66,.394,9,26,.346,14,19,.737,93,45,86,.523,32,61,.525,13,25,.520,14,18,.778,117,2015-11-01,DEN,OKC
58,Home,L 93-102 (OT),265,33,93,.355,22,61,.361,11,32,.344,16,23,.696,93,39,96,.406,32,80,.400,7,16,.438,17,27,.630,102,2015-11-07,CHI,MIN
59,@,L 93-95 ,240,42,86,.488,38,65,.585,4,21,.190,5,7,.714,93,35,84,.417,27,61,.443,8,23,.348,17,28,.607,95,2015-11-11,NYK,CHO
60,@,L 93-106 ,240,36,76,.474,30,56,.536,6,20,.300,15,20,.750,93,42,103,.408,31,70,.443,11,33,.333,11,12,.917,106,2015-11-13,ATL,BOS
61,@,L 93-102 ,240,34,87,.391,26,62,.419,8,25,.320,17,23,.739,93,32,76,.421,22,49,.449,10,27,.370,28,31,.903,102,2015-11-13,UTA,ORL
62,Home,W 93-80 ,240,38,89,.427,31,66,.470,7,23,.304,10,13,.769,93,31,75,.413,24,56,.429,7,19,.368,11,13,.846,80,2015-11-16,SAS,POR
63,Home,W 93-89 ,240,35,72,.486,28,50,.560,7,22,.318,16,22,.727,93,34,80,.425,29,60,.483,5,20,.250,16,18,.889,89,2015-11-18,UTA,TOR
64,@,L 93-102 ,240,35,80,.438,29,60,.483,6,20,.300,17,21,.810,93,39,83,.470,31,55,.564,8,28,.286,16,17,.941,102,2015-11-20,UTA,DAL
65,@,W 93-90 ,240,33,72,.458,21,52,.404,12,20,.600,15,23,.652,93,35,92,.380,32,63,.508,3,29,.103,17,23,.739,90,2015-11-20,NYK,OKC
66,Home,L 93-107 ,240,32,88,.364,26,70,.371,6,18,.333,23,27,.852,93,43,87,.494,35,62,.565,8,25,.320,13,17,.765,107,2015-11-22,LAL,POR
67,@,W 93-88 ,240,33,86,.384,26,68,.382,7,18,.389,20,23,.870,93,31,88,.352,25,66,.379,6,22,.273,20,27,.741,88,2015-11-24,CHI,POR
68,Home,L 93-102 ,240,30,71,.423,20,37,.541,10,34,.294,23,27,.852,93,39,80,.488,36,64,.563,3,16,.188,21,23,.913,102,2015-11-25,HOU,MEM
69,Home,L 93-96 ,240,29,77,.377,25,58,.431,4,19,.211,31,38,.816,93,38,86,.442,33,69,.478,5,17,.294,15,20,.750,96,2015-12-01,MIN,ORL
70,@,L 93-95 ,240,36,82,.439,27,51,.529,9,31,.290,12,17,.706,93,36,90,.400,31,75,.413,5,15,.333,18,24,.750,95,2015-12-06,PHO,MEM
71,Home,L 93-111 ,240,37,90,.411,33,77,.429,4,13,.308,15,18,.833,93,40,81,.494,28,53,.528,12,28,.429,19,24,.792,111,2015-12-07,NOP,BOS
72,@,L 93-102 ,240,34,83,.410,27,64,.422,7,19,.368,18,20,.900,93,34,74,.459,25,49,.510,9,25,.360,25,32,.781,102,2015-12-07,LAL,TOR
73,@,W 93-92 ,240,41,88,.466,37,73,.507,4,15,.267,7,13,.538,93,37,87,.425,29,58,.500,8,29,.276,10,15,.667,92,2015-12-09,MEM,DET
74,Home,L 93-98 ,240,36,88,.409,25,53,.472,11,35,.314,10,10,1.000,93,40,96,.417,31,71,.437,9,25,.360,9,10,.900,98,2015-12-12,CHO,BOS
75,@,W 93-92 ,240,35,78,.449,20,48,.417,15,30,.500,8,14,.571,93,39,88,.443,35,70,.500,4,18,.222,10,12,.833,92,2015-12-22,DET,MIA
76,Home,L 93-99 ,240,35,91,.385,29,66,.439,6,25,.240,17,25,.680,93,39,84,.464,35,61,.574,4,23,.174,17,23,.739,99,2015-12-26,DET,BOS
77,@,L 93-103 ,240,38,79,.481,34,65,.523,4,14,.286,13,15,.867,93,38,84,.452,28,62,.452,10,22,.455,17,26,.654,103,2015-12-28,MIL,DAL
78,Home,W 93-87 ,240,38,87,.437,31,61,.508,7,26,.269,10,18,.556,93,31,74,.419,25,49,.510,6,25,.240,19,25,.760,87,2015-12-28,IND,ATL
79,@,W 93-87 ,240,38,86,.442,34,64,.531,4,22,.182,13,22,.591,93,37,89,.416,32,65,.492,5,24,.208,8,11,.727,87,2015-12-29,CLE,DEN
80,@,L 93-100 ,240,35,83,.422,32,63,.508,3,20,.150,20,22,.909,93,36,82,.439,27,56,.482,9,26,.346,19,21,.905,100,2015-12-30,BRK,ORL
81,Home,W 93-84 ,240,33,87,.379,28,71,.394,5,16,.313,22,29,.759,93,31,84,.369,27,60,.450,4,24,.167,18,25,.720,84,2016-01-01,LAL,PHI
82,@,W 93-91 ,240,33,68,.485,22,42,.524,11,26,.423,16,21,.762,93,30,75,.400,18,46,.391,12,29,.414,19,25,.760,91,2016-01-04,HOU,UTA
83,@,W 93-87 ,240,36,77,.468,30,57,.526,6,20,.300,15,21,.714,93,33,79,.418,29,63,.460,4,16,.250,17,22,.773,87,2016-01-10,DAL,MIN
84,@,L 93-113 ,240,34,85,.400,29,73,.397,5,12,.417,20,23,.870,93,47,89,.528,42,66,.636,5,23,.217,14,22,.636,113,2016-01-15,MIN,OKC
85,Home,L 93-112 ,240,32,90,.356,28,65,.431,4,25,.160,25,31,.806,93,43,89,.483,37,69,.536,6,20,.300,20,28,.714,112,2016-01-20,LAL,SAC
86,@,L 93-115 ,240,33,70,.471,25,50,.500,8,20,.400,19,25,.760,93,45,81,.556,34,53,.642,11,28,.393,14,16,.875,115,2016-01-27,PHO,CLE
87,@,L 93-103 ,240,38,87,.437,31,69,.449,7,18,.389,10,20,.500,93,37,85,.435,29,65,.446,8,20,.400,21,29,.724,103,2016-01-28,NYK,TOR
88,@,L 93-105 ,240,34,78,.436,29,65,.446,5,13,.385,20,25,.800,93,40,81,.494,32,55,.582,8,26,.308,17,24,.708,105,2016-01-29,LAL,LAC
89,@,L 93-120 ,240,40,93,.430,35,78,.449,5,15,.333,8,11,.727,93,45,84,.536,28,52,.538,17,32,.531,13,19,.684,120,2016-01-31,CHI,LAC
90,@,L 93-96 ,240,35,80,.438,31,64,.484,4,16,.250,19,28,.679,93,32,76,.421,26,49,.531,6,27,.222,26,30,.867,96,2016-01-31,MIN,POR
91,@,L 93-112 ,240,29,78,.372,21,53,.396,8,25,.320,27,39,.692,93,45,83,.542,35,61,.574,10,22,.455,12,15,.800,112,2016-02-01,TOR,DEN
92,@,W 93-90 ,240,37,88,.420,35,73,.479,2,15,.133,17,23,.739,93,34,87,.391,26,67,.388,8,20,.400,14,19,.737,90,2016-02-03,MIA,DAL
93,Home,L 93-107 ,240,34,81,.420,30,61,.492,4,20,.200,21,28,.750,93,40,74,.541,32,47,.681,8,27,.296,19,23,.826,107,2016-02-05,ORL,LAC
94,Home,L 93-100 ,240,33,83,.398,26,66,.394,7,17,.412,20,29,.690,93,37,81,.457,28,56,.500,9,25,.360,17,33,.515,100,2016-02-07,MIA,LAC
95,@,L 93-111 ,240,30,81,.370,23,56,.411,7,25,.280,26,36,.722,93,37,68,.544,27,45,.600,10,23,.435,27,44,.614,111,2016-02-19,BOS,UTA
96,@,L 93-101 (OT),265,36,92,.391,31,77,.403,5,15,.333,16,25,.640,93,38,100,.380,36,87,.414,2,13,.154,23,34,.676,101,2016-02-22,IND,MIA
97,@,L 93-116 ,240,34,84,.405,23,55,.418,11,29,.379,14,20,.700,93,43,107,.402,36,81,.444,7,26,.269,23,24,.958,116,2016-03-02,POR,BOS
98,@,L 93-114 ,240,35,80,.438,28,56,.500,7,24,.292,16,22,.727,93,38,67,.567,29,51,.569,9,16,.563,29,38,.763,114,2016-03-11,WAS,UTA
99,Home,W 93-85 ,240,34,85,.400,30,61,.492,4,24,.167,21,25,.840,93,31,81,.383,29,63,.460,2,18,.111,21,25,.840,85,2016-03-12,SAS,OKC
0,Home,L 93-101 ,240,35,83,.422,26,51,.510,9,32,.281,14,20,.700,93,38,87,.437,29,69,.420,9,18,.500,16,23,.696,101,2016-03-19,CHO,DEN
1,@,W 93-84 ,240,39,83,.470,30,62,.484,9,21,.429,6,7,.857,93,32,84,.381,28,73,.384,4,11,.364,16,19,.842,84,2016-03-26,UTA,MIN
2,Home,L 93-107 ,240,33,79,.418,25,56,.446,8,23,.348,19,28,.679,93,37,83,.446,23,49,.469,14,34,.412,19,25,.760,107,2016-03-26,NYK,CLE
3,@,L 93-105 ,240,37,89,.416,30,74,.405,7,15,.467,12,19,.632,93,38,80,.475,24,51,.471,14,29,.483,15,18,.833,105,2016-03-28,SAC,POR
4,@,L 93-110 ,240,34,88,.386,28,69,.406,6,19,.316,19,27,.704,93,41,79,.519,31,64,.484,10,15,.667,18,23,.783,110,2016-04-02,MIA,POR
5,@,L 93-107 ,240,37,82,.451,30,64,.469,7,18,.389,12,16,.750,93,40,88,.455,27,54,.500,13,34,.382,14,17,.824,107,2016-04-05,NOP,PHI
6,@,L 93-103 ,240,35,87,.402,28,65,.431,7,22,.318,16,22,.727,93,30,60,.500,18,29,.621,12,31,.387,31,39,.795,103,2016-04-08,MEM,DAL
7,@,W 93-89 ,240,37,78,.474,30,58,.517,7,20,.350,12,19,.632,93,32,89,.360,25,69,.362,7,20,.350,18,21,.857,89,2016-04-10,TOR,NYK
8,Home,L 93-99 ,240,34,84,.405,29,66,.439,5,18,.278,20,30,.667,93,38,78,.487,31,58,.534,7,20,.350,16,22,.727,99,2016-04-12,DET,MIA
9,Home,W 93-92 ,240,34,80,.425,23,49,.469,11,31,.355,14,21,.667,93,32,84,.381,21,54,.389,11,30,.367,17,20,.850,92,2016-10-30,HOU,DAL
10,@,L 93-109 ,240,34,86,.395,22,48,.458,12,38,.316,13,15,.867,93,39,79,.494,26,45,.578,13,34,.382,18,26,.692,109,2016-11-02,PHI,CHO
11,@,L 93-118 ,240,35,81,.432,25,50,.500,10,31,.323,13,22,.591,93,46,92,.500,36,71,.507,10,21,.476,16,20,.800,118,2016-11-09,BOS,WAS
12,@,L 93-100 ,240,36,95,.379,25,66,.379,11,29,.379,10,12,.833,93,39,92,.424,25,54,.463,14,38,.368,8,15,.533,100,2016-11-13,CHO,CLE
13,Home,W 93-77 ,240,34,78,.436,25,53,.472,9,25,.360,16,18,.889,93,32,84,.381,27,57,.474,5,27,.185,8,11,.727,77,2016-11-14,NYK,DAL
14,@,W 93-90 ,240,37,80,.463,31,63,.492,6,17,.353,13,19,.684,93,36,89,.404,29,66,.439,7,23,.304,11,14,.786,90,2016-11-15,ATL,MIA
15,@,L 93-103 ,240,35,86,.407,24,56,.429,11,30,.367,12,20,.600,93,43,86,.500,33,58,.569,10,28,.357,7,11,.636,103,2016-11-16,CLE,IND
16,Home,W 93-71 ,240,29,76,.382,27,58,.466,2,18,.111,33,38,.868,93,25,64,.391,18,42,.429,7,22,.318,14,22,.636,71,2016-11-19,MEM,MIN
17,Home,W 93-89 ,240,35,86,.407,27,57,.474,8,29,.276,15,21,.714,93,32,77,.416,25,52,.481,7,25,.280,18,24,.750,89,2016-11-21,MIL,ORL
18,Home,L 93-99 ,240,36,86,.419,32,62,.516,4,24,.167,17,25,.680,93,38,84,.452,26,46,.565,12,38,.316,11,14,.786,99,2016-11-21,MIN,BOS
19,Home,L 93-111 ,240,34,89,.382,22,49,.449,12,40,.300,13,16,.813,93,36,80,.450,21,46,.457,15,34,.441,24,29,.828,111,2016-12-01,BRK,MIL
20,Home,W 93-85 ,240,35,81,.432,23,58,.397,12,23,.522,11,16,.688,93,28,75,.373,19,50,.380,9,25,.360,20,31,.645,85,2016-12-14,MEM,CLE
21,Home,L 93-108 ,240,33,82,.402,22,49,.449,11,33,.333,16,21,.762,93,40,93,.430,30,76,.395,10,17,.588,18,26,.692,108,2016-12-20,PHI,NOP
22,Home,L 93-94 ,240,33,74,.446,24,47,.511,9,27,.333,18,22,.818,93,34,74,.459,24,53,.453,10,21,.476,16,24,.667,94,2016-12-21,UTA,SAC
23,Home,W 93-91 ,240,33,85,.388,26,53,.491,7,32,.219,20,25,.800,93,33,82,.402,26,58,.448,7,24,.292,18,20,.900,91,2017-01-03,PHI,MIN
24,@,L 93-101 ,240,34,73,.466,27,53,.509,7,20,.350,18,21,.857,93,36,91,.396,28,70,.400,8,21,.381,21,28,.750,101,2017-01-05,UTA,TOR
25,Home,L 93-100 ,240,38,91,.418,30,68,.441,8,23,.348,9,13,.692,93,39,86,.453,24,37,.649,15,49,.306,7,12,.583,100,2017-01-06,ORL,HOU
26,@,L 93-102 ,240,28,85,.329,22,62,.355,6,23,.261,31,32,.969,93,36,76,.474,22,38,.579,14,38,.368,16,20,.800,102,2017-01-13,CHO,PHI
27,@,L 93-109 ,240,36,87,.414,26,56,.464,10,31,.323,11,21,.524,93,44,91,.484,36,74,.486,8,17,.471,13,18,.722,109,2017-01-14,PHI,WAS
28,@,L 93-102 ,240,34,81,.420,27,53,.509,7,28,.250,18,19,.947,93,39,82,.476,30,60,.500,9,22,.409,15,19,.789,102,2017-01-20,CHI,ATL
29,Home,W 93-92 ,240,36,92,.391,24,63,.381,12,29,.414,9,16,.563,93,33,89,.371,27,70,.386,6,19,.316,20,28,.714,92,2017-01-20,PHI,POR
30,@,L 93-110 ,240,33,78,.423,21,49,.429,12,29,.414,15,18,.833,93,45,91,.495,38,71,.535,7,20,.350,13,23,.565,110,2017-01-21,PHI,ATL
31,@,L 93-103 ,240,35,85,.412,28,63,.444,7,22,.318,16,21,.762,93,35,76,.461,25,50,.500,10,26,.385,23,31,.742,103,2017-01-24,UTA,DEN
32,@,L 93-116 ,240,34,86,.395,27,60,.450,7,26,.269,18,21,.857,93,45,93,.484,33,61,.541,12,32,.375,14,19,.737,116,2017-02-01,ATL,MIA
33,Home,W 93-90 ,240,33,87,.379,25,61,.410,8,26,.308,19,29,.655,93,34,88,.386,27,60,.450,7,28,.250,15,21,.714,90,2017-02-06,IND,OKC
34,@,L 93-110 ,240,40,101,.396,33,66,.500,7,35,.200,6,14,.429,93,44,97,.454,34,73,.466,10,24,.417,12,17,.706,110,2017-02-24,LAL,OKC
35,@,L 93-104 ,240,39,84,.464,32,64,.500,7,20,.350,8,12,.667,93,37,86,.430,29,60,.483,8,26,.308,22,28,.786,104,2017-03-08,NYK,MIL
36,Home,W 92-78 ,240,35,77,.455,29,61,.475,6,16,.375,16,24,.667,92,28,70,.400,24,49,.490,4,21,.190,18,25,.720,78,2011-12-28,GSW,NYK
37,Home,W 92-89 ,240,39,86,.453,37,62,.597,2,24,.083,12,15,.800,92,34,80,.425,27,54,.500,7,26,.269,14,22,.636,89,2011-12-31,LAL,DEN
38,Home,L 92-114 ,240,30,86,.349,24,64,.375,6,22,.273,26,41,.634,92,40,89,.449,30,61,.492,10,28,.357,24,27,.889,114,2011-12-31,SAC,NYK
39,@,L 92-100 ,240,35,83,.422,32,72,.444,3,11,.273,19,23,.826,92,38,83,.458,28,63,.444,10,20,.500,14,21,.667,100,2012-01-02,WAS,BOS
40,Home,L 92-100 ,240,34,73,.466,29,60,.483,5,13,.385,19,28,.679,92,39,82,.476,30,66,.455,9,16,.563,13,20,.650,100,2012-01-02,MIA,ATL
41,Home,W 92-77 ,240,36,77,.468,26,50,.520,10,27,.370,10,13,.769,92,24,81,.296,17,58,.293,7,23,.304,22,26,.846,77,2012-01-04,TOR,CLE
42,Home,W 92-86 ,240,31,69,.449,27,50,.540,4,19,.211,26,40,.650,92,29,80,.363,23,60,.383,6,20,.300,22,27,.815,86,2012-01-07,LAC,MIL
43,Home,W 92-68 ,240,34,74,.459,31,58,.534,3,16,.188,21,25,.840,92,28,71,.394,27,67,.403,1,4,.250,11,14,.786,68,2012-01-09,CHI,DET
44,@,L 92-97 ,240,32,85,.376,24,61,.393,8,24,.333,20,25,.800,92,37,76,.487,32,62,.516,5,14,.357,18,23,.783,97,2012-01-13,CLE,LAL
45,@,L 92-104 ,240,34,83,.410,29,64,.453,5,19,.263,19,23,.826,92,34,71,.479,27,53,.509,7,18,.389,29,34,.853,104,2012-01-14,NYK,OKC
46,Home,W 92-89 ,240,33,71,.465,28,60,.467,5,11,.455,21,27,.778,92,35,92,.380,30,73,.411,5,19,.263,14,20,.700,89,2012-01-18,ATL,POR
47,Home,W 92-88 ,240,28,93,.301,20,62,.323,8,31,.258,28,41,.683,92,34,78,.436,33,65,.508,1,13,.077,19,27,.704,88,2012-01-18,SAC,IND
48,Home,W 92-80 ,240,32,77,.416,20,50,.400,12,27,.444,16,26,.615,92,29,76,.382,23,56,.411,6,20,.300,16,22,.727,80,2012-01-20,ORL,LAL
49,@,L 92-113 ,240,37,83,.446,29,68,.426,8,15,.533,10,15,.667,92,44,81,.543,37,65,.569,7,16,.438,18,21,.857,113,2012-01-21,PHI,MIA
50,Home,L 92-97 ,240,37,92,.402,32,75,.427,5,17,.294,13,17,.765,92,38,83,.458,35,72,.486,3,11,.273,18,21,.857,97,2012-01-23,MIL,ATL
51,Home,L 92-107 ,240,33,80,.413,28,68,.412,5,12,.417,21,27,.778,92,39,86,.453,32,65,.492,7,21,.333,22,28,.786,107,2012-01-23,MIN,HOU
52,Home,W 92-85 ,240,32,70,.457,27,52,.519,5,18,.278,23,26,.885,92,34,68,.500,28,52,.538,6,16,.375,11,17,.647,85,2012-01-24,MIA,CLE
53,Home,W 92-75 ,240,39,83,.470,36,73,.493,3,10,.300,11,16,.688,92,28,78,.359,27,69,.391,1,9,.111,18,25,.720,75,2012-01-25,WAS,CHA
54,@,L 92-95 ,240,40,88,.455,36,70,.514,4,18,.222,8,16,.500,92,34,76,.447,29,59,.492,5,17,.294,22,29,.759,95,2012-02-02,POR,SAC
55,@,L 92-99 ,240,30,72,.417,20,46,.435,10,26,.385,22,26,.846,92,37,83,.446,35,69,.507,2,14,.143,23,26,.885,99,2012-02-04,NJN,NYK
56,Home,L 92-100 ,240,34,81,.420,31,72,.431,3,9,.333,21,26,.808,92,37,78,.474,29,54,.537,8,24,.333,18,25,.720,100,2012-02-06,NOH,SAC
57,@,L 92-99 ,240,32,78,.410,29,63,.460,3,15,.200,25,29,.862,92,36,71,.507,29,53,.547,7,18,.389,20,26,.769,99,2012-02-08,LAC,CLE
58,Home,L 92-99 ,240,33,78,.423,23,51,.451,10,27,.370,16,20,.800,92,39,73,.534,37,64,.578,2,9,.222,19,29,.655,99,2012-02-08,NJN,DET
59,@,L 92-109 ,240,31,74,.419,26,55,.473,5,19,.263,25,31,.806,92,43,79,.544,39,69,.565,4,10,.400,19,25,.760,109,2012-02-10,NJN,DET
60,@,L 92-98 ,240,30,78,.385,24,62,.387,6,16,.375,26,37,.703,92,34,73,.466,33,64,.516,1,9,.111,29,37,.784,98,2012-02-10,IND,MEM
61,Home,W 92-85 ,240,33,77,.429,28,56,.500,5,21,.238,21,34,.618,92,30,80,.375,24,56,.429,6,24,.250,19,23,.826,85,2012-02-10,NYK,LAL
62,Home,L 92-94 ,240,37,78,.474,31,67,.463,6,11,.545,12,17,.706,92,35,81,.432,25,58,.431,10,23,.435,14,20,.700,94,2012-02-12,TOR,LAL
63,@,L 92-96 ,240,33,74,.446,23,47,.489,10,27,.370,16,25,.640,92,35,79,.443,29,61,.475,6,18,.333,20,28,.714,96,2012-02-13,LAC,DAL
64,@,L 92-109 ,240,33,99,.333,24,75,.320,9,24,.375,17,19,.895,92,40,78,.513,36,64,.563,4,14,.286,25,34,.735,109,2012-02-14,PHO,DEN
65,@,W 92-89 ,240,36,80,.450,29,65,.446,7,15,.467,13,17,.765,92,33,86,.384,26,68,.382,7,18,.389,16,18,.889,89,2012-02-15,NOH,MIL
66,@,L 92-93 ,240,35,93,.376,31,74,.419,4,19,.211,18,25,.720,92,32,89,.360,25,67,.373,7,22,.318,22,30,.733,93,2012-02-19,SAC,CLE
67,Home,W 92-91 ,240,33,85,.388,30,69,.435,3,16,.188,23,26,.885,92,40,90,.444,37,79,.468,3,11,.273,8,10,.800,91,2012-02-19,MIN,PHI
68,@,W 92-85 ,240,33,86,.384,26,67,.388,7,19,.368,19,24,.792,92,29,85,.341,24,62,.387,5,23,.217,22,33,.667,85,2012-02-19,MIL,NJN
69,@,L 92-103 ,240,32,78,.410,20,55,.364,12,23,.522,16,22,.727,92,38,83,.458,30,64,.469,8,19,.421,19,22,.864,103,2012-02-20,POR,LAL
70,Home,L 92-100 ,240,34,85,.400,29,64,.453,5,21,.238,19,26,.731,92,32,82,.390,17,51,.333,15,31,.484,21,29,.724,100,2012-02-20,NYK,NJN
71,Home,L 92-93 ,240,32,89,.360,24,64,.375,8,25,.320,20,28,.714,92,37,84,.440,30,59,.508,7,25,.280,12,14,.857,93,2012-02-28,DAL,NJN
72,@,W 92-88 ,240,30,78,.385,24,59,.407,6,19,.316,26,34,.765,92,37,90,.411,33,73,.452,4,17,.235,10,12,.833,88,2012-02-29,OKC,PHI
73,@,L 92-97 ,240,37,83,.446,26,54,.481,11,29,.379,7,10,.700,92,40,88,.455,37,75,.493,3,13,.231,14,17,.824,97,2012-03-02,DAL,NOH
74,Home,W 92-72 ,240,33,78,.423,24,63,.381,9,15,.600,17,27,.630,92,27,79,.342,24,63,.381,3,16,.188,15,22,.682,72,2012-03-05,CHI,IND
75,@,W 92-88 ,240,35,79,.443,26,51,.510,9,28,.321,13,28,.464,92,32,79,.405,24,59,.407,8,20,.400,16,20,.800,88,2012-03-05,ORL,TOR
76,@,L 92-97 (OT),265,32,83,.386,27,64,.422,5,19,.263,23,29,.793,92,35,81,.432,31,67,.463,4,14,.286,23,31,.742,97,2012-03-06,HOU,BOS
77,Home,L 92-110 ,240,35,79,.443,27,61,.443,8,18,.444,14,23,.609,92,42,80,.525,35,61,.574,7,19,.368,19,21,.905,110,2012-03-07,GSW,MEM
78,Home,W 92-75 ,240,40,82,.488,36,71,.507,4,11,.364,8,15,.533,92,20,64,.313,15,42,.357,5,22,.227,30,38,.789,75,2012-03-13,IND,POR
79,@,L 92-97 ,240,37,92,.402,33,70,.471,4,22,.182,14,20,.700,92,33,80,.413,23,58,.397,10,22,.455,21,27,.778,97,2012-03-16,MIN,LAL
80,@,L 92-99 (OT),265,33,80,.413,27,55,.491,6,25,.240,20,25,.800,92,42,101,.416,40,88,.455,2,13,.154,13,16,.813,99,2012-03-17,GSW,UTA
81,@,L 92-97 ,240,37,78,.474,31,60,.517,6,18,.333,12,19,.632,92,34,85,.400,32,78,.410,2,7,.286,27,37,.730,97,2012-03-18,WAS,MEM
82,Home,L 92-101 ,240,39,79,.494,36,70,.514,3,9,.333,11,14,.786,92,39,89,.438,25,60,.417,14,29,.483,9,10,.900,101,2012-03-21,NOH,GSW
83,Home,L 92-112 ,240,34,84,.405,33,76,.434,1,8,.125,23,26,.885,92,48,90,.533,44,77,.571,4,13,.308,12,21,.571,112,2012-03-23,CHA,MIL
84,Home,L 92-95 ,240,38,85,.447,34,67,.507,4,18,.222,12,14,.857,92,37,76,.487,30,53,.566,7,23,.304,14,21,.667,95,2012-03-24,WAS,ATL
85,Home,W 92-78 ,240,36,74,.486,32,65,.492,4,9,.444,16,17,.941,92,30,91,.330,22,67,.328,8,24,.333,10,15,.667,78,2012-04-01,OKC,CHI
86,Home,W 92-75 ,240,35,71,.493,32,56,.571,3,15,.200,19,21,.905,92,32,77,.416,28,68,.412,4,9,.444,7,9,.778,75,2012-04-01,PHO,NOH
87,@,L 92-99 ,240,34,71,.479,26,51,.510,8,20,.400,16,20,.800,92,37,77,.481,33,60,.550,4,17,.235,21,23,.913,99,2012-04-01,WAS,TOR
88,Home,W 92-87 ,240,35,76,.461,28,58,.483,7,18,.389,15,22,.682,92,31,77,.403,27,65,.415,4,12,.333,21,30,.700,87,2012-04-03,TOR,CHA
89,@,L 92-94 ,240,35,83,.422,29,63,.460,6,20,.300,16,22,.727,92,35,67,.522,30,57,.526,5,10,.500,19,27,.704,94,2012-04-04,DEN,NOH
90,Home,W 92-77 ,240,36,81,.444,27,61,.443,9,20,.450,11,16,.688,92,27,72,.375,22,50,.440,5,22,.227,18,29,.621,77,2012-04-16,LAC,OKC
91,@,L 92-97 ,240,39,81,.481,34,69,.493,5,12,.417,9,14,.643,92,37,72,.514,28,55,.509,9,17,.529,14,17,.824,97,2012-04-20,BOS,ATL
92,Home,L 92-103 ,240,38,93,.409,33,77,.429,5,16,.313,11,18,.611,92,40,75,.533,36,63,.571,4,12,.333,19,22,.864,103,2012-04-20,SAC,OKC
93,Home,W 92-86 ,240,29,78,.372,23,61,.377,6,17,.353,28,36,.778,92,34,76,.447,30,62,.484,4,14,.286,14,18,.778,86,2012-04-23,MIL,TOR
94,@,W 92-87 ,240,38,81,.469,32,64,.500,6,17,.353,10,10,1.000,92,35,80,.438,29,66,.439,6,14,.429,11,16,.688,87,2012-04-25,CHI,IND
95,@,L 92-101 ,240,33,86,.384,31,72,.431,2,14,.143,24,30,.800,92,38,74,.514,33,59,.559,5,15,.333,20,29,.690,101,2012-10-31,MEM,LAC
96,Home,W 92-80 ,240,32,87,.368,30,70,.429,2,17,.118,26,36,.722,92,32,89,.360,29,73,.397,3,16,.188,13,16,.813,80,2012-11-02,MIN,SAC
97,@,L 92-106 ,240,32,89,.360,23,63,.365,9,26,.346,19,24,.792,92,39,76,.513,34,67,.507,5,9,.556,23,32,.719,106,2012-11-02,POR,OKC
98,Home,W 92-89 ,240,40,92,.435,38,81,.469,2,11,.182,10,14,.714,92,37,90,.411,33,77,.429,4,13,.308,11,19,.579,89,2012-11-02,PHO,DET
99,@,L 92-94 ,240,31,78,.397,25,57,.439,6,21,.286,24,28,.857,92,37,81,.457,33,62,.532,4,19,.211,16,23,.696,94,2012-11-05,GSW,SAC
0,Home,L 92-96 ,240,35,88,.398,32,69,.464,3,19,.158,19,26,.731,92,32,72,.444,27,57,.474,5,15,.333,27,34,.794,96,2012-11-10,MIL,BOS
1,@,W 92-90 ,240,27,73,.370,26,63,.413,1,10,.100,37,42,.881,92,33,83,.398,27,66,.409,6,17,.353,18,27,.667,90,2012-11-12,OKC,DET
2,Home,W 92-76 ,240,31,78,.397,28,65,.431,3,13,.231,27,32,.844,92,25,84,.298,20,53,.377,5,31,.161,21,32,.656,76,2012-11-13,CHA,WAS
3,Home,W 92-88 ,240,33,71,.465,28,53,.528,5,18,.278,21,25,.840,92,34,78,.436,27,55,.491,7,23,.304,13,18,.722,88,2012-11-14,GSW,ATL
4,Home,L 92-97 ,240,36,78,.462,30,61,.492,6,17,.353,14,17,.824,92,36,81,.444,31,66,.470,5,15,.333,20,28,.714,97,2012-11-19,MEM,DEN
5,@,W 92-87 ,240,40,85,.471,39,73,.534,1,12,.083,11,19,.579,92,29,82,.354,23,62,.371,6,20,.300,23,28,.821,87,2012-11-19,LAC,SAS
6,Home,W 92-83 ,240,35,86,.407,22,63,.349,13,23,.565,9,14,.643,92,31,86,.360,27,69,.391,4,17,.235,17,22,.773,83,2012-11-21,CLE,PHI
7,Home,L 92-93 ,240,35,80,.438,30,69,.435,5,11,.455,17,19,.895,92,39,85,.459,36,70,.514,3,15,.200,12,19,.632,93,2012-11-26,CHI,MIL
8,Home,L 92-118 ,240,37,90,.411,33,76,.434,4,14,.286,14,17,.824,92,45,80,.563,32,57,.561,13,23,.565,15,20,.750,118,2012-11-26,WAS,SAS
9,Home,L 92-97 ,240,32,75,.427,26,58,.448,6,17,.353,22,25,.880,92,37,85,.435,28,59,.475,9,26,.346,14,19,.737,97,2012-11-30,SAC,IND
10,Home,W 92-77 ,240,38,93,.409,27,68,.397,11,25,.440,5,8,.625,92,29,85,.341,24,64,.375,5,21,.238,14,18,.778,77,2012-12-01,DAL,DET
11,@,L 92-103 ,240,34,74,.459,26,52,.500,8,22,.364,16,20,.800,92,38,80,.475,29,60,.483,9,20,.450,18,19,.947,103,2012-12-01,IND,GSW
12,@,L 92-99 ,240,34,79,.430,28,57,.491,6,22,.273,18,22,.818,92,36,80,.450,27,54,.500,9,26,.346,18,19,.947,99,2012-12-05,POR,IND
13,Home,L 92-112 ,240,32,76,.421,26,60,.433,6,16,.375,22,28,.786,92,41,91,.451,23,47,.489,18,44,.409,12,19,.632,112,2012-12-06,MIA,NYK
14,@,W 92-89 ,240,38,86,.442,35,69,.507,3,17,.176,13,20,.650,92,34,76,.447,24,53,.453,10,23,.435,11,18,.611,89,2012-12-07,DEN,IND
15,@,L 92-114 ,240,37,95,.389,26,62,.419,11,33,.333,7,8,.875,92,48,87,.552,42,67,.627,6,20,.300,12,13,.923,114,2012-12-07,HOU,SAS
16,Home,W 92-79 ,240,40,75,.533,36,61,.590,4,14,.286,8,12,.667,92,31,79,.392,27,62,.435,4,17,.235,13,16,.813,79,2012-12-08,BOS,PHI
17,@,L 92-101 ,240,32,75,.427,23,47,.489,9,28,.321,19,20,.950,92,39,67,.582,30,46,.652,9,21,.429,14,22,.636,101,2012-12-10,ATL,MIA
18,Home,W 92-74 ,240,36,89,.404,36,69,.522,0,20,.000,20,22,.909,92,26,74,.351,23,53,.434,3,21,.143,19,21,.905,74,2012-12-10,POR,TOR
19,Home,W 92-88 ,240,31,71,.437,26,56,.464,5,15,.333,25,32,.781,92,33,83,.398,24,61,.393,9,22,.409,13,16,.813,88,2012-12-12,OKC,NOH
20,@,W 92-90 ,240,37,83,.446,32,63,.508,5,20,.250,13,16,.813,92,33,77,.429,26,60,.433,7,17,.412,17,22,.773,90,2012-12-18,UTA,BRK
21,@,L 92-103 ,240,37,86,.430,33,69,.478,4,17,.235,14,19,.737,92,36,77,.468,23,52,.442,13,25,.520,18,23,.783,103,2012-12-18,MIN,MIA
22,Home,L 92-100 ,240,36,94,.383,27,70,.386,9,24,.375,11,17,.647,92,36,84,.429,27,59,.458,9,25,.360,19,20,.950,100,2012-12-19,ATL,OKC
23,Home,W 92-82 ,240,36,89,.404,33,76,.434,3,13,.231,17,20,.850,92,31,76,.408,25,55,.455,6,21,.286,14,17,.824,82,2012-12-21,MEM,DAL
24,Home,W 92-75 ,240,38,77,.494,31,58,.534,7,19,.368,9,10,.900,92,32,76,.421,27,62,.435,5,14,.357,6,8,.750,75,2012-12-22,ATL,CHI
25,@,L 92-95 ,240,38,88,.432,30,70,.429,8,18,.444,8,10,.800,92,33,74,.446,25,52,.481,8,22,.364,21,30,.700,95,2012-12-23,PHI,BRK
26,Home,L 92-105 ,240,34,78,.436,29,64,.453,5,14,.357,19,28,.679,92,37,81,.457,25,58,.431,12,23,.522,19,25,.760,105,2012-12-26,CHA,MIA
27,Home,W 92-78 ,240,37,82,.451,30,59,.508,7,23,.304,11,21,.524,92,30,78,.385,25,49,.510,5,29,.172,13,29,.448,78,2013-01-01,DEN,LAC
28,@,L 92-104 ,240,38,90,.422,33,74,.446,5,16,.313,11,20,.550,92,41,83,.494,36,59,.610,5,24,.208,17,23,.739,104,2013-01-02,NOH,HOU
29,@,W 92-81 ,240,37,69,.536,35,61,.574,2,8,.250,16,20,.800,92,31,79,.392,26,65,.400,5,14,.357,14,18,.778,81,2013-01-06,MEM,PHO
30,Home,L 92-104 ,240,34,76,.447,26,53,.491,8,23,.348,16,21,.762,92,38,77,.494,32,55,.582,6,22,.273,22,24,.917,104,2013-01-06,TOR,OKC
31,@,L 92-118 ,240,33,78,.423,26,64,.406,7,14,.500,19,23,.826,92,44,82,.537,34,68,.500,10,14,.714,20,24,.833,118,2013-01-07,CLE,CHI
32,Home,W 92-90 ,240,30,80,.375,21,53,.396,9,27,.333,23,30,.767,92,35,77,.455,29,58,.500,6,19,.316,14,20,.700,90,2013-01-10,POR,MIA
33,@,L 92-104 ,240,31,69,.449,27,51,.529,4,18,.222,26,33,.788,92,44,84,.524,36,62,.581,8,22,.364,8,9,.889,104,2013-01-11,MIN,NOH
34,@,W 92-75 ,240,36,90,.400,28,61,.459,8,29,.276,12,18,.667,92,29,80,.363,26,68,.382,3,12,.250,14,18,.778,75,2013-01-16,MIA,GSW
35,Home,W 92-79 ,240,30,64,.469,27,50,.540,3,14,.214,29,36,.806,92,25,78,.321,17,47,.362,8,31,.258,21,28,.750,79,2013-01-19,MIN,HOU
36,Home,L 92-104 ,240,31,76,.408,25,61,.410,6,15,.400,24,29,.828,92,43,87,.494,31,62,.500,12,25,.480,6,12,.500,104,2013-01-23,CHA,ATL
37,Home,W 92-88 ,240,38,85,.447,35,73,.479,3,12,.250,13,19,.684,92,31,86,.360,24,68,.353,7,18,.389,19,26,.731,88,2013-01-23,UTA,WAS
38,@,L 92-93 ,240,33,85,.388,24,63,.381,9,22,.409,17,23,.739,92,36,75,.480,26,49,.531,10,26,.385,11,18,.611,93,2013-01-30,TOR,ATL
39,Home,W 92-84 ,240,40,95,.421,34,82,.415,6,13,.462,6,10,.600,92,30,75,.400,23,53,.434,7,22,.318,17,21,.810,84,2013-01-30,PHI,WAS
40,Home,W 92-86 ,240,38,83,.458,35,71,.493,3,12,.250,13,15,.867,92,33,78,.423,25,51,.490,8,27,.296,12,19,.632,86,2013-01-30,PHO,LAL
41,@,W 92-83 ,240,37,82,.451,34,69,.493,3,13,.231,15,18,.833,92,31,89,.348,25,66,.379,6,23,.261,15,19,.789,83,2013-02-05,LAL,BRK
42,@,L 92-103 ,240,38,84,.452,33,72,.458,5,12,.417,11,16,.688,92,38,74,.514,28,50,.560,10,24,.417,17,23,.739,103,2013-02-06,MEM,ATL
43,Home,L 92-100 ,240,40,79,.506,35,61,.574,5,18,.278,7,11,.636,92,39,75,.520,31,61,.508,8,14,.571,14,17,.824,100,2013-02-11,CLE,MIN
44,@,L 92-94 ,240,34,76,.447,30,63,.476,4,13,.308,20,24,.833,92,37,88,.420,33,70,.471,4,18,.222,16,21,.762,94,2013-02-13,PHI,MIL
45,@,W 92-88 ,240,31,73,.425,22,52,.423,9,21,.429,21,24,.875,92,28,79,.354,19,54,.352,9,25,.360,23,32,.719,88,2013-02-13,TOR,NYK
46,Home,L 92-105 ,240,37,89,.416,33,64,.516,4,25,.160,14,17,.824,92,38,81,.469,29,57,.509,9,24,.375,20,27,.741,105,2013-02-19,ORL,CHA
47,Home,W 92-86 ,240,35,79,.443,28,58,.483,7,21,.333,15,19,.789,92,36,85,.424,34,72,.472,2,13,.154,12,15,.800,86,2013-02-24,POR,BOS
48,@,L 92-103 ,240,35,78,.449,33,58,.569,2,20,.100,20,25,.800,92,34,82,.415,29,69,.420,5,13,.385,30,32,.938,103,2013-02-27,TOR,CLE
49,Home,W 92-87 ,240,36,81,.444,26,59,.441,10,22,.455,10,12,.833,92,31,73,.425,23,50,.460,8,23,.348,17,22,.773,87,2013-03-01,PHO,ATL
50,@,L 92-97 ,240,35,81,.432,27,62,.435,8,19,.421,14,18,.778,92,33,71,.465,27,58,.466,6,13,.462,25,33,.758,97,2013-03-03,CHI,IND
51,@,L 92-107 ,240,36,85,.424,29,63,.460,7,22,.318,13,16,.813,92,43,77,.558,32,54,.593,11,23,.478,10,12,.833,107,2013-03-07,LAC,DEN
52,Home,L 92-103 ,240,33,72,.458,27,58,.466,6,14,.429,20,26,.769,92,45,86,.523,41,75,.547,4,11,.364,9,11,.818,103,2013-03-08,CLE,MEM
53,Home,W 92-63 ,240,32,78,.410,21,58,.362,11,20,.550,17,24,.708,92,20,73,.274,15,46,.326,5,27,.185,18,28,.643,63,2013-03-11,GSW,NYK
54,@,L 92-96 ,240,36,92,.391,28,63,.444,8,29,.276,12,16,.750,92,37,79,.468,29,57,.509,8,22,.364,14,21,.667,96,2013-03-13,LAL,ATL
55,Home,W 92-91 ,240,37,84,.440,32,71,.451,5,13,.385,13,17,.765,92,37,83,.446,29,64,.453,8,19,.421,9,10,.900,91,2013-03-14,SAS,DAL
56,Home,W 92-78 ,240,33,68,.485,30,58,.517,3,10,.300,23,27,.852,92,26,80,.325,20,58,.345,6,22,.273,20,29,.690,78,2013-03-15,TOR,CHA
57,Home,W 92-77 ,240,40,82,.488,35,66,.530,5,16,.313,7,11,.636,92,29,86,.337,23,62,.371,6,24,.250,13,18,.722,77,2013-03-18,MEM,MIN
58,@,W 92-91 ,240,36,79,.456,26,53,.491,10,26,.385,10,14,.714,92,32,75,.427,28,58,.483,4,17,.235,23,25,.920,91,2013-03-23,DET,CHA
59,@,L 92-101 ,240,36,88,.409,29,71,.408,7,17,.412,13,16,.813,92,37,75,.493,27,55,.491,10,20,.500,17,22,.773,101,2013-03-23,WAS,GSW
60,Home,L 92-93 ,240,38,86,.442,31,69,.449,7,17,.412,9,14,.643,92,34,76,.447,29,62,.468,5,14,.357,20,28,.714,93,2013-03-27,CLE,BOS
61,@,L 92-100 ,240,37,89,.416,31,65,.477,6,24,.250,12,13,.923,92,42,89,.472,34,73,.466,8,16,.500,8,9,.889,100,2013-03-27,MIL,PHI
62,@,L 92-97 ,240,30,81,.370,26,61,.426,4,20,.200,28,32,.875,92,37,86,.430,32,71,.451,5,15,.333,18,22,.818,97,2013-03-29,WAS,ORL
63,@,L 92-100 ,240,38,76,.500,36,68,.529,2,8,.250,14,23,.609,92,38,73,.521,33,57,.579,5,16,.313,19,27,.704,100,2013-03-30,CHA,PHI
64,@,L 92-112 ,240,38,82,.463,31,64,.484,7,18,.389,9,12,.750,92,40,74,.541,28,53,.528,12,21,.571,20,29,.690,112,2013-03-31,CLE,NOH
65,@,L 92-109 ,240,32,81,.395,25,62,.403,7,19,.368,21,26,.808,92,41,85,.482,32,68,.471,9,17,.529,18,28,.643,109,2013-03-31,TOR,WAS
66,Home,W 92-90 ,240,36,79,.456,34,72,.472,2,7,.286,18,24,.750,92,36,75,.480,28,52,.538,8,23,.348,10,11,.909,90,2013-04-01,MEM,SAS
67,@,W 92-90 ,240,38,82,.463,34,71,.479,4,11,.364,12,19,.632,92,31,70,.443,26,57,.456,5,13,.385,23,30,.767,90,2013-04-04,CHI,BRK
68,Home,L 92-95 ,240,34,80,.425,27,59,.458,7,21,.333,17,19,.895,92,32,80,.400,28,65,.431,4,15,.267,27,29,.931,95,2013-04-07,PHO,NOH
69,@,L 92-95 ,240,36,85,.424,29,69,.420,7,16,.438,13,17,.765,92,37,78,.474,30,60,.500,7,18,.389,14,19,.737,95,2013-04-17,WAS,CHI
70,@,L 92-98 ,240,37,90,.411,35,69,.507,2,21,.095,16,17,.941,92,39,91,.429,30,67,.448,9,24,.375,11,16,.688,98,2013-04-17,ATL,NYK
71,@,L 92-93 ,240,34,94,.362,29,66,.439,5,28,.179,19,24,.792,92,39,85,.459,34,69,.493,5,16,.313,10,11,.909,93,2013-11-04,MIN,CLE
72,Home,W 92-90 ,240,36,73,.493,33,58,.569,3,15,.200,17,30,.567,92,35,79,.443,28,63,.444,7,16,.438,13,15,.867,90,2013-11-06,CHA,TOR
73,Home,W 92-79 ,240,39,77,.506,31,55,.564,8,22,.364,6,8,.750,92,33,91,.363,28,76,.368,5,15,.333,8,11,.727,79,2013-11-13,SAS,WAS
74,@,W 92-79 ,240,34,82,.415,29,65,.446,5,17,.294,19,27,.704,92,30,86,.349,22,64,.344,8,22,.364,11,15,.733,79,2013-11-16,OKC,MIL
75,Home,W 92-86 ,240,35,70,.500,28,51,.549,7,19,.368,15,21,.714,92,33,76,.434,27,52,.519,6,24,.250,14,18,.778,86,2013-11-19,DET,NYK
76,Home,L 92-120 ,240,29,71,.408,14,42,.333,15,29,.517,19,21,.905,92,38,74,.514,23,50,.460,15,24,.625,29,32,.906,120,2013-11-20,ORL,MIA
77,@,L 92-107 ,240,33,83,.398,25,51,.490,8,32,.250,18,24,.750,92,39,79,.494,32,57,.561,7,22,.318,22,24,.917,107,2013-11-25,PHO,MIA
78,Home,L 92-109 ,240,30,73,.411,21,51,.412,9,22,.409,23,27,.852,92,42,83,.506,34,61,.557,8,22,.364,17,20,.850,109,2013-11-26,ATL,ORL
79,Home,L 92-100 (OT),265,37,85,.435,27,60,.450,10,25,.400,8,10,.800,92,37,74,.500,27,48,.563,10,26,.385,16,22,.727,100,2013-11-27,MIL,WAS
80,Home,W 92-76 ,240,35,79,.443,32,64,.500,3,15,.200,19,31,.613,92,28,84,.333,23,67,.343,5,17,.294,15,20,.750,76,2013-11-29,CHA,MIL
81,Home,W 92-85 ,240,36,78,.462,28,61,.459,8,17,.471,12,20,.600,92,35,84,.417,31,65,.477,4,19,.211,11,15,.733,85,2013-11-30,MIL,BOS
82,@,W 92-75 ,240,34,80,.425,22,61,.361,12,19,.632,12,15,.800,92,30,90,.333,27,72,.375,3,18,.167,12,15,.800,75,2013-12-07,DET,CHI
83,Home,L 92-103 ,240,40,88,.455,37,72,.514,3,16,.188,9,14,.643,92,35,83,.422,28,61,.459,7,22,.318,26,34,.765,103,2013-12-07,PHI,DEN
84,Home,L 92-101 ,240,31,87,.356,22,61,.361,9,26,.346,21,27,.778,92,38,86,.442,34,68,.500,4,18,.222,21,28,.750,101,2013-12-10,ATL,OKC
85,@,W 92-83 ,240,38,90,.422,31,71,.437,7,19,.368,9,9,1.000,92,31,84,.369,27,67,.403,4,17,.235,17,18,.944,83,2013-12-11,ORL,CHA
86,@,L 92-115 ,240,37,76,.487,31,58,.534,6,18,.333,12,21,.571,92,39,76,.513,28,53,.528,11,23,.478,26,35,.743,115,2013-12-16,SAS,LAC
87,Home,L 92-96 ,240,37,91,.407,32,75,.427,5,16,.313,13,17,.765,92,37,75,.493,30,53,.566,7,22,.318,15,19,.789,96,2013-12-17,MEM,LAL
88,Home,L 92-115 ,240,34,88,.386,26,60,.433,8,28,.286,16,24,.667,92,46,96,.479,36,72,.500,10,24,.417,13,18,.722,115,2013-12-23,CLE,DET
89,@,L 92-100 ,240,38,93,.409,33,75,.440,5,18,.278,11,20,.550,92,31,71,.437,26,47,.553,5,24,.208,33,40,.825,100,2013-12-26,MEM,HOU
90,@,L 92-109 ,240,39,95,.411,34,77,.442,5,18,.278,9,18,.500,92,45,85,.529,41,71,.577,4,14,.286,15,23,.652,109,2013-12-27,DET,ORL
91,@,W 92-91 ,240,33,91,.363,28,62,.452,5,29,.172,21,25,.840,92,35,84,.417,30,64,.469,5,20,.250,16,17,.941,91,2013-12-31,ATL,BOS
92,@,L 92-113 ,240,37,84,.440,32,69,.464,5,15,.333,13,15,.867,92,40,78,.513,31,58,.534,9,20,.450,24,28,.857,113,2013-12-31,BRK,SAS
93,Home,L 92-95 ,240,31,89,.348,24,60,.400,7,29,.241,23,28,.821,92,38,77,.494,36,71,.507,2,6,.333,17,22,.773,95,2014-01-03,BOS,NOP
94,@,L 92-116 ,240,37,79,.468,34,64,.531,3,15,.200,15,21,.714,92,50,90,.556,46,72,.639,4,18,.222,12,16,.750,116,2014-01-04,LAC,SAS
95,@,W 92-80 ,240,37,76,.487,32,63,.508,5,13,.385,13,16,.813,92,32,78,.410,26,52,.500,6,26,.231,10,18,.556,80,2014-01-05,NYK,DAL
96,Home,W 92-87 ,240,36,82,.439,30,68,.441,6,14,.429,14,23,.609,92,33,82,.402,27,59,.458,6,23,.261,15,19,.789,87,2014-01-07,CHI,PHO
97,@,L 92-102 ,240,37,68,.544,30,47,.638,7,21,.333,11,21,.524,92,44,82,.537,35,58,.603,9,24,.375,5,10,.500,102,2014-01-09,MIA,NYK
98,@,L 92-119 ,240,37,84,.440,29,65,.446,8,19,.421,10,14,.714,92,48,88,.545,39,69,.565,9,19,.474,14,19,.737,119,2014-01-10,CHA,MIN
99,Home,L 92-102 ,240,36,78,.462,31,59,.525,5,19,.263,15,21,.714,92,39,82,.476,33,64,.516,6,18,.333,18,23,.783,102,2014-01-11,PHI,NYK
0,Home,L 92-104 ,240,38,101,.376,35,84,.417,3,17,.176,13,14,.929,92,37,79,.468,29,60,.483,8,19,.421,22,34,.647,104,2014-01-13,BOS,HOU
1,@,L 92-116 ,240,39,92,.424,35,79,.443,4,13,.308,10,17,.588,92,45,82,.549,39,66,.591,6,16,.375,20,25,.800,116,2014-01-14,SAC,IND
2,@,L 92-95 ,240,35,88,.398,30,68,.441,5,20,.250,17,26,.654,92,39,77,.506,33,62,.532,6,15,.400,11,20,.550,95,2014-01-15,CHA,PHI
3,Home,L 92-104 ,240,33,82,.402,21,48,.438,12,34,.353,14,21,.667,92,38,82,.463,32,57,.561,6,25,.240,22,25,.880,104,2014-01-16,HOU,OKC
4,@,L 92-106 ,240,33,83,.398,28,63,.444,5,20,.250,21,24,.875,92,38,83,.458,29,64,.453,9,19,.474,21,22,.955,106,2014-01-18,LAC,IND
5,Home,L 92-95 ,240,31,74,.419,24,55,.436,7,19,.368,23,28,.821,92,35,77,.455,30,68,.441,5,9,.556,20,23,.870,95,2014-01-20,MEM,NOP
6,@,L 92-100 ,240,36,77,.468,33,62,.532,3,15,.200,17,19,.895,92,37,81,.457,32,69,.464,5,12,.417,21,27,.778,100,2014-01-26,ORL,NOP
7,Home,L 92-104 ,240,37,94,.394,32,70,.457,5,24,.208,13,16,.813,92,42,99,.424,37,78,.474,5,21,.238,15,27,.556,104,2014-01-28,LAL,IND
8,@,L 92-111 ,240,31,76,.408,23,52,.442,8,24,.333,22,34,.647,92,45,91,.495,39,70,.557,6,21,.286,15,20,.750,111,2014-01-30,LAC,GSW
9,@,L 92-106 ,240,38,87,.437,30,57,.526,8,30,.267,8,10,.800,92,41,80,.513,34,54,.630,7,26,.269,17,24,.708,106,2014-02-01,CLE,HOU
10,Home,L 92-101 ,240,31,80,.388,23,52,.442,8,28,.286,22,29,.759,92,35,78,.449,29,60,.483,6,18,.333,25,31,.806,101,2014-02-04,PHO,CHI
11,@,W 92-86 ,240,34,80,.425,27,58,.466,7,22,.318,17,17,1.000,92,36,82,.439,30,63,.476,6,19,.316,8,11,.727,86,2014-02-09,CHI,LAL
12,@,L 92-93 ,240,35,79,.443,24,55,.436,11,24,.458,11,19,.579,92,34,83,.410,29,71,.408,5,12,.417,20,26,.769,93,2014-02-09,IND,ORL
13,Home,W 92-89 ,240,33,70,.471,30,57,.526,3,13,.231,23,27,.852,92,34,74,.459,27,50,.540,7,24,.292,14,20,.700,89,2014-02-11,MEM,WAS
14,Home,L 92-104 ,240,37,80,.463,31,63,.492,6,17,.353,12,17,.706,92,41,82,.500,32,63,.508,9,19,.474,13,14,.929,104,2014-02-12,BOS,SAS
15,Home,W 92-76 ,240,35,70,.500,31,56,.554,4,14,.286,18,21,.857,92,26,67,.388,21,50,.420,5,17,.294,19,28,.679,76,2014-02-13,CHI,BRK
16,Home,L 92-101 ,240,33,79,.418,27,62,.435,6,17,.353,20,28,.714,92,39,86,.453,36,67,.537,3,19,.158,20,24,.833,101,2014-02-19,SAC,GSW
17,Home,L 92-94 ,240,35,83,.422,32,66,.485,3,17,.176,19,23,.826,92,36,72,.500,29,60,.483,7,12,.583,15,20,.750,94,2014-02-19,TOR,CHI
18,@,L 92-101 ,240,38,97,.392,34,75,.453,4,22,.182,12,17,.706,92,40,83,.482,33,61,.541,7,22,.318,14,19,.737,101,2014-02-21,BOS,LAL
19,Home,W 92-89 ,240,30,82,.366,22,62,.355,8,20,.400,24,27,.889,92,34,79,.430,30,64,.469,4,15,.267,17,22,.773,89,2014-02-22,CHA,MEM
20,Home,W 92-82 ,240,34,73,.466,25,53,.472,9,20,.450,15,15,1.000,92,33,90,.367,30,73,.411,3,17,.176,13,15,.867,82,2014-02-28,SAS,CHA
21,Home,W 92-81 ,240,35,83,.422,34,70,.486,1,13,.077,21,27,.778,92,32,86,.372,27,62,.435,5,24,.208,12,18,.667,81,2014-03-02,ORL,PHI
22,@,L 92-125 ,240,32,94,.340,22,64,.344,10,30,.333,18,26,.692,92,43,76,.566,36,56,.643,7,20,.350,32,43,.744,125,2014-03-04,PHI,OKC
23,@,L 92-101 ,240,37,86,.430,34,69,.493,3,17,.176,15,20,.750,92,36,77,.468,27,48,.563,9,29,.310,20,22,.909,101,2014-03-07,CLE,CHA
24,Home,L 92-104 ,240,36,76,.474,31,54,.574,5,22,.227,15,20,.750,92,37,80,.463,27,57,.474,10,23,.435,20,28,.714,104,2014-03-08,PHI,UTA
25,Home,L 92-116 ,240,34,81,.420,26,62,.419,8,19,.421,16,23,.696,92,42,80,.525,31,61,.508,11,19,.579,21,24,.875,116,2014-03-12,BOS,NYK
26,@,L 92-97 ,240,34,83,.410,26,58,.448,8,25,.320,16,25,.640,92,33,81,.407,19,49,.388,14,32,.438,17,29,.586,97,2014-03-15,DEN,ATL
27,Home,L 92-101 ,240,37,89,.416,30,71,.423,7,18,.389,11,16,.688,92,39,68,.574,30,48,.625,9,20,.450,14,18,.778,101,2014-03-16,MIL,CHA
28,Home,W 92-86 ,240,32,82,.390,28,65,.431,4,17,.235,24,29,.828,92,31,73,.425,26,50,.520,5,23,.217,19,27,.704,86,2014-03-19,NYK,IND
29,Home,L 92-93 ,240,34,91,.374,24,50,.480,10,41,.244,14,21,.667,92,34,82,.415,27,53,.509,7,29,.241,18,25,.720,93,2014-03-21,PHI,NYK
30,@,L 92-98 ,240,39,90,.433,35,74,.473,4,16,.250,10,26,.385,92,33,73,.452,25,48,.521,8,25,.320,24,35,.686,98,2014-03-21,DET,PHO
31,@,L 92-109 ,240,34,90,.378,27,66,.409,7,24,.292,17,20,.850,92,48,91,.527,42,79,.532,6,12,.500,7,13,.538,109,2014-03-24,MIN,MEM
32,Home,L 92-94 ,240,36,73,.493,30,53,.566,6,20,.300,14,24,.583,92,38,85,.447,33,76,.434,5,9,.556,13,23,.565,94,2014-03-31,DEN,MEM
33,@,W 92-83 ,240,33,70,.471,24,41,.585,9,29,.310,17,24,.708,92,33,85,.388,25,61,.410,8,24,.333,9,15,.600,83,2014-03-31,NYK,UTA
34,Home,L 92-105 ,240,32,72,.444,24,48,.500,8,24,.333,20,26,.769,92,40,78,.513,28,53,.528,12,25,.480,13,15,.867,105,2014-04-02,ATL,CHI
35,@,L 92-118 ,240,32,81,.395,29,57,.509,3,24,.125,25,30,.833,92,45,72,.625,35,53,.660,10,19,.526,18,21,.857,118,2014-04-02,BOS,WAS
36,@,L 92-100 ,240,29,80,.363,22,57,.386,7,23,.304,27,32,.844,92,32,83,.386,30,72,.417,2,11,.182,34,38,.895,100,2014-04-04,DEN,MEM
37,@,L 92-100 ,240,36,77,.468,35,63,.556,1,14,.071,19,28,.679,92,43,79,.544,34,62,.548,9,17,.529,5,9,.556,100,2014-04-05,MIN,ORL
38,@,L 92-112 ,240,38,86,.442,33,72,.458,5,14,.357,11,17,.647,92,43,77,.558,34,55,.618,9,22,.409,17,18,.944,112,2014-04-06,MEM,SAS
39,Home,L 92-107 ,240,34,82,.415,31,68,.456,3,14,.214,21,28,.750,92,38,80,.475,26,58,.448,12,22,.545,19,27,.704,107,2014-04-08,SAC,OKC
40,@,L 92-95 ,240,36,80,.450,27,51,.529,9,29,.310,11,18,.611,92,37,81,.457,29,64,.453,8,17,.471,13,19,.684,95,2014-04-16,TOR,NYK
41,@,L 92-102 ,240,31,81,.383,19,49,.388,12,32,.375,18,21,.857,92,35,69,.507,28,49,.571,7,20,.350,25,33,.758,102,2014-11-01,IND,ATL
42,Home,L 92-98 ,240,33,88,.375,24,57,.421,9,31,.290,17,21,.810,92,34,68,.500,31,58,.534,3,10,.300,27,33,.818,98,2014-11-02,LAC,SAC
43,@,L 92-94 ,240,38,92,.413,30,67,.448,8,25,.320,8,11,.727,92,31,69,.449,26,52,.500,5,17,.294,27,38,.711,94,2014-11-05,ATL,SAS
44,@,L 92-102 ,240,35,87,.402,31,71,.437,4,16,.250,18,23,.783,92,41,78,.526,36,65,.554,5,13,.385,15,17,.882,102,2014-11-08,MIN,MIA
45,@,L 92-93 ,240,29,82,.354,26,68,.382,3,14,.214,31,34,.912,92,40,88,.455,35,70,.500,5,18,.278,8,11,.727,93,2014-11-08,MEM,MIL
46,@,L 92-107 ,240,35,79,.443,32,65,.492,3,14,.214,19,27,.704,92,42,82,.512,36,65,.554,6,17,.353,17,22,.773,107,2014-11-09,CHO,LAL
47,@,W 92-90 ,240,35,74,.473,30,58,.517,5,16,.313,17,25,.680,92,37,83,.446,30,65,.462,7,18,.389,9,13,.692,90,2014-11-19,SAS,CLE
48,Home,L 92-98 ,240,30,74,.405,15,36,.417,15,38,.395,17,23,.739,92,37,91,.407,32,71,.451,5,20,.250,19,23,.826,98,2014-11-19,HOU,LAL
49,@,L 92-96 ,240,35,80,.438,32,70,.457,3,10,.300,19,26,.731,92,38,83,.458,29,57,.509,9,26,.346,11,13,.846,96,2014-11-19,MEM,TOR
50,Home,L 92-121 ,240,37,90,.411,33,77,.429,4,13,.308,14,22,.636,92,46,84,.548,33,63,.524,13,21,.619,16,18,.889,121,2014-11-21,MIN,SAS
51,Home,L 92-94 ,240,38,85,.447,34,65,.523,4,20,.200,12,19,.632,92,31,67,.463,26,52,.500,5,15,.333,27,30,.900,94,2014-11-21,OKC,BRK
52,@,L 92-95 ,240,35,88,.398,29,53,.547,6,35,.171,16,22,.727,92,30,82,.366,15,36,.417,15,46,.326,20,23,.870,95,2014-11-22,DAL,HOU
53,Home,L 92-99 ,240,35,78,.449,32,62,.516,3,16,.188,19,27,.704,92,37,71,.521,25,45,.556,12,26,.462,13,18,.722,99,2014-11-22,ORL,MIA
54,Home,L 92-113 ,240,31,75,.413,29,55,.527,2,20,.100,28,35,.800,92,45,88,.511,30,56,.536,15,32,.469,8,10,.800,113,2014-11-24,CHO,LAC
55,Home,L 92-108 ,240,37,84,.440,28,57,.491,9,27,.333,9,17,.529,92,40,77,.519,31,56,.554,9,21,.429,19,27,.704,108,2014-12-08,IND,ATL
56,@,L 92-101 ,240,32,79,.405,29,62,.468,3,17,.176,25,37,.676,92,35,74,.473,32,66,.485,3,8,.375,28,36,.778,101,2014-12-08,UTA,SAC
57,Home,L 92-111 ,240,36,78,.462,35,71,.493,1,7,.143,19,29,.655,92,45,88,.511,39,64,.609,6,24,.250,15,20,.750,111,2014-12-12,MIN,OKC
58,Home,L 92-104 ,240,36,84,.429,31,66,.470,5,18,.278,15,17,.882,92,41,87,.471,35,67,.522,6,20,.300,16,24,.667,104,2014-12-16,SAC,OKC
59,@,L 92-109 ,240,37,85,.435,32,66,.485,5,19,.263,13,15,.867,92,44,80,.550,37,61,.607,7,19,.368,14,18,.778,109,2014-12-17,ORL,BOS
60,Home,L 92-104 ,240,34,83,.410,31,69,.449,3,14,.214,21,29,.724,92,40,78,.513,34,61,.557,6,17,.353,18,25,.720,104,2014-12-21,WAS,PHO
61,@,W 92-90 ,240,29,84,.345,24,71,.338,5,13,.385,29,33,.879,92,36,83,.434,31,70,.443,5,13,.385,13,21,.619,90,2014-12-29,CHI,IND
62,Home,L 92-98 ,240,32,86,.372,22,55,.400,10,31,.323,18,24,.750,92,33,81,.407,27,58,.466,6,23,.261,26,30,.867,98,2015-01-02,UTA,ATL
63,@,L 92-101 ,240,40,82,.488,36,68,.529,4,14,.286,8,13,.615,92,43,78,.551,39,62,.629,4,16,.250,11,18,.611,101,2015-01-03,WAS,SAS
64,@,W 92-85 ,240,38,79,.481,36,69,.522,2,10,.200,14,17,.824,92,33,74,.446,27,55,.491,6,19,.316,13,17,.765,85,2015-01-05,WAS,NOP
65,@,L 92-95 ,240,33,85,.388,22,55,.400,11,30,.367,15,22,.682,92,38,79,.481,31,56,.554,7,23,.304,12,15,.800,95,2015-01-05,CLE,PHI
66,@,L 92-93 ,240,29,87,.333,25,69,.362,4,18,.222,30,42,.714,92,32,80,.400,21,56,.375,11,24,.458,18,25,.720,93,2015-01-10,IND,PHI
67,@,L 92-103 ,240,37,92,.402,34,71,.479,3,21,.143,15,20,.750,92,36,76,.474,26,50,.520,10,26,.385,21,26,.808,103,2015-01-10,ORL,POR
68,Home,L 92-103 ,240,36,75,.480,26,49,.531,10,26,.385,10,12,.833,92,39,83,.470,36,66,.545,3,17,.176,22,29,.759,103,2015-01-14,BRK,MEM
69,@,W 92-89 ,240,36,90,.400,30,66,.455,6,24,.250,14,24,.583,92,34,76,.447,29,58,.500,5,18,.278,16,25,.640,89,2015-01-19,TOR,MIL
70,@,L 92-99 ,240,35,84,.417,27,57,.474,8,27,.296,14,20,.700,92,38,78,.487,28,55,.509,10,23,.435,13,17,.765,99,2015-01-19,NOP,NYK
71,@,L 92-106 ,240,35,84,.417,27,62,.435,8,22,.364,14,18,.778,92,42,81,.519,37,57,.649,5,24,.208,17,25,.680,106,2015-01-21,UTA,CLE
72,Home,W 92-86 ,240,34,74,.459,33,67,.493,1,7,.143,23,29,.793,92,27,85,.318,22,57,.386,5,28,.179,27,32,.844,86,2015-01-21,MEM,TOR
73,@,W 92-84 ,240,40,80,.500,37,76,.487,3,4,.750,9,14,.643,92,35,84,.417,33,75,.440,2,9,.222,12,17,.706,84,2015-01-23,NOP,MIN
74,Home,W 92-84 ,240,36,86,.419,32,66,.485,4,20,.200,16,24,.667,92,29,85,.341,27,72,.375,2,13,.154,24,32,.750,84,2015-01-26,OKC,MIN
75,Home,L 92-98 ,240,37,87,.425,32,67,.478,5,20,.250,13,16,.813,92,38,78,.487,34,62,.548,4,16,.250,18,27,.667,98,2015-01-27,LAL,WAS
76,@,L 92-100 ,240,34,85,.400,29,63,.460,5,22,.227,19,22,.864,92,40,91,.440,32,74,.432,8,17,.471,12,17,.706,100,2015-01-28,OKC,NYK
77,Home,W 92-80 ,240,37,84,.440,27,62,.435,10,22,.455,8,13,.615,92,27,76,.355,20,60,.333,7,16,.438,19,23,.826,80,2015-02-01,NYK,LAL
78,@,W 92-88 ,240,37,79,.468,33,64,.516,4,15,.267,14,19,.737,92,33,81,.407,27,66,.409,6,15,.400,16,19,.842,88,2015-02-02,CHO,WAS
79,Home,W 92-88 ,240,37,74,.500,34,63,.540,3,11,.273,15,22,.682,92,34,89,.382,28,65,.431,6,24,.250,14,17,.824,88,2015-02-06,BRK,NYK
80,Home,L 92-106 ,240,35,87,.402,27,69,.391,8,18,.444,14,17,.824,92,37,81,.457,25,56,.446,12,25,.480,20,24,.833,106,2015-02-07,NYK,GSW
81,Home,W 92-76 ,240,37,83,.446,27,58,.466,10,25,.400,8,17,.471,92,26,72,.361,22,50,.440,4,22,.182,20,22,.909,76,2015-02-20,UTA,POR
82,Home,W 92-81 ,240,36,78,.462,31,60,.517,5,18,.278,15,19,.789,92,33,90,.367,27,71,.380,6,19,.316,9,13,.692,81,2015-02-22,DAL,CHO
83,Home,L 92-98 ,240,33,82,.402,20,49,.408,13,33,.394,13,16,.813,92,42,89,.472,39,80,.488,3,9,.333,11,13,.846,98,2015-02-22,POR,MEM
84,@,L 92-99 ,240,38,84,.452,29,58,.500,9,26,.346,7,11,.636,92,38,79,.481,30,60,.500,8,19,.421,15,18,.833,99,2015-02-24,TOR,DAL
85,@,L 92-105 ,240,38,88,.432,29,62,.468,9,26,.346,7,11,.636,92,40,96,.417,31,72,.431,9,24,.375,16,18,.889,105,2015-02-24,IND,OKC
86,Home,L 92-99 ,240,37,92,.402,28,59,.475,9,33,.273,9,17,.529,92,36,74,.486,31,52,.596,5,22,.227,22,30,.733,99,2015-03-01,DEN,NOP
87,@,L 92-97 ,240,35,84,.417,27,62,.435,8,22,.364,14,19,.737,92,33,78,.423,24,49,.490,9,29,.310,22,30,.733,97,2015-03-03,WAS,CHI
88,@,W 92-86 ,240,30,79,.380,23,61,.377,7,18,.389,25,30,.833,92,30,78,.385,27,63,.429,3,15,.200,23,30,.767,86,2015-03-07,IND,NYK
89,Home,W 92-84 ,240,35,95,.368,22,58,.379,13,37,.351,9,17,.529,92,30,77,.390,19,52,.365,11,25,.440,13,16,.813,84,2015-03-07,PHI,ATL
90,@,L 92-95 ,240,37,78,.474,32,66,.485,5,12,.417,13,13,1.000,92,37,85,.435,29,58,.500,8,27,.296,13,17,.765,95,2015-03-11,MEM,BOS
91,@,L 92-102 ,240,35,79,.443,30,56,.536,5,23,.217,17,24,.708,92,34,79,.430,22,46,.478,12,33,.364,22,31,.710,102,2015-03-13,MIA,TOR
92,Home,W 92-81 ,240,33,80,.413,31,71,.437,2,9,.222,24,28,.857,92,30,81,.370,22,63,.349,8,18,.444,13,21,.619,81,2015-03-16,MEM,DEN
93,@,L 92-106 ,240,30,79,.380,19,46,.413,11,33,.333,21,27,.778,92,42,76,.553,38,61,.623,4,15,.267,18,22,.818,106,2015-03-16,CLE,MIA
94,@,L 92-99 ,240,32,79,.405,27,65,.415,5,14,.357,23,29,.793,92,35,77,.455,26,53,.491,9,24,.375,20,28,.714,99,2015-03-17,CHO,LAC
95,@,L 92-117 ,240,36,80,.450,31,60,.517,5,20,.250,15,21,.714,92,45,82,.549,30,53,.566,15,29,.517,12,20,.600,117,2015-03-18,BRK,CLE
96,Home,L 92-95 (OT),265,40,97,.412,36,77,.468,4,20,.200,8,10,.800,92,34,83,.410,32,71,.451,2,12,.167,25,30,.833,95,2015-03-19,NYK,MIN
97,@,L 92-108 ,240,30,79,.380,20,54,.370,10,25,.400,22,26,.846,92,42,79,.532,33,51,.647,9,28,.321,15,17,.882,108,2015-03-20,TOR,CHI
98,@,L 92-95 ,240,36,84,.429,28,64,.438,8,20,.400,12,13,.923,92,35,82,.427,26,56,.464,9,26,.346,16,21,.762,95,2015-03-20,IND,CLE
99,@,L 92-98 ,240,37,96,.385,32,77,.416,5,19,.263,13,22,.591,92,39,76,.513,33,55,.600,6,21,.286,14,23,.609,98,2015-03-22,DAL,PHO
0,@,W 92-89 ,240,34,81,.420,27,54,.500,7,27,.259,17,20,.850,92,35,80,.438,31,64,.484,4,16,.250,15,23,.652,89,2015-03-25,POR,UTA
1,Home,L 92-96 ,240,38,87,.437,31,63,.492,7,24,.292,9,14,.643,92,29,69,.420,25,49,.510,4,20,.200,34,43,.791,96,2015-03-27,NYK,BOS
2,Home,L 92-113 ,240,37,83,.446,32,67,.478,5,16,.313,13,21,.619,92,44,78,.564,35,62,.565,9,16,.563,16,21,.762,113,2015-04-01,LAL,NOP
3,@,L 92-100 ,240,36,88,.409,32,71,.451,4,17,.235,16,26,.615,92,38,80,.475,34,59,.576,4,21,.190,20,28,.714,100,2015-04-03,OKC,MEM
4,Home,W 92-91 ,240,35,86,.407,34,73,.466,1,13,.077,21,23,.913,92,28,76,.368,17,50,.340,11,26,.423,24,33,.727,91,2015-04-04,CHO,PHI
5,Home,L 92-107 ,240,32,85,.376,26,63,.413,6,22,.273,22,31,.710,92,34,79,.430,21,45,.467,13,34,.382,26,42,.619,107,2015-04-04,DEN,LAC
6,@,W 92-83 ,240,38,79,.481,30,57,.526,8,22,.364,8,10,.800,92,34,81,.420,33,66,.500,1,15,.067,14,18,.778,83,2015-04-04,WAS,MEM
7,@,L 92-107 ,240,39,91,.429,30,63,.476,9,28,.321,5,10,.500,92,44,83,.530,37,62,.597,7,21,.333,12,15,.800,107,2015-04-05,GSW,SAS
8,@,W 92-74 ,240,33,77,.429,21,50,.420,12,27,.444,14,19,.737,92,28,81,.346,18,59,.305,10,22,.455,8,11,.727,74,2015-04-08,TOR,CHO
9,@,L 92-102 ,240,40,96,.417,36,81,.444,4,15,.267,8,13,.615,92,35,72,.486,31,56,.554,4,16,.250,28,36,.778,102,2015-04-13,LAL,SAC
10,@,L 92-109 ,240,34,82,.415,25,62,.403,9,20,.450,15,23,.652,92,41,82,.500,30,54,.556,11,28,.393,16,26,.615,109,2015-04-13,DAL,UTA
11,Home,W 92-87 ,240,38,77,.494,26,44,.591,12,33,.364,4,4,1.000,92,30,71,.423,18,38,.474,12,33,.364,15,16,.938,87,2015-04-15,TOR,CHO
12,Home,W 92-87 ,240,30,74,.405,23,55,.418,7,19,.368,25,34,.735,92,35,75,.467,33,63,.524,2,12,.167,15,21,.714,87,2015-10-28,DET,UTA
13,@,L 92-102 ,240,33,77,.429,27,56,.482,6,21,.286,20,22,.909,92,39,86,.453,33,61,.541,6,25,.240,18,21,.857,102,2015-10-30,MIA,CLE
14,Home,L 92-112 ,240,30,82,.366,25,59,.424,5,23,.217,27,36,.750,92,43,93,.462,34,67,.507,9,26,.346,17,25,.680,112,2015-10-30,HOU,GSW
15,@,L 92-110 ,240,34,86,.395,25,62,.403,9,24,.375,15,19,.789,92,37,83,.446,33,65,.508,4,18,.222,32,42,.762,110,2015-10-30,POR,PHO
16,Home,W 92-87 ,240,33,87,.379,26,59,.441,7,28,.250,19,22,.864,92,35,90,.389,28,67,.418,7,23,.304,10,17,.588,87,2015-11-01,CHI,ORL
17,Home,L 92-94 ,240,32,86,.372,18,49,.367,14,37,.378,14,15,.933,92,37,88,.420,30,59,.508,7,29,.241,13,14,.929,94,2015-11-01,CHO,ATL
18,Home,L 92-98 ,240,38,86,.442,33,58,.569,5,28,.179,11,16,.688,92,37,90,.411,30,69,.435,7,21,.333,17,22,.773,98,2015-11-03,MIA,ATL
19,Home,L 92-108 ,240,33,88,.375,28,64,.438,5,24,.208,21,33,.636,92,41,77,.532,30,52,.577,11,25,.440,15,32,.469,108,2015-11-04,UTA,POR
20,Home,L 92-99 ,240,33,81,.407,29,57,.509,4,24,.167,22,28,.786,92,35,81,.432,32,67,.478,3,14,.214,26,29,.897,99,2015-11-06,NYK,MIL
21,Home,W 92-87 ,240,33,77,.429,24,52,.462,9,25,.360,17,22,.773,92,30,86,.349,25,63,.397,5,23,.217,22,29,.759,87,2015-11-06,ORL,TOR
22,Home,L 92-100 ,240,37,92,.402,27,62,.435,10,30,.333,8,13,.615,92,37,74,.500,29,52,.558,8,22,.364,18,36,.500,100,2015-11-06,PHO,DET
23,@,L 92-94 ,240,35,80,.438,33,69,.478,2,11,.182,20,29,.690,92,28,68,.412,23,49,.469,5,19,.263,33,37,.892,94,2015-11-09,MEM,LAC
24,@,L 92-101 ,240,34,89,.382,25,57,.439,9,32,.281,15,20,.750,92,37,74,.500,28,58,.483,9,16,.563,18,24,.750,101,2015-11-11,DET,SAC
25,Home,W 92-91 ,240,36,77,.468,32,64,.500,4,13,.308,16,25,.640,92,34,89,.382,30,72,.417,4,17,.235,19,25,.760,91,2015-11-12,MIA,UTA
26,Home,W 92-83 ,240,33,85,.388,28,69,.406,5,16,.313,21,25,.840,92,33,82,.402,25,60,.417,8,22,.364,9,11,.818,83,2015-11-14,SAS,PHI
27,@,W 92-86 ,240,30,76,.395,23,52,.442,7,24,.292,25,30,.833,92,34,76,.447,29,54,.537,5,22,.227,13,20,.650,86,2015-11-16,DAL,PHI
28,Home,W 92-82 ,240,34,72,.472,27,51,.529,7,21,.333,17,22,.773,92,32,74,.432,31,65,.477,1,9,.111,17,17,1.000,82,2015-11-21,SAS,MEM
29,@,L 92-104 ,240,32,92,.348,21,66,.318,11,26,.423,17,20,.850,92,37,87,.425,29,59,.492,8,28,.286,22,29,.759,104,2015-11-27,CHI,IND
30,Home,W 92-81 ,240,33,77,.429,26,51,.510,7,26,.269,19,27,.704,92,30,75,.400,22,50,.440,8,25,.320,13,17,.765,81,2015-11-28,DAL,DEN
31,Home,W 92-84 ,240,34,81,.420,30,68,.441,4,13,.308,20,27,.741,92,30,77,.390,18,41,.439,12,36,.333,12,16,.750,84,2015-11-29,MEM,PHI
32,Home,W 92-89 ,240,37,86,.430,31,70,.443,6,16,.375,12,20,.600,92,37,90,.411,35,76,.461,2,14,.143,13,18,.722,89,2015-11-30,CHI,SAS
33,Home,W 92-74 ,240,35,77,.455,29,59,.492,6,18,.333,16,22,.727,92,28,75,.373,22,56,.393,6,19,.316,12,16,.750,74,2015-11-30,MIL,DEN
34,Home,L 92-93 ,240,37,87,.425,29,58,.500,8,29,.276,10,15,.667,92,41,88,.466,37,73,.507,4,15,.267,7,13,.538,93,2015-12-09,DET,MEM
35,@,L 92-106 ,240,38,90,.422,31,71,.437,7,19,.368,9,15,.600,92,46,89,.517,40,69,.580,6,20,.300,8,9,.889,106,2015-12-21,IND,SAS
36,Home,L 92-93 ,240,39,88,.443,35,70,.500,4,18,.222,10,12,.833,92,35,78,.449,20,48,.417,15,30,.500,8,14,.571,93,2015-12-22,MIA,DET
37,@,L 92-98 ,240,37,90,.411,30,71,.423,7,19,.368,11,21,.524,92,28,69,.406,14,37,.378,14,32,.438,28,32,.875,98,2015-12-26,MEM,CHO
38,Home,W 92-87 (OT),265,31,75,.413,22,48,.458,9,27,.333,21,28,.750,92,33,81,.407,26,63,.413,7,18,.389,14,26,.538,87,2016-01-02,UTA,MEM
39,@,L 92-101 ,240,35,98,.357,30,73,.411,5,25,.200,17,22,.773,92,39,94,.415,30,72,.417,9,22,.409,14,17,.824,101,2016-01-07,BOS,CHI
40,@,L 92-95 ,240,30,83,.361,18,47,.383,12,36,.333,20,24,.833,92,32,77,.416,20,50,.400,12,27,.444,19,23,.826,95,2016-01-10,CHO,DEN
41,Home,L 92-105 ,240,33,87,.379,24,51,.471,9,36,.250,17,22,.773,92,39,72,.542,34,60,.567,5,12,.417,22,26,.846,105,2016-01-16,CHO,MIL
42,Home,L 92-112 ,240,35,89,.393,27,63,.429,8,26,.308,14,20,.700,92,43,97,.443,32,72,.444,11,25,.440,15,19,.789,112,2016-01-24,PHI,BOS
43,Home,L 92-95 ,240,34,85,.400,25,56,.446,9,29,.310,15,18,.833,92,34,75,.453,23,53,.434,11,22,.500,16,33,.485,95,2016-01-25,UTA,DET
44,@,W 92-90 ,240,33,76,.434,27,51,.529,6,25,.240,20,26,.769,92,30,74,.405,23,49,.469,7,25,.280,23,28,.821,90,2016-01-26,DAL,LAL
45,@,L 92-111 ,240,33,83,.398,26,55,.473,7,28,.250,19,21,.905,92,38,78,.487,29,63,.460,9,15,.600,26,30,.867,111,2016-01-28,ATL,IND
46,@,L 92-107 ,240,39,96,.406,34,79,.430,5,17,.294,9,11,.818,92,40,78,.513,31,54,.574,9,24,.375,18,21,.857,107,2016-02-01,ORL,SAS
47,Home,L 92-98 (OT),265,34,90,.378,28,65,.431,6,25,.240,18,21,.857,92,35,95,.368,30,73,.411,5,22,.227,23,31,.742,98,2016-02-08,PHI,LAC
48,Home,L 92-103 ,240,38,88,.432,28,61,.459,10,27,.370,6,7,.857,92,39,83,.470,33,64,.516,6,19,.316,19,24,.792,103,2016-02-10,DET,DEN
49,@,L 92-99 ,240,34,88,.386,28,56,.500,6,32,.188,18,24,.750,92,36,82,.439,32,68,.471,4,14,.286,23,32,.719,99,2016-02-11,WAS,MIL
50,Home,L 92-115 ,240,37,90,.411,32,69,.464,5,21,.238,13,19,.684,92,41,80,.513,31,57,.544,10,23,.435,23,27,.852,115,2016-02-21,OKC,CLE
51,Home,L 92-102 ,240,36,86,.419,26,52,.500,10,34,.294,10,16,.625,92,39,89,.438,25,44,.568,14,45,.311,10,12,.833,102,2016-02-22,ATL,GSW
52,Home,L 92-108 ,240,39,96,.406,33,78,.423,6,18,.333,8,15,.533,92,44,85,.518,36,66,.545,8,19,.421,12,15,.800,108,2016-02-24,SAC,SAS
53,@,L 92-126 ,240,33,91,.363,27,64,.422,6,27,.222,20,27,.741,92,45,93,.484,32,66,.485,13,27,.481,23,27,.852,126,2016-03-01,PHO,CHO
54,@,L 92-108 ,240,33,82,.402,28,60,.467,5,22,.227,21,27,.778,92,40,83,.482,31,66,.470,9,17,.529,19,25,.760,108,2016-03-03,PHO,MIA
55,@,L 92-103 ,240,35,89,.393,29,60,.483,6,29,.207,16,21,.762,92,40,81,.494,36,68,.529,4,13,.308,19,24,.792,103,2016-03-12,NOP,MIL
56,Home,W 92-85 ,240,39,80,.488,33,61,.541,6,19,.316,8,11,.727,92,35,86,.407,27,59,.458,8,27,.296,7,12,.583,85,2016-03-19,CHI,UTA
57,Home,W 92-91 ,240,35,85,.412,26,52,.500,9,33,.273,13,17,.765,92,41,76,.539,36,67,.537,5,9,.556,4,7,.571,91,2016-03-21,DET,MIL
58,Home,W 92-84 ,240,36,79,.456,29,59,.492,7,20,.350,13,15,.867,92,35,85,.412,31,69,.449,4,16,.250,10,14,.714,84,2016-03-24,IND,NOP
59,@,L 92-111 ,240,37,86,.430,33,71,.465,4,15,.267,14,17,.824,92,44,85,.518,37,65,.569,7,20,.350,16,18,.889,111,2016-03-26,SAS,OKC
60,@,L 92-100 ,240,36,80,.450,28,63,.444,8,17,.471,12,18,.667,92,36,75,.480,24,51,.471,12,24,.500,16,22,.727,100,2016-03-30,NOP,SAS
61,@,W 92-87 ,240,34,81,.420,27,59,.458,7,22,.318,17,20,.850,92,33,96,.344,26,71,.366,7,25,.280,14,20,.700,87,2016-04-03,IND,NYK
62,@,L 92-108 ,240,34,77,.442,23,48,.479,11,29,.379,13,19,.684,92,39,87,.448,32,68,.471,7,19,.368,23,26,.885,108,2016-04-05,CHI,MEM
63,@,W 92-86 ,240,34,77,.442,24,50,.480,10,27,.370,14,18,.778,92,34,90,.378,31,73,.425,3,17,.176,15,19,.789,86,2016-04-10,GSW,SAS
64,Home,L 92-101 ,240,35,77,.455,26,44,.591,9,33,.273,13,18,.722,92,36,81,.444,25,49,.510,11,32,.344,18,22,.818,101,2016-04-11,UTA,DAL
65,Home,L 92-97 ,240,37,87,.425,30,64,.469,7,23,.304,11,13,.846,92,39,90,.433,28,66,.424,11,24,.458,8,10,.800,97,2016-04-13,MIL,IND
66,@,L 92-93 ,240,32,84,.381,21,54,.389,11,30,.367,17,20,.850,92,34,80,.425,23,49,.469,11,31,.355,14,21,.667,93,2016-10-30,DAL,HOU
67,@,L 92-95 ,240,32,83,.386,27,58,.466,5,25,.200,23,36,.639,92,31,80,.388,26,60,.433,5,20,.250,28,35,.800,95,2016-11-04,ATL,WAS
68,@,L 92-112 ,240,33,84,.393,29,65,.446,4,19,.211,22,29,.759,92,45,86,.523,38,70,.543,7,16,.438,15,24,.625,112,2016-11-05,MIN,OKC
69,Home,L 92-116 ,240,30,74,.405,20,49,.408,10,25,.400,22,25,.880,92,47,91,.516,38,68,.559,9,23,.391,13,14,.929,116,2016-11-05,SAS,LAC
70,Home,L 92-94 ,240,37,86,.430,30,66,.455,7,20,.350,11,16,.688,92,33,82,.402,21,51,.412,12,31,.387,16,17,.941,94,2016-11-19,DET,BOS
71,Home,L 92-111 ,240,34,86,.395,24,55,.436,10,31,.323,14,22,.636,92,45,98,.459,30,60,.500,15,38,.395,6,8,.750,111,2016-11-23,BRK,BOS
72,@,W 92-87 ,240,33,73,.452,24,51,.471,9,22,.409,17,22,.773,92,33,91,.363,26,66,.394,7,25,.280,14,23,.609,87,2016-11-23,PHO,ORL
73,@,L 92-97 ,240,33,88,.375,27,62,.435,6,26,.231,20,25,.800,92,36,88,.409,25,60,.417,11,28,.393,14,15,.933,97,2016-12-02,SAC,BOS
74,@,L 92-99 ,240,38,86,.442,32,64,.500,6,22,.273,10,15,.667,92,36,89,.404,27,65,.415,9,24,.375,18,24,.750,99,2016-12-03,MIA,POR
75,Home,L 92-98 ,240,38,86,.442,28,59,.475,10,27,.370,6,13,.462,92,42,79,.532,35,56,.625,7,23,.304,7,14,.500,98,2016-12-04,DET,ORL
76,@,L 92-101 ,240,36,98,.367,30,70,.429,6,28,.214,14,19,.737,92,41,89,.461,35,61,.574,6,28,.214,13,26,.500,101,2016-12-04,NOP,OKC
77,Home,W 92-85 ,240,35,78,.449,29,59,.492,6,19,.316,16,17,.941,92,31,76,.408,24,44,.545,7,32,.219,16,24,.667,85,2016-12-08,WAS,DEN
78,@,L 92-112 ,240,35,83,.422,28,58,.483,7,25,.280,15,18,.833,92,45,77,.584,33,51,.647,12,26,.462,10,12,.833,112,2016-12-12,DEN,DAL
79,@,L 92-116 ,240,33,84,.393,23,61,.377,10,23,.435,16,21,.762,92,47,84,.560,37,61,.607,10,23,.435,12,21,.571,116,2016-12-12,LAL,SAC
80,Home,L 92-107 ,240,34,85,.400,24,58,.414,10,27,.370,14,18,.778,92,39,74,.527,34,58,.586,5,16,.313,24,26,.923,107,2016-12-15,PHO,SAS
81,Home,L 92-96 ,240,29,77,.377,24,52,.462,5,25,.200,29,36,.806,92,31,80,.388,24,56,.429,7,24,.292,27,37,.730,96,2016-12-16,MEM,SAC
82,@,W 92-84 ,240,35,83,.422,26,54,.481,9,29,.310,13,14,.929,92,34,82,.415,27,56,.482,7,26,.269,9,13,.692,84,2016-12-21,MIN,ATL
83,@,L 92-104 ,240,35,93,.376,28,70,.400,7,23,.304,15,16,.938,92,38,85,.447,26,56,.464,12,29,.414,16,17,.941,104,2016-12-30,NYK,NOP
84,Home,L 92-111 ,240,37,86,.430,28,58,.483,9,28,.321,9,10,.900,92,44,81,.543,34,62,.548,10,19,.526,13,18,.722,111,2017-01-04,ORL,ATL
85,Home,L 92-94 ,240,35,80,.438,28,60,.467,7,20,.350,15,21,.714,92,32,77,.416,24,54,.444,8,23,.348,22,28,.786,94,2017-01-07,MIN,UTA
86,@,L 92-101 ,240,36,78,.462,23,50,.460,13,28,.464,7,9,.778,92,40,71,.563,34,55,.618,6,16,.375,15,21,.714,101,2017-01-09,DAL,MIN
87,@,L 92-100 ,240,31,85,.365,22,54,.407,9,31,.290,21,25,.840,92,38,79,.481,25,45,.556,13,34,.382,11,19,.579,100,2017-01-10,CLE,UTA
88,@,L 92-111 ,240,37,93,.398,30,65,.462,7,28,.250,11,14,.786,92,43,95,.453,29,51,.569,14,44,.318,11,15,.733,111,2017-01-18,MIL,HOU
89,@,L 92-93 ,240,33,89,.371,27,70,.386,6,19,.316,20,28,.714,92,36,92,.391,24,63,.381,12,29,.414,9,16,.563,93,2017-01-20,POR,PHI
90,Home,L 92-100 ,240,35,85,.412,28,63,.444,7,22,.318,15,20,.750,92,35,77,.455,28,55,.509,7,22,.318,23,30,.767,100,2017-01-24,ORL,CHI
91,@,L 92-123 ,240,37,92,.402,33,68,.485,4,24,.167,14,19,.737,92,48,85,.565,33,57,.579,15,28,.536,12,13,.923,123,2017-02-08,CHI,GSW
92,@,L 92-108 ,240,29,73,.397,19,41,.463,10,32,.313,24,27,.889,92,42,84,.500,32,59,.542,10,25,.400,14,15,.933,108,2017-02-08,BOS,SAC
93,Home,L 92-103 ,240,39,92,.424,34,75,.453,5,17,.294,9,13,.692,92,41,82,.500,32,63,.508,9,19,.474,12,15,.800,103,2017-02-10,DET,SAS
94,@,L 92-102 ,240,35,84,.417,26,57,.456,9,27,.333,13,23,.565,92,40,78,.513,29,52,.558,11,26,.423,11,11,1.000,102,2017-02-24,MEM,IND
95,Home,L 92-102 ,240,37,87,.425,29,65,.446,8,22,.364,10,13,.769,92,34,72,.472,23,48,.479,11,24,.458,23,32,.719,102,2017-02-26,WAS,UTA
96,@,W 92-91 ,240,33,78,.423,26,52,.500,7,26,.269,19,23,.826,92,33,73,.452,24,49,.490,9,24,.375,16,19,.842,91,2017-02-27,TOR,NYK
97,@,L 92-120 ,240,35,73,.479,24,46,.522,11,27,.407,11,18,.611,92,46,88,.523,28,54,.519,18,34,.529,10,12,.833,120,2017-03-04,CLE,MIA
98,@,L 92-102 ,240,35,84,.417,29,65,.446,6,19,.316,16,20,.800,92,41,88,.466,35,68,.515,6,20,.300,14,21,.667,102,2017-03-09,SAS,OKC
99,@,L 91-99 ,240,34,82,.415,26,58,.448,8,24,.333,15,22,.682,91,36,77,.468,32,62,.516,4,15,.267,23,31,.742,99,2011-12-26,CHI,GSW
0,Home,W 91-79 ,240,32,87,.368,25,72,.347,7,15,.467,20,25,.800,91,27,75,.360,20,56,.357,7,19,.368,18,21,.857,79,2011-12-26,IND,DET
1,@,L 91-100 ,240,37,88,.420,36,72,.500,1,16,.063,16,19,.842,91,35,75,.467,26,57,.456,9,18,.500,21,35,.600,100,2011-12-26,LAL,SAC
2,@,L 91-98 (OT),265,34,88,.386,29,63,.460,5,25,.200,18,31,.581,91,36,94,.383,34,84,.405,2,10,.200,24,32,.750,98,2011-12-30,CLE,IND
3,Home,W 91-86 ,240,33,83,.398,29,64,.453,4,19,.211,21,27,.778,91,37,88,.420,32,69,.464,5,19,.263,7,11,.636,86,2012-01-02,DEN,MIL
4,@,L 91-102 ,240,36,72,.500,29,55,.527,7,17,.412,12,20,.600,91,39,87,.448,31,64,.484,8,23,.348,16,21,.762,102,2012-01-02,GSW,PHO
5,Home,W 91-87 ,240,30,79,.380,29,69,.420,1,10,.100,30,40,.750,91,34,82,.415,27,63,.429,7,19,.368,12,15,.800,87,2012-01-09,NYK,CHA
6,Home,L 91-98 ,240,34,80,.425,28,60,.467,6,20,.300,17,21,.810,91,30,81,.370,23,57,.404,7,24,.292,31,34,.912,98,2012-01-11,TOR,SAC
7,@,L 91-93 ,240,38,85,.447,34,64,.531,4,21,.190,11,12,.917,91,32,78,.410,25,57,.439,7,21,.333,22,27,.815,93,2012-01-14,MIN,ATL
8,Home,L 91-99 ,240,31,74,.419,24,55,.436,7,19,.368,22,26,.846,91,38,73,.521,35,58,.603,3,15,.200,20,27,.741,99,2012-01-15,DET,GSW
9,@,L 91-102 ,240,38,91,.418,33,76,.434,5,15,.333,10,14,.714,91,40,81,.494,35,62,.565,5,19,.263,17,23,.739,102,2012-01-15,PHO,SAS
10,@,L 91-101 ,240,33,78,.423,25,54,.463,8,24,.333,17,26,.654,91,37,80,.463,29,59,.492,8,21,.381,19,35,.543,101,2012-01-16,NJN,LAC
11,Home,W 91-89 ,240,37,87,.425,29,65,.446,8,22,.364,9,17,.529,91,34,81,.420,25,61,.410,9,20,.450,12,18,.667,89,2012-01-18,LAC,DAL
12,@,W 91-88 ,240,36,79,.456,29,67,.433,7,12,.583,12,16,.750,91,32,86,.372,28,71,.394,4,15,.267,20,30,.667,88,2012-01-18,PHO,NYK
13,Home,L 91-94 ,240,31,80,.388,28,68,.412,3,12,.250,26,29,.897,91,37,71,.521,32,51,.627,5,20,.250,15,19,.789,94,2012-01-19,UTA,DAL
14,Home,L 91-94 ,240,37,80,.463,27,57,.474,10,23,.435,7,8,.875,91,35,83,.422,27,67,.403,8,16,.500,16,21,.762,94,2012-01-20,GSW,IND
15,@,L 91-94 ,240,34,81,.420,31,61,.508,3,20,.150,20,24,.833,91,30,67,.448,23,52,.442,7,15,.467,27,32,.844,94,2012-01-21,POR,DET
16,@,L 91-103 ,240,29,81,.358,21,62,.339,8,19,.421,25,31,.806,91,35,72,.486,27,51,.529,8,21,.381,25,40,.625,103,2012-01-22,TOR,LAC
17,@,W 91-82 ,240,28,80,.350,23,50,.460,5,30,.167,30,34,.882,91,25,67,.373,22,55,.400,3,12,.250,29,35,.829,82,2012-01-22,MIL,MIA
18,@,W 91-90 ,240,36,85,.424,34,72,.472,2,13,.154,17,23,.739,91,38,76,.500,29,51,.569,9,25,.360,5,8,.625,90,2012-01-23,MEM,GSW
19,Home,W 91-81 ,240,34,78,.436,25,58,.431,9,20,.450,14,26,.538,91,32,76,.421,29,56,.518,3,20,.150,14,20,.700,81,2012-01-25,CLE,NYK
20,@,L 91-96 ,240,37,87,.425,29,64,.453,8,23,.348,9,14,.643,91,32,66,.485,24,50,.480,8,16,.500,24,32,.750,96,2012-01-25,LAC,LAL
21,@,L 91-101 ,240,35,75,.467,34,68,.500,1,7,.143,20,21,.952,91,34,64,.531,29,51,.569,5,13,.385,28,33,.848,101,2012-01-25,NOH,OKC
22,@,L 91-98 ,240,30,84,.357,24,66,.364,6,18,.333,25,31,.806,91,35,72,.486,26,50,.520,9,22,.409,19,27,.704,98,2012-01-26,MEM,LAC
23,@,W 91-83 ,240,34,73,.466,24,52,.462,10,21,.476,13,19,.684,91,30,79,.380,25,62,.403,5,17,.294,18,31,.581,83,2012-01-26,BOS,ORL
24,@,L 91-99 ,240,36,79,.456,27,57,.474,9,22,.409,10,13,.769,91,35,76,.461,28,58,.483,7,18,.389,22,31,.710,99,2012-02-01,HOU,SAS
25,Home,L 91-112 ,240,39,85,.459,31,58,.534,8,27,.296,5,12,.417,91,39,73,.534,27,52,.519,12,21,.571,22,25,.880,112,2012-02-02,LAC,DEN
26,Home,W 91-89 ,240,31,76,.408,21,56,.375,10,20,.500,19,25,.760,91,34,80,.425,31,65,.477,3,15,.200,18,21,.857,89,2012-02-03,BOS,NYK
27,Home,W 91-88 ,240,37,93,.398,31,70,.443,6,23,.261,11,15,.733,91,32,67,.478,26,54,.481,6,13,.462,18,27,.667,88,2012-02-04,CLE,DAL
28,@,L 91-100 ,240,39,91,.429,37,81,.457,2,10,.200,11,14,.786,91,37,82,.451,31,62,.500,6,20,.300,20,23,.870,100,2012-02-04,HOU,MIN
29,@,L 91-107 ,240,32,82,.390,25,63,.397,7,19,.368,20,30,.667,91,39,84,.464,33,67,.493,6,17,.353,23,26,.885,107,2012-02-07,CLE,MIA
30,@,L 91-95 ,240,34,88,.386,28,68,.412,6,20,.300,17,24,.708,91,37,75,.493,34,62,.548,3,13,.231,18,26,.692,95,2012-02-12,CHI,BOS
31,Home,L 91-93 ,240,36,76,.474,29,57,.509,7,19,.368,12,16,.750,91,34,84,.405,24,62,.387,10,22,.455,15,17,.882,93,2012-02-15,GSW,POR
32,Home,L 91-98 ,240,35,84,.417,33,68,.485,2,16,.125,19,28,.679,91,37,74,.500,31,59,.525,6,15,.400,18,23,.783,98,2012-02-17,TOR,CHA
33,@,L 91-92 ,240,40,90,.444,37,79,.468,3,11,.273,8,10,.800,91,33,85,.388,30,69,.435,3,16,.188,23,26,.885,92,2012-02-19,PHI,MIN
34,@,L 91-110 ,240,37,88,.420,35,75,.467,2,13,.154,15,19,.789,91,43,79,.544,37,66,.561,6,13,.462,18,24,.750,110,2012-02-22,MIL,CHI
35,Home,L 91-96 ,240,36,90,.400,28,58,.483,8,32,.250,11,16,.688,91,35,76,.461,27,56,.482,8,20,.400,18,31,.581,96,2012-02-22,DAL,LAL
36,Home,L 91-108 ,240,38,81,.469,29,57,.509,9,24,.375,6,9,.667,91,45,84,.536,32,55,.582,13,29,.448,5,15,.333,108,2012-02-22,NJN,ORL
37,Home,L 91-112 ,240,35,80,.438,26,58,.448,9,22,.409,12,16,.750,91,47,89,.528,37,69,.536,10,20,.500,8,12,.667,112,2012-03-02,CLE,CHI
38,Home,L 91-96 ,240,38,97,.392,37,86,.430,1,11,.091,14,17,.824,91,39,82,.476,32,66,.485,7,16,.438,11,16,.688,96,2012-03-04,PHI,CHI
39,@,L 91-95 ,240,36,84,.429,27,63,.429,9,21,.429,10,10,1.000,91,29,76,.382,21,49,.429,8,27,.296,29,33,.879,95,2012-03-05,DAL,OKC
40,@,L 91-104 ,240,34,84,.405,31,73,.425,3,11,.273,20,24,.833,91,41,78,.526,38,71,.535,3,7,.429,19,27,.704,104,2012-03-09,UTA,PHI
41,@,L 91-93 (OT),265,33,88,.375,26,71,.366,7,17,.412,18,25,.720,91,35,75,.467,32,62,.516,3,13,.231,20,31,.645,93,2012-03-10,IND,MIA
42,@,L 91-98 ,240,36,86,.419,31,72,.431,5,14,.357,14,19,.737,91,41,86,.477,37,75,.493,4,11,.364,12,15,.800,98,2012-03-10,MEM,PHO
43,Home,L 91-94 ,240,32,79,.405,28,70,.400,4,9,.444,23,30,.767,91,37,73,.507,32,58,.552,5,15,.333,15,23,.652,94,2012-03-11,DEN,MEM
44,@,W 91-87 ,240,32,78,.410,23,54,.426,9,24,.375,18,23,.783,91,39,85,.459,35,69,.507,4,16,.250,5,12,.417,87,2012-03-15,PHO,LAC
45,@,L 91-98 ,240,36,76,.474,33,61,.541,3,15,.200,16,17,.941,91,34,74,.459,27,54,.500,7,20,.350,23,31,.742,98,2012-03-17,BOS,DEN
46,@,L 91-95 ,240,35,72,.486,29,52,.558,6,20,.300,15,18,.833,91,35,86,.407,29,63,.460,6,23,.261,19,27,.704,95,2012-03-17,HOU,LAC
47,Home,W 91-81 ,240,34,74,.459,32,66,.485,2,8,.250,21,27,.778,91,30,76,.395,21,51,.412,9,25,.360,12,21,.571,81,2012-03-18,MIA,ORL
48,@,L 91-114 ,240,29,79,.367,17,53,.321,12,26,.462,21,27,.778,91,42,78,.538,33,56,.589,9,22,.409,21,22,.955,114,2012-03-21,LAC,OKC
49,Home,L 91-100 ,240,36,90,.400,33,75,.440,3,15,.200,16,20,.800,91,43,89,.483,36,72,.500,7,17,.412,7,10,.700,100,2012-03-22,MIL,BOS
50,Home,L 91-108 ,240,35,74,.473,22,54,.407,13,20,.650,8,11,.727,91,44,88,.500,36,72,.500,8,16,.500,12,16,.750,108,2012-03-26,CHI,DEN
51,Home,W 91-75 ,240,30,76,.395,21,48,.438,9,28,.321,22,32,.688,91,28,72,.389,26,59,.441,2,13,.154,17,27,.630,75,2012-03-31,NYK,CLE
52,Home,W 91-72 ,240,33,70,.471,28,57,.491,5,13,.385,20,22,.909,91,31,89,.348,28,73,.384,3,16,.188,7,17,.412,72,2012-04-01,BOS,MIA
53,Home,W 91-87 ,240,39,81,.481,32,59,.542,7,22,.318,6,6,1.000,91,34,85,.400,28,67,.418,6,18,.333,13,15,.867,87,2012-04-03,LAL,NJN
54,Home,W 91-75 ,240,30,72,.417,20,49,.408,10,23,.435,21,26,.808,91,29,78,.372,23,62,.371,6,16,.375,11,16,.688,75,2012-04-08,OKC,TOR
55,Home,L 91-93 ,240,36,80,.450,27,65,.415,9,15,.600,10,10,1.000,91,34,73,.466,29,63,.460,5,10,.500,20,26,.769,93,2012-04-09,NOH,LAL
56,Home,W 91-84 ,240,31,73,.425,27,59,.458,4,14,.286,25,33,.758,91,35,87,.402,28,63,.444,7,24,.292,7,10,.700,84,2012-04-09,UTA,SAS
57,Home,L 91-103 ,240,31,87,.356,27,67,.403,4,20,.200,25,29,.862,91,40,78,.513,34,64,.531,6,14,.429,17,22,.773,103,2012-04-11,HOU,UTA
58,@,L 91-105 ,240,38,96,.396,36,80,.450,2,16,.125,13,18,.722,91,40,76,.526,31,58,.534,9,18,.500,16,19,.842,105,2012-04-14,PHO,SAS
59,Home,L 91-112 ,240,39,80,.488,37,70,.529,2,10,.200,11,11,1.000,91,50,84,.595,43,66,.652,7,18,.389,5,11,.455,112,2012-04-17,LAL,SAS
60,@,W 91-84 ,240,40,91,.440,35,78,.449,5,13,.385,6,11,.545,91,26,73,.356,19,51,.373,7,22,.318,25,30,.833,84,2012-04-17,MEM,MIN
61,@,L 91-103 ,240,29,60,.483,27,53,.509,2,7,.286,31,38,.816,91,42,83,.506,34,61,.557,8,22,.364,11,13,.846,103,2012-04-18,NOH,MEM
62,Home,L 91-112 ,240,31,79,.392,25,59,.424,6,20,.300,23,29,.793,91,38,80,.475,28,63,.444,10,17,.588,26,32,.813,112,2012-04-18,POR,UTA
63,@,W 91-80 ,240,34,73,.466,31,58,.534,3,15,.200,20,28,.714,91,33,91,.363,26,72,.361,7,19,.368,7,9,.778,80,2012-04-19,MIN,DET
64,Home,L 91-99 ,240,38,77,.494,35,64,.547,3,13,.231,12,31,.387,91,40,85,.471,35,70,.500,5,15,.333,14,18,.778,99,2012-10-30,LAL,DAL
65,@,L 91-114 ,240,36,93,.387,31,71,.437,5,22,.227,14,18,.778,91,48,78,.615,38,58,.655,10,20,.500,8,13,.615,114,2012-11-05,POR,DAL
66,Home,L 91-97 ,240,35,84,.417,30,69,.435,5,15,.333,16,18,.889,91,36,73,.493,31,60,.517,5,13,.385,20,21,.952,97,2012-11-08,CHI,OKC
67,Home,L 91-101 ,240,34,78,.436,30,60,.500,4,18,.222,19,22,.864,91,40,78,.513,34,63,.540,6,15,.400,15,19,.789,101,2012-11-09,WAS,MIL
68,@,L 91-106 ,240,34,83,.410,27,60,.450,7,23,.304,16,23,.696,91,40,73,.548,33,58,.569,7,15,.467,19,22,.864,106,2012-11-11,CLE,OKC
69,@,L 91-102 ,240,30,86,.349,23,65,.354,7,21,.333,24,31,.774,91,37,92,.402,28,71,.394,9,21,.429,19,23,.826,102,2012-11-19,HOU,UTA
70,Home,L 91-101 ,240,31,83,.373,23,61,.377,8,22,.364,21,26,.808,91,42,78,.538,31,56,.554,11,22,.500,6,14,.429,101,2012-11-23,CHA,ATL
71,@,L 91-102 ,240,35,80,.438,28,63,.444,7,17,.412,14,18,.778,91,40,84,.476,35,65,.538,5,19,.263,17,30,.567,102,2012-11-23,GSW,DEN
72,Home,W 91-90 ,240,36,78,.462,32,65,.492,4,13,.308,15,26,.577,91,32,78,.410,26,60,.433,6,18,.333,20,25,.800,90,2012-11-23,DET,TOR
73,@,W 91-78 ,240,37,79,.468,31,62,.500,6,17,.353,11,18,.611,91,30,84,.357,28,69,.406,2,15,.133,16,22,.727,78,2012-11-27,PHO,CLE
74,@,L 91-94 ,240,30,76,.395,18,52,.346,12,24,.500,19,23,.826,91,36,90,.400,24,58,.414,12,32,.375,10,15,.667,94,2012-11-28,CHA,ATL
75,Home,W 91-88 ,240,36,79,.456,32,66,.485,4,13,.308,15,20,.750,91,34,82,.415,28,63,.444,6,19,.316,14,17,.824,88,2012-12-01,MIL,BOS
76,Home,W 91-73 ,240,30,70,.429,26,51,.510,4,19,.211,27,35,.771,91,30,87,.345,23,63,.365,7,24,.292,6,9,.667,73,2012-12-07,MIN,CLE
77,Home,W 91-82 ,240,32,79,.405,28,58,.483,4,21,.190,23,28,.821,91,30,80,.375,26,65,.400,4,15,.267,18,21,.857,82,2012-12-07,SAC,ORL
78,@,L 91-103 ,240,36,88,.409,31,70,.443,5,18,.278,14,21,.667,91,37,62,.597,28,45,.622,9,17,.529,20,27,.741,103,2012-12-19,CLE,BOS
79,@,L 91-97 ,240,35,84,.417,32,72,.444,3,12,.250,18,30,.600,91,35,72,.486,25,43,.581,10,29,.345,17,22,.773,97,2012-12-19,DET,TOR
80,@,L 91-94 ,240,34,84,.405,27,62,.435,7,22,.318,16,18,.889,91,32,72,.444,26,46,.565,6,26,.231,24,28,.857,94,2012-12-23,MIN,NYK
81,@,L 91-129 ,240,34,74,.459,29,60,.483,5,14,.357,18,29,.621,91,47,84,.560,27,54,.500,20,30,.667,15,19,.789,129,2012-12-23,DAL,SAS
82,@,L 91-109 ,240,35,86,.407,26,62,.419,9,24,.375,12,16,.750,91,44,87,.506,38,66,.576,6,21,.286,15,20,.750,109,2012-12-26,SAC,POR
83,@,L 91-97 ,240,38,82,.463,36,68,.529,2,14,.143,13,16,.813,91,34,77,.442,26,61,.426,8,16,.500,21,29,.724,97,2012-12-28,PHO,IND
84,@,W 91-81 ,240,33,70,.471,29,60,.483,4,10,.400,21,38,.553,91,33,94,.351,29,78,.372,4,16,.250,11,18,.611,81,2012-12-31,CHA,CHI
85,@,L 91-110 ,240,28,78,.359,19,53,.358,9,25,.360,26,35,.743,91,39,76,.513,35,65,.538,4,11,.364,28,39,.718,110,2013-01-05,UTA,DEN
86,@,L 91-103 ,240,35,80,.438,26,47,.553,9,33,.273,12,29,.414,91,41,79,.519,32,56,.571,9,23,.391,12,16,.750,103,2013-01-11,HOU,BOS
87,@,L 91-98 ,240,37,85,.435,32,61,.525,5,24,.208,12,16,.750,91,36,82,.439,32,66,.485,4,16,.250,22,31,.710,98,2013-01-11,CLE,DEN
88,@,L 91-120 ,240,37,87,.425,32,69,.464,5,18,.278,12,15,.800,91,46,82,.561,39,71,.549,7,11,.636,21,25,.840,120,2013-01-14,ORL,WAS
89,@,W 91-83 ,240,37,84,.440,31,64,.484,6,20,.300,11,16,.688,91,38,83,.458,35,68,.515,3,15,.200,4,6,.667,83,2013-01-23,BRK,MIN
90,@,W 91-83 ,240,33,77,.429,24,57,.421,9,20,.450,16,23,.696,91,32,88,.364,29,72,.403,3,16,.188,16,18,.889,83,2013-01-27,NOH,MEM
91,@,L 91-112 ,240,36,87,.414,33,71,.465,3,16,.188,16,20,.800,91,41,87,.471,31,62,.500,10,25,.400,20,27,.741,112,2013-02-04,DAL,OKC
92,@,L 91-98 (OT),265,35,87,.402,32,67,.478,3,20,.150,18,25,.720,91,38,72,.528,31,60,.517,7,12,.583,15,18,.833,98,2013-02-04,SAC,UTA
93,@,L 91-116 ,240,34,89,.382,28,73,.384,6,16,.375,17,24,.708,91,38,77,.494,27,57,.474,11,20,.550,29,38,.763,116,2013-02-09,GSW,DAL
94,@,L 91-94 ,240,32,77,.416,26,63,.413,6,14,.429,21,26,.808,91,33,77,.429,25,59,.424,8,18,.444,20,30,.667,94,2013-02-11,BOS,CHA
95,Home,W 91-85 ,240,36,83,.434,29,62,.468,7,21,.333,12,18,.667,91,35,85,.412,32,72,.444,3,13,.231,12,17,.706,85,2013-02-12,LAL,PHO
96,Home,L 91-105 ,240,38,82,.463,29,62,.468,9,20,.450,6,10,.600,91,45,80,.563,42,71,.592,3,9,.333,12,20,.600,105,2013-02-19,DET,MEM
97,@,L 91-125 ,240,29,86,.337,24,58,.414,5,28,.179,28,36,.778,91,42,79,.532,31,55,.564,11,24,.458,30,39,.769,125,2013-02-20,NYK,IND
98,Home,L 91-102 ,240,37,83,.446,33,68,.485,4,15,.267,13,23,.565,91,38,78,.487,33,61,.541,5,17,.294,21,26,.808,102,2013-02-27,UTA,ATL
99,Home,L 91-99 ,240,32,75,.427,23,50,.460,9,25,.360,18,25,.720,91,39,80,.488,35,57,.614,4,23,.174,17,21,.810,99,2013-02-28,IND,LAC
0,@,L 91-98 ,240,33,77,.429,29,64,.453,4,13,.308,21,27,.778,91,34,73,.466,24,54,.444,10,19,.526,20,27,.741,98,2013-03-01,MEM,MIA
1,Home,W 91-85 ,240,38,87,.437,34,75,.453,4,12,.333,11,18,.611,91,31,76,.408,25,56,.446,6,20,.300,17,28,.607,85,2013-03-06,MEM,POR
2,@,L 91-105 ,240,26,63,.413,16,36,.444,10,27,.370,29,34,.853,91,38,68,.559,31,54,.574,7,14,.500,22,31,.710,105,2013-03-10,IND,MIA
3,Home,W 91-79 ,240,30,68,.441,26,52,.500,4,16,.250,27,33,.818,91,29,77,.377,22,57,.386,7,20,.350,14,20,.700,79,2013-03-10,OKC,BOS
4,@,L 91-99 ,240,40,86,.465,35,74,.473,5,12,.417,6,10,.600,91,41,83,.494,29,56,.518,12,27,.444,5,7,.714,99,2013-03-10,PHI,ORL
5,@,L 91-107 ,240,35,80,.438,29,61,.475,6,19,.316,15,18,.833,91,41,82,.500,32,57,.561,9,25,.360,16,26,.615,107,2013-03-13,MIN,IND
6,@,L 91-92 ,240,37,83,.446,29,64,.453,8,19,.421,9,10,.900,91,37,84,.440,32,71,.451,5,13,.385,13,17,.765,92,2013-03-14,DAL,SAS
7,@,L 91-98 ,240,34,88,.386,28,72,.389,6,16,.375,17,21,.810,91,39,79,.494,33,66,.500,6,13,.462,14,19,.737,98,2013-03-16,IND,PHI
8,Home,L 91-108 ,240,39,94,.415,37,74,.500,2,20,.100,11,12,.917,91,39,67,.582,29,45,.644,10,22,.455,20,29,.690,108,2013-03-17,TOR,MIA
9,Home,L 91-92 ,240,32,75,.427,28,58,.483,4,17,.235,23,25,.920,91,36,79,.456,26,53,.491,10,26,.385,10,14,.714,92,2013-03-23,CHA,DET
10,@,L 91-107 ,240,32,83,.386,28,69,.406,4,14,.286,23,28,.821,91,41,84,.488,34,70,.486,7,14,.500,18,21,.857,107,2013-03-25,PHI,UTA
11,Home,L 91-100 ,240,32,83,.386,26,62,.419,6,21,.286,21,26,.808,91,35,78,.449,29,60,.483,6,18,.333,24,28,.857,100,2013-03-27,HOU,IND
12,Home,L 91-105 ,240,35,71,.493,31,57,.544,4,14,.286,17,24,.708,91,34,73,.466,21,44,.477,13,29,.448,24,28,.857,105,2013-03-27,NOH,LAC
13,Home,L 91-97 ,240,36,89,.404,30,67,.448,6,22,.273,13,22,.591,91,36,89,.404,33,76,.434,3,13,.231,22,26,.846,97,2013-04-05,BOS,CLE
14,Home,W 91-85 ,240,32,89,.360,25,72,.347,7,17,.412,20,24,.833,91,34,90,.378,33,77,.429,1,13,.077,16,22,.727,85,2013-04-07,CLE,ORL
15,Home,L 91-96 ,240,37,80,.463,33,58,.569,4,22,.182,13,16,.813,91,42,90,.467,39,77,.506,3,13,.231,9,12,.750,96,2013-04-07,POR,DAL
16,Home,L 91-102 ,240,34,85,.400,28,68,.412,6,17,.353,17,21,.810,91,37,89,.416,25,62,.403,12,27,.444,16,17,.941,102,2013-04-10,DAL,PHO
17,Home,L 91-101 ,240,34,79,.430,28,57,.491,6,22,.273,17,24,.708,91,40,79,.506,30,51,.588,10,28,.357,11,17,.647,101,2013-04-12,CLE,NYK
18,@,W 91-87 ,240,37,80,.463,31,64,.484,6,16,.375,11,18,.611,91,34,83,.410,28,70,.400,6,13,.462,13,20,.650,87,2013-04-13,LAC,MEM
19,Home,W 91-86 ,240,31,85,.365,22,58,.379,9,27,.333,20,31,.645,91,33,89,.371,27,71,.380,6,18,.333,14,19,.737,86,2013-04-14,LAL,SAS
20,Home,W 91-77 ,240,38,86,.442,30,65,.462,8,21,.381,7,11,.636,91,31,85,.365,26,69,.377,5,16,.313,10,15,.667,77,2013-04-14,PHI,CLE
21,@,L 91-104 ,240,33,81,.407,25,55,.455,8,26,.308,17,24,.708,91,43,83,.518,39,64,.609,4,19,.211,14,18,.778,104,2013-10-30,POR,PHO
22,@,W 91-85 ,240,38,94,.404,33,73,.452,5,21,.238,10,14,.714,91,30,82,.366,22,55,.400,8,27,.296,17,24,.708,85,2013-11-01,SAS,LAL
23,Home,L 91-99 ,240,33,87,.379,28,62,.452,5,25,.200,20,25,.800,91,38,73,.521,29,52,.558,9,21,.429,14,23,.609,99,2013-11-05,DET,IND
24,Home,L 91-101 ,240,31,76,.408,27,60,.450,4,16,.250,25,30,.833,91,42,90,.467,30,64,.469,12,26,.462,5,9,.556,101,2013-11-08,CHA,NYK
25,Home,W 91-84 ,240,36,78,.462,30,57,.526,6,21,.286,13,16,.813,91,32,81,.395,26,63,.413,6,18,.333,14,16,.875,84,2013-11-08,IND,TOR
26,@,W 91-89 ,240,34,95,.358,32,81,.395,2,14,.143,21,26,.808,91,33,83,.398,29,63,.460,4,20,.200,19,29,.655,89,2013-11-08,BOS,ORL
27,@,L 91-104 ,240,36,86,.419,30,64,.469,6,22,.273,13,15,.867,91,39,80,.488,29,57,.509,10,23,.435,16,18,.889,104,2013-11-08,SAC,POR
28,Home,L 91-96 ,240,35,76,.461,27,57,.474,8,19,.421,13,16,.813,91,37,80,.463,30,66,.455,7,14,.500,15,20,.750,96,2013-11-09,BRK,IND
29,@,W 91-83 ,240,33,78,.423,27,59,.458,6,19,.316,19,21,.905,91,31,81,.383,20,58,.345,11,23,.478,10,16,.625,83,2013-11-09,DAL,MIL
30,@,L 91-115 ,240,34,77,.442,31,59,.525,3,18,.167,20,24,.833,91,40,83,.482,30,58,.517,10,25,.400,25,29,.862,115,2013-11-09,UTA,TOR
31,Home,L 91-95 ,240,35,77,.455,30,53,.566,5,24,.208,16,21,.762,91,37,88,.420,25,54,.463,12,34,.353,9,13,.692,95,2013-11-13,ATL,NYK
32,@,L 91-94 ,240,33,74,.446,28,61,.459,5,13,.385,20,22,.909,91,35,82,.427,26,56,.464,9,26,.346,15,21,.714,94,2013-11-13,MIL,ORL
33,@,W 91-82 ,240,35,76,.461,31,61,.508,4,15,.267,17,22,.773,91,35,91,.385,30,75,.400,5,16,.313,7,11,.636,82,2013-11-15,SAS,UTA
34,@,L 91-95 ,240,32,67,.478,23,48,.479,9,19,.474,18,25,.720,91,36,81,.444,31,68,.456,5,13,.385,18,30,.600,95,2013-11-20,BRK,CHA
35,Home,L 91-98 ,240,32,77,.416,23,54,.426,9,23,.391,18,21,.857,91,38,84,.452,30,65,.462,8,19,.421,14,14,1.000,98,2013-11-20,CLE,WAS
36,@,W 91-82 ,240,35,86,.407,24,55,.436,11,31,.355,10,15,.667,91,35,80,.438,30,66,.455,5,14,.357,7,12,.583,82,2013-11-20,POR,MIL
37,@,L 91-105 ,240,38,92,.413,30,64,.469,8,28,.286,7,15,.467,91,41,79,.519,37,60,.617,4,19,.211,19,29,.655,105,2013-11-21,LAC,OKC
38,Home,L 91-98 ,240,32,77,.416,29,63,.460,3,14,.214,24,33,.727,91,33,70,.471,23,47,.489,10,23,.435,22,38,.579,98,2013-11-22,CHA,PHO
39,@,L 91-102 ,240,38,85,.447,32,70,.457,6,15,.400,9,14,.643,91,37,84,.440,28,59,.475,9,25,.360,19,22,.864,102,2013-11-25,NYK,POR
40,Home,L 91-109 ,240,34,78,.436,25,59,.424,9,19,.474,14,15,.933,91,42,76,.553,34,59,.576,8,17,.471,17,17,1.000,109,2013-11-29,ORL,SAS
41,@,L 91-110 ,240,37,87,.425,30,58,.517,7,29,.241,10,15,.667,91,46,84,.548,41,70,.586,5,14,.357,13,21,.619,110,2013-12-03,PHO,MEM
42,@,W 91-90 ,240,34,81,.420,27,57,.474,7,24,.292,16,19,.842,91,33,74,.446,29,64,.453,4,10,.400,20,25,.800,90,2013-12-13,CHI,MIL
43,@,L 91-106 ,240,31,75,.413,24,48,.500,7,27,.259,22,38,.579,91,39,81,.481,36,68,.529,3,13,.231,25,30,.833,106,2013-12-15,HOU,SAC
44,@,L 91-105 ,240,37,93,.398,29,75,.387,8,18,.444,9,14,.643,91,40,73,.548,35,58,.603,5,15,.333,20,23,.870,105,2013-12-18,MEM,DAL
45,@,L 91-104 ,240,33,95,.347,28,73,.384,5,22,.227,20,25,.800,91,42,78,.538,35,59,.593,7,19,.368,13,15,.867,104,2013-12-20,MIN,LAL
46,@,L 91-112 ,240,31,88,.352,25,58,.431,6,30,.200,23,29,.793,91,39,86,.453,26,53,.491,13,33,.394,21,31,.677,112,2013-12-21,DEN,LAC
47,@,L 91-105 ,240,36,77,.468,28,56,.500,8,21,.381,11,16,.688,91,38,71,.535,30,52,.577,8,19,.421,21,25,.840,105,2013-12-28,BRK,IND
48,Home,L 91-95 ,240,35,78,.449,35,73,.479,0,5,.000,21,28,.750,91,28,65,.431,22,50,.440,6,15,.400,33,42,.786,95,2013-12-30,MEM,CHI
49,Home,L 91-92 ,240,35,84,.417,30,64,.469,5,20,.250,16,17,.941,91,33,91,.363,28,62,.452,5,29,.172,21,25,.840,92,2013-12-31,BOS,ATL
50,Home,W 91-76 ,240,34,77,.442,29,52,.558,5,25,.200,18,22,.818,91,29,80,.363,28,68,.412,1,12,.083,17,23,.739,76,2013-12-31,IND,CLE
51,Home,L 91-99 ,240,37,90,.411,29,60,.483,8,30,.267,9,16,.563,91,44,92,.478,41,78,.526,3,14,.214,8,14,.571,99,2014-01-02,PHO,MEM
52,Home,W 91-84 ,240,33,81,.407,27,64,.422,6,17,.353,19,24,.792,91,32,86,.372,24,58,.414,8,28,.286,12,14,.857,84,2014-01-04,CHI,ATL
53,Home,W 91-86 ,240,33,80,.413,25,53,.472,8,27,.296,17,26,.654,91,27,70,.386,19,46,.413,8,24,.333,24,26,.923,86,2014-01-06,BRK,ATL
54,@,L 91-112 ,240,34,86,.395,30,70,.429,4,16,.250,19,35,.543,91,35,86,.407,24,55,.436,11,31,.355,31,34,.912,112,2014-01-08,DET,TOR
55,Home,W 91-90 ,240,36,78,.462,30,61,.492,6,17,.353,13,18,.722,91,33,81,.407,28,70,.400,5,11,.455,19,23,.826,90,2014-01-17,MEM,SAC
56,@,L 91-93 ,240,33,90,.367,30,77,.390,3,13,.231,22,24,.917,91,30,71,.423,26,56,.464,4,15,.267,29,36,.806,93,2014-01-19,BOS,ORL
57,@,L 91-95 ,240,39,90,.433,33,64,.516,6,26,.231,7,9,.778,91,39,84,.464,34,69,.493,5,15,.333,12,20,.600,95,2014-01-22,LAC,CHA
58,Home,L 91-103 ,240,34,90,.378,30,63,.476,4,27,.148,19,27,.704,91,40,76,.526,36,55,.655,4,21,.190,19,25,.760,103,2014-01-25,PHI,OKC
59,Home,L 91-106 ,240,33,67,.493,22,41,.537,11,26,.423,14,23,.609,91,41,76,.539,33,53,.623,8,23,.348,16,24,.667,106,2014-02-01,NYK,MIA
60,@,W 91-75 ,240,37,78,.474,32,65,.492,5,13,.385,12,19,.632,91,29,93,.312,25,73,.342,4,20,.200,13,16,.813,75,2014-02-04,CHA,GSW
61,@,L 91-98 ,240,28,75,.373,24,57,.421,4,18,.222,31,37,.838,91,39,81,.481,31,66,.470,8,15,.533,12,16,.750,98,2014-02-07,MIN,NOP
62,Home,L 91-102 ,240,33,92,.359,22,65,.338,11,27,.407,14,15,.933,91,37,82,.451,27,59,.458,10,23,.435,18,20,.900,102,2014-02-09,BOS,DAL
63,Home,W 91-83 (OT),265,35,88,.398,25,68,.368,10,20,.500,11,18,.611,91,33,86,.384,30,72,.417,3,14,.214,14,16,.875,83,2014-02-09,CLE,MEM
64,@,L 91-104 ,240,35,87,.402,29,65,.446,6,22,.273,15,20,.750,91,40,83,.482,34,63,.540,6,20,.300,18,31,.581,104,2014-02-19,IND,MIN
65,Home,L 91-98 ,240,35,75,.467,28,54,.519,7,21,.333,14,21,.667,91,37,83,.446,27,62,.435,10,21,.476,14,20,.700,98,2014-02-19,NOP,NYK
66,@,L 91-98 ,240,32,82,.390,26,62,.419,6,20,.300,21,29,.724,91,40,93,.430,33,72,.458,7,21,.333,11,13,.846,98,2014-02-21,CLE,TOR
67,Home,L 91-100 ,240,34,85,.400,23,54,.426,11,31,.355,12,17,.706,91,36,71,.507,27,52,.519,9,19,.474,19,28,.679,100,2014-02-28,DAL,CHI
68,@,L 91-94 ,240,36,78,.462,30,64,.469,6,14,.429,13,18,.722,91,34,82,.415,29,67,.433,5,15,.333,21,28,.750,94,2014-03-02,UTA,IND
69,@,L 91-104 ,240,35,78,.449,27,55,.491,8,23,.348,13,22,.591,91,44,81,.543,38,66,.576,6,15,.400,10,10,1.000,104,2014-03-05,UTA,WAS
70,Home,W 91-84 ,240,31,70,.443,23,49,.469,8,21,.381,21,26,.808,91,29,80,.363,25,50,.500,4,30,.133,22,26,.846,84,2014-03-07,BOS,BRK
71,Home,W 91-79 ,240,34,79,.430,32,68,.471,2,11,.182,21,25,.840,91,28,77,.364,23,66,.348,5,11,.455,18,24,.750,79,2014-03-21,IND,CHI
72,Home,W 91-86 ,240,35,75,.467,28,55,.509,7,20,.350,14,16,.875,91,36,79,.456,33,65,.508,3,14,.214,11,17,.647,86,2014-03-21,MIA,MEM
73,Home,W 91-81 ,240,31,70,.443,26,56,.464,5,14,.357,24,31,.774,91,30,87,.345,29,67,.433,1,20,.050,20,22,.909,81,2014-03-22,CHI,PHI
74,@,L 91-93 ,240,28,74,.378,17,35,.486,11,39,.282,24,27,.889,91,37,84,.440,32,69,.464,5,15,.333,14,23,.609,93,2014-03-24,POR,MIA
75,@,L 91-113 ,240,36,88,.409,25,55,.455,11,33,.333,8,18,.444,91,44,79,.557,31,52,.596,13,27,.481,12,16,.750,113,2014-03-24,PHI,SAS
76,@,W 91-87 ,240,36,79,.456,32,70,.457,4,9,.444,15,16,.938,91,32,69,.464,27,53,.509,5,16,.313,18,26,.692,87,2014-03-26,MEM,UTA
77,@,W 91-74 ,240,35,80,.438,25,58,.431,10,22,.455,11,16,.688,91,33,84,.393,30,67,.448,3,17,.176,5,7,.714,74,2014-03-28,POR,CHI
78,Home,W 91-78 ,240,34,87,.391,27,64,.422,7,23,.304,16,17,.941,91,28,79,.354,26,66,.394,2,13,.154,20,25,.800,78,2014-03-28,WAS,IND
79,Home,W 91-80 ,240,33,78,.423,27,62,.435,6,16,.375,19,23,.826,91,31,87,.356,28,76,.368,3,11,.273,15,18,.833,80,2014-04-04,CHA,ORL
80,@,L 91-102 ,240,33,88,.375,18,46,.391,15,42,.357,10,13,.769,91,34,61,.557,22,34,.647,12,27,.444,22,30,.733,102,2014-04-06,NYK,MIA
81,Home,L 91-93 ,240,36,76,.474,31,58,.534,5,18,.278,14,20,.700,91,36,89,.404,23,58,.397,13,31,.419,8,14,.571,93,2014-04-06,SAC,DAL
82,@,L 91-110 ,240,36,81,.444,32,64,.500,4,17,.235,15,25,.600,91,42,91,.462,37,76,.487,5,15,.333,21,26,.808,110,2014-04-08,SAS,MIN
83,@,L 91-104 ,240,32,68,.471,27,60,.450,5,8,.625,22,34,.647,91,40,84,.476,32,62,.516,8,22,.364,16,19,.842,104,2014-04-12,MIL,WAS
84,Home,L 91-97 ,240,38,80,.475,33,54,.611,5,26,.192,10,14,.714,91,40,77,.519,34,62,.548,6,15,.400,11,15,.733,97,2014-04-14,PHO,MEM
85,Home,W 91-86 (OT),265,34,85,.400,29,64,.453,5,21,.238,18,26,.692,91,34,86,.395,26,64,.406,8,22,.364,10,15,.667,86,2014-04-16,CHA,CHI
86,@,L 91-103 ,240,34,89,.382,28,68,.412,6,21,.286,17,30,.567,91,38,81,.469,30,56,.536,8,25,.320,19,28,.679,103,2014-10-29,PHI,IND
87,@,L 91-97 ,240,38,91,.418,31,70,.443,7,21,.333,8,13,.615,91,37,76,.487,33,66,.500,4,10,.400,19,28,.679,97,2014-10-30,DET,MIN
88,@,L 91-102 ,240,35,80,.438,28,54,.519,7,26,.269,14,20,.700,91,37,80,.463,31,60,.517,6,20,.300,22,31,.710,102,2014-11-01,DEN,OKC
89,@,L 91-118 ,240,36,87,.414,29,56,.518,7,31,.226,12,15,.800,91,42,88,.477,35,62,.565,7,26,.269,27,33,.818,118,2014-11-01,PHO,UTA
90,Home,L 91-108 ,240,31,74,.419,19,46,.413,12,28,.429,17,27,.630,91,35,68,.515,18,31,.581,17,37,.459,21,27,.778,108,2014-11-04,MIA,HOU
91,@,L 91-100 ,240,37,80,.463,31,59,.525,6,21,.286,11,13,.846,91,38,81,.469,33,63,.524,5,18,.278,19,19,1.000,100,2014-11-04,CHO,NOP
92,Home,L 91-98 ,240,36,82,.439,28,61,.459,8,21,.381,11,17,.647,91,37,90,.411,30,73,.411,7,17,.412,17,22,.773,98,2014-11-05,BRK,MIN
93,@,W 91-89 ,240,39,88,.443,36,68,.529,3,20,.150,10,12,.833,91,33,77,.429,25,52,.481,8,25,.320,15,23,.652,89,2014-11-05,ORL,PHI
94,Home,L 91-102 ,240,32,69,.464,24,48,.500,8,21,.381,19,21,.905,91,40,80,.500,31,63,.492,9,17,.529,13,17,.765,102,2014-11-05,PHO,MEM
95,@,W 91-89 ,240,34,81,.420,25,63,.397,9,18,.500,14,17,.824,91,37,79,.468,25,54,.463,12,25,.480,3,11,.273,89,2014-11-07,MEM,OKC
96,@,L 91-102 ,240,34,80,.425,27,66,.409,7,14,.500,16,25,.640,91,39,88,.443,32,68,.471,7,20,.350,17,20,.850,102,2014-11-10,DET,CHI
97,@,W 91-85 ,240,27,71,.380,17,44,.386,10,27,.370,27,28,.964,91,36,83,.434,30,57,.526,6,26,.231,7,12,.583,85,2014-11-10,ATL,NYK
98,@,L 91-139 ,240,29,72,.403,26,58,.448,3,14,.214,30,41,.732,91,56,84,.667,41,64,.641,15,20,.750,12,16,.750,139,2014-11-14,MIN,NOP
99,@,L 91-94 ,240,34,80,.425,27,56,.482,7,24,.292,16,18,.889,91,37,86,.430,37,74,.500,0,12,.000,20,24,.833,94,2014-11-15,SAS,SAC
0,@,W 91-84 ,240,35,74,.473,30,56,.536,5,18,.278,16,26,.615,91,30,73,.411,19,48,.396,11,25,.440,13,22,.591,84,2014-11-16,MIL,MIA
1,Home,W 91-78 ,240,41,84,.488,37,74,.500,4,10,.400,5,9,.556,91,27,75,.360,21,48,.438,6,27,.222,18,23,.783,78,2014-11-21,WAS,CLE
2,Home,W 91-83 ,240,33,66,.500,27,49,.551,6,17,.353,19,21,.905,91,30,75,.400,22,49,.449,8,26,.308,15,25,.600,83,2014-11-22,NYK,PHI
3,@,L 91-107 ,240,32,77,.416,25,52,.481,7,25,.280,20,28,.714,91,42,85,.494,35,64,.547,7,21,.333,16,23,.696,107,2014-11-23,LAC,MEM
4,@,W 91-86 ,240,33,93,.355,26,68,.382,7,25,.280,18,24,.750,91,32,90,.356,29,73,.397,3,17,.176,19,27,.704,86,2014-11-23,GSW,OKC
5,Home,W 91-86 ,240,32,76,.421,18,40,.450,14,36,.389,13,19,.684,91,35,76,.461,29,54,.537,6,22,.273,10,15,.667,86,2014-11-24,HOU,NYK
6,Home,L 91-99 ,240,34,85,.400,25,61,.410,9,24,.375,14,17,.824,91,35,71,.493,27,47,.574,8,24,.333,21,28,.750,99,2014-11-26,PHI,BRK
7,@,L 91-100 ,240,36,89,.404,29,65,.446,7,24,.292,12,16,.750,91,38,76,.500,33,59,.559,5,17,.294,19,22,.864,100,2014-11-28,NOP,ATL
8,Home,L 91-103 ,240,32,84,.381,24,56,.429,8,28,.286,19,30,.633,91,35,71,.493,26,48,.542,9,23,.391,24,31,.774,103,2014-12-05,PHI,OKC
9,Home,L 91-105 ,240,35,86,.407,27,62,.435,8,24,.333,13,20,.650,91,41,84,.488,32,64,.500,9,20,.450,14,21,.667,105,2014-12-05,TOR,CLE
10,@,W 91-89 ,240,41,81,.506,36,69,.522,5,12,.417,4,9,.444,91,38,84,.452,31,69,.449,7,15,.467,6,9,.667,89,2014-12-10,WAS,ORL
11,Home,L 91-99 ,240,34,83,.410,26,67,.388,8,16,.500,15,21,.714,91,34,74,.459,29,58,.500,5,16,.313,26,35,.743,99,2014-12-14,DEN,SAS
12,@,L 91-110 ,240,29,88,.330,19,62,.306,10,26,.385,23,29,.793,91,40,83,.482,33,66,.500,7,17,.412,23,27,.852,110,2014-12-15,LAL,IND
13,@,L 91-113 ,240,35,83,.422,27,56,.482,8,27,.296,13,22,.591,91,43,80,.538,31,56,.554,12,24,.500,15,20,.750,113,2014-12-15,DET,LAC
14,Home,L 91-95 ,240,30,77,.390,22,49,.449,8,28,.286,23,32,.719,91,33,72,.458,24,48,.500,9,24,.375,20,26,.769,95,2014-12-16,BRK,MIA
15,@,L 91-95 ,240,37,78,.474,28,54,.519,9,24,.375,8,12,.667,91,31,77,.403,22,53,.415,9,24,.375,24,29,.828,95,2014-12-19,BRK,CLE
16,Home,L 91-109 ,240,32,71,.451,20,45,.444,12,26,.462,15,17,.882,91,43,98,.439,33,74,.446,10,24,.417,13,17,.765,109,2014-12-19,PHI,CHO
17,@,L 91-105 ,240,39,86,.453,38,70,.543,1,16,.063,12,15,.800,91,46,76,.605,39,62,.629,7,14,.500,6,10,.600,105,2014-12-21,MEM,CLE
18,Home,L 91-97 ,240,38,86,.442,31,63,.492,7,23,.304,8,9,.889,91,34,75,.453,25,56,.446,9,19,.474,20,27,.741,97,2014-12-22,MEM,UTA
19,@,W 91-87 ,240,33,77,.429,28,58,.483,5,19,.263,20,27,.741,91,33,80,.413,25,54,.463,8,26,.308,13,18,.722,87,2014-12-23,PHI,MIA
20,Home,L 91-99 ,240,38,89,.427,33,80,.413,5,9,.556,10,16,.625,91,39,85,.459,34,68,.500,5,17,.294,16,24,.667,99,2014-12-23,WAS,CHI
21,@,L 91-101 ,240,32,72,.444,26,46,.565,6,26,.231,21,33,.636,91,40,84,.476,33,63,.524,7,21,.333,14,17,.824,101,2014-12-25,CLE,MIA
22,Home,L 91-102 ,240,36,80,.450,32,58,.552,4,22,.182,15,19,.789,91,44,86,.512,37,70,.529,7,16,.438,7,10,.700,102,2014-12-25,NYK,WAS
23,@,W 91-87 ,240,33,87,.379,29,72,.403,4,15,.267,21,30,.700,91,32,87,.368,26,59,.441,6,28,.214,17,26,.654,87,2015-01-02,CLE,CHO
24,Home,L 91-94 ,240,38,89,.427,31,65,.477,7,24,.292,8,10,.800,91,35,81,.432,27,61,.443,8,20,.400,16,20,.800,94,2015-01-02,MIL,IND
25,@,L 91-127 ,240,32,79,.405,23,54,.426,9,25,.360,18,26,.692,91,46,85,.541,31,48,.646,15,37,.405,20,26,.769,127,2015-01-03,PHI,LAC
26,@,L 91-117 ,240,30,98,.306,25,70,.357,5,28,.179,26,34,.765,91,41,88,.466,26,60,.433,15,28,.536,20,32,.625,117,2015-01-05,OKC,GSW
27,@,L 91-101 ,240,34,82,.415,23,56,.411,11,26,.423,12,16,.750,91,39,76,.513,31,60,.517,8,16,.500,15,21,.714,101,2015-01-07,NYK,WAS
28,Home,L 91-105 ,240,34,83,.410,23,50,.460,11,33,.333,12,14,.857,91,36,73,.493,26,44,.591,10,29,.345,23,27,.852,105,2015-01-14,BOS,ATL
29,@,L 91-110 ,240,31,78,.397,26,53,.491,5,25,.200,24,26,.923,91,39,78,.500,26,49,.531,13,29,.448,19,26,.731,110,2015-01-21,IND,ATL
30,Home,L 91-98 ,240,29,79,.367,21,56,.375,8,23,.348,25,32,.781,91,37,91,.407,30,71,.423,7,20,.350,17,20,.850,98,2015-01-21,PHI,NYK
31,@,W 91-86 ,240,33,80,.413,27,56,.482,6,24,.250,19,24,.792,91,31,81,.383,22,52,.423,9,29,.310,15,18,.833,86,2015-01-23,TOR,PHI
32,Home,L 91-104 ,240,34,82,.415,27,64,.422,7,18,.389,16,23,.696,91,34,73,.466,25,47,.532,9,26,.346,27,34,.794,104,2015-01-27,IND,TOR
33,Home,W 91-85 ,240,34,78,.436,24,50,.480,10,28,.357,13,18,.722,91,31,81,.383,17,46,.370,14,35,.400,9,15,.600,85,2015-01-31,ATL,PHI
34,@,L 91-108 ,240,35,74,.473,29,60,.483,6,14,.429,15,23,.652,91,42,88,.477,33,68,.485,9,20,.450,15,18,.833,108,2015-02-03,MIA,DET
35,Home,L 91-102 ,240,37,97,.381,30,72,.417,7,25,.280,10,13,.769,91,45,85,.529,40,70,.571,5,15,.333,7,11,.636,102,2015-02-04,NOP,OKC
36,Home,L 91-94 ,240,33,86,.384,28,72,.389,5,14,.357,20,27,.741,91,40,90,.444,33,63,.524,7,27,.259,7,9,.778,94,2015-02-11,MIN,GSW
37,@,L 91-100 ,240,33,78,.423,28,62,.452,5,16,.313,20,22,.909,91,38,84,.452,32,62,.516,6,22,.273,18,33,.545,100,2015-02-20,CHI,DET
38,Home,L 91-105 ,240,33,79,.418,28,62,.452,5,17,.294,20,27,.741,91,35,83,.422,27,62,.435,8,21,.381,27,31,.871,105,2015-02-21,MIA,NOP
39,Home,L 91-93 ,240,32,81,.395,25,55,.455,7,26,.269,20,21,.952,91,34,79,.430,24,54,.444,10,25,.400,15,20,.750,93,2015-02-28,MIA,ATL
40,Home,L 91-115 ,240,35,88,.398,32,72,.444,3,16,.188,18,24,.750,91,42,85,.494,34,66,.515,8,19,.421,23,28,.821,115,2015-03-04,BRK,CHO
41,Home,W 91-85 ,240,36,78,.462,26,58,.448,10,20,.500,9,15,.600,91,31,81,.383,22,53,.415,9,28,.321,14,22,.636,85,2015-03-07,MIL,WAS
42,Home,L 91-101 ,240,35,80,.438,25,58,.431,10,22,.455,11,14,.786,91,42,84,.500,37,70,.529,5,14,.357,12,17,.706,101,2015-03-09,CHI,MEM
43,Home,L 91-111 ,240,35,84,.417,29,68,.426,6,16,.375,15,23,.652,91,45,87,.517,33,66,.500,12,21,.571,9,11,.818,111,2015-03-10,BRK,NOP
44,@,L 91-97 ,240,34,85,.400,24,67,.358,10,18,.556,13,13,1.000,91,39,79,.494,31,61,.508,8,18,.444,11,16,.688,97,2015-03-11,ORL,MIL
45,@,L 91-109 ,240,34,79,.430,27,47,.574,7,32,.219,16,24,.667,91,44,92,.478,33,59,.559,11,33,.333,10,17,.588,109,2015-03-12,HOU,UTA
46,@,L 91-101 ,240,31,82,.378,16,50,.320,15,32,.469,14,19,.737,91,33,89,.371,26,70,.371,7,19,.368,28,33,.848,101,2015-03-13,CHI,CHO
47,@,W 91-86 ,240,34,76,.447,29,53,.547,5,23,.217,18,27,.667,91,34,85,.400,27,67,.403,7,18,.389,11,15,.733,86,2015-03-15,ATL,LAL
48,@,L 91-108 ,240,37,79,.468,30,52,.577,7,27,.259,10,19,.526,91,43,81,.531,36,65,.554,7,16,.438,15,19,.789,108,2015-03-20,DEN,MIA
49,@,L 91-101 ,240,36,91,.396,30,73,.411,6,18,.333,13,16,.813,91,37,78,.474,28,57,.491,9,21,.429,18,25,.720,101,2015-03-20,CHO,SAC
50,@,L 91-107 ,240,33,77,.429,27,56,.482,6,21,.286,19,24,.792,91,44,90,.489,33,64,.516,11,26,.423,8,10,.800,107,2015-03-21,CHI,DET
51,@,L 91-106 ,240,32,73,.438,22,51,.431,10,22,.455,17,21,.810,91,38,78,.487,30,60,.500,8,18,.444,22,26,.846,106,2015-03-21,UTA,GSW
52,Home,L 91-110 ,240,32,89,.360,31,72,.431,1,17,.059,26,30,.867,91,47,92,.511,41,70,.586,6,22,.273,10,14,.714,110,2015-03-23,BRK,BOS
53,@,W 91-88 ,240,39,91,.429,36,77,.468,3,14,.214,10,11,.909,91,36,91,.396,33,79,.418,3,12,.250,13,20,.650,88,2015-03-25,BRK,CHO
54,@,L 91-130 ,240,36,90,.400,30,72,.417,6,18,.333,13,14,.929,91,51,88,.580,38,67,.567,13,21,.619,15,19,.789,130,2015-03-25,OKC,SAS
55,@,L 91-107 ,240,32,81,.395,27,54,.500,5,27,.185,22,31,.710,91,39,76,.513,26,52,.500,13,24,.542,16,23,.696,107,2015-03-27,UTA,DEN
56,Home,L 91-99 ,240,29,75,.387,25,60,.417,4,15,.267,29,37,.784,91,34,80,.425,25,51,.490,9,29,.310,22,33,.667,99,2015-03-29,WAS,HOU
57,@,L 91-95 ,240,31,74,.419,26,48,.542,5,26,.192,24,37,.649,91,37,89,.416,29,68,.426,8,21,.381,13,18,.722,95,2015-04-01,CHI,MIL
58,Home,L 91-103 ,240,39,93,.419,34,76,.447,5,17,.294,8,9,.889,91,35,86,.407,22,57,.386,13,29,.448,20,23,.870,103,2015-04-01,ORL,SAS
59,@,L 91-92 ,240,28,76,.368,17,50,.340,11,26,.423,24,33,.727,91,35,86,.407,34,73,.466,1,13,.077,21,23,.913,92,2015-04-04,PHI,CHO
60,@,L 91-101 ,240,38,99,.384,28,67,.418,10,32,.313,5,8,.625,91,37,72,.514,34,59,.576,3,13,.231,24,29,.828,101,2015-04-05,PHI,NYK
61,@,L 91-116 ,240,32,85,.376,29,74,.392,3,11,.273,24,29,.828,91,42,85,.494,30,52,.577,12,33,.364,20,23,.870,116,2015-04-08,MIN,POR
62,@,L 91-103 ,240,33,75,.440,26,59,.441,7,16,.438,18,28,.643,91,36,74,.486,23,43,.535,13,31,.419,18,25,.720,103,2015-04-08,SAC,UTA
63,Home,L 91-99 ,240,34,72,.472,29,59,.492,5,13,.385,18,24,.750,91,37,76,.487,31,59,.525,6,17,.353,19,29,.655,99,2015-04-10,NYK,MIL
64,@,L 91-107 ,240,35,85,.412,31,69,.449,4,16,.250,17,23,.739,91,35,69,.507,27,50,.540,8,19,.421,29,34,.853,107,2015-04-12,PHO,SAS
65,Home,W 91-85 ,240,31,77,.403,24,53,.453,7,24,.292,22,26,.846,91,36,92,.391,28,63,.444,8,29,.276,5,7,.714,85,2015-04-15,CHI,ATL
66,@,L 91-117 ,240,38,101,.376,33,74,.446,5,27,.185,10,18,.556,91,41,76,.539,29,48,.604,12,28,.429,23,34,.676,117,2015-04-15,UTA,HOU
67,@,L 91-101 ,240,38,79,.481,35,66,.530,3,13,.231,12,18,.667,91,34,80,.425,25,57,.439,9,23,.391,24,28,.857,101,2015-10-31,BRK,MEM
68,Home,L 91-102 ,240,33,86,.384,26,63,.413,7,23,.304,18,25,.720,91,37,82,.451,32,65,.492,5,17,.294,23,26,.885,102,2015-11-03,DAL,TOR
69,Home,W 91-87 ,240,35,86,.407,27,63,.429,8,23,.348,13,17,.765,91,34,81,.420,28,53,.528,6,28,.214,13,15,.867,87,2015-11-04,MIL,PHI
70,Home,L 91-102 ,240,32,77,.416,28,53,.528,4,24,.167,23,32,.719,91,38,79,.481,32,62,.516,6,17,.353,20,31,.645,102,2015-11-11,BOS,IND
71,@,L 91-92 ,240,34,89,.382,30,72,.417,4,17,.235,19,25,.760,91,36,77,.468,32,64,.500,4,13,.308,16,25,.640,92,2015-11-12,UTA,MIA
72,Home,L 91-103 ,240,36,79,.456,31,55,.564,5,24,.208,14,30,.467,91,36,97,.371,32,76,.421,4,21,.190,27,35,.771,103,2015-11-17,MIA,MIN
73,Home,L 91-102 ,240,35,77,.455,27,52,.519,8,25,.320,13,17,.765,91,34,78,.436,19,45,.422,15,33,.455,19,24,.792,102,2015-11-20,LAL,TOR
74,@,L 91-102 ,240,38,86,.442,31,62,.500,7,24,.292,8,16,.500,91,38,90,.422,30,65,.462,8,25,.320,18,24,.750,102,2015-11-20,LAC,POR
75,@,L 91-96 ,240,31,82,.378,21,51,.412,10,31,.323,19,24,.792,91,30,69,.435,25,51,.490,5,18,.278,31,45,.689,96,2015-11-21,PHI,MIA
76,Home,L 91-97 ,240,38,92,.413,29,61,.475,9,31,.290,6,8,.750,91,31,81,.383,24,61,.393,7,20,.350,28,31,.903,97,2015-11-21,ORL,SAC
77,@,W 91-80 ,240,29,78,.372,25,61,.410,4,17,.235,29,31,.935,91,29,74,.392,22,42,.524,7,32,.219,15,20,.750,80,2015-11-22,TOR,LAC
78,Home,L 91-102 ,240,38,75,.507,34,63,.540,4,12,.333,11,17,.647,91,39,77,.506,33,64,.516,6,13,.462,18,25,.720,102,2015-11-25,LAC,UTA
79,@,L 91-100 ,240,31,83,.373,22,56,.393,9,27,.333,20,25,.800,91,34,86,.395,29,70,.414,5,16,.313,27,32,.844,100,2015-11-25,NYK,ORL
80,@,W 91-80 ,240,36,75,.480,28,53,.528,8,22,.364,11,14,.786,91,31,77,.403,24,57,.421,7,20,.350,11,13,.846,80,2015-11-27,SAS,DEN
81,Home,L 91-101 ,240,37,86,.430,29,64,.453,8,22,.364,9,15,.600,91,37,77,.481,28,52,.538,9,25,.360,18,19,.947,101,2015-11-27,SAC,MIN
82,@,L 91-110 ,240,36,88,.409,31,61,.508,5,27,.185,14,20,.700,91,45,93,.484,36,68,.529,9,25,.360,11,16,.688,110,2015-11-29,BOS,ORL
83,@,L 91-94 ,240,33,75,.440,23,47,.489,10,28,.357,15,22,.682,91,41,84,.488,37,71,.521,4,13,.308,8,12,.667,94,2015-12-01,PHO,BRK
84,@,L 91-103 ,240,33,89,.371,25,55,.455,8,34,.235,17,24,.708,91,37,79,.468,23,47,.489,14,32,.438,15,23,.652,103,2015-12-01,LAL,PHI
85,Home,L 91-103 ,240,30,79,.380,24,52,.462,6,27,.222,25,39,.641,91,32,76,.421,25,56,.446,7,20,.350,32,39,.821,103,2015-12-02,LAC,IND
86,@,L 91-108 ,240,39,91,.429,36,80,.450,3,11,.273,10,15,.667,91,39,87,.448,27,60,.450,12,27,.444,18,21,.857,108,2015-12-04,BRK,NYK
87,@,L 91-106 ,240,32,76,.421,26,51,.510,6,25,.240,21,28,.750,91,44,89,.494,42,85,.494,2,4,.500,16,24,.667,106,2015-12-05,NYK,MIL
88,@,L 91-111 ,240,32,80,.400,27,62,.435,5,18,.278,22,29,.759,91,41,93,.441,32,69,.464,9,24,.375,20,26,.769,111,2015-12-06,LAL,DET
89,@,L 91-100 ,240,34,87,.391,30,56,.536,4,31,.129,19,22,.864,91,37,74,.500,31,60,.517,6,14,.429,20,27,.741,100,2015-12-10,PHI,BRK
90,@,L 91-107 ,240,37,94,.394,32,73,.438,5,21,.238,12,17,.706,91,41,82,.500,36,62,.581,5,20,.250,20,24,.833,107,2015-12-19,CHI,NYK
91,Home,W 91-84 ,240,32,83,.386,27,61,.443,5,22,.227,22,25,.880,91,32,82,.390,27,66,.409,5,16,.313,15,16,.938,84,2015-12-23,CLE,NYK
92,@,L 91-100 ,240,33,72,.458,30,55,.545,3,17,.176,22,32,.688,91,37,82,.451,26,57,.456,11,25,.440,15,19,.789,100,2015-12-23,MEM,WAS
93,@,L 91-100 ,240,33,89,.371,29,70,.414,4,19,.211,21,24,.875,91,36,85,.424,28,65,.431,8,20,.400,20,29,.690,100,2015-12-27,NYK,BOS
94,@,L 91-95 ,240,36,86,.419,31,65,.477,5,21,.238,14,19,.737,91,28,84,.333,21,58,.362,7,26,.269,32,36,.889,95,2015-12-28,PHI,UTA
95,Home,L 91-108 ,240,34,87,.391,27,63,.429,7,24,.292,16,24,.667,91,41,78,.526,34,55,.618,7,23,.304,19,25,.760,108,2015-12-28,WAS,LAC
96,@,L 91-114 ,240,33,81,.407,26,62,.419,7,19,.368,18,24,.750,91,42,82,.512,28,55,.509,14,27,.519,16,20,.800,114,2015-12-30,GSW,DAL
97,@,L 91-94 ,240,35,87,.402,27,65,.415,8,22,.364,13,17,.765,91,28,82,.341,22,58,.379,6,24,.250,32,39,.821,94,2015-12-30,WAS,TOR
98,@,L 91-103 ,240,40,85,.471,35,65,.538,5,20,.250,6,8,.750,91,43,92,.467,35,66,.530,8,26,.308,9,10,.900,103,2016-01-01,ORL,WAS
99,@,W 91-78 ,240,35,91,.385,32,76,.421,3,15,.200,18,26,.692,91,28,72,.389,21,44,.477,7,28,.250,15,24,.625,78,2016-01-04,MEM,POR
0,Home,L 91-93 ,240,30,75,.400,18,46,.391,12,29,.414,19,25,.760,91,33,68,.485,22,42,.524,11,26,.423,16,21,.762,93,2016-01-04,UTA,HOU
1,@,W 91-74 ,240,35,80,.438,31,58,.534,4,22,.182,17,18,.944,91,31,78,.397,26,62,.419,5,16,.313,7,12,.583,74,2016-01-06,TOR,BRK
2,Home,L 91-100 ,240,34,92,.370,27,62,.435,7,30,.233,16,20,.800,91,37,87,.425,30,59,.508,7,28,.250,19,22,.864,100,2016-01-06,NOP,DAL
3,Home,W 91-84 ,240,30,82,.366,22,64,.344,8,18,.444,23,30,.767,91,32,87,.368,28,68,.412,4,19,.211,16,19,.842,84,2016-01-08,MEM,DEN
4,@,W 91-86 ,240,36,81,.444,31,60,.517,5,21,.238,14,19,.737,91,31,83,.373,22,54,.407,9,29,.310,15,20,.750,86,2016-01-08,IND,NOP
5,@,L 91-95 ,240,38,91,.418,32,68,.471,6,23,.261,9,14,.643,91,32,87,.368,26,58,.448,6,29,.207,25,32,.781,95,2016-01-12,NOP,LAL
6,Home,L 91-107 ,240,33,72,.458,26,54,.481,7,18,.389,18,24,.750,91,33,77,.429,15,42,.357,18,35,.514,23,27,.852,107,2016-01-12,MEM,HOU
7,@,W 91-77 ,240,34,87,.391,26,52,.500,8,35,.229,15,23,.652,91,26,74,.351,20,49,.408,6,25,.240,19,29,.655,77,2016-01-15,CLE,HOU
8,@,W 91-79 ,240,36,74,.486,31,62,.500,5,12,.417,14,16,.875,91,27,74,.365,22,52,.423,5,22,.227,20,26,.769,79,2016-01-19,MIL,MIA
9,@,W 91-78 ,240,36,77,.468,31,60,.517,5,17,.294,14,20,.700,91,35,84,.417,31,65,.477,4,19,.211,4,8,.500,78,2016-01-20,CLE,BRK
10,Home,W 91-88 ,240,33,92,.359,26,68,.382,7,24,.292,18,24,.750,91,35,84,.417,27,51,.529,8,33,.242,10,15,.667,88,2016-01-21,SAC,ATL
11,Home,L 91-116 ,240,32,75,.427,25,51,.490,7,24,.292,20,30,.667,91,44,90,.489,35,68,.515,9,22,.409,19,23,.826,116,2016-01-25,WAS,BOS
12,@,W 91-89 ,240,32,78,.410,17,41,.415,15,37,.405,12,24,.500,91,35,83,.422,30,67,.448,5,16,.313,14,24,.583,89,2016-01-26,LAC,IND
13,Home,L 91-114 ,240,32,85,.376,23,60,.383,9,25,.360,18,23,.783,91,47,95,.495,41,78,.526,6,17,.353,14,16,.875,114,2016-01-28,LAL,CHI
14,Home,W 91-79 ,240,37,80,.463,29,59,.492,8,21,.381,9,15,.600,91,28,78,.359,24,58,.414,4,20,.200,19,23,.826,79,2016-01-29,DAL,BRK
15,@,L 91-109 ,240,31,80,.388,21,51,.412,10,29,.345,19,28,.679,91,45,92,.489,38,72,.528,7,20,.350,12,16,.750,109,2016-01-29,CHO,POR
16,Home,W 91-78 ,240,31,78,.397,23,49,.469,8,29,.276,21,23,.913,91,27,74,.365,22,51,.431,5,23,.217,19,24,.792,78,2016-01-31,DAL,PHO
17,@,W 91-85 ,240,33,76,.434,29,58,.500,4,18,.222,21,24,.875,91,30,80,.375,20,51,.392,10,29,.345,15,17,.882,85,2016-02-05,MEM,NYK
18,@,L 91-108 ,240,35,90,.389,25,65,.385,10,25,.400,11,14,.786,91,35,80,.438,21,44,.477,14,36,.389,24,31,.774,108,2016-02-08,CHI,CHO
19,@,L 91-111 ,240,33,83,.398,26,60,.433,7,23,.304,18,26,.692,91,39,83,.470,28,55,.509,11,28,.393,22,34,.647,111,2016-02-24,PHI,DET
20,Home,L 91-102 ,240,38,78,.487,31,66,.470,7,12,.583,8,12,.667,91,37,88,.420,25,58,.431,12,30,.400,16,24,.667,102,2016-02-27,MIL,DET
21,@,L 91-99 ,240,34,96,.354,30,68,.441,4,28,.143,19,22,.864,91,32,78,.410,25,62,.403,7,16,.438,28,30,.933,99,2016-03-07,SAS,IND
22,Home,L 91-116 ,240,36,79,.456,32,64,.500,4,15,.267,15,19,.789,91,47,85,.553,43,66,.652,4,19,.211,18,19,.947,116,2016-03-08,MIN,SAS
23,@,W 91-84 ,240,38,80,.475,30,55,.545,8,25,.320,7,14,.500,91,30,86,.349,23,60,.383,7,26,.269,17,23,.739,84,2016-03-08,ATL,UTA
24,@,L 91-105 ,240,36,82,.439,27,61,.443,9,21,.429,10,12,.833,91,37,77,.481,24,49,.490,13,28,.464,18,25,.720,105,2016-03-18,BOS,TOR
25,Home,W 91-88 ,240,35,87,.402,27,68,.397,8,19,.421,13,19,.684,91,37,86,.430,33,69,.478,4,17,.235,10,13,.769,88,2016-03-21,CHO,SAS
26,@,L 91-124 ,240,32,81,.395,24,59,.407,8,22,.364,19,25,.760,91,48,86,.558,33,55,.600,15,31,.484,13,17,.765,124,2016-03-21,DEN,CLE
27,@,L 91-92 ,240,41,76,.539,36,67,.537,5,9,.556,4,7,.571,91,35,85,.412,26,52,.500,9,33,.273,13,17,.765,92,2016-03-21,MIL,DET
28,Home,W 91-75 ,240,35,81,.432,25,55,.455,10,26,.385,11,13,.846,91,31,80,.388,27,62,.435,4,18,.222,9,14,.643,75,2016-03-21,IND,PHI
29,Home,W 91-79 ,240,35,80,.438,27,60,.450,8,20,.400,13,21,.619,91,31,89,.348,25,67,.373,6,22,.273,11,20,.550,79,2016-03-23,BOS,TOR
30,@,L 91-113 ,240,35,73,.479,30,51,.588,5,22,.227,16,23,.696,91,45,83,.542,36,61,.590,9,22,.409,14,22,.636,113,2016-03-24,UTA,OKC
31,Home,L 91-115 ,240,37,84,.440,33,69,.478,4,15,.267,13,15,.867,91,41,74,.554,25,45,.556,16,29,.552,17,21,.810,115,2016-03-26,MIL,CHO
32,Home,L 91-115 ,240,37,85,.435,33,70,.471,4,15,.267,13,20,.650,91,39,73,.534,27,44,.614,12,29,.414,25,28,.893,115,2016-03-26,NOP,TOR
33,@,L 91-99 ,240,36,89,.404,26,58,.448,10,31,.323,9,13,.692,91,32,75,.427,24,56,.429,8,19,.421,27,37,.730,99,2016-03-28,NYK,NOP
34,Home,W 91-89 ,240,35,85,.412,27,60,.450,8,25,.320,13,17,.765,91,35,77,.455,32,60,.533,3,17,.176,16,18,.889,89,2016-03-30,DAL,NYK
35,@,L 91-100 ,240,33,90,.367,23,51,.451,10,39,.256,15,21,.714,91,36,84,.429,29,57,.509,7,27,.259,21,27,.778,100,2016-04-01,PHI,CHO
36,@,L 91-105 ,240,36,101,.356,32,77,.416,4,24,.167,15,20,.750,91,42,84,.500,28,61,.459,14,23,.609,7,7,1.000,105,2016-04-01,BRK,NYK
37,@,W 91-81 ,240,37,83,.446,30,58,.517,7,25,.280,10,14,.714,91,32,90,.356,28,71,.394,4,19,.211,13,17,.765,81,2016-04-06,LAC,LAL
38,@,L 91-98 ,240,30,74,.405,22,44,.500,8,30,.267,23,33,.697,91,37,76,.487,28,58,.483,9,18,.500,15,37,.405,98,2016-04-10,DAL,LAC
39,Home,L 91-96 ,240,31,77,.403,19,38,.500,12,39,.308,17,21,.810,91,35,74,.473,29,51,.569,6,23,.261,20,26,.769,96,2016-04-13,DAL,SAS
40,@,L 91-109 ,240,35,84,.417,31,62,.500,4,22,.182,17,22,.773,91,41,86,.477,38,68,.559,3,18,.167,24,29,.828,109,2016-10-26,DET,TOR
41,Home,L 91-97 ,240,32,86,.372,18,52,.346,14,34,.412,13,20,.650,91,35,92,.380,28,70,.400,7,22,.318,20,24,.833,97,2016-10-28,MIA,CHO
42,Home,L 91-94 ,240,35,90,.389,31,74,.419,4,16,.250,17,18,.944,91,33,79,.418,21,47,.447,12,32,.375,16,22,.727,94,2016-10-28,TOR,CLE
43,Home,L 91-106 ,240,33,76,.434,27,56,.482,6,20,.300,19,21,.905,91,38,76,.500,23,45,.511,15,31,.484,15,18,.833,106,2016-11-01,SAS,UTA
44,@,L 91-117 ,240,33,84,.393,23,56,.411,10,28,.357,15,19,.789,91,41,82,.500,27,49,.551,14,33,.424,21,25,.840,117,2016-11-05,SAC,MIL
45,Home,L 91-96 ,240,30,84,.357,23,54,.426,7,30,.233,24,31,.774,91,34,78,.436,29,62,.468,5,16,.313,23,31,.742,96,2016-11-06,TOR,SAC
46,Home,L 91-101 ,240,34,85,.400,26,64,.406,8,21,.381,15,20,.750,91,38,74,.514,29,47,.617,9,27,.333,16,22,.727,101,2016-11-10,SAC,LAL
47,Home,L 91-102 ,240,38,81,.469,33,64,.516,5,17,.294,10,19,.526,91,40,81,.494,34,61,.557,6,20,.300,16,19,.842,102,2016-11-12,MIA,UTA
48,@,L 91-105 ,240,33,85,.388,26,59,.441,7,26,.269,18,23,.783,91,42,86,.488,34,64,.531,8,22,.364,13,30,.433,105,2016-11-20,UTA,DEN
49,@,L 91-96 ,240,35,74,.473,27,47,.574,8,27,.296,13,20,.650,91,35,75,.467,27,55,.491,8,20,.400,18,25,.720,96,2016-11-21,DAL,SAS
50,Home,L 91-94 ,240,35,80,.438,28,57,.491,7,23,.304,14,20,.700,91,40,88,.455,34,59,.576,6,29,.207,8,10,.800,94,2016-11-25,ORL,WAS
51,Home,W 91-81 ,240,32,77,.416,22,50,.440,10,27,.370,17,20,.850,91,30,77,.390,25,57,.439,5,20,.250,16,18,.889,81,2016-11-27,DAL,NOP
52,Home,W 91-70 ,240,40,92,.435,35,73,.479,5,19,.263,6,7,.857,91,22,70,.314,18,46,.391,4,24,.167,22,27,.815,70,2016-11-27,IND,LAC
53,@,L 91-102 ,240,33,75,.440,31,60,.517,2,15,.133,23,32,.719,91,40,88,.455,32,67,.478,8,21,.381,14,21,.667,102,2016-12-06,CHI,DET
54,@,L 91-96 ,240,32,82,.390,18,41,.439,14,41,.341,13,26,.500,91,33,86,.384,31,69,.449,2,17,.118,28,35,.800,96,2016-12-06,PHI,MEM
55,Home,L 91-105 ,240,36,82,.439,29,62,.468,7,20,.350,12,18,.667,91,39,74,.527,28,50,.560,11,24,.458,16,19,.842,105,2016-12-06,MIN,SAS
56,@,L 91-95 ,240,39,97,.402,30,69,.435,9,28,.321,4,5,.800,91,35,80,.438,31,63,.492,4,17,.235,21,27,.778,95,2016-12-08,SAS,CHI
57,@,L 91-103 ,240,38,96,.396,31,74,.419,7,22,.318,8,10,.800,91,37,84,.440,32,66,.485,5,18,.278,24,28,.857,103,2016-12-23,CHI,CHO
58,Home,W 91-87 ,240,33,89,.371,22,61,.361,11,28,.393,14,21,.667,91,36,87,.414,28,67,.418,8,20,.400,7,13,.538,87,2016-12-23,NOP,MIA
59,Home,L 91-95 ,240,35,83,.422,27,60,.450,8,23,.348,13,18,.722,91,32,95,.337,20,61,.328,12,34,.353,19,24,.792,95,2016-12-26,POR,TOR
60,Home,W 91-82 ,240,36,93,.387,31,67,.463,5,26,.192,14,18,.778,91,33,82,.402,23,54,.426,10,28,.357,6,13,.462,82,2016-12-29,CHO,MIA
61,@,L 91-99 ,240,30,75,.400,23,48,.479,7,27,.259,24,29,.828,91,37,83,.446,28,62,.452,9,21,.429,16,23,.696,99,2016-12-29,TOR,PHO
62,Home,W 91-86 ,240,35,73,.479,27,53,.509,8,20,.400,13,20,.650,91,36,87,.414,29,70,.414,7,17,.412,7,10,.700,86,2016-12-31,UTA,PHO
63,@,L 91-101 ,240,38,87,.437,32,61,.525,6,26,.231,9,12,.750,91,37,86,.430,25,47,.532,12,39,.308,15,21,.714,101,2017-01-02,WAS,HOU
64,@,L 91-93 ,240,33,82,.402,26,58,.448,7,24,.292,18,20,.900,91,33,85,.388,26,53,.491,7,32,.219,20,25,.800,93,2017-01-03,MIN,PHI
65,@,L 91-126 ,240,31,88,.352,22,54,.407,9,34,.265,20,27,.741,91,46,91,.505,31,57,.544,15,34,.441,19,24,.792,126,2017-01-16,CLE,GSW
66,@,L 91-107 ,240,31,76,.408,25,47,.532,6,29,.207,23,32,.719,91,38,83,.458,27,55,.491,11,28,.393,20,25,.800,107,2017-01-20,SAC,MEM
67,@,L 91-107 ,240,37,100,.370,31,74,.419,6,26,.231,11,16,.688,91,41,92,.446,33,63,.524,8,29,.276,17,22,.773,107,2017-01-29,OKC,CLE
68,@,L 91-105 ,240,37,84,.440,32,67,.478,5,17,.294,12,22,.545,91,38,83,.458,28,52,.538,10,31,.323,19,22,.864,105,2017-02-04,NOP,WAS
69,@,L 91-110 ,240,29,87,.333,24,64,.375,5,23,.217,28,34,.824,91,35,72,.486,21,48,.438,14,24,.583,26,34,.765,110,2017-02-08,PHO,MEM
70,@,L 91-98 ,240,35,92,.380,25,55,.455,10,37,.270,11,11,1.000,91,36,82,.439,30,63,.476,6,19,.316,20,22,.909,98,2017-02-15,DAL,DET
71,Home,L 91-95 ,240,33,89,.371,27,56,.482,6,33,.182,19,25,.760,91,37,75,.493,29,57,.509,8,18,.444,13,22,.591,95,2017-02-15,MEM,NOP
72,Home,L 91-92 ,240,33,73,.452,24,49,.490,9,24,.375,16,19,.842,91,33,78,.423,26,52,.500,7,26,.269,19,23,.826,92,2017-02-27,NYK,TOR
73,Home,L 91-101 ,240,35,83,.422,29,66,.439,6,17,.353,15,20,.750,91,41,85,.482,35,60,.583,6,25,.240,13,16,.813,101,2017-03-04,CHI,LAC
74,@,L 91-107 ,240,35,83,.422,26,59,.441,9,24,.375,12,18,.667,91,42,86,.488,37,66,.561,5,20,.250,18,20,.900,107,2017-03-08,LAC,MIN
75,@,L 91-98 ,240,36,81,.444,24,53,.453,12,28,.429,7,11,.636,91,37,89,.416,30,64,.469,7,25,.280,17,21,.810,98,2017-03-08,CHI,ORL
76,@,W 90-84 ,240,34,86,.395,28,60,.467,6,26,.231,16,20,.800,90,31,74,.419,30,67,.448,1,7,.143,21,34,.618,84,2011-12-26,NJN,WAS
77,@,L 90-115 ,240,29,74,.392,22,54,.407,7,20,.350,25,33,.758,90,45,80,.563,35,61,.574,10,19,.526,15,15,1.000,115,2011-12-28,LAC,SAS
78,@,W 90-85 ,240,32,81,.395,25,65,.385,7,16,.438,19,22,.864,90,36,79,.456,30,64,.469,6,15,.400,7,13,.538,85,2011-12-28,IND,TOR
79,@,L 90-99 ,240,35,88,.398,31,65,.477,4,23,.174,16,24,.667,90,33,71,.465,31,53,.585,2,18,.111,31,37,.838,99,2012-01-01,LAL,DEN
80,@,L 90-129 ,240,35,92,.380,29,74,.392,6,18,.333,14,21,.667,90,48,80,.600,41,69,.594,7,11,.636,26,31,.839,129,2012-01-01,CHA,MIA
81,@,W 90-85 ,240,30,68,.441,23,51,.451,7,17,.412,23,29,.793,90,28,78,.359,18,43,.419,10,35,.286,19,25,.760,85,2012-01-02,TOR,NYK
82,@,L 90-94 ,240,37,74,.500,34,64,.531,3,10,.300,13,16,.813,90,37,76,.487,32,61,.525,5,15,.333,15,23,.652,94,2012-01-02,NOH,UTA
83,@,W 90-86 ,240,33,80,.413,30,71,.423,3,9,.333,21,25,.840,90,33,82,.402,26,61,.426,7,21,.333,13,24,.542,86,2012-01-04,MEM,MIN
84,@,L 90-97 ,240,38,77,.494,34,63,.540,4,14,.286,10,19,.526,90,37,77,.481,34,66,.515,3,11,.273,20,29,.690,97,2012-01-06,GSW,LAL
85,Home,L 90-101 ,240,28,83,.337,18,50,.360,10,33,.303,24,32,.750,90,38,76,.500,33,61,.541,5,15,.333,20,24,.833,101,2012-01-07,NJN,MIA
86,Home,W 90-82 ,240,35,74,.473,29,55,.527,6,19,.316,14,21,.667,90,38,93,.409,37,84,.440,1,9,.111,5,10,.500,82,2012-01-08,LAL,MEM
87,@,W 90-85 ,240,35,79,.443,29,63,.460,6,16,.375,14,25,.560,90,29,64,.453,25,53,.472,4,11,.364,23,32,.719,85,2012-01-11,DAL,BOS
88,@,W 90-87 (OT),265,35,82,.427,31,73,.425,4,9,.444,16,19,.842,90,36,93,.387,32,79,.405,4,14,.286,11,16,.688,87,2012-01-11,LAL,UTA
89,Home,L 90-101 ,240,34,75,.453,26,54,.481,8,21,.381,14,20,.700,90,39,89,.438,29,70,.414,10,19,.526,13,21,.619,101,2012-01-12,PHO,CLE
90,Home,L 90-95 ,240,33,74,.446,29,57,.509,4,17,.235,20,32,.625,90,30,66,.455,27,58,.466,3,8,.375,32,38,.842,95,2012-01-13,TOR,IND
91,Home,L 90-103 ,240,38,88,.432,35,74,.473,3,14,.214,11,17,.647,90,37,86,.430,31,70,.443,6,16,.375,23,27,.852,103,2012-01-14,WAS,PHI
92,Home,W 90-88 (OT),265,35,88,.398,26,61,.426,9,27,.333,11,13,.846,90,37,94,.394,34,83,.410,3,11,.273,11,16,.688,88,2012-01-19,HOU,NOH
93,Home,W 90-76 ,240,35,84,.417,31,67,.463,4,17,.235,16,19,.842,90,32,74,.432,27,59,.458,5,15,.333,7,8,.875,76,2012-01-20,PHI,ATL
94,Home,L 90-91 ,240,38,76,.500,29,51,.569,9,25,.360,5,8,.625,90,36,85,.424,34,72,.472,2,13,.154,17,23,.739,91,2012-01-23,GSW,MEM
95,Home,L 90-95 ,240,36,90,.400,33,77,.429,3,13,.231,15,21,.714,90,38,80,.475,33,70,.471,5,10,.500,14,21,.667,95,2012-01-25,CHI,IND
96,Home,L 90-105 ,240,39,95,.411,33,73,.452,6,22,.273,6,10,.600,90,34,77,.442,25,56,.446,9,21,.429,28,33,.848,105,2012-01-25,DAL,MIN
97,Home,L 90-97 (OT),265,35,79,.443,30,65,.462,5,14,.357,15,19,.789,90,37,82,.451,25,55,.455,12,27,.444,11,14,.786,97,2012-01-25,PHI,NJN
98,Home,L 90-93 ,240,34,75,.453,27,58,.466,7,17,.412,15,21,.714,90,37,73,.507,32,59,.542,5,14,.357,14,19,.737,93,2012-01-31,CLE,BOS
99,@,L 90-93 ,240,35,82,.427,29,66,.439,6,16,.375,14,19,.737,90,37,91,.407,29,67,.433,8,24,.333,11,13,.846,93,2012-01-31,SAC,GSW
0,Home,L 90-113 ,240,37,93,.398,36,81,.444,1,12,.083,15,19,.789,90,48,90,.533,34,60,.567,14,30,.467,3,4,.750,113,2012-02-04,MIL,CHI
1,Home,L 90-99 ,240,33,84,.393,27,60,.450,6,24,.250,18,21,.857,90,41,79,.519,30,55,.545,11,24,.458,6,7,.857,99,2012-02-06,ATL,PHO
2,Home,L 90-99 ,240,34,78,.436,31,56,.554,3,22,.136,19,33,.576,90,35,81,.432,25,62,.403,10,19,.526,19,24,.792,99,2012-02-06,DEN,HOU
3,@,L 90-95 ,240,34,81,.420,27,57,.474,7,24,.292,15,20,.750,90,38,81,.469,30,64,.469,8,17,.471,11,17,.647,95,2012-02-06,LAL,PHI
4,@,W 90-67 ,240,39,85,.459,35,69,.507,4,16,.250,8,12,.667,90,28,75,.373,27,72,.375,1,3,.333,10,17,.588,67,2012-02-08,CHI,NOH
5,Home,L 90-100 ,240,38,93,.409,31,79,.392,7,14,.500,7,11,.636,90,37,84,.440,32,69,.464,5,15,.333,21,26,.808,100,2012-02-08,PHI,SAS
6,Home,L 90-105 ,240,33,76,.434,31,61,.508,2,15,.133,22,29,.759,90,35,70,.500,30,57,.526,5,13,.385,30,35,.857,105,2012-02-14,IND,MIA
7,@,W 90-87 ,240,33,80,.413,27,63,.429,6,17,.353,18,27,.667,90,37,73,.507,33,58,.569,4,15,.267,9,15,.600,87,2012-02-14,NYK,TOR
8,@,L 90-102 ,240,38,85,.447,31,67,.463,7,18,.389,7,15,.467,90,43,85,.506,39,69,.565,4,16,.250,12,16,.750,102,2012-02-15,CHA,MIN
9,Home,W 90-78 ,240,38,80,.475,35,68,.515,3,12,.250,11,14,.786,90,27,74,.365,16,45,.356,11,29,.379,13,25,.520,78,2012-02-19,MIA,ORL
10,@,L 90-102 ,240,35,78,.449,32,60,.533,3,18,.167,17,25,.680,90,34,80,.425,27,60,.450,7,20,.350,27,32,.844,102,2012-02-19,LAL,PHO
11,Home,W 90-79 ,240,34,88,.386,26,68,.382,8,20,.400,14,19,.737,90,30,74,.405,21,49,.429,9,25,.360,10,21,.476,79,2012-02-20,CHI,ATL
12,Home,L 90-93 ,240,37,91,.407,32,69,.464,5,22,.227,11,13,.846,90,33,76,.434,25,54,.463,8,22,.364,19,25,.760,93,2012-02-20,MIL,ORL
13,@,L 90-97 ,240,30,73,.411,24,50,.480,6,23,.261,24,29,.828,90,37,85,.435,29,68,.426,8,17,.471,15,22,.682,97,2012-03-03,OKC,ATL
14,Home,L 90-96 ,240,37,76,.487,31,52,.596,6,24,.250,10,17,.588,90,38,91,.418,33,74,.446,5,17,.294,15,24,.625,96,2012-03-09,OKC,CLE
15,@,L 90-105 ,240,34,71,.479,31,59,.525,3,12,.250,19,28,.679,90,39,72,.542,32,61,.525,7,11,.636,20,26,.769,105,2012-03-12,DET,UTA
16,Home,L 90-103 ,240,34,78,.436,29,56,.518,5,22,.227,17,25,.680,90,36,79,.456,24,54,.444,12,25,.480,19,24,.792,103,2012-03-15,DEN,OKC
17,@,L 90-97 ,240,30,71,.423,22,52,.423,8,19,.421,22,30,.733,90,38,80,.475,33,70,.471,5,10,.500,16,22,.727,97,2012-03-20,OKC,UTA
18,@,L 90-97 ,240,35,90,.389,30,63,.476,5,27,.185,15,24,.625,90,34,59,.576,32,54,.593,2,5,.400,27,34,.794,97,2012-03-22,LAC,NOH
19,Home,W 90-87 ,240,31,85,.365,21,55,.382,10,30,.333,18,27,.667,90,32,74,.432,25,52,.481,7,22,.318,16,17,.941,87,2012-03-25,POR,GSW
20,@,L 90-105 ,240,29,69,.420,21,49,.429,8,20,.400,24,37,.649,90,37,81,.457,27,63,.429,10,18,.556,21,28,.750,105,2012-03-26,MIA,IND
21,Home,W 90-81 ,240,34,73,.466,28,54,.519,6,19,.316,16,20,.800,90,33,79,.418,27,58,.466,6,21,.286,9,12,.750,81,2012-03-27,DAL,HOU
22,@,L 90-100 ,240,31,70,.443,25,53,.472,6,17,.353,22,33,.667,90,37,73,.507,33,54,.611,4,19,.211,22,26,.846,100,2012-03-30,NYK,ATL
23,@,L 90-95 ,240,35,74,.473,31,60,.517,4,14,.286,16,22,.727,90,37,77,.481,31,65,.477,6,12,.500,15,19,.789,95,2012-03-31,ATL,PHI
24,Home,L 90-125 ,240,34,82,.415,25,58,.431,9,24,.375,13,15,.867,90,48,81,.593,37,58,.638,11,23,.478,18,21,.857,125,2012-04-03,CLE,SAS
25,@,L 90-95 ,240,36,85,.424,34,73,.466,2,12,.167,16,24,.667,90,37,91,.407,32,76,.421,5,15,.333,16,24,.667,95,2012-04-06,CHA,MIL
26,@,L 90-99 ,240,33,81,.407,23,56,.411,10,25,.400,14,18,.778,90,40,82,.488,36,69,.522,4,13,.308,15,19,.789,99,2012-04-07,MIN,NOH
27,Home,L 90-114 ,240,32,83,.386,26,61,.426,6,22,.273,20,23,.870,90,47,82,.573,40,62,.645,7,20,.350,13,16,.813,114,2012-04-09,MIN,PHO
28,@,L 90-103 ,240,37,79,.468,34,68,.500,3,11,.273,13,16,.813,90,40,83,.482,29,64,.453,11,19,.579,12,14,.857,103,2012-04-10,CHA,CLE
29,@,L 90-93 ,240,37,83,.446,32,67,.478,5,16,.313,11,17,.647,90,33,74,.446,24,50,.480,9,24,.375,18,24,.750,93,2012-04-19,LAC,PHO
30,@,L 90-98 ,240,35,83,.422,23,50,.460,12,33,.364,8,15,.533,90,36,79,.456,30,60,.500,6,19,.316,20,27,.741,98,2012-04-20,NYK,CLE
31,@,W 90-85 ,240,36,101,.356,31,85,.365,5,16,.313,13,18,.722,90,36,81,.444,30,65,.462,6,16,.375,7,9,.778,85,2012-04-25,PHI,MIL
32,@,W 90-88 ,240,37,78,.474,32,67,.478,5,11,.455,11,16,.688,90,33,91,.363,27,74,.365,6,17,.353,16,19,.842,88,2012-10-31,IND,TOR
33,Home,W 90-89 ,240,31,85,.365,24,66,.364,7,19,.368,21,24,.875,90,33,83,.398,26,57,.456,7,26,.269,16,27,.593,89,2012-11-02,CHA,IND
34,Home,L 90-108 ,240,35,91,.385,29,76,.382,6,15,.400,14,21,.667,90,44,83,.530,38,67,.567,6,16,.375,14,19,.737,108,2012-11-07,MIL,MEM
35,Home,W 90-75 ,240,34,76,.447,27,56,.482,7,20,.350,15,22,.682,90,28,80,.350,25,68,.368,3,12,.250,16,20,.800,75,2012-11-07,MIN,ORL
36,Home,L 90-103 ,240,32,75,.427,25,55,.455,7,20,.350,19,30,.633,90,41,77,.532,38,64,.594,3,13,.231,18,25,.720,103,2012-11-08,POR,LAC
37,@,L 90-103 ,240,36,90,.400,29,67,.433,7,23,.304,11,14,.786,90,36,81,.444,28,56,.500,8,25,.320,23,30,.767,103,2012-11-11,SAC,LAL
38,@,W 90-82 ,240,30,65,.462,26,50,.520,4,15,.267,26,32,.813,90,29,80,.363,25,64,.391,4,16,.250,20,25,.800,82,2012-11-12,MIN,DAL
39,Home,L 90-92 ,240,33,83,.398,27,66,.409,6,17,.353,18,27,.667,90,27,73,.370,26,63,.413,1,10,.100,37,42,.881,92,2012-11-12,DET,OKC
40,Home,L 90-99 ,240,37,80,.463,31,62,.500,6,18,.333,10,19,.526,90,36,75,.480,31,58,.534,5,17,.294,22,25,.880,99,2012-11-18,SAC,BRK
41,@,L 90-95 ,240,34,82,.415,27,59,.458,7,23,.304,15,21,.714,90,35,73,.479,29,52,.558,6,21,.286,19,37,.514,95,2012-11-20,BRK,LAL
42,Home,W 90-74 ,240,36,83,.434,31,63,.492,5,20,.250,13,18,.722,90,28,85,.329,25,68,.368,3,17,.176,15,22,.682,74,2012-11-21,ORL,DET
43,@,L 90-91 ,240,32,78,.410,26,60,.433,6,18,.333,20,25,.800,90,36,78,.462,32,65,.492,4,13,.308,15,26,.577,91,2012-11-23,TOR,DET
44,Home,W 90-78 ,240,34,85,.400,30,73,.411,4,12,.333,18,21,.857,90,29,72,.403,25,56,.446,4,16,.250,16,20,.800,78,2012-11-30,MEM,DET
45,@,L 90-112 ,240,34,84,.405,29,65,.446,5,19,.263,17,19,.895,90,45,90,.500,39,70,.557,6,20,.300,16,21,.762,112,2012-12-05,DAL,LAC
46,@,L 90-106 ,240,35,78,.449,27,60,.450,8,18,.444,12,13,.923,90,40,69,.580,33,58,.569,7,11,.636,19,24,.792,106,2012-12-08,NOH,MIA
47,Home,L 90-98 ,240,36,78,.462,31,58,.534,5,20,.250,13,18,.722,90,40,77,.519,35,62,.565,5,15,.333,13,18,.722,98,2012-12-09,PHO,ORL
48,@,L 90-113 ,240,34,79,.430,28,58,.483,6,21,.286,16,20,.800,90,43,75,.573,29,46,.630,14,29,.483,13,23,.565,113,2012-12-13,CHA,ATL
49,@,L 90-98 ,240,33,72,.458,27,53,.509,6,19,.316,18,25,.720,90,40,88,.455,33,61,.541,7,27,.259,11,12,.917,98,2012-12-13,SAS,POR
50,@,W 90-86 ,240,33,83,.398,28,68,.412,5,15,.333,19,27,.704,90,32,81,.395,23,63,.365,9,18,.500,13,14,.929,86,2012-12-14,MIL,CLE
51,@,L 90-101 ,240,34,83,.410,31,70,.443,3,13,.231,19,24,.792,90,41,85,.482,33,63,.524,8,22,.364,11,15,.733,101,2012-12-17,SAC,PHO
52,Home,L 90-92 ,240,33,77,.429,26,60,.433,7,17,.412,17,22,.773,90,37,83,.446,32,63,.508,5,20,.250,13,16,.813,92,2012-12-18,BRK,UTA
53,Home,W 90-80 ,240,36,88,.409,33,80,.413,3,8,.375,15,19,.789,90,30,85,.353,25,65,.385,5,20,.250,15,19,.789,80,2012-12-19,MEM,MIL
54,Home,W 90-83 ,240,34,81,.420,26,61,.426,8,20,.400,14,17,.824,90,34,77,.442,25,60,.417,9,17,.529,6,8,.750,83,2012-12-19,ORL,WAS
55,@,L 90-93 ,240,35,70,.500,31,56,.554,4,14,.286,16,19,.842,90,33,81,.407,25,62,.403,8,19,.421,19,21,.905,93,2012-12-21,ORL,TOR
56,Home,W 90-72 ,240,39,80,.488,38,69,.551,1,11,.091,11,13,.846,90,29,74,.392,27,64,.422,2,10,.200,12,19,.632,72,2013-01-09,TOR,PHI
57,@,L 90-92 ,240,35,77,.455,29,58,.500,6,19,.316,14,20,.700,90,30,80,.375,21,53,.396,9,27,.333,23,30,.767,92,2013-01-10,MIA,POR
58,@,W 90-87 ,240,36,71,.507,31,61,.508,5,10,.500,13,18,.722,90,34,65,.523,28,49,.571,6,16,.375,13,21,.619,87,2013-01-12,UTA,DET
59,Home,L 90-102 ,240,35,84,.417,26,59,.441,9,25,.360,11,18,.611,90,40,84,.476,35,67,.522,5,17,.294,17,22,.773,102,2013-01-14,PHO,OKC
60,@,W 90-78 ,240,31,71,.437,29,54,.537,2,17,.118,26,31,.839,90,34,74,.459,30,56,.536,4,18,.222,6,16,.375,78,2013-01-16,NOH,BOS
61,Home,L 90-99 ,240,31,72,.431,21,50,.420,10,22,.455,18,28,.643,90,40,83,.482,38,70,.543,2,13,.154,17,23,.739,99,2013-01-17,LAL,MIA
62,@,W 90-77 ,240,35,77,.455,30,64,.469,5,13,.385,15,23,.652,90,30,84,.357,26,65,.400,4,19,.211,13,20,.650,77,2013-01-17,LAC,MIN
63,@,W 90-85 ,240,34,81,.420,31,63,.492,3,18,.167,19,26,.731,90,37,84,.440,33,70,.471,4,14,.286,7,11,.636,85,2013-01-21,SAS,PHI
64,@,L 90-95 ,240,32,84,.381,25,67,.373,7,17,.412,19,22,.864,90,37,82,.451,35,70,.500,2,12,.167,19,22,.864,95,2013-01-22,BOS,CLE
65,@,L 90-105 ,240,38,84,.452,30,64,.469,8,20,.400,6,8,.750,90,42,91,.462,35,68,.515,7,23,.304,14,21,.667,105,2013-01-22,ORL,DET
66,Home,L 90-117 ,240,34,84,.405,32,73,.438,2,11,.182,20,28,.714,90,46,98,.469,35,75,.467,11,23,.478,14,22,.636,117,2013-01-29,DET,MIL
67,Home,L 90-96 ,240,33,76,.434,28,57,.491,5,19,.263,19,27,.704,90,35,76,.461,32,67,.478,3,9,.333,23,36,.639,96,2013-01-30,MIN,LAC
68,@,L 90-98 ,240,37,79,.468,33,62,.532,4,17,.235,12,15,.800,90,37,84,.440,30,72,.417,7,12,.583,17,27,.630,98,2013-02-04,LAC,WAS
69,Home,L 90-96 ,240,36,82,.439,33,73,.452,3,9,.333,15,17,.882,90,37,73,.507,33,63,.524,4,10,.400,18,22,.818,96,2013-02-05,MEM,PHO
70,Home,L 90-93 ,240,36,83,.434,33,66,.500,3,17,.176,15,21,.714,90,34,82,.415,28,66,.424,6,16,.375,19,25,.760,93,2013-02-06,DET,BRK
71,Home,L 90-102 ,240,36,95,.379,31,72,.431,5,23,.217,13,22,.591,90,42,74,.568,38,62,.613,4,12,.333,14,17,.824,102,2013-02-11,MIL,WAS
72,Home,L 90-107 ,240,35,84,.417,26,66,.394,9,18,.500,11,16,.688,90,44,75,.587,36,56,.643,8,19,.421,11,22,.500,107,2013-02-11,PHI,LAC
73,@,L 90-97 ,240,35,79,.443,28,59,.475,7,20,.350,13,16,.813,90,33,77,.429,26,57,.456,7,20,.350,24,36,.667,97,2013-02-19,BOS,DEN
74,Home,L 90-103 ,240,36,72,.500,29,46,.630,7,26,.269,11,16,.688,90,37,78,.474,27,55,.491,10,23,.435,19,25,.760,103,2013-02-20,ATL,MIA
75,Home,L 90-116 ,240,32,76,.421,27,60,.450,5,16,.313,21,25,.840,90,43,73,.589,35,56,.625,8,17,.471,22,28,.786,116,2013-02-21,LAC,SAS
76,@,W 90-72 ,240,34,75,.453,26,53,.491,8,22,.364,14,19,.737,90,26,77,.338,24,63,.381,2,14,.143,18,24,.750,72,2013-02-23,IND,DET
77,Home,L 90-114 ,240,35,78,.449,24,50,.480,11,28,.393,9,10,.900,90,45,77,.584,36,56,.643,9,21,.429,15,18,.833,114,2013-02-23,PHI,MIA
78,@,W 90-84 ,240,34,81,.420,27,69,.391,7,12,.583,15,17,.882,90,29,79,.367,24,60,.400,5,19,.263,21,27,.778,84,2013-02-25,WAS,TOR
79,Home,L 90-95 ,240,36,85,.424,35,68,.515,1,17,.059,17,21,.810,90,34,82,.415,27,64,.422,7,18,.389,20,26,.769,95,2013-02-26,DAL,MIL
80,Home,W 90-84 ,240,29,78,.372,24,64,.375,5,14,.357,27,34,.794,90,33,76,.434,30,64,.469,3,12,.250,15,19,.789,84,2013-02-27,MEM,DAL
81,Home,L 90-98 ,240,36,78,.462,29,55,.527,7,23,.304,11,14,.786,90,39,78,.500,30,57,.526,9,21,.429,11,14,.786,98,2013-03-01,BRK,DAL
82,Home,W 90-87 ,240,34,80,.425,28,65,.431,6,15,.400,16,21,.762,90,33,85,.388,27,66,.409,6,19,.316,15,20,.750,87,2013-03-03,WAS,PHI
83,Home,W 90-81 ,240,39,86,.453,34,60,.567,5,26,.192,7,14,.500,90,33,89,.371,29,73,.397,4,16,.250,11,12,.917,81,2013-03-10,LAL,CHI
84,@,L 90-103 ,240,34,80,.425,27,60,.450,7,20,.350,15,18,.833,90,42,81,.519,36,65,.554,6,16,.375,13,15,.867,103,2013-03-11,DET,UTA
85,@,L 90-95 ,240,31,76,.408,26,59,.441,5,17,.294,23,28,.821,90,34,83,.410,26,57,.456,8,26,.308,19,25,.760,95,2013-03-12,WAS,CLE
86,@,L 90-105 ,240,36,82,.439,29,57,.509,7,25,.280,11,17,.647,90,40,78,.513,30,50,.600,10,28,.357,15,21,.714,105,2013-03-14,NYK,POR
87,Home,W 90-84 ,240,31,71,.437,26,55,.473,5,16,.313,23,31,.742,90,33,77,.429,29,65,.446,4,12,.333,14,22,.636,84,2013-03-16,UTA,MEM
88,Home,L 90-111 ,240,35,92,.380,29,68,.426,6,24,.250,14,21,.667,90,39,88,.443,31,66,.470,8,22,.364,25,29,.862,111,2013-03-18,CLE,IND
89,@,W 90-83 ,240,32,69,.464,24,46,.522,8,23,.348,18,25,.720,90,29,76,.382,20,57,.351,9,19,.474,16,24,.667,83,2013-03-18,NYK,UTA
90,@,L 90-98 ,240,37,99,.374,29,80,.363,8,19,.421,8,11,.727,90,38,79,.481,30,61,.492,8,18,.444,14,17,.824,98,2013-03-20,MIL,ATL
91,Home,W 90-89 (OT),265,32,89,.360,26,74,.351,6,15,.400,20,24,.833,90,30,84,.357,28,66,.424,2,18,.111,27,32,.844,89,2013-03-20,MEM,OKC
92,Home,W 90-83 ,240,36,76,.474,32,62,.516,4,14,.286,14,18,.778,90,30,73,.411,27,63,.429,3,10,.300,20,25,.800,83,2013-03-22,NOH,MEM
93,@,L 90-92 ,240,36,75,.480,28,52,.538,8,23,.348,10,11,.909,90,36,79,.456,34,72,.472,2,7,.286,18,24,.750,92,2013-04-01,SAS,MEM
94,Home,L 90-102 ,240,30,60,.500,22,40,.550,8,20,.400,22,27,.815,90,37,71,.521,23,44,.523,14,27,.519,14,20,.700,102,2013-04-02,MIA,NYK
95,Home,W 90-86 ,240,33,78,.423,27,65,.415,6,13,.462,18,26,.692,90,35,89,.393,30,66,.455,5,23,.217,11,16,.688,86,2013-04-02,WAS,CHI
96,Home,L 90-92 ,240,31,70,.443,26,57,.456,5,13,.385,23,30,.767,90,38,82,.463,34,71,.479,4,11,.364,12,19,.632,92,2013-04-04,BRK,CHI
97,Home,L 90-101 ,240,34,73,.466,29,56,.518,5,17,.294,17,27,.630,90,37,80,.463,28,64,.438,9,16,.563,18,24,.750,101,2013-04-05,ATL,PHI
98,Home,L 90-97 ,240,35,74,.473,28,57,.491,7,17,.412,13,18,.722,90,40,88,.455,29,63,.460,11,25,.440,6,7,.857,97,2013-04-07,GSW,UTA
99,@,W 90-80 ,240,32,81,.395,23,60,.383,9,21,.429,17,18,.944,90,31,79,.392,24,54,.444,7,25,.280,11,14,.786,80,2013-04-09,OKC,UTA
0,Home,L 90-106 ,240,36,88,.409,30,68,.441,6,20,.300,12,18,.667,90,40,77,.519,31,55,.564,9,22,.409,17,21,.810,106,2013-04-12,POR,OKC
1,Home,W 90-80 ,240,35,82,.427,24,51,.471,11,31,.355,9,11,.818,90,28,65,.431,20,37,.541,8,28,.286,16,26,.615,80,2013-04-14,NYK,IND
2,@,L 90-114 ,240,37,84,.440,30,67,.448,7,17,.412,9,13,.692,90,40,80,.500,28,59,.475,12,21,.571,22,28,.786,114,2013-04-17,BOS,TOR
3,Home,L 90-95 ,240,34,85,.400,29,74,.392,5,11,.455,17,21,.810,90,30,70,.429,20,47,.426,10,23,.435,25,30,.833,95,2013-10-30,NOP,IND
4,Home,W 90-83 ,240,36,71,.507,33,58,.569,3,13,.231,15,17,.882,90,34,74,.459,29,58,.500,5,16,.313,10,12,.833,83,2013-10-30,NYK,MIL
5,Home,W 90-88 ,240,33,81,.407,25,60,.417,8,21,.381,16,23,.696,90,34,79,.430,29,64,.453,5,15,.333,15,17,.882,88,2013-10-30,SAC,DEN
6,Home,W 90-84 ,240,33,73,.452,30,61,.492,3,12,.250,21,34,.618,90,32,84,.381,28,66,.424,4,18,.222,16,22,.727,84,2013-11-01,CHA,CLE
7,@,L 90-110 ,240,32,92,.348,26,80,.325,6,12,.500,20,26,.769,90,39,70,.557,28,48,.583,11,22,.500,21,27,.778,110,2013-11-01,NOP,ORL
8,Home,L 90-97 ,240,37,84,.440,31,67,.463,6,17,.353,10,18,.556,90,31,78,.397,24,55,.436,7,23,.304,28,38,.737,97,2013-11-02,MIL,TOR
9,Home,L 90-110 ,240,31,88,.352,26,63,.413,5,25,.200,23,37,.622,90,41,92,.446,26,54,.481,15,38,.395,13,20,.650,110,2013-11-04,PHI,GSW
10,@,L 90-92 ,240,35,79,.443,28,63,.444,7,16,.438,13,15,.867,90,36,73,.493,33,58,.569,3,15,.200,17,30,.567,92,2013-11-06,TOR,CHA
11,@,L 90-98 ,240,36,95,.379,33,76,.434,3,19,.158,15,21,.714,90,40,82,.488,35,66,.530,5,16,.313,13,17,.765,98,2013-11-06,LAC,ORL
12,@,L 90-108 ,240,33,78,.423,23,48,.479,10,30,.333,14,26,.538,90,42,79,.532,37,66,.561,5,13,.385,19,25,.760,108,2013-11-09,GSW,MEM
13,Home,L 90-113 ,240,35,92,.380,25,66,.379,10,26,.385,10,18,.556,90,44,90,.489,34,70,.486,10,20,.500,15,19,.789,113,2013-11-10,LAL,MIN
14,Home,W 90-89 ,240,35,84,.417,29,69,.420,6,15,.400,14,23,.609,90,37,86,.430,32,71,.451,5,15,.333,10,13,.769,89,2013-11-13,POR,PHO
15,Home,L 90-97 ,240,34,80,.425,24,55,.436,10,25,.400,12,17,.706,90,38,85,.447,32,62,.516,6,23,.261,15,24,.625,97,2013-11-15,SAC,DET
16,Home,L 90-110 ,240,34,90,.378,24,60,.400,10,30,.333,12,16,.750,90,44,78,.564,35,56,.625,9,22,.409,13,17,.765,110,2013-11-16,NYK,ATL
17,@,W 90-83 ,240,36,76,.474,27,54,.500,9,22,.409,9,13,.692,90,28,73,.384,20,43,.465,8,30,.267,19,32,.594,83,2013-11-29,MIA,TOR
18,@,W 90-82 ,240,34,74,.459,29,56,.518,5,18,.278,17,23,.739,90,30,73,.411,23,53,.434,7,20,.350,15,22,.682,82,2013-12-07,BRK,MIL
19,Home,W 90-84 ,240,34,67,.507,29,52,.558,5,15,.333,17,25,.680,90,33,77,.429,29,56,.518,4,21,.190,14,20,.700,84,2013-12-10,IND,MIA
20,Home,W 90-86 ,240,33,68,.485,26,47,.553,7,21,.333,17,25,.680,90,32,80,.400,27,59,.458,5,21,.238,17,19,.895,86,2013-12-13,BOS,NYK
21,Home,L 90-91 ,240,33,74,.446,29,64,.453,4,10,.400,20,25,.800,90,34,81,.420,27,57,.474,7,24,.292,16,19,.842,91,2013-12-13,MIL,CHI
22,@,L 90-117 ,240,30,81,.370,24,61,.393,6,20,.300,24,37,.649,90,42,90,.467,28,58,.483,14,32,.438,19,25,.760,117,2013-12-23,LAL,PHO
23,@,L 90-98 ,240,32,76,.421,25,57,.439,7,19,.368,19,21,.905,90,35,77,.455,32,63,.508,3,14,.214,25,32,.781,98,2013-12-28,UTA,LAC
24,@,L 90-112 ,240,39,93,.419,32,74,.432,7,19,.368,5,8,.625,90,40,76,.526,31,56,.554,9,20,.450,23,26,.885,112,2014-01-08,DAL,SAS
25,Home,L 90-107 ,240,36,80,.450,33,73,.452,3,7,.429,15,19,.789,90,41,78,.526,27,50,.540,14,28,.500,11,16,.688,107,2014-01-10,NOP,DAL
26,Home,W 90-87 ,240,32,80,.400,28,66,.424,4,14,.286,22,27,.815,90,33,81,.407,28,60,.467,5,21,.238,16,20,.800,87,2014-01-14,MEM,OKC
27,@,L 90-91 ,240,33,81,.407,28,70,.400,5,11,.455,19,23,.826,90,36,78,.462,30,61,.492,6,17,.353,13,18,.722,91,2014-01-17,SAC,MEM
28,@,L 90-101 ,240,33,72,.458,26,53,.491,7,19,.368,17,23,.739,90,40,81,.494,30,53,.566,10,28,.357,11,13,.846,101,2014-01-21,ORL,BRK
29,Home,L 90-99 ,240,34,86,.395,29,70,.414,5,16,.313,17,24,.708,90,34,82,.415,25,55,.455,9,27,.333,22,28,.786,99,2014-01-26,CLE,PHO
30,@,L 90-97 ,240,35,82,.427,29,59,.492,6,23,.261,14,21,.667,90,33,75,.440,28,57,.491,5,18,.278,26,47,.553,97,2014-01-28,SAS,HOU
31,Home,L 90-100 ,240,36,80,.450,28,59,.475,8,21,.381,10,14,.714,90,37,85,.435,29,64,.453,8,21,.381,18,20,.900,100,2014-01-31,DEN,TOR
32,Home,L 90-94 ,240,39,84,.464,33,62,.532,6,22,.273,6,7,.857,90,38,80,.475,34,68,.500,4,12,.333,14,22,.636,94,2014-01-31,MIN,MEM
33,Home,L 90-95 ,240,35,73,.479,32,64,.500,3,9,.333,17,21,.810,90,33,88,.375,23,62,.371,10,26,.385,19,24,.792,95,2014-01-31,UTA,GSW
34,@,L 90-99 ,240,30,76,.395,21,53,.396,9,23,.391,21,25,.840,90,38,79,.481,32,69,.464,6,10,.600,17,22,.773,99,2014-02-01,MIL,MEM
35,@,L 90-100 ,240,37,81,.457,32,62,.516,5,19,.263,11,12,.917,90,37,84,.440,30,67,.448,7,17,.412,19,22,.864,100,2014-02-03,POR,WAS
36,Home,L 90-94 ,240,36,90,.400,32,69,.464,4,21,.190,14,20,.700,90,30,79,.380,22,58,.379,8,21,.381,26,33,.788,94,2014-02-05,NYK,POR
37,@,L 90-117 ,240,32,76,.421,25,50,.500,7,26,.269,19,26,.731,90,48,85,.565,37,57,.649,11,28,.393,10,14,.714,117,2014-02-07,DEN,NYK
38,@,L 90-117 ,240,33,84,.393,24,60,.400,9,24,.375,15,20,.750,90,45,86,.523,33,60,.550,12,26,.462,15,23,.652,117,2014-02-12,DEN,MIN
39,Home,L 90-101 ,240,35,82,.427,31,61,.508,4,21,.190,16,20,.800,90,39,76,.513,31,58,.534,8,18,.444,15,26,.577,101,2014-02-20,MIL,DEN
40,Home,W 90-87 ,240,31,80,.388,28,65,.431,3,15,.200,25,36,.694,90,35,83,.422,26,60,.433,9,23,.391,8,11,.727,87,2014-02-21,CHA,NOP
41,@,L 90-105 ,240,36,87,.414,31,73,.425,5,14,.357,13,17,.765,90,34,65,.523,25,48,.521,9,17,.529,28,36,.778,105,2014-02-23,ORL,TOR
42,Home,L 90-101 ,240,32,87,.368,27,65,.415,5,22,.227,21,28,.750,90,39,94,.415,30,76,.395,9,18,.500,14,16,.875,101,2014-02-26,PHI,ORL
43,@,L 90-109 ,240,35,79,.443,30,61,.492,5,18,.278,15,18,.833,90,39,84,.464,31,62,.500,8,22,.364,23,33,.697,109,2014-03-02,NYK,CHI
44,@,L 90-99 ,240,36,89,.404,24,58,.414,12,31,.387,6,9,.667,90,40,80,.500,30,59,.508,10,21,.476,9,9,1.000,99,2014-03-10,WAS,MIA
45,@,W 90-88 ,240,32,74,.432,28,56,.500,4,18,.222,22,27,.815,90,31,75,.413,27,57,.474,4,18,.222,22,22,1.000,88,2014-03-12,MEM,NOP
46,@,L 90-103 ,240,32,83,.386,28,62,.452,4,21,.190,22,30,.733,90,38,88,.432,27,64,.422,11,24,.458,16,22,.727,103,2014-03-12,POR,SAS
47,@,L 90-99 ,240,35,81,.432,26,58,.448,9,23,.391,11,20,.550,90,31,81,.383,25,63,.397,6,18,.333,31,38,.816,99,2014-03-17,PHI,IND
48,Home,L 90-99 ,240,31,77,.403,28,62,.452,3,15,.200,25,29,.862,90,35,89,.393,25,61,.410,10,28,.357,19,25,.760,99,2014-03-22,GSW,SAS
49,Home,L 90-99 ,240,32,79,.405,23,57,.404,9,22,.409,17,22,.773,90,36,80,.450,25,57,.439,11,23,.478,16,18,.889,99,2014-03-26,BOS,TOR
50,Home,W 90-76 ,240,34,76,.447,29,62,.468,5,14,.357,17,21,.810,90,29,78,.372,21,56,.375,8,22,.364,10,16,.625,76,2014-03-30,CLE,IND
51,@,L 90-111 ,240,36,85,.424,28,64,.438,8,21,.381,10,10,1.000,90,44,83,.530,40,64,.625,4,19,.211,19,22,.864,111,2014-04-02,GSW,SAS
52,@,L 90-102 ,240,31,68,.456,29,60,.483,2,8,.250,26,35,.743,90,31,84,.369,24,62,.387,7,22,.318,33,42,.786,102,2014-04-04,MIL,CHI
53,@,W 90-89 ,240,38,78,.487,33,59,.559,5,19,.263,9,15,.600,90,34,76,.447,20,45,.444,14,31,.452,7,8,.875,89,2014-04-04,WAS,NYK
54,Home,L 90-102 ,240,35,80,.438,24,53,.453,11,27,.407,9,11,.818,90,42,88,.477,34,73,.466,8,15,.533,10,13,.769,102,2014-04-13,LAL,MEM
55,Home,L 90-108 ,240,28,79,.354,25,69,.362,3,10,.300,31,39,.795,90,31,73,.425,19,44,.432,12,29,.414,34,50,.680,108,2014-10-28,LAL,HOU
56,Home,L 90-95 ,240,32,70,.457,23,46,.500,9,24,.375,17,20,.850,90,37,69,.536,31,57,.544,6,12,.500,15,18,.833,95,2014-10-30,CLE,NYK
57,@,L 90-93 ,240,28,65,.431,22,44,.500,6,21,.286,28,34,.824,90,34,87,.391,27,57,.474,7,30,.233,18,25,.720,93,2014-10-30,OKC,LAC
58,Home,L 90-102 ,240,32,76,.421,31,59,.525,1,17,.059,25,35,.714,90,42,87,.483,35,61,.574,7,26,.269,11,13,.846,102,2014-11-01,DET,BRK
59,@,L 90-104 ,240,37,98,.378,36,73,.493,1,25,.040,15,18,.833,90,32,76,.421,20,42,.476,12,34,.353,28,40,.700,104,2014-11-01,BOS,HOU
60,Home,L 90-95 ,240,37,92,.402,30,65,.462,7,27,.259,9,14,.643,90,36,81,.444,30,62,.484,6,19,.316,17,21,.810,95,2014-11-02,POR,GSW
61,@,L 90-98 ,240,38,88,.432,32,74,.432,6,14,.429,8,14,.571,90,35,75,.467,28,60,.467,7,15,.467,21,27,.778,98,2014-11-04,ORL,CHI
62,Home,L 90-97 ,240,33,77,.429,25,53,.472,8,24,.333,16,25,.640,90,39,81,.481,37,70,.529,2,11,.182,17,23,.739,97,2014-11-08,IND,WAS
63,Home,L 90-99 ,240,35,83,.422,31,66,.470,4,17,.235,16,23,.696,90,37,77,.481,30,59,.508,7,18,.389,18,25,.720,99,2014-11-15,CHI,IND
64,Home,L 90-92 ,240,37,83,.446,30,65,.462,7,18,.389,9,13,.692,90,35,74,.473,30,58,.517,5,16,.313,17,25,.680,92,2014-11-19,CLE,SAS
65,Home,L 90-114 ,240,34,86,.395,26,62,.419,8,24,.333,14,18,.778,90,45,84,.536,33,63,.524,12,21,.571,12,16,.750,114,2014-11-19,ORL,LAC
66,Home,L 90-101 ,240,34,86,.395,27,65,.415,7,21,.333,15,21,.714,90,41,83,.494,35,63,.556,6,20,.300,13,21,.619,101,2014-11-19,PHI,BOS
67,Home,L 90-93 ,240,34,85,.400,27,59,.458,7,26,.269,15,18,.833,90,35,76,.461,30,61,.492,5,15,.333,18,25,.720,93,2014-11-30,PHO,ORL
68,@,W 90-87 ,240,32,70,.457,27,52,.519,5,18,.278,21,26,.808,90,37,88,.420,29,62,.468,8,26,.308,5,6,.833,87,2014-12-04,CLE,NYK
69,Home,W 90-82 ,240,32,81,.395,31,69,.449,1,12,.083,25,33,.758,90,31,80,.388,21,45,.467,10,35,.286,10,12,.833,82,2014-12-10,MIN,POR
70,Home,L 90-95 ,240,33,93,.355,22,64,.344,11,29,.379,13,19,.684,90,35,79,.443,29,59,.492,6,20,.300,19,23,.826,95,2014-12-13,SAC,DET
71,Home,L 90-95 (OT),265,29,78,.372,20,49,.408,9,29,.310,23,28,.821,90,36,78,.462,27,54,.500,9,24,.375,14,18,.778,95,2014-12-14,NYK,TOR
72,Home,L 90-99 ,240,33,86,.384,27,61,.443,6,25,.240,18,23,.783,90,38,82,.463,33,64,.516,5,18,.278,18,22,.818,99,2014-12-18,HOU,NOP
73,Home,L 90-99 ,240,35,88,.398,28,66,.424,7,22,.318,13,16,.813,90,35,78,.449,25,53,.472,10,25,.400,19,23,.826,99,2014-12-20,NYK,PHO
74,@,L 90-97 ,240,37,75,.493,31,61,.508,6,14,.429,10,14,.714,90,35,84,.417,29,67,.433,6,17,.353,21,24,.875,97,2014-12-26,SAS,NOP
75,@,W 90-85 ,240,33,90,.367,24,61,.393,9,29,.310,15,19,.789,90,31,80,.388,19,50,.380,12,30,.400,11,14,.786,85,2014-12-27,ATL,MIL
76,Home,L 90-92 ,240,36,83,.434,31,70,.443,5,13,.385,13,21,.619,90,29,84,.345,24,71,.338,5,13,.385,29,33,.879,92,2014-12-29,IND,CHI
77,Home,L 90-98 ,240,33,87,.379,29,68,.426,4,19,.211,20,21,.952,90,35,78,.449,31,62,.500,4,16,.250,24,32,.750,98,2015-01-03,ORL,CHO
78,Home,L 90-109 ,240,35,86,.407,27,61,.443,8,25,.320,12,17,.706,90,44,78,.564,32,52,.615,12,26,.462,9,11,.818,109,2015-01-04,CLE,DAL
79,@,L 90-93 ,240,35,88,.398,27,66,.409,8,22,.364,12,16,.750,90,33,74,.446,26,57,.456,7,17,.412,20,26,.769,93,2015-01-07,ORL,DEN
80,@,W 90-88 ,240,36,79,.456,28,62,.452,8,17,.471,10,17,.588,90,33,73,.452,30,57,.526,3,16,.188,19,27,.704,88,2015-01-09,PHI,BRK
81,Home,L 90-104 ,240,34,75,.453,25,49,.510,9,26,.346,13,18,.722,90,39,81,.481,33,60,.550,6,21,.286,20,24,.833,104,2015-01-11,LAC,MIA
82,Home,L 90-99 ,240,36,82,.439,32,65,.492,4,17,.235,14,18,.778,90,40,77,.519,35,61,.574,5,16,.313,14,27,.519,99,2015-01-17,BRK,WAS
83,@,W 90-89 ,240,39,87,.448,32,68,.471,7,19,.368,5,7,.714,90,33,89,.371,24,61,.393,9,28,.321,14,19,.737,89,2015-01-22,BOS,POR
84,@,L 90-129 ,240,36,89,.404,34,73,.466,2,16,.125,16,24,.667,90,46,89,.517,31,61,.508,15,28,.536,22,28,.786,129,2015-01-23,CHO,CLE
85,Home,L 90-99 ,240,35,82,.427,26,58,.448,9,24,.375,11,19,.579,90,35,74,.473,27,55,.491,8,19,.421,21,23,.913,99,2015-01-26,UTA,BOS
86,Home,L 90-109 ,240,38,78,.487,31,52,.596,7,26,.269,7,10,.700,90,42,79,.532,32,58,.552,10,21,.476,15,20,.750,109,2015-01-27,DAL,MEM
87,@,L 90-101 ,240,30,84,.357,27,66,.409,3,18,.167,27,32,.844,90,38,80,.475,27,49,.551,11,31,.355,14,22,.636,101,2015-01-30,SAC,CLE
88,Home,L 90-106 ,240,34,82,.415,28,69,.406,6,13,.462,16,21,.762,90,42,87,.483,32,55,.582,10,32,.313,12,19,.632,106,2015-01-31,MIN,CLE
89,@,L 90-101 ,240,31,89,.348,23,64,.359,8,25,.320,20,26,.769,90,38,92,.413,30,65,.462,8,27,.296,17,23,.739,101,2015-02-04,CHI,HOU
90,Home,L 90-100 ,240,33,73,.452,26,50,.520,7,23,.304,17,26,.654,90,38,80,.475,32,67,.478,6,13,.462,18,22,.818,100,2015-02-04,UTA,MEM
91,Home,W 90-89 ,240,35,81,.432,30,64,.469,5,17,.294,15,17,.882,90,36,69,.522,34,57,.596,2,12,.167,15,20,.750,89,2015-02-06,MIN,MEM
92,@,L 90-102 ,240,32,82,.390,29,69,.420,3,13,.231,23,33,.697,90,43,86,.500,38,67,.567,5,19,.263,11,17,.647,102,2015-02-07,SAC,UTA
93,@,W 90-87 ,240,33,81,.407,28,66,.424,5,15,.333,19,26,.731,90,35,79,.443,26,52,.500,9,27,.333,8,12,.667,87,2015-02-23,MEM,LAC
94,Home,W 90-81 ,240,34,83,.410,30,68,.441,4,15,.267,18,23,.783,90,32,79,.405,27,60,.450,5,19,.263,12,21,.571,81,2015-02-23,UTA,SAS
95,Home,L 90-93 (OT),265,33,78,.423,27,56,.482,6,22,.273,18,31,.581,90,32,84,.381,26,53,.491,6,31,.194,23,32,.719,93,2015-02-25,ORL,MIA
96,@,L 90-102 ,240,34,84,.405,30,68,.441,4,16,.250,18,23,.783,90,39,80,.488,33,64,.516,6,16,.375,18,25,.720,102,2015-02-25,MEM,SAC
97,@,L 90-97 ,240,39,84,.464,34,72,.472,5,12,.417,7,9,.778,90,34,77,.442,33,66,.500,1,11,.091,28,33,.848,97,2015-03-06,LAL,MEM
98,Home,L 90-100 ,240,29,69,.420,25,52,.481,4,17,.235,28,34,.824,90,39,87,.448,33,62,.532,6,25,.240,16,17,.941,100,2015-03-09,MIA,BOS
99,Home,L 90-108 ,240,38,70,.543,35,58,.603,3,12,.250,11,14,.786,90,42,84,.500,29,53,.547,13,31,.419,11,16,.688,108,2015-03-22,MIL,CLE
0,Home,L 90-97 ,240,39,89,.438,34,73,.466,5,16,.313,7,13,.538,90,40,86,.465,32,65,.492,8,21,.381,9,13,.692,97,2015-04-04,MIL,ORL
1,@,L 90-99 ,240,39,85,.459,32,69,.464,7,16,.438,5,10,.500,90,36,84,.429,30,68,.441,6,16,.375,21,23,.913,99,2015-04-04,NOP,POR
2,Home,L 90-119 ,240,31,89,.348,22,62,.355,9,27,.333,19,27,.704,90,47,72,.653,39,57,.684,8,15,.533,17,23,.739,119,2015-04-08,PHI,WAS
3,Home,L 90-99 ,240,32,77,.416,23,43,.535,9,34,.265,17,25,.680,90,38,84,.452,30,62,.484,8,22,.364,15,21,.714,99,2015-04-10,CLE,BOS
4,Home,W 90-75 ,240,37,84,.440,32,65,.492,5,19,.263,11,19,.579,90,30,85,.353,23,60,.383,7,25,.280,8,10,.800,75,2015-04-10,NOP,PHO
5,Home,L 90-100 ,240,34,83,.410,21,51,.412,13,32,.406,9,17,.529,90,35,85,.412,26,50,.520,9,35,.257,21,26,.808,100,2015-04-13,CHO,HOU
6,@,L 90-101 ,240,38,83,.458,30,60,.500,8,23,.348,6,9,.667,90,39,96,.406,35,75,.467,4,21,.190,19,27,.704,101,2015-04-13,POR,OKC
7,Home,L 90-112 ,240,33,77,.429,26,58,.448,7,19,.368,17,27,.630,90,41,81,.506,31,55,.564,10,26,.385,20,27,.741,112,2015-04-15,NYK,DET
8,Home,L 90-101 ,240,33,79,.418,25,49,.510,8,30,.267,16,28,.571,90,39,94,.415,28,62,.452,11,32,.344,12,16,.750,101,2015-10-31,POR,PHO
9,Home,W 90-87 ,240,36,80,.450,31,65,.477,5,15,.333,13,24,.542,90,36,81,.444,30,61,.492,6,20,.300,9,13,.692,87,2015-11-06,IND,MIA
10,Home,W 90-82 ,240,30,82,.366,23,55,.418,7,27,.259,23,29,.793,90,29,88,.330,20,61,.328,9,27,.333,15,18,.833,82,2015-11-13,DAL,LAL
11,@,W 90-84 ,240,33,78,.423,27,50,.540,6,28,.214,18,31,.581,90,29,79,.367,20,52,.385,9,27,.333,17,21,.810,84,2015-11-13,CLE,NYK
12,Home,W 90-88 ,240,37,84,.440,28,64,.438,9,20,.450,7,13,.538,90,33,76,.434,21,47,.447,12,29,.414,10,14,.714,88,2015-11-17,BRK,ATL
13,@,L 90-104 ,240,34,84,.405,25,67,.373,9,17,.529,13,16,.813,90,40,88,.455,32,66,.485,8,22,.364,16,17,.941,104,2015-11-20,SAS,NOP
14,Home,L 90-93 ,240,35,92,.380,32,63,.508,3,29,.103,17,23,.739,90,33,72,.458,21,52,.404,12,20,.600,15,23,.652,93,2015-11-20,OKC,NYK
15,Home,L 90-95 ,240,33,80,.413,28,55,.509,5,25,.200,19,25,.760,90,34,81,.420,26,56,.464,8,25,.320,19,25,.760,95,2015-11-27,CHO,CLE
16,@,L 90-111 ,240,34,94,.362,29,74,.392,5,20,.250,17,23,.739,90,40,83,.482,33,64,.516,7,19,.368,24,30,.800,111,2015-11-27,NOP,LAC
17,@,L 90-114 ,240,31,74,.419,23,48,.479,8,26,.308,20,22,.909,90,43,82,.524,31,55,.564,12,27,.444,16,22,.727,114,2015-11-27,MIL,ORL
18,Home,W 90-88 ,240,35,87,.402,26,60,.433,9,27,.333,11,17,.647,90,33,81,.407,29,64,.453,4,17,.235,18,24,.750,88,2015-11-28,CLE,BRK
19,@,L 90-99 ,240,36,93,.387,31,78,.397,5,15,.333,13,22,.591,90,36,89,.404,30,72,.417,6,17,.353,21,27,.778,99,2015-12-02,DEN,CHI
20,Home,W 90-88 ,240,30,73,.411,26,60,.433,4,13,.308,26,33,.788,90,33,85,.388,25,52,.481,8,33,.242,14,18,.778,88,2015-12-07,MIL,POR
21,Home,W 90-83 ,240,34,70,.486,27,50,.540,7,20,.350,15,23,.652,90,33,80,.413,29,69,.420,4,11,.364,13,16,.813,83,2015-12-11,TOR,MIL
22,Home,L 90-94 ,240,33,78,.423,25,50,.500,8,28,.286,16,24,.667,90,37,79,.468,31,62,.500,6,17,.353,14,16,.875,94,2015-12-11,UTA,OKC
23,@,L 90-106 ,240,29,79,.367,19,51,.373,10,28,.357,22,26,.846,90,41,86,.477,31,64,.484,10,22,.455,14,16,.875,106,2015-12-14,TOR,IND
24,@,L 90-103 ,240,38,88,.432,33,72,.458,5,16,.313,9,11,.818,90,36,75,.480,25,54,.463,11,21,.524,20,24,.833,103,2015-12-16,MIL,LAC
25,@,L 90-106 ,240,32,92,.348,21,66,.318,11,26,.423,15,18,.833,90,38,79,.481,36,65,.554,2,14,.143,28,37,.757,106,2015-12-16,POR,OKC
26,Home,L 90-104 ,240,31,66,.470,24,43,.558,7,23,.304,21,32,.656,90,40,85,.471,35,70,.500,5,15,.333,19,24,.792,104,2015-12-22,PHI,MEM
27,Home,L 90-111 ,240,34,81,.420,28,67,.418,6,14,.429,16,18,.889,90,42,81,.519,29,52,.558,13,29,.448,14,19,.737,111,2015-12-26,MIL,TOR
28,@,L 90-99 (OT),265,35,79,.443,24,50,.480,11,29,.379,9,18,.500,90,38,87,.437,34,72,.472,4,15,.267,19,20,.950,99,2015-12-29,MIA,MEM
29,@,L 90-115 ,240,35,86,.407,30,72,.417,5,14,.357,15,19,.789,90,41,86,.477,27,51,.529,14,35,.400,19,28,.679,115,2015-12-31,MIN,DET
30,Home,L 90-109 ,240,29,84,.345,23,62,.371,6,22,.273,26,34,.765,90,35,79,.443,26,56,.464,9,23,.391,30,37,.811,109,2016-01-02,CHO,OKC
31,Home,L 90-98 ,240,37,82,.451,35,65,.538,2,17,.118,14,15,.933,90,39,70,.557,36,62,.581,3,8,.375,17,18,.944,98,2016-01-06,MIA,NYK
32,@,L 90-104 ,240,31,70,.443,22,46,.478,9,24,.375,19,29,.655,90,40,94,.426,29,69,.420,11,25,.440,13,16,.813,104,2016-01-13,MIA,LAC
33,@,L 90-120 ,240,31,74,.419,26,60,.433,5,14,.357,23,31,.742,90,44,85,.518,33,59,.559,11,26,.423,21,25,.840,120,2016-01-25,SAS,GSW
34,Home,L 90-92 ,240,30,74,.405,23,49,.469,7,25,.280,23,28,.821,90,33,76,.434,27,51,.529,6,25,.240,20,26,.769,92,2016-01-26,LAL,DAL
35,@,L 90-103 ,240,35,75,.467,33,65,.508,2,10,.200,18,26,.692,90,40,76,.526,30,51,.588,10,25,.400,13,16,.813,103,2016-01-29,MIN,UTA
36,Home,L 90-93 ,240,34,87,.391,26,67,.388,8,20,.400,14,19,.737,90,37,88,.420,35,73,.479,2,15,.133,17,23,.739,93,2016-02-03,DAL,MIA
37,Home,L 90-116 ,240,33,73,.452,30,58,.517,3,15,.200,21,27,.778,90,41,80,.513,29,58,.500,12,22,.545,22,25,.880,116,2016-02-05,DAL,SAS
38,Home,L 90-109 ,240,33,71,.465,22,49,.449,11,22,.500,13,19,.684,90,45,86,.523,36,66,.545,9,20,.450,10,12,.833,109,2016-02-10,BRK,MEM
39,Home,L 90-113 ,240,38,86,.442,33,72,.458,5,14,.357,9,12,.750,90,43,90,.478,30,57,.526,13,33,.394,14,15,.933,113,2016-02-10,CHI,ATL
40,@,L 90-100 ,240,36,91,.396,29,73,.397,7,18,.389,11,17,.647,90,39,78,.500,29,53,.547,10,25,.400,12,15,.800,100,2016-03-07,MIL,CHI
41,Home,L 90-109 ,240,30,81,.370,26,56,.464,4,25,.160,26,32,.813,90,39,83,.470,27,51,.529,12,32,.375,19,29,.655,109,2016-03-07,DAL,LAC
42,Home,L 90-114 ,240,32,79,.405,22,47,.468,10,32,.313,16,19,.842,90,41,84,.488,23,47,.489,18,37,.486,14,20,.700,114,2016-03-13,LAC,CLE
43,@,W 90-87 ,240,33,75,.440,28,54,.519,5,21,.238,19,27,.704,90,34,85,.400,31,69,.449,3,16,.188,16,21,.762,87,2016-03-13,NYK,LAL
44,Home,L 90-95 ,240,31,86,.360,25,63,.397,6,23,.261,22,26,.846,90,32,89,.360,24,59,.407,8,30,.267,23,26,.885,95,2016-03-18,LAL,PHO
45,@,L 90-101 ,240,35,84,.417,32,71,.451,3,13,.231,17,26,.654,90,41,97,.423,36,65,.554,5,32,.156,14,17,.824,101,2016-03-25,MIL,ATL
46,@,L 90-105 ,240,37,94,.394,30,65,.462,7,29,.241,9,13,.692,90,38,80,.475,28,52,.538,10,28,.357,19,26,.731,105,2016-03-27,DEN,LAC
47,@,L 90-114 ,240,31,89,.348,24,70,.343,7,19,.368,21,27,.778,90,44,84,.524,33,59,.559,11,25,.440,15,18,.833,114,2016-03-28,BOS,LAC
48,Home,L 90-94 ,240,34,88,.386,25,63,.397,9,25,.360,13,15,.867,90,32,76,.421,22,56,.393,10,20,.500,20,34,.588,94,2016-04-02,CHI,DET
49,@,L 90-103 ,240,30,81,.370,18,50,.360,12,31,.387,18,30,.600,90,39,95,.411,28,61,.459,11,34,.324,14,19,.737,103,2016-04-05,PHO,ATL
50,@,L 90-96 ,240,32,88,.364,21,53,.396,11,35,.314,15,21,.714,90,34,78,.436,28,55,.509,6,23,.261,22,31,.710,96,2016-04-05,CHO,TOR
51,@,L 90-102 ,240,36,80,.450,26,53,.491,10,27,.370,8,9,.889,90,41,80,.513,35,61,.574,6,19,.316,14,20,.700,102,2016-04-12,NYK,IND
52,@,L 90-94 ,240,37,84,.440,33,69,.478,4,15,.267,12,21,.571,90,33,82,.402,25,67,.373,8,15,.533,20,27,.741,94,2016-11-14,MIA,SAS
53,Home,L 90-93 ,240,36,89,.404,29,66,.439,7,23,.304,11,14,.786,90,37,80,.463,31,63,.492,6,17,.353,13,19,.684,93,2016-11-15,MIA,ATL
54,Home,W 90-83 ,240,33,76,.434,26,55,.473,7,21,.333,17,23,.739,90,34,83,.410,26,60,.433,8,23,.348,7,10,.700,83,2016-11-16,BOS,DAL
55,Home,L 90-105 ,240,30,73,.411,21,42,.500,9,31,.290,21,33,.636,90,40,84,.476,28,58,.483,12,26,.462,13,17,.765,105,2016-11-21,CHO,MEM
56,@,L 90-128 ,240,37,91,.407,29,56,.518,8,35,.229,8,12,.667,90,43,85,.506,23,42,.548,20,43,.465,22,24,.917,128,2016-11-25,DAL,CLE
57,@,W 90-81 ,240,33,85,.388,21,54,.389,12,31,.387,12,18,.667,90,29,82,.354,25,63,.397,4,19,.211,19,23,.826,81,2016-11-25,MIA,MEM
58,Home,L 90-96 ,240,32,91,.352,28,70,.400,4,21,.190,22,29,.759,90,33,81,.407,31,73,.425,2,8,.250,28,41,.683,96,2016-11-30,CHI,LAL
59,Home,L 90-117 ,240,37,78,.474,34,62,.548,3,16,.188,13,20,.650,90,42,84,.500,28,55,.509,14,29,.483,19,23,.826,117,2016-12-09,MIN,DET
60,@,L 90-103 ,240,38,93,.409,33,72,.458,5,21,.238,9,19,.474,90,45,96,.469,36,64,.563,9,32,.281,4,8,.500,103,2016-12-15,NYK,GSW
61,Home,L 90-105 ,240,32,84,.381,22,54,.407,10,30,.333,16,22,.727,90,40,83,.482,34,64,.531,6,19,.316,19,25,.760,105,2016-12-17,DET,IND
62,@,L 90-135 ,240,34,86,.395,26,58,.448,8,28,.286,14,20,.700,90,51,87,.586,37,59,.627,14,28,.500,19,26,.731,135,2016-12-17,POR,GSW
63,@,W 90-88 ,240,37,87,.425,30,58,.517,7,29,.241,9,15,.600,90,34,74,.459,21,45,.467,13,29,.448,7,11,.636,88,2016-12-23,DAL,LAC
64,@,L 90-109 ,240,31,87,.356,23,64,.359,8,23,.348,20,24,.833,90,45,89,.506,34,62,.548,11,27,.407,8,14,.571,109,2016-12-23,LAL,ORL
65,Home,L 90-110 ,240,35,79,.443,23,49,.469,12,30,.400,8,16,.500,90,39,78,.500,27,58,.466,12,20,.600,20,21,.952,110,2016-12-23,POR,SAS
66,Home,W 90-85 ,240,32,83,.386,26,58,.448,6,25,.240,20,28,.714,90,34,81,.420,25,56,.446,9,25,.360,8,10,.800,85,2016-12-26,CHI,IND
67,@,L 90-106 ,240,30,79,.380,19,51,.373,11,28,.393,19,23,.826,90,41,92,.446,25,64,.391,16,28,.571,8,15,.533,106,2016-12-26,CLE,DET
68,@,L 90-104 ,240,35,83,.422,27,51,.529,8,32,.250,12,17,.706,90,37,82,.451,22,51,.431,15,31,.484,15,18,.833,104,2016-12-26,ATL,MIN
69,Home,W 90-82 ,240,34,90,.378,28,59,.475,6,31,.194,16,22,.727,90,32,88,.364,21,62,.339,11,26,.423,7,10,.700,82,2017-01-02,CLE,NOP
70,@,L 90-99 ,240,36,91,.396,30,68,.441,6,23,.261,12,16,.750,90,36,77,.468,27,54,.500,9,23,.391,18,22,.818,99,2017-01-03,MIA,PHO
71,Home,L 90-95 ,240,37,88,.420,32,63,.508,5,25,.200,11,16,.688,90,35,99,.354,29,72,.403,6,27,.222,19,31,.613,95,2017-02-01,BRK,NYK
72,@,L 90-93 ,240,34,88,.386,27,60,.450,7,28,.250,15,21,.714,90,33,87,.379,25,61,.410,8,26,.308,19,29,.655,93,2017-02-06,OKC,IND
73,@,L 90-94 ,240,33,91,.363,27,62,.435,6,29,.207,18,22,.818,90,34,68,.500,25,54,.463,9,14,.643,17,21,.810,94,2017-02-12,SAS,NYK
74,Home,W 90-85 ,240,32,84,.381,20,52,.385,12,32,.375,14,19,.737,90,32,76,.421,19,38,.500,13,38,.342,8,9,.889,85,2017-02-15,TOR,CHO
75,Home,L 90-108 ,240,30,79,.380,24,59,.407,6,20,.300,24,36,.667,90,40,99,.404,23,62,.371,17,37,.459,11,13,.846,108,2017-02-24,ATL,MIA
76,Home,L 90-101 ,240,34,83,.410,29,58,.500,5,25,.200,17,22,.773,90,34,81,.420,26,52,.500,8,29,.276,25,31,.806,101,2017-03-01,ORL,NYK
77,@,L 90-97 (OT),265,35,89,.393,31,73,.425,4,16,.250,16,22,.727,90,38,94,.404,32,70,.457,6,24,.250,15,24,.625,97,2017-03-04,MIN,SAS
78,@,L 89-97 ,240,30,81,.370,22,53,.415,8,28,.286,21,26,.808,89,34,72,.472,24,53,.453,10,19,.526,19,26,.731,97,2011-12-25,ORL,OKC
79,Home,L 89-105 ,240,36,81,.444,27,60,.450,9,21,.429,8,11,.727,89,40,70,.571,33,58,.569,7,12,.583,18,22,.818,105,2011-12-28,DET,CLE
80,@,L 89-92 ,240,34,80,.425,27,54,.500,7,26,.269,14,22,.636,89,39,86,.453,37,62,.597,2,24,.083,12,15,.800,92,2011-12-31,DEN,LAL
81,@,L 89-104 ,240,33,89,.371,31,73,.425,2,16,.125,21,25,.840,89,36,74,.486,26,58,.448,10,16,.625,22,31,.710,104,2011-12-31,UTA,SAS
82,Home,W 89-78 ,240,31,62,.500,29,54,.537,2,8,.250,25,33,.758,89,28,63,.444,20,41,.488,8,22,.364,14,21,.667,78,2012-01-02,DET,ORL
83,Home,W 89-70 ,240,35,71,.493,29,55,.527,6,16,.375,13,21,.619,89,30,74,.405,26,54,.481,4,20,.200,6,10,.600,70,2012-01-04,BOS,NJN
84,@,L 89-98 ,240,37,82,.451,32,65,.492,5,17,.294,10,15,.667,89,38,91,.418,30,69,.435,8,22,.364,14,21,.667,98,2012-01-04,PHO,DAL
85,@,L 89-117 ,240,35,76,.461,28,60,.467,7,16,.438,12,17,.706,89,47,82,.573,41,66,.621,6,16,.375,17,24,.708,117,2012-01-04,HOU,LAC
86,@,L 89-95 (OT),265,32,81,.395,27,65,.415,5,16,.313,20,34,.588,89,36,86,.419,30,69,.435,6,17,.353,17,23,.739,95,2012-01-11,MIA,LAC
87,@,L 89-103 ,240,35,80,.438,31,60,.517,4,20,.200,15,16,.938,89,40,89,.449,32,68,.471,8,21,.381,15,19,.789,103,2012-01-13,SAC,HOU
88,@,L 89-120 ,240,36,81,.444,32,64,.500,4,17,.235,13,20,.650,89,47,85,.553,35,67,.522,12,18,.667,14,19,.737,120,2012-01-13,WAS,PHI
89,@,L 89-96 ,240,36,77,.468,31,60,.517,5,17,.294,12,17,.706,89,36,78,.462,29,56,.518,7,22,.318,17,26,.654,96,2012-01-17,CHA,ORL
90,@,L 89-92 ,240,35,92,.380,30,73,.411,5,19,.263,14,20,.700,89,33,71,.465,28,60,.467,5,11,.455,21,27,.778,92,2012-01-18,POR,ATL
91,@,L 89-91 ,240,34,81,.420,25,61,.410,9,20,.450,12,18,.667,89,37,87,.425,29,65,.446,8,22,.364,9,17,.529,91,2012-01-18,DAL,LAC
92,@,L 89-95 ,240,35,74,.473,33,63,.524,2,11,.182,17,23,.739,89,40,85,.471,34,70,.486,6,15,.400,9,15,.600,95,2012-01-21,CHA,CHI
93,@,L 89-101 ,240,32,80,.400,25,62,.403,7,18,.389,18,25,.720,89,41,88,.466,34,69,.493,7,19,.368,12,21,.571,101,2012-01-23,SAC,POR
94,@,L 89-99 ,240,30,84,.357,12,41,.293,18,43,.419,11,14,.786,89,37,80,.463,35,70,.500,2,10,.200,23,26,.885,99,2012-01-27,NYK,MIA
95,Home,W 89-72 ,240,35,78,.449,29,63,.460,6,15,.400,13,16,.813,89,27,70,.386,23,55,.418,4,15,.267,14,21,.667,72,2012-01-27,PHI,CHA
96,@,L 89-100 ,240,36,82,.439,30,63,.476,6,19,.316,11,17,.647,89,40,80,.500,35,61,.574,5,19,.263,15,16,.938,100,2012-01-28,LAL,MIL
97,@,L 89-93 ,240,37,80,.463,32,60,.533,5,20,.250,10,13,.769,89,32,84,.381,29,72,.403,3,12,.250,26,38,.684,93,2012-01-30,POR,UTA
98,@,L 89-91 ,240,34,80,.425,31,65,.477,3,15,.200,18,21,.857,89,31,76,.408,21,56,.375,10,20,.500,19,25,.760,91,2012-02-03,NYK,BOS
99,Home,L 89-93 ,240,33,75,.440,28,52,.538,5,23,.217,18,23,.783,89,37,78,.474,33,65,.508,4,13,.308,15,25,.600,93,2012-02-03,DEN,LAL
0,@,L 89-106 ,240,33,87,.379,28,68,.412,5,19,.263,18,25,.720,89,42,93,.452,39,80,.488,3,13,.231,19,28,.679,106,2012-02-03,WAS,TOR
1,Home,W 89-87 ,240,35,78,.449,33,68,.485,2,10,.200,17,23,.739,89,34,72,.472,30,60,.500,4,12,.333,15,18,.833,87,2012-02-04,DET,NOH
2,@,L 89-95 ,240,33,75,.440,24,56,.429,9,19,.474,14,19,.737,89,34,85,.400,24,63,.381,10,22,.455,17,24,.708,95,2012-02-04,CHA,PHO
3,@,L 89-95 ,240,34,79,.430,28,57,.491,6,22,.273,15,21,.714,89,31,69,.449,27,57,.474,4,12,.333,29,34,.853,95,2012-02-05,TOR,MIA
4,@,W 89-84 ,240,34,73,.466,27,57,.474,7,16,.438,14,21,.667,89,31,83,.373,27,70,.386,4,13,.308,18,21,.857,84,2012-02-06,SAS,MEM
5,@,L 89-102 ,240,36,76,.474,31,61,.508,5,15,.333,12,17,.706,89,35,83,.422,18,41,.439,17,42,.405,15,21,.714,102,2012-02-08,MIA,ORL
6,Home,L 89-96 ,240,35,74,.473,26,47,.553,9,27,.333,10,16,.625,89,42,86,.488,34,70,.486,8,16,.500,4,6,.667,96,2012-02-09,PHO,HOU
7,@,W 89-87 (OT),265,36,82,.439,30,65,.462,6,17,.353,11,18,.611,89,35,83,.422,26,59,.441,9,24,.375,8,14,.571,87,2012-02-10,ATL,ORL
8,Home,L 89-106 ,240,34,89,.382,30,68,.441,4,21,.190,17,28,.607,89,40,81,.494,35,66,.530,5,15,.333,21,23,.913,106,2012-02-10,WAS,MIA
9,Home,L 89-103 ,240,35,87,.402,28,63,.444,7,24,.292,12,15,.800,89,42,80,.525,35,58,.603,7,22,.318,12,17,.706,103,2012-02-11,NJN,SAS
10,Home,L 89-98 ,240,30,73,.411,23,56,.411,7,17,.412,22,30,.733,89,36,83,.434,30,65,.462,6,18,.333,20,24,.833,98,2012-02-13,CHA,PHI
11,@,L 89-102 ,240,33,80,.413,27,59,.458,6,21,.286,17,25,.680,89,36,85,.424,24,55,.436,12,30,.400,18,22,.818,102,2012-02-13,MIN,ORL
12,Home,L 89-92 ,240,33,86,.384,26,68,.382,7,18,.389,16,18,.889,89,36,80,.450,29,65,.446,7,15,.467,13,17,.765,92,2012-02-15,MIL,NOH
13,Home,W 89-80 ,240,30,76,.395,20,55,.364,10,21,.476,19,28,.679,89,31,78,.397,28,63,.444,3,15,.200,15,18,.833,80,2012-02-16,CHI,BOS
14,@,W 89-85 ,240,32,75,.427,25,63,.397,7,12,.583,18,23,.783,89,31,75,.413,27,51,.529,4,24,.167,19,29,.655,85,2012-02-17,NOH,NYK
15,Home,W 89-73 ,240,36,89,.404,29,64,.453,7,25,.280,10,14,.714,89,29,74,.392,22,50,.440,7,24,.292,8,11,.727,73,2012-02-20,DAL,BOS
16,Home,W 89-76 ,240,31,78,.397,25,66,.379,6,12,.500,21,29,.724,89,31,85,.365,23,70,.329,8,15,.533,6,8,.750,76,2012-02-21,MEM,PHI
17,@,W 89-84 ,240,36,89,.404,34,79,.430,2,10,.200,15,20,.750,89,27,85,.318,21,58,.362,6,27,.222,24,37,.649,84,2012-02-22,NOH,CLE
18,Home,L 89-96 ,240,37,86,.430,29,66,.439,8,20,.400,7,12,.583,89,37,88,.420,30,73,.411,7,15,.467,15,21,.714,96,2012-02-29,SAS,CHI
19,Home,W 89-86 ,240,35,80,.438,35,70,.500,0,10,.000,19,25,.760,89,35,76,.461,27,53,.509,8,23,.348,8,9,.889,86,2012-03-07,MIA,ATL
20,Home,L 89-95 ,240,33,80,.413,28,57,.491,5,23,.217,18,25,.720,89,39,85,.459,36,78,.462,3,7,.429,14,16,.875,95,2012-03-10,MIN,NOH
21,Home,L 89-115 ,240,33,82,.402,26,63,.413,7,19,.368,16,21,.762,89,46,91,.505,34,67,.507,12,24,.500,11,15,.733,115,2012-03-13,SAC,GSW
22,Home,L 89-99 ,240,34,75,.453,30,61,.492,4,14,.286,17,19,.895,89,39,75,.520,33,57,.579,6,18,.333,15,17,.882,99,2012-03-15,NOH,WAS
23,Home,L 89-100 ,240,36,85,.424,28,58,.483,8,27,.296,9,11,.818,89,39,79,.494,28,58,.483,11,21,.524,11,12,.917,100,2012-03-16,CHI,POR
24,Home,W 89-80 ,240,31,77,.403,25,56,.446,6,21,.286,21,31,.677,89,33,79,.418,30,66,.455,3,13,.231,11,15,.733,80,2012-03-17,CHI,PHI
25,@,L 89-102 ,240,37,85,.435,31,63,.492,6,22,.273,9,20,.450,89,35,72,.486,27,58,.466,8,14,.571,24,26,.923,102,2012-03-20,LAC,IND
26,Home,L 89-108 ,240,31,84,.369,25,64,.391,6,20,.300,21,27,.778,89,40,83,.482,34,66,.515,6,17,.353,22,29,.759,108,2012-03-21,NJN,WAS
27,@,L 89-102 ,240,35,79,.443,32,65,.492,3,14,.214,16,22,.727,89,39,88,.443,34,72,.472,5,16,.313,19,22,.864,102,2012-03-24,CHA,NJN
28,@,W 89-86 ,240,36,90,.400,34,71,.479,2,19,.105,15,17,.882,89,37,81,.457,36,76,.474,1,5,.200,11,12,.917,86,2012-03-24,SAS,NOH
29,Home,W 89-80 ,240,26,74,.351,19,43,.442,7,31,.226,30,35,.857,89,31,85,.365,25,61,.410,6,24,.250,12,18,.667,80,2012-03-26,NYK,MIL
30,@,L 89-93 ,240,33,78,.423,26,56,.464,7,22,.318,16,25,.640,89,31,79,.392,25,63,.397,6,16,.375,25,32,.781,93,2012-03-29,WAS,IND
31,@,L 89-98 ,240,35,94,.372,34,79,.430,1,15,.067,18,26,.692,89,38,73,.521,31,59,.525,7,14,.500,15,20,.750,98,2012-03-30,MEM,HOU
32,@,L 89-94 ,240,34,73,.466,25,52,.481,9,21,.429,12,17,.706,89,31,80,.388,22,60,.367,9,20,.450,23,27,.852,94,2012-04-07,DAL,MEM
33,Home,L 89-109 ,240,37,87,.425,31,68,.456,6,19,.316,9,13,.692,89,39,81,.481,31,61,.508,8,20,.400,23,25,.920,109,2012-04-09,MIL,OKC
34,@,L 89-119 ,240,30,74,.405,23,54,.426,7,20,.350,22,26,.846,89,42,80,.525,27,52,.519,15,28,.536,20,24,.833,119,2012-04-09,DET,ORL
35,Home,L 89-94 ,240,33,83,.398,27,62,.435,6,21,.286,17,19,.895,89,37,80,.463,27,61,.443,10,19,.526,10,13,.769,94,2012-04-09,POR,HOU
36,@,L 89-115 ,240,35,90,.389,26,65,.400,9,25,.360,10,14,.714,89,43,90,.478,38,78,.487,5,12,.417,24,32,.750,115,2012-04-13,SAC,OKC
37,Home,L 89-95 ,240,34,81,.420,33,71,.465,1,10,.100,20,27,.741,89,34,81,.420,28,65,.431,6,16,.375,21,27,.778,95,2012-04-13,PHI,NJN
38,Home,L 89-98 ,240,38,87,.437,34,73,.466,4,14,.286,9,12,.750,89,34,66,.515,31,58,.534,3,8,.375,27,33,.818,98,2012-04-14,WAS,CLE
39,@,L 89-93 ,240,29,78,.372,23,54,.426,6,24,.250,25,31,.806,89,40,90,.444,36,73,.493,4,17,.235,9,10,.900,93,2012-04-21,POR,MEM
40,@,L 89-124 ,240,37,96,.385,31,80,.388,6,16,.375,9,11,.818,89,48,81,.593,36,59,.610,12,22,.545,16,21,.762,124,2012-04-23,POR,SAS
41,@,L 89-106 ,240,33,78,.423,28,63,.444,5,15,.333,18,23,.783,89,45,85,.529,36,58,.621,9,27,.333,7,9,.778,106,2012-04-26,DAL,ATL
42,@,L 89-90 ,240,33,83,.398,26,57,.456,7,26,.269,16,27,.593,89,31,85,.365,24,66,.364,7,19,.368,21,24,.875,90,2012-11-02,IND,CHA
43,@,L 89-102 ,240,32,84,.381,25,58,.431,7,26,.269,18,27,.667,89,42,86,.488,37,71,.521,5,15,.333,13,18,.722,102,2012-11-02,DEN,ORL
44,@,L 89-92 ,240,37,90,.411,33,77,.429,4,13,.308,11,19,.579,89,40,92,.435,38,81,.469,2,11,.182,10,14,.714,92,2012-11-02,DET,PHO
45,@,W 89-82 ,240,32,75,.427,27,57,.474,5,18,.278,20,23,.870,89,29,88,.330,26,71,.366,3,17,.176,21,25,.840,82,2012-11-03,NOH,CHI
46,@,W 89-86 ,240,36,84,.429,28,63,.444,8,21,.381,9,13,.692,89,34,78,.436,28,58,.483,6,20,.300,12,17,.706,86,2012-11-03,BOS,WAS
47,Home,W 89-86 ,240,38,87,.437,31,65,.477,7,22,.318,6,12,.500,89,35,85,.412,27,59,.458,8,26,.308,8,9,.889,86,2012-11-07,ATL,IND
48,Home,L 89-95 ,240,34,81,.420,25,56,.446,9,25,.360,12,16,.750,89,37,76,.487,30,54,.556,7,22,.318,14,16,.875,95,2012-11-09,ATL,MIA
49,Home,W 89-85 ,240,34,80,.425,27,64,.422,7,16,.438,14,24,.583,89,35,79,.443,25,55,.455,10,24,.417,5,7,.714,85,2012-11-10,IND,WAS
50,Home,W 89-76 ,240,38,82,.463,33,67,.493,5,15,.333,8,8,1.000,89,30,72,.417,21,47,.447,9,25,.360,7,16,.438,76,2012-11-11,LAC,ATL
51,Home,L 89-99 ,240,37,75,.493,32,61,.525,5,14,.357,10,17,.588,89,41,84,.488,32,60,.533,9,24,.375,8,11,.727,99,2012-11-13,ORL,NYK
52,@,W 89-87 ,240,38,84,.452,34,68,.500,4,16,.250,9,14,.643,89,31,81,.383,26,62,.419,5,19,.263,20,37,.541,87,2012-11-14,CHA,MIN
53,@,L 89-107 ,240,30,70,.429,22,48,.458,8,22,.364,21,31,.677,89,43,76,.566,37,61,.607,6,15,.400,15,19,.789,107,2012-11-17,TOR,BOS
54,Home,L 89-96 ,240,31,87,.356,27,70,.386,4,17,.235,23,31,.742,89,34,70,.486,31,51,.608,3,19,.158,25,29,.862,96,2012-11-19,WAS,IND
55,@,L 89-93 ,240,38,95,.400,36,79,.456,2,16,.125,11,19,.579,89,32,74,.432,25,55,.455,7,19,.368,22,31,.710,93,2012-11-21,CHI,HOU
56,Home,L 89-115 ,240,34,92,.370,24,64,.375,10,28,.357,11,20,.550,89,40,82,.488,28,60,.467,12,22,.545,23,34,.676,115,2012-11-24,DAL,LAL
57,@,L 89-96 (OT),265,33,85,.388,27,64,.422,6,21,.286,17,24,.708,89,37,91,.407,28,63,.444,9,28,.321,13,19,.684,96,2012-11-26,NYK,BRK
58,Home,L 89-97 ,240,37,84,.440,31,67,.463,6,17,.353,9,14,.643,89,38,83,.458,32,61,.525,6,22,.273,15,18,.833,97,2012-11-27,SAC,MIN
59,Home,L 89-110 ,240,41,95,.432,39,80,.488,2,15,.133,5,8,.625,89,44,84,.524,33,59,.559,11,25,.440,11,15,.733,110,2012-11-28,ORL,SAS
60,@,L 89-102 ,240,33,75,.440,27,47,.574,6,28,.214,17,27,.630,89,40,78,.513,33,58,.569,7,20,.350,15,19,.789,102,2012-12-01,BRK,MIA
61,Home,W 89-79 ,240,36,84,.429,32,66,.485,4,18,.222,13,19,.684,89,32,95,.337,29,75,.387,3,20,.150,12,17,.706,79,2012-12-03,DET,CLE
62,Home,L 89-92 ,240,34,76,.447,24,53,.453,10,23,.435,11,18,.611,89,38,86,.442,35,69,.507,3,17,.176,13,20,.650,92,2012-12-07,IND,DEN
63,Home,L 89-96 ,240,36,75,.480,28,59,.475,8,16,.500,9,12,.750,89,36,72,.500,28,55,.509,8,17,.471,16,22,.727,96,2012-12-07,NOH,MEM
64,Home,L 89-94 ,240,35,87,.402,25,67,.373,10,20,.500,9,12,.750,89,37,80,.463,33,69,.478,4,11,.364,16,23,.696,94,2012-12-11,CHI,LAC
65,Home,L 89-96 ,240,41,91,.451,39,77,.506,2,14,.143,5,11,.455,89,34,78,.436,30,67,.448,4,11,.364,24,26,.923,96,2012-12-12,PHI,CHI
66,@,L 89-101 ,240,34,85,.400,26,65,.400,8,20,.400,13,17,.765,89,37,76,.487,27,49,.551,10,27,.370,17,23,.739,101,2012-12-14,BOS,HOU
67,@,L 89-100 ,240,35,81,.432,30,71,.423,5,10,.500,14,19,.737,89,37,74,.500,32,65,.492,5,9,.556,21,24,.875,100,2012-12-18,BOS,CHI
68,Home,L 89-99 ,240,32,80,.400,27,64,.422,5,16,.313,20,26,.769,89,39,80,.488,34,64,.531,5,16,.313,16,25,.640,99,2012-12-21,CLE,IND
69,@,L 89-105 ,240,30,73,.411,23,57,.404,7,16,.438,22,26,.846,89,38,73,.521,27,49,.551,11,24,.458,18,22,.818,105,2012-12-22,UTA,MIA
70,Home,L 89-99 ,240,35,90,.389,30,75,.400,5,15,.333,14,17,.824,89,37,71,.521,28,55,.509,9,16,.563,16,23,.696,99,2012-12-26,MEM,PHI
71,@,L 89-96 ,240,35,87,.402,30,67,.448,5,20,.250,14,23,.609,89,34,80,.425,27,63,.429,7,17,.412,21,26,.808,96,2012-12-28,PHI,GSW
72,Home,W 89-85 ,240,34,76,.447,26,53,.491,8,23,.348,13,16,.813,89,36,85,.424,32,68,.471,4,17,.235,9,11,.818,85,2012-12-29,POR,PHI
73,Home,W 89-81 ,240,29,77,.377,24,61,.393,5,16,.313,26,31,.839,89,35,83,.422,32,70,.457,3,13,.231,8,10,.800,81,2013-01-02,IND,WAS
74,@,L 89-95 ,240,37,84,.440,32,70,.457,5,14,.357,10,12,.833,89,39,85,.459,36,72,.500,3,13,.231,14,20,.700,95,2013-01-02,PHI,PHO
75,Home,L 89-96 ,240,30,65,.462,25,45,.556,5,20,.250,24,31,.774,89,36,80,.450,31,66,.470,5,14,.357,19,24,.792,96,2013-01-04,MIA,CHI
76,@,W 89-81 ,240,39,85,.459,36,69,.522,3,16,.188,8,12,.667,89,28,68,.412,18,39,.462,10,29,.345,15,19,.789,81,2013-01-05,BOS,ATL
77,@,L 89-115 ,240,32,72,.444,27,52,.519,5,20,.250,20,26,.769,89,47,90,.522,37,62,.597,10,28,.357,11,15,.733,115,2013-01-05,GSW,LAC
78,Home,L 89-109 ,240,38,79,.481,31,62,.500,7,17,.412,6,10,.600,89,40,83,.482,30,59,.508,10,24,.417,19,22,.864,109,2013-01-08,PHI,BRK
79,@,L 89-100 ,240,33,79,.418,27,64,.422,6,15,.400,17,24,.708,89,39,80,.488,31,59,.525,8,21,.381,14,20,.700,100,2013-01-14,CHA,BOS
80,@,L 89-94 ,240,35,80,.438,26,59,.441,9,21,.429,10,14,.714,89,30,74,.405,21,48,.438,9,26,.346,25,38,.658,94,2013-01-18,ATL,BRK
81,@,W 89-86 ,240,32,83,.386,24,55,.436,8,28,.286,17,20,.850,89,31,76,.408,28,58,.483,3,18,.167,21,28,.750,86,2013-01-24,NYK,BOS
82,@,L 89-106 ,240,34,98,.347,28,73,.384,6,25,.240,15,19,.789,89,40,72,.556,35,58,.603,5,14,.357,21,25,.840,106,2013-01-31,MEM,OKC
83,@,L 89-93 ,240,34,78,.436,33,64,.516,1,14,.071,20,22,.909,89,39,75,.520,34,64,.531,5,11,.455,10,20,.500,93,2013-02-01,CHI,BRK
84,@,L 89-102 ,240,33,70,.471,28,56,.500,5,14,.357,18,24,.750,89,39,70,.557,32,53,.604,7,17,.412,17,24,.708,102,2013-02-01,MIA,IND
85,Home,W 89-80 ,240,36,76,.474,33,62,.532,3,14,.214,14,19,.737,89,30,79,.380,29,69,.420,1,10,.100,19,25,.760,80,2013-02-01,PHI,SAC
86,@,L 89-111 ,240,34,77,.442,27,61,.443,7,16,.438,14,19,.737,89,36,68,.529,21,41,.512,15,27,.556,24,32,.750,111,2013-02-08,LAC,MIA
87,Home,L 89-93 ,240,37,78,.474,33,62,.532,4,16,.250,11,17,.647,89,36,79,.456,31,67,.463,5,12,.417,16,18,.889,93,2013-02-08,UTA,CHI
88,Home,W 89-74 ,240,36,80,.450,29,64,.453,7,16,.438,10,11,.909,89,25,76,.329,20,58,.345,5,18,.278,19,32,.594,74,2013-02-08,WAS,BRK
89,@,L 89-102 ,240,34,69,.493,29,56,.518,5,13,.385,16,25,.640,89,40,78,.513,32,62,.516,8,16,.500,14,18,.778,102,2013-02-10,NOH,TOR
90,Home,L 89-103 ,240,37,78,.474,35,66,.530,2,12,.167,13,20,.650,89,39,75,.520,31,59,.525,8,16,.500,17,20,.850,103,2013-02-11,CHI,SAS
91,@,W 89-84 (OT),265,31,80,.388,27,68,.397,4,12,.333,23,32,.719,89,33,96,.344,28,74,.378,5,22,.227,13,18,.722,84,2013-02-11,BRK,IND
92,Home,L 89-105 ,240,33,74,.446,28,58,.483,5,16,.313,18,28,.643,89,43,83,.518,36,58,.621,7,25,.280,12,20,.600,105,2013-03-01,CLE,LAC
93,Home,W 89-88 ,240,30,81,.370,26,64,.406,4,17,.235,25,30,.833,89,37,81,.457,35,71,.493,2,10,.200,12,18,.667,88,2013-03-08,CHI,UTA
94,@,L 89-90 (OT),265,30,84,.357,28,66,.424,2,18,.111,27,32,.844,89,32,89,.360,26,74,.351,6,15,.400,20,24,.833,90,2013-03-20,OKC,MEM
95,Home,L 89-99 ,240,39,89,.438,35,75,.467,4,14,.286,7,11,.636,89,41,84,.488,31,63,.492,10,21,.476,7,10,.700,99,2013-03-21,CHI,POR
96,@,L 89-103 ,240,34,83,.410,27,61,.443,7,22,.318,14,18,.778,89,38,68,.559,30,53,.566,8,15,.533,19,26,.731,103,2013-03-22,DET,MIA
97,Home,L 89-97 ,240,38,92,.413,33,76,.434,5,16,.313,8,10,.800,89,34,80,.425,29,59,.492,5,21,.238,24,33,.727,97,2013-03-22,ORL,OKC
98,Home,L 89-108 ,240,34,74,.459,29,56,.518,5,18,.278,16,18,.889,89,42,69,.609,28,42,.667,14,27,.519,10,16,.625,108,2013-03-29,NOH,MIA
99,@,L 89-108 ,240,32,74,.432,25,49,.510,7,25,.280,18,23,.783,89,35,72,.486,21,45,.467,14,27,.519,24,31,.774,108,2013-03-31,BOS,NYK
0,@,W 89-79 ,240,31,69,.449,18,36,.500,13,33,.394,14,17,.824,89,28,88,.318,25,72,.347,3,16,.188,20,22,.909,79,2013-04-05,MIA,CHA
1,@,W 89-87 ,240,32,73,.438,29,66,.439,3,7,.429,22,29,.759,89,29,81,.358,22,56,.393,7,25,.280,22,28,.786,87,2013-04-07,MEM,SAC
2,@,L 89-105 ,240,33,90,.367,26,71,.366,7,19,.368,16,20,.800,89,39,91,.429,29,67,.433,10,24,.417,17,22,.773,105,2013-04-09,MIN,GSW
3,Home,L 89-107 ,240,33,87,.379,24,65,.369,9,22,.409,14,18,.778,89,45,86,.523,36,65,.554,9,21,.429,8,8,1.000,107,2013-04-14,NOH,DAL
4,Home,L 89-95 ,240,37,89,.416,34,68,.500,3,21,.143,12,14,.857,89,36,85,.424,26,58,.448,10,27,.370,13,18,.722,95,2013-04-17,OKC,MIL
5,Home,W 89-74 ,240,32,77,.416,22,49,.449,10,28,.357,15,20,.750,89,29,83,.349,26,68,.382,3,15,.200,13,15,.867,74,2013-11-02,IND,CLE
6,Home,L 89-91 ,240,33,83,.398,29,63,.460,4,20,.200,19,29,.655,89,34,95,.358,32,81,.395,2,14,.143,21,26,.808,91,2013-11-08,ORL,BOS
7,Home,L 89-120 ,240,31,82,.378,25,60,.417,6,22,.273,21,29,.724,89,41,76,.539,29,48,.604,12,28,.429,26,30,.867,120,2013-11-10,NYK,SAS
8,@,W 89-83 ,240,30,82,.366,27,70,.386,3,12,.250,26,30,.867,89,29,77,.377,22,56,.393,7,21,.333,18,25,.720,83,2013-11-13,CHA,BOS
9,@,L 89-90 ,240,37,86,.430,32,71,.451,5,15,.333,10,13,.769,89,35,84,.417,29,69,.420,6,15,.400,14,23,.609,90,2013-11-13,PHO,POR
10,@,W 89-86 ,240,37,85,.435,36,72,.500,1,13,.077,14,14,1.000,89,35,80,.438,25,56,.446,10,24,.417,6,11,.545,86,2013-11-15,MEM,LAL
11,Home,L 89-96 ,240,36,84,.429,33,71,.465,3,13,.231,14,22,.636,89,37,85,.435,29,62,.468,8,23,.348,14,21,.667,96,2013-11-22,DET,ATL
12,@,L 89-98 ,240,36,82,.439,25,53,.472,11,29,.379,6,15,.400,89,37,76,.487,30,57,.526,7,19,.368,17,22,.773,98,2013-11-23,NYK,WAS
13,Home,W 89-83 (OT),265,33,85,.388,26,68,.382,7,17,.412,16,19,.842,89,31,79,.392,30,66,.455,1,13,.077,20,28,.714,83,2013-11-25,UTA,CHI
14,Home,W 89-82 ,240,33,82,.402,25,61,.410,8,21,.381,15,17,.882,89,30,78,.385,27,61,.443,3,17,.176,19,25,.760,82,2013-12-03,DAL,CHA
15,@,L 89-108 ,240,38,94,.404,33,74,.446,5,20,.250,8,17,.471,89,47,91,.516,39,68,.574,8,23,.348,6,11,.545,108,2013-12-06,CLE,ATL
16,@,W 89-81 ,240,36,84,.429,29,68,.426,7,16,.438,10,18,.556,89,31,81,.383,28,68,.412,3,13,.231,16,21,.762,81,2013-12-23,GSW,DEN
17,@,W 89-85 ,240,33,80,.413,25,55,.455,8,25,.320,15,24,.625,89,30,80,.375,21,57,.368,9,23,.391,16,20,.800,85,2013-12-27,OKC,CHA
18,@,L 89-105 ,240,33,82,.402,27,59,.458,6,23,.261,17,24,.708,89,42,89,.472,31,65,.477,11,24,.458,10,15,.667,105,2013-12-27,DEN,NOP
19,Home,W 89-82 ,240,31,71,.437,23,47,.489,8,24,.333,19,22,.864,89,29,79,.367,19,57,.333,10,22,.455,14,20,.700,82,2014-01-04,BRK,CLE
20,Home,W 89-85 ,240,33,81,.407,24,55,.436,9,26,.346,14,20,.700,89,32,86,.372,29,67,.433,3,19,.158,18,23,.783,85,2014-01-07,NYK,DET
21,@,L 89-117 ,240,34,85,.400,30,66,.455,4,19,.211,17,22,.773,89,43,86,.500,33,63,.524,10,23,.435,21,23,.913,117,2014-01-16,NYK,IND
22,Home,L 89-110 ,240,32,74,.432,28,58,.483,4,16,.250,21,31,.677,89,43,79,.544,34,57,.596,9,22,.409,15,19,.789,110,2014-01-17,DET,UTA
23,@,L 89-94 ,240,36,82,.439,33,64,.516,3,18,.167,14,20,.700,89,34,78,.436,23,54,.426,11,24,.458,15,20,.750,94,2014-01-17,MIN,TOR
24,@,W 89-87 ,240,31,77,.403,20,54,.370,11,23,.478,16,22,.727,89,37,88,.420,31,69,.449,6,19,.316,7,10,.700,87,2014-01-25,CHI,CHA
25,Home,L 89-100 ,240,33,80,.413,27,65,.415,6,15,.400,17,27,.630,89,39,74,.527,35,61,.574,4,13,.308,18,23,.783,100,2014-01-28,CLE,NOP
26,Home,L 89-99 ,240,38,79,.481,33,58,.569,5,21,.238,8,8,1.000,89,41,75,.547,37,61,.607,4,14,.286,13,16,.813,99,2014-01-29,SAC,MEM
27,@,L 89-96 ,240,33,80,.413,28,66,.424,5,14,.357,18,22,.818,89,41,82,.500,37,68,.544,4,14,.286,10,12,.833,96,2014-02-02,ORL,BOS
28,@,W 89-85 ,240,34,74,.459,29,56,.518,5,18,.278,16,20,.800,89,33,76,.434,26,51,.510,7,25,.280,12,15,.800,85,2014-02-04,IND,ATL
29,@,L 89-103 ,240,29,73,.397,22,52,.423,7,21,.333,24,29,.828,89,46,93,.495,42,80,.525,4,13,.308,7,10,.700,103,2014-02-06,SAS,BRK
30,@,L 89-99 ,240,31,87,.356,26,72,.361,5,15,.333,22,24,.917,89,40,88,.455,31,66,.470,9,22,.409,10,15,.667,99,2014-02-07,SAC,BOS
31,@,L 89-94 ,240,29,67,.433,22,44,.500,7,23,.304,24,30,.800,89,36,74,.486,26,49,.531,10,25,.400,12,19,.632,94,2014-02-08,MIA,UTA
32,Home,L 89-107 ,240,31,87,.356,25,62,.403,6,25,.240,21,21,1.000,89,39,82,.476,28,55,.509,11,27,.407,18,20,.900,107,2014-02-10,MIN,HOU
33,@,L 89-114 ,240,37,82,.451,32,68,.471,5,14,.357,10,12,.833,89,45,82,.549,33,58,.569,12,24,.500,12,15,.800,114,2014-02-11,DAL,CHA
34,@,L 89-92 ,240,34,74,.459,27,50,.540,7,24,.292,14,20,.700,89,33,70,.471,30,57,.526,3,13,.231,23,27,.852,92,2014-02-11,WAS,MEM
35,@,L 89-105 ,240,36,87,.414,26,60,.433,10,27,.370,7,15,.467,89,40,80,.500,27,49,.551,13,31,.419,12,15,.800,105,2014-02-12,CHA,BRK
36,Home,L 89-93 ,240,33,83,.398,29,60,.483,4,23,.174,19,27,.704,89,34,84,.405,29,69,.420,5,15,.333,20,30,.667,93,2014-02-12,DET,CLE
37,@,L 89-117 ,240,35,87,.402,28,72,.389,7,15,.467,12,22,.545,89,42,84,.500,32,67,.478,10,17,.588,23,27,.852,117,2014-02-21,DEN,CHI
38,@,L 89-92 ,240,34,79,.430,30,64,.469,4,15,.267,17,22,.773,89,30,82,.366,22,62,.355,8,20,.400,24,27,.889,92,2014-02-22,MEM,CHA
39,@,L 89-108 ,240,36,71,.507,27,51,.529,9,20,.450,8,19,.421,89,41,79,.519,31,57,.544,10,22,.455,16,17,.941,108,2014-02-26,NOP,DAL
40,Home,L 89-112 ,240,30,81,.370,24,59,.407,6,22,.273,23,33,.697,89,39,82,.476,29,51,.569,10,31,.323,24,29,.828,112,2014-02-27,DEN,BRK
41,@,L 89-96 ,240,32,75,.427,26,55,.473,6,20,.300,19,28,.679,89,32,68,.471,31,61,.508,1,7,.143,31,41,.756,96,2014-03-03,NOP,SAC
42,Home,L 89-101 ,240,38,84,.452,35,70,.500,3,14,.214,10,12,.833,89,40,82,.488,34,60,.567,6,22,.273,15,24,.625,101,2014-03-05,ORL,HOU
43,@,L 89-111 ,240,37,93,.398,32,72,.444,5,21,.238,10,14,.714,89,44,87,.506,37,74,.500,7,13,.538,16,22,.727,111,2014-03-08,CHA,MEM
44,@,L 89-104 ,240,36,81,.444,31,58,.534,5,23,.217,12,21,.571,89,41,77,.532,29,52,.558,12,25,.480,10,16,.625,104,2014-03-09,SAC,BRK
45,@,L 89-99 ,240,34,84,.405,31,69,.449,3,15,.200,18,30,.600,89,38,87,.437,31,69,.449,7,18,.389,16,19,.842,99,2014-03-11,SAC,DET
46,@,L 89-94 ,240,34,93,.366,25,71,.352,9,22,.409,12,14,.857,89,33,78,.423,24,51,.471,9,27,.333,19,21,.905,94,2014-03-17,BOS,DAL
47,@,L 89-103 ,240,35,77,.455,31,64,.484,4,13,.308,15,20,.750,89,37,82,.451,27,55,.491,10,27,.370,19,21,.905,103,2014-03-18,ORL,GSW
48,Home,W 89-88 ,240,29,75,.387,18,48,.375,11,27,.407,20,26,.769,89,31,79,.392,24,62,.387,7,17,.412,19,24,.792,88,2014-03-22,UTA,ORL
49,Home,L 89-100 ,240,32,86,.372,28,65,.431,4,21,.190,21,25,.840,89,39,82,.476,27,55,.491,12,27,.444,10,18,.556,100,2014-03-24,CHA,HOU
50,Home,W 89-77 ,240,35,84,.417,31,69,.449,4,15,.267,15,16,.938,89,27,73,.370,23,63,.365,4,10,.400,19,21,.905,77,2014-03-24,CHI,IND
51,@,W 89-84 ,240,32,80,.400,23,55,.418,9,25,.360,16,18,.889,89,28,79,.354,18,48,.375,10,31,.323,18,22,.818,84,2014-03-30,NYK,GSW
52,Home,L 89-90 ,240,34,76,.447,20,45,.444,14,31,.452,7,8,.875,89,38,78,.487,33,59,.559,5,19,.263,9,15,.600,90,2014-04-04,NYK,WAS
53,@,L 89-100 ,240,29,74,.392,23,52,.442,6,22,.273,25,32,.781,89,37,81,.457,28,56,.500,9,25,.360,17,21,.810,100,2014-04-13,CHI,NYK
54,@,L 89-101 ,240,31,77,.403,22,45,.489,9,32,.281,18,22,.818,89,35,79,.443,26,50,.520,9,29,.310,22,30,.733,101,2014-04-14,OKC,NOP
55,Home,W 89-79 ,240,30,85,.353,24,61,.393,6,24,.250,23,31,.742,89,31,84,.369,25,58,.431,6,26,.231,11,19,.579,79,2014-10-29,DEN,DET
56,@,L 89-106 ,240,33,81,.407,31,65,.477,2,16,.125,21,26,.808,89,39,87,.448,28,58,.483,11,29,.379,17,22,.773,106,2014-10-29,OKC,POR
57,Home,L 89-97 ,240,34,74,.459,26,53,.491,8,21,.381,13,16,.813,89,35,79,.443,28,60,.467,7,19,.368,20,27,.741,97,2014-10-31,IND,MEM
58,@,L 89-94 ,240,32,78,.410,24,53,.453,8,25,.320,17,23,.739,89,35,87,.402,33,69,.478,2,18,.111,22,26,.846,94,2014-10-31,SAS,PHO
59,@,L 89-96 ,240,30,77,.390,26,55,.473,4,22,.182,25,31,.806,89,35,82,.427,30,64,.469,5,18,.278,21,29,.724,96,2014-11-05,MIA,CHO
60,Home,L 89-91 ,240,33,77,.429,25,52,.481,8,25,.320,15,23,.652,89,39,88,.443,36,68,.529,3,20,.150,10,12,.833,91,2014-11-05,PHI,ORL
61,Home,L 89-91 ,240,37,79,.468,25,54,.463,12,25,.480,3,11,.273,89,34,81,.420,25,63,.397,9,18,.500,14,17,.824,91,2014-11-07,OKC,MEM
62,@,W 89-85 ,240,33,83,.398,31,64,.484,2,19,.105,21,27,.778,89,33,74,.446,28,52,.538,5,22,.227,14,17,.824,85,2014-11-10,SAS,LAC
63,Home,L 89-96 (OT),265,38,96,.396,26,60,.433,12,36,.333,1,6,.167,89,38,89,.427,27,58,.466,11,31,.355,9,15,.600,96,2014-11-14,OKC,DET
64,Home,L 89-105 ,240,36,81,.444,29,58,.500,7,23,.304,10,22,.455,89,39,80,.488,29,54,.537,10,26,.385,17,25,.680,105,2014-11-17,LAC,CHI
65,@,L 89-99 ,240,31,83,.373,27,62,.435,4,21,.190,23,24,.958,89,38,80,.475,33,56,.589,5,24,.208,18,26,.692,99,2014-11-21,DET,ATL
66,Home,L 89-99 ,240,33,79,.418,30,62,.484,3,17,.176,20,29,.690,89,37,77,.481,32,63,.508,5,14,.357,20,24,.833,99,2014-11-25,NOP,SAC
67,@,L 89-102 ,240,31,71,.437,26,55,.473,5,16,.313,22,28,.786,89,42,94,.447,30,59,.508,12,35,.343,6,15,.400,102,2014-11-26,SAC,HOU
68,Home,L 89-111 ,240,36,87,.414,30,69,.435,6,18,.333,11,15,.733,89,41,85,.482,30,59,.508,11,26,.423,18,20,.900,111,2014-11-30,BOS,SAS
69,@,L 89-119 ,240,31,82,.378,26,60,.433,5,22,.227,22,30,.733,89,45,85,.529,38,65,.585,7,20,.350,22,27,.815,119,2014-12-05,DEN,WAS
70,Home,L 89-91 ,240,38,84,.452,31,69,.449,7,15,.467,6,9,.667,89,41,81,.506,36,69,.522,5,12,.417,4,9,.444,91,2014-12-10,ORL,WAS
71,@,L 89-105 ,240,35,81,.432,26,54,.481,9,27,.333,10,22,.455,89,41,80,.513,31,60,.517,10,20,.500,13,19,.684,105,2014-12-17,BRK,TOR
72,Home,L 89-98 ,240,36,73,.493,27,52,.519,9,21,.429,8,12,.667,89,33,80,.413,25,50,.500,8,30,.267,24,26,.923,98,2014-12-26,ORL,CLE
73,Home,L 89-101 ,240,34,86,.395,28,67,.418,6,19,.316,15,18,.833,89,38,75,.507,27,55,.491,11,20,.550,14,21,.667,101,2015-01-03,MIN,UTA
74,@,W 89-81 ,240,35,88,.398,30,70,.429,5,18,.278,14,17,.824,89,30,74,.405,27,60,.450,3,14,.214,18,26,.692,81,2015-01-07,BOS,BRK
75,@,L 89-114 ,240,37,85,.435,32,65,.492,5,20,.250,10,17,.588,89,40,85,.471,28,52,.538,12,33,.364,22,30,.733,114,2015-01-07,LAL,LAC
76,@,L 89-120 ,240,36,76,.474,31,56,.554,5,20,.250,12,15,.800,89,42,89,.472,26,58,.448,16,31,.516,20,24,.833,120,2015-01-11,WAS,ATL
77,@,L 89-104 ,240,30,71,.423,24,53,.453,6,18,.333,23,27,.852,89,38,81,.469,25,52,.481,13,29,.448,15,19,.789,104,2015-01-14,MIA,GSW
78,@,L 89-97 ,240,34,83,.410,25,58,.431,9,25,.360,12,25,.480,89,33,79,.418,25,54,.463,8,25,.320,23,29,.793,97,2015-01-16,DEN,DAL
79,Home,L 89-110 ,240,35,82,.427,29,57,.509,6,25,.240,13,17,.765,89,42,69,.609,30,46,.652,12,23,.522,14,16,.875,110,2015-01-16,TOR,ATL
80,@,L 89-107 ,240,38,82,.463,31,54,.574,7,28,.250,6,7,.857,89,38,88,.432,23,53,.434,15,35,.429,16,19,.842,107,2015-01-17,PHI,DET
81,Home,W 89-69 ,240,31,80,.388,23,63,.365,8,17,.471,19,23,.826,89,28,84,.333,25,74,.338,3,10,.300,10,16,.625,69,2015-01-18,SAS,UTA
82,Home,L 89-92 ,240,34,76,.447,29,58,.500,5,18,.278,16,25,.640,89,36,90,.400,30,66,.455,6,24,.250,14,24,.583,92,2015-01-19,MIL,TOR
83,Home,L 89-90 ,240,33,89,.371,24,61,.393,9,28,.321,14,19,.737,89,39,87,.448,32,68,.471,7,19,.368,5,7,.714,90,2015-01-22,POR,BOS
84,Home,W 89-87 ,240,36,75,.480,32,58,.552,4,17,.235,13,15,.867,89,32,78,.410,29,63,.460,3,15,.200,20,23,.870,87,2015-01-23,MIA,IND
85,Home,W 89-69 ,240,37,78,.474,30,57,.526,7,21,.333,8,12,.667,89,23,75,.307,21,55,.382,2,20,.100,21,23,.913,69,2015-01-28,PHI,DET
86,Home,L 89-94 ,240,35,81,.432,30,57,.526,5,24,.208,14,20,.700,89,34,76,.447,25,50,.500,9,26,.346,17,25,.680,94,2015-01-28,UTA,LAC
87,@,L 89-90 ,240,36,69,.522,34,57,.596,2,12,.167,15,20,.750,89,35,81,.432,30,64,.469,5,17,.294,15,17,.882,90,2015-02-06,MEM,MIN
88,Home,W 89-81 ,240,29,74,.392,20,51,.392,9,23,.391,22,30,.733,89,29,84,.345,23,61,.377,6,23,.261,17,20,.850,81,2015-02-07,PHI,CHO
89,@,W 89-84 ,240,34,85,.400,27,56,.482,7,29,.241,14,19,.737,89,33,79,.418,26,55,.473,7,24,.292,11,14,.786,84,2015-02-09,GSW,PHI
90,Home,W 89-88 ,240,30,93,.323,20,62,.323,10,31,.323,19,20,.950,89,33,78,.423,26,49,.531,7,29,.241,15,23,.652,88,2015-02-11,BOS,ATL
91,@,L 89-105 ,240,32,86,.372,30,74,.405,2,12,.167,23,30,.767,89,37,83,.446,30,63,.476,7,20,.350,24,25,.960,105,2015-02-11,MEM,OKC
92,Home,W 89-83 ,240,31,67,.463,27,56,.482,4,11,.364,23,28,.821,89,25,73,.342,20,58,.345,5,15,.333,28,36,.778,83,2015-02-11,ORL,NYK
93,@,L 89-104 ,240,33,91,.363,24,64,.375,9,27,.333,14,17,.824,89,38,91,.418,31,69,.449,7,22,.318,21,26,.808,104,2015-02-19,DAL,OKC
94,Home,W 89-81 ,240,33,78,.423,28,63,.444,5,15,.333,18,22,.818,89,30,84,.357,23,58,.397,7,26,.269,14,21,.667,81,2015-02-20,MIL,DEN
95,Home,L 89-127 ,240,38,86,.442,37,70,.529,1,16,.063,12,16,.750,89,46,90,.511,32,57,.561,14,33,.424,21,28,.750,127,2015-02-20,WAS,CLE
96,@,L 89-106 ,240,37,85,.435,31,68,.456,6,17,.353,9,14,.643,89,37,89,.416,24,57,.421,13,32,.406,19,25,.760,106,2015-02-22,WAS,DET
97,@,L 89-96 ,240,33,77,.429,31,63,.492,2,14,.143,21,31,.677,89,37,96,.385,28,65,.431,9,31,.290,13,16,.813,96,2015-02-27,MIN,CHI
98,Home,W 89-81 ,240,28,80,.350,16,47,.340,12,33,.364,21,34,.618,89,30,93,.323,26,76,.342,4,17,.235,17,22,.773,81,2015-02-27,PHI,WAS
99,Home,L 89-113 ,240,31,77,.403,27,55,.491,4,22,.182,23,28,.821,89,42,87,.483,29,59,.492,13,28,.464,16,19,.842,113,2015-02-27,TOR,GSW
0,@,L 89-104 ,240,32,87,.368,26,67,.388,6,20,.300,19,26,.731,89,38,81,.469,27,58,.466,11,23,.478,17,19,.895,104,2015-03-06,DAL,GSW
1,@,W 89-83 ,240,27,71,.380,21,59,.356,6,12,.500,29,41,.707,89,32,88,.364,22,56,.393,10,32,.313,9,18,.500,83,2015-03-06,UTA,PHI
2,Home,W 89-79 ,240,31,75,.413,23,55,.418,8,20,.400,19,23,.826,89,30,84,.357,21,59,.356,9,25,.360,10,14,.714,79,2015-03-07,CLE,PHO
3,@,L 89-95 ,240,32,74,.432,26,58,.448,6,16,.375,19,29,.655,89,38,80,.475,30,57,.526,8,23,.348,11,13,.846,95,2015-03-07,MEM,NOP
4,Home,W 89-76 ,240,35,79,.443,24,48,.500,11,31,.355,8,15,.533,89,31,83,.373,29,75,.387,2,8,.250,12,21,.571,76,2015-03-09,LAC,MIN
5,Home,L 89-93 ,240,34,85,.400,25,61,.410,9,24,.375,12,15,.800,89,35,83,.422,27,55,.491,8,28,.286,15,21,.714,93,2015-03-14,IND,BOS
6,@,L 89-102 ,240,32,73,.438,27,59,.458,5,14,.357,20,30,.667,89,41,83,.494,35,65,.538,6,18,.333,14,23,.609,102,2015-03-15,NYK,PHO
7,@,L 89-108 ,240,34,84,.405,26,60,.433,8,24,.333,13,24,.542,89,44,88,.500,36,68,.529,8,20,.400,12,15,.800,108,2015-03-16,PHI,BOS
8,@,L 89-101 ,240,35,88,.398,30,68,.441,5,20,.250,14,20,.700,89,38,81,.469,33,58,.569,5,23,.217,20,23,.870,101,2015-03-20,BOS,SAS
9,@,L 89-106 ,240,35,84,.417,27,65,.415,8,19,.421,11,16,.688,89,39,75,.520,35,64,.547,4,11,.364,24,29,.828,106,2015-03-22,NYK,TOR
10,Home,W 89-88 ,240,36,87,.414,32,70,.457,4,17,.235,13,17,.765,89,33,75,.440,25,56,.446,8,19,.421,14,18,.778,88,2015-03-24,MIL,MIA
11,Home,L 89-111 ,240,37,85,.435,33,68,.485,4,17,.235,11,16,.688,89,43,84,.512,29,50,.580,14,34,.412,11,13,.846,111,2015-03-25,MEM,CLE
12,Home,L 89-92 ,240,35,80,.438,31,64,.484,4,16,.250,15,23,.652,89,34,81,.420,27,54,.500,7,27,.259,17,20,.850,92,2015-03-25,UTA,POR
13,@,L 89-94 ,240,31,73,.425,25,57,.439,6,16,.375,21,32,.656,89,32,84,.381,26,55,.473,6,29,.207,24,35,.686,94,2015-03-28,OKC,UTA
14,@,L 89-103 ,240,36,82,.439,30,68,.441,6,14,.429,11,12,.917,89,42,83,.506,38,66,.576,4,17,.235,15,18,.833,103,2015-03-29,MEM,SAS
15,@,L 89-112 ,240,37,82,.451,35,62,.565,2,20,.100,13,19,.684,89,37,85,.435,23,55,.418,14,30,.467,24,36,.667,112,2015-04-05,MIA,IND
16,@,W 89-78 ,240,35,91,.385,29,68,.426,6,23,.261,13,17,.765,89,34,88,.386,29,70,.414,5,18,.278,5,7,.714,78,2015-04-09,CHI,MIA
17,@,W 89-88 ,240,36,76,.474,31,61,.508,5,15,.333,12,19,.632,89,31,71,.437,20,48,.417,11,23,.478,15,22,.682,88,2015-04-10,MEM,UTA
18,@,L 89-109 ,240,32,79,.405,22,43,.512,10,36,.278,15,18,.833,89,42,86,.488,33,64,.516,9,22,.409,16,21,.762,109,2015-11-01,HOU,MIA
19,Home,L 89-103 ,240,29,74,.392,22,54,.407,7,20,.350,24,40,.600,89,40,83,.482,37,63,.587,3,20,.150,20,25,.800,103,2015-11-03,SAC,MEM
20,Home,W 89-79 ,240,31,74,.419,19,47,.404,12,27,.444,15,18,.833,89,30,91,.330,24,72,.333,6,19,.316,13,14,.929,79,2015-11-07,UTA,MEM
21,@,L 89-93 ,240,34,80,.425,29,60,.483,5,20,.250,16,18,.889,89,35,72,.486,28,50,.560,7,22,.318,16,22,.727,93,2015-11-18,TOR,UTA
22,Home,L 89-111 ,240,28,73,.384,23,54,.426,5,19,.263,28,40,.700,89,42,77,.545,31,50,.620,11,27,.407,16,18,.889,111,2015-11-23,UTA,OKC
23,@,L 89-92 ,240,37,90,.411,35,76,.461,2,14,.143,13,18,.722,89,37,86,.430,31,70,.443,6,16,.375,12,20,.600,92,2015-11-30,SAS,CHI
24,@,W 89-77 ,240,36,78,.462,28,55,.509,8,23,.348,9,10,.900,89,28,87,.322,19,55,.345,9,32,.281,12,14,.857,77,2015-12-15,CLE,BOS
25,@,L 89-110 ,240,31,79,.392,24,55,.436,7,24,.292,20,22,.909,89,36,79,.456,27,54,.500,9,25,.360,29,37,.784,110,2015-12-21,PHO,UTA
26,Home,L 89-102 ,240,29,81,.358,21,53,.396,8,28,.286,23,32,.719,89,36,85,.424,29,56,.518,7,29,.241,23,26,.885,102,2015-12-23,CHO,BOS
27,@,L 89-115 ,240,33,95,.347,26,67,.388,7,28,.250,16,24,.667,89,41,85,.482,28,54,.519,13,31,.419,20,23,.870,115,2015-12-23,POR,NOP
28,Home,W 89-83 ,240,32,78,.410,27,60,.450,5,18,.278,20,27,.741,89,30,95,.316,25,65,.385,5,30,.167,18,25,.720,83,2015-12-25,GSW,CLE
29,@,L 89-104 ,240,37,83,.446,32,63,.508,5,20,.250,10,15,.667,89,45,82,.549,38,65,.585,7,17,.412,7,11,.636,104,2015-12-28,NOP,ORL
30,Home,L 89-95 ,240,36,82,.439,29,57,.509,7,25,.280,10,15,.667,89,35,90,.389,25,56,.446,10,34,.294,15,19,.789,95,2015-12-31,NOP,LAC
31,@,L 89-115 ,240,36,81,.444,30,61,.492,6,20,.300,11,11,1.000,89,43,88,.489,29,58,.500,14,30,.467,15,21,.714,115,2016-01-04,ORL,DET
32,@,L 89-103 ,240,38,82,.463,33,73,.452,5,9,.556,8,10,.800,89,43,92,.467,35,65,.538,8,27,.296,9,14,.643,103,2016-01-09,BRK,DET
33,@,L 89-108 ,240,32,82,.390,26,51,.510,6,31,.194,19,25,.760,89,38,82,.463,23,49,.469,15,33,.455,17,29,.586,108,2016-01-13,DAL,OKC
34,@,L 89-114 ,240,34,87,.391,29,58,.500,5,29,.172,16,24,.667,89,42,76,.553,32,53,.604,10,23,.435,20,30,.667,114,2016-01-16,POR,PHI
35,Home,L 89-117 ,240,32,81,.395,26,63,.413,6,18,.333,19,23,.826,89,42,86,.488,33,72,.458,9,14,.643,24,28,.857,117,2016-01-21,PHO,SAS
36,@,W 89-84 ,240,37,81,.457,34,67,.507,3,14,.214,12,17,.706,89,35,88,.398,30,70,.429,5,18,.278,9,12,.750,84,2016-01-25,MIA,CHI
37,Home,L 89-91 ,240,35,83,.422,30,67,.448,5,16,.313,14,24,.583,89,32,78,.410,17,41,.415,15,37,.405,12,24,.500,91,2016-01-26,IND,LAC
38,@,L 89-106 ,240,32,78,.410,28,63,.444,4,15,.267,21,28,.750,89,35,79,.443,24,50,.480,11,29,.379,25,32,.781,106,2016-01-26,WAS,TOR
39,Home,L 89-97 ,240,31,82,.378,25,62,.403,6,20,.300,21,28,.750,89,40,90,.444,37,71,.521,3,19,.158,14,17,.824,97,2016-02-02,NYK,BOS
40,Home,L 89-98 ,240,30,80,.375,21,56,.375,9,24,.375,20,26,.769,89,34,78,.436,29,62,.468,5,16,.313,25,31,.806,98,2016-02-06,PHO,UTA
41,Home,L 89-103 ,240,36,80,.450,28,52,.538,8,28,.286,9,17,.529,89,39,70,.557,28,50,.560,11,20,.550,14,17,.824,103,2016-02-08,DET,TOR
42,Home,W 89-87 ,240,31,78,.397,27,51,.529,4,27,.148,23,33,.697,89,29,93,.312,21,58,.362,8,35,.229,21,26,.808,87,2016-02-08,IND,LAL
43,@,L 89-103 ,240,31,77,.403,27,62,.435,4,15,.267,23,29,.793,89,42,86,.488,35,68,.515,7,18,.389,12,21,.571,103,2016-02-18,UTA,WAS
44,@,L 89-109 ,240,29,83,.349,23,60,.383,6,23,.261,25,33,.758,89,43,94,.457,31,68,.456,12,26,.462,11,17,.647,109,2016-02-23,NOP,WAS
45,@,L 89-101 ,240,36,87,.414,35,74,.473,1,13,.077,16,23,.696,89,39,96,.406,34,80,.425,5,16,.313,18,22,.818,101,2016-02-27,MIA,BOS
46,@,L 89-102 ,240,38,99,.384,32,80,.400,6,19,.316,7,11,.636,89,39,97,.402,32,76,.421,7,21,.333,17,22,.773,102,2016-03-02,CHI,ORL
47,@,L 89-102 ,240,36,92,.391,30,66,.455,6,26,.231,11,15,.733,89,42,79,.532,38,63,.603,4,16,.250,14,18,.778,102,2016-03-05,DET,NYK
48,@,L 89-95 ,240,33,87,.379,28,70,.400,5,17,.294,18,22,.818,89,38,84,.452,29,56,.518,9,28,.321,10,15,.667,95,2016-03-11,BRK,PHI
49,Home,L 89-107 ,240,34,77,.442,32,64,.500,2,13,.154,19,26,.731,89,39,83,.470,25,53,.472,14,30,.467,15,17,.882,107,2016-03-15,MIL,TOR
50,@,L 89-99 ,240,32,81,.395,22,60,.367,10,21,.476,15,17,.882,89,39,87,.448,31,58,.534,8,29,.276,13,17,.765,99,2016-03-19,NYK,WAS
51,@,W 89-87 ,240,31,77,.403,20,48,.417,11,29,.379,16,20,.800,89,33,74,.446,24,51,.471,9,23,.391,12,22,.545,87,2016-03-23,UTA,HOU
52,@,L 89-111 ,240,36,88,.409,30,64,.469,6,24,.250,11,17,.647,89,48,89,.539,41,70,.586,7,19,.368,8,12,.667,111,2016-03-26,CHI,ORL
53,@,L 89-91 ,240,35,77,.455,32,60,.533,3,17,.176,16,18,.889,89,35,85,.412,27,60,.450,8,25,.320,13,17,.765,91,2016-03-30,NYK,DAL
54,Home,L 89-98 ,240,31,81,.383,18,48,.375,13,33,.394,14,24,.583,89,39,85,.459,31,61,.508,8,24,.333,12,14,.857,98,2016-04-01,DET,DAL
55,@,L 89-107 ,240,32,80,.400,27,58,.466,5,22,.227,20,25,.800,89,44,84,.524,35,70,.500,9,14,.643,10,14,.714,107,2016-04-05,DET,MIA
56,Home,L 89-93 ,240,32,89,.360,25,69,.362,7,20,.350,18,21,.857,89,37,78,.474,30,58,.517,7,20,.350,12,19,.632,93,2016-04-10,NYK,TOR
57,@,L 89-96 ,240,32,84,.381,23,61,.377,9,23,.391,16,21,.762,89,31,75,.413,25,50,.500,6,25,.240,28,40,.700,96,2016-10-28,LAL,UTA
58,@,L 89-102 ,240,35,86,.407,28,64,.438,7,22,.318,12,15,.800,89,41,89,.461,33,76,.434,8,13,.615,12,21,.571,102,2016-11-01,NYK,DET
59,Home,W 89-83 (OT),265,33,94,.351,25,67,.373,8,27,.296,15,20,.750,89,30,81,.370,19,47,.404,11,34,.324,12,16,.750,83,2016-11-02,MEM,NOP
60,Home,W 89-82 ,240,34,88,.386,24,61,.393,10,27,.370,11,19,.579,89,30,82,.366,23,61,.377,7,21,.333,15,19,.789,82,2016-11-16,ORL,NOP
61,@,L 89-93 ,240,32,77,.416,25,52,.481,7,25,.280,18,24,.750,89,35,86,.407,27,57,.474,8,29,.276,15,21,.714,93,2016-11-21,ORL,MIL
62,Home,L 89-105 ,240,31,78,.397,22,56,.393,9,22,.409,18,22,.818,89,40,90,.444,34,69,.493,6,21,.286,19,26,.731,105,2016-11-25,PHI,CHI
63,Home,L 89-112 ,240,31,78,.397,22,51,.431,9,27,.333,18,21,.857,89,45,92,.489,33,64,.516,12,28,.429,10,11,.909,112,2016-11-29,CHO,DET
64,Home,L 89-120 ,240,32,78,.410,22,48,.458,10,30,.333,15,20,.750,89,47,84,.560,37,62,.597,10,22,.455,16,21,.762,120,2016-12-07,DAL,SAC
65,@,L 89-110 ,240,34,77,.442,25,50,.500,9,27,.333,12,20,.600,89,38,87,.437,30,61,.492,8,26,.308,26,29,.897,110,2016-12-10,GSW,MEM
66,@,L 89-95 ,240,33,89,.371,24,62,.387,9,27,.333,14,17,.824,89,37,82,.451,30,57,.526,7,25,.280,14,25,.560,95,2016-12-14,IND,MIA
67,@,L 89-109 ,240,30,82,.366,24,63,.381,6,19,.316,23,27,.852,89,42,72,.583,29,49,.592,13,23,.565,12,15,.800,109,2016-12-14,OKC,UTA
68,Home,L 89-100 ,240,32,88,.364,26,57,.456,6,31,.194,19,24,.792,89,36,79,.456,27,49,.551,9,30,.300,19,22,.864,100,2016-12-16,PHI,LAL
69,@,L 89-102 ,240,31,79,.392,22,51,.431,9,28,.321,18,23,.783,89,35,74,.473,23,49,.469,12,25,.480,20,22,.909,102,2016-12-28,SAC,POR
70,Home,L 89-101 ,240,32,68,.471,25,49,.510,7,19,.368,18,25,.720,89,38,77,.494,24,46,.522,14,31,.452,11,14,.786,101,2016-12-29,LAL,DAL
71,Home,L 89-95 ,240,35,87,.402,28,64,.438,7,23,.304,12,18,.667,89,36,73,.493,30,51,.588,6,22,.273,17,28,.607,95,2017-01-01,MIN,POR
72,Home,L 89-101 ,240,33,78,.423,27,51,.529,6,27,.222,17,23,.739,89,39,93,.419,32,69,.464,7,24,.292,16,20,.800,101,2017-01-02,BRK,UTA
73,@,L 89-104 ,240,35,89,.393,32,71,.451,3,18,.167,16,21,.762,89,44,92,.478,37,69,.536,7,23,.304,9,11,.818,104,2017-01-12,CHI,NYK
74,@,L 89-94 ,240,34,86,.395,28,62,.452,6,24,.250,15,23,.652,89,31,69,.449,23,45,.511,8,24,.333,24,32,.750,94,2017-01-18,TOR,PHI
75,Home,W 89-74 ,240,32,81,.395,28,62,.452,4,19,.211,21,25,.840,89,30,82,.366,26,63,.413,4,19,.211,10,18,.556,74,2017-02-06,MEM,SAS
76,@,L 89-117 ,240,35,84,.417,25,59,.424,10,25,.400,9,13,.692,89,44,81,.543,38,57,.667,6,24,.250,23,26,.885,117,2017-02-12,CHI,MIN
77,@,L 89-102 ,240,34,78,.436,27,57,.474,7,21,.333,14,19,.737,89,40,79,.506,34,58,.586,6,21,.286,16,16,1.000,102,2017-02-13,DET,MIL
78,@,L 89-96 ,240,37,83,.446,28,57,.491,9,26,.346,6,13,.462,89,33,76,.434,24,58,.414,9,18,.500,21,23,.913,96,2017-02-27,MIA,DAL
79,@,L 89-104 ,240,33,82,.402,31,60,.517,2,22,.091,21,30,.700,89,42,86,.488,35,61,.574,7,25,.280,13,16,.813,104,2017-03-05,OKC,DAL
80,@,W 88-87 ,240,36,89,.404,29,74,.392,7,15,.467,9,14,.643,88,36,76,.474,32,60,.533,4,16,.250,11,20,.550,87,2011-12-25,CHI,LAL
81,@,L 88-96 ,240,30,76,.395,25,61,.410,5,15,.333,23,28,.821,88,39,82,.476,31,67,.463,8,15,.533,10,13,.769,96,2011-12-31,IND,DET
82,@,L 88-93 ,240,33,78,.423,29,63,.460,4,15,.267,18,22,.818,88,36,75,.480,30,51,.588,6,24,.250,15,24,.625,93,2012-01-01,POR,LAC
83,Home,L 88-96 ,240,36,77,.468,28,60,.467,8,17,.471,8,10,.800,88,37,79,.468,32,58,.552,5,21,.238,17,22,.773,96,2012-01-06,NOH,DEN
84,@,W 88-87 ,240,32,81,.395,28,65,.431,4,16,.250,20,28,.714,88,29,70,.414,22,51,.431,7,19,.368,22,24,.917,87,2012-01-07,UTA,GSW
85,@,W 88-79 ,240,34,76,.447,30,63,.476,4,13,.308,16,21,.762,88,31,75,.413,25,61,.410,6,14,.429,11,13,.846,79,2012-01-13,CHI,BOS
86,Home,L 88-97 ,240,34,87,.391,28,73,.384,6,14,.429,14,16,.875,88,36,80,.450,29,61,.475,7,19,.368,18,19,.947,97,2012-01-16,BOS,OKC
87,Home,L 88-91 ,240,32,86,.372,28,71,.394,4,15,.267,20,30,.667,88,36,79,.456,29,67,.433,7,12,.583,12,16,.750,91,2012-01-18,NYK,PHO
88,@,L 88-92 ,240,34,78,.436,33,65,.508,1,13,.077,19,27,.704,88,28,93,.301,20,62,.323,8,31,.258,28,41,.683,92,2012-01-18,IND,SAC
89,@,L 88-90 (OT),265,37,94,.394,34,83,.410,3,11,.273,11,16,.688,88,35,88,.398,26,61,.426,9,27,.333,11,13,.846,90,2012-01-19,NOH,HOU
90,@,W 88-86 ,240,36,83,.434,31,62,.500,5,21,.238,11,19,.579,88,31,82,.378,26,57,.456,5,25,.200,19,21,.905,86,2012-01-20,SAC,SAS
91,@,W 88-87 ,240,34,79,.430,31,66,.470,3,13,.231,17,20,.850,88,36,69,.522,31,58,.534,5,11,.455,10,14,.714,87,2012-01-29,CLE,BOS
92,Home,L 88-98 ,240,37,92,.402,34,78,.436,3,14,.214,11,13,.846,88,34,75,.453,28,55,.509,6,20,.300,24,31,.774,98,2012-01-30,WAS,CHI
93,Home,W 88-80 ,240,34,81,.420,30,67,.448,4,14,.286,16,19,.842,88,26,74,.351,23,57,.404,3,17,.176,25,33,.758,80,2012-02-03,DET,MIL
94,@,L 88-91 ,240,32,67,.478,26,54,.481,6,13,.462,18,27,.667,88,37,93,.398,31,70,.443,6,23,.261,11,15,.733,91,2012-02-04,DAL,CLE
95,@,L 88-99 ,240,33,76,.434,31,65,.477,2,11,.182,20,26,.769,88,35,73,.479,26,45,.578,9,28,.321,20,31,.645,99,2012-02-06,UTA,NYK
96,@,W 88-87 (OT),265,36,91,.396,35,76,.461,1,15,.067,15,20,.750,88,38,97,.392,32,78,.410,6,19,.316,5,5,1.000,87,2012-02-09,LAL,BOS
97,Home,L 88-98 ,240,34,78,.436,32,68,.471,2,10,.200,18,23,.783,88,42,83,.506,37,70,.529,5,13,.385,9,13,.692,98,2012-02-12,MEM,UTA
98,Home,L 88-98 ,240,34,77,.442,33,71,.465,1,6,.167,19,32,.594,88,35,74,.473,31,62,.500,4,12,.333,24,29,.828,98,2012-02-15,BOS,DET
99,@,L 88-93 ,240,35,75,.467,31,58,.534,4,17,.235,14,16,.875,88,32,81,.395,25,62,.403,7,19,.368,22,26,.846,93,2012-02-16,NJN,IND
0,@,L 88-104 ,240,36,84,.429,31,64,.484,5,20,.250,11,19,.579,88,37,79,.468,30,58,.517,7,21,.333,23,29,.793,104,2012-02-20,WAS,PHO
1,Home,L 88-102 ,240,31,88,.352,23,69,.333,8,19,.421,18,23,.783,88,34,85,.400,27,69,.391,7,16,.438,27,32,.844,102,2012-02-22,CHA,IND
2,@,L 88-102 ,240,31,79,.392,24,62,.387,7,17,.412,19,22,.864,88,42,85,.494,38,71,.535,4,14,.286,14,19,.737,102,2012-02-23,NYK,MIA
3,Home,W 88-85 ,240,29,75,.387,22,55,.400,7,20,.350,23,28,.821,88,35,75,.467,33,58,.569,2,17,.118,13,18,.722,85,2012-02-28,HOU,TOR
4,Home,L 88-92 ,240,37,90,.411,33,73,.452,4,17,.235,10,12,.833,88,30,78,.385,24,59,.407,6,19,.316,26,34,.765,92,2012-02-29,PHI,OKC
5,@,L 88-96 ,240,38,99,.384,36,86,.419,2,13,.154,10,14,.714,88,40,88,.455,35,76,.461,5,12,.417,11,16,.688,96,2012-03-04,SAC,PHO
6,Home,L 88-92 ,240,32,79,.405,24,59,.407,8,20,.400,16,20,.800,88,35,79,.443,26,51,.510,9,28,.321,13,28,.464,92,2012-03-05,TOR,ORL
7,Home,W 88-85 (OT),265,37,93,.398,34,83,.410,3,10,.300,11,12,.917,88,34,81,.420,31,59,.525,3,22,.136,14,17,.824,85,2012-03-06,DET,LAL
8,Home,L 88-96 ,240,29,76,.382,26,61,.426,3,15,.200,27,33,.818,88,37,74,.500,29,55,.527,8,19,.421,14,21,.667,96,2012-03-13,CLE,TOR
9,@,L 88-102 ,240,38,78,.487,33,67,.493,5,11,.455,7,9,.778,88,40,83,.482,28,56,.500,12,27,.444,10,13,.769,102,2012-03-16,WAS,ATL
10,Home,L 88-102 ,240,32,79,.405,28,60,.467,4,19,.211,20,27,.741,88,32,77,.416,25,53,.472,7,24,.292,31,40,.775,102,2012-03-17,IND,NYK
11,@,W 88-73 ,240,34,77,.442,32,61,.525,2,16,.125,18,20,.900,88,29,75,.387,23,60,.383,6,15,.400,9,17,.529,73,2012-03-23,MIA,DET
12,Home,W 88-76 ,240,34,70,.486,31,60,.517,3,10,.300,17,18,.944,88,30,87,.345,27,73,.370,3,14,.214,13,19,.684,76,2012-03-25,BOS,WAS
13,@,W 88-83 ,240,33,81,.407,25,60,.417,8,21,.381,14,20,.700,88,31,78,.397,28,65,.431,3,13,.231,18,22,.818,83,2012-03-28,MIN,CHA
14,Home,L 88-99 ,240,36,98,.367,30,76,.395,6,22,.273,10,11,.909,88,38,73,.521,36,56,.643,2,17,.118,21,29,.724,99,2012-03-30,CHA,DEN
15,Home,W 88-85 ,240,32,77,.416,25,55,.455,7,22,.318,17,22,.773,88,39,92,.424,37,82,.451,2,10,.200,5,10,.500,85,2012-03-31,LAL,NOH
16,Home,L 88-94 ,240,33,73,.452,28,52,.538,5,21,.238,17,24,.708,88,34,87,.391,30,71,.423,4,16,.250,22,24,.917,94,2012-04-02,OKC,MEM
17,@,L 88-101 ,240,32,86,.372,26,67,.388,6,19,.316,18,19,.947,88,37,81,.457,25,57,.439,12,24,.500,15,19,.789,101,2012-04-04,NJN,POR
18,@,W 88-82 ,240,29,80,.363,23,60,.383,6,20,.300,24,31,.774,88,31,78,.397,26,65,.400,5,13,.385,15,20,.750,82,2012-04-07,ORL,PHI
19,Home,L 88-107 ,240,34,88,.386,32,77,.416,2,11,.182,18,21,.857,88,39,85,.459,33,68,.485,6,17,.353,23,26,.885,107,2012-04-10,NJN,PHI
20,Home,W 88-86 (OT),265,37,89,.416,34,76,.447,3,13,.231,11,13,.846,88,34,83,.410,32,63,.508,2,20,.100,16,23,.696,86,2012-04-11,BOS,ATL
21,Home,W 88-75 ,240,32,73,.438,29,60,.483,3,13,.231,21,21,1.000,88,25,70,.357,20,52,.385,5,18,.278,20,25,.800,75,2012-04-15,NOH,MEM
22,@,L 88-111 ,240,32,87,.368,25,62,.403,7,25,.280,17,25,.680,88,39,88,.443,28,64,.438,11,24,.458,22,25,.880,111,2012-04-16,MIN,IND
23,Home,L 88-114 ,240,39,89,.438,37,74,.500,2,15,.133,8,14,.571,88,48,87,.552,45,78,.577,3,9,.333,15,20,.750,114,2012-04-22,CHA,SAC
24,@,L 88-97 ,240,35,76,.461,28,56,.500,7,20,.350,11,13,.846,88,35,85,.412,30,69,.435,5,16,.313,22,24,.917,97,2012-04-22,HOU,MIA
25,Home,L 88-93 ,240,30,82,.366,23,56,.411,7,26,.269,21,21,1.000,88,41,92,.446,36,76,.474,5,16,.313,6,10,.600,93,2012-04-22,MIN,GSW
26,@,L 88-100 ,240,34,84,.405,29,61,.475,5,23,.217,15,23,.652,88,37,87,.425,33,74,.446,4,13,.308,22,29,.759,100,2012-04-24,PHO,UTA
27,Home,W 88-76 ,240,34,72,.472,32,60,.533,2,12,.167,18,22,.818,88,30,73,.411,23,47,.489,7,26,.269,9,15,.600,76,2012-04-26,MEM,ORL
28,Home,L 88-90 ,240,33,91,.363,27,74,.365,6,17,.353,16,19,.842,88,37,78,.474,32,67,.478,5,11,.455,11,16,.688,90,2012-10-31,TOR,IND
29,Home,L 88-99 ,240,33,74,.446,28,60,.467,5,14,.357,17,21,.810,88,40,86,.465,32,68,.471,8,18,.444,11,12,.917,99,2012-11-02,BOS,MIL
30,Home,W 88-86 ,240,37,81,.457,32,67,.478,5,14,.357,9,14,.643,88,35,85,.412,25,57,.439,10,28,.357,6,12,.500,86,2012-11-02,NOH,UTA
31,Home,L 88-110 ,240,29,86,.337,21,64,.328,8,22,.364,22,26,.846,88,39,84,.464,26,52,.500,13,32,.406,19,19,1.000,110,2012-11-05,PHI,NYK
32,@,L 88-108 ,240,30,84,.357,23,54,.426,7,30,.233,21,25,.840,88,35,74,.473,26,49,.531,9,25,.360,29,34,.853,108,2012-11-06,TOR,OKC
33,@,L 88-92 ,240,34,78,.436,27,55,.491,7,23,.304,13,18,.722,88,33,71,.465,28,53,.528,5,18,.278,21,25,.840,92,2012-11-14,ATL,GSW
34,Home,L 88-97 ,240,34,79,.430,29,61,.475,5,18,.278,15,21,.714,88,38,71,.535,30,52,.577,8,19,.421,13,19,.684,97,2012-11-17,PHO,MIA
35,Home,W 88-76 ,240,33,90,.367,26,65,.400,7,25,.280,15,19,.789,88,28,71,.394,20,51,.392,8,20,.400,12,18,.667,76,2012-11-18,NYK,IND
36,Home,L 88-102 ,240,33,72,.458,28,59,.475,5,13,.385,17,21,.810,88,35,73,.479,24,52,.462,11,21,.524,21,25,.840,102,2012-11-28,MIL,NYK
37,@,L 88-93 ,240,36,82,.439,33,70,.471,3,12,.250,13,18,.722,88,38,81,.469,34,74,.459,4,7,.571,13,21,.619,93,2012-12-01,PHI,CHI
38,@,L 88-91 ,240,34,82,.415,28,63,.444,6,19,.316,14,17,.824,88,36,79,.456,32,66,.485,4,13,.308,15,20,.750,91,2012-12-01,BOS,MIL
39,Home,L 88-105 ,240,35,83,.422,30,63,.476,5,20,.250,13,23,.565,88,41,77,.532,28,52,.538,13,25,.520,10,17,.588,105,2012-12-04,PHI,MIN
40,Home,L 88-97 ,240,32,79,.405,25,54,.463,7,25,.280,17,23,.739,88,33,71,.465,26,55,.473,7,16,.438,24,30,.800,97,2012-12-09,BRK,MIL
41,@,L 88-92 ,240,33,83,.398,24,61,.393,9,22,.409,13,16,.813,88,31,71,.437,26,56,.464,5,15,.333,25,32,.781,92,2012-12-12,NOH,OKC
42,Home,L 88-94 ,240,37,75,.493,33,57,.579,4,18,.222,10,17,.588,88,29,64,.453,19,45,.422,10,19,.526,26,35,.743,94,2012-12-12,TOR,BRK
43,@,W 88-77 ,240,35,72,.486,28,48,.583,7,24,.292,11,16,.688,88,32,83,.386,29,70,.414,3,13,.231,10,15,.667,77,2012-12-15,IND,DET
44,@,L 88-103 ,240,38,81,.469,32,65,.492,6,16,.375,6,8,.750,88,38,81,.469,26,56,.464,12,25,.480,15,20,.750,103,2012-12-15,BOS,SAS
45,@,W 88-76 ,240,35,78,.449,30,56,.536,5,22,.227,13,17,.765,88,29,71,.408,22,51,.431,7,20,.350,11,19,.579,76,2012-12-17,LAC,DET
46,@,L 88-110 ,240,33,87,.379,30,67,.448,3,20,.150,19,30,.633,88,47,92,.511,41,72,.569,6,20,.300,10,15,.667,110,2012-12-22,CHA,DEN
47,Home,L 88-123 ,240,36,81,.444,31,63,.492,5,18,.278,11,22,.500,88,46,82,.561,31,55,.564,15,27,.556,16,21,.762,123,2012-12-29,ORL,TOR
48,Home,W 88-83 ,240,28,70,.400,16,45,.356,12,25,.480,20,24,.833,88,31,82,.378,28,71,.394,3,11,.273,18,24,.750,83,2012-12-31,IND,MEM
49,@,L 88-95 ,240,33,73,.452,27,52,.519,6,21,.286,16,20,.800,88,40,83,.482,35,70,.500,5,13,.385,10,12,.833,95,2013-01-07,SAS,NOH
50,Home,W 88-79 ,240,35,84,.417,30,65,.462,5,19,.263,13,16,.813,88,30,75,.400,21,48,.438,9,27,.333,10,13,.769,79,2013-01-09,NOH,HOU
51,@,L 88-96 ,240,36,78,.462,33,71,.465,3,7,.429,13,16,.813,88,38,89,.427,27,61,.443,11,28,.393,9,12,.750,96,2013-01-12,CHA,IND
52,@,L 88-106 ,240,33,89,.371,29,73,.397,4,16,.250,18,23,.783,88,45,80,.563,37,59,.627,8,21,.381,8,11,.727,106,2013-01-13,MIN,SAS
53,@,L 88-104 ,240,34,95,.358,27,67,.403,7,28,.250,13,22,.591,88,42,84,.500,32,55,.582,10,29,.345,10,18,.556,104,2013-01-15,MIL,LAL
54,Home,L 88-93 ,240,31,79,.392,22,50,.440,9,29,.310,17,26,.654,88,32,83,.386,28,66,.424,4,17,.235,25,32,.781,93,2013-01-16,POR,CLE
55,@,L 88-95 ,240,36,84,.429,32,68,.471,4,16,.250,12,14,.857,88,36,80,.450,31,58,.534,5,22,.227,18,20,.900,95,2013-01-18,GSW,SAS
56,@,L 88-103 ,240,33,83,.398,29,68,.426,4,15,.267,18,25,.720,88,36,78,.462,27,59,.458,9,19,.474,22,31,.710,103,2013-01-20,BOS,DET
57,@,W 88-85 ,240,31,74,.419,19,50,.380,12,24,.500,14,20,.700,88,34,84,.405,28,63,.444,6,21,.286,11,17,.647,85,2013-01-21,BRK,NYK
58,@,L 88-92 ,240,31,86,.360,24,68,.353,7,18,.389,19,26,.731,88,38,85,.447,35,73,.479,3,12,.250,13,19,.684,92,2013-01-23,WAS,UTA
59,@,L 88-93 ,240,33,83,.398,27,65,.415,6,18,.333,16,26,.615,88,30,71,.423,25,55,.455,5,16,.313,28,37,.757,93,2013-01-24,LAC,PHO
60,@,L 88-110 ,240,34,72,.472,30,60,.500,4,12,.333,16,23,.696,88,43,77,.558,38,60,.633,5,17,.294,19,23,.826,110,2013-01-25,DET,MIA
61,Home,L 88-104 ,240,34,82,.415,28,68,.412,6,14,.429,14,19,.737,88,45,91,.495,41,78,.526,4,13,.308,10,13,.769,104,2013-01-30,MIL,CHI
62,@,W 88-69 ,240,32,81,.395,27,64,.422,5,17,.294,19,25,.760,88,31,89,.348,29,81,.358,2,8,.250,5,7,.714,69,2013-02-06,IND,PHI
63,@,L 88-105 ,240,34,69,.493,30,53,.566,4,16,.250,16,25,.640,88,41,79,.519,35,66,.530,6,13,.462,17,22,.773,105,2013-02-10,MIN,MEM
64,Home,L 88-102 ,240,33,74,.446,26,51,.510,7,23,.304,15,18,.833,88,41,80,.513,31,52,.596,10,28,.357,10,16,.625,102,2013-02-10,NYK,LAC
65,Home,L 88-92 ,240,28,79,.354,19,54,.352,9,25,.360,23,32,.719,88,31,73,.425,22,52,.423,9,21,.429,21,24,.875,92,2013-02-13,NYK,TOR
66,Home,L 88-96 ,240,30,78,.385,24,63,.381,6,15,.400,22,27,.815,88,35,78,.449,27,58,.466,8,20,.400,18,20,.900,96,2013-02-19,WAS,TOR
67,@,W 88-82 ,240,29,80,.363,23,67,.343,6,13,.462,24,34,.706,88,26,71,.366,18,53,.340,8,18,.444,22,26,.846,82,2013-02-20,MEM,TOR
68,Home,W 88-82 ,240,34,76,.447,31,60,.517,3,16,.188,17,29,.586,88,35,84,.417,30,69,.435,5,15,.333,7,9,.778,82,2013-02-22,MEM,ORL
69,Home,L 88-113 ,240,35,84,.417,31,65,.477,4,19,.211,14,23,.609,88,44,79,.557,34,57,.596,10,22,.455,15,23,.652,113,2013-02-22,PHO,BOS
70,Home,L 88-96 ,240,31,74,.419,24,58,.414,7,16,.438,19,29,.655,88,35,81,.432,27,53,.509,8,28,.286,18,21,.857,96,2013-03-01,WAS,NYK
71,@,L 88-104 ,240,36,89,.404,29,65,.446,7,24,.292,9,11,.818,88,46,86,.535,41,71,.577,5,15,.333,7,9,.778,104,2013-03-04,ATL,DEN
72,@,L 88-89 ,240,37,81,.457,35,71,.493,2,10,.200,12,18,.667,88,30,81,.370,26,64,.406,4,17,.235,25,30,.833,89,2013-03-08,UTA,CHI
73,Home,L 88-94 ,240,33,87,.379,24,66,.364,9,21,.429,13,20,.650,88,27,74,.365,12,39,.308,15,35,.429,25,34,.735,94,2013-03-08,GSW,HOU
74,@,L 88-111 ,240,35,84,.417,30,66,.455,5,18,.278,13,19,.684,88,42,78,.538,33,61,.541,9,17,.529,18,22,.818,111,2013-03-09,MIN,DEN
75,@,L 88-112 ,240,34,79,.430,31,66,.470,3,13,.231,17,19,.895,88,39,76,.513,33,61,.541,6,15,.400,28,35,.800,112,2013-03-13,TOR,BOS
76,@,L 88-105 ,240,34,76,.447,27,56,.482,7,20,.350,13,21,.619,88,41,79,.519,31,64,.484,10,15,.667,13,20,.650,105,2013-03-16,CHA,BOS
77,@,W 88-79 ,240,33,68,.485,27,53,.509,6,15,.400,16,25,.640,88,28,83,.337,25,68,.368,3,15,.200,20,22,.909,79,2013-03-20,WAS,PHO
78,Home,L 88-107 ,240,35,78,.449,31,61,.508,4,17,.235,14,20,.700,88,40,81,.494,30,60,.500,10,21,.476,17,20,.850,107,2013-03-27,TOR,ATL
79,@,L 88-103 ,240,34,76,.447,28,60,.467,6,16,.375,14,19,.737,88,44,85,.518,38,70,.543,6,15,.400,9,13,.692,103,2013-03-27,PHO,UTA
80,@,L 88-97 ,240,34,87,.391,30,74,.405,4,13,.308,16,27,.593,88,34,78,.436,28,57,.491,6,21,.286,23,31,.742,97,2013-03-30,ORL,ATL
81,@,W 88-86 ,240,33,71,.465,21,43,.488,12,28,.429,10,15,.667,88,35,79,.443,28,55,.509,7,24,.292,9,16,.563,86,2013-03-31,MIA,SAS
82,Home,W 88-83 ,240,35,81,.432,31,67,.463,4,14,.286,14,16,.875,88,33,94,.351,29,78,.372,4,16,.250,13,16,.813,83,2013-04-03,CHA,PHI
83,@,L 88-98 ,240,33,83,.398,29,68,.426,4,15,.267,18,23,.783,88,36,78,.462,29,59,.492,7,19,.368,19,22,.864,98,2013-04-03,NOH,GSW
84,Home,W 88-78 ,240,30,66,.455,29,58,.500,1,8,.125,27,36,.750,88,26,80,.325,21,61,.344,5,19,.263,21,29,.724,78,2013-04-03,TOR,WAS
85,@,L 88-100 ,240,33,83,.398,25,62,.403,8,21,.381,14,17,.824,88,38,82,.463,26,58,.448,12,24,.500,12,13,.923,100,2013-04-04,SAS,OKC
86,@,L 88-97 ,240,34,77,.442,25,59,.424,9,18,.500,11,14,.786,88,34,72,.472,32,64,.500,2,8,.250,27,33,.818,97,2013-04-12,CHI,TOR
87,Home,L 88-120 ,240,35,83,.422,30,69,.435,5,14,.357,13,15,.867,88,48,81,.593,38,65,.585,10,16,.625,14,19,.737,120,2013-04-13,ORL,BOS
88,Home,L 88-99 ,240,35,82,.427,29,70,.414,6,12,.500,12,14,.857,88,40,93,.430,31,72,.431,9,21,.429,10,13,.769,99,2013-04-17,POR,GSW
89,@,L 88-90 ,240,34,79,.430,29,64,.453,5,15,.333,15,17,.882,88,33,81,.407,25,60,.417,8,21,.381,16,23,.696,90,2013-10-30,DEN,SAC
90,@,L 88-95 ,240,33,70,.471,26,50,.520,7,20,.350,15,18,.833,88,36,74,.486,31,59,.525,5,15,.333,18,22,.818,95,2013-11-04,BOS,MEM
91,@,L 88-104 ,240,31,82,.378,27,64,.422,4,18,.222,22,30,.733,88,40,78,.513,36,67,.537,4,11,.364,20,32,.625,104,2013-11-05,UTA,BRK
92,@,L 88-102 ,240,35,77,.455,27,60,.450,8,17,.471,10,16,.625,88,41,80,.513,32,59,.542,9,21,.429,11,14,.786,102,2013-11-16,UTA,GSW
93,@,L 88-106 ,240,34,86,.395,29,68,.426,5,18,.278,15,18,.833,88,40,94,.426,33,71,.465,7,23,.304,19,22,.864,106,2013-11-16,BOS,MIN
94,@,L 88-104 ,240,33,74,.446,22,50,.440,11,24,.458,11,15,.733,88,41,81,.506,31,60,.517,10,21,.476,12,19,.632,104,2013-11-19,ATL,MIA
95,@,W 88-81 (OT),265,34,88,.386,31,76,.408,3,12,.250,17,19,.895,88,36,82,.439,31,64,.484,5,18,.278,4,8,.500,81,2013-11-20,MEM,GSW
96,@,L 88-96 ,240,36,86,.419,30,69,.435,6,17,.353,10,13,.769,88,37,78,.474,32,60,.533,5,18,.278,17,23,.739,96,2013-11-22,WAS,TOR
97,@,L 88-94 ,240,36,92,.391,29,65,.446,7,27,.259,9,14,.643,88,39,84,.464,35,69,.507,4,15,.267,12,15,.800,94,2013-11-27,SAS,OKC
98,Home,W 88-87 ,240,31,73,.425,28,58,.483,3,15,.200,23,30,.767,88,29,77,.377,20,53,.377,9,24,.375,20,21,.952,87,2013-11-29,ATL,DAL
99,Home,L 88-97 ,240,36,77,.468,29,62,.468,7,15,.467,9,12,.750,88,34,73,.466,25,55,.455,9,18,.500,20,26,.769,97,2013-11-30,MEM,BRK
0,@,L 88-98 ,240,36,92,.391,30,69,.435,6,23,.261,10,13,.769,88,37,91,.407,32,77,.416,5,14,.357,19,24,.792,98,2013-12-04,DEN,CLE
1,Home,L 88-97 ,240,31,88,.352,22,57,.386,9,31,.290,17,19,.895,88,36,79,.456,25,55,.455,11,24,.458,14,19,.737,97,2013-12-04,HOU,PHO
2,@,L 88-105 ,240,37,92,.402,31,65,.477,6,27,.222,8,13,.615,88,42,91,.462,38,70,.543,4,21,.190,17,25,.680,105,2013-12-06,PHI,CHA
3,Home,W 88-82 ,240,31,83,.373,27,69,.391,4,14,.286,22,30,.733,88,28,87,.322,21,52,.404,7,35,.200,19,26,.731,82,2013-12-07,CLE,LAC
4,@,L 88-98 ,240,32,93,.344,24,64,.375,8,29,.276,16,28,.571,88,32,76,.421,22,43,.512,10,33,.303,24,42,.571,98,2013-12-08,ORL,HOU
5,Home,L 88-96 ,240,33,80,.413,27,63,.429,6,17,.353,16,19,.842,88,34,76,.447,28,59,.475,6,17,.353,22,34,.647,96,2013-12-11,BOS,LAC
6,@,W 88-85 ,240,30,77,.390,23,57,.404,7,20,.350,21,23,.913,88,39,89,.438,37,76,.487,2,13,.154,5,8,.625,85,2013-12-14,LAL,CHA
7,@,W 88-85 ,240,32,83,.386,22,62,.355,10,21,.476,14,18,.778,88,36,83,.434,34,71,.479,2,12,.167,11,16,.688,85,2013-12-21,UTA,CHA
8,Home,L 88-107 ,240,31,85,.365,24,65,.369,7,20,.350,19,26,.731,88,41,85,.482,29,54,.537,12,31,.387,13,22,.591,107,2013-12-30,LAC,PHO
9,Home,L 88-101 ,240,34,82,.415,30,70,.429,4,12,.333,16,17,.941,88,40,79,.506,29,57,.509,11,22,.500,10,13,.769,101,2014-01-03,WAS,TOR
10,@,L 88-107 ,240,36,77,.468,33,68,.485,3,9,.333,13,17,.765,88,40,78,.513,31,51,.608,9,27,.333,18,23,.783,107,2014-01-07,NOP,MIA
11,@,L 88-101 ,240,30,85,.353,24,61,.393,6,24,.250,22,27,.815,88,37,90,.411,23,59,.390,14,31,.452,13,18,.722,101,2014-01-09,OKC,DEN
12,Home,L 88-102 ,240,34,79,.430,25,58,.431,9,21,.429,11,19,.579,88,39,75,.520,32,57,.561,7,18,.389,17,28,.607,102,2014-01-13,CHI,WAS
13,@,L 88-107 ,240,34,76,.447,27,52,.519,7,24,.292,13,16,.813,88,40,79,.506,27,52,.519,13,27,.481,14,15,.933,107,2014-01-13,ORL,DAL
14,Home,W 88-83 ,240,29,84,.345,25,67,.373,4,17,.235,26,36,.722,88,30,78,.385,19,54,.352,11,24,.458,12,25,.480,83,2014-01-15,BOS,TOR
15,@,W 88-87 ,240,36,78,.462,32,71,.451,4,7,.571,12,16,.750,88,32,79,.405,18,45,.400,14,34,.412,9,14,.643,87,2014-01-24,MEM,HOU
16,@,L 88-103 ,240,28,83,.337,22,62,.355,6,21,.286,26,33,.788,88,38,91,.418,28,66,.424,10,25,.400,17,21,.810,103,2014-01-26,POR,GSW
17,@,W 88-85 ,240,34,90,.378,24,68,.353,10,22,.455,10,15,.667,88,30,80,.375,23,57,.404,7,23,.304,18,23,.783,85,2014-01-28,WAS,GSW
18,@,L 88-114 ,240,32,82,.390,26,60,.433,6,22,.273,18,24,.750,88,44,82,.537,34,62,.548,10,20,.500,16,23,.696,114,2014-01-28,BOS,NYK
19,Home,W 88-77 ,240,33,82,.402,29,62,.468,4,20,.200,18,25,.720,88,29,82,.354,27,61,.443,2,21,.095,17,23,.739,77,2014-01-29,MIN,NOP
20,Home,W 88-79 ,240,38,80,.475,34,71,.479,4,9,.444,8,10,.800,88,27,70,.386,24,54,.444,3,16,.188,22,33,.667,79,2014-02-01,NOP,CHI
21,@,L 88-114 ,240,31,79,.392,25,58,.431,6,21,.286,20,26,.769,88,42,74,.568,34,61,.557,8,13,.615,22,26,.846,114,2014-03-03,UTA,MIL
22,Home,L 88-108 ,240,30,76,.395,23,50,.460,7,26,.269,21,26,.808,88,46,98,.469,41,70,.586,5,28,.179,11,12,.917,108,2014-03-05,BOS,GSW
23,@,L 88-95 (OT),265,30,74,.405,23,54,.426,7,20,.350,21,22,.955,88,38,90,.422,31,71,.437,7,19,.368,12,17,.706,95,2014-03-09,MIA,CHI
24,Home,L 88-90 ,240,31,75,.413,27,57,.474,4,18,.222,22,22,1.000,88,32,74,.432,28,56,.500,4,18,.222,22,27,.815,90,2014-03-12,NOP,MEM
25,@,L 88-89 ,240,31,79,.392,24,62,.387,7,17,.412,19,24,.792,88,29,75,.387,18,48,.375,11,27,.407,20,26,.769,89,2014-03-22,ORL,UTA
26,@,L 88-112 ,240,35,87,.402,27,62,.435,8,25,.320,10,16,.625,88,40,88,.455,26,55,.473,14,33,.424,18,23,.783,112,2014-03-28,NYK,PHO
27,@,W 88-67 ,240,32,74,.432,25,51,.490,7,23,.304,17,21,.810,88,27,79,.342,23,65,.354,4,14,.286,9,14,.643,67,2014-03-29,MIA,MIL
28,@,L 88-102 ,240,40,95,.421,36,84,.429,4,11,.364,4,6,.667,88,43,81,.531,38,65,.585,5,16,.313,11,16,.688,102,2014-04-02,MEM,MIN
29,Home,L 88-107 ,240,32,78,.410,27,58,.466,5,20,.250,19,30,.633,88,41,73,.562,29,46,.630,12,27,.444,13,17,.765,107,2014-04-06,IND,ATL
30,@,W 88-87 ,240,36,68,.529,27,45,.600,9,23,.391,7,14,.500,88,33,69,.478,26,45,.578,7,24,.292,14,19,.737,87,2014-04-08,BRK,MIA
31,Home,L 88-94 ,240,34,80,.425,28,66,.424,6,14,.429,14,17,.824,88,39,80,.488,30,61,.492,9,19,.474,7,10,.700,94,2014-04-09,NOP,PHO
32,Home,L 88-94 (OT),265,37,82,.451,36,67,.537,1,15,.067,13,20,.650,88,35,92,.380,24,67,.358,11,25,.440,13,15,.867,94,2014-04-09,WAS,CHA
33,Home,L 88-93 ,240,34,80,.425,28,58,.483,6,22,.273,14,25,.560,88,36,79,.456,35,60,.583,1,19,.053,20,21,.952,93,2014-04-11,BRK,ATL
34,@,L 88-97 ,240,35,74,.473,27,54,.500,8,20,.400,10,14,.714,88,34,73,.466,22,44,.500,12,29,.414,17,23,.739,97,2014-04-13,ORL,BRK
35,@,L 88-100 ,240,34,65,.523,28,44,.636,6,21,.286,14,25,.560,88,32,81,.395,24,50,.480,8,31,.258,28,33,.848,100,2014-11-04,OKC,TOR
36,@,L 88-120 ,240,33,87,.379,23,53,.434,10,34,.294,12,18,.667,88,43,76,.566,36,59,.610,7,17,.412,27,30,.900,120,2014-11-09,PHI,TOR
37,Home,W 88-87 ,240,29,78,.372,22,44,.500,7,34,.206,23,37,.622,88,34,80,.425,27,59,.458,7,21,.333,12,18,.667,87,2014-11-14,HOU,PHI
38,@,L 88-95 ,240,34,82,.415,24,56,.429,10,26,.385,10,17,.588,88,32,86,.372,28,71,.394,4,15,.267,27,33,.818,95,2014-11-15,DET,MEM
39,@,W 88-86 ,240,37,75,.493,33,60,.550,4,15,.267,10,13,.769,88,33,87,.379,26,62,.419,7,25,.280,13,19,.684,86,2014-11-19,PHO,DET
40,Home,W 88-86 ,240,35,78,.449,33,63,.524,2,15,.133,16,24,.667,88,37,86,.430,32,72,.444,5,14,.357,7,12,.583,86,2014-11-19,IND,CHO
41,@,L 88-103 ,240,36,84,.429,31,65,.477,5,19,.263,11,16,.688,88,38,74,.514,34,68,.500,4,6,.667,23,27,.852,103,2014-11-20,CHI,SAC
42,@,L 88-101 ,240,35,82,.427,29,65,.446,6,17,.353,12,19,.632,88,41,82,.500,35,59,.593,6,23,.261,13,19,.684,101,2014-11-21,UTA,GSW
43,Home,L 88-94 ,240,37,95,.389,32,72,.444,5,23,.217,9,12,.750,88,37,86,.430,30,67,.448,7,19,.368,13,15,.867,94,2014-11-23,BOS,POR
44,Home,L 88-104 ,240,34,83,.410,28,60,.467,6,23,.261,14,25,.560,88,39,77,.506,26,48,.542,13,29,.448,13,16,.813,104,2014-11-28,DET,MIL
45,Home,W 88-82 ,240,33,83,.398,29,62,.468,4,21,.190,18,23,.783,88,36,91,.396,31,73,.425,5,18,.278,5,8,.625,82,2014-12-04,POR,IND
46,Home,L 88-110 ,240,36,81,.444,32,62,.516,4,19,.211,12,19,.632,88,43,90,.478,34,65,.523,9,25,.360,15,22,.682,110,2014-12-08,BRK,CLE
47,Home,W 88-70 ,240,36,81,.444,31,61,.508,5,20,.250,11,17,.647,88,22,69,.319,11,41,.268,11,28,.393,15,20,.750,70,2014-12-12,BRK,PHI
48,@,L 88-112 ,240,34,99,.343,27,68,.397,7,31,.226,13,18,.722,88,39,80,.488,35,62,.565,4,18,.222,30,34,.882,112,2014-12-14,PHO,OKC
49,@,L 88-97 ,240,38,83,.458,33,67,.493,5,16,.313,7,14,.500,88,38,83,.458,29,59,.492,9,24,.375,12,17,.706,97,2014-12-15,CHO,CLE
50,Home,L 88-114 ,240,30,85,.353,27,70,.386,3,15,.200,25,28,.893,88,48,90,.533,39,65,.600,9,25,.360,9,15,.600,114,2014-12-20,NOP,POR
51,Home,L 88-96 ,240,35,84,.417,28,61,.459,7,23,.304,11,20,.550,88,35,82,.427,29,59,.492,6,23,.261,20,25,.800,96,2014-12-21,ORL,PHI
52,Home,W 88-71 ,240,30,84,.357,26,61,.426,4,23,.174,24,28,.857,88,24,74,.324,19,48,.396,5,26,.192,18,28,.643,71,2014-12-27,UTA,PHI
53,@,L 88-101 ,240,32,79,.405,26,55,.473,6,24,.250,18,24,.750,88,45,90,.500,40,77,.519,5,13,.385,6,10,.600,101,2014-12-27,BOS,WAS
54,Home,W 88-87 ,240,27,71,.380,21,53,.396,6,18,.333,28,30,.933,88,33,90,.367,25,62,.403,8,28,.286,13,18,.722,87,2015-01-04,LAL,IND
55,Home,W 88-84 ,240,31,67,.463,26,53,.491,5,14,.357,21,28,.750,88,34,86,.395,27,62,.435,7,24,.292,9,13,.692,84,2015-01-04,MIA,BRK
56,Home,L 88-96 (OT),265,33,84,.393,30,59,.508,3,25,.120,19,23,.826,88,37,94,.394,27,67,.403,10,27,.370,12,19,.632,96,2015-01-05,BRK,DAL
57,Home,L 88-90 ,240,33,73,.452,30,57,.526,3,16,.188,19,27,.704,88,36,79,.456,28,62,.452,8,17,.471,10,17,.588,90,2015-01-09,BRK,PHI
58,@,L 88-95 ,240,33,89,.371,24,58,.414,9,31,.290,13,18,.722,88,37,82,.451,29,61,.475,8,21,.381,13,14,.929,95,2015-01-31,POR,MIL
59,Home,L 88-92 ,240,33,81,.407,27,66,.409,6,15,.400,16,19,.842,88,37,79,.468,33,64,.516,4,15,.267,14,19,.737,92,2015-02-02,WAS,CHO
60,@,L 88-92 ,240,34,89,.382,28,65,.431,6,24,.250,14,17,.824,88,37,74,.500,34,63,.540,3,11,.273,15,22,.682,92,2015-02-06,NYK,BRK
61,@,L 88-98 ,240,33,85,.388,28,63,.444,5,22,.227,17,22,.773,88,37,82,.451,33,58,.569,4,24,.167,20,26,.769,98,2015-02-06,DEN,DET
62,@,L 88-94 ,240,33,80,.413,21,50,.420,12,30,.400,10,11,.909,88,36,92,.391,33,79,.418,3,13,.231,19,21,.905,94,2015-02-08,ATL,MEM
63,@,L 88-89 ,240,33,78,.423,26,49,.531,7,29,.241,15,23,.652,88,30,93,.323,20,62,.323,10,31,.323,19,20,.950,89,2015-02-11,ATL,BOS
64,@,L 88-104 ,240,31,75,.413,20,50,.400,11,25,.440,15,19,.789,88,44,82,.537,39,67,.582,5,15,.333,11,16,.688,104,2015-02-25,PHI,MIL
65,@,L 88-95 ,240,36,80,.450,27,54,.500,9,26,.346,7,13,.538,88,36,81,.444,22,50,.440,14,31,.452,9,12,.750,95,2015-02-27,ORL,ATL
66,Home,W 88-85 ,240,37,90,.411,35,78,.449,2,12,.167,12,16,.750,88,38,93,.409,36,79,.456,2,14,.143,7,9,.778,85,2015-03-04,NOP,DET
67,Home,L 88-95 ,240,38,76,.500,30,61,.492,8,15,.533,4,11,.364,88,34,72,.472,24,50,.480,10,22,.455,17,21,.810,95,2015-03-08,BRK,UTA
68,@,L 88-95 ,240,34,80,.425,28,60,.467,6,20,.300,14,28,.500,88,37,86,.430,27,60,.450,10,26,.385,11,20,.550,95,2015-03-13,ORL,BOS
69,Home,W 88-85 ,240,33,69,.478,27,55,.491,6,14,.429,16,24,.667,88,32,84,.381,24,61,.393,8,23,.348,13,22,.591,85,2015-03-14,UTA,DET
70,@,W 88-84 ,240,33,63,.524,27,52,.519,6,11,.545,16,23,.696,88,34,82,.415,30,60,.500,4,22,.182,12,24,.500,84,2015-03-18,WAS,UTA
71,@,L 88-89 ,240,33,75,.440,25,56,.446,8,19,.421,14,18,.778,88,36,87,.414,32,70,.457,4,17,.235,13,17,.765,89,2015-03-24,MIA,MIL
72,Home,L 88-91 ,240,36,91,.396,33,79,.418,3,12,.250,13,20,.650,88,39,91,.429,36,77,.468,3,14,.214,10,11,.909,91,2015-03-25,CHO,BRK
73,@,L 88-102 ,240,35,79,.443,28,64,.438,7,15,.467,11,18,.611,88,43,84,.512,34,64,.531,9,20,.450,7,12,.583,102,2015-03-27,SAC,NOP
74,@,L 88-110 ,240,32,75,.427,30,63,.476,2,12,.167,22,24,.917,88,43,75,.573,37,62,.597,6,13,.462,18,24,.750,110,2015-03-29,MIN,NOP
75,@,L 88-101 ,240,34,75,.453,30,58,.517,4,17,.235,16,23,.696,88,36,79,.456,27,50,.540,9,29,.310,20,24,.833,101,2015-03-30,MIL,ATL
76,@,L 88-114 ,240,32,75,.427,25,54,.463,7,21,.333,17,21,.810,88,40,80,.500,25,45,.556,15,35,.429,19,25,.760,114,2015-04-02,MIA,CLE
77,Home,W 88-82 ,240,33,85,.388,29,68,.426,4,17,.235,18,21,.857,88,32,74,.432,26,55,.473,6,19,.316,12,15,.800,82,2015-04-03,CHI,DET
78,Home,L 88-113 ,240,34,84,.405,29,65,.446,5,19,.263,15,28,.536,88,47,89,.528,37,65,.569,10,24,.417,9,13,.692,113,2015-04-07,OKC,SAS
79,Home,L 88-89 ,240,31,71,.437,20,48,.417,11,23,.478,15,22,.682,88,36,76,.474,31,61,.508,5,15,.333,12,19,.632,89,2015-04-10,UTA,MEM
80,Home,L 88-100 ,240,31,78,.397,27,64,.422,4,14,.286,22,28,.786,88,37,84,.440,31,63,.492,6,21,.286,20,24,.833,100,2015-04-13,MIN,NOP
81,@,L 88-101 ,240,38,79,.481,31,59,.525,7,20,.350,5,13,.385,88,39,80,.488,30,56,.536,9,24,.375,14,23,.609,101,2015-04-15,ORL,BRK
82,@,W 88-87 ,240,33,84,.393,26,56,.464,7,28,.250,15,25,.600,88,37,100,.370,32,74,.432,5,26,.192,8,12,.667,87,2015-10-28,WAS,ORL
83,@,L 88-104 ,240,35,97,.361,29,67,.433,6,30,.200,12,15,.800,88,38,87,.437,30,56,.536,8,31,.258,20,33,.606,104,2015-10-29,DAL,LAC
84,Home,L 88-111 ,240,35,100,.350,30,75,.400,5,25,.200,13,23,.565,88,41,96,.427,31,71,.437,10,25,.400,19,23,.826,111,2015-11-09,PHI,CHI
85,Home,L 88-106 ,240,34,84,.405,27,65,.415,7,19,.368,13,19,.684,88,46,87,.529,40,64,.625,6,23,.261,8,11,.727,106,2015-11-09,SAC,SAS
86,@,L 88-101 ,240,34,77,.442,23,55,.418,11,22,.500,9,12,.750,88,38,84,.452,33,64,.516,5,20,.250,20,27,.741,101,2015-11-10,LAL,MIA
87,@,L 88-90 ,240,33,76,.434,21,47,.447,12,29,.414,10,14,.714,88,37,84,.440,28,64,.438,9,20,.450,7,13,.538,90,2015-11-17,ATL,BRK
88,@,L 88-113 ,240,32,79,.405,24,53,.453,8,26,.308,16,22,.727,88,40,81,.494,28,56,.500,12,25,.480,21,22,.955,113,2015-11-20,PHI,CHO
89,@,L 88-109 ,240,31,91,.341,25,63,.397,6,28,.214,20,24,.833,88,43,83,.518,34,70,.486,9,13,.692,14,17,.824,109,2015-11-23,DET,MIL
90,Home,L 88-93 ,240,31,88,.352,25,66,.379,6,22,.273,20,27,.741,88,33,86,.384,26,68,.382,7,18,.389,20,23,.870,93,2015-11-24,POR,CHI
91,Home,W 88-83 ,240,33,81,.407,25,53,.472,8,28,.286,14,19,.737,88,34,83,.410,28,61,.459,6,22,.273,9,12,.750,83,2015-11-25,SAS,DAL
92,@,L 88-90 ,240,33,81,.407,29,64,.453,4,17,.235,18,24,.750,88,35,87,.402,26,60,.433,9,27,.333,11,17,.647,90,2015-11-28,BRK,CLE
93,@,L 88-108 ,240,37,87,.425,31,61,.508,6,26,.231,8,13,.615,88,40,85,.471,31,68,.456,9,17,.529,19,20,.950,108,2015-11-28,ATL,SAS
94,@,L 88-90 ,240,33,85,.388,25,52,.481,8,33,.242,14,18,.778,88,30,73,.411,26,60,.433,4,13,.308,26,33,.788,90,2015-12-07,POR,MIL
95,Home,L 88-125 ,240,33,81,.407,30,67,.448,3,14,.214,19,22,.864,88,47,84,.560,34,58,.586,13,26,.500,18,23,.783,125,2015-12-08,MEM,OKC
96,Home,L 88-100 ,240,33,84,.393,25,51,.490,8,33,.242,14,15,.933,88,40,89,.449,33,73,.452,7,16,.438,13,15,.867,100,2015-12-14,ATL,MIA
97,@,L 88-97 ,240,30,80,.375,24,63,.381,6,17,.353,22,24,.917,88,34,78,.436,24,49,.490,10,29,.345,19,21,.905,97,2015-12-18,MEM,DAL
98,@,L 88-104 ,240,26,71,.366,22,49,.449,4,22,.182,32,38,.842,88,44,84,.524,38,68,.559,6,16,.375,10,17,.588,104,2015-12-18,NOP,PHO
99,@,L 88-97 ,240,31,79,.392,25,51,.490,6,28,.214,20,25,.800,88,34,73,.466,24,48,.500,10,25,.400,19,25,.760,97,2015-12-18,DEN,UTA
0,Home,W 88-84 ,240,32,74,.432,25,59,.424,7,15,.467,17,26,.654,88,36,88,.409,31,68,.456,5,20,.250,7,8,.875,84,2015-12-25,HOU,SAS
1,@,L 88-94 (OT),265,36,90,.400,30,70,.429,6,20,.300,10,11,.909,88,35,88,.398,29,62,.468,6,26,.231,18,27,.667,94,2015-12-25,NOP,MIA
2,Home,L 88-102 ,240,35,75,.467,31,63,.492,4,12,.333,14,18,.778,88,40,80,.500,31,54,.574,9,26,.346,13,14,.929,102,2015-12-26,MIN,IND
3,Home,L 88-109 ,240,29,91,.319,24,70,.343,5,21,.238,25,30,.833,88,40,86,.465,27,55,.491,13,31,.419,16,21,.762,109,2016-01-05,LAL,GSW
4,Home,L 88-97 ,240,33,84,.393,25,59,.424,8,25,.320,14,15,.933,88,34,75,.453,29,61,.475,5,14,.357,24,26,.923,97,2016-01-08,WAS,TOR
5,@,L 88-100 ,240,32,80,.400,29,67,.433,3,13,.231,21,30,.700,88,39,84,.464,32,60,.533,7,24,.292,15,18,.833,100,2016-01-10,MIL,NYK
6,@,L 88-91 ,240,35,84,.417,27,51,.529,8,33,.242,10,15,.667,88,33,92,.359,26,68,.382,7,24,.292,18,24,.750,91,2016-01-21,ATL,SAC
7,Home,L 88-116 ,240,33,85,.388,29,67,.433,4,18,.222,18,20,.900,88,43,76,.566,30,53,.566,13,23,.565,17,24,.708,116,2016-01-22,NYK,LAC
8,Home,L 88-96 ,240,34,79,.430,26,53,.491,8,26,.308,12,13,.923,88,37,80,.463,29,55,.527,8,25,.320,14,21,.667,96,2016-02-22,CLE,DET
9,@,L 88-103 ,240,32,88,.364,27,68,.397,5,20,.250,19,22,.864,88,37,89,.416,30,55,.545,7,34,.206,22,24,.917,103,2016-02-26,CHI,ATL
10,@,L 88-94 ,240,32,75,.427,27,56,.482,5,19,.263,19,29,.655,88,37,81,.457,33,63,.524,4,18,.222,16,19,.842,94,2016-03-04,UTA,MEM
11,@,W 88-80 ,240,35,88,.398,28,63,.444,7,25,.280,11,14,.786,88,32,91,.352,28,72,.389,4,19,.211,12,15,.800,80,2016-03-20,SAC,NYK
12,@,L 88-91 ,240,37,86,.430,33,69,.478,4,17,.235,10,13,.769,88,35,87,.402,27,68,.397,8,19,.421,13,19,.684,91,2016-03-21,SAS,CHO
13,@,L 88-112 ,240,37,77,.481,30,63,.476,7,14,.500,7,12,.583,88,42,81,.519,34,67,.507,8,14,.571,20,24,.833,112,2016-03-23,MIA,SAS
14,Home,L 88-101 ,240,33,87,.379,26,59,.441,7,28,.250,15,17,.882,88,39,72,.542,32,54,.593,7,18,.389,16,29,.552,101,2016-03-27,LAL,WAS
15,Home,L 88-97 ,240,31,70,.443,22,46,.478,9,24,.375,17,19,.895,88,36,88,.409,25,56,.446,11,32,.344,14,15,.933,97,2016-03-28,DEN,DAL
16,Home,W 88-82 ,240,33,87,.379,29,68,.426,4,19,.211,18,20,.900,88,31,82,.378,25,61,.410,6,21,.286,14,22,.636,82,2016-03-29,DET,OKC
17,@,W 88-78 ,240,32,83,.386,18,43,.419,14,40,.350,10,17,.588,88,29,71,.408,25,50,.500,4,21,.190,16,18,.889,78,2016-04-03,DAL,MIN
18,@,W 88-86 ,240,32,72,.444,25,55,.455,7,17,.412,17,19,.895,88,32,68,.471,27,51,.529,5,17,.294,17,21,.810,86,2016-04-05,SAS,UTA
19,Home,W 88-86 ,240,33,80,.413,23,47,.489,10,33,.303,12,14,.857,88,34,78,.436,28,58,.483,6,20,.300,12,18,.667,86,2016-04-06,DAL,HOU
20,@,L 88-98 ,240,38,88,.432,36,69,.522,2,19,.105,10,12,.833,88,37,86,.430,32,72,.444,5,14,.357,19,22,.864,98,2016-04-13,MIA,BOS
21,@,L 88-117 ,240,32,87,.368,23,60,.383,9,27,.333,15,20,.750,88,45,94,.479,32,59,.542,13,35,.371,14,19,.737,117,2016-10-25,NYK,CLE
22,Home,W 88-75 ,240,34,83,.410,28,56,.500,6,27,.222,14,20,.700,88,29,73,.397,22,54,.407,7,19,.368,10,13,.769,75,2016-10-30,LAC,UTA
23,Home,L 88-118 ,240,33,96,.344,28,65,.431,5,31,.161,17,21,.810,88,45,89,.506,34,62,.548,11,27,.407,17,18,.944,118,2016-10-31,BRK,CHI
24,Home,L 88-99 ,240,31,84,.369,22,58,.379,9,26,.346,17,22,.773,88,32,85,.376,24,58,.414,8,27,.296,27,33,.818,99,2016-11-04,MEM,LAC
25,Home,W 88-86 ,240,31,78,.397,22,50,.440,9,28,.321,17,27,.630,88,34,86,.395,28,69,.406,6,17,.353,12,17,.706,86,2016-11-05,ORL,WAS
26,@,L 88-104 ,240,33,88,.375,28,61,.459,5,27,.185,17,22,.773,88,43,92,.467,38,76,.500,5,16,.313,13,16,.813,104,2016-11-14,OKC,DET
27,@,L 88-115 ,240,34,90,.378,29,68,.426,5,22,.227,15,17,.882,88,44,91,.484,27,51,.529,17,40,.425,10,17,.588,115,2016-11-14,PHI,HOU
28,Home,W 88-69 ,240,35,90,.389,27,65,.415,8,25,.320,10,10,1.000,88,27,84,.321,22,59,.373,5,25,.200,10,13,.769,69,2016-11-14,IND,ORL
29,Home,L 88-113 ,240,34,95,.358,25,61,.410,9,34,.265,11,18,.611,88,41,98,.418,34,78,.436,7,20,.350,24,28,.857,113,2016-11-15,POR,CHI
30,Home,L 88-104 ,240,31,83,.373,20,51,.392,11,32,.344,15,19,.789,88,44,90,.489,35,62,.565,9,28,.321,7,12,.583,104,2016-11-18,BOS,GSW
31,@,L 88-106 ,240,37,82,.451,36,63,.571,1,19,.053,13,17,.765,88,42,83,.506,34,60,.567,8,23,.348,14,26,.538,106,2016-11-26,DET,OKC
32,@,L 88-105 ,240,37,87,.425,32,57,.561,5,30,.167,9,18,.500,88,38,88,.432,30,57,.526,8,31,.258,21,25,.840,105,2016-11-29,LAL,NOP
33,Home,L 88-105 ,240,36,95,.379,27,63,.429,9,32,.281,7,10,.700,88,37,78,.474,24,52,.462,13,26,.500,18,26,.692,105,2016-12-02,PHI,ORL
34,Home,W 88-86 ,240,31,87,.356,25,67,.373,6,20,.300,20,30,.667,88,25,82,.305,18,54,.333,7,28,.250,29,40,.725,86,2016-12-08,MEM,POR
35,Home,L 88-99 ,240,33,84,.393,26,59,.441,7,25,.280,15,22,.682,88,39,91,.429,27,51,.529,12,40,.300,9,13,.692,99,2016-12-08,NOP,PHI
36,@,L 88-109 ,240,34,91,.374,25,57,.439,9,34,.265,11,14,.786,88,41,85,.482,32,63,.508,9,22,.409,18,23,.783,109,2016-12-09,ORL,CHO
37,@,L 88-96 ,240,32,98,.327,24,68,.353,8,30,.267,16,19,.842,88,34,78,.436,25,50,.500,9,28,.321,19,26,.731,96,2016-12-16,CHO,BOS
38,Home,L 88-90 ,240,34,74,.459,21,45,.467,13,29,.448,7,11,.636,88,37,87,.425,30,58,.517,7,29,.241,9,15,.600,90,2016-12-23,LAC,DAL
39,@,L 88-114 ,240,31,75,.413,23,45,.511,8,30,.267,18,21,.857,88,37,78,.474,27,49,.551,10,29,.345,30,35,.857,114,2016-12-31,LAC,OKC
40,Home,W 88-79 ,240,34,78,.436,25,54,.463,9,24,.375,11,14,.786,88,28,72,.389,19,49,.388,9,23,.391,14,23,.609,79,2017-01-08,MEM,UTA
41,@,L 88-96 ,240,36,84,.429,32,70,.457,4,14,.286,12,13,.923,88,33,81,.407,27,55,.491,6,26,.231,24,28,.857,96,2017-01-26,LAL,UTA
42,Home,L 88-100 ,240,33,79,.418,30,66,.455,3,13,.231,19,25,.760,88,41,89,.461,32,65,.492,9,24,.375,9,11,.818,100,2017-01-27,CHI,MIA
43,Home,L 88-98 ,240,31,77,.403,25,53,.472,6,24,.250,20,28,.714,88,33,69,.478,24,49,.490,9,20,.450,23,26,.885,98,2017-02-01,ORL,IND
44,@,L 88-104 ,240,32,73,.438,23,50,.460,9,23,.391,15,25,.600,88,36,78,.462,25,49,.510,11,29,.379,21,27,.778,104,2017-02-01,MIL,UTA
45,Home,L 88-106 ,240,33,71,.465,27,56,.482,6,15,.400,16,28,.571,88,41,86,.477,30,53,.566,11,33,.333,13,18,.722,106,2017-02-08,MIL,MIA
46,@,W 88-72 ,240,36,81,.444,27,56,.482,9,25,.360,7,11,.636,88,28,87,.322,24,64,.375,4,23,.174,12,18,.667,72,2017-02-13,LAC,UTA
47,@,L 88-111 ,240,32,79,.405,23,57,.404,9,22,.409,15,20,.750,88,42,81,.519,31,59,.525,11,22,.500,16,23,.696,111,2017-02-15,POR,UTA
48,Home,L 88-102 ,240,36,82,.439,30,65,.462,6,17,.353,10,15,.667,88,40,95,.421,32,72,.444,8,23,.348,14,20,.700,102,2017-02-27,SAC,MIN
49,@,L 88-100 ,240,37,81,.457,25,51,.490,12,30,.400,2,3,.667,88,35,86,.407,24,55,.436,11,31,.355,19,21,.905,100,2017-03-06,IND,CHO
50,Home,W 88-83 ,240,33,81,.407,23,54,.426,10,27,.370,12,15,.800,88,30,84,.357,20,51,.392,10,33,.303,13,18,.722,83,2017-03-06,UTA,NOP
51,Home,L 87-88 ,240,36,76,.474,32,60,.533,4,16,.250,11,20,.550,87,36,89,.404,29,74,.392,7,15,.467,9,14,.643,88,2011-12-25,LAL,CHI
52,@,L 87-100 ,240,31,77,.403,26,58,.448,5,19,.263,20,26,.769,87,39,80,.488,34,64,.531,5,16,.313,17,20,.850,100,2012-01-02,OKC,DAL
53,@,W 87-74 ,240,32,80,.400,24,66,.364,8,14,.571,15,18,.833,87,26,66,.394,21,52,.404,5,14,.357,17,24,.708,74,2012-01-06,IND,BOS
54,Home,L 87-98 ,240,31,79,.392,27,59,.458,4,20,.200,21,31,.677,87,37,80,.463,29,63,.460,8,17,.471,16,22,.727,98,2012-01-06,MIN,CLE
55,Home,L 87-88 ,240,29,70,.414,22,51,.431,7,19,.368,22,24,.917,87,32,81,.395,28,65,.431,4,16,.250,20,28,.714,88,2012-01-07,GSW,UTA
56,@,L 87-91 ,240,34,82,.415,27,63,.429,7,19,.368,12,15,.800,87,30,79,.380,29,69,.420,1,10,.100,30,40,.750,91,2012-01-09,CHA,NYK
57,@,L 87-97 ,240,27,80,.338,20,56,.357,7,24,.292,26,33,.788,87,34,77,.442,31,58,.534,3,19,.158,26,28,.929,97,2012-01-09,MIN,TOR
58,Home,L 87-90 (OT),265,36,93,.387,32,79,.405,4,14,.286,11,16,.688,87,35,82,.427,31,73,.425,4,9,.444,16,19,.842,90,2012-01-11,UTA,LAL
59,@,W 87-80 ,240,24,70,.343,18,45,.400,6,25,.240,33,38,.868,87,34,90,.378,30,74,.405,4,16,.250,8,16,.500,80,2012-01-13,MIN,NOH
60,Home,L 87-93 ,240,34,70,.486,29,58,.500,5,12,.417,14,16,.875,87,36,73,.493,30,59,.508,6,14,.429,15,17,.882,93,2012-01-18,NOH,MEM
61,@,L 87-98 ,240,34,81,.420,28,61,.459,6,20,.300,13,16,.813,87,38,85,.447,29,67,.433,9,18,.500,13,18,.722,98,2012-01-19,LAL,MIA
62,@,L 87-97 ,240,37,79,.468,32,65,.492,5,14,.357,8,15,.533,87,38,86,.442,31,59,.525,7,27,.259,14,15,.933,97,2012-01-22,CHA,NJN
63,Home,W 87-56 ,240,33,78,.423,31,65,.477,2,13,.154,19,19,1.000,87,16,65,.246,12,49,.245,4,16,.250,20,30,.667,56,2012-01-23,BOS,ORL
64,@,L 87-93 ,240,31,83,.373,25,63,.397,6,20,.300,19,22,.864,87,33,81,.407,25,56,.446,8,25,.320,19,29,.655,93,2012-01-23,PHO,DAL
65,@,L 87-94 ,240,28,80,.350,27,61,.443,1,19,.053,30,31,.968,87,38,83,.458,32,69,.464,6,14,.429,12,14,.857,94,2012-01-27,IND,BOS
66,Home,W 87-79 ,240,36,82,.439,34,73,.466,2,9,.222,13,18,.722,87,31,75,.413,24,59,.407,7,16,.438,10,11,.909,79,2012-01-27,MIN,SAS
67,Home,L 87-88 ,240,36,69,.522,31,58,.534,5,11,.455,10,14,.714,87,34,79,.430,31,66,.470,3,13,.231,17,20,.850,88,2012-01-29,BOS,CLE
68,Home,L 87-98 ,240,35,83,.422,29,67,.433,6,16,.375,11,13,.846,87,37,87,.425,25,62,.403,12,25,.480,12,16,.750,98,2012-02-03,DAL,IND
69,Home,L 87-98 ,240,32,74,.432,27,59,.458,5,15,.333,18,27,.667,87,44,88,.500,40,79,.506,4,9,.444,6,9,.667,98,2012-02-04,ATL,PHI
70,@,L 87-89 ,240,34,72,.472,30,60,.500,4,12,.333,15,18,.833,87,35,78,.449,33,68,.485,2,10,.200,17,23,.739,89,2012-02-04,NOH,DET
71,@,L 87-96 ,240,29,75,.387,25,61,.410,4,14,.286,25,30,.833,87,39,87,.448,35,75,.467,4,12,.333,14,20,.700,96,2012-02-04,LAL,UTA
72,Home,L 87-108 ,240,32,79,.405,29,62,.468,3,17,.176,20,26,.769,87,40,72,.556,31,57,.544,9,15,.600,19,23,.826,108,2012-02-06,NJN,CHI
73,@,L 87-97 ,240,33,75,.440,28,61,.459,5,14,.357,16,23,.696,87,35,76,.461,26,55,.473,9,21,.429,18,24,.750,97,2012-02-08,IND,ATL
74,Home,L 87-88 (OT),265,38,97,.392,32,78,.410,6,19,.316,5,5,1.000,87,36,91,.396,35,76,.461,1,15,.067,15,20,.750,88,2012-02-09,BOS,LAL
75,Home,L 87-89 (OT),265,35,83,.422,26,59,.441,9,24,.375,8,14,.571,87,36,82,.439,30,65,.462,6,17,.353,11,18,.611,89,2012-02-10,ORL,ATL
76,Home,L 87-101 ,240,38,80,.475,35,71,.493,3,9,.333,8,13,.615,87,35,74,.473,31,54,.574,4,20,.200,27,32,.844,101,2012-02-10,UTA,OKC
77,Home,L 87-107 ,240,35,90,.389,24,63,.381,11,27,.407,6,7,.857,87,38,83,.458,33,71,.465,5,12,.417,26,31,.839,107,2012-02-12,ATL,MIA
78,Home,L 87-90 ,240,37,73,.507,33,58,.569,4,15,.267,9,15,.600,87,33,80,.413,27,63,.429,6,17,.353,18,27,.667,90,2012-02-14,TOR,NYK
79,@,L 87-98 ,240,32,87,.368,27,71,.380,5,16,.313,18,27,.667,87,36,77,.468,26,50,.520,10,27,.370,16,23,.696,98,2012-02-15,IND,CLE
80,@,L 87-103 ,240,36,85,.424,30,67,.448,6,18,.333,9,12,.750,87,40,75,.533,25,50,.500,15,25,.600,8,13,.615,103,2012-02-15,PHI,ORL
81,Home,L 87-111 ,240,30,76,.395,24,60,.400,6,16,.375,21,31,.677,87,40,79,.506,26,58,.448,14,21,.667,17,20,.850,111,2012-02-17,CLE,MIA
82,@,L 87-110 ,240,31,89,.348,24,66,.364,7,23,.304,18,21,.857,87,39,74,.527,29,50,.580,10,24,.417,22,27,.815,110,2012-02-17,GSW,OKC
83,@,L 87-93 ,240,33,82,.402,33,73,.452,0,9,.000,21,27,.778,87,36,78,.462,31,60,.517,5,18,.278,16,20,.800,93,2012-02-22,PHI,HOU
84,@,L 87-111 ,240,28,75,.373,18,52,.346,10,23,.435,21,26,.808,87,40,74,.541,30,49,.612,10,25,.400,21,25,.840,111,2012-03-10,DAL,GSW
85,@,L 87-107 ,240,33,81,.407,29,69,.420,4,12,.333,17,19,.895,87,45,84,.536,39,75,.520,6,9,.667,11,17,.647,107,2012-03-14,CHA,HOU
86,Home,L 87-91 ,240,39,85,.459,35,69,.507,4,16,.250,5,12,.417,87,32,78,.410,23,54,.426,9,24,.375,18,23,.783,91,2012-03-15,LAC,PHO
87,Home,L 87-103 ,240,33,84,.393,28,64,.438,5,20,.250,16,20,.800,87,43,85,.506,35,67,.522,8,18,.444,9,12,.750,103,2012-03-18,CLE,ATL
88,Home,W 87-83 (OT),265,35,87,.402,31,67,.463,4,20,.200,13,19,.684,87,31,81,.383,29,65,.446,2,16,.125,19,23,.826,83,2012-03-18,LAC,DET
89,@,L 87-106 ,240,33,69,.478,31,56,.554,2,13,.154,19,22,.864,87,39,81,.481,34,65,.523,5,16,.313,23,33,.697,106,2012-03-20,TOR,NYK
90,Home,L 87-116 ,240,29,82,.354,22,58,.379,7,24,.292,22,26,.846,87,48,83,.578,37,62,.597,11,21,.524,9,13,.692,116,2012-03-20,POR,MIL
91,@,L 87-104 ,240,31,81,.383,20,55,.364,11,26,.423,14,17,.824,87,43,88,.489,34,63,.540,9,25,.360,9,11,.818,104,2012-03-23,DAL,SAS
92,@,L 87-103 ,240,33,71,.465,26,49,.531,7,22,.318,14,14,1.000,87,39,74,.527,33,63,.524,6,11,.545,19,23,.826,103,2012-03-25,MIA,OKC
93,@,L 87-90 ,240,32,74,.432,25,52,.481,7,22,.318,16,17,.941,87,31,85,.365,21,55,.382,10,30,.333,18,27,.667,90,2012-03-25,GSW,POR
94,@,W 87-75 ,240,35,83,.422,28,68,.412,7,15,.467,10,16,.625,87,30,87,.345,25,70,.357,5,17,.294,10,12,.833,75,2012-03-28,DET,CLE
95,Home,L 87-102 ,240,33,74,.446,23,46,.500,10,28,.357,11,15,.733,87,43,79,.544,36,68,.529,7,11,.636,9,14,.643,102,2012-03-28,GSW,NOH
96,@,L 87-91 ,240,34,85,.400,28,67,.418,6,18,.333,13,15,.867,87,39,81,.481,32,59,.542,7,22,.318,6,6,1.000,91,2012-04-03,NJN,LAL
97,@,L 87-92 ,240,31,77,.403,27,65,.415,4,12,.333,21,30,.700,87,35,76,.461,28,58,.483,7,18,.389,15,22,.682,92,2012-04-03,CHA,TOR
98,@,W 87-86 ,240,36,86,.419,29,58,.500,7,28,.250,8,11,.727,87,38,83,.458,34,73,.466,4,10,.400,6,13,.462,86,2012-04-04,SAS,BOS
99,Home,L 87-104 ,240,30,70,.429,23,56,.411,7,14,.500,20,37,.541,87,42,93,.452,33,71,.465,9,22,.409,11,13,.846,104,2012-04-08,SAC,HOU
0,@,W 87-84 ,240,34,89,.382,30,71,.423,4,18,.222,15,19,.789,87,32,84,.381,28,70,.400,4,14,.286,16,22,.727,84,2012-04-16,WAS,CHI
1,Home,L 87-109 ,240,35,79,.443,31,70,.443,4,9,.444,13,16,.813,87,39,80,.488,33,59,.559,6,21,.286,25,36,.694,109,2012-04-16,TOR,ATL
2,Home,L 87-103 ,240,36,79,.456,31,65,.477,5,14,.357,10,16,.625,87,43,82,.524,34,67,.507,9,15,.600,8,10,.800,103,2012-04-18,CLE,PHI
3,Home,L 87-99 ,240,38,90,.422,34,71,.479,4,19,.211,7,10,.700,87,37,79,.468,33,63,.524,4,16,.250,21,28,.750,99,2012-04-18,GSW,LAL
4,Home,L 87-105 ,240,31,72,.431,27,58,.466,4,14,.286,21,23,.913,87,43,80,.538,38,66,.576,5,14,.357,14,17,.824,105,2012-04-23,NJN,PHI
5,Home,L 87-92 ,240,35,80,.438,29,66,.439,6,14,.429,11,16,.688,87,38,81,.469,32,64,.500,6,17,.353,10,10,1.000,92,2012-04-25,IND,CHI
6,Home,W 87-74 ,240,35,87,.402,27,63,.429,8,24,.333,9,11,.818,87,29,78,.372,27,69,.391,2,9,.222,14,23,.609,74,2012-04-26,BOS,MIL
7,@,L 87-93 ,240,34,84,.405,28,67,.418,6,17,.353,13,16,.813,87,33,79,.418,31,70,.443,2,9,.222,25,33,.758,93,2012-10-31,SAC,CHI
8,@,W 87-85 ,240,33,86,.384,28,69,.406,5,17,.294,16,23,.696,87,32,80,.400,28,59,.475,4,21,.190,17,22,.773,85,2012-10-31,GSW,PHO
9,Home,L 87-93 ,240,31,84,.369,23,51,.451,8,33,.242,17,23,.739,87,37,82,.451,30,64,.469,7,18,.389,12,21,.571,93,2012-11-07,HOU,DEN
10,Home,W 87-80 ,240,34,80,.425,28,67,.418,6,13,.462,13,16,.813,87,33,85,.388,30,72,.417,3,13,.231,11,15,.733,80,2012-11-10,CHI,MIN
11,Home,L 87-95 ,240,30,83,.361,24,60,.400,6,23,.261,21,26,.808,87,35,79,.443,28,61,.459,7,18,.389,18,22,.818,95,2012-11-12,POR,ATL
12,Home,L 87-89 ,240,31,81,.383,26,62,.419,5,19,.263,20,37,.541,87,38,84,.452,34,68,.500,4,16,.250,9,14,.643,89,2012-11-14,MIN,CHA
13,Home,L 87-94 ,240,32,85,.376,28,72,.389,4,13,.308,19,28,.679,87,31,80,.388,29,66,.439,2,14,.143,30,34,.882,94,2012-11-17,CHA,MEM
14,Home,L 87-92 ,240,29,82,.354,23,62,.371,6,20,.300,23,28,.821,87,40,85,.471,39,73,.534,1,12,.083,11,19,.579,92,2012-11-19,SAS,LAC
15,@,L 87-114 ,240,31,77,.403,26,58,.448,5,19,.263,20,26,.769,87,46,77,.597,39,60,.650,7,17,.412,15,18,.833,114,2012-11-21,POR,PHO
16,@,L 87-108 ,240,35,78,.449,30,60,.500,5,18,.278,12,21,.571,87,43,81,.531,31,52,.596,12,29,.414,10,15,.667,108,2012-11-30,WAS,NYK
17,Home,L 87-103 ,240,35,85,.412,28,66,.424,7,19,.368,10,18,.556,87,37,80,.463,24,52,.462,13,28,.464,16,22,.727,103,2012-12-05,NOH,LAL
18,Home,W 87-81 ,240,32,77,.416,31,67,.463,1,10,.100,22,27,.815,87,34,77,.442,33,62,.532,1,15,.067,12,17,.706,81,2012-12-05,UTA,ORL
19,Home,L 87-96 ,240,29,77,.377,25,56,.446,4,21,.190,25,32,.781,87,36,88,.409,28,69,.406,8,19,.421,16,20,.800,96,2012-12-22,WAS,DET
20,@,W 87-84 ,240,33,81,.407,24,50,.480,9,31,.290,12,15,.800,87,32,84,.381,25,56,.446,7,28,.250,13,17,.765,84,2012-12-26,HOU,MIN
21,@,W 87-84 ,240,31,82,.378,21,55,.382,10,27,.370,15,23,.652,87,35,76,.461,31,58,.534,4,18,.222,10,14,.714,84,2012-12-26,CLE,WAS
22,@,L 87-104 ,240,36,87,.414,33,68,.485,3,19,.158,12,16,.750,87,40,86,.465,33,62,.532,7,24,.292,17,28,.607,104,2012-12-28,POR,LAL
23,Home,W 87-77 ,240,34,87,.391,27,71,.380,7,16,.438,12,18,.667,87,31,85,.365,28,75,.373,3,10,.300,12,18,.667,77,2012-12-29,CHI,WAS
24,@,W 87-80 ,240,40,89,.449,39,80,.488,1,9,.111,6,9,.667,87,34,75,.453,30,60,.500,4,15,.267,8,11,.727,80,2013-01-04,UTA,PHO
25,Home,W 87-77 ,240,33,91,.363,24,69,.348,9,22,.409,12,19,.632,87,28,68,.412,20,49,.408,8,19,.421,13,18,.722,77,2013-01-08,IND,MIA
26,Home,W 87-79 ,240,37,81,.457,34,67,.507,3,14,.214,10,12,.833,87,33,84,.393,31,72,.431,2,12,.167,11,18,.611,79,2013-01-09,BOS,PHO
27,Home,L 87-94 ,240,33,71,.465,26,54,.481,7,17,.412,14,20,.700,87,40,88,.455,38,71,.535,2,17,.118,12,16,.750,94,2013-01-09,GSW,MEM
28,Home,L 87-103 ,240,36,91,.396,35,75,.467,1,16,.063,14,19,.737,87,39,90,.433,31,68,.456,8,22,.364,17,25,.680,103,2013-01-11,MIL,DET
29,Home,L 87-90 ,240,34,65,.523,28,49,.571,6,16,.375,13,21,.619,87,36,71,.507,31,61,.508,5,10,.500,13,18,.722,90,2013-01-12,DET,UTA
30,@,L 87-100 ,240,33,82,.402,29,59,.492,4,23,.174,17,22,.773,87,35,81,.432,24,51,.471,11,30,.367,19,25,.760,100,2013-01-13,NOH,NYK
31,@,W 87-83 ,240,32,71,.451,26,48,.542,6,23,.261,17,22,.773,87,31,86,.360,25,65,.385,6,21,.286,15,18,.833,83,2013-01-13,OKC,POR
32,Home,L 87-102 ,240,35,79,.443,29,62,.468,6,17,.353,11,22,.500,87,33,72,.458,22,41,.537,11,31,.355,25,31,.806,102,2013-01-17,DET,NYK
33,@,L 87-94 ,240,32,77,.416,24,57,.421,8,20,.400,15,27,.556,87,34,93,.366,29,72,.403,5,21,.238,21,31,.677,94,2013-01-19,WAS,LAC
34,@,L 87-103 ,240,27,78,.346,23,59,.390,4,19,.211,29,33,.879,87,41,88,.466,32,68,.471,9,20,.450,12,18,.667,103,2013-01-25,GSW,CHI
35,Home,W 87-76 ,240,39,93,.419,37,77,.481,2,16,.125,7,10,.700,87,27,88,.307,25,72,.347,2,16,.125,20,23,.870,76,2013-02-09,PHI,CHA
36,Home,L 87-96 ,240,35,84,.417,31,67,.463,4,17,.235,13,20,.650,87,39,84,.464,34,71,.479,5,13,.385,13,17,.765,96,2013-02-19,NOH,CHI
37,@,L 87-94 ,240,31,81,.383,27,68,.397,4,13,.308,21,32,.656,87,28,70,.400,23,57,.404,5,13,.385,33,44,.750,94,2013-02-20,PHI,MIN
38,Home,L 87-97 ,240,30,81,.370,27,72,.375,3,9,.333,24,33,.727,87,32,72,.444,27,55,.491,5,17,.294,28,35,.800,97,2013-02-24,PHO,SAS
39,@,L 87-92 ,240,31,73,.425,23,50,.460,8,23,.348,17,22,.773,87,36,81,.444,26,59,.441,10,22,.455,10,12,.833,92,2013-03-01,ATL,PHO
40,@,L 87-90 ,240,33,85,.388,27,66,.409,6,19,.316,15,20,.750,87,34,80,.425,28,65,.431,6,15,.400,16,21,.762,90,2013-03-03,PHI,WAS
41,@,W 87-77 ,240,31,75,.413,18,40,.450,13,35,.371,12,15,.800,87,32,74,.432,25,54,.463,7,20,.350,6,10,.600,77,2013-03-06,NYK,DET
42,Home,W 87-83 ,240,27,75,.360,19,52,.365,8,23,.348,25,29,.862,87,33,83,.398,25,59,.424,8,24,.333,9,12,.750,83,2013-03-06,GSW,SAC
43,Home,W 87-82 ,240,31,76,.408,27,62,.435,4,14,.286,21,31,.677,87,29,65,.446,23,46,.500,6,19,.316,18,22,.818,82,2013-03-06,MIN,WAS
44,@,L 87-104 ,240,32,79,.405,27,64,.422,5,15,.333,18,23,.783,87,35,70,.500,25,52,.481,10,18,.556,24,32,.750,104,2013-03-09,CHA,WAS
45,@,L 87-110 ,240,28,80,.350,23,65,.354,5,15,.333,26,33,.788,87,37,69,.536,30,53,.566,7,16,.438,29,33,.879,110,2013-03-13,UTA,OKC
46,Home,W 87-80 ,240,35,77,.455,34,65,.523,1,12,.083,16,22,.727,87,30,85,.353,26,73,.356,4,12,.333,16,19,.842,80,2013-03-15,DEN,MEM
47,@,L 87-96 ,240,35,80,.438,32,61,.525,3,19,.158,14,19,.737,87,36,72,.500,27,52,.519,9,20,.450,15,19,.789,96,2013-03-15,NOH,WAS
48,Home,W 87-86 ,240,31,71,.437,26,55,.473,5,16,.313,20,26,.769,87,33,72,.458,29,58,.500,4,14,.286,16,17,.941,86,2013-03-20,NOH,BOS
49,Home,W 87-84 ,240,35,81,.432,32,70,.457,3,11,.273,14,22,.636,87,30,78,.385,25,64,.391,5,14,.357,19,24,.792,84,2013-03-23,CHI,IND
50,Home,L 87-97 ,240,37,86,.430,33,68,.485,4,18,.222,9,15,.600,87,42,86,.488,35,68,.515,7,18,.389,6,10,.600,97,2013-03-29,CLE,PHI
51,@,L 87-109 ,240,32,79,.405,27,59,.458,5,20,.250,18,36,.500,87,42,74,.568,38,60,.633,4,14,.286,21,31,.677,109,2013-03-29,BRK,DEN
52,Home,W 87-86 ,240,33,82,.402,25,62,.403,8,20,.400,13,14,.929,87,34,80,.425,30,70,.429,4,10,.400,14,17,.824,86,2013-04-05,CHI,ORL
53,@,L 87-106 ,240,33,82,.402,27,62,.435,6,20,.300,15,20,.750,87,40,83,.482,26,58,.448,14,25,.560,12,14,.857,106,2013-04-06,PHI,MIA
54,Home,L 87-89 ,240,29,81,.358,22,56,.393,7,25,.280,22,28,.786,87,32,73,.438,29,66,.439,3,7,.429,22,29,.759,89,2013-04-07,SAC,MEM
55,Home,L 87-91 ,240,34,83,.410,28,70,.400,6,13,.462,13,20,.650,87,37,80,.463,31,64,.484,6,16,.375,11,18,.611,91,2013-04-13,MEM,LAC
56,@,L 87-93 ,240,34,84,.405,26,54,.481,8,30,.267,11,19,.579,87,36,82,.439,30,67,.448,6,15,.400,15,21,.714,93,2013-04-14,BRK,TOR
57,@,L 87-99 ,240,31,84,.369,27,73,.370,4,11,.364,21,28,.750,87,42,82,.512,36,66,.545,6,16,.375,9,11,.818,99,2013-04-17,NOH,DAL
58,@,L 87-97 ,240,36,93,.387,27,74,.365,9,19,.474,6,10,.600,87,34,71,.479,27,54,.500,7,17,.412,22,32,.688,97,2013-10-29,ORL,IND
59,@,L 87-93 ,240,32,66,.485,29,53,.547,3,13,.231,20,29,.690,87,38,86,.442,33,69,.478,5,17,.294,12,23,.522,93,2013-10-30,BOS,TOR
60,Home,W 87-84 ,240,31,83,.373,25,61,.410,6,22,.273,19,24,.792,87,31,85,.365,26,68,.382,5,17,.294,17,27,.630,84,2013-11-01,PHO,UTA
61,@,L 87-98 ,240,30,87,.345,24,61,.393,6,26,.231,21,24,.875,87,39,76,.513,28,49,.571,11,27,.407,9,12,.750,98,2013-11-02,SAC,GSW
62,Home,W 87-77 ,240,34,76,.447,32,63,.508,2,13,.154,17,29,.586,87,31,74,.419,28,58,.483,3,16,.188,12,12,1.000,77,2013-11-03,DET,BOS
63,@,L 87-97 ,240,37,80,.463,36,70,.514,1,10,.100,12,18,.667,87,40,89,.449,33,69,.478,7,20,.350,10,14,.714,97,2013-11-06,UTA,BOS
64,Home,L 87-103 ,240,35,82,.427,29,61,.475,6,21,.286,11,17,.647,87,31,67,.463,23,52,.442,8,15,.533,33,39,.846,103,2013-11-13,MEM,TOR
65,Home,L 87-98 ,240,32,81,.395,25,66,.379,7,15,.467,16,19,.842,87,32,79,.405,20,57,.351,12,22,.545,22,30,.733,98,2013-11-18,UTA,GSW
66,@,L 87-97 ,240,38,98,.388,35,88,.398,3,10,.300,8,14,.571,87,38,84,.452,29,63,.460,9,21,.429,12,22,.545,97,2013-11-21,CHI,DEN
67,Home,L 87-94 ,240,36,93,.387,31,73,.425,5,20,.250,10,12,.833,87,33,72,.458,29,56,.518,4,16,.250,24,31,.774,94,2013-11-23,ATL,BOS
68,@,L 87-88 ,240,29,77,.377,20,53,.377,9,24,.375,20,21,.952,87,31,73,.425,28,58,.483,3,15,.200,23,30,.767,88,2013-11-29,DAL,ATL
69,Home,L 87-111 ,240,30,75,.400,28,59,.475,2,16,.125,25,34,.735,87,43,85,.506,36,67,.537,7,18,.389,18,28,.643,111,2013-12-03,BRK,DEN
70,@,L 87-107 ,240,32,77,.416,26,55,.473,6,22,.273,17,24,.708,87,37,74,.500,27,55,.491,10,19,.526,23,32,.719,107,2013-12-05,MIA,CHI
71,@,L 87-95 ,240,30,80,.375,26,65,.400,4,15,.267,23,28,.821,87,35,78,.449,27,61,.443,8,17,.471,17,24,.708,95,2013-12-17,SAC,CHA
72,Home,L 87-95 ,240,33,79,.418,27,57,.474,6,22,.273,15,23,.652,87,39,82,.476,38,73,.521,1,9,.111,16,19,.842,95,2013-12-21,NYK,MEM
73,@,W 87-78 ,240,30,78,.385,24,54,.444,6,24,.250,21,23,.913,87,33,88,.375,28,64,.438,5,24,.208,7,10,.700,78,2014-01-01,DAL,WAS
74,Home,W 87-81 (OT),265,33,96,.344,29,77,.377,4,19,.211,17,24,.708,87,32,84,.381,25,59,.424,7,25,.280,10,18,.556,81,2014-01-02,CLE,ORL
75,@,L 87-96 ,240,36,76,.474,32,54,.593,4,22,.182,11,14,.786,87,36,81,.444,29,65,.446,7,16,.438,17,17,1.000,96,2014-01-02,MIL,UTA
76,@,L 87-92 ,240,33,82,.402,27,59,.458,6,23,.261,15,19,.789,87,36,82,.439,30,68,.441,6,14,.429,14,23,.609,92,2014-01-07,PHO,CHI
77,@,L 87-97 ,240,35,87,.402,26,60,.433,9,27,.333,8,9,.889,87,34,75,.453,24,52,.462,10,23,.435,19,22,.864,97,2014-01-08,IND,ATL
78,@,L 87-123 ,240,29,84,.345,25,68,.368,4,16,.250,25,28,.893,87,45,92,.489,38,69,.551,7,23,.304,26,35,.743,123,2014-01-10,LAL,LAC
79,@,L 87-90 ,240,33,81,.407,28,60,.467,5,21,.238,16,20,.800,87,32,80,.400,28,66,.424,4,14,.286,22,27,.815,90,2014-01-14,OKC,MEM
80,Home,L 87-97 ,240,32,83,.386,30,72,.417,2,11,.182,21,28,.750,87,37,84,.440,31,62,.500,6,22,.273,17,19,.895,97,2014-01-18,NOP,GSW
81,Home,L 87-98 ,240,33,88,.375,25,69,.362,8,19,.421,13,18,.722,87,37,70,.529,27,49,.551,10,21,.476,14,18,.778,98,2014-01-22,CLE,CHI
82,Home,L 87-88 ,240,32,79,.405,18,45,.400,14,34,.412,9,14,.643,87,36,78,.462,32,71,.451,4,7,.571,12,16,.750,88,2014-01-24,HOU,MEM
83,Home,L 87-89 ,240,37,88,.420,31,69,.449,6,19,.316,7,10,.700,87,31,77,.403,20,54,.370,11,23,.478,16,22,.727,89,2014-01-25,CHA,CHI
84,Home,L 87-112 ,240,38,82,.463,33,61,.541,5,21,.238,6,13,.462,87,40,76,.526,27,50,.540,13,26,.500,19,25,.760,112,2014-01-25,MIL,ATL
85,@,L 87-103 ,240,32,77,.416,24,57,.421,8,20,.400,15,25,.600,87,39,86,.453,33,66,.500,6,20,.300,19,28,.679,103,2014-01-28,ORL,DET
86,@,L 87-102 ,240,29,81,.358,19,51,.373,10,30,.333,19,28,.679,87,38,74,.514,36,62,.581,2,12,.167,24,37,.649,102,2014-02-01,UTA,LAC
87,@,L 87-102 ,240,32,77,.416,28,63,.444,4,14,.286,19,20,.950,87,40,83,.482,29,61,.475,11,22,.500,11,15,.733,102,2014-02-06,CHI,GSW
88,@,L 87-90 ,240,35,83,.422,26,60,.433,9,23,.391,8,11,.727,87,31,80,.388,28,65,.431,3,15,.200,25,36,.694,90,2014-02-21,NOP,CHA
89,@,L 87-109 ,240,31,76,.408,21,53,.396,10,23,.435,15,20,.750,87,43,84,.512,34,66,.515,9,18,.500,14,20,.700,109,2014-03-05,IND,CHA
90,@,L 87-111 ,240,34,79,.430,30,66,.455,4,13,.308,15,18,.833,87,40,79,.506,31,56,.554,9,23,.391,22,26,.846,111,2014-03-06,MIA,SAS
91,@,L 87-99 ,240,30,72,.417,25,53,.472,5,19,.263,22,37,.595,87,34,73,.466,24,52,.462,10,21,.476,21,28,.750,99,2014-03-07,SAC,TOR
92,@,L 87-101 ,240,34,78,.436,25,56,.446,9,22,.409,10,24,.417,87,37,88,.420,29,68,.426,8,20,.400,19,25,.760,101,2014-03-12,DET,TOR
93,@,L 87-111 ,240,28,79,.354,23,53,.434,5,26,.192,26,34,.765,87,43,86,.500,29,62,.468,14,24,.583,11,13,.846,111,2014-03-13,HOU,CHI
94,@,W 87-80 ,240,34,80,.425,29,54,.537,5,26,.192,14,20,.700,87,29,94,.309,26,73,.356,3,21,.143,19,21,.905,80,2014-03-14,PHO,BOS
95,Home,L 87-96 ,240,35,77,.455,28,63,.444,7,14,.500,10,13,.769,87,37,76,.487,28,53,.528,9,23,.391,13,20,.650,96,2014-03-14,UTA,LAC
96,@,L 87-94 ,240,31,85,.365,29,71,.408,2,14,.143,23,37,.622,87,31,78,.397,25,58,.431,6,20,.300,26,33,.788,94,2014-03-15,SAC,CHI
97,Home,L 87-91 ,240,32,69,.464,27,53,.509,5,16,.313,18,26,.692,87,36,79,.456,32,70,.457,4,9,.444,15,16,.938,91,2014-03-26,UTA,MEM
98,Home,L 87-88 ,240,33,69,.478,26,45,.578,7,24,.292,14,19,.737,87,36,68,.529,27,45,.600,9,23,.391,7,14,.500,88,2014-04-08,MIA,BRK
99,Home,L 87-102 ,240,34,80,.425,30,63,.476,4,17,.235,15,16,.938,87,41,82,.500,30,61,.492,11,21,.524,9,12,.750,102,2014-04-09,MIN,CHI
0,Home,L 87-100 ,240,30,73,.411,20,43,.465,10,30,.333,17,22,.773,87,38,74,.514,28,51,.549,10,23,.435,14,16,.875,100,2014-04-16,MIA,PHI
1,@,W 87-81 ,240,37,83,.446,30,62,.484,7,21,.333,6,7,.857,87,31,78,.397,25,54,.463,6,24,.250,13,22,.591,81,2014-11-04,MIL,IND
2,@,L 87-108 ,240,33,90,.367,28,67,.418,5,23,.217,16,16,1.000,87,40,77,.519,28,47,.596,12,30,.400,16,19,.842,108,2014-11-06,DAL,POR
3,Home,L 87-98 ,240,30,86,.349,20,44,.455,10,42,.238,17,21,.810,87,39,87,.448,30,59,.508,9,28,.321,11,17,.647,98,2014-11-08,HOU,GSW
4,@,L 87-88 ,240,34,80,.425,27,59,.458,7,21,.333,12,18,.667,87,29,78,.372,22,44,.500,7,34,.206,23,37,.622,88,2014-11-14,PHI,HOU
5,Home,L 87-108 ,240,34,84,.405,26,62,.419,8,22,.364,11,22,.500,87,43,87,.494,35,64,.547,8,23,.348,14,25,.560,108,2014-11-14,IND,DEN
6,@,L 87-112 ,240,32,84,.381,25,67,.373,7,17,.412,16,28,.571,87,45,87,.517,34,61,.557,11,26,.423,11,14,.786,112,2014-11-15,CHO,GSW
7,@,L 87-97 ,240,35,89,.393,34,70,.486,1,19,.053,16,17,.941,87,33,78,.423,22,52,.423,11,26,.423,20,27,.741,97,2014-11-15,BRK,POR
8,@,L 87-105 ,240,30,83,.361,22,61,.361,8,22,.364,19,28,.679,87,39,79,.494,30,63,.476,9,16,.563,18,22,.818,105,2014-11-21,CHI,POR
9,@,L 87-99 ,240,34,91,.374,25,64,.391,9,27,.333,10,10,1.000,87,41,79,.519,33,58,.569,8,21,.381,9,11,.818,99,2014-11-22,BRK,SAS
10,@,L 87-113 ,240,33,71,.465,28,58,.483,5,13,.385,16,22,.727,87,38,74,.514,32,54,.593,6,20,.300,31,38,.816,113,2014-11-26,WAS,CLE
11,Home,L 87-90 ,240,37,88,.420,29,62,.468,8,26,.308,5,6,.833,87,32,70,.457,27,52,.519,5,18,.278,21,26,.808,90,2014-12-04,NYK,CLE
12,Home,L 87-104 ,240,36,90,.400,31,71,.437,5,19,.263,10,15,.667,87,43,83,.518,35,65,.538,8,18,.444,10,15,.667,104,2014-12-07,LAL,NOP
13,@,L 87-103 ,240,39,80,.488,34,64,.531,5,16,.313,4,8,.500,87,43,73,.589,35,60,.583,8,13,.615,9,11,.818,103,2014-12-07,MIA,MEM
14,@,L 87-96 ,240,38,87,.437,33,64,.516,5,23,.217,6,10,.600,87,35,84,.417,32,70,.457,3,14,.214,23,29,.793,96,2014-12-10,BOS,CHO
15,Home,W 87-81 ,240,29,78,.372,20,49,.408,9,29,.310,20,27,.741,87,30,77,.390,21,51,.412,9,26,.346,12,16,.750,81,2014-12-12,ATL,ORL
16,Home,L 87-114 ,240,31,79,.392,23,57,.404,8,22,.364,17,27,.630,87,42,72,.583,26,49,.531,16,23,.696,14,20,.700,114,2014-12-13,CHO,BRK
17,Home,L 87-105 ,240,33,93,.355,29,65,.446,4,28,.143,17,21,.810,87,38,86,.442,32,61,.525,6,25,.240,23,35,.657,105,2014-12-15,PHI,BOS
18,Home,L 87-107 ,240,37,84,.440,32,63,.508,5,21,.238,8,10,.800,87,42,83,.506,27,50,.540,15,33,.455,8,8,1.000,107,2014-12-16,NYK,DAL
19,Home,L 87-105 ,240,27,70,.386,23,53,.434,4,17,.235,29,40,.725,87,35,66,.530,21,41,.512,14,25,.560,21,24,.875,105,2014-12-17,MIA,UTA
20,Home,L 87-91 ,240,33,80,.413,25,54,.463,8,26,.308,13,18,.722,87,33,77,.429,28,58,.483,5,19,.263,20,27,.741,91,2014-12-23,MIA,PHI
21,@,L 87-114 ,240,33,74,.446,29,62,.468,4,12,.333,17,27,.630,87,43,82,.524,35,67,.522,8,15,.533,20,29,.690,114,2014-12-30,WAS,DAL
22,@,L 87-95 ,240,35,78,.449,30,56,.536,5,22,.227,12,17,.706,87,35,72,.486,28,57,.491,7,15,.467,18,22,.818,95,2014-12-30,SAS,MEM
23,Home,L 87-91 ,240,32,87,.368,26,59,.441,6,28,.214,17,26,.654,87,33,87,.379,29,72,.403,4,15,.267,21,30,.700,91,2015-01-02,CHO,CLE
24,@,L 87-88 ,240,33,90,.367,25,62,.403,8,28,.286,13,18,.722,87,27,71,.380,21,53,.396,6,18,.333,28,30,.933,88,2015-01-04,IND,LAL
25,@,L 87-95 ,240,36,81,.444,33,70,.471,3,11,.273,12,16,.750,87,35,88,.398,31,71,.437,4,17,.235,21,24,.875,95,2015-01-10,MIL,CHI
26,Home,L 87-105 ,240,31,76,.408,22,51,.431,9,25,.360,16,25,.640,87,42,87,.483,30,64,.469,12,23,.522,9,16,.563,105,2015-01-13,PHI,ATL
27,@,L 87-89 ,240,32,78,.410,29,63,.460,3,15,.200,20,23,.870,87,36,75,.480,32,58,.552,4,17,.235,13,15,.867,89,2015-01-23,IND,MIA
28,Home,L 87-99 ,240,34,79,.430,33,66,.500,1,13,.077,18,25,.720,87,35,87,.402,22,43,.512,13,44,.295,16,21,.762,99,2015-01-25,LAL,HOU
29,Home,L 87-93 ,240,32,90,.356,25,66,.379,7,24,.292,16,23,.696,87,35,84,.417,27,54,.500,8,30,.267,15,20,.750,93,2015-01-30,BOS,HOU
30,@,L 87-106 ,240,33,91,.363,24,65,.369,9,26,.346,12,17,.706,87,40,87,.460,28,55,.509,12,32,.375,14,18,.778,106,2015-01-31,PHO,GSW
31,@,L 87-94 ,240,35,84,.417,30,74,.405,5,10,.500,12,17,.706,87,33,76,.434,27,51,.529,6,25,.240,22,27,.815,94,2015-02-05,WAS,CHO
32,@,L 87-108 ,240,34,88,.386,28,65,.431,6,23,.261,13,17,.765,87,40,90,.444,32,59,.542,8,31,.258,20,23,.870,108,2015-02-05,PHO,POR
33,Home,W 87-82 ,240,32,74,.432,28,61,.459,4,13,.308,19,24,.792,87,31,93,.333,24,65,.369,7,28,.250,13,16,.813,82,2015-02-08,TOR,SAS
34,Home,W 87-82 ,240,28,75,.373,18,47,.383,10,28,.357,21,26,.808,87,30,80,.375,19,51,.373,11,29,.379,11,21,.524,82,2015-02-11,DAL,UTA
35,Home,L 87-104 ,240,33,81,.407,24,60,.400,9,21,.429,12,17,.706,87,42,88,.477,32,61,.525,10,27,.370,10,11,.909,104,2015-02-11,DET,SAS
36,Home,L 87-111 ,240,35,82,.427,29,64,.453,6,18,.333,11,16,.688,87,38,79,.481,29,59,.492,9,20,.450,26,35,.743,111,2015-02-20,NYK,MIA
37,Home,W 87-71 ,240,27,76,.355,19,50,.380,8,26,.308,25,32,.781,87,30,89,.337,26,71,.366,4,18,.222,7,13,.538,71,2015-02-23,CHI,MIL
38,Home,L 87-90 ,240,35,79,.443,26,52,.500,9,27,.333,8,12,.667,87,33,81,.407,28,66,.424,5,15,.333,19,26,.731,90,2015-02-23,LAC,MEM
39,@,L 87-104 ,240,34,80,.425,29,49,.592,5,31,.161,14,18,.778,87,39,85,.459,26,50,.520,13,35,.371,13,16,.813,104,2015-02-25,DAL,ATL
40,Home,W 87-82 ,240,30,70,.429,24,52,.462,6,18,.333,21,29,.724,87,31,79,.392,26,66,.394,5,13,.385,15,17,.882,82,2015-03-10,UTA,NYK
41,@,L 87-107 ,240,31,80,.388,28,61,.459,3,19,.158,22,30,.733,87,40,80,.500,35,63,.556,5,17,.294,22,31,.710,107,2015-03-12,MEM,WAS
42,Home,L 87-96 ,240,32,78,.410,22,52,.423,10,26,.385,13,21,.619,87,39,83,.470,31,65,.477,8,18,.444,10,12,.833,96,2015-03-13,PHO,ATL
43,Home,L 87-94 ,240,35,94,.372,27,57,.474,8,37,.216,9,14,.643,87,37,84,.440,35,67,.522,2,17,.118,18,26,.692,94,2015-03-14,PHI,BRK
44,@,L 87-101 ,240,32,89,.360,23,62,.371,9,27,.333,14,21,.667,87,39,81,.481,34,67,.507,5,14,.357,18,22,.818,101,2015-03-22,PHI,LAL
45,@,W 87-81 ,240,36,89,.404,29,63,.460,7,26,.269,8,18,.444,87,32,87,.368,26,67,.388,6,20,.300,11,12,.917,81,2015-03-27,POR,PHO
46,Home,W 87-86 ,240,33,85,.388,24,62,.387,9,23,.391,12,18,.667,87,34,84,.405,24,54,.444,10,30,.333,8,15,.533,86,2015-03-29,CLE,PHI
47,@,L 87-100 ,240,34,81,.420,28,66,.424,6,15,.400,13,23,.565,87,39,86,.453,33,59,.559,6,27,.222,16,18,.889,100,2015-04-01,IND,BOS
48,@,L 87-101 ,240,31,84,.369,24,63,.381,7,21,.333,18,20,.900,87,43,93,.462,36,77,.468,7,16,.438,8,12,.667,101,2015-04-03,NYK,WAS
49,Home,W 87-85 ,240,30,69,.435,25,55,.455,5,14,.357,22,29,.759,87,29,74,.392,22,53,.415,7,21,.333,20,24,.833,85,2015-04-04,PHO,UTA
50,@,L 87-92 ,240,30,71,.423,18,38,.474,12,33,.364,15,16,.938,87,38,77,.494,26,44,.591,12,33,.364,4,4,1.000,92,2015-04-15,CHO,TOR
51,@,L 87-92 ,240,35,75,.467,33,63,.524,2,12,.167,15,21,.714,87,30,74,.405,23,55,.418,7,19,.368,25,34,.735,92,2015-10-28,UTA,DET
52,Home,L 87-88 ,240,37,100,.370,32,74,.432,5,26,.192,8,12,.667,87,33,84,.393,26,56,.464,7,28,.250,15,25,.600,88,2015-10-28,ORL,WAS
53,Home,L 87-95 ,240,35,98,.357,29,69,.420,6,29,.207,11,14,.786,87,36,83,.434,31,64,.484,5,19,.263,18,25,.720,95,2015-11-01,BOS,SAS
54,@,L 87-92 ,240,35,90,.389,28,67,.418,7,23,.304,10,17,.588,87,33,87,.379,26,59,.441,7,28,.250,19,22,.864,92,2015-11-01,ORL,CHI
55,@,L 87-106 ,240,29,69,.420,24,50,.480,5,19,.263,24,24,1.000,87,41,90,.456,30,65,.462,11,25,.440,13,20,.650,106,2015-11-01,MIL,TOR
56,@,L 87-101 ,240,36,83,.434,31,62,.500,5,21,.238,10,13,.769,87,37,76,.487,29,54,.537,8,22,.364,19,24,.792,101,2015-11-04,BRK,ATL
57,@,L 87-91 ,240,34,81,.420,28,53,.528,6,28,.214,13,15,.867,87,35,86,.407,27,63,.429,8,23,.348,13,17,.765,91,2015-11-04,PHI,MIL
58,@,L 87-90 ,240,36,81,.444,30,61,.492,6,20,.300,9,13,.692,87,36,80,.450,31,65,.477,5,15,.333,13,24,.542,90,2015-11-06,MIA,IND
59,@,L 87-92 ,240,30,86,.349,25,63,.397,5,23,.217,22,29,.759,87,33,77,.429,24,52,.462,9,25,.360,17,22,.773,92,2015-11-06,TOR,ORL
60,@,L 87-95 ,240,32,71,.451,26,50,.520,6,21,.286,17,19,.895,87,38,88,.432,34,70,.486,4,18,.222,15,19,.789,95,2015-11-15,NOP,NYK
61,@,L 87-101 ,240,31,87,.356,21,55,.382,10,32,.313,15,18,.833,87,39,83,.470,31,57,.544,8,26,.308,15,15,1.000,101,2015-11-25,WAS,CHO
62,@,L 87-103 ,240,31,90,.344,22,61,.361,9,29,.310,16,20,.800,87,37,79,.468,30,55,.545,7,24,.292,22,26,.846,103,2015-11-27,DET,OKC
63,@,L 87-101 ,240,29,69,.420,24,52,.462,5,17,.294,24,30,.800,87,38,82,.463,29,64,.453,9,18,.500,16,21,.762,101,2015-11-28,NOP,UTA
64,Home,W 87-83 ,240,35,81,.432,31,69,.449,4,12,.333,13,16,.813,87,34,101,.337,28,77,.364,6,24,.250,9,21,.429,83,2015-11-29,BRK,DET
65,Home,W 87-82 ,240,27,70,.386,12,39,.308,15,31,.484,18,22,.818,87,33,82,.402,25,54,.463,8,28,.286,8,14,.571,82,2015-11-29,CHO,MIL
66,@,L 87-102 ,240,33,87,.379,28,64,.438,5,23,.217,16,27,.593,87,33,85,.388,25,66,.379,8,19,.421,28,56,.500,102,2015-11-30,POR,LAC
67,@,L 87-99 ,240,32,86,.372,23,56,.411,9,30,.300,14,24,.583,87,38,88,.432,34,69,.493,4,19,.211,19,22,.864,99,2015-12-02,PHI,NYK
68,@,L 87-100 ,240,32,86,.372,19,59,.322,13,27,.481,10,13,.769,87,37,74,.500,27,48,.563,10,26,.385,16,20,.800,100,2015-12-04,LAL,ATL
69,@,L 87-109 ,240,36,88,.409,27,63,.429,9,25,.360,6,10,.600,87,44,82,.537,38,68,.559,6,14,.429,15,25,.600,109,2015-12-11,LAL,SAS
70,Home,L 87-107 ,240,36,84,.429,31,60,.517,5,24,.208,10,18,.556,87,34,88,.386,22,57,.386,12,31,.387,27,42,.643,107,2015-12-17,LAL,HOU
71,@,L 87-93 ,240,31,74,.419,25,49,.510,6,25,.240,19,25,.760,87,38,87,.437,31,61,.508,7,26,.269,10,18,.556,93,2015-12-28,ATL,IND
72,Home,L 87-93 ,240,37,89,.416,32,65,.492,5,24,.208,8,11,.727,87,38,86,.442,34,64,.531,4,22,.182,13,22,.591,93,2015-12-29,DEN,CLE
73,@,L 87-92 (OT),265,33,81,.407,26,63,.413,7,18,.389,14,26,.538,87,31,75,.413,22,48,.458,9,27,.333,21,28,.750,92,2016-01-02,MEM,UTA
74,Home,L 87-93 ,240,33,79,.418,29,63,.460,4,16,.250,17,22,.773,87,36,77,.468,30,57,.526,6,20,.300,15,21,.714,93,2016-01-10,MIN,DAL
75,@,L 87-117 ,240,35,81,.432,32,66,.485,3,15,.200,14,25,.560,87,39,69,.565,32,51,.627,7,18,.389,32,40,.800,117,2016-01-17,PHO,MIN
76,Home,L 87-96 ,240,33,84,.393,29,67,.433,4,17,.235,17,26,.654,87,36,74,.486,27,55,.491,9,19,.474,15,21,.714,96,2016-01-20,ORL,PHI
77,@,L 87-106 ,240,33,68,.485,26,53,.491,7,15,.467,14,18,.778,87,45,86,.523,40,70,.571,5,16,.313,11,13,.846,106,2016-01-20,MIA,WAS
78,@,L 87-105 ,240,27,70,.386,22,48,.458,5,22,.227,28,32,.875,87,39,81,.481,34,61,.557,5,20,.250,22,26,.846,105,2016-01-31,ATL,MIA
79,@,L 87-89 ,240,29,93,.312,21,58,.362,8,35,.229,21,26,.808,87,31,78,.397,27,51,.529,4,27,.148,23,33,.697,89,2016-02-08,LAL,IND
80,@,W 87-81 ,240,34,90,.378,28,66,.424,6,24,.250,13,17,.765,87,30,85,.353,17,39,.436,13,46,.283,8,14,.571,81,2016-02-24,DEN,LAC
81,Home,W 87-76 ,240,38,77,.494,30,60,.500,8,17,.471,3,5,.600,87,27,81,.333,20,49,.408,7,32,.219,15,23,.652,76,2016-02-28,ATL,CHO
82,Home,L 87-90 ,240,34,85,.400,31,69,.449,3,16,.188,16,21,.762,87,33,75,.440,28,54,.519,5,21,.238,19,27,.704,90,2016-03-13,LAL,NYK
83,@,L 87-108 ,240,32,69,.464,24,50,.480,8,19,.421,15,22,.682,87,44,82,.537,36,62,.581,8,20,.400,12,16,.750,108,2016-03-15,LAC,SAS
84,Home,W 87-79 ,240,32,78,.410,24,57,.421,8,21,.381,15,18,.833,87,31,82,.378,22,46,.478,9,36,.250,8,10,.800,79,2016-03-19,SAS,GSW
85,Home,L 87-89 ,240,33,74,.446,24,51,.471,9,23,.391,12,22,.545,87,31,77,.403,20,48,.417,11,29,.379,16,20,.800,89,2016-03-23,HOU,UTA
86,Home,L 87-101 ,240,33,83,.398,27,64,.422,6,19,.316,15,24,.625,87,37,72,.514,32,57,.561,5,15,.333,22,30,.733,101,2016-03-28,MEM,SAS
87,@,L 87-107 ,240,35,94,.372,31,73,.425,4,21,.190,13,21,.619,87,38,87,.437,26,49,.531,12,38,.316,19,24,.792,107,2016-03-31,BRK,CLE
88,Home,L 87-106 ,240,33,85,.388,25,62,.403,8,23,.348,13,21,.619,87,42,76,.553,34,54,.630,8,22,.364,14,23,.609,106,2016-04-03,BRK,NOP
89,Home,L 87-92 ,240,33,96,.344,26,71,.366,7,25,.280,14,20,.700,87,34,81,.420,27,59,.458,7,22,.318,17,20,.850,92,2016-04-03,NYK,IND
90,@,L 87-95 ,240,32,84,.381,24,63,.381,8,21,.381,15,20,.750,87,33,76,.434,21,44,.477,12,32,.375,17,21,.810,95,2016-04-07,TOR,ATL
91,@,L 87-96 ,240,34,88,.386,25,60,.417,9,28,.321,10,15,.667,87,37,84,.440,31,59,.525,6,25,.240,16,18,.889,96,2016-11-04,MIA,TOR
92,@,L 87-115 ,240,33,94,.351,27,71,.380,6,23,.261,15,17,.882,87,35,90,.389,24,63,.381,11,27,.407,34,43,.791,115,2016-11-11,NYK,BOS
93,@,W 87-74 ,240,33,81,.407,26,53,.491,7,28,.250,14,16,.875,87,26,78,.333,18,58,.310,8,20,.400,14,19,.737,74,2016-11-11,UTA,ORL
94,@,L 87-95 ,240,26,77,.338,13,49,.265,13,28,.464,22,27,.815,87,34,78,.436,26,57,.456,8,21,.381,19,22,.864,95,2016-11-19,DAL,ORL
95,Home,L 87-92 ,240,33,91,.363,26,66,.394,7,25,.280,14,23,.609,87,33,73,.452,24,51,.471,9,22,.409,17,22,.773,92,2016-11-23,ORL,PHO
96,Home,L 87-94 ,240,33,77,.429,23,47,.489,10,30,.333,11,14,.786,87,33,71,.465,22,52,.423,11,19,.579,17,24,.708,94,2016-11-30,DAL,SAS
97,@,L 87-97 ,240,32,86,.372,23,55,.418,9,31,.290,14,18,.778,87,35,74,.473,30,56,.536,5,18,.278,22,31,.710,97,2016-12-01,DAL,CHO
98,Home,W 87-77 ,240,30,88,.341,24,67,.358,6,21,.286,21,29,.724,87,34,89,.382,30,62,.484,4,27,.148,5,8,.625,77,2016-12-07,CHO,DET
99,Home,L 87-117 ,240,30,81,.370,19,55,.345,11,26,.423,16,24,.667,87,43,84,.512,36,58,.621,7,26,.269,24,29,.828,117,2016-12-07,ORL,BOS
0,@,L 87-109 ,240,32,79,.405,21,45,.467,11,34,.324,12,14,.857,87,37,74,.500,18,37,.486,19,37,.514,16,22,.727,109,2016-12-10,DAL,HOU
1,@,L 87-91 ,240,36,87,.414,28,67,.418,8,20,.400,7,13,.538,87,33,89,.371,22,61,.361,11,28,.393,14,21,.667,91,2016-12-23,MIA,NOP
2,Home,L 87-108 ,240,32,83,.386,23,59,.390,9,24,.375,14,26,.538,87,43,85,.506,36,64,.563,7,21,.333,15,20,.750,108,2017-01-10,LAL,POR
3,@,L 87-98 ,240,35,80,.438,30,59,.508,5,21,.238,12,18,.667,87,36,77,.468,24,48,.500,12,29,.414,14,19,.737,98,2017-01-15,MIN,DAL
4,@,L 87-110 ,240,34,79,.430,26,53,.491,8,26,.308,11,17,.647,87,42,84,.500,31,56,.554,11,28,.393,15,16,.938,110,2017-02-06,DAL,DEN
5,@,L 87-94 ,240,34,88,.386,28,58,.483,6,30,.200,13,14,.929,87,36,82,.439,31,63,.492,5,19,.263,17,21,.810,94,2017-03-02,GSW,CHI
6,Home,L 87-94 ,240,34,80,.425,25,51,.490,9,29,.310,10,13,.769,87,36,76,.474,28,55,.509,8,21,.381,14,23,.609,94,2017-03-08,NOP,TOR
7,Home,L 86-105 ,240,32,82,.390,27,61,.443,5,21,.238,17,24,.708,86,37,81,.457,29,58,.500,8,23,.348,23,38,.605,105,2011-12-25,GSW,LAC
8,@,L 86-99 ,240,33,72,.458,27,58,.466,6,14,.429,14,18,.778,86,32,72,.444,25,47,.532,7,25,.280,28,38,.737,99,2011-12-30,TOR,DAL
9,Home,L 86-94 ,240,32,78,.410,30,62,.484,2,16,.125,20,23,.870,86,37,74,.500,32,62,.516,5,12,.417,15,23,.652,94,2012-01-01,WAS,BOS
10,@,L 86-91 ,240,37,88,.420,32,69,.464,5,19,.263,7,11,.636,86,33,83,.398,29,64,.453,4,19,.211,21,27,.778,91,2012-01-02,MIL,DEN
11,Home,L 86-90 ,240,33,82,.402,26,61,.426,7,21,.333,13,24,.542,86,33,80,.413,30,71,.423,3,9,.333,21,25,.840,90,2012-01-04,MIN,MEM
12,@,L 86-92 ,240,29,80,.363,23,60,.383,6,20,.300,22,27,.815,86,31,69,.449,27,50,.540,4,19,.211,26,40,.650,92,2012-01-07,MIL,LAC
13,@,L 86-96 ,240,30,82,.366,26,69,.377,4,13,.308,22,30,.733,86,38,76,.500,32,59,.542,6,17,.353,14,19,.737,96,2012-01-09,IND,PHI
14,Home,L 86-100 ,240,30,69,.435,24,56,.429,6,13,.462,20,25,.800,86,38,69,.551,34,54,.630,4,15,.267,20,27,.741,100,2012-01-10,DET,DAL
15,@,L 86-102 ,240,33,78,.423,32,66,.485,1,12,.083,19,25,.760,86,47,87,.540,44,77,.571,3,10,.300,5,9,.556,102,2012-01-16,CHI,MEM
16,@,L 86-99 ,240,35,79,.443,31,62,.500,4,17,.235,12,20,.600,86,37,80,.463,27,54,.500,10,26,.385,15,19,.789,99,2012-01-16,SAC,MIN
17,Home,L 86-100 ,240,27,73,.370,21,51,.412,6,22,.273,26,33,.788,86,39,82,.476,31,60,.517,8,22,.364,14,20,.700,100,2012-01-20,NYK,MIL
18,Home,L 86-88 ,240,31,82,.378,26,57,.456,5,25,.200,19,21,.905,86,36,83,.434,31,62,.500,5,21,.238,11,19,.579,88,2012-01-20,SAS,SAC
19,Home,W 86-84 ,240,32,88,.364,27,70,.386,5,18,.278,17,24,.708,86,33,76,.434,32,73,.438,1,3,.333,17,20,.850,84,2012-01-28,PHO,MEM
20,@,L 86-113 ,240,32,71,.451,29,62,.468,3,9,.333,19,25,.760,86,42,70,.600,33,52,.635,9,18,.500,20,25,.800,113,2012-01-31,DET,NYK
21,Home,L 86-95 ,240,30,84,.357,26,65,.400,4,19,.211,22,25,.880,86,33,81,.407,28,61,.459,5,20,.250,24,33,.727,95,2012-02-01,DAL,OKC
22,Home,W 86-84 ,240,32,79,.405,28,65,.431,4,14,.286,18,28,.643,86,31,82,.378,23,59,.390,8,23,.348,14,21,.667,84,2012-02-07,MIN,SAC
23,Home,L 86-94 ,240,33,75,.440,30,59,.508,3,16,.188,17,25,.680,86,35,68,.515,31,51,.608,4,17,.235,20,25,.800,94,2012-02-10,NOH,POR
24,Home,W 86-74 ,240,33,75,.440,28,56,.500,5,19,.263,15,20,.750,86,29,65,.446,26,55,.473,3,10,.300,13,18,.722,74,2012-02-10,TOR,BOS
25,Home,L 86-111 ,240,26,74,.351,25,60,.417,1,14,.071,33,43,.767,86,41,78,.526,33,58,.569,8,20,.400,21,24,.875,111,2012-02-11,CHA,LAC
26,Home,W 86-80 ,240,32,75,.427,29,64,.453,3,11,.273,19,28,.679,86,30,73,.411,26,59,.441,4,14,.286,16,23,.696,80,2012-02-13,NOH,UTA
27,Home,W 86-78 ,240,37,84,.440,29,67,.433,8,17,.471,4,9,.444,86,31,90,.344,24,63,.381,7,27,.259,9,14,.643,78,2012-02-14,LAL,ATL
28,@,W 86-83 ,240,33,74,.446,26,57,.456,7,17,.412,13,14,.929,86,31,78,.397,27,61,.443,4,17,.235,17,25,.680,83,2012-02-28,BOS,CLE
29,Home,W 86-74 ,240,31,72,.431,25,50,.500,6,22,.273,18,24,.750,86,29,70,.414,26,61,.426,3,9,.333,13,22,.591,74,2012-03-05,POR,NOH
30,@,L 86-89 ,240,35,76,.461,27,53,.509,8,23,.348,8,9,.889,86,35,80,.438,35,70,.500,0,10,.000,19,25,.760,89,2012-03-07,ATL,MIA
31,@,L 86-104 ,240,31,72,.431,25,57,.439,6,15,.400,18,23,.783,86,42,88,.477,34,70,.486,8,18,.444,12,17,.706,104,2012-03-09,POR,BOS
32,Home,W 86-85 ,240,38,68,.559,37,60,.617,1,8,.125,9,15,.600,86,31,73,.425,23,54,.426,8,19,.421,15,22,.682,85,2012-03-09,DET,ATL
33,@,L 86-105 ,240,29,73,.397,24,52,.462,5,21,.238,23,25,.920,86,39,74,.527,32,53,.604,7,21,.333,20,25,.800,105,2012-03-10,TOR,DET
34,Home,W 86-70 ,240,34,67,.507,26,38,.684,8,29,.276,10,14,.714,86,28,83,.337,22,63,.349,6,20,.300,8,10,.800,70,2012-03-16,ORL,NJN
35,@,L 86-99 ,240,35,82,.427,34,71,.479,1,11,.091,15,22,.682,86,40,85,.471,33,65,.508,7,20,.350,12,19,.632,99,2012-03-18,HOU,PHO
36,@,L 86-99 ,240,36,74,.486,32,64,.500,4,10,.400,10,13,.769,86,41,92,.446,38,82,.463,3,10,.300,14,18,.778,99,2012-03-23,BOS,PHI
37,Home,L 86-89 ,240,37,81,.457,36,76,.474,1,5,.200,11,12,.917,86,36,90,.400,34,71,.479,2,19,.105,15,17,.882,89,2012-03-24,NOH,SAS
38,@,L 86-93 ,240,33,85,.388,24,56,.429,9,29,.310,11,13,.846,86,34,80,.425,34,69,.493,0,11,.000,25,28,.893,93,2012-03-27,MIN,MEM
39,@,L 86-103 ,240,30,80,.375,25,54,.463,5,26,.192,21,32,.656,86,41,82,.500,34,63,.540,7,19,.368,14,23,.609,103,2012-03-28,PHO,LAC
40,@,L 86-108 ,240,31,69,.449,22,43,.512,9,26,.346,15,26,.577,86,43,85,.506,31,51,.608,12,34,.353,10,12,.833,108,2012-03-28,ORL,NYK
41,Home,L 86-87 ,240,38,83,.458,34,73,.466,4,10,.400,6,13,.462,86,36,86,.419,29,58,.500,7,28,.250,8,11,.727,87,2012-04-04,BOS,SAS
42,@,L 86-93 ,240,33,77,.429,28,64,.438,5,13,.385,15,18,.833,86,33,80,.413,28,64,.438,5,16,.313,22,26,.846,93,2012-04-05,BOS,CHI
43,@,W 86-72 ,240,32,76,.421,23,58,.397,9,18,.500,13,14,.929,86,26,74,.351,21,52,.404,5,22,.227,15,19,.789,72,2012-04-07,BOS,IND
44,@,L 86-98 ,240,31,73,.425,24,52,.462,7,21,.333,17,21,.810,86,39,90,.433,30,70,.429,9,20,.450,11,16,.688,98,2012-04-10,NYK,CHI
45,@,L 86-88 (OT),265,34,83,.410,32,63,.508,2,20,.100,16,23,.696,86,37,89,.416,34,76,.447,3,13,.231,11,13,.846,88,2012-04-11,ATL,BOS
46,@,L 86-96 (OT),265,36,82,.439,32,71,.451,4,11,.364,10,16,.625,86,37,86,.430,26,64,.406,11,22,.500,11,19,.579,96,2012-04-12,MIA,CHI
47,Home,L 86-102 ,240,29,72,.403,24,50,.480,5,22,.227,23,31,.742,86,41,74,.554,37,62,.597,4,12,.333,16,23,.696,102,2012-04-15,ATL,TOR
48,@,L 86-101 ,240,32,87,.368,22,61,.361,10,26,.385,12,20,.600,86,41,83,.494,37,67,.552,4,16,.250,15,21,.714,101,2012-04-15,HOU,DEN
49,@,W 86-84 ,240,36,87,.414,29,69,.420,7,18,.389,7,9,.778,86,31,77,.403,22,52,.423,9,25,.360,13,16,.813,84,2012-04-21,WAS,MIA
50,@,L 86-92 ,240,34,76,.447,30,62,.484,4,14,.286,14,18,.778,86,29,78,.372,23,61,.377,6,17,.353,28,36,.778,92,2012-04-23,TOR,MIL
51,@,L 86-108 ,240,34,87,.391,29,72,.403,5,15,.333,13,16,.813,86,41,81,.506,27,49,.551,14,32,.438,12,16,.750,108,2012-04-26,PHI,DET
52,Home,W 86-84 ,240,35,79,.443,30,60,.500,5,19,.263,11,16,.688,86,29,77,.377,22,60,.367,7,17,.412,19,23,.826,84,2012-11-01,SAS,OKC
53,Home,L 86-115 ,240,32,79,.405,24,59,.407,8,20,.400,14,27,.519,86,44,69,.638,40,59,.678,4,10,.400,23,30,.767,115,2012-11-02,CLE,CHI
54,@,L 86-88 ,240,35,85,.412,25,57,.439,10,28,.357,6,12,.500,86,37,81,.457,32,67,.478,5,14,.357,9,14,.643,88,2012-11-02,UTA,NOH
55,Home,L 86-89 ,240,34,78,.436,28,58,.483,6,20,.300,12,17,.706,86,36,84,.429,28,63,.444,8,21,.381,9,13,.692,89,2012-11-03,WAS,BOS
56,@,L 86-105 ,240,29,64,.453,23,48,.479,6,16,.375,22,31,.710,86,40,90,.444,30,69,.435,10,21,.476,15,17,.882,105,2012-11-04,MIN,TOR
57,@,L 86-89 ,240,35,85,.412,27,59,.458,8,26,.308,8,9,.889,86,38,87,.437,31,65,.477,7,22,.318,6,12,.500,89,2012-11-07,IND,ATL
58,@,L 86-95 ,240,25,74,.338,21,51,.412,4,23,.174,32,46,.696,86,37,83,.446,32,66,.485,5,17,.294,16,18,.889,95,2012-11-07,LAL,UTA
59,Home,L 86-97 ,240,32,91,.352,29,75,.387,3,16,.188,19,26,.731,86,35,72,.486,30,54,.556,5,18,.278,22,26,.846,97,2012-11-09,SAC,SAS
60,@,L 86-104 ,240,30,79,.380,26,64,.406,4,15,.267,22,36,.611,86,38,86,.442,24,62,.387,14,24,.583,14,16,.875,104,2012-11-11,MIA,MEM
61,Home,L 86-103 ,240,36,77,.468,35,66,.530,1,11,.091,13,19,.684,86,35,72,.486,21,45,.467,14,27,.519,19,22,.864,103,2012-11-13,SAC,POR
62,Home,W 86-79 ,240,34,80,.425,25,60,.417,9,20,.450,9,12,.750,86,30,84,.357,25,64,.391,5,20,.250,14,15,.933,79,2012-11-18,PHI,CLE
63,@,L 86-97 ,240,32,80,.400,28,67,.418,4,13,.308,18,21,.857,86,38,80,.475,31,62,.500,7,18,.389,14,23,.609,97,2012-11-18,ORL,TOR
64,Home,W 86-76 ,240,34,73,.466,29,60,.483,5,13,.385,13,19,.684,86,29,72,.403,25,55,.455,4,17,.235,14,22,.636,76,2012-11-23,BRK,LAC
65,Home,L 86-93 ,240,38,88,.432,35,71,.493,3,17,.176,7,10,.700,86,32,82,.390,28,66,.424,4,16,.250,25,26,.962,93,2012-11-24,MIL,CHI
66,Home,L 86-98 ,240,35,78,.449,34,67,.507,1,11,.091,15,19,.789,86,38,83,.458,27,63,.429,11,20,.550,11,13,.846,98,2012-11-30,ORL,BRK
67,@,W 86-80 ,240,35,80,.438,29,58,.500,6,22,.273,10,16,.625,86,31,81,.383,24,59,.407,7,22,.318,11,11,1.000,80,2012-12-12,ATL,ORL
68,Home,L 86-90 ,240,32,81,.395,23,63,.365,9,18,.500,13,14,.929,86,33,83,.398,28,68,.412,5,15,.333,19,27,.704,90,2012-12-14,CLE,MIL
69,Home,L 86-99 ,240,31,74,.419,26,57,.456,5,17,.294,19,24,.792,86,38,85,.447,34,74,.459,4,11,.364,19,24,.792,99,2012-12-15,UTA,MEM
70,@,L 86-100 ,240,35,78,.449,25,53,.472,10,25,.400,6,9,.667,86,38,83,.458,27,54,.500,11,29,.379,13,17,.765,100,2012-12-19,BRK,NYK
71,Home,L 86-111 ,240,38,95,.400,37,79,.468,1,16,.063,9,10,.900,86,41,81,.506,33,62,.532,8,19,.421,21,24,.875,111,2012-12-30,DAL,SAS
72,Home,L 86-95 ,240,36,82,.439,26,62,.419,10,20,.500,4,12,.333,86,41,83,.494,32,61,.525,9,22,.409,4,8,.500,95,2013-01-01,NOH,ATL
73,@,W 86-84 ,240,33,81,.407,23,54,.426,10,27,.370,10,15,.667,86,32,81,.395,30,76,.395,2,5,.400,18,18,1.000,84,2013-01-04,POR,MEM
74,@,L 86-109 ,240,35,84,.417,32,67,.478,3,17,.176,13,20,.650,86,41,85,.482,33,60,.550,8,25,.320,19,23,.826,109,2013-01-05,PHI,SAS
75,@,L 86-97 ,240,35,83,.422,29,59,.492,6,24,.250,10,12,.833,86,33,81,.407,27,67,.403,6,14,.429,25,31,.806,97,2013-01-13,IND,BRK
76,@,L 86-97 ,240,37,85,.435,35,68,.515,2,17,.118,10,12,.833,86,40,86,.465,28,65,.431,12,21,.571,5,5,1.000,97,2013-01-16,IND,ORL
77,Home,L 86-89 ,240,31,76,.408,28,58,.483,3,18,.167,21,28,.750,86,32,83,.386,24,55,.436,8,28,.286,17,20,.850,89,2013-01-24,BOS,NYK
78,Home,W 86-73 ,240,34,79,.430,31,69,.449,3,10,.300,15,19,.789,86,29,71,.408,25,56,.446,4,15,.267,11,12,.917,73,2013-01-26,WAS,CHI
79,@,L 86-92 ,240,33,78,.423,25,51,.490,8,27,.296,12,19,.632,86,38,83,.458,35,71,.493,3,12,.250,13,15,.867,92,2013-01-30,LAL,PHO
80,@,L 86-96 ,240,33,83,.398,25,63,.397,8,20,.400,12,17,.706,86,32,76,.421,19,41,.463,13,35,.371,19,26,.731,96,2013-02-01,MIL,NYK
81,Home,W 86-77 ,240,35,81,.432,31,66,.470,4,15,.267,12,17,.706,86,29,79,.367,22,59,.373,7,20,.350,12,16,.750,77,2013-02-01,UTA,POR
82,@,L 86-115 ,240,28,70,.400,25,56,.446,3,14,.214,27,33,.818,86,45,77,.584,40,62,.645,5,15,.333,20,29,.690,115,2013-02-02,NOH,MIN
83,@,L 86-96 ,240,36,88,.409,30,66,.455,6,22,.273,8,17,.471,86,38,78,.487,33,58,.569,5,20,.250,15,16,.938,96,2013-02-02,WAS,SAS
84,@,W 86-76 ,240,33,82,.402,27,64,.422,6,18,.333,14,22,.636,86,30,87,.345,24,67,.358,6,20,.300,10,14,.714,76,2013-02-06,LAC,ORL
85,@,L 86-100 ,240,29,82,.354,23,63,.365,6,19,.316,22,29,.759,86,39,81,.481,34,71,.479,5,10,.500,17,26,.654,100,2013-02-06,MIL,UTA
86,Home,L 86-111 ,240,34,72,.472,28,53,.528,6,19,.316,12,17,.706,86,43,73,.589,31,54,.574,12,19,.632,13,20,.650,111,2013-02-10,BRK,SAS
87,Home,L 86-105 ,240,29,81,.358,24,62,.387,5,19,.263,23,33,.697,86,41,83,.494,31,62,.500,10,21,.476,13,14,.929,105,2013-02-11,DET,NOH
88,@,W 86-67 ,240,37,73,.507,34,60,.567,3,13,.231,9,14,.643,86,28,75,.373,26,65,.400,2,10,.200,9,11,.818,67,2013-02-21,MIA,CHI
89,@,L 86-92 ,240,36,85,.424,34,72,.472,2,13,.154,12,15,.800,86,35,79,.443,28,58,.483,7,21,.333,15,19,.789,92,2013-02-24,BOS,POR
90,@,L 86-94 ,240,32,94,.340,27,71,.380,5,23,.217,17,22,.773,86,36,75,.480,33,60,.550,3,15,.200,19,28,.679,94,2013-03-01,GSW,BOS
91,Home,L 86-115 ,240,32,82,.390,27,67,.403,5,15,.333,17,19,.895,86,43,83,.518,32,64,.500,11,19,.579,18,23,.783,115,2013-03-08,ORL,IND
92,@,L 86-96 ,240,34,78,.436,27,62,.435,7,16,.438,11,18,.611,86,41,82,.500,34,61,.557,7,21,.333,7,11,.636,96,2013-03-15,CLE,DAL
93,@,L 86-87 ,240,33,72,.458,29,58,.500,4,14,.286,16,17,.941,86,31,71,.437,26,55,.473,5,16,.313,20,26,.769,87,2013-03-20,BOS,NOH
94,Home,L 86-117 ,240,36,95,.379,32,73,.438,4,22,.182,10,21,.476,86,42,79,.532,40,67,.597,2,12,.167,31,40,.775,117,2013-03-22,PHO,MIN
95,@,L 86-110 ,240,25,66,.379,20,50,.400,5,16,.313,31,39,.795,86,41,85,.482,27,60,.450,14,25,.560,14,15,.933,110,2013-03-25,DEN,NOH
96,Home,L 86-99 ,240,29,67,.433,24,51,.471,5,16,.313,23,34,.676,86,37,73,.507,31,63,.492,6,10,.600,19,27,.704,99,2013-03-30,MIN,MEM
97,Home,L 86-88 ,240,35,79,.443,28,55,.509,7,24,.292,9,16,.563,86,33,71,.465,21,43,.488,12,28,.429,10,15,.667,88,2013-03-31,SAS,MIA
98,@,L 86-90 ,240,35,89,.393,30,66,.455,5,23,.217,11,16,.688,86,33,78,.423,27,65,.415,6,13,.462,18,26,.692,90,2013-04-02,CHI,WAS
99,@,L 86-87 ,240,34,80,.425,30,70,.429,4,10,.400,14,17,.824,86,33,82,.402,25,62,.403,8,20,.400,13,14,.929,87,2013-04-05,ORL,CHI
0,Home,W 86-84 ,240,34,74,.459,29,54,.537,5,20,.250,13,18,.722,86,38,86,.442,35,72,.486,3,14,.214,5,7,.714,84,2013-04-05,LAL,MEM
1,@,L 86-96 ,240,35,87,.402,31,66,.470,4,21,.190,12,17,.706,86,39,86,.453,33,71,.465,6,15,.400,12,21,.571,96,2013-04-10,SAS,DEN
2,Home,L 86-97 ,240,36,87,.414,35,74,.473,1,13,.077,13,21,.619,86,40,93,.430,33,71,.465,7,22,.318,10,11,.909,97,2013-04-12,WAS,PHI
3,@,L 86-91 ,240,33,89,.371,27,71,.380,6,18,.333,14,19,.737,86,31,85,.365,22,58,.379,9,27,.333,20,31,.645,91,2013-04-14,SAS,LAL
4,Home,W 86-70 ,240,34,84,.405,30,71,.423,4,13,.308,14,20,.700,86,25,78,.321,22,67,.328,3,11,.273,17,26,.654,70,2013-04-17,MEM,UTA
5,@,L 86-107 ,240,34,89,.382,30,72,.417,4,17,.235,14,15,.933,86,42,89,.472,35,72,.486,7,17,.412,16,22,.727,107,2013-11-03,BRK,ORL
6,@,L 86-107 ,240,31,82,.378,28,69,.406,3,13,.231,21,27,.778,86,41,94,.436,33,70,.471,8,24,.333,17,23,.739,107,2013-11-13,BRK,SAC
7,@,W 86-80 ,240,32,80,.400,24,60,.400,8,20,.400,14,20,.700,86,32,79,.405,28,64,.438,4,15,.267,12,17,.706,80,2013-11-15,CHA,CLE
8,Home,L 86-89 ,240,35,80,.438,25,56,.446,10,24,.417,6,11,.545,86,37,85,.435,36,72,.500,1,13,.077,14,14,1.000,89,2013-11-15,LAL,MEM
9,Home,L 86-97 ,240,33,87,.379,26,64,.406,7,23,.304,13,17,.765,86,40,72,.556,36,59,.610,4,13,.308,13,18,.722,97,2013-11-17,SAC,MEM
10,Home,W 86-81 ,240,27,75,.360,21,63,.333,6,12,.500,26,31,.839,86,33,91,.363,26,75,.347,7,16,.438,8,16,.500,81,2013-11-18,CHI,CHA
11,@,L 86-92 ,240,33,76,.434,27,52,.519,6,24,.250,14,18,.778,86,35,70,.500,28,51,.549,7,19,.368,15,21,.714,92,2013-11-19,NYK,DET
12,Home,L 86-102 ,240,35,80,.438,32,69,.464,3,11,.273,13,17,.765,86,42,79,.532,35,62,.565,7,17,.412,11,16,.688,102,2013-11-22,MEM,SAS
13,@,L 86-100 ,240,35,84,.417,27,60,.450,8,24,.333,8,15,.533,86,40,87,.460,32,61,.525,8,26,.308,12,15,.800,100,2013-11-24,SAC,LAL
14,Home,L 86-96 ,240,33,74,.446,30,65,.462,3,9,.333,17,20,.850,86,35,80,.438,26,60,.433,9,20,.450,17,21,.810,96,2013-11-25,CHA,BOS
15,Home,L 86-93 ,240,34,82,.415,30,69,.435,4,13,.308,14,18,.778,86,34,69,.493,28,45,.622,6,24,.250,19,27,.704,93,2013-11-25,MEM,HOU
16,@,L 86-103 ,240,32,86,.372,28,68,.412,4,18,.222,18,27,.667,86,38,76,.500,27,53,.509,11,23,.478,16,26,.615,103,2013-11-29,CLE,BOS
17,Home,L 86-95 ,240,33,80,.413,29,69,.420,4,11,.364,16,18,.889,86,40,84,.476,37,68,.544,3,16,.188,12,15,.800,95,2013-12-04,UTA,IND
18,@,L 86-90 ,240,32,80,.400,27,59,.458,5,21,.238,17,19,.895,86,33,68,.485,26,47,.553,7,21,.333,17,25,.680,90,2013-12-13,NYK,BOS
19,@,W 86-82 ,240,33,82,.402,25,61,.410,8,21,.381,12,15,.800,86,28,86,.326,21,71,.296,7,15,.467,19,20,.950,82,2013-12-18,UTA,ORL
20,Home,L 86-103 ,240,29,76,.382,23,50,.460,6,26,.231,22,25,.880,86,38,83,.458,29,55,.527,9,28,.321,18,19,.947,103,2013-12-23,BRK,IND
21,@,L 86-115 ,240,32,89,.360,28,66,.424,4,23,.174,18,23,.783,86,45,85,.529,37,65,.569,8,20,.400,17,24,.708,115,2013-12-27,PHO,GSW
22,@,L 86-117 ,240,31,85,.365,24,57,.421,7,28,.250,17,31,.548,86,47,82,.573,37,60,.617,10,22,.455,13,16,.813,117,2013-12-29,HOU,OKC
23,@,L 86-91 ,240,27,70,.386,19,46,.413,8,24,.333,24,26,.923,86,33,80,.413,25,53,.472,8,27,.296,17,26,.654,91,2014-01-06,ATL,BRK
24,Home,W 86-79 ,240,32,75,.427,31,64,.484,1,11,.091,21,26,.808,86,30,81,.370,25,62,.403,5,19,.263,14,18,.778,79,2014-01-07,IND,TOR
25,@,L 86-104 ,240,33,93,.355,28,76,.368,5,17,.294,15,18,.833,86,42,74,.568,33,61,.541,9,13,.692,11,14,.786,104,2014-01-12,MIN,SAS
26,Home,L 86-101 ,240,31,84,.369,29,64,.453,2,20,.100,22,37,.595,86,38,80,.475,30,57,.526,8,23,.348,17,20,.850,101,2014-01-17,PHI,MIA
27,@,L 86-93 ,240,33,84,.393,28,57,.491,5,27,.185,15,18,.833,86,38,74,.514,33,54,.611,5,20,.250,12,16,.750,93,2014-01-21,BOS,MIA
28,Home,L 86-95 ,240,32,85,.376,24,61,.393,8,24,.333,14,16,.875,86,34,73,.466,29,56,.518,5,17,.294,22,26,.846,95,2014-01-27,CHI,MIN
29,Home,L 86-114 ,240,34,89,.382,30,67,.448,4,22,.182,14,22,.636,86,43,79,.544,29,51,.569,14,28,.500,14,19,.737,114,2014-01-27,MIL,LAC
30,Home,L 86-96 ,240,33,71,.465,28,58,.483,5,13,.385,15,16,.938,86,37,83,.446,33,71,.465,4,12,.333,18,23,.783,96,2014-01-29,SAS,CHI
31,@,L 86-117 ,240,31,87,.356,23,64,.359,8,23,.348,16,22,.727,86,43,76,.566,31,50,.620,12,26,.462,19,28,.679,117,2014-01-30,CLE,NYK
32,Home,W 86-77 ,240,34,76,.447,30,58,.517,4,18,.222,14,23,.609,86,32,81,.395,30,65,.462,2,16,.125,11,15,.733,77,2014-02-03,OKC,MEM
33,Home,L 86-92 ,240,36,82,.439,30,63,.476,6,19,.316,8,11,.727,86,34,80,.425,27,58,.466,7,22,.318,17,17,1.000,92,2014-02-09,LAL,CHI
34,Home,L 86-102 ,240,31,72,.431,25,56,.446,6,16,.375,18,25,.720,86,42,88,.477,35,68,.515,7,20,.350,11,14,.786,102,2014-02-10,MIL,BOS
35,@,W 86-81 ,240,36,77,.468,34,65,.523,2,12,.167,12,18,.667,86,34,83,.410,30,70,.429,4,13,.308,9,10,.900,81,2014-02-12,MEM,ORL
36,@,L 86-93 ,240,32,78,.410,30,57,.526,2,21,.095,20,24,.833,86,37,85,.435,31,65,.477,6,20,.300,13,17,.765,93,2014-02-22,BRK,GSW
37,@,L 86-109 ,240,31,80,.388,25,61,.410,6,19,.316,18,29,.621,86,42,74,.568,33,56,.589,9,18,.500,16,24,.667,109,2014-02-26,PHO,UTA
38,@,L 86-112 ,240,34,74,.459,27,58,.466,7,16,.438,11,15,.733,86,40,76,.526,27,48,.563,13,28,.464,19,25,.760,112,2014-03-07,IND,HOU
39,@,L 86-99 ,240,33,74,.446,31,66,.470,2,8,.250,18,27,.667,86,36,71,.507,27,54,.500,9,17,.529,18,22,.818,99,2014-03-14,MEM,TOR
40,Home,L 86-109 ,240,29,79,.367,20,50,.400,9,29,.310,19,27,.704,86,40,75,.533,27,51,.529,13,24,.542,16,20,.800,109,2014-03-16,OKC,DAL
41,@,L 86-124 ,240,34,83,.410,30,65,.462,4,18,.222,14,18,.778,86,46,79,.582,33,54,.611,13,25,.520,19,26,.731,124,2014-03-17,UTA,HOU
42,@,L 86-96 ,240,37,84,.440,30,66,.455,7,18,.389,5,10,.500,86,36,81,.444,34,70,.486,2,11,.182,22,25,.880,96,2014-03-19,UTA,MEM
43,@,L 86-92 ,240,31,73,.425,26,50,.520,5,23,.217,19,27,.704,86,32,82,.390,28,65,.431,4,17,.235,24,29,.828,92,2014-03-19,IND,NYK
44,@,L 86-91 ,240,36,79,.456,33,65,.508,3,14,.214,11,17,.647,86,35,75,.467,28,55,.509,7,20,.350,14,16,.875,91,2014-03-21,MEM,MIA
45,@,L 86-96 ,240,33,76,.434,28,56,.500,5,20,.250,15,20,.750,86,34,80,.425,26,56,.464,8,24,.333,20,28,.714,96,2014-03-23,ATL,TOR
46,@,L 86-98 ,240,31,65,.477,23,51,.451,8,14,.571,16,19,.842,86,35,75,.467,29,59,.492,6,16,.375,22,28,.786,98,2014-04-11,IND,MIA
47,Home,L 86-96 ,240,32,77,.416,28,58,.483,4,19,.211,18,24,.750,86,35,82,.427,33,63,.524,2,19,.105,24,33,.727,96,2014-04-11,ORL,WAS
48,@,L 86-91 (OT),265,34,86,.395,26,64,.406,8,22,.364,10,15,.667,86,34,85,.400,29,64,.453,5,21,.238,18,26,.692,91,2014-04-16,CHI,CHA
49,Home,L 86-101 ,240,32,79,.405,27,64,.422,5,15,.333,17,24,.708,86,41,88,.466,30,65,.462,11,23,.478,8,11,.727,101,2014-04-16,ORL,IND
50,Home,L 86-95 ,240,33,89,.371,30,74,.405,3,15,.200,17,20,.850,86,34,73,.466,29,57,.509,5,16,.313,22,30,.733,95,2014-11-05,MIL,CHI
51,@,L 86-97 ,240,32,74,.432,26,53,.491,6,21,.286,16,21,.762,86,39,90,.433,33,75,.440,6,15,.400,13,15,.867,97,2014-11-10,UTA,IND
52,Home,L 86-88 ,240,33,87,.379,26,62,.419,7,25,.280,13,19,.684,86,37,75,.493,33,60,.550,4,15,.267,10,13,.769,88,2014-11-19,DET,PHO
53,@,L 86-88 ,240,37,86,.430,32,72,.444,5,14,.357,7,12,.583,86,35,78,.449,33,63,.524,2,15,.133,16,24,.667,88,2014-11-19,CHO,IND
54,Home,L 86-91 ,240,32,90,.356,29,73,.397,3,17,.176,19,27,.704,86,33,93,.355,26,68,.382,7,25,.280,18,24,.750,91,2014-11-23,OKC,GSW
55,@,L 86-91 ,240,35,76,.461,29,54,.537,6,22,.273,10,15,.667,86,32,76,.421,18,40,.450,14,36,.389,13,19,.684,91,2014-11-24,NYK,HOU
56,@,L 86-98 ,240,36,78,.462,29,58,.500,7,20,.350,7,17,.412,86,39,90,.433,29,68,.426,10,22,.455,10,13,.769,98,2014-11-25,DET,MIL
57,Home,L 86-103 ,240,31,81,.383,28,67,.418,3,14,.214,21,34,.618,86,40,85,.471,35,69,.507,5,16,.313,18,19,.947,103,2014-11-26,MIN,MIL
58,@,W 86-79 ,240,30,72,.417,23,49,.469,7,23,.304,19,31,.613,86,31,88,.352,28,64,.438,3,24,.125,14,20,.700,79,2014-11-30,MIA,NYK
59,@,L 86-107 ,240,33,72,.458,31,50,.620,2,22,.091,18,30,.600,86,39,72,.542,29,53,.547,10,19,.526,19,24,.792,107,2014-12-01,MIA,WAS
60,@,L 86-114 ,240,33,79,.418,26,59,.441,7,20,.350,13,25,.520,86,42,78,.538,30,47,.638,12,31,.387,18,25,.720,114,2014-12-03,ORL,LAC
61,Home,L 86-102 ,240,32,88,.364,30,77,.390,2,11,.182,20,29,.690,86,42,91,.462,37,69,.536,5,22,.227,13,14,.929,102,2014-12-08,MIN,GSW
62,Home,L 86-98 ,240,34,97,.351,29,75,.387,5,22,.227,13,16,.813,86,41,84,.488,32,63,.508,9,21,.429,7,8,.875,98,2014-12-09,DET,POR
63,@,L 86-93 ,240,35,93,.376,29,64,.453,6,29,.207,10,14,.714,86,36,83,.434,29,62,.468,7,21,.333,14,17,.824,93,2014-12-15,CHI,ATL
64,@,L 86-104 ,240,33,85,.388,25,54,.463,8,31,.258,12,15,.800,86,42,87,.483,33,65,.508,9,22,.409,11,16,.688,104,2014-12-20,UTA,CHO
65,@,L 86-100 ,240,34,80,.425,28,52,.538,6,28,.214,12,22,.545,86,34,87,.391,25,55,.455,9,32,.281,23,31,.742,100,2014-12-25,GSW,LAC
66,@,L 86-126 ,240,33,86,.384,27,66,.409,6,20,.300,14,23,.609,86,46,82,.561,34,54,.630,12,28,.429,22,27,.815,126,2014-12-30,PHI,GSW
67,Home,L 86-109 ,240,38,85,.447,34,65,.523,4,20,.200,6,10,.600,86,40,86,.465,26,53,.491,14,33,.424,15,29,.517,109,2014-12-30,ORL,DET
68,@,L 86-96 ,240,35,79,.443,30,62,.484,5,17,.294,11,11,1.000,86,32,72,.444,19,47,.404,13,25,.520,19,23,.826,96,2015-01-07,MEM,ATL
69,@,L 86-102 ,240,32,83,.386,22,57,.386,10,26,.385,12,19,.632,86,41,86,.477,33,71,.465,8,15,.533,12,19,.632,102,2015-01-09,CHI,WAS
70,Home,L 86-94 ,240,32,68,.471,24,46,.522,8,22,.364,14,19,.737,86,41,92,.446,35,66,.530,6,26,.231,6,10,.600,94,2015-01-20,MIA,OKC
71,@,L 86-92 ,240,27,85,.318,22,57,.386,5,28,.179,27,32,.844,86,34,74,.459,33,67,.493,1,7,.143,23,29,.793,92,2015-01-21,TOR,MEM
72,Home,L 86-91 ,240,31,81,.383,22,52,.423,9,29,.310,15,18,.833,86,33,80,.413,27,56,.482,6,24,.250,19,24,.792,91,2015-01-23,PHI,TOR
73,@,L 86-101 ,240,31,86,.360,25,61,.410,6,25,.240,18,25,.720,86,41,81,.506,30,64,.469,11,17,.647,8,10,.800,101,2015-01-24,DET,MIL
74,@,L 86-95 ,240,34,83,.410,28,65,.431,6,18,.333,12,14,.857,86,35,83,.422,25,54,.463,10,29,.345,15,18,.833,95,2015-01-28,CHO,SAS
75,Home,L 86-104 ,240,33,92,.359,28,68,.412,5,24,.208,15,20,.750,86,44,93,.473,44,82,.537,0,11,.000,16,25,.640,104,2015-01-31,DEN,CHO
76,@,L 86-104 ,240,35,75,.467,33,63,.524,2,12,.167,14,27,.519,86,42,80,.525,35,60,.583,7,20,.350,13,15,.867,104,2015-02-10,SAC,CHI
77,@,L 86-95 ,240,35,81,.432,32,69,.464,3,12,.250,13,17,.765,86,36,81,.444,30,62,.484,6,19,.316,17,25,.680,95,2015-02-10,BRK,MEM
78,@,L 86-102 ,240,34,93,.366,27,77,.351,7,16,.438,11,11,1.000,86,35,86,.407,25,56,.446,10,30,.333,22,23,.957,102,2015-02-11,LAL,POR
79,Home,L 86-97 ,240,32,72,.444,28,56,.500,4,16,.250,18,18,1.000,86,35,87,.402,26,57,.456,9,30,.300,18,21,.857,97,2015-02-22,MIL,ATL
80,Home,L 86-98 ,240,34,77,.442,31,60,.517,3,17,.176,15,23,.652,86,39,84,.464,35,70,.500,4,14,.286,16,21,.762,98,2015-02-25,CHI,CHO
81,@,L 86-93 ,240,33,92,.359,24,63,.381,9,29,.310,11,14,.786,86,34,80,.425,28,63,.444,6,17,.353,19,29,.655,93,2015-02-27,CLE,IND
82,Home,L 86-96 ,240,27,87,.310,17,61,.279,10,26,.385,22,30,.733,86,38,87,.437,31,60,.517,7,27,.259,13,24,.542,96,2015-03-01,CHI,LAC
83,Home,L 86-124 ,240,30,82,.366,26,60,.433,4,22,.182,22,30,.733,86,41,83,.494,31,65,.477,10,18,.556,32,37,.865,124,2015-03-03,NYK,SAC
84,Home,L 86-92 ,240,30,78,.385,27,63,.429,3,15,.200,23,30,.767,86,30,79,.380,23,61,.377,7,18,.389,25,30,.833,92,2015-03-07,NYK,IND
85,@,L 86-118 ,240,34,92,.370,30,75,.400,4,17,.235,14,20,.700,86,45,85,.529,28,51,.549,17,34,.500,11,12,.917,118,2015-03-10,ORL,IND
86,Home,L 86-91 ,240,34,85,.400,27,67,.403,7,18,.389,11,15,.733,86,34,76,.447,29,53,.547,5,23,.217,18,27,.667,91,2015-03-15,LAL,ATL
87,@,L 86-103 ,240,32,81,.395,26,62,.419,6,19,.316,16,21,.762,86,34,82,.415,24,58,.414,10,24,.417,25,28,.893,103,2015-03-18,IND,CHI
88,@,L 86-97 ,240,33,76,.434,27,54,.500,6,22,.273,14,15,.933,86,37,89,.416,26,71,.366,11,18,.611,12,16,.750,97,2015-03-21,POR,MEM
89,@,L 86-109 ,240,35,87,.402,32,70,.457,3,17,.176,13,18,.722,86,40,79,.506,32,62,.516,8,17,.471,21,23,.913,109,2015-03-22,WAS,SAC
90,@,L 86-98 ,240,28,81,.346,20,61,.328,8,20,.400,22,28,.786,86,37,82,.451,34,66,.515,3,16,.188,21,29,.724,98,2015-03-23,CHO,CHI
91,Home,L 86-93 ,240,28,69,.406,23,50,.460,5,19,.263,25,37,.676,86,34,77,.442,25,53,.472,9,24,.375,16,23,.696,93,2015-03-25,BOS,MIA
92,@,L 86-99 ,240,32,82,.390,21,47,.447,11,35,.314,11,15,.733,86,37,72,.514,31,54,.574,6,18,.333,19,24,.792,99,2015-03-27,MIA,ATL
93,@,L 86-87 ,240,34,84,.405,24,54,.444,10,30,.333,8,15,.533,86,33,85,.388,24,62,.387,9,23,.391,12,18,.667,87,2015-03-29,PHI,CLE
94,@,L 86-109 ,240,38,87,.437,35,71,.493,3,16,.188,7,10,.700,86,44,86,.512,32,59,.542,12,27,.444,9,10,.900,109,2015-03-30,PHO,POR
95,Home,L 86-102 ,240,29,84,.345,22,67,.328,7,17,.412,21,26,.808,86,38,77,.494,34,55,.618,4,22,.182,22,27,.815,102,2015-04-08,NYK,IND
96,@,L 86-94 ,240,34,77,.442,32,68,.471,2,9,.222,16,24,.667,86,35,88,.398,29,61,.475,6,27,.222,18,22,.818,94,2015-04-11,MEM,LAC
97,Home,L 86-113 ,240,32,87,.368,29,75,.387,3,12,.250,19,22,.864,86,44,88,.500,32,58,.552,12,30,.400,13,17,.765,113,2015-04-13,BRK,CHI
98,@,L 86-96 ,240,33,84,.393,25,60,.417,8,24,.333,12,15,.800,86,33,83,.398,26,56,.464,7,27,.259,23,32,.719,96,2015-11-04,NYK,CLE
99,@,L 86-94 ,240,34,82,.415,31,73,.425,3,9,.333,15,19,.789,86,37,82,.451,29,62,.468,8,20,.400,12,16,.750,94,2015-11-07,BRK,MIL
0,Home,L 86-92 ,240,34,76,.447,29,54,.537,5,22,.227,13,20,.650,86,30,76,.395,23,52,.442,7,24,.292,25,30,.833,92,2015-11-16,PHI,DAL
1,@,L 86-115 ,240,31,72,.431,21,51,.412,10,21,.476,14,24,.583,86,37,70,.529,25,48,.521,12,22,.545,29,41,.707,115,2015-11-17,MIL,WAS
2,Home,L 86-96 ,240,33,77,.429,30,64,.469,3,13,.231,17,25,.680,86,40,87,.460,34,59,.576,6,28,.214,10,13,.769,96,2015-11-20,MIN,DET
3,@,L 86-123 ,240,34,79,.430,29,62,.468,5,17,.294,13,19,.684,86,47,91,.516,32,61,.525,15,30,.500,14,23,.609,123,2015-11-21,MIL,IND
4,Home,L 86-96 ,240,33,90,.367,25,63,.397,8,27,.296,12,16,.750,86,36,79,.456,30,54,.556,6,25,.240,18,24,.750,96,2015-12-02,ATL,TOR
5,@,L 86-108 ,240,30,86,.349,25,62,.403,5,24,.208,21,30,.700,86,40,85,.471,29,60,.483,11,25,.440,17,21,.810,108,2015-12-20,PHI,CLE
6,@,L 86-101 ,240,38,86,.442,33,68,.485,5,18,.278,5,6,.833,86,39,81,.481,32,71,.451,7,10,.700,16,17,.941,101,2015-12-26,DEN,SAS
7,Home,L 86-95 ,240,32,79,.405,26,48,.542,6,31,.194,16,17,.941,86,32,76,.421,26,54,.481,6,22,.273,25,29,.862,95,2016-01-06,ORL,IND
8,Home,L 86-91 ,240,31,83,.373,22,54,.407,9,29,.310,15,20,.750,86,36,81,.444,31,60,.517,5,21,.238,14,19,.737,91,2016-01-08,NOP,IND
9,@,W 86-74 ,240,31,69,.449,26,53,.491,5,16,.313,19,25,.760,86,29,89,.326,26,68,.382,3,21,.143,13,15,.867,74,2016-01-10,UTA,LAL
10,@,L 86-114 ,240,34,78,.436,28,58,.483,6,20,.300,12,19,.632,86,44,79,.557,36,50,.720,8,29,.276,18,24,.750,114,2016-01-16,BRK,ATL
11,Home,L 86-108 ,240,33,75,.440,27,59,.458,6,16,.375,14,18,.778,86,43,75,.573,34,59,.576,9,16,.563,13,15,.867,108,2016-01-22,BRK,UTA
12,Home,L 86-124 ,240,35,84,.417,29,57,.509,6,27,.222,10,14,.714,86,48,92,.522,38,72,.528,10,20,.500,18,25,.720,124,2016-02-03,PHI,ATL
13,@,L 86-105 ,240,35,83,.422,31,66,.470,4,17,.235,12,15,.800,86,39,78,.500,27,53,.509,12,25,.480,15,20,.750,105,2016-02-18,SAS,LAC
14,@,L 86-98 ,240,35,82,.427,28,59,.475,7,23,.304,9,17,.529,86,36,78,.462,29,56,.518,7,22,.318,19,26,.731,98,2016-02-19,DET,WAS
15,Home,L 86-94 ,240,35,89,.393,27,65,.415,8,24,.333,8,8,1.000,86,36,81,.444,28,60,.467,8,21,.381,14,15,.933,94,2016-03-03,NOP,SAS
16,@,L 86-96 ,240,34,92,.370,31,79,.392,3,13,.231,15,17,.882,86,37,75,.493,32,56,.571,5,19,.263,17,25,.680,96,2016-03-17,MEM,MIL
17,Home,L 86-101 ,240,33,78,.423,25,51,.490,8,27,.296,12,19,.632,86,39,81,.481,29,54,.537,10,27,.370,13,17,.765,101,2016-04-03,PHO,UTA
18,Home,L 86-88 ,240,32,68,.471,27,51,.529,5,17,.294,17,21,.810,86,32,72,.444,25,55,.455,7,17,.412,17,19,.895,88,2016-04-05,UTA,SAS
19,@,L 86-88 ,240,34,78,.436,28,58,.483,6,20,.300,12,18,.667,86,33,80,.413,23,47,.489,10,33,.303,12,14,.857,88,2016-04-06,HOU,DAL
20,Home,L 86-92 ,240,34,90,.378,31,73,.425,3,17,.176,15,19,.789,86,34,77,.442,24,50,.480,10,27,.370,14,18,.778,92,2016-04-10,SAS,GSW
21,Home,L 86-100 ,240,30,80,.375,19,54,.352,11,26,.423,15,24,.625,86,37,83,.446,31,63,.492,6,20,.300,20,22,.909,100,2016-11-04,UTA,SAS
22,@,L 86-103 ,240,31,94,.330,24,69,.348,7,25,.280,17,20,.850,86,40,84,.476,33,64,.516,7,20,.350,16,22,.727,103,2016-11-05,DEN,DET
23,@,L 86-88 ,240,34,86,.395,28,69,.406,6,17,.353,12,17,.706,86,31,78,.397,22,50,.440,9,28,.321,17,27,.630,88,2016-11-05,WAS,ORL
24,Home,W 86-75 (OT),265,33,88,.375,24,50,.480,9,38,.237,11,12,.917,86,30,82,.366,24,53,.453,6,29,.207,9,12,.750,75,2016-11-06,DAL,MIL
25,@,L 86-96 ,240,32,76,.421,27,51,.529,5,25,.200,17,21,.810,86,36,81,.444,27,61,.443,9,20,.450,15,19,.789,96,2016-11-11,DET,SAS
26,@,L 86-110 ,240,31,83,.373,22,51,.431,9,32,.281,15,19,.789,86,43,84,.512,37,59,.627,6,25,.240,18,20,.900,110,2016-11-17,PHI,MIN
27,@,L 86-88 ,240,25,82,.305,18,54,.333,7,28,.250,29,40,.725,86,31,87,.356,25,67,.373,6,20,.300,20,30,.667,88,2016-12-08,POR,MEM
28,@,L 86-103 ,240,35,86,.407,31,64,.484,4,22,.182,12,15,.800,86,37,81,.457,25,50,.500,12,31,.387,17,23,.739,103,2016-12-13,MEM,CLE
29,Home,L 86-98 ,240,26,72,.361,20,49,.408,6,23,.261,28,37,.757,86,35,82,.427,23,52,.442,12,30,.400,16,19,.842,98,2016-12-21,DET,MEM
30,@,L 86-91 ,240,36,87,.414,29,70,.414,7,17,.412,7,10,.700,86,35,73,.479,27,53,.509,8,20,.400,13,20,.650,91,2016-12-31,PHO,UTA
31,@,L 86-98 ,240,31,84,.369,24,57,.421,7,27,.259,17,21,.810,86,36,86,.419,27,56,.482,9,30,.300,17,25,.680,98,2017-01-08,MIA,LAC
32,@,L 86-102 ,240,28,82,.341,19,52,.365,9,30,.300,21,28,.750,86,40,93,.430,30,63,.476,10,30,.333,12,16,.750,102,2017-01-11,CLE,POR
33,@,L 86-96 ,240,33,85,.388,30,65,.462,3,20,.150,17,21,.810,86,39,86,.453,34,68,.500,5,18,.278,13,14,.929,96,2017-01-13,OKC,MIN
34,Home,L 86-112 ,240,32,81,.395,27,56,.482,5,25,.200,17,18,.944,86,45,95,.474,36,73,.493,9,22,.409,13,16,.813,112,2017-01-23,BRK,SAS
35,Home,L 86-112 ,240,30,83,.361,21,52,.404,9,31,.290,17,25,.680,86,43,89,.483,30,58,.517,13,31,.419,13,19,.684,112,2017-01-27,ATL,WAS
36,@,L 86-102 ,240,31,80,.388,24,57,.421,7,23,.304,17,24,.708,86,37,84,.440,27,59,.458,10,25,.400,18,23,.783,102,2017-01-27,MIL,TOR
37,@,L 86-102 ,240,30,88,.341,21,63,.333,9,25,.360,17,23,.739,86,38,89,.427,32,68,.471,6,21,.286,20,27,.741,102,2017-02-02,PHI,SAS
38,@,L 86-113 ,240,27,78,.346,20,51,.392,7,27,.259,25,28,.893,86,41,78,.526,31,50,.620,10,28,.357,21,27,.778,113,2017-02-04,ORL,ATL
39,@,L 86-109 ,240,33,89,.371,26,65,.400,7,24,.292,13,17,.765,86,41,84,.488,28,48,.583,13,36,.361,14,21,.667,109,2017-02-15,SAC,GSW
40,@,L 86-105 ,240,32,85,.376,24,60,.400,8,25,.320,14,26,.538,86,37,81,.457,29,54,.537,8,27,.296,23,24,.958,105,2017-02-25,ATL,ORL
41,@,L 86-109 ,240,40,103,.388,37,80,.463,3,23,.130,3,17,.176,86,39,78,.500,30,53,.566,9,25,.360,22,23,.957,109,2017-03-01,DET,NOP
42,Home,L 86-99 ,240,37,84,.440,31,54,.574,6,30,.200,6,9,.667,86,37,84,.440,27,55,.491,10,29,.345,15,19,.789,99,2017-03-08,GSW,BOS
43,@,W 85-84 ,240,35,79,.443,33,63,.524,2,16,.125,13,21,.619,85,32,81,.395,27,56,.482,5,25,.200,15,19,.789,84,2011-12-26,NOH,PHO
44,Home,L 85-90 ,240,36,79,.456,30,64,.469,6,15,.400,7,13,.538,85,32,81,.395,25,65,.385,7,16,.438,19,22,.864,90,2011-12-28,TOR,IND
45,@,L 85-105 ,240,35,93,.376,33,76,.434,2,17,.118,13,20,.650,85,43,85,.506,34,59,.576,9,26,.346,10,13,.769,105,2011-12-29,SAS,HOU
46,@,L 85-96 ,240,34,79,.430,31,63,.492,3,16,.188,14,15,.933,85,35,67,.522,28,51,.549,7,16,.438,19,19,1.000,96,2011-12-30,DET,BOS
47,Home,L 85-90 ,240,28,78,.359,18,43,.419,10,35,.286,19,25,.760,85,30,68,.441,23,51,.451,7,17,.412,23,29,.793,90,2012-01-02,NYK,TOR
48,Home,W 85-73 ,240,32,66,.485,29,53,.547,3,13,.231,18,28,.643,85,29,95,.305,27,74,.365,2,21,.095,13,16,.813,73,2012-01-03,UTA,MIL
49,@,L 85-103 ,240,34,93,.366,32,81,.395,2,12,.167,15,18,.833,85,39,85,.459,31,66,.470,8,19,.421,17,25,.680,103,2012-01-04,WAS,ORL
50,Home,L 85-97 ,240,33,73,.452,27,56,.482,6,17,.353,13,19,.684,85,31,80,.388,16,49,.327,15,31,.484,20,27,.741,97,2012-01-06,TOR,NJN
51,@,L 85-94 ,240,33,80,.413,29,63,.460,4,17,.235,15,21,.714,85,36,71,.507,34,63,.540,2,8,.250,20,30,.667,94,2012-01-06,MEM,UTA
52,@,L 85-112 ,240,34,86,.395,30,67,.448,4,19,.211,13,21,.619,85,47,83,.566,42,70,.600,5,13,.385,13,19,.684,112,2012-01-10,SAC,PHI
53,Home,L 85-90 ,240,29,64,.453,25,53,.472,4,11,.364,23,32,.719,85,35,79,.443,29,63,.460,6,16,.375,14,25,.560,90,2012-01-11,BOS,DAL
54,Home,L 85-95 ,240,36,80,.450,35,64,.547,1,16,.063,12,17,.706,85,35,73,.479,28,53,.528,7,20,.350,18,26,.692,95,2012-01-11,NOH,OKC
55,Home,W 85-79 ,240,32,77,.416,26,55,.473,6,22,.273,15,19,.789,85,32,81,.395,29,66,.439,3,15,.200,12,18,.667,79,2012-01-11,NYK,PHI
56,@,L 85-93 ,240,35,79,.443,30,68,.441,5,11,.455,10,21,.476,85,30,75,.400,22,52,.423,8,23,.348,25,34,.735,93,2012-01-18,DET,MIN
57,@,W 85-83 (OT),265,36,84,.429,34,67,.507,2,17,.118,11,18,.611,85,29,87,.333,25,66,.379,4,21,.190,21,27,.778,83,2012-01-18,SAS,ORL
58,@,L 85-92 ,240,34,68,.500,28,52,.538,6,16,.375,11,17,.647,85,32,70,.457,27,52,.519,5,18,.278,23,26,.885,92,2012-01-24,CLE,MIA
59,Home,L 85-106 ,240,31,64,.484,21,41,.512,10,23,.435,13,29,.448,85,45,88,.511,37,71,.521,8,17,.471,8,11,.727,106,2012-01-29,ORL,IND
60,@,W 85-81 ,240,29,72,.403,20,47,.426,9,25,.360,18,23,.783,85,29,85,.341,25,63,.397,4,22,.182,19,21,.905,81,2012-02-04,ORL,IND
61,Home,W 85-80 ,240,35,94,.372,31,83,.373,4,11,.364,11,15,.733,85,31,79,.392,27,60,.450,4,19,.211,14,19,.737,80,2012-02-08,MEM,MIN
62,@,L 85-92 ,240,30,80,.375,24,56,.429,6,24,.250,19,23,.826,85,33,77,.429,28,56,.500,5,21,.238,21,34,.618,92,2012-02-10,LAL,NYK
63,@,L 85-111 ,240,32,90,.356,29,77,.377,3,13,.231,18,24,.750,85,42,77,.545,37,63,.587,5,14,.357,22,34,.647,111,2012-02-14,UTA,OKC
64,@,L 85-100 ,240,33,87,.379,29,69,.420,4,18,.222,15,20,.750,85,39,77,.506,32,53,.604,7,24,.292,15,17,.882,100,2012-02-15,SAC,NYK
65,Home,L 85-89 ,240,31,75,.413,27,51,.529,4,24,.167,19,29,.655,85,32,75,.427,25,63,.397,7,12,.583,18,23,.783,89,2012-02-17,NYK,NOH
66,@,L 85-94 ,240,33,90,.367,27,69,.391,6,21,.286,13,17,.765,85,33,76,.434,24,47,.511,9,29,.310,19,26,.731,94,2012-02-17,MIL,ORL
67,Home,L 85-97 ,240,33,84,.393,30,71,.423,3,13,.231,16,27,.593,85,34,85,.400,24,63,.381,10,22,.455,19,25,.760,97,2012-02-18,CHI,NJN
68,@,L 85-101 ,240,32,81,.395,27,67,.403,5,14,.357,16,20,.800,85,37,72,.514,27,53,.509,10,19,.526,17,24,.708,101,2012-02-19,UTA,HOU
69,Home,L 85-92 ,240,29,85,.341,24,62,.387,5,23,.217,22,33,.667,85,33,86,.384,26,67,.388,7,19,.368,19,24,.792,92,2012-02-19,NJN,MIL
70,@,L 85-100 ,240,30,78,.385,26,65,.400,4,13,.308,21,23,.913,85,36,77,.468,29,52,.558,7,25,.280,21,25,.840,100,2012-02-23,LAL,OKC
71,@,L 85-88 ,240,35,75,.467,33,58,.569,2,17,.118,13,18,.722,85,29,75,.387,22,55,.400,7,20,.350,23,28,.821,88,2012-02-28,TOR,HOU
72,@,W 85-82 ,240,34,83,.410,33,71,.465,1,12,.083,16,17,.941,85,31,92,.337,27,74,.365,4,18,.222,16,26,.615,82,2012-02-29,GSW,ATL
73,@,L 85-104 ,240,35,89,.393,30,70,.429,5,19,.263,10,18,.556,85,41,84,.488,36,63,.571,5,21,.238,17,22,.773,104,2012-02-29,MIN,LAL
74,@,L 85-96 ,240,35,79,.443,31,56,.554,4,23,.174,11,14,.786,85,39,80,.488,37,68,.544,2,12,.167,16,19,.842,96,2012-02-29,DAL,MEM
75,@,L 85-95 ,240,32,84,.381,26,61,.426,6,23,.261,15,23,.652,85,31,80,.388,24,54,.444,7,26,.269,26,30,.867,95,2012-03-06,NYK,DAL
76,@,L 85-88 (OT),265,34,81,.420,31,59,.525,3,22,.136,14,17,.824,85,37,93,.398,34,83,.410,3,10,.300,11,12,.917,88,2012-03-06,LAL,DET
77,@,L 85-86 ,240,31,73,.425,23,54,.426,8,19,.421,15,22,.682,85,38,68,.559,37,60,.617,1,8,.125,9,15,.600,86,2012-03-09,ATL,DET
78,Home,L 85-94 ,240,31,83,.373,26,60,.433,5,23,.217,18,21,.857,85,33,67,.493,28,54,.519,5,13,.385,23,27,.852,94,2012-03-12,LAC,BOS
79,@,W 85-59 ,240,35,79,.443,28,61,.459,7,18,.389,8,11,.727,85,24,68,.353,20,48,.417,4,20,.200,7,18,.389,59,2012-03-19,CHI,ORL
80,@,W 85-83 ,240,31,74,.419,27,56,.482,4,18,.222,19,28,.679,85,30,71,.423,25,53,.472,5,18,.278,18,23,.783,83,2012-03-22,IND,WAS
81,@,L 85-101 ,240,33,78,.423,24,63,.381,9,15,.600,10,14,.714,85,36,72,.500,31,56,.554,5,16,.313,24,33,.727,101,2012-03-24,MEM,LAC
82,@,L 85-97 ,240,31,62,.500,29,51,.569,2,11,.182,21,31,.677,85,37,74,.500,29,48,.604,8,26,.308,15,21,.714,97,2012-03-26,NOH,LAC
83,@,L 85-103 ,240,28,70,.400,19,47,.404,9,23,.391,20,28,.714,85,45,92,.489,35,73,.479,10,19,.526,3,5,.600,103,2012-03-27,CLE,PHI
84,@,L 85-106 ,240,33,78,.423,24,54,.444,9,24,.375,10,13,.769,85,39,80,.488,34,63,.540,5,17,.294,23,27,.852,106,2012-03-29,DAL,MIA
85,@,L 85-88 ,240,39,92,.424,37,82,.451,2,10,.200,5,10,.500,85,32,77,.416,25,55,.455,7,22,.318,17,22,.773,88,2012-03-31,NOH,LAL
86,@,L 85-95 ,240,35,83,.422,28,67,.418,7,16,.438,8,14,.571,85,40,80,.500,36,65,.554,4,15,.267,11,16,.688,95,2012-04-04,MEM,DAL
87,Home,L 85-93 ,240,35,84,.417,31,67,.463,4,17,.235,11,15,.733,85,36,80,.450,31,61,.508,5,19,.263,16,24,.667,93,2012-04-05,SAC,LAC
88,Home,L 85-113 ,240,32,82,.390,29,73,.397,3,9,.333,18,22,.818,85,40,83,.482,29,58,.500,11,25,.440,22,26,.846,113,2012-04-09,CHA,WAS
89,@,L 85-94 ,240,34,84,.405,30,66,.455,4,18,.222,13,18,.722,85,37,74,.500,33,61,.541,4,13,.308,16,20,.800,94,2012-04-09,LAC,MEM
90,@,L 85-93 ,240,34,93,.366,23,58,.397,11,35,.314,6,10,.600,85,39,78,.500,36,63,.571,3,15,.200,12,15,.800,93,2012-04-10,ORL,WAS
91,Home,L 85-109 ,240,31,70,.443,25,59,.424,6,11,.545,17,23,.739,85,43,82,.524,38,69,.551,5,13,.385,18,21,.857,109,2012-04-12,CHA,DET
92,@,L 85-96 ,240,33,73,.452,31,62,.500,2,11,.182,17,21,.810,85,38,69,.551,32,56,.571,6,13,.462,14,21,.667,96,2012-04-13,UTA,NOH
93,Home,L 85-93 ,240,31,73,.425,22,43,.512,9,30,.300,14,23,.609,85,36,78,.462,32,61,.525,4,17,.235,17,21,.810,93,2012-04-15,NYK,MIA
94,@,W 85-80 ,240,34,75,.453,32,67,.478,2,8,.250,15,21,.714,85,32,79,.405,29,70,.414,3,9,.333,13,18,.722,80,2012-04-20,MEM,CHA
95,Home,L 85-96 ,240,34,77,.442,30,60,.500,4,17,.235,13,18,.722,85,40,91,.440,36,75,.480,4,16,.250,12,16,.750,96,2012-04-25,CLE,WAS
96,Home,L 85-90 ,240,36,81,.444,30,65,.462,6,16,.375,7,9,.778,85,36,101,.356,31,85,.365,5,16,.313,13,18,.722,90,2012-04-25,MIL,PHI
97,Home,L 85-87 ,240,32,80,.400,28,59,.475,4,21,.190,17,22,.773,85,33,86,.384,28,69,.406,5,17,.294,16,23,.696,87,2012-10-31,PHO,GSW
98,Home,L 85-95 (OT),265,34,96,.354,29,70,.414,5,26,.192,12,18,.667,85,39,93,.419,29,69,.420,10,24,.417,7,12,.583,95,2012-11-03,HOU,POR
99,@,L 85-93 ,240,31,76,.408,22,49,.449,9,27,.333,14,15,.933,85,35,94,.372,29,75,.387,6,19,.316,17,23,.739,93,2012-11-09,HOU,MEM
0,@,L 85-89 ,240,35,79,.443,25,55,.455,10,24,.417,5,7,.714,85,34,80,.425,27,64,.422,7,16,.438,14,24,.583,89,2012-11-10,WAS,IND
1,@,L 85-99 ,240,30,80,.375,25,60,.417,5,20,.250,20,31,.645,85,38,91,.418,35,75,.467,3,16,.188,20,25,.800,99,2012-11-14,IND,MIL
2,@,L 85-96 ,240,33,86,.384,28,59,.475,5,27,.185,14,19,.737,85,33,78,.423,27,57,.474,6,21,.286,24,29,.828,96,2012-11-24,MIN,GSW
3,@,L 85-98 ,240,34,78,.436,27,61,.443,7,17,.412,10,13,.769,85,39,92,.424,34,75,.453,5,17,.294,15,21,.714,98,2012-11-25,POR,BRK
4,@,L 85-95 ,240,34,93,.366,29,75,.387,5,18,.278,12,16,.750,85,34,87,.391,26,68,.382,8,19,.421,19,27,.704,95,2012-11-30,MIL,MIN
5,Home,L 85-95 ,240,31,85,.365,26,69,.377,5,16,.313,18,25,.720,85,34,72,.472,30,57,.526,4,15,.267,23,27,.852,95,2012-12-05,CLE,CHI
6,@,L 85-93 ,240,27,84,.321,19,61,.311,8,23,.348,23,28,.821,85,34,78,.436,27,65,.415,7,13,.538,18,18,1.000,93,2012-12-08,NYK,CHI
7,@,L 85-98 ,240,32,86,.372,29,67,.433,3,19,.158,18,21,.857,85,39,96,.406,33,79,.418,6,17,.353,14,24,.583,98,2012-12-12,SAC,MIL
8,@,L 85-95 ,240,35,81,.432,32,69,.464,3,12,.250,12,16,.750,85,35,77,.455,27,63,.429,8,14,.571,17,27,.630,95,2012-12-14,PHI,IND
9,@,L 85-99 ,240,34,92,.370,27,72,.375,7,20,.350,10,11,.909,85,41,86,.477,32,65,.492,9,21,.429,8,11,.727,99,2012-12-14,GSW,ORL
10,Home,L 85-111 ,240,30,83,.361,23,62,.371,7,21,.333,18,25,.720,85,44,82,.537,39,71,.549,5,11,.455,18,24,.750,111,2012-12-15,MIL,LAC
11,@,L 85-97 ,240,33,79,.418,25,57,.439,8,22,.364,11,16,.688,85,37,87,.425,30,64,.469,7,23,.304,16,24,.667,97,2012-12-21,SAC,LAC
12,Home,L 85-106 ,240,33,88,.375,28,63,.444,5,25,.200,14,21,.667,85,43,94,.457,31,66,.470,12,28,.429,8,14,.571,106,2012-12-28,DAL,DEN
13,@,L 85-104 ,240,33,76,.434,29,63,.460,4,13,.308,15,24,.625,85,40,98,.408,32,77,.416,8,21,.381,16,17,.941,104,2012-12-29,MIA,MIL
14,@,L 85-89 ,240,36,85,.424,32,68,.471,4,17,.235,9,11,.818,85,34,76,.447,26,53,.491,8,23,.348,13,16,.813,89,2012-12-29,PHI,POR
15,Home,W 85-84 ,240,35,85,.412,32,70,.457,3,15,.200,12,21,.571,85,31,75,.413,21,46,.457,10,29,.345,12,20,.600,84,2013-01-04,DET,ATL
16,@,L 85-109 ,240,34,84,.405,23,60,.383,11,24,.458,6,8,.750,85,39,75,.520,29,58,.500,10,17,.588,21,27,.778,109,2013-01-04,PHI,OKC
17,Home,W 85-69 ,240,34,78,.436,31,71,.437,3,7,.429,14,20,.700,85,29,85,.341,27,75,.360,2,10,.200,9,15,.600,69,2013-01-18,MEM,SAC
18,@,W 85-82 (OT),265,34,84,.405,34,79,.430,0,5,.000,17,28,.607,85,31,85,.365,28,71,.394,3,14,.214,17,21,.810,82,2013-01-19,MEM,CHI
19,Home,L 85-88 ,240,34,84,.405,28,63,.444,6,21,.286,11,17,.647,85,31,74,.419,19,50,.380,12,24,.500,14,20,.700,88,2013-01-21,NYK,BRK
20,Home,L 85-90 ,240,37,84,.440,33,70,.471,4,14,.286,7,11,.636,85,34,81,.420,31,63,.492,3,18,.167,19,26,.731,90,2013-01-21,PHI,SAS
21,Home,W 85-82 ,240,31,71,.437,28,57,.491,3,14,.214,20,26,.769,85,34,82,.415,30,69,.435,4,13,.308,10,14,.714,82,2013-01-23,CHI,DET
22,@,L 85-93 ,240,32,81,.395,26,69,.377,6,12,.500,15,21,.714,85,35,78,.449,28,60,.467,7,18,.389,16,25,.640,93,2013-01-28,CHA,CHI
23,Home,L 85-105 ,240,31,69,.449,26,52,.500,5,17,.294,18,24,.750,85,43,83,.518,32,64,.500,11,19,.579,8,14,.571,105,2013-01-30,BRK,MIA
24,Home,W 85-76 ,240,35,78,.449,34,71,.479,1,7,.143,14,17,.824,85,34,83,.410,29,63,.460,5,20,.250,3,3,1.000,76,2013-02-01,MEM,WAS
25,Home,L 85-100 ,240,28,75,.373,24,57,.421,4,18,.222,25,32,.781,85,40,75,.533,37,63,.587,3,12,.250,17,23,.739,100,2013-02-03,TOR,MIA
26,@,L 85-99 ,240,38,90,.422,35,77,.455,3,13,.231,6,12,.500,85,36,79,.456,22,45,.489,14,34,.412,13,16,.813,99,2013-02-04,DET,NYK
27,@,L 85-91 ,240,35,85,.412,32,72,.444,3,13,.231,12,17,.706,85,36,83,.434,29,62,.468,7,21,.333,12,18,.667,91,2013-02-12,PHO,LAL
28,@,L 85-96 ,240,34,70,.486,31,59,.525,3,11,.273,14,22,.636,85,35,79,.443,26,61,.426,9,18,.500,17,25,.680,96,2013-02-13,WAS,DET
29,@,L 85-96 ,240,32,72,.444,27,57,.474,5,15,.333,16,23,.696,85,38,73,.521,32,58,.552,6,15,.400,14,14,1.000,96,2013-03-02,BRK,CHI
30,@,L 85-91 ,240,31,76,.408,25,56,.446,6,20,.300,17,28,.607,85,38,87,.437,34,75,.453,4,12,.333,11,18,.611,91,2013-03-06,POR,MEM
31,@,L 85-96 ,240,34,79,.430,32,67,.478,2,12,.167,15,17,.882,85,38,81,.469,34,68,.500,4,13,.308,16,20,.800,96,2013-03-09,NOH,MEM
32,Home,L 85-96 ,240,31,72,.431,25,46,.543,6,26,.231,17,18,.944,85,37,68,.544,31,56,.554,6,12,.500,16,21,.762,96,2013-03-13,LAC,MEM
33,Home,L 85-100 ,240,31,69,.449,25,49,.510,6,20,.300,17,22,.773,85,39,90,.433,31,62,.500,8,28,.286,14,18,.778,100,2013-03-26,BOS,NYK
34,@,L 85-104 ,240,35,86,.407,32,66,.485,3,20,.150,12,15,.800,85,39,79,.494,35,67,.522,4,12,.333,22,31,.710,104,2013-04-06,IND,WAS
35,@,L 85-91 ,240,34,90,.378,33,77,.429,1,13,.077,16,22,.727,85,32,89,.360,25,72,.347,7,17,.412,20,24,.833,91,2013-04-07,ORL,CLE
36,@,L 85-99 ,240,33,73,.452,30,58,.517,3,15,.200,16,25,.640,85,39,73,.534,30,55,.545,9,18,.500,12,17,.706,99,2013-04-07,CHI,DET
37,@,L 85-95 ,240,34,87,.391,25,58,.431,9,29,.310,8,12,.667,85,37,80,.463,33,71,.465,4,9,.444,17,24,.708,95,2013-04-13,MIL,CHA
38,Home,L 85-91 ,240,30,82,.366,22,55,.400,8,27,.296,17,24,.708,85,38,94,.404,33,73,.452,5,21,.238,10,14,.714,91,2013-11-01,LAL,SAS
39,@,L 85-96 ,240,31,80,.388,25,61,.410,6,19,.316,17,26,.654,85,38,87,.437,35,78,.449,3,9,.333,17,22,.773,96,2013-11-08,LAL,NOP
40,Home,L 85-96 ,240,36,78,.462,33,66,.500,3,12,.250,10,14,.714,85,36,82,.439,27,62,.435,9,20,.450,15,22,.682,96,2013-11-09,SAC,POR
41,Home,L 85-109 ,240,34,82,.415,29,63,.460,5,19,.263,12,16,.750,85,44,89,.494,31,61,.508,13,28,.464,8,11,.727,109,2013-11-11,PHI,SAS
42,@,L 85-109 ,240,32,99,.323,25,79,.316,7,20,.350,14,20,.700,85,41,72,.569,32,51,.627,9,21,.429,18,24,.750,109,2013-11-19,BOS,HOU
43,@,L 85-93 ,240,35,87,.402,29,65,.446,6,22,.273,9,12,.750,85,36,71,.507,32,56,.571,4,15,.267,17,24,.708,93,2013-11-20,DET,ATL
44,@,L 85-92 ,240,35,84,.417,31,65,.477,4,19,.211,11,15,.733,85,36,78,.462,28,61,.459,8,17,.471,12,20,.600,92,2013-11-30,BOS,MIL
45,@,L 85-94 ,240,30,75,.400,24,53,.453,6,22,.273,19,20,.950,85,36,86,.419,26,69,.377,10,17,.588,12,17,.706,94,2013-12-09,ORL,MEM
46,Home,L 85-88 ,240,39,89,.438,37,76,.487,2,13,.154,5,8,.625,85,30,77,.390,23,57,.404,7,20,.350,21,23,.913,88,2013-12-14,CHA,LAL
47,@,L 85-118 ,240,35,94,.372,32,76,.421,3,18,.167,12,15,.800,85,45,86,.523,35,60,.583,10,26,.385,18,24,.750,118,2013-12-20,UTA,ATL
48,Home,L 85-88 ,240,36,83,.434,34,71,.479,2,12,.167,11,16,.688,85,32,83,.386,22,62,.355,10,21,.476,14,18,.778,88,2013-12-21,CHA,UTA
49,Home,L 85-89 ,240,30,80,.375,21,57,.368,9,23,.391,16,20,.800,85,33,80,.413,25,55,.455,8,25,.320,15,24,.625,89,2013-12-27,CHA,OKC
50,@,W 85-79 ,240,29,69,.420,25,55,.455,4,14,.286,23,31,.742,85,30,82,.366,28,73,.384,2,9,.222,17,21,.810,79,2013-12-31,TOR,CHI
51,@,L 85-112 ,240,29,76,.382,23,55,.418,6,21,.286,21,22,.955,85,47,85,.553,36,51,.706,11,34,.324,7,10,.700,112,2014-01-01,CHA,LAC
52,@,L 85-89 ,240,32,86,.372,29,67,.433,3,19,.158,18,23,.783,85,33,81,.407,24,55,.436,9,26,.346,14,20,.700,89,2014-01-07,DET,NYK
53,@,L 85-101 ,240,32,81,.395,20,50,.400,12,31,.387,9,14,.643,85,35,86,.407,25,61,.410,10,25,.400,21,27,.778,101,2014-01-11,MIL,OKC
54,@,L 85-93 ,240,34,73,.466,27,53,.509,7,20,.350,10,14,.714,85,32,76,.421,25,53,.472,7,23,.304,22,32,.688,93,2014-01-22,DAL,TOR
55,@,W 85-79 ,240,33,84,.393,27,59,.458,6,25,.240,13,18,.722,85,28,75,.373,21,49,.429,7,26,.269,16,19,.842,79,2014-01-26,BRK,BOS
56,Home,L 85-88 ,240,30,80,.375,23,57,.404,7,23,.304,18,23,.783,85,34,90,.378,24,68,.353,10,22,.455,10,15,.667,88,2014-01-28,GSW,WAS
57,Home,L 85-89 ,240,33,76,.434,26,51,.510,7,25,.280,12,15,.800,85,34,74,.459,29,56,.518,5,18,.278,16,20,.800,89,2014-02-04,ATL,IND
58,@,L 85-100 ,240,35,80,.438,25,57,.439,10,23,.435,5,9,.556,85,43,85,.506,35,65,.538,8,20,.400,6,13,.462,100,2014-02-11,ATL,CHI
59,Home,L 85-114 ,240,31,87,.356,26,65,.400,5,22,.227,18,27,.667,85,40,87,.460,34,69,.493,6,18,.333,28,33,.848,114,2014-02-18,PHI,CLE
60,@,L 85-106 ,240,29,83,.349,27,62,.435,2,21,.095,25,27,.926,85,42,82,.512,37,57,.649,5,25,.200,17,25,.680,106,2014-02-21,SAS,PHO
61,@,L 85-96 ,240,32,83,.386,22,55,.400,10,28,.357,11,14,.786,85,35,83,.422,31,71,.437,4,12,.333,22,30,.733,96,2014-03-03,NYK,DET
62,@,W 85-77 ,240,35,78,.449,30,70,.429,5,8,.625,10,18,.556,85,31,75,.413,29,62,.468,2,13,.154,13,14,.929,77,2014-03-07,MEM,CHI
63,@,L 85-108 ,240,30,82,.366,25,64,.391,5,18,.278,20,31,.645,85,41,80,.513,29,55,.527,12,25,.480,14,17,.824,108,2014-03-11,DAL,GSW
64,Home,L 85-98 ,240,35,82,.427,26,57,.456,9,25,.360,6,9,.667,85,38,78,.487,33,60,.550,5,18,.278,17,22,.773,98,2014-03-12,WAS,CHA
65,@,L 85-119 ,240,31,91,.341,27,70,.386,4,21,.190,19,25,.760,85,48,98,.490,35,71,.493,13,27,.481,10,13,.769,119,2014-03-14,LAL,SAS
66,Home,L 85-97 ,240,29,84,.345,24,62,.387,5,22,.227,22,31,.710,85,31,75,.413,18,50,.360,13,25,.520,22,28,.786,97,2014-03-17,CHI,OKC
67,@,L 85-95 ,240,32,86,.372,25,60,.417,7,26,.269,14,17,.824,85,37,85,.435,31,68,.456,6,17,.353,15,22,.682,95,2014-03-25,POR,ORL
68,Home,L 85-100 ,240,34,84,.405,30,62,.484,4,22,.182,13,17,.765,85,37,80,.463,27,54,.500,10,26,.385,16,21,.762,100,2014-03-27,ATL,POR
69,@,L 85-98 ,240,35,73,.479,29,48,.604,6,25,.240,9,19,.474,85,36,78,.462,26,56,.464,10,22,.455,16,19,.842,98,2014-04-12,MIA,ATL
70,@,L 85-114 ,240,30,79,.380,22,54,.407,8,25,.320,17,23,.739,85,46,87,.529,38,67,.567,8,20,.400,14,17,.824,114,2014-04-16,BRK,CLE
71,@,L 85-116 ,240,32,82,.390,24,59,.407,8,23,.348,13,21,.619,85,44,84,.524,33,61,.541,11,23,.478,17,19,.895,116,2014-11-03,OKC,BRK
72,Home,L 85-89 ,240,33,74,.446,28,52,.538,5,22,.227,14,17,.824,85,33,83,.398,31,64,.484,2,19,.105,21,27,.778,89,2014-11-10,LAC,SAS
73,Home,L 85-91 ,240,36,83,.434,30,57,.526,6,26,.231,7,12,.583,85,27,71,.380,17,44,.386,10,27,.370,27,28,.964,91,2014-11-10,NYK,ATL
74,Home,W 85-78 ,240,33,81,.407,30,66,.455,3,15,.200,16,24,.667,85,29,87,.333,23,67,.343,6,20,.300,14,19,.737,78,2014-11-11,MIL,OKC
75,@,L 85-101 ,240,36,80,.450,34,61,.557,2,19,.105,11,14,.786,85,35,80,.438,25,56,.446,10,24,.417,21,27,.778,101,2014-11-14,MIL,ORL
76,Home,L 85-102 ,240,32,82,.390,22,45,.489,10,37,.270,11,15,.733,85,38,81,.469,29,56,.518,9,25,.360,17,22,.773,102,2014-11-28,HOU,LAC
77,Home,L 85-97 ,240,33,70,.471,32,59,.542,1,11,.091,18,27,.667,85,38,79,.481,35,66,.530,3,13,.231,18,28,.643,97,2014-11-30,SAC,MEM
78,@,W 85-77 ,240,32,82,.390,27,58,.466,5,24,.208,16,25,.640,85,30,84,.357,27,67,.403,3,17,.176,14,17,.824,77,2014-12-03,PHI,MIN
79,@,L 85-112 ,240,37,89,.416,34,74,.459,3,15,.200,8,13,.615,85,47,100,.470,37,78,.474,10,22,.455,8,17,.471,112,2014-12-04,NOP,GSW
80,@,L 85-109 ,240,30,68,.441,23,50,.460,7,18,.389,18,27,.667,85,39,69,.565,30,53,.566,9,16,.563,22,26,.846,109,2014-12-05,MIA,MIL
81,Home,L 85-95 ,240,34,88,.386,30,73,.411,4,15,.267,13,16,.813,85,40,90,.444,35,73,.479,5,17,.294,10,12,.833,95,2014-12-13,IND,POR
82,Home,L 85-110 ,240,28,77,.364,21,52,.404,7,25,.280,22,27,.815,85,44,86,.512,35,68,.515,9,18,.500,13,18,.722,110,2014-12-27,BRK,IND
83,Home,L 85-90 ,240,31,80,.388,19,50,.380,12,30,.400,11,14,.786,85,33,90,.367,24,61,.393,9,29,.310,15,19,.789,90,2014-12-27,MIL,ATL
84,@,L 85-114 ,240,37,86,.430,35,72,.486,2,14,.143,9,13,.692,85,41,79,.519,34,64,.531,7,15,.467,25,31,.806,114,2015-01-03,MEM,DEN
85,Home,L 85-92 ,240,33,74,.446,27,55,.491,6,19,.316,13,17,.765,85,38,79,.481,36,69,.522,2,10,.200,14,17,.824,92,2015-01-05,NOP,WAS
86,@,L 85-94 ,240,31,65,.477,28,58,.483,3,7,.429,20,27,.741,85,36,85,.424,24,54,.444,12,31,.387,10,10,1.000,94,2015-01-16,LAL,UTA
87,@,L 85-99 ,240,33,83,.398,28,70,.400,5,13,.385,14,20,.700,85,36,84,.429,29,60,.483,7,24,.292,20,27,.741,99,2015-01-23,LAL,SAS
88,Home,L 85-93 ,240,32,82,.390,29,67,.433,3,15,.200,18,24,.750,85,39,85,.459,29,68,.426,10,17,.588,5,7,.714,93,2015-01-28,NOP,DEN
89,@,L 85-91 ,240,31,81,.383,17,46,.370,14,35,.400,9,15,.600,85,34,78,.436,24,50,.480,10,28,.357,13,18,.722,91,2015-01-31,PHI,ATL
90,Home,W 85-74 ,240,34,91,.374,31,80,.388,3,11,.273,14,17,.824,85,27,78,.346,21,58,.362,6,20,.300,14,18,.778,74,2015-01-31,MEM,OKC
91,Home,L 85-105 ,240,28,75,.373,18,45,.400,10,30,.333,19,28,.679,85,40,91,.440,32,69,.464,8,22,.364,17,18,.944,105,2015-01-31,SAS,LAC
92,@,L 85-98 ,240,36,80,.450,31,64,.484,5,16,.313,8,9,.889,85,40,83,.482,29,54,.537,11,29,.379,7,9,.778,98,2015-02-06,MIA,SAS
93,Home,W 85-83 ,240,34,75,.453,30,63,.476,4,12,.333,13,21,.619,85,33,91,.363,28,63,.444,5,28,.179,12,17,.706,83,2015-02-08,SAC,PHO
94,Home,W 85-84 ,240,33,88,.375,25,61,.410,8,27,.296,11,20,.550,85,34,75,.453,31,56,.554,3,19,.158,13,21,.619,84,2015-03-04,BOS,UTA
95,Home,L 85-100 ,240,32,82,.390,29,64,.453,3,18,.167,18,25,.720,85,42,92,.457,34,72,.472,8,20,.400,8,10,.800,100,2015-03-04,MIN,DEN
96,@,L 85-88 ,240,38,93,.409,36,79,.456,2,14,.143,7,9,.778,85,37,90,.411,35,78,.449,2,12,.167,12,16,.750,88,2015-03-04,DET,NOP
97,@,L 85-112 ,240,29,78,.372,26,69,.377,3,9,.333,24,34,.706,85,45,85,.529,35,62,.565,10,23,.435,12,16,.750,112,2015-03-04,SAC,SAS
98,@,L 85-91 ,240,31,81,.383,22,53,.415,9,28,.321,14,22,.636,85,36,78,.462,26,58,.448,10,20,.500,9,15,.600,91,2015-03-07,WAS,MIL
99,@,L 85-93 ,240,32,84,.381,24,49,.490,8,35,.229,13,19,.684,85,32,75,.427,29,62,.468,3,13,.231,26,30,.867,93,2015-03-10,DET,LAL
0,@,L 85-88 ,240,32,84,.381,24,61,.393,8,23,.348,13,22,.591,85,33,69,.478,27,55,.491,6,14,.429,16,24,.667,88,2015-03-14,DET,UTA
1,Home,W 85-84 ,240,29,83,.349,21,58,.362,8,25,.320,19,26,.731,85,32,86,.372,28,66,.424,4,20,.200,16,21,.762,84,2015-03-17,NOP,MIL
2,Home,L 85-99 ,240,29,84,.345,21,55,.382,8,29,.276,19,27,.704,85,35,84,.417,21,50,.420,14,34,.412,15,22,.682,99,2015-03-25,DEN,PHI
3,@,L 85-87 ,240,29,74,.392,22,53,.415,7,21,.333,20,24,.833,85,30,69,.435,25,55,.455,5,14,.357,22,29,.759,87,2015-04-04,UTA,PHO
4,@,L 85-91 ,240,36,92,.391,28,63,.444,8,29,.276,5,7,.714,85,31,77,.403,24,53,.453,7,24,.292,22,26,.846,91,2015-04-15,ATL,CHI
5,Home,L 85-105 ,240,30,87,.345,22,52,.423,8,35,.229,17,26,.654,85,40,79,.506,27,52,.519,13,27,.481,12,18,.667,105,2015-10-28,HOU,DEN
6,@,L 85-102 ,240,30,86,.349,25,69,.362,5,17,.294,20,28,.714,85,39,97,.402,31,72,.431,8,25,.320,16,21,.762,102,2015-11-13,PHI,OKC
7,@,L 85-97 ,240,35,96,.365,28,69,.406,7,27,.259,8,15,.533,85,31,75,.413,25,56,.446,6,19,.316,29,39,.744,97,2015-11-15,DET,LAL
8,Home,L 85-100 ,240,28,77,.364,22,52,.423,6,25,.240,23,29,.793,85,39,82,.476,30,59,.508,9,23,.391,13,20,.650,100,2015-11-15,OKC,BOS
9,Home,L 85-112 ,240,35,76,.461,30,51,.588,5,25,.200,10,16,.625,85,42,92,.457,30,65,.462,12,27,.444,16,20,.800,112,2015-11-18,PHI,IND
10,Home,L 85-97 ,240,28,83,.337,19,53,.358,9,30,.300,20,23,.870,85,39,83,.470,32,55,.582,7,28,.250,12,16,.750,97,2015-12-01,CLE,WAS
11,@,W 85-74 ,240,38,88,.432,37,72,.514,1,16,.063,8,10,.800,85,28,84,.333,21,60,.350,7,24,.292,11,20,.550,74,2015-12-08,ORL,DEN
12,@,L 85-106 ,240,31,78,.397,23,57,.404,8,21,.381,15,27,.556,85,39,80,.488,30,59,.508,9,21,.429,19,23,.826,106,2015-12-09,NYK,UTA
13,@,L 85-98 ,240,32,76,.421,27,57,.474,5,19,.263,16,28,.571,85,38,86,.442,29,62,.468,9,24,.375,13,19,.684,98,2015-12-16,MEM,CHI
14,Home,L 85-100 ,240,32,78,.410,27,57,.474,5,21,.238,16,20,.800,85,38,80,.475,35,68,.515,3,12,.250,21,24,.875,100,2015-12-20,BRK,MIN
15,@,L 85-103 ,240,33,80,.413,26,60,.433,7,20,.350,12,14,.857,85,39,83,.470,30,60,.500,9,23,.391,16,16,1.000,103,2015-12-23,UTA,GSW
16,Home,L 85-120 ,240,32,89,.360,25,64,.391,7,25,.280,14,22,.636,85,51,95,.537,46,76,.605,5,19,.263,13,17,.765,120,2015-12-23,LAL,OKC
17,Home,L 85-95 ,240,33,84,.393,30,70,.429,3,14,.214,16,24,.667,85,32,75,.427,24,59,.407,8,16,.500,23,28,.821,95,2016-01-02,MIN,MIL
18,Home,L 85-95 ,240,35,77,.455,29,59,.492,6,18,.333,9,19,.474,85,35,90,.389,26,58,.448,9,32,.281,16,23,.696,95,2016-01-10,PHI,CLE
19,@,L 85-99 ,240,31,76,.408,23,57,.404,8,19,.421,15,22,.682,85,39,88,.443,28,62,.452,11,26,.423,10,15,.667,99,2016-01-13,UTA,POR
20,@,W 85-83 ,240,33,85,.388,28,58,.483,5,27,.185,14,21,.667,85,33,79,.418,23,56,.411,10,23,.435,7,14,.500,83,2016-01-27,LAC,ATL
21,Home,W 85-81 ,240,33,74,.446,28,52,.538,5,22,.227,14,20,.700,85,26,70,.371,22,52,.423,4,18,.222,25,33,.758,81,2016-02-03,UTA,DEN
22,Home,L 85-91 ,240,30,80,.375,20,51,.392,10,29,.345,15,17,.882,85,33,76,.434,29,58,.500,4,18,.222,21,24,.875,91,2016-02-05,NYK,MEM
23,@,L 85-98 ,240,28,76,.368,25,56,.446,3,20,.150,26,32,.813,85,33,81,.407,26,53,.491,7,28,.250,25,31,.806,98,2016-02-21,MEM,TOR
24,Home,L 85-104 ,240,33,88,.375,27,67,.403,6,21,.286,13,18,.722,85,37,88,.420,25,58,.431,12,30,.400,18,20,.900,104,2016-03-01,NYK,POR
25,@,L 85-93 ,240,31,81,.383,29,63,.460,2,18,.111,21,25,.840,85,34,85,.400,30,61,.492,4,24,.167,21,25,.840,93,2016-03-12,OKC,SAS
26,@,L 85-94 ,240,35,88,.398,25,45,.556,10,43,.233,5,8,.625,85,35,71,.493,23,44,.523,12,27,.444,12,14,.857,94,2016-03-14,CLE,UTA
27,@,L 85-121 ,240,36,91,.396,29,72,.403,7,19,.368,6,10,.600,85,46,91,.505,28,54,.519,18,37,.486,11,12,.917,121,2016-03-16,NYK,GSW
28,@,L 85-92 ,240,35,86,.407,27,59,.458,8,27,.296,7,12,.583,85,39,80,.488,33,61,.541,6,19,.316,8,11,.727,92,2016-03-19,UTA,CHI
29,Home,L 85-94 ,240,34,65,.523,31,57,.544,3,8,.375,14,17,.824,85,34,83,.410,21,45,.467,13,38,.342,13,14,.929,94,2016-03-20,MIL,UTA
30,Home,L 85-100 ,240,30,96,.313,14,52,.269,16,44,.364,9,10,.900,85,38,87,.437,31,62,.500,7,25,.280,17,18,.944,100,2016-03-29,PHI,CHO
31,@,L 85-98 ,240,35,79,.443,26,56,.464,9,23,.391,6,10,.600,85,38,72,.528,30,50,.600,8,22,.364,14,23,.609,98,2016-04-01,MIN,UTA
32,@,W 85-83 ,240,34,84,.405,29,64,.453,5,20,.250,12,20,.600,85,34,87,.391,27,65,.415,7,22,.318,8,18,.444,83,2016-11-02,OKC,LAC
33,@,L 85-97 ,240,31,84,.369,27,67,.403,4,17,.235,19,22,.864,85,37,85,.435,28,57,.491,9,28,.321,14,17,.824,97,2016-11-07,MIA,OKC
34,@,W 85-77 ,240,33,90,.367,28,73,.384,5,17,.294,14,16,.875,85,30,78,.385,25,53,.472,5,25,.200,12,14,.857,77,2016-11-17,CHI,UTA
35,Home,L 85-96 ,240,34,84,.405,27,57,.474,7,27,.259,10,14,.714,85,36,85,.424,31,65,.477,5,20,.250,19,22,.864,96,2016-11-23,IND,ATL
36,Home,L 85-109 ,240,32,90,.356,27,68,.397,5,22,.227,16,23,.696,85,43,83,.518,32,55,.582,11,28,.393,12,17,.706,109,2016-11-25,LAL,GSW
37,Home,L 85-98 ,240,32,79,.405,26,53,.491,6,26,.231,15,21,.714,85,34,85,.400,27,63,.429,7,22,.318,23,25,.920,98,2016-11-25,PHO,MIN
38,Home,L 85-104 ,240,36,89,.404,29,60,.483,7,29,.241,6,13,.462,85,36,82,.439,27,56,.482,9,26,.346,23,31,.742,104,2016-11-28,MEM,CHO
39,Home,L 85-121 ,240,32,88,.364,26,64,.406,6,24,.250,15,20,.750,85,48,89,.539,31,60,.517,17,29,.586,8,12,.667,121,2016-12-02,ATL,DET
40,@,L 85-92 ,240,31,76,.408,24,44,.545,7,32,.219,16,24,.667,85,35,78,.449,29,59,.492,6,19,.316,16,17,.941,92,2016-12-08,DEN,WAS
41,Home,L 85-95 ,240,32,78,.410,24,53,.453,8,25,.320,13,16,.813,85,36,71,.507,31,54,.574,5,17,.294,18,22,.818,95,2016-12-14,DAL,DET
42,@,L 85-93 ,240,28,75,.373,19,50,.380,9,25,.360,20,31,.645,85,35,81,.432,23,58,.397,12,23,.522,11,16,.688,93,2016-12-14,CLE,MEM
43,@,L 85-90 ,240,34,81,.420,25,56,.446,9,25,.360,8,10,.800,85,32,83,.386,26,58,.448,6,25,.240,20,28,.714,90,2016-12-26,IND,CHI
44,@,L 85-102 ,240,30,75,.400,26,54,.481,4,21,.190,21,25,.840,85,36,89,.404,23,55,.418,13,34,.382,17,20,.850,102,2017-01-07,CHO,SAS
45,@,L 85-107 ,240,33,94,.351,25,63,.397,8,31,.258,11,11,1.000,85,41,87,.471,30,61,.492,11,26,.423,14,17,.824,107,2017-01-18,POR,CHO
46,@,L 85-90 ,240,32,76,.421,19,38,.500,13,38,.342,8,9,.889,85,32,84,.381,20,52,.385,12,32,.375,14,19,.737,90,2017-02-15,CHO,TOR
47,Home,L 85-99 ,240,31,79,.392,20,51,.392,11,28,.393,12,15,.800,85,34,85,.400,20,47,.426,14,38,.368,17,18,.944,99,2017-02-25,SAC,CHO
48,Home,L 84-85 ,240,32,81,.395,27,56,.482,5,25,.200,15,19,.789,84,35,79,.443,33,63,.524,2,16,.125,13,21,.619,85,2011-12-26,PHO,NOH
49,Home,L 84-90 ,240,31,74,.419,30,67,.448,1,7,.143,21,34,.618,84,34,86,.395,28,60,.467,6,26,.231,16,20,.800,90,2011-12-26,WAS,NJN
50,@,L 84-95 ,240,35,80,.438,31,64,.484,4,16,.250,10,16,.625,84,38,82,.463,29,63,.460,9,19,.474,10,13,.769,95,2011-12-31,ATL,HOU
51,@,L 84-96 ,240,30,80,.375,25,67,.373,5,13,.385,19,27,.704,84,39,85,.459,33,71,.465,6,14,.429,12,16,.750,96,2012-01-11,ATL,IND
52,@,L 84-93 ,240,33,78,.423,30,66,.455,3,12,.250,15,22,.682,84,32,71,.451,27,58,.466,5,13,.385,24,31,.774,93,2012-01-16,TOR,ATL
53,@,W 84-77 ,240,34,72,.472,28,52,.538,6,20,.300,10,15,.667,84,28,68,.412,28,59,.475,0,9,.000,21,28,.750,77,2012-01-16,POR,NOH
54,Home,L 84-94 ,240,30,82,.366,25,67,.373,5,15,.333,19,25,.760,84,33,82,.402,28,67,.418,5,15,.333,23,31,.742,94,2012-01-20,TOR,POR
55,@,W 84-74 ,240,32,77,.416,28,60,.467,4,17,.235,16,24,.667,84,27,87,.310,24,64,.375,3,23,.130,17,19,.895,74,2012-01-21,OKC,NJN
56,@,L 84-97 ,240,34,90,.378,31,76,.408,3,14,.214,13,17,.765,84,31,72,.431,26,50,.520,5,22,.227,30,36,.833,97,2012-01-24,MEM,POR
57,@,L 84-97 ,240,34,89,.382,29,63,.460,5,26,.192,11,15,.733,84,38,77,.494,34,65,.523,4,12,.333,17,22,.773,97,2012-01-28,NYK,HOU
58,@,L 84-86 ,240,33,76,.434,32,73,.438,1,3,.333,17,20,.850,84,32,88,.364,27,70,.386,5,18,.278,17,24,.708,86,2012-01-28,MEM,PHO
59,Home,L 84-89 ,240,31,83,.373,27,70,.386,4,13,.308,18,21,.857,84,34,73,.466,27,57,.474,7,16,.438,14,21,.667,89,2012-02-06,MEM,SAS
60,@,L 84-94 ,240,32,71,.451,28,55,.509,4,16,.250,16,20,.800,84,41,81,.506,37,58,.638,4,23,.174,8,8,1.000,94,2012-02-07,CHA,BOS
61,@,L 84-86 ,240,31,82,.378,23,59,.390,8,23,.348,14,21,.667,84,32,79,.405,28,65,.431,4,14,.286,18,28,.643,86,2012-02-07,SAC,MIN
62,Home,L 84-99 ,240,31,84,.369,28,70,.400,3,14,.214,19,25,.760,84,35,79,.443,29,65,.446,6,14,.429,23,30,.767,99,2012-02-11,CLE,PHI
63,Home,L 84-98 ,240,27,77,.351,19,56,.339,8,21,.381,22,28,.786,84,39,78,.500,31,55,.564,8,23,.348,12,15,.800,98,2012-02-11,SAC,PHO
64,@,L 84-102 ,240,30,84,.357,24,57,.421,6,27,.222,18,31,.581,84,37,80,.463,27,54,.500,10,26,.385,18,22,.818,102,2012-02-15,DEN,DAL
65,@,L 84-102 ,240,30,76,.395,25,54,.463,5,22,.227,19,28,.679,84,35,83,.422,24,62,.387,11,21,.524,21,28,.750,102,2012-02-15,WAS,LAC
66,Home,L 84-89 ,240,27,85,.318,21,58,.362,6,27,.222,24,37,.649,84,36,89,.404,34,79,.430,2,10,.200,15,20,.750,89,2012-02-22,CLE,NOH
67,Home,L 84-95 ,240,30,80,.375,27,64,.422,3,16,.188,21,27,.778,84,34,77,.442,25,62,.403,9,15,.600,18,23,.783,95,2012-02-29,NOH,TOR
68,Home,L 84-102 ,240,33,81,.407,29,69,.420,4,12,.333,14,21,.667,84,35,80,.438,26,61,.426,9,19,.474,23,32,.719,102,2012-03-03,NOH,IND
69,@,L 84-100 ,240,31,80,.388,18,45,.400,13,35,.371,9,17,.529,84,38,80,.475,34,70,.486,4,10,.400,20,27,.741,100,2012-03-06,ORL,CHA
70,@,L 84-98 ,240,31,81,.383,30,71,.423,1,10,.100,21,25,.840,84,38,79,.481,31,62,.500,7,17,.412,15,17,.882,98,2012-03-14,TOR,NJN
71,@,W 84-78 ,240,35,74,.473,31,62,.500,4,12,.333,10,19,.526,84,33,93,.355,28,75,.373,5,18,.278,7,14,.500,78,2012-03-16,MIA,PHI
72,@,L 84-93 ,240,32,80,.400,26,55,.473,6,25,.240,14,21,.667,84,36,77,.468,29,56,.518,7,21,.333,14,20,.700,93,2012-03-23,NJN,ATL
73,Home,L 84-105 ,240,29,81,.358,24,60,.400,5,21,.238,21,35,.600,84,42,81,.519,37,67,.552,5,14,.357,16,18,.889,105,2012-03-26,NJN,UTA
74,@,L 84-100 ,240,35,77,.455,29,57,.509,6,20,.300,8,13,.615,84,40,82,.488,33,66,.500,7,16,.438,13,15,.867,100,2012-03-28,IND,NJN
75,Home,L 84-121 ,240,34,85,.400,28,63,.444,6,22,.273,10,19,.526,84,50,88,.568,40,72,.556,10,16,.625,11,18,.611,121,2012-03-30,CLE,MIL
76,@,W 84-80 ,240,25,73,.342,20,56,.357,5,17,.294,29,40,.725,84,31,73,.425,28,58,.483,3,15,.200,15,24,.625,80,2012-04-06,CLE,TOR
77,@,L 84-123 ,240,31,84,.369,19,59,.322,12,25,.480,10,14,.714,84,48,88,.545,39,70,.557,9,18,.500,18,24,.750,123,2012-04-09,GSW,DEN
78,@,L 84-91 ,240,35,87,.402,28,63,.444,7,24,.292,7,10,.700,84,31,73,.425,27,59,.458,4,14,.286,25,33,.758,91,2012-04-09,SAS,UTA
79,Home,L 84-98 ,240,33,81,.407,20,57,.351,13,24,.542,5,9,.556,84,40,89,.449,29,66,.439,11,23,.478,7,12,.583,98,2012-04-11,SAS,LAL
80,Home,W 84-79 ,240,25,72,.347,18,54,.333,7,18,.389,27,31,.871,84,30,80,.375,26,61,.426,4,19,.211,15,19,.789,79,2012-04-13,TOR,BOS
81,Home,L 84-100 ,240,28,75,.373,22,56,.393,6,19,.316,22,29,.759,84,36,79,.456,25,50,.500,11,29,.379,17,21,.810,100,2012-04-15,CLE,ORL
82,Home,L 84-87 ,240,32,84,.381,28,70,.400,4,14,.286,16,22,.727,84,34,89,.382,30,71,.423,4,18,.222,15,19,.789,87,2012-04-16,CHI,WAS
83,Home,L 84-91 ,240,26,73,.356,19,51,.373,7,22,.318,25,30,.833,84,40,91,.440,35,78,.449,5,13,.385,6,11,.545,91,2012-04-17,MIN,MEM
84,@,L 84-116 ,240,32,92,.348,25,67,.373,7,25,.280,13,19,.684,84,42,85,.494,34,57,.596,8,28,.286,24,29,.828,116,2012-04-18,DET,ATL
85,Home,L 84-86 ,240,31,77,.403,22,52,.423,9,25,.360,13,16,.813,84,36,87,.414,29,69,.420,7,18,.389,7,9,.778,86,2012-04-21,MIA,WAS
86,Home,L 84-104 ,240,32,74,.432,26,58,.448,6,16,.375,14,26,.538,84,44,85,.518,36,65,.554,8,20,.400,8,15,.533,104,2012-04-26,CHA,NYK
87,Home,W 84-77 ,240,32,91,.352,23,63,.365,9,28,.321,11,14,.786,84,27,68,.397,22,53,.415,5,15,.333,18,30,.600,77,2012-04-26,HOU,NOH
88,@,L 84-94 ,240,32,90,.356,24,58,.414,8,32,.250,12,20,.600,84,36,79,.456,29,59,.492,7,20,.350,15,22,.682,94,2012-10-30,WAS,CLE
89,Home,W 84-75 ,240,30,85,.353,23,60,.383,7,25,.280,17,21,.810,84,33,88,.375,29,70,.414,4,18,.222,5,11,.455,75,2012-10-31,PHI,DEN
90,@,L 84-86 ,240,29,77,.377,22,60,.367,7,17,.412,19,23,.826,84,35,79,.443,30,60,.500,5,19,.263,11,16,.688,86,2012-11-01,OKC,SAS
91,@,L 84-104 ,240,33,71,.465,26,51,.510,7,20,.350,11,13,.846,84,36,84,.429,17,48,.354,19,36,.528,13,15,.867,104,2012-11-02,MIA,NYK
92,@,L 84-100 ,240,34,79,.430,26,62,.419,8,17,.471,8,10,.800,84,39,77,.506,28,50,.560,11,27,.407,11,18,.611,100,2012-11-04,PHI,NYK
93,@,L 84-106 ,240,30,73,.411,22,50,.440,8,23,.348,16,24,.667,84,46,83,.554,40,66,.606,6,17,.353,8,9,.889,106,2012-11-07,SAS,LAC
94,@,L 84-104 ,240,32,87,.368,28,64,.438,4,23,.174,16,22,.727,84,40,92,.435,34,75,.453,6,17,.353,18,25,.720,104,2012-11-09,UTA,DEN
95,@,W 84-82 ,240,35,90,.389,28,70,.400,7,20,.350,7,11,.636,84,31,74,.419,25,54,.463,6,20,.300,14,22,.636,82,2012-11-13,SAS,LAL
96,@,L 84-102 ,240,33,85,.388,27,72,.375,6,13,.462,12,20,.600,84,40,75,.533,35,62,.565,5,13,.385,17,21,.810,102,2012-11-25,NOH,DEN
97,Home,W 84-78 ,240,33,71,.465,29,60,.483,4,11,.364,14,18,.778,84,31,76,.408,27,60,.450,4,16,.250,12,15,.800,78,2012-11-26,MEM,CLE
98,Home,L 84-96 ,240,31,73,.425,26,52,.500,5,21,.238,17,21,.810,84,31,63,.492,25,52,.481,6,11,.545,28,38,.737,96,2012-11-28,NOH,UTA
99,Home,W 84-82 ,240,31,71,.437,26,59,.441,5,12,.417,17,19,.895,84,30,86,.349,20,55,.364,10,31,.323,12,18,.667,82,2012-11-28,WAS,POR
0,@,L 84-99 ,240,33,82,.402,30,71,.423,3,11,.273,15,21,.714,84,38,83,.458,32,70,.457,6,13,.462,17,22,.773,99,2012-12-14,UTA,PHO
1,@,L 84-104 ,240,32,86,.372,30,71,.423,2,15,.133,18,25,.720,84,41,80,.513,32,64,.500,9,16,.563,13,18,.722,104,2012-12-19,UTA,IND
2,Home,L 84-87 ,240,32,84,.381,25,56,.446,7,28,.250,13,17,.765,84,33,81,.407,24,50,.480,9,31,.290,12,15,.800,87,2012-12-26,MIN,HOU
3,Home,L 84-87 ,240,35,76,.461,31,58,.534,4,18,.222,10,14,.714,84,31,82,.378,21,55,.382,10,27,.370,15,23,.652,87,2012-12-26,WAS,CLE
4,@,L 84-106 ,240,29,84,.345,27,67,.403,2,17,.118,24,30,.800,84,43,87,.494,39,75,.520,4,12,.333,16,19,.842,106,2013-01-02,MIN,UTA
5,@,L 84-85 ,240,31,75,.413,21,46,.457,10,29,.345,12,20,.600,84,35,85,.412,32,70,.457,3,15,.200,12,21,.571,85,2013-01-04,ATL,DET
6,Home,L 84-86 ,240,32,81,.395,30,76,.395,2,5,.400,18,18,1.000,84,33,81,.407,23,54,.426,10,27,.370,10,15,.667,86,2013-01-04,MEM,POR
7,@,L 84-106 ,240,31,72,.431,28,60,.467,3,12,.250,19,24,.792,84,36,76,.474,25,56,.446,11,20,.550,23,27,.852,106,2013-01-09,MIN,OKC
8,@,L 84-102 ,240,34,81,.420,31,67,.463,3,14,.214,13,16,.813,84,43,80,.538,34,59,.576,9,21,.429,7,13,.538,102,2013-01-25,UTA,LAL
9,@,L 84-92 ,240,30,75,.400,23,53,.434,7,22,.318,17,21,.810,84,40,95,.421,34,82,.415,6,13,.462,6,10,.600,92,2013-01-30,WAS,PHI
10,@,L 84-97 ,240,36,95,.379,33,76,.434,3,19,.158,9,9,1.000,84,42,84,.500,38,66,.576,4,18,.222,9,14,.643,97,2013-02-01,ORL,BOS
11,@,L 84-93 ,240,35,78,.449,34,63,.540,1,15,.067,13,15,.867,84,39,75,.520,35,61,.574,4,14,.286,11,17,.647,93,2013-02-06,PHO,NOH
12,Home,L 84-89 (OT),265,33,96,.344,28,74,.378,5,22,.227,13,18,.722,84,31,80,.388,27,68,.397,4,12,.333,23,32,.719,89,2013-02-11,IND,BRK
13,Home,L 84-90 ,240,29,79,.367,24,60,.400,5,19,.263,21,27,.778,84,34,81,.420,27,69,.391,7,12,.583,15,17,.882,90,2013-02-25,TOR,WAS
14,@,L 84-106 ,240,33,81,.407,27,65,.415,6,16,.375,12,14,.857,84,41,76,.539,29,54,.537,12,22,.545,12,26,.462,106,2013-02-26,CHA,LAC
15,Home,L 84-98 ,240,32,81,.395,25,60,.417,7,21,.333,13,18,.722,84,41,76,.539,36,63,.571,5,13,.385,11,16,.688,98,2013-02-26,PHI,ORL
16,Home,W 84-83 (OT),265,37,91,.407,32,78,.410,5,13,.385,5,14,.357,84,31,90,.344,26,71,.366,5,19,.263,16,25,.640,83,2013-02-26,PHO,MIN
17,@,L 84-90 ,240,33,76,.434,30,64,.469,3,12,.250,15,19,.789,84,29,78,.372,24,64,.375,5,14,.357,27,34,.794,90,2013-02-27,DAL,MEM
18,@,L 84-113 ,240,30,78,.385,22,52,.423,8,26,.308,16,21,.762,84,38,75,.507,25,43,.581,13,32,.406,24,30,.800,113,2013-03-09,UTA,NYK
19,@,L 84-90 ,240,33,77,.429,29,65,.446,4,12,.333,14,22,.636,84,31,71,.437,26,55,.473,5,16,.313,23,31,.742,90,2013-03-16,MEM,UTA
20,@,L 84-87 ,240,30,78,.385,25,64,.391,5,14,.357,19,24,.792,84,35,81,.432,32,70,.457,3,11,.273,14,22,.636,87,2013-03-23,IND,CHI
21,@,L 84-110 ,240,34,76,.447,30,53,.566,4,23,.174,12,18,.667,84,41,79,.519,34,60,.567,7,19,.368,21,23,.913,110,2013-03-23,TOR,NYK
22,@,L 84-98 ,240,35,90,.389,29,73,.397,6,17,.353,8,9,.889,84,40,90,.444,30,61,.492,10,29,.345,8,13,.615,98,2013-04-03,ORL,SAS
23,@,L 84-86 ,240,38,86,.442,35,72,.486,3,14,.214,5,7,.714,84,34,74,.459,29,54,.537,5,20,.250,13,18,.722,86,2013-04-05,MEM,LAL
24,Home,L 84-102 ,240,31,74,.419,29,64,.453,2,10,.200,20,33,.606,84,42,75,.560,33,58,.569,9,17,.529,9,13,.692,102,2013-04-15,ORL,CHI
25,@,L 84-90 ,240,32,84,.381,28,66,.424,4,18,.222,16,22,.727,84,33,73,.452,30,61,.492,3,12,.250,21,34,.618,90,2013-11-01,CLE,CHA
26,@,L 84-87 ,240,31,85,.365,26,68,.382,5,17,.294,17,27,.630,84,31,83,.373,25,61,.410,6,22,.273,19,24,.792,87,2013-11-01,UTA,PHO
27,@,L 84-105 ,240,30,80,.375,27,59,.458,3,21,.143,21,36,.583,84,37,75,.493,30,62,.484,7,13,.538,24,28,.857,105,2013-11-02,CHA,NOP
28,Home,L 84-99 ,240,34,71,.479,30,56,.536,4,15,.267,12,14,.857,84,38,78,.487,34,65,.523,4,13,.308,19,21,.905,99,2013-11-06,MEM,NOP
29,@,L 84-91 ,240,32,81,.395,26,63,.413,6,18,.333,14,16,.875,84,36,78,.462,30,57,.526,6,21,.286,13,16,.813,91,2013-11-08,TOR,IND
30,@,L 84-98 ,240,29,88,.330,26,69,.377,3,19,.158,23,28,.821,84,40,80,.500,32,65,.492,8,15,.533,10,17,.588,98,2013-11-25,MIN,IND
31,Home,L 84-95 ,240,29,83,.349,19,55,.345,10,28,.357,16,24,.667,84,35,72,.486,31,53,.585,4,19,.211,21,25,.840,95,2013-11-27,CLE,MIA
32,@,L 84-113 ,240,32,75,.427,24,53,.453,8,22,.364,12,15,.800,84,43,78,.551,29,51,.569,14,27,.519,13,21,.619,113,2013-11-27,ATL,HOU
33,@,L 84-90 ,240,33,77,.429,29,56,.518,4,21,.190,14,20,.700,84,34,67,.507,29,52,.558,5,15,.333,17,25,.680,90,2013-12-10,MIA,IND
34,Home,L 84-100 ,240,35,89,.393,29,69,.420,6,20,.300,8,11,.727,84,41,88,.466,33,68,.485,8,20,.400,10,12,.833,100,2013-12-14,UTA,SAS
35,@,L 84-100 ,240,36,90,.400,32,72,.444,4,18,.222,8,9,.889,84,37,69,.536,27,54,.500,10,15,.667,16,24,.667,100,2013-12-21,CLE,CHI
36,@,L 84-91 ,240,32,86,.372,24,58,.414,8,28,.286,12,14,.857,84,33,81,.407,27,64,.422,6,17,.353,19,24,.792,91,2014-01-04,ATL,CHI
37,Home,L 84-112 ,240,35,86,.407,31,69,.449,4,17,.235,10,20,.500,84,43,92,.467,35,77,.455,8,15,.533,18,22,.818,112,2014-01-05,DET,MEM
38,@,L 84-93 ,240,29,82,.354,27,71,.380,2,11,.182,24,28,.857,84,34,79,.430,26,58,.448,8,21,.381,17,22,.773,93,2014-02-09,SAC,WAS
39,@,L 84-91 ,240,29,80,.363,25,50,.500,4,30,.133,22,26,.846,84,31,70,.443,23,49,.469,8,21,.381,21,26,.808,91,2014-03-07,BRK,BOS
40,Home,W 84-83 ,240,30,81,.370,23,67,.343,7,14,.500,17,21,.810,84,28,61,.459,22,42,.524,6,19,.316,21,29,.724,83,2014-03-26,IND,MIA
41,Home,L 84-89 ,240,28,79,.354,18,48,.375,10,31,.323,18,22,.818,84,32,80,.400,23,55,.418,9,25,.360,16,18,.889,89,2014-03-30,GSW,NYK
42,@,L 84-101 ,240,32,84,.381,28,73,.384,4,11,.364,16,21,.762,84,41,101,.406,37,84,.440,4,17,.235,15,31,.484,101,2014-10-28,ORL,NOP
43,@,L 84-103 ,240,30,83,.361,27,64,.422,3,19,.158,21,32,.656,84,35,80,.438,26,58,.448,9,22,.409,24,31,.774,103,2014-11-07,WAS,TOR
44,Home,L 84-91 ,240,30,73,.411,19,48,.396,11,25,.440,13,22,.591,84,35,74,.473,30,56,.536,5,18,.278,16,26,.615,91,2014-11-16,MIA,MIL
45,Home,L 84-102 ,240,32,86,.372,30,72,.417,2,14,.143,18,24,.750,84,34,69,.493,27,45,.600,7,24,.292,27,34,.794,102,2014-11-30,BRK,CHI
46,@,L 84-96 ,240,34,93,.366,28,58,.483,6,35,.171,10,13,.769,84,36,87,.414,26,60,.433,10,27,.370,14,19,.737,96,2014-12-07,DEN,ATL
47,@,L 84-93 ,240,30,78,.385,25,61,.410,5,17,.294,19,28,.679,84,41,84,.488,37,71,.521,4,13,.308,7,12,.583,93,2014-12-14,UTA,WAS
48,@,L 84-100 ,240,33,83,.398,27,60,.450,6,23,.261,12,15,.800,84,37,78,.474,31,57,.544,6,21,.286,20,26,.769,100,2014-12-21,BOS,MIA
49,@,L 84-96 ,240,33,83,.398,29,63,.460,4,20,.200,14,19,.737,84,39,78,.500,34,63,.540,5,15,.333,13,18,.722,96,2014-12-23,NOP,IND
50,@,L 84-106 ,240,32,87,.368,30,72,.417,2,15,.133,18,28,.643,84,44,94,.468,39,73,.534,5,21,.238,13,15,.867,106,2014-12-31,SAC,BOS
51,@,L 84-88 ,240,34,86,.395,27,62,.435,7,24,.292,9,13,.692,84,31,67,.463,26,53,.491,5,14,.357,21,28,.750,88,2015-01-04,BRK,MIA
52,@,L 84-101 ,240,30,76,.395,24,62,.387,6,14,.429,18,23,.783,84,36,90,.400,29,69,.420,7,21,.333,22,31,.710,101,2015-01-09,ORL,LAL
53,@,L 84-98 ,240,32,79,.405,26,57,.456,6,22,.273,14,17,.824,84,39,75,.520,27,56,.482,12,19,.632,8,10,.800,98,2015-01-09,MIN,MIL
54,@,L 84-103 ,240,33,78,.423,22,46,.478,11,32,.344,7,12,.583,84,42,86,.488,36,69,.522,6,17,.353,13,17,.765,103,2015-01-11,CLE,SAC
55,@,L 84-100 ,240,31,80,.388,28,61,.459,3,19,.158,19,31,.613,84,38,82,.463,28,53,.528,10,29,.345,14,22,.636,100,2015-01-14,PHI,TOR
56,@,L 84-123 ,240,33,88,.375,29,67,.433,4,21,.190,14,25,.560,84,49,83,.590,38,58,.655,11,25,.440,14,21,.667,123,2015-01-22,BRK,LAC
57,Home,L 84-92 ,240,35,84,.417,33,75,.440,2,9,.222,12,17,.706,84,40,80,.500,37,76,.487,3,4,.750,9,14,.643,92,2015-01-23,MIN,NOP
58,Home,L 84-96 ,240,31,87,.356,24,63,.381,7,24,.292,15,19,.789,84,38,84,.452,37,71,.521,1,13,.077,19,23,.826,96,2015-01-25,CHI,MIA
59,@,L 84-92 ,240,29,85,.341,27,72,.375,2,13,.154,24,32,.750,84,36,86,.419,32,66,.485,4,20,.200,16,24,.667,92,2015-01-26,MIN,OKC
60,@,L 84-97 ,240,31,78,.397,19,45,.422,12,33,.364,10,14,.714,84,35,78,.449,23,51,.451,12,27,.444,15,22,.682,97,2015-02-02,PHI,CLE
61,Home,L 84-89 ,240,33,79,.418,26,55,.473,7,24,.292,11,14,.786,84,34,85,.400,27,56,.482,7,29,.241,14,19,.737,89,2015-02-09,PHI,GSW
62,@,L 84-95 ,240,29,69,.420,24,50,.480,5,19,.263,21,28,.750,84,44,88,.500,40,70,.571,4,18,.222,3,6,.500,95,2015-02-20,NOP,ORL
63,@,L 84-85 ,240,34,75,.453,31,56,.554,3,19,.158,13,21,.619,84,33,88,.375,25,61,.410,8,27,.296,11,20,.550,85,2015-03-04,UTA,BOS
64,@,L 84-98 ,240,31,86,.360,26,63,.413,5,23,.217,17,19,.895,84,34,80,.425,28,60,.467,6,20,.300,24,33,.727,98,2015-03-06,CHI,IND
65,@,L 84-92 ,240,30,77,.390,19,52,.365,11,25,.440,13,16,.813,84,35,95,.368,22,58,.379,13,37,.351,9,17,.529,92,2015-03-07,ATL,PHI
66,@,L 84-85 ,240,32,86,.372,28,66,.424,4,20,.200,16,21,.762,84,29,83,.349,21,58,.362,8,25,.320,19,26,.731,85,2015-03-17,MIL,NOP
67,Home,L 84-88 ,240,34,82,.415,30,60,.500,4,22,.182,12,24,.500,84,33,63,.524,27,52,.519,6,11,.545,16,23,.696,88,2015-03-18,UTA,WAS
68,Home,L 84-107 ,240,34,76,.447,29,63,.460,5,13,.385,11,15,.733,84,39,90,.433,23,59,.390,16,31,.516,13,17,.765,107,2015-03-27,MEM,GSW
69,Home,L 84-104 ,240,28,76,.368,22,60,.367,6,16,.375,22,27,.815,84,39,82,.476,29,49,.592,10,33,.303,16,18,.889,104,2015-03-30,MIN,UTA
70,@,L 84-98 ,240,33,95,.347,26,62,.419,7,33,.212,11,12,.917,84,37,77,.481,28,54,.519,9,23,.391,15,24,.625,98,2015-04-01,DEN,UTA
71,Home,L 84-97 ,240,29,64,.453,28,53,.528,1,11,.091,25,32,.781,84,40,92,.435,34,71,.479,6,21,.286,11,17,.647,97,2015-04-03,MIN,ORL
72,Home,L 84-94 ,240,32,89,.360,28,76,.368,4,13,.308,16,21,.762,84,39,79,.494,35,66,.530,4,13,.308,12,17,.706,94,2015-11-02,NYK,SAS
73,Home,L 84-96 ,240,28,72,.389,23,52,.442,5,20,.250,23,34,.676,84,37,85,.435,26,61,.426,11,24,.458,11,17,.647,96,2015-11-05,DEN,UTA
74,Home,L 84-96 ,240,30,85,.353,26,73,.356,4,12,.333,20,22,.909,84,37,76,.487,33,62,.532,4,14,.286,18,25,.720,96,2015-11-05,MIN,MIA
75,@,L 84-97 ,240,31,78,.397,21,45,.467,10,33,.303,12,17,.706,84,34,77,.442,23,52,.442,11,25,.440,18,22,.818,97,2015-11-09,ORL,IND
76,Home,L 84-100 ,240,24,70,.343,21,55,.382,3,15,.200,33,36,.917,84,36,75,.480,25,48,.521,11,27,.407,17,23,.739,100,2015-11-11,MEM,GSW
77,Home,L 84-90 ,240,29,79,.367,20,52,.385,9,27,.333,17,21,.810,84,33,78,.423,27,50,.540,6,28,.214,18,31,.581,90,2015-11-13,NYK,CLE
78,@,L 84-96 ,240,28,74,.378,22,45,.489,6,29,.207,22,37,.595,84,36,85,.424,28,61,.459,8,24,.333,16,19,.842,96,2015-11-20,HOU,MEM
79,@,L 84-98 ,240,34,73,.466,27,54,.500,7,19,.368,9,10,.900,84,42,82,.512,33,62,.532,9,20,.450,5,10,.500,98,2015-11-23,PHO,SAS
80,Home,W 84-80 ,240,31,91,.341,22,62,.355,9,29,.310,13,18,.722,84,31,83,.373,24,56,.429,7,27,.259,11,15,.733,80,2015-11-25,BOS,PHI
81,@,W 84-82 ,240,31,72,.431,20,48,.417,11,24,.458,11,14,.786,84,27,82,.329,20,59,.339,7,23,.304,21,27,.778,82,2015-11-28,TOR,WAS
82,@,L 84-92 ,240,30,77,.390,18,41,.439,12,36,.333,12,16,.750,84,34,81,.420,30,68,.441,4,13,.308,20,27,.741,92,2015-11-29,PHI,MEM
83,@,L 84-99 ,240,31,85,.365,25,57,.439,6,28,.214,16,24,.667,84,37,68,.544,30,52,.577,7,16,.438,18,29,.621,99,2015-12-05,CLE,MIA
84,@,L 84-104 ,240,32,87,.368,22,53,.415,10,34,.294,10,22,.455,84,36,84,.429,28,58,.483,8,26,.308,24,35,.686,104,2015-12-07,DET,CHO
85,@,L 84-96 ,240,30,77,.390,25,49,.510,5,28,.179,19,25,.760,84,37,83,.446,32,64,.500,5,19,.263,17,21,.810,96,2015-12-19,IND,MEM
86,@,L 84-91 ,240,32,82,.390,27,66,.409,5,16,.313,15,16,.938,84,32,83,.386,27,61,.443,5,22,.227,22,25,.880,91,2015-12-23,NYK,CLE
87,@,L 84-88 ,240,36,88,.409,31,68,.456,5,20,.250,7,8,.875,84,32,74,.432,25,59,.424,7,15,.467,17,26,.654,88,2015-12-25,SAS,HOU
88,Home,L 84-94 ,240,32,77,.416,25,54,.463,7,23,.304,13,25,.520,84,38,85,.447,28,59,.475,10,26,.385,8,11,.727,94,2015-12-25,LAL,LAC
89,@,L 84-93 ,240,31,84,.369,27,60,.450,4,24,.167,18,25,.720,84,33,87,.379,28,71,.394,5,16,.313,22,29,.759,93,2016-01-01,PHI,LAL
90,@,L 84-91 ,240,32,87,.368,28,68,.412,4,19,.211,16,19,.842,84,30,82,.366,22,64,.344,8,18,.444,23,30,.767,91,2016-01-08,DEN,MEM
91,@,L 84-107 ,240,30,81,.370,23,56,.411,7,25,.280,17,21,.810,84,36,82,.439,23,43,.535,13,39,.333,22,26,.846,107,2016-01-13,ATL,CHO
92,@,L 84-97 ,240,29,77,.377,22,53,.415,7,24,.292,19,32,.594,84,28,82,.341,19,51,.373,9,31,.290,32,37,.865,97,2016-01-23,NYK,CHO
93,Home,L 84-89 ,240,35,88,.398,30,70,.429,5,18,.278,9,12,.750,84,37,81,.457,34,67,.507,3,14,.214,12,17,.706,89,2016-01-25,CHI,MIA
94,@,L 84-102 ,240,35,85,.412,28,59,.475,7,26,.269,7,12,.583,84,36,84,.429,29,64,.453,7,20,.350,23,26,.885,102,2016-01-29,PHO,NYK
95,Home,W 84-81 ,240,30,77,.390,22,50,.440,8,27,.296,16,23,.696,84,30,71,.423,23,57,.404,7,14,.500,14,21,.667,81,2016-02-05,UTA,MIL
96,@,L 84-99 ,240,34,87,.391,29,64,.453,5,23,.217,11,16,.688,84,39,90,.433,25,49,.510,14,41,.341,7,7,1.000,99,2016-02-06,NOP,CLE
97,@,L 84-124 ,240,31,88,.352,24,64,.375,7,24,.292,15,20,.750,84,44,80,.550,31,56,.554,13,24,.542,23,35,.657,124,2016-02-22,PHO,LAC
98,Home,L 84-102 ,240,35,101,.347,28,74,.378,7,27,.259,7,14,.500,84,35,78,.449,30,64,.469,5,14,.357,27,39,.692,102,2016-03-04,ORL,PHO
99,Home,L 84-91 ,240,30,86,.349,23,60,.383,7,26,.269,17,23,.739,84,38,80,.475,30,55,.545,8,25,.320,7,14,.500,91,2016-03-08,UTA,ATL
0,@,L 84-121 ,240,34,91,.374,27,65,.415,7,26,.269,9,18,.500,84,47,84,.560,30,49,.612,17,35,.486,10,11,.909,121,2016-03-12,ORL,POR
1,@,L 84-92 ,240,35,85,.412,31,69,.449,4,16,.250,10,14,.714,84,36,79,.456,29,59,.492,7,20,.350,13,15,.867,92,2016-03-24,NOP,IND
2,Home,L 84-93 ,240,32,84,.381,28,73,.384,4,11,.364,16,19,.842,84,39,83,.470,30,62,.484,9,21,.429,6,7,.857,93,2016-03-26,MIN,UTA
3,Home,L 84-100 ,240,32,80,.400,26,53,.491,6,27,.222,14,19,.737,84,36,79,.456,24,48,.500,12,31,.387,16,21,.762,100,2016-04-10,DEN,UTA
4,@,L 84-110 ,240,35,86,.407,30,66,.455,5,20,.250,9,14,.643,84,41,75,.547,29,50,.580,12,25,.480,16,21,.762,110,2016-04-12,MEM,LAC
5,Home,L 84-109 ,240,31,77,.403,24,56,.429,7,21,.333,15,22,.682,84,43,85,.506,32,66,.485,11,19,.579,12,20,.600,109,2016-11-07,PHI,UTA
6,@,L 84-107 ,240,27,75,.360,20,49,.408,7,26,.269,23,30,.767,84,40,81,.494,34,62,.548,6,19,.316,21,25,.840,107,2016-11-23,MIA,DET
7,@,L 84-128 ,240,35,88,.398,28,60,.467,7,28,.250,7,14,.500,84,53,92,.576,40,68,.588,13,24,.542,9,11,.818,128,2016-12-03,ATL,TOR
8,@,L 84-114 ,240,31,90,.344,25,63,.397,6,27,.222,16,21,.762,84,46,83,.554,37,59,.627,9,24,.375,13,19,.684,114,2016-12-09,MIA,CLE
9,@,L 84-104 ,240,34,90,.378,25,64,.391,9,26,.346,7,13,.538,84,37,77,.481,24,48,.500,13,29,.448,17,18,.944,104,2016-12-10,SAC,UTA
10,Home,L 84-92 ,240,34,82,.415,27,56,.482,7,26,.269,9,13,.692,84,35,83,.422,26,54,.481,9,29,.310,13,14,.929,92,2016-12-21,ATL,MIN
11,@,L 84-105 ,240,31,75,.413,25,58,.431,6,17,.353,16,20,.800,84,44,91,.484,37,67,.552,7,24,.292,10,15,.667,105,2017-02-04,DET,IND
12,@,L 84-99 ,240,32,79,.405,25,53,.472,7,26,.269,13,19,.684,84,37,79,.468,23,42,.548,14,37,.378,11,12,.917,99,2017-02-15,ATL,LAC
13,@,L 84-97 ,240,35,83,.422,27,50,.540,8,33,.242,6,9,.667,84,41,78,.526,36,65,.554,5,13,.385,10,14,.714,97,2017-02-24,DAL,MIN
14,@,L 83-101 ,240,30,77,.390,24,61,.393,6,16,.375,17,22,.773,83,32,75,.427,23,52,.442,9,23,.391,28,35,.800,101,2011-12-28,WAS,ATL
15,Home,L 83-103 ,240,33,80,.413,31,69,.449,2,11,.182,15,18,.833,83,41,86,.477,34,69,.493,7,17,.412,14,18,.778,103,2011-12-28,PHO,PHI
16,@,L 83-110 ,240,30,93,.323,28,72,.389,2,21,.095,21,24,.875,83,46,76,.605,43,67,.642,3,9,.333,15,22,.682,110,2012-01-04,SAC,DEN
17,Home,L 83-99 ,240,36,88,.409,35,82,.427,1,6,.167,10,12,.833,83,40,76,.526,35,64,.547,5,12,.417,14,21,.667,99,2012-01-04,DET,CHI
18,@,L 83-118 ,240,24,69,.348,19,50,.380,5,19,.263,30,39,.769,83,42,80,.525,34,59,.576,8,21,.381,26,28,.929,118,2012-01-04,IND,MIA
19,Home,L 83-97 ,240,30,75,.400,23,55,.418,7,20,.350,16,21,.762,83,38,86,.442,30,72,.417,8,14,.571,13,17,.765,97,2012-01-06,ORL,CHI
20,@,L 83-99 ,240,34,80,.425,27,60,.450,7,20,.350,8,12,.667,83,39,80,.488,37,63,.587,2,17,.118,19,23,.826,99,2012-01-10,PHO,LAL
21,@,L 83-94 ,240,31,83,.373,20,57,.351,11,26,.423,10,11,.909,83,34,75,.453,28,63,.444,6,12,.500,20,30,.667,94,2012-01-12,NYK,MEM
22,@,L 83-99 ,240,34,84,.405,29,66,.439,5,18,.278,10,14,.714,83,38,74,.514,32,57,.561,6,17,.353,17,25,.680,99,2012-01-13,POR,SAS
23,@,L 83-97 ,240,32,83,.386,27,68,.397,5,15,.333,14,18,.778,83,35,94,.372,30,78,.385,5,16,.313,22,23,.957,97,2012-01-14,BOS,IND
24,Home,L 83-85 (OT),265,29,87,.333,25,66,.379,4,21,.190,21,27,.778,83,36,84,.429,34,67,.507,2,17,.118,11,18,.611,85,2012-01-18,ORL,SAS
25,@,W 83-81 ,240,32,79,.405,28,53,.528,4,26,.154,15,20,.750,83,29,79,.367,27,60,.450,2,19,.105,21,32,.656,81,2012-01-21,DAL,NOH
26,@,L 83-103 ,240,32,74,.432,32,67,.478,0,7,.000,19,27,.704,83,43,83,.518,37,67,.552,6,16,.375,11,20,.550,103,2012-01-23,WAS,PHI
27,Home,L 83-102 ,240,31,78,.397,28,67,.418,3,11,.273,18,18,1.000,83,38,83,.458,25,51,.490,13,32,.406,13,19,.684,102,2012-01-24,IND,ORL
28,@,L 83-105 ,240,35,80,.438,29,63,.460,6,17,.353,7,10,.700,83,42,82,.512,31,59,.525,11,23,.478,10,15,.667,105,2012-01-25,ATL,SAS
29,Home,L 83-91 ,240,30,79,.380,25,62,.403,5,17,.294,18,31,.581,83,34,73,.466,24,52,.462,10,21,.476,13,19,.684,91,2012-01-26,ORL,BOS
30,@,W 83-73 ,240,32,80,.400,22,56,.393,10,24,.417,9,15,.600,83,27,73,.370,24,64,.375,3,9,.333,16,20,.800,73,2012-01-30,SAS,MEM
31,@,L 83-93 ,240,30,78,.385,27,68,.397,3,10,.300,20,24,.833,83,35,73,.479,30,64,.469,5,9,.556,18,21,.857,93,2012-02-14,HOU,MEM
32,Home,W 83-78 ,240,31,78,.397,24,61,.393,7,17,.412,14,20,.700,83,31,82,.378,24,50,.480,7,32,.219,9,13,.692,78,2012-02-23,ATL,ORL
33,Home,L 83-86 ,240,31,78,.397,27,61,.443,4,17,.235,17,25,.680,83,33,74,.446,26,57,.456,7,17,.412,13,14,.929,86,2012-02-28,CLE,BOS
34,@,L 83-104 ,240,32,82,.390,26,59,.441,6,23,.261,13,16,.813,83,42,87,.483,38,75,.507,4,12,.333,16,16,1.000,104,2012-02-29,HOU,UTA
35,@,L 83-105 ,240,33,82,.402,28,64,.438,5,18,.278,12,14,.857,83,42,89,.472,34,72,.472,8,17,.471,13,16,.813,105,2012-03-02,GSW,PHI
36,@,L 83-100 ,240,29,76,.382,27,67,.403,2,9,.222,23,29,.793,83,37,75,.493,31,64,.484,6,11,.545,20,22,.909,100,2012-03-03,DET,MEM
37,@,L 83-93 ,240,33,88,.375,26,64,.406,7,24,.292,10,15,.667,83,35,71,.493,30,54,.556,5,17,.294,18,25,.720,93,2012-03-04,MIA,LAL
38,Home,W 83-75 ,240,29,78,.372,25,68,.368,4,10,.400,21,24,.875,83,29,80,.363,25,61,.410,4,19,.211,13,19,.684,75,2012-03-04,TOR,GSW
39,@,W 83-74 ,240,30,83,.361,26,61,.426,4,22,.182,19,26,.731,83,30,86,.349,28,75,.373,2,11,.182,12,21,.571,74,2012-03-09,NJN,CHA
40,@,L 83-87 (OT),265,31,81,.383,29,65,.446,2,16,.125,19,23,.826,83,35,87,.402,31,67,.463,4,20,.200,13,19,.684,87,2012-03-18,DET,LAC
41,@,L 83-109 ,240,34,82,.415,28,66,.424,6,16,.375,9,10,.900,83,40,85,.471,34,68,.500,6,17,.353,23,27,.852,109,2012-03-22,GSW,HOU
42,Home,L 83-85 ,240,30,71,.423,25,53,.472,5,18,.278,18,23,.783,83,31,74,.419,27,56,.482,4,18,.222,19,28,.679,85,2012-03-22,WAS,IND
43,Home,L 83-108 ,240,27,70,.386,23,54,.426,4,16,.250,25,30,.833,83,42,82,.512,36,65,.554,6,17,.353,18,26,.692,108,2012-03-25,CLE,PHO
44,Home,L 83-88 ,240,31,78,.397,28,65,.431,3,13,.231,18,22,.818,83,33,81,.407,25,60,.417,8,21,.381,14,20,.700,88,2012-03-28,CHA,MIN
45,Home,W 83-71 ,240,32,75,.427,30,63,.476,2,12,.167,17,21,.810,83,31,84,.369,28,73,.384,3,11,.273,6,7,.857,71,2012-03-30,CHI,DET
46,@,L 83-102 ,240,28,79,.354,21,58,.362,7,21,.333,20,22,.909,83,37,90,.411,31,70,.443,6,20,.300,22,26,.846,102,2012-04-13,CLE,IND
47,Home,W 83-72 ,240,32,76,.421,28,63,.444,4,13,.308,15,21,.714,83,25,70,.357,23,54,.426,2,16,.125,20,28,.714,72,2012-04-19,MIA,CHI
48,@,L 83-93 ,240,31,79,.392,27,64,.422,4,15,.267,17,19,.895,83,38,84,.452,29,64,.453,9,20,.450,8,12,.667,93,2012-04-21,DAL,CHI
49,@,W 83-81 ,240,31,71,.437,29,66,.439,2,5,.400,19,31,.613,83,33,79,.418,27,65,.415,6,14,.429,9,13,.692,81,2012-04-24,NOH,GSW
50,Home,L 83-93 ,240,30,79,.380,18,53,.340,12,26,.462,11,16,.688,83,34,73,.466,28,59,.475,6,14,.429,19,25,.760,93,2012-11-10,TOR,PHI
51,@,L 83-103 ,240,30,81,.370,28,68,.412,2,13,.154,21,25,.840,83,39,83,.470,33,67,.493,6,16,.375,19,31,.613,103,2012-11-16,DAL,IND
52,@,W 83-76 ,240,31,82,.378,29,73,.397,2,9,.222,19,27,.704,83,31,85,.365,26,69,.377,5,16,.313,9,12,.750,76,2012-11-17,UTA,WAS
53,@,L 83-103 ,240,32,71,.451,28,54,.519,4,17,.235,15,19,.789,83,39,72,.542,35,61,.574,4,11,.364,21,26,.808,103,2012-11-18,BOS,DET
54,@,L 83-92 ,240,31,86,.360,27,69,.391,4,17,.235,17,22,.773,83,35,86,.407,22,63,.349,13,23,.565,9,14,.643,92,2012-11-21,PHI,CLE
55,Home,L 83-95 ,240,32,75,.427,31,68,.456,1,7,.143,18,24,.750,83,33,82,.402,23,58,.397,10,24,.417,19,29,.655,95,2012-11-28,BOS,BRK
56,Home,L 83-93 ,240,33,77,.429,27,61,.443,6,16,.375,11,18,.611,83,34,77,.442,27,60,.450,7,17,.412,18,25,.720,93,2012-12-08,MEM,ATL
57,@,L 83-102 ,240,30,77,.390,20,51,.392,10,26,.385,13,17,.765,83,36,79,.456,30,60,.500,6,19,.316,24,34,.706,102,2012-12-09,TOR,LAC
58,Home,W 83-82 ,240,33,75,.440,31,65,.477,2,10,.200,15,19,.789,83,29,75,.387,22,56,.393,7,19,.368,17,22,.773,82,2012-12-15,CHI,BRK
59,@,L 83-90 ,240,34,77,.442,25,60,.417,9,17,.529,6,8,.750,83,34,81,.420,26,61,.426,8,20,.400,14,17,.824,90,2012-12-19,WAS,ORL
60,Home,L 83-94 ,240,32,83,.386,28,66,.424,4,17,.235,15,22,.682,83,33,82,.402,24,64,.375,9,18,.500,19,20,.950,94,2012-12-26,UTA,GSW
61,@,L 83-101 ,240,31,86,.360,26,64,.406,5,22,.227,16,21,.762,83,38,73,.521,26,54,.481,12,19,.632,13,16,.813,101,2012-12-29,BOS,GSW
62,@,L 83-88 ,240,31,82,.378,28,71,.394,3,11,.273,18,24,.750,83,28,70,.400,16,45,.356,12,25,.480,20,24,.833,88,2012-12-31,MEM,IND
63,Home,L 83-93 ,240,32,71,.451,24,49,.490,8,22,.364,11,16,.688,83,34,71,.479,26,53,.491,8,18,.444,17,22,.773,93,2013-01-02,BOS,MEM
64,@,L 83-100 ,240,28,77,.364,19,43,.442,9,34,.265,18,21,.857,83,39,82,.476,27,55,.491,12,27,.444,10,16,.625,100,2013-01-03,SAS,NYK
65,@,L 83-99 ,240,37,84,.440,30,62,.484,7,22,.318,2,5,.400,83,37,81,.457,25,58,.431,12,23,.522,13,20,.650,99,2013-01-09,ATL,CLE
66,@,L 83-104 ,240,32,84,.381,29,76,.382,3,8,.375,16,26,.615,83,39,80,.488,28,63,.444,11,17,.647,15,21,.714,104,2013-01-12,MEM,DAL
67,@,L 83-93 ,240,30,78,.385,23,54,.426,7,24,.292,16,25,.640,83,36,79,.456,34,68,.500,2,11,.182,19,27,.704,93,2013-01-12,ATL,WAS
68,Home,L 83-87 ,240,31,86,.360,25,65,.385,6,21,.286,15,18,.833,83,32,71,.451,26,48,.542,6,23,.261,17,22,.773,87,2013-01-13,POR,OKC
69,@,L 83-95 ,240,32,81,.395,29,64,.453,3,17,.176,16,23,.696,83,39,93,.419,30,76,.395,9,17,.529,8,12,.667,95,2013-01-21,LAL,CHI
70,Home,L 83-91 ,240,38,83,.458,35,68,.515,3,15,.200,4,6,.667,83,37,84,.440,31,64,.484,6,20,.300,11,16,.688,91,2013-01-23,MIN,BRK
71,@,L 83-96 ,240,29,66,.439,26,51,.510,3,15,.200,22,29,.759,83,42,82,.512,36,65,.554,6,17,.353,6,9,.667,96,2013-01-27,POR,LAC
72,Home,L 83-91 ,240,32,88,.364,29,72,.403,3,16,.188,16,18,.889,83,33,77,.429,24,57,.421,9,20,.450,16,23,.696,91,2013-01-27,MEM,NOH
73,Home,L 83-92 ,240,31,89,.348,25,66,.379,6,23,.261,15,19,.789,83,37,82,.451,34,69,.493,3,13,.231,15,18,.833,92,2013-02-05,BRK,LAL
74,@,L 83-84 (OT),265,31,90,.344,26,71,.366,5,19,.263,16,25,.640,83,37,91,.407,32,78,.410,5,13,.385,5,14,.357,84,2013-02-26,MIN,PHO
75,@,L 83-119 ,240,28,77,.364,22,54,.407,6,23,.261,21,27,.778,83,42,90,.467,29,57,.509,13,33,.394,22,27,.815,119,2013-03-03,CHA,SAC
76,@,L 83-87 ,240,33,83,.398,25,59,.424,8,24,.333,9,12,.750,83,27,75,.360,19,52,.365,8,23,.348,25,29,.862,87,2013-03-06,SAC,GSW
77,@,W 83-81 ,240,34,83,.410,27,66,.409,7,17,.412,8,9,.889,83,32,88,.364,26,61,.426,6,27,.222,11,14,.786,81,2013-03-06,BOS,IND
78,@,L 83-101 ,240,33,90,.367,24,70,.343,9,20,.450,8,8,1.000,83,40,74,.541,32,60,.533,8,14,.571,13,18,.722,101,2013-03-06,CHI,SAS
79,@,L 83-107 ,240,29,82,.354,20,53,.377,9,29,.310,16,18,.889,83,44,82,.537,32,62,.516,12,20,.600,7,18,.389,107,2013-03-12,SAS,MIN
80,Home,L 83-90 ,240,29,76,.382,20,57,.351,9,19,.474,16,24,.667,83,32,69,.464,24,46,.522,8,23,.348,18,25,.720,90,2013-03-18,UTA,NYK
81,@,L 83-90 ,240,30,73,.411,27,63,.429,3,10,.300,20,25,.800,83,36,76,.474,32,62,.516,4,14,.286,14,18,.778,90,2013-03-22,MEM,NOH
82,@,L 83-103 ,240,32,79,.405,22,53,.415,10,26,.385,9,13,.692,83,43,82,.524,39,71,.549,4,11,.364,13,18,.722,103,2013-03-24,POR,OKC
83,@,L 83-88 ,240,33,94,.351,29,78,.372,4,16,.250,13,16,.813,83,35,81,.432,31,67,.463,4,14,.286,14,16,.875,88,2013-04-03,PHI,CHA
84,@,L 83-101 ,240,29,76,.382,17,46,.370,12,30,.400,13,18,.722,83,41,89,.461,29,53,.547,12,36,.333,7,8,.875,101,2013-04-05,MIL,NYK
85,@,L 83-95 ,240,32,77,.416,30,65,.462,2,12,.167,17,20,.850,83,39,77,.506,28,51,.549,11,26,.423,6,11,.545,95,2013-04-05,NOH,UTA
86,@,L 83-100 ,240,30,83,.361,27,73,.370,3,10,.300,20,23,.870,83,36,76,.474,30,57,.526,6,19,.316,22,29,.759,100,2013-04-06,TOR,MIL
87,@,L 83-104 ,240,30,80,.375,23,66,.348,7,14,.500,16,20,.800,83,42,93,.452,37,73,.507,5,20,.250,15,23,.652,104,2013-04-09,PHI,BRK
88,@,L 83-94 ,240,33,75,.440,24,50,.480,9,25,.360,8,14,.571,83,38,88,.432,30,53,.566,8,35,.229,10,10,1.000,94,2013-04-09,MIL,MIA
89,@,L 83-96 ,240,33,90,.367,29,80,.363,4,10,.400,13,20,.650,83,36,76,.474,27,51,.529,9,25,.360,15,24,.625,96,2013-10-30,CHA,HOU
90,@,L 83-90 ,240,34,74,.459,29,58,.500,5,16,.313,10,12,.833,83,36,71,.507,33,58,.569,3,13,.231,15,17,.882,90,2013-10-30,MIL,NYK
91,Home,L 83-91 ,240,31,81,.383,20,58,.345,11,23,.478,10,16,.625,83,33,78,.423,27,59,.458,6,19,.316,19,21,.905,91,2013-11-09,MIL,DAL
92,Home,L 83-89 ,240,29,77,.377,22,56,.393,7,21,.333,18,25,.720,83,30,82,.366,27,70,.386,3,12,.250,26,30,.867,89,2013-11-13,BOS,CHA
93,@,L 83-89 (OT),265,31,79,.392,30,66,.455,1,13,.077,20,28,.714,83,33,85,.388,26,68,.382,7,17,.412,16,19,.842,89,2013-11-25,CHI,UTA
94,Home,L 83-90 ,240,28,73,.384,20,43,.465,8,30,.267,19,32,.594,83,36,76,.474,27,54,.500,9,22,.409,9,13,.692,90,2013-11-29,TOR,MIA
95,Home,L 83-113 ,240,29,73,.397,25,57,.439,4,16,.250,21,31,.677,83,44,77,.571,28,50,.560,16,27,.593,9,11,.818,113,2013-12-05,BRK,NYK
96,@,L 83-105 ,240,27,76,.355,25,60,.417,2,16,.125,27,34,.794,83,37,83,.446,31,55,.564,6,28,.214,25,39,.641,105,2013-12-06,GSW,HOU
97,@,L 83-121 ,240,30,70,.429,20,45,.444,10,25,.400,13,20,.650,83,44,83,.530,27,49,.551,17,34,.500,16,19,.842,121,2013-12-06,ORL,NYK
98,Home,L 83-94 ,240,33,92,.359,30,71,.423,3,21,.143,14,19,.737,83,35,82,.427,30,55,.545,5,27,.185,19,29,.655,94,2013-12-09,PHI,LAC
99,Home,L 83-92 ,240,31,84,.369,27,67,.403,4,17,.235,17,18,.944,83,38,90,.422,31,71,.437,7,19,.368,9,9,1.000,92,2013-12-11,CHA,ORL
0,Home,W 83-78 ,240,31,76,.408,26,57,.456,5,19,.263,16,19,.842,83,24,72,.333,18,51,.353,6,21,.286,24,29,.828,78,2013-12-11,NYK,CHI
1,@,W 83-82 ,240,33,83,.398,28,71,.394,5,12,.417,12,16,.750,83,28,81,.346,23,63,.365,5,18,.278,21,26,.808,82,2013-12-16,ORL,CHI
2,@,L 83-102 ,240,26,80,.325,22,60,.367,4,20,.200,27,33,.818,83,38,98,.388,26,67,.388,12,31,.387,14,19,.737,102,2013-12-21,LAL,GSW
3,Home,L 83-95 ,240,30,79,.380,20,60,.333,10,19,.526,13,21,.619,83,31,73,.425,21,45,.467,10,28,.357,23,33,.697,95,2013-12-27,NYK,TOR
4,Home,L 83-105 ,240,32,74,.432,29,57,.509,3,17,.176,16,19,.842,83,41,78,.526,28,52,.538,13,26,.500,10,11,.909,105,2013-12-28,CHI,DAL
5,Home,W 83-80 ,240,34,80,.425,26,59,.441,8,21,.381,7,9,.778,83,31,84,.369,24,70,.343,7,14,.500,11,15,.733,80,2013-12-30,UTA,CHA
6,Home,L 83-97 ,240,31,72,.431,25,56,.446,6,16,.375,15,24,.625,83,40,85,.471,35,68,.515,5,17,.294,12,15,.800,97,2014-01-07,CHA,WAS
7,Home,W 83-80 ,240,32,86,.372,23,54,.426,9,32,.281,10,11,.909,83,29,70,.414,23,51,.451,6,19,.316,16,22,.727,80,2014-01-10,ATL,HOU
8,@,L 83-103 ,240,26,78,.333,18,51,.353,8,27,.296,23,29,.793,83,41,80,.513,38,66,.576,3,14,.214,18,19,.947,103,2014-01-10,ORL,SAC
9,@,L 83-88 ,240,30,78,.385,19,54,.352,11,24,.458,12,25,.480,83,29,84,.345,25,67,.373,4,17,.235,26,36,.722,88,2014-01-15,TOR,BOS
10,Home,L 83-101 ,240,32,75,.427,27,48,.563,5,27,.185,14,19,.737,83,43,80,.538,38,67,.567,5,13,.385,10,13,.769,101,2014-01-24,BOS,OKC
11,@,L 83-98 ,240,28,84,.333,22,65,.338,6,19,.316,21,26,.808,83,37,87,.425,23,56,.411,14,31,.452,10,13,.769,98,2014-01-29,ORL,TOR
12,@,L 83-91 (OT),265,33,86,.384,30,72,.417,3,14,.214,14,16,.875,83,35,88,.398,25,68,.368,10,20,.500,11,18,.611,91,2014-02-09,MEM,CLE
13,@,L 83-104 ,240,30,78,.385,26,58,.448,4,20,.200,19,23,.826,83,38,94,.404,27,61,.443,11,33,.333,17,22,.773,104,2014-02-12,ATL,TOR
14,Home,L 83-96 ,240,30,78,.385,28,60,.467,2,18,.111,21,26,.808,83,41,96,.427,33,76,.434,8,20,.400,6,10,.600,96,2014-02-23,CLE,WAS
15,@,L 83-103 ,240,30,84,.357,25,63,.397,5,21,.238,18,22,.818,83,37,83,.446,32,69,.464,5,14,.357,24,30,.800,103,2014-02-26,GSW,CHI
16,@,L 83-94 ,240,32,91,.352,29,72,.403,3,19,.158,16,19,.842,83,40,73,.548,36,57,.632,4,16,.250,10,13,.769,94,2014-03-11,BOS,IND
17,Home,L 83-97 ,240,30,85,.353,21,60,.350,9,25,.360,14,16,.875,83,39,85,.459,26,51,.510,13,34,.382,6,7,.857,97,2014-03-17,CHA,ATL
18,@,L 83-84 ,240,28,61,.459,22,42,.524,6,19,.316,21,29,.724,83,30,81,.370,23,67,.343,7,14,.500,17,21,.810,84,2014-03-26,MIA,IND
19,@,L 83-107 ,240,31,82,.378,24,54,.444,7,28,.250,14,16,.875,83,43,86,.500,34,64,.531,9,22,.409,12,16,.750,107,2014-03-26,ATL,MIN
20,@,L 83-93 ,240,35,70,.500,27,44,.614,8,26,.308,5,10,.500,83,34,66,.515,27,41,.659,7,25,.280,18,22,.818,93,2014-03-31,TOR,MIA
21,Home,L 83-92 ,240,33,85,.388,25,61,.410,8,24,.333,9,15,.600,83,33,70,.471,24,41,.585,9,29,.310,17,24,.708,92,2014-03-31,UTA,NYK
22,Home,L 83-95 ,240,36,87,.414,32,63,.508,4,24,.167,7,13,.538,83,40,72,.556,31,49,.633,9,23,.391,6,11,.545,95,2014-04-08,UTA,DAL
23,Home,L 83-98 ,240,30,81,.370,22,66,.333,8,15,.533,15,19,.789,83,39,80,.488,31,62,.500,8,18,.444,12,19,.632,98,2014-11-04,NYK,WAS
24,Home,L 83-95 ,240,29,70,.414,20,47,.426,9,23,.391,16,26,.615,83,31,72,.431,22,45,.489,9,27,.333,24,27,.889,95,2014-11-17,BRK,MIA
25,Home,L 83-106 ,240,31,84,.369,24,61,.393,7,23,.304,14,20,.700,83,38,85,.447,26,54,.481,12,31,.387,18,20,.900,106,2014-11-22,IND,PHO
26,@,L 83-91 ,240,30,75,.400,22,49,.449,8,26,.308,15,25,.600,83,33,66,.500,27,49,.551,6,17,.353,19,21,.905,91,2014-11-22,PHI,NYK
27,@,L 83-98 ,240,31,70,.443,24,52,.462,7,18,.389,14,16,.875,83,41,94,.436,37,78,.474,4,16,.250,12,14,.857,98,2014-11-28,ORL,IND
28,Home,W 83-80 ,240,35,76,.461,30,64,.469,5,12,.417,8,12,.667,83,30,81,.370,24,64,.375,6,17,.353,14,21,.667,80,2014-11-29,WAS,NOP
29,@,L 83-102 ,240,29,76,.382,26,58,.448,3,18,.167,22,26,.846,83,38,88,.432,21,45,.467,17,43,.395,9,14,.643,102,2014-12-31,CHO,HOU
30,@,L 83-111 ,240,35,88,.398,29,59,.492,6,29,.207,7,11,.636,83,44,83,.530,37,68,.544,7,15,.467,16,20,.800,111,2015-01-02,HOU,NOP
31,@,L 83-105 ,240,33,76,.434,25,50,.500,8,26,.308,9,13,.692,83,43,82,.524,36,67,.537,7,15,.467,12,19,.632,105,2015-01-05,NYK,MEM
32,@,L 83-104 ,240,29,89,.326,20,59,.339,9,30,.300,16,23,.696,83,36,92,.391,26,73,.356,10,19,.526,22,28,.786,104,2015-01-07,OKC,SAC
33,@,L 83-99 ,240,29,77,.377,26,63,.413,3,14,.214,22,30,.733,83,40,95,.421,32,68,.471,8,27,.296,11,15,.733,99,2015-01-08,MIA,POR
34,Home,L 83-95 ,240,32,75,.427,25,59,.424,7,16,.438,12,14,.857,83,35,74,.473,27,57,.474,8,17,.471,17,21,.810,95,2015-01-16,SAC,MIA
35,@,L 83-101 ,240,31,81,.383,22,57,.386,9,24,.375,12,22,.545,83,37,79,.468,31,65,.477,6,14,.429,21,25,.840,101,2015-01-24,PHI,MEM
36,@,W 83-75 ,240,32,77,.416,28,56,.500,4,21,.190,15,21,.714,83,30,81,.370,26,62,.419,4,19,.211,11,18,.611,75,2015-02-01,MIA,BOS
37,@,L 83-85 ,240,33,91,.363,28,63,.444,5,28,.179,12,17,.706,83,34,75,.453,30,63,.476,4,12,.333,13,21,.619,85,2015-02-08,PHO,SAC
38,@,L 83-89 ,240,25,73,.342,20,58,.345,5,15,.333,28,36,.778,83,31,67,.463,27,56,.482,4,11,.364,23,28,.821,89,2015-02-11,NYK,ORL
39,Home,L 83-101 ,240,37,99,.374,34,80,.425,3,19,.158,6,7,.857,83,40,79,.506,28,46,.609,12,33,.364,9,15,.600,101,2015-02-22,NYK,CLE
40,Home,L 83-98 ,240,31,85,.365,25,70,.357,6,15,.400,15,20,.750,83,40,80,.500,32,62,.516,8,18,.444,10,14,.714,98,2015-03-01,ORL,CHO
41,Home,L 83-89 ,240,32,88,.364,22,56,.393,10,32,.313,9,18,.500,83,27,71,.380,21,59,.356,6,12,.500,29,41,.707,89,2015-03-06,PHI,UTA
42,@,L 83-96 ,240,30,72,.417,25,53,.472,5,19,.263,18,27,.667,83,37,78,.474,29,64,.453,8,14,.571,14,16,.875,96,2015-03-14,MIL,MEM
43,@,L 83-94 ,240,29,88,.330,21,62,.339,8,26,.308,17,19,.895,83,36,84,.429,25,57,.439,11,27,.407,11,18,.611,94,2015-03-18,DET,PHI
44,Home,L 83-95 ,240,32,78,.410,29,62,.468,3,16,.188,16,20,.800,83,39,90,.433,29,59,.492,10,31,.323,7,10,.700,95,2015-03-25,ORL,ATL
45,@,L 83-94 ,240,29,84,.345,25,67,.373,4,17,.235,21,29,.724,83,36,75,.480,29,57,.509,7,18,.389,15,21,.714,94,2015-03-27,LAL,TOR
46,@,L 83-97 ,240,33,81,.407,28,65,.431,5,16,.313,12,20,.600,83,38,83,.458,30,60,.500,8,23,.348,13,17,.765,97,2015-03-30,SAC,MEM
47,Home,L 83-92 ,240,34,81,.420,33,66,.500,1,15,.067,14,18,.778,83,38,79,.481,30,57,.526,8,22,.364,8,10,.800,92,2015-04-04,MEM,WAS
48,@,L 83-95 ,240,32,78,.410,24,54,.444,8,24,.333,11,15,.733,83,36,76,.474,34,67,.507,2,9,.222,21,26,.808,95,2015-04-15,IND,MEM
49,Home,L 83-99 ,240,30,73,.411,24,56,.429,6,17,.353,17,23,.739,83,38,86,.442,31,56,.554,7,30,.233,16,19,.842,99,2015-11-10,MIL,BOS
50,@,L 83-92 ,240,33,82,.402,25,60,.417,8,22,.364,9,11,.818,83,33,85,.388,28,69,.406,5,16,.313,21,25,.840,92,2015-11-14,PHI,SAS
51,@,L 83-88 ,240,34,83,.410,28,61,.459,6,22,.273,9,12,.750,83,33,81,.407,25,53,.472,8,28,.286,14,19,.737,88,2015-11-25,DAL,SAS
52,@,L 83-87 ,240,34,101,.337,28,77,.364,6,24,.250,9,21,.429,83,35,81,.432,31,69,.449,4,12,.333,13,16,.813,87,2015-11-29,DET,BRK
53,Home,L 83-103 ,240,30,80,.375,28,64,.438,2,16,.125,21,25,.840,83,40,80,.500,30,62,.484,10,18,.556,13,18,.722,103,2015-12-03,MEM,SAS
54,Home,W 83-80 ,240,31,87,.356,24,64,.375,7,23,.304,14,16,.875,83,30,88,.341,20,66,.303,10,22,.455,10,12,.833,80,2015-12-10,CHI,LAC
55,@,L 83-96 ,240,35,81,.432,30,61,.492,5,20,.250,8,13,.615,83,36,86,.419,30,58,.517,6,28,.214,18,20,.900,96,2015-12-11,MIA,IND
56,@,L 83-90 ,240,33,80,.413,29,69,.420,4,11,.364,13,16,.813,83,34,70,.486,27,50,.540,7,20,.350,15,23,.652,90,2015-12-11,MIL,TOR
57,Home,L 83-108 ,240,30,72,.417,27,62,.435,3,10,.300,20,25,.800,83,44,82,.537,34,58,.586,10,24,.417,10,14,.714,108,2015-12-23,MIN,SAS
58,@,L 83-89 ,240,30,95,.316,25,65,.385,5,30,.167,18,25,.720,83,32,78,.410,27,60,.450,5,18,.278,20,27,.741,89,2015-12-25,CLE,GSW
59,@,W 83-77 ,240,33,83,.398,20,55,.364,13,28,.464,4,6,.667,83,29,73,.397,22,51,.431,7,22,.318,12,20,.600,77,2016-01-08,ORL,BRK
60,@,L 83-97 ,240,31,84,.369,24,61,.393,7,23,.304,14,19,.737,83,40,91,.440,32,60,.533,8,31,.258,9,10,.900,97,2016-01-09,CHO,LAC
61,@,L 83-98 ,240,34,82,.415,28,63,.444,6,19,.316,9,17,.529,83,39,71,.549,30,51,.588,9,20,.450,11,18,.611,98,2016-01-09,MIA,UTA
62,@,W 83-77 ,240,30,77,.390,22,55,.400,8,22,.364,15,17,.882,83,31,86,.360,29,67,.433,2,19,.105,13,15,.867,77,2016-01-15,DAL,CHI
63,@,L 83-112 ,240,29,81,.358,23,58,.397,6,23,.261,19,25,.760,83,42,90,.467,37,70,.529,5,20,.250,23,28,.821,112,2016-01-17,DAL,SAS
64,Home,L 83-96 ,240,35,94,.372,31,70,.443,4,24,.167,9,22,.409,83,38,87,.437,31,70,.443,7,17,.412,13,15,.867,96,2016-01-23,CLE,CHI
65,Home,L 83-85 ,240,33,79,.418,23,56,.411,10,23,.435,7,14,.500,83,33,85,.388,28,58,.483,5,27,.185,14,21,.667,85,2016-01-27,ATL,LAC
66,@,L 83-103 ,240,29,79,.367,28,63,.444,1,16,.063,24,27,.889,83,38,80,.475,28,52,.538,10,28,.357,17,20,.850,103,2016-01-28,MIL,MEM
67,@,L 83-108 ,240,32,81,.395,29,61,.475,3,20,.150,16,24,.667,83,42,90,.467,30,63,.476,12,27,.444,12,16,.750,108,2016-03-04,WAS,CLE
68,@,L 83-95 ,240,33,95,.347,27,72,.375,6,23,.261,11,14,.786,83,36,84,.429,25,50,.500,11,34,.324,12,17,.706,95,2016-03-12,MEM,ATL
69,@,L 83-98 ,240,34,87,.391,30,70,.429,4,17,.235,11,14,.786,83,39,88,.443,34,68,.500,5,20,.250,15,20,.750,98,2016-10-30,MIL,DET
70,Home,L 83-85 ,240,34,87,.391,27,65,.415,7,22,.318,8,18,.444,83,34,84,.405,29,64,.453,5,20,.250,12,20,.600,85,2016-11-02,LAC,OKC
71,@,L 83-89 (OT),265,30,81,.370,19,47,.404,11,34,.324,12,16,.750,83,33,94,.351,25,67,.373,8,27,.296,15,20,.750,89,2016-11-02,NOP,MEM
72,@,L 83-90 ,240,34,83,.410,26,60,.433,8,23,.348,7,10,.700,83,33,76,.434,26,55,.473,7,21,.333,17,23,.739,90,2016-11-16,DAL,BOS
73,Home,L 83-120 ,240,33,103,.320,27,80,.338,6,23,.261,11,12,.917,83,40,90,.444,27,54,.500,13,36,.361,27,32,.844,120,2016-11-21,IND,GSW
74,@,L 83-108 ,240,28,88,.318,19,61,.311,9,27,.333,18,31,.581,83,39,79,.494,31,53,.585,8,26,.308,22,31,.710,108,2016-11-23,DEN,UTA
75,Home,L 83-95 ,240,28,76,.368,23,56,.411,5,20,.250,22,26,.846,83,39,86,.453,33,71,.465,6,15,.400,11,12,.917,95,2016-11-29,SAS,ORL
76,@,L 83-100 ,240,35,87,.402,29,63,.460,6,24,.250,7,8,.875,83,35,73,.479,20,47,.426,15,26,.577,15,28,.536,100,2016-12-29,PHI,UTA
77,@,L 83-105 ,240,30,86,.349,22,57,.386,8,29,.276,15,26,.577,83,38,85,.447,24,40,.600,14,45,.311,15,22,.682,105,2017-01-31,SAC,HOU
78,@,L 83-96 ,240,31,77,.403,26,54,.481,5,23,.217,16,25,.640,83,36,78,.462,24,52,.462,12,26,.462,12,16,.750,96,2017-02-25,NOP,DAL
79,@,L 83-88 ,240,30,84,.357,20,51,.392,10,33,.303,13,18,.722,83,33,81,.407,23,54,.426,10,27,.370,12,15,.800,88,2017-03-06,NOP,UTA
80,@,L 82-95 ,240,34,73,.466,31,66,.470,3,7,.429,11,19,.579,82,35,88,.398,25,55,.455,10,33,.303,15,22,.682,95,2011-12-26,MEM,SAS
81,@,L 82-99 ,240,21,67,.313,15,45,.333,6,22,.273,34,41,.829,82,38,73,.521,29,57,.509,9,16,.563,14,22,.636,99,2011-12-29,NYK,LAL
82,@,L 82-98 ,240,27,71,.380,20,49,.408,7,22,.318,21,28,.750,82,38,78,.487,22,52,.423,16,26,.615,6,11,.545,98,2012-01-01,NJN,CLE
83,@,L 82-99 ,240,29,77,.377,22,53,.415,7,24,.292,17,21,.810,82,36,85,.424,26,63,.413,10,22,.455,17,24,.708,99,2012-01-01,DAL,MIN
84,@,L 82-90 ,240,38,93,.409,37,84,.440,1,9,.111,5,10,.500,82,35,74,.473,29,55,.527,6,19,.316,14,21,.667,90,2012-01-08,MEM,LAL
85,@,W 82-70 ,240,32,83,.386,26,66,.394,6,17,.353,12,16,.750,82,30,88,.341,29,75,.387,1,13,.077,9,11,.818,70,2012-01-10,HOU,CHA
86,@,L 82-94 ,240,35,75,.467,32,61,.525,3,14,.214,9,14,.643,82,37,84,.440,26,61,.426,11,23,.478,9,13,.692,94,2012-01-16,MIL,PHI
87,Home,L 82-91 ,240,25,67,.373,22,55,.400,3,12,.250,29,35,.829,82,28,80,.350,23,50,.460,5,30,.167,30,34,.882,91,2012-01-22,MIA,MIL
88,@,L 82-103 ,240,32,83,.386,31,74,.419,1,9,.111,17,20,.850,82,36,70,.514,26,53,.491,10,17,.588,21,26,.808,103,2012-01-30,DET,MIL
89,@,L 82-98 ,240,32,74,.432,25,57,.439,7,17,.412,11,16,.688,82,40,84,.476,36,73,.493,4,11,.364,14,19,.737,98,2012-02-01,CHI,PHI
90,@,W 82-75 ,240,31,81,.383,26,67,.388,5,14,.357,15,18,.833,82,29,86,.337,28,72,.389,1,14,.071,16,19,.842,75,2012-02-17,DAL,PHI
91,@,L 82-99 ,240,32,81,.395,24,52,.462,8,29,.276,10,18,.556,82,38,80,.475,30,58,.517,8,22,.364,15,24,.625,99,2012-02-22,ATL,NYK
92,Home,L 82-85 ,240,31,92,.337,27,74,.365,4,18,.222,16,26,.615,82,34,83,.410,33,71,.465,1,12,.083,16,17,.941,85,2012-02-29,ATL,GSW
93,@,L 82-96 ,240,29,68,.426,21,43,.488,8,25,.320,16,20,.800,82,38,70,.543,28,50,.560,10,20,.500,10,17,.588,96,2012-03-14,ATL,LAC
94,@,W 82-79 ,240,29,79,.367,27,66,.409,2,13,.154,22,28,.786,82,29,75,.387,21,58,.362,8,17,.471,13,18,.722,79,2012-03-21,NYK,PHI
95,Home,L 82-94 ,240,35,85,.412,34,77,.442,1,8,.125,11,11,1.000,82,36,82,.439,29,66,.439,7,16,.438,15,23,.652,94,2012-03-21,TOR,CHI
96,@,L 82-94 ,240,32,82,.390,29,72,.403,3,10,.300,15,24,.625,82,36,77,.468,32,62,.516,4,15,.267,18,21,.857,94,2012-03-28,UTA,BOS
97,Home,L 82-97 ,240,33,82,.402,29,64,.453,4,18,.222,12,16,.750,82,38,82,.463,30,65,.462,8,17,.471,13,17,.765,97,2012-04-06,MIA,MEM
98,Home,L 82-88 ,240,31,78,.397,26,65,.400,5,13,.385,15,20,.750,82,29,80,.363,23,60,.383,6,20,.300,24,31,.774,88,2012-04-07,PHI,ORL
99,Home,L 82-95 ,240,31,77,.403,26,56,.464,5,21,.238,15,22,.682,82,39,91,.429,27,60,.450,12,31,.387,5,10,.500,95,2012-04-12,MIN,LAC
0,@,L 82-105 ,240,33,74,.446,28,57,.491,5,17,.294,11,19,.579,82,44,85,.518,42,71,.592,2,14,.143,15,17,.882,105,2012-04-13,CHA,MIA
1,Home,L 82-94 ,240,32,87,.368,26,65,.400,6,22,.273,12,14,.857,82,37,81,.457,32,67,.478,5,14,.357,15,22,.682,94,2012-04-14,NJN,BOS
2,Home,L 82-94 ,240,32,79,.405,29,66,.439,3,13,.231,15,20,.750,82,39,80,.488,34,65,.523,5,15,.333,11,17,.647,94,2012-04-15,CHA,BOS
3,Home,L 82-89 ,240,29,88,.330,26,71,.366,3,17,.176,21,25,.840,82,32,75,.427,27,57,.474,5,18,.278,20,23,.870,89,2012-11-03,CHI,NOH
4,@,L 82-96 ,240,32,80,.400,25,60,.417,7,20,.350,11,16,.688,82,33,82,.402,24,56,.429,9,26,.346,21,26,.808,96,2012-11-10,DET,HOU
5,Home,W 82-74 ,240,29,78,.372,22,54,.407,7,24,.292,17,25,.680,82,30,84,.357,29,71,.408,1,13,.077,13,18,.722,74,2012-11-11,BRK,ORL
6,Home,L 82-90 ,240,29,80,.363,25,64,.391,4,16,.250,20,25,.800,82,30,65,.462,26,50,.520,4,15,.267,26,32,.813,90,2012-11-12,DAL,MIN
7,Home,L 82-84 ,240,31,74,.419,25,54,.463,6,20,.300,14,22,.636,82,35,90,.389,28,70,.400,7,20,.350,7,11,.636,84,2012-11-13,LAL,SAS
8,@,L 82-103 ,240,29,74,.392,24,57,.421,5,17,.294,19,24,.792,82,38,80,.475,30,62,.484,8,18,.444,19,28,.679,103,2012-11-28,TOR,MEM
9,@,L 82-84 ,240,30,86,.349,20,55,.364,10,31,.323,12,18,.667,82,31,71,.437,26,59,.441,5,12,.417,17,19,.895,84,2012-11-28,POR,WAS
10,@,L 82-91 ,240,30,80,.375,26,65,.400,4,15,.267,18,21,.857,82,32,79,.405,28,58,.483,4,21,.190,23,28,.821,91,2012-12-07,ORL,SAC
11,Home,W 82-80 ,240,34,89,.382,29,67,.433,5,22,.227,9,11,.818,82,33,73,.452,31,63,.492,2,10,.200,12,12,1.000,80,2012-12-12,PHO,MEM
12,@,L 82-83 ,240,29,75,.387,22,56,.393,7,19,.368,17,22,.773,82,33,75,.440,31,65,.477,2,10,.200,15,19,.789,83,2012-12-15,BRK,CHI
13,@,L 82-92 ,240,31,76,.408,25,55,.455,6,21,.286,14,17,.824,82,36,89,.404,33,76,.434,3,13,.231,17,20,.850,92,2012-12-21,DAL,MEM
14,Home,L 82-94 ,240,31,79,.392,27,59,.458,4,20,.200,16,23,.696,82,38,88,.432,33,71,.465,5,17,.294,13,16,.813,94,2012-12-22,MIL,CLE
15,@,L 82-103 ,240,29,69,.420,28,60,.467,1,9,.111,23,28,.821,82,44,76,.579,35,58,.603,9,18,.500,6,10,.600,103,2013-01-16,MEM,SAS
16,Home,L 82-85 (OT),265,31,85,.365,28,71,.394,3,14,.214,17,21,.810,82,34,84,.405,34,79,.430,0,5,.000,17,28,.607,85,2013-01-19,CHI,MEM
17,@,W 82-81 ,240,34,69,.493,26,52,.500,8,17,.471,6,11,.545,82,35,83,.422,31,73,.425,4,10,.400,7,7,1.000,81,2013-01-21,IND,MEM
18,@,L 82-85 ,240,34,82,.415,30,69,.435,4,13,.308,10,14,.714,82,31,71,.437,28,57,.491,3,14,.214,20,26,.769,85,2013-01-23,DET,CHI
19,Home,L 82-100 ,240,31,80,.388,28,60,.467,3,20,.150,17,20,.850,82,34,71,.479,23,50,.460,11,21,.524,21,26,.808,100,2013-01-25,NOH,HOU
20,Home,L 82-88 ,240,26,71,.366,18,53,.340,8,18,.444,22,26,.846,82,29,80,.363,23,67,.343,6,13,.462,24,34,.706,88,2013-02-20,TOR,MEM
21,@,L 82-114 ,240,29,82,.354,26,63,.413,3,19,.158,21,37,.568,82,41,73,.562,31,59,.525,10,14,.714,22,33,.667,114,2013-02-22,DET,IND
22,@,L 82-88 ,240,35,84,.417,30,69,.435,5,15,.333,7,9,.778,82,34,76,.447,31,60,.517,3,16,.188,17,29,.586,88,2013-02-22,ORL,MEM
23,@,L 82-93 ,240,33,85,.388,29,74,.392,4,11,.364,12,21,.571,82,32,83,.386,29,69,.420,3,14,.214,26,33,.788,93,2013-02-28,PHI,CHI
24,Home,L 82-108 ,240,29,73,.397,27,58,.466,2,15,.133,22,26,.846,82,44,83,.530,33,59,.559,11,24,.458,9,15,.600,108,2013-03-03,ORL,MEM
25,@,L 82-87 ,240,29,65,.446,23,46,.500,6,19,.316,18,22,.818,82,31,76,.408,27,62,.435,4,14,.286,21,31,.677,87,2013-03-06,WAS,MIN
26,Home,L 82-119 ,240,34,78,.436,33,60,.550,1,18,.056,13,15,.867,82,45,83,.542,36,62,.581,9,21,.429,20,23,.870,119,2013-03-18,DET,BRK
27,Home,L 82-105 ,240,32,79,.405,25,59,.424,7,20,.350,11,13,.846,82,42,79,.532,28,53,.528,14,26,.538,7,8,.875,105,2013-03-26,DET,MIN
28,Home,L 82-99 ,240,31,76,.408,26,58,.448,5,18,.278,15,23,.652,82,44,82,.537,40,69,.580,4,13,.308,7,9,.778,99,2013-03-29,DET,TOR
29,Home,L 82-95 ,240,32,66,.485,23,40,.575,9,26,.346,9,19,.474,82,40,77,.519,33,55,.600,7,22,.318,8,12,.667,95,2013-04-03,ATL,NYK
30,@,W 82-78 ,240,29,83,.349,24,66,.364,5,17,.294,19,28,.679,82,23,74,.311,12,42,.286,11,32,.344,21,28,.750,78,2013-04-12,MEM,HOU
31,Home,W 82-81 ,240,31,76,.408,28,60,.467,3,16,.188,17,19,.895,82,31,86,.360,22,62,.355,9,24,.375,10,14,.714,81,2013-10-31,CHI,NYK
32,Home,L 82-91 ,240,35,91,.385,30,75,.400,5,16,.313,7,11,.636,82,35,76,.461,31,61,.508,4,15,.267,17,22,.773,91,2013-11-15,UTA,SAS
33,Home,L 82-91 ,240,35,80,.438,30,66,.455,5,14,.357,7,12,.583,82,35,86,.407,24,55,.436,11,31,.355,10,15,.667,91,2013-11-20,MIL,POR
34,Home,L 82-97 ,240,35,69,.507,30,58,.517,5,11,.455,7,9,.778,82,38,81,.469,32,64,.500,6,17,.353,15,18,.833,97,2013-11-22,BOS,IND
35,@,L 82-121 ,240,32,81,.395,28,69,.406,4,12,.333,14,23,.609,82,48,82,.585,40,61,.656,8,21,.381,17,19,.895,121,2013-11-24,CHI,LAC
36,@,L 82-89 ,240,30,78,.385,27,61,.443,3,17,.176,19,25,.760,82,33,82,.402,25,61,.410,8,21,.381,15,17,.882,89,2013-12-03,CHA,DAL
37,@,L 82-88 ,240,28,87,.322,21,52,.404,7,35,.200,19,26,.731,82,31,83,.373,27,69,.391,4,14,.286,22,30,.733,88,2013-12-07,LAC,CLE
38,Home,L 82-108 ,240,31,85,.365,29,75,.387,2,10,.200,18,22,.818,82,44,88,.500,36,70,.514,8,18,.444,12,14,.857,108,2013-12-07,MEM,GSW
39,Home,L 82-90 ,240,30,73,.411,23,53,.434,7,20,.350,15,22,.682,82,34,74,.459,29,56,.518,5,18,.278,17,23,.739,90,2013-12-07,MIL,BRK
40,Home,L 82-103 ,240,24,82,.293,19,60,.317,5,22,.227,29,39,.744,82,43,78,.551,39,60,.650,4,18,.222,13,19,.684,103,2013-12-07,MIN,MIA
41,Home,L 82-83 ,240,28,81,.346,23,63,.365,5,18,.278,21,26,.808,82,33,83,.398,28,71,.394,5,12,.417,12,16,.750,83,2013-12-16,CHI,ORL
42,Home,L 82-86 ,240,28,86,.326,21,71,.296,7,15,.467,19,20,.950,82,33,82,.402,25,61,.410,8,21,.381,12,15,.800,86,2013-12-18,ORL,UTA
43,@,L 82-106 ,240,31,77,.403,24,56,.429,7,21,.333,13,17,.765,82,43,86,.500,34,67,.507,9,19,.474,11,17,.647,106,2013-12-28,DET,WAS
44,@,L 82-95 ,240,32,74,.432,27,60,.450,5,14,.357,13,20,.650,82,34,78,.436,27,59,.458,7,19,.368,20,23,.870,95,2014-01-01,IND,TOR
45,@,L 82-94 ,240,32,81,.395,30,69,.435,2,12,.167,16,23,.696,82,35,84,.417,33,69,.478,2,15,.133,22,28,.786,94,2014-01-02,BOS,CHI
46,@,L 82-89 ,240,29,79,.367,19,57,.333,10,22,.455,14,20,.700,82,31,71,.437,23,47,.489,8,24,.333,19,22,.864,89,2014-01-04,CLE,BRK
47,@,L 82-99 ,240,31,68,.456,28,59,.475,3,9,.333,17,26,.654,82,39,83,.470,32,61,.525,7,22,.318,14,19,.737,99,2014-01-04,NOP,IND
48,@,W 82-78 ,240,28,77,.364,20,53,.377,8,24,.333,18,22,.818,82,27,79,.342,21,59,.356,6,20,.300,18,20,.900,78,2014-01-05,IND,CLE
49,@,W 82-77 ,240,33,82,.402,28,62,.452,5,20,.250,11,18,.611,82,31,82,.378,25,62,.403,6,20,.300,9,12,.750,77,2014-01-15,MEM,MIL
50,@,L 82-110 ,240,33,88,.375,27,67,.403,6,21,.286,10,17,.588,82,43,76,.566,32,58,.552,11,18,.611,13,21,.619,110,2014-01-19,MIL,SAS
51,@,L 82-108 ,240,31,83,.373,27,60,.450,4,23,.174,16,22,.727,82,45,74,.608,39,59,.661,6,15,.400,12,18,.667,108,2014-02-27,NYK,MIA
52,@,L 82-92 ,240,33,90,.367,30,73,.411,3,17,.176,13,15,.867,82,34,73,.466,25,53,.472,9,20,.450,15,15,1.000,92,2014-02-28,CHA,SAS
53,Home,W 82-71 ,240,33,75,.440,28,62,.452,5,13,.385,11,17,.647,82,27,74,.365,21,59,.356,6,15,.400,11,14,.786,71,2014-03-22,MEM,IND
54,@,L 82-101 ,240,31,85,.365,22,64,.344,9,21,.429,11,14,.786,82,37,75,.493,29,50,.580,8,25,.320,19,25,.760,101,2014-11-04,CLE,POR
55,Home,L 82-105 ,240,29,68,.426,20,40,.500,9,28,.321,15,19,.789,82,42,88,.477,33,64,.516,9,24,.375,12,14,.857,105,2014-11-07,UTA,DAL
56,@,L 82-124 ,240,27,74,.365,21,54,.389,6,20,.300,22,32,.688,82,45,86,.523,30,61,.492,15,25,.600,19,24,.792,124,2014-11-21,MIL,TOR
57,@,L 82-97 ,240,31,70,.443,28,54,.519,3,16,.188,17,28,.607,82,40,83,.482,28,57,.491,12,26,.462,5,10,.500,97,2014-11-26,UTA,OKC
58,@,L 82-88 ,240,36,91,.396,31,73,.425,5,18,.278,5,8,.625,82,33,83,.398,29,62,.468,4,21,.190,18,23,.783,88,2014-12-04,IND,POR
59,@,L 82-102 ,240,30,82,.366,23,60,.383,7,22,.318,15,21,.714,82,38,85,.447,30,62,.484,8,23,.348,18,27,.667,102,2014-12-10,MIA,DEN
60,@,L 82-90 ,240,31,80,.388,21,45,.467,10,35,.286,10,12,.833,82,32,81,.395,31,69,.449,1,12,.083,25,33,.758,90,2014-12-10,POR,MIN
61,@,L 82-95 ,240,36,74,.486,32,59,.542,4,15,.267,6,8,.750,82,37,83,.446,26,53,.491,11,30,.367,10,15,.667,95,2014-12-15,ORL,TOR
62,@,L 82-110 ,240,31,82,.378,29,64,.453,2,18,.111,18,24,.750,82,43,80,.538,35,61,.574,8,19,.421,16,24,.667,110,2014-12-22,DEN,CHO
63,Home,L 82-96 ,240,33,86,.384,25,61,.410,8,25,.320,8,15,.533,82,36,83,.434,30,69,.435,6,14,.429,18,21,.857,96,2014-12-30,CHI,BRK
64,Home,L 82-95 ,240,31,76,.408,22,51,.431,9,25,.360,11,14,.786,82,35,77,.455,31,61,.508,4,16,.250,21,27,.778,95,2015-01-04,NYK,MIL
65,@,L 82-97 ,240,29,70,.414,24,53,.453,5,17,.294,19,21,.905,82,33,77,.429,20,43,.465,13,34,.382,18,21,.857,97,2015-01-10,UTA,HOU
66,Home,L 82-110 ,240,33,85,.388,25,56,.446,8,29,.276,8,9,.889,82,39,78,.500,32,62,.516,7,16,.438,25,33,.758,110,2015-01-10,NYK,CHO
67,@,L 82-93 ,240,29,82,.354,20,47,.426,9,35,.257,15,26,.577,82,37,84,.440,28,54,.519,9,30,.300,10,14,.714,93,2015-01-19,DET,ATL
68,@,L 82-103 ,240,34,81,.420,29,65,.446,5,16,.313,9,13,.692,82,42,79,.532,36,61,.590,6,18,.333,13,18,.722,103,2015-01-29,NYK,IND
69,@,W 82-75 ,240,33,80,.413,26,64,.406,7,16,.438,9,17,.529,82,25,78,.321,18,51,.353,7,27,.259,18,22,.818,75,2015-02-02,MIL,TOR
70,@,L 82-87 ,240,31,93,.333,24,65,.369,7,28,.250,13,16,.813,82,32,74,.432,28,61,.459,4,13,.308,19,24,.792,87,2015-02-08,SAS,TOR
71,@,L 82-87 ,240,30,80,.375,19,51,.373,11,29,.379,11,21,.524,82,28,75,.373,18,47,.383,10,28,.357,21,26,.808,87,2015-02-11,UTA,DAL
72,Home,L 82-110 ,240,31,94,.330,24,67,.358,7,27,.259,13,22,.591,82,43,92,.467,39,71,.549,4,21,.190,20,23,.870,110,2015-02-23,DEN,BRK
73,Home,L 82-104 ,240,28,84,.333,20,52,.385,8,32,.250,18,29,.621,82,39,68,.574,30,47,.638,9,21,.429,17,21,.810,104,2015-02-27,DEN,UTA
74,Home,W 82-75 ,240,29,76,.382,23,54,.426,6,22,.273,18,23,.783,82,29,74,.392,24,59,.407,5,15,.333,12,14,.857,75,2015-02-28,UTA,MIL
75,Home,L 82-93 ,240,33,82,.402,30,71,.423,3,11,.273,13,19,.684,82,36,80,.450,31,55,.564,5,25,.200,16,19,.842,93,2015-03-03,MEM,UTA
76,@,L 82-105 ,240,30,76,.395,24,60,.400,6,16,.375,16,23,.696,82,38,80,.475,28,58,.483,10,22,.455,19,24,.792,105,2015-03-04,NYK,IND
77,@,L 82-87 ,240,31,79,.392,26,66,.394,5,13,.385,15,17,.882,82,30,70,.429,24,52,.462,6,18,.333,21,29,.724,87,2015-03-10,NYK,UTA
78,Home,L 82-103 ,240,32,76,.421,28,58,.483,4,18,.222,14,17,.824,82,41,79,.519,34,67,.507,7,12,.583,14,19,.737,103,2015-03-23,NYK,MEM
79,@,L 82-88 ,240,32,74,.432,26,55,.473,6,19,.316,12,15,.800,82,33,85,.388,29,68,.426,4,17,.235,18,21,.857,88,2015-04-03,DET,CHI
80,Home,L 82-94 ,240,33,86,.384,28,64,.438,5,22,.227,11,17,.647,82,38,88,.432,31,65,.477,7,23,.304,11,12,.917,94,2015-11-03,DET,IND
81,@,L 82-90 ,240,29,88,.330,20,61,.328,9,27,.333,15,18,.833,82,30,82,.366,23,55,.418,7,27,.259,23,29,.793,90,2015-11-13,LAL,DAL
82,@,L 82-92 ,240,32,74,.432,31,65,.477,1,9,.111,17,17,1.000,82,34,72,.472,27,51,.529,7,21,.333,17,22,.773,92,2015-11-21,MEM,SAS
83,Home,L 82-84 ,240,27,82,.329,20,59,.339,7,23,.304,21,27,.778,82,31,72,.431,20,48,.417,11,24,.458,11,14,.786,84,2015-11-28,WAS,TOR
84,@,L 82-87 ,240,33,82,.402,25,54,.463,8,28,.286,8,14,.571,82,27,70,.386,12,39,.308,15,31,.484,18,22,.818,87,2015-11-29,MIL,CHO
85,Home,L 82-105 ,240,31,80,.388,24,61,.393,7,19,.368,13,16,.813,82,41,76,.539,32,55,.582,9,21,.429,14,20,.700,105,2015-12-14,BRK,ORL
86,@,L 82-106 ,240,32,88,.364,25,57,.439,7,31,.226,11,14,.786,82,46,82,.561,38,64,.594,8,18,.444,6,9,.667,106,2016-01-01,DAL,MIA
87,@,L 82-94 ,240,33,93,.355,30,73,.411,3,20,.150,13,23,.565,82,33,73,.452,26,55,.473,7,18,.389,21,29,.724,94,2016-01-02,DET,IND
88,@,L 82-109 ,240,31,90,.344,22,67,.328,9,23,.391,11,18,.611,82,41,83,.494,29,59,.492,12,24,.500,15,18,.833,109,2016-01-16,LAL,UTA
89,Home,L 82-101 ,240,27,80,.338,19,51,.373,8,29,.276,20,23,.870,82,36,96,.375,23,60,.383,13,36,.361,16,26,.615,101,2016-01-31,LAL,CHO
90,@,L 82-88 ,240,31,82,.378,25,61,.410,6,21,.286,14,22,.636,82,33,87,.379,29,68,.426,4,19,.211,18,20,.900,88,2016-03-29,OKC,DET
91,@,L 82-108 ,240,33,95,.347,25,69,.362,8,26,.308,8,12,.667,82,48,95,.505,41,76,.539,7,19,.368,5,6,.833,108,2016-10-28,ORL,DET
92,@,L 82-114 ,240,30,82,.366,26,70,.371,4,12,.333,18,26,.692,82,41,76,.539,28,51,.549,13,25,.520,19,22,.864,114,2016-11-07,DET,LAC
93,@,L 82-89 ,240,30,82,.366,23,61,.377,7,21,.333,15,19,.789,82,34,88,.386,24,61,.393,10,27,.370,11,19,.579,89,2016-11-16,NOP,ORL
94,@,L 82-107 ,240,32,71,.451,29,58,.500,3,13,.231,15,21,.714,82,40,87,.460,27,56,.482,13,31,.419,14,18,.778,107,2016-12-03,CHI,DAL
95,@,W 82-73 ,240,30,66,.455,22,39,.564,8,27,.296,14,25,.560,82,28,93,.301,26,70,.371,2,23,.087,15,18,.833,73,2016-12-18,UTA,MEM
96,@,L 82-113 ,240,34,83,.410,31,60,.517,3,23,.130,11,13,.846,82,49,82,.598,41,66,.621,8,16,.500,7,7,1.000,113,2016-12-19,DET,CHI
97,@,L 82-91 ,240,33,82,.402,23,54,.426,10,28,.357,6,13,.462,82,36,93,.387,31,67,.463,5,26,.192,14,18,.778,91,2016-12-29,MIA,CHO
98,@,L 82-90 ,240,32,88,.364,21,62,.339,11,26,.423,7,10,.700,82,34,90,.378,28,59,.475,6,31,.194,16,22,.727,90,2017-01-02,NOP,CLE
99,@,L 82-110 ,240,31,83,.373,27,65,.415,4,18,.222,16,22,.727,82,43,78,.551,30,54,.556,13,24,.542,11,15,.733,110,2017-01-03,TOR,SAS
0,Home,L 82-97 ,240,32,82,.390,23,46,.500,9,36,.250,9,10,.900,82,30,74,.405,19,52,.365,11,22,.500,26,32,.813,97,2017-01-07,DAL,ATL
1,@,L 81-102 ,240,30,85,.353,23,67,.343,7,18,.389,14,19,.737,81,39,73,.534,31,53,.585,8,20,.400,16,25,.640,102,2011-12-30,WAS,MIL
2,@,L 81-96 ,240,26,64,.406,20,53,.377,6,11,.545,23,28,.821,81,32,74,.432,24,55,.436,8,19,.421,24,29,.828,96,2012-01-07,NOH,DAL
3,Home,L 81-94 ,240,29,71,.408,21,48,.438,8,23,.348,15,21,.714,81,39,75,.520,33,65,.508,6,10,.600,10,14,.714,94,2012-01-09,DEN,NOH
4,@,L 81-111 ,240,33,78,.423,32,70,.457,1,8,.125,14,16,.875,81,42,90,.467,36,71,.507,6,19,.316,21,28,.750,111,2012-01-12,CHA,ATL
5,Home,L 81-98 ,240,33,74,.446,32,66,.485,1,8,.125,14,16,.875,81,40,82,.488,33,68,.485,7,14,.500,11,16,.688,98,2012-01-13,CHA,DET
6,Home,L 81-98 ,240,29,66,.439,25,56,.446,4,10,.400,19,26,.731,81,39,68,.574,34,59,.576,5,9,.556,15,20,.750,98,2012-01-20,DET,MEM
7,Home,L 81-83 ,240,29,79,.367,27,60,.450,2,19,.105,21,32,.656,81,32,79,.405,28,53,.528,4,26,.154,15,20,.750,83,2012-01-21,NOH,DAL
8,@,L 81-91 ,240,32,76,.421,29,56,.518,3,20,.150,14,20,.700,81,34,78,.436,25,58,.431,9,20,.450,14,26,.538,91,2012-01-25,NYK,CLE
9,@,L 81-96 ,240,32,82,.390,25,63,.397,7,19,.368,10,14,.714,81,32,70,.457,24,43,.558,8,27,.296,24,32,.750,96,2012-01-27,TOR,DEN
10,@,L 81-93 ,240,33,74,.446,30,66,.455,3,8,.375,12,16,.750,81,34,74,.459,30,55,.545,4,19,.211,21,27,.778,93,2012-02-02,NOH,SAS
11,@,L 81-99 ,240,34,83,.410,30,64,.469,4,19,.211,9,14,.643,81,39,89,.438,35,74,.473,4,15,.267,17,17,1.000,99,2012-02-03,PHO,HOU
12,Home,L 81-85 ,240,29,85,.341,25,63,.397,4,22,.182,19,21,.905,81,29,72,.403,20,47,.426,9,25,.360,18,23,.783,85,2012-02-04,IND,ORL
13,Home,L 81-107 ,240,30,80,.375,23,62,.371,7,18,.389,14,23,.609,81,45,83,.542,34,60,.567,11,23,.478,6,17,.353,107,2012-02-04,WAS,LAC
14,@,L 81-96 ,240,32,72,.444,26,56,.464,6,16,.375,11,15,.733,81,31,82,.378,26,73,.356,5,9,.556,29,46,.630,96,2012-02-19,BOS,DET
15,Home,W 81-78 ,240,28,80,.350,21,59,.356,7,21,.333,18,29,.621,81,32,87,.368,26,71,.366,6,16,.375,8,9,.889,78,2012-03-02,PHO,LAC
16,@,L 81-91 ,240,30,76,.395,21,51,.412,9,25,.360,12,21,.571,81,34,74,.459,32,66,.485,2,8,.250,21,27,.778,91,2012-03-18,ORL,MIA
17,@,L 81-90 ,240,33,79,.418,27,58,.466,6,21,.286,9,12,.750,81,34,73,.466,28,54,.519,6,19,.316,16,20,.800,90,2012-03-27,HOU,DAL
18,Home,L 81-109 ,240,33,85,.388,27,57,.474,6,28,.214,9,14,.643,81,40,79,.506,26,44,.591,14,35,.400,15,16,.938,109,2012-04-13,ORL,ATL
19,Home,L 81-83 ,240,33,79,.418,27,65,.415,6,14,.429,9,13,.692,81,31,71,.437,29,66,.439,2,5,.400,19,31,.613,83,2012-04-24,GSW,NOH
20,@,L 81-94 ,240,32,87,.368,28,71,.394,4,16,.250,13,17,.765,81,38,78,.487,36,64,.563,2,14,.143,16,24,.667,94,2012-11-10,PHO,UTA
21,Home,W 81-72 ,240,34,89,.382,29,64,.453,5,25,.200,8,13,.615,81,31,82,.378,29,72,.403,2,10,.200,8,14,.571,72,2012-11-19,ATL,ORL
22,@,L 81-116 ,240,29,76,.382,20,53,.377,9,23,.391,14,18,.778,81,47,86,.547,35,62,.565,12,24,.500,10,16,.625,116,2012-12-01,SAC,LAC
23,@,L 81-102 ,240,29,76,.382,21,57,.368,8,19,.421,15,23,.652,81,43,82,.524,38,70,.543,5,12,.417,11,11,1.000,102,2012-12-03,MIL,NOH
24,@,L 81-87 ,240,34,77,.442,33,62,.532,1,15,.067,12,17,.706,81,32,77,.416,31,67,.463,1,10,.100,22,27,.815,87,2012-12-05,ORL,UTA
25,@,L 81-96 ,240,27,81,.333,18,59,.305,9,22,.409,18,25,.720,81,34,83,.410,29,65,.446,5,18,.278,23,28,.821,96,2012-12-12,CLE,IND
26,@,W 81-75 ,240,33,77,.429,29,60,.483,4,17,.235,11,18,.611,81,33,82,.402,29,71,.408,4,11,.364,5,7,.714,75,2012-12-22,IND,NOH
27,@,L 81-97 ,240,28,73,.384,25,63,.397,3,10,.300,22,32,.688,81,34,76,.447,25,49,.510,9,27,.333,20,26,.769,97,2012-12-28,CHA,BRK
28,Home,W 81-72 ,240,36,89,.404,31,70,.443,5,19,.263,4,7,.571,81,29,68,.426,26,52,.500,3,16,.188,11,18,.611,72,2012-12-29,MEM,DEN
29,Home,L 81-91 ,240,33,94,.351,29,78,.372,4,16,.250,11,18,.611,81,33,70,.471,29,60,.483,4,10,.400,21,38,.553,91,2012-12-31,CHI,CHA
30,@,L 81-89 ,240,35,83,.422,32,70,.457,3,13,.231,8,10,.800,81,29,77,.377,24,61,.393,5,16,.313,26,31,.839,89,2013-01-02,WAS,IND
31,Home,L 81-89 ,240,28,68,.412,18,39,.462,10,29,.345,15,19,.789,81,39,85,.459,36,69,.522,3,16,.188,8,12,.667,89,2013-01-05,ATL,BOS
32,Home,L 81-92 ,240,31,79,.392,26,65,.400,5,14,.357,14,18,.778,81,37,69,.536,35,61,.574,2,8,.250,16,20,.800,92,2013-01-06,PHO,MEM
33,Home,L 81-113 ,240,28,76,.368,23,55,.418,5,21,.238,20,23,.870,81,39,80,.488,28,60,.467,11,20,.550,24,27,.889,113,2013-01-07,SAC,MEM
34,Home,W 81-76 ,240,31,79,.392,26,58,.448,5,21,.238,14,16,.875,81,31,89,.348,27,69,.391,4,20,.200,10,13,.769,76,2013-01-10,IND,NYK
35,Home,L 81-97 ,240,32,88,.364,30,77,.390,2,11,.182,15,21,.714,81,36,73,.493,30,59,.508,6,14,.429,19,25,.760,97,2013-01-12,CHI,PHO
36,Home,L 81-82 ,240,35,83,.422,31,73,.425,4,10,.400,7,7,1.000,81,34,69,.493,26,52,.500,8,17,.471,6,11,.545,82,2013-01-21,MEM,IND
37,@,L 81-99 ,240,29,73,.397,23,56,.411,6,17,.353,17,26,.654,81,39,73,.534,34,57,.596,5,16,.313,16,20,.800,99,2013-01-30,SAC,BOS
38,@,L 81-120 ,240,32,76,.421,26,55,.473,6,21,.286,11,15,.733,81,47,86,.547,28,43,.651,19,43,.442,7,13,.538,120,2013-02-02,SAC,NYK
39,Home,L 81-93 ,240,29,72,.403,26,61,.426,3,11,.273,20,25,.800,81,34,70,.486,27,50,.540,7,20,.350,18,22,.818,93,2013-03-01,TOR,IND
40,Home,L 81-97 ,240,33,88,.375,28,68,.412,5,20,.250,10,15,.667,81,38,74,.514,33,53,.623,5,21,.238,16,19,.842,97,2013-03-04,MIN,MIA
41,Home,L 81-83 ,240,32,88,.364,26,61,.426,6,27,.222,11,14,.786,81,34,83,.410,27,66,.409,7,17,.412,8,9,.889,83,2013-03-06,IND,BOS
42,@,L 81-90 ,240,33,89,.371,29,73,.397,4,16,.250,11,12,.917,81,39,86,.453,34,60,.567,5,26,.192,7,14,.500,90,2013-03-10,CHI,LAL
43,@,L 81-98 ,240,33,78,.423,28,56,.500,5,22,.227,10,14,.714,81,35,82,.427,29,62,.468,6,20,.300,22,30,.733,98,2013-03-12,ATL,MIA
44,@,L 81-111 ,240,34,81,.420,28,60,.467,6,21,.286,7,10,.700,81,39,76,.513,29,55,.527,10,21,.476,23,30,.767,111,2013-03-13,PHO,HOU
45,@,L 81-98 ,240,31,78,.397,24,56,.429,7,22,.318,12,14,.857,81,35,80,.438,26,56,.464,9,24,.375,19,27,.704,98,2013-03-30,LAC,HOU
46,@,L 81-101 ,240,34,81,.420,27,62,.435,7,19,.368,6,12,.500,81,36,81,.444,28,57,.491,8,24,.333,21,33,.636,101,2013-04-02,DAL,LAL
47,@,L 81-82 ,240,31,86,.360,22,62,.355,9,24,.375,10,14,.714,81,31,76,.408,28,60,.467,3,16,.188,17,19,.895,82,2013-10-31,NYK,CHI
48,@,L 81-100 ,240,29,83,.349,22,52,.423,7,31,.226,16,19,.842,81,33,77,.429,25,57,.439,8,20,.400,26,33,.788,100,2013-11-01,OKC,MIN
49,@,L 81-96 ,240,31,75,.413,26,61,.426,5,14,.357,14,20,.700,81,34,83,.410,30,67,.448,4,16,.250,24,26,.923,96,2013-11-11,CLE,CHI
50,Home,L 81-100 ,240,31,77,.403,28,60,.467,3,17,.176,16,23,.696,81,36,80,.450,31,63,.492,5,17,.294,23,27,.852,100,2013-11-11,UTA,DEN
51,Home,L 81-97 ,240,29,83,.349,21,56,.375,8,27,.296,15,20,.750,81,35,69,.507,29,54,.537,6,15,.400,21,23,.913,97,2013-11-16,CHA,MIA
52,@,L 81-86 ,240,33,91,.363,26,75,.347,7,16,.438,8,16,.500,81,27,75,.360,21,63,.333,6,12,.500,26,31,.839,86,2013-11-18,CHA,CHI
53,Home,L 81-88 (OT),265,36,82,.439,31,64,.484,5,18,.278,4,8,.500,81,34,88,.386,31,76,.408,3,12,.250,17,19,.895,88,2013-11-20,GSW,MEM
54,@,L 81-111 ,240,31,78,.397,26,62,.419,5,16,.313,14,20,.700,81,40,97,.412,29,61,.475,11,36,.306,20,23,.870,111,2013-11-22,BRK,MIN
55,Home,L 81-101 ,240,29,77,.377,26,64,.406,3,13,.231,20,26,.769,81,38,80,.475,27,60,.450,11,20,.550,14,18,.778,101,2013-12-05,MEM,LAC
56,@,L 81-114 ,240,32,84,.381,28,62,.452,4,22,.182,13,24,.542,81,43,81,.531,31,55,.564,12,26,.462,16,22,.727,114,2013-12-20,HOU,IND
57,Home,L 81-89 ,240,31,81,.383,28,68,.412,3,13,.231,16,21,.762,81,36,84,.429,29,68,.426,7,16,.438,10,18,.556,89,2013-12-23,DEN,GSW
58,Home,L 81-94 ,240,34,89,.382,29,70,.414,5,19,.263,8,13,.615,81,41,85,.482,35,58,.603,6,27,.222,6,10,.600,94,2013-12-31,ORL,GSW
59,@,L 81-87 (OT),265,32,84,.381,25,59,.424,7,25,.280,10,18,.556,81,33,96,.344,29,77,.377,4,19,.211,17,24,.708,87,2014-01-02,ORL,CLE
60,@,L 81-101 ,240,30,84,.357,23,65,.354,7,19,.368,14,21,.667,81,35,83,.422,24,52,.462,11,31,.355,20,24,.833,101,2014-01-06,ORL,LAC
61,@,W 81-72 ,240,24,62,.387,18,46,.391,6,16,.375,27,39,.692,81,28,88,.318,21,67,.313,7,21,.333,9,12,.750,72,2014-01-10,CHI,MIL
62,@,L 81-99 ,240,30,81,.370,21,49,.429,9,32,.281,12,17,.706,81,41,88,.466,34,69,.493,7,19,.368,10,14,.714,99,2014-01-25,HOU,MEM
63,Home,L 81-98 ,240,30,87,.345,26,63,.413,4,24,.167,17,22,.773,81,43,83,.518,37,70,.529,6,13,.462,6,10,.600,98,2014-01-28,POR,MEM
64,@,L 81-96 ,240,31,78,.397,27,54,.500,4,24,.167,15,17,.882,81,41,89,.461,33,65,.508,8,24,.333,6,9,.667,96,2014-02-01,OKC,WAS
65,@,L 81-103 ,240,31,76,.408,19,41,.463,12,35,.343,7,14,.500,81,38,81,.469,28,63,.444,10,18,.556,17,22,.773,103,2014-02-07,UTA,DAL
66,@,L 81-93 ,240,30,83,.361,24,65,.369,6,18,.333,15,27,.556,81,35,66,.530,29,38,.763,6,28,.214,17,29,.586,93,2014-02-09,NOP,BRK
67,@,W 81-73 ,240,30,84,.357,25,65,.385,5,19,.263,16,21,.762,81,27,84,.321,20,60,.333,7,24,.292,12,14,.857,73,2014-02-12,DAL,IND
68,Home,L 81-86 ,240,34,83,.410,30,70,.429,4,13,.308,9,10,.900,81,36,77,.468,34,65,.523,2,12,.167,12,18,.667,86,2014-02-12,ORL,MEM
69,Home,L 81-103 ,240,28,74,.378,26,54,.481,2,20,.100,23,30,.767,81,41,75,.547,36,54,.667,5,21,.238,16,21,.762,103,2014-02-20,OKC,MIA
70,@,L 81-92 ,240,32,86,.372,27,62,.435,5,24,.208,12,18,.667,81,35,83,.422,34,70,.486,1,13,.077,21,27,.778,92,2014-03-02,PHI,ORL
71,@,L 81-108 ,240,30,73,.411,24,46,.522,6,27,.222,15,20,.750,81,42,85,.494,30,54,.556,12,31,.387,12,18,.667,108,2014-03-07,UTA,NYK
72,@,L 81-91 ,240,30,87,.345,29,67,.433,1,20,.050,20,22,.909,81,31,70,.443,26,56,.464,5,14,.357,24,31,.774,91,2014-03-22,PHI,CHI
73,@,L 81-94 ,240,31,85,.365,22,67,.328,9,18,.500,10,16,.625,81,33,69,.478,24,46,.522,9,23,.391,19,25,.760,94,2014-03-28,SAC,OKC
74,@,L 81-110 ,240,26,65,.400,18,39,.462,8,26,.308,21,28,.750,81,42,70,.600,31,45,.689,11,25,.440,15,20,.750,110,2014-04-02,BRK,NYK
75,@,L 81-93 ,240,32,86,.372,27,63,.429,5,23,.217,12,22,.545,81,36,88,.409,27,64,.422,9,24,.375,12,21,.571,93,2014-10-31,PHI,MIL
76,@,L 81-93 ,240,29,86,.337,25,62,.403,4,24,.167,19,29,.655,81,31,76,.408,27,62,.435,4,14,.286,27,37,.730,93,2014-11-03,NOP,MEM
77,Home,L 81-87 ,240,31,78,.397,25,54,.463,6,24,.250,13,22,.591,81,37,83,.446,30,62,.484,7,21,.333,6,7,.857,87,2014-11-04,IND,MIL
78,@,L 81-98 ,240,31,90,.344,29,70,.414,2,20,.100,17,19,.895,81,34,72,.472,24,45,.533,10,27,.370,20,33,.606,98,2014-11-06,SAS,HOU
79,@,W 81-75 ,240,30,80,.375,22,54,.407,8,26,.308,13,15,.867,81,29,68,.426,20,48,.417,9,20,.450,8,18,.444,75,2014-11-12,IND,MIA
80,@,L 81-98 ,240,30,84,.357,22,61,.361,8,23,.348,13,19,.684,81,35,81,.432,25,57,.439,10,24,.417,18,26,.692,98,2014-11-18,OKC,UTA
81,@,L 81-87 ,240,30,77,.390,21,51,.412,9,26,.346,12,16,.750,81,29,78,.372,20,49,.408,9,29,.310,20,27,.741,87,2014-12-12,ORL,ATL
82,Home,L 81-97 ,240,32,91,.352,22,67,.328,10,24,.417,7,14,.500,81,38,76,.500,25,43,.581,13,33,.394,8,14,.571,97,2015-01-02,NYK,DET
83,Home,L 81-89 ,240,30,74,.405,27,60,.450,3,14,.214,18,26,.692,81,35,88,.398,30,70,.429,5,18,.278,14,17,.824,89,2015-01-07,BRK,BOS
84,@,L 81-96 ,240,29,75,.387,25,58,.431,4,17,.235,19,29,.655,81,36,80,.450,29,58,.500,7,22,.318,17,27,.630,96,2015-01-16,NOP,PHI
85,@,L 81-104 ,240,30,81,.370,24,60,.400,6,21,.286,15,18,.833,81,36,76,.474,30,57,.526,6,19,.316,26,32,.813,104,2015-01-22,SAS,CHI
86,@,L 81-89 ,240,29,84,.345,23,61,.377,6,23,.261,17,20,.850,81,29,74,.392,20,51,.392,9,23,.391,22,30,.733,89,2015-02-07,CHO,PHI
87,@,L 81-89 ,240,30,84,.357,23,58,.397,7,26,.269,14,21,.667,81,33,78,.423,28,63,.444,5,15,.333,18,22,.818,89,2015-02-20,DEN,MIL
88,@,L 81-92 ,240,33,90,.367,27,71,.380,6,19,.316,9,13,.692,81,36,78,.462,31,60,.517,5,18,.278,15,19,.789,92,2015-02-22,CHO,DAL
89,@,L 81-90 ,240,32,79,.405,27,60,.450,5,19,.263,12,21,.571,81,34,83,.410,30,68,.441,4,15,.267,18,23,.783,90,2015-02-23,SAS,UTA
90,@,L 81-89 ,240,30,93,.323,26,76,.342,4,17,.235,17,22,.773,81,28,80,.350,16,47,.340,12,33,.364,21,34,.618,89,2015-02-27,WAS,PHI
91,@,L 81-92 ,240,30,81,.370,22,63,.349,8,18,.444,13,21,.619,81,33,80,.413,31,71,.437,2,9,.222,24,28,.857,92,2015-03-16,DEN,MEM
92,@,L 81-97 ,240,25,69,.362,17,53,.321,8,16,.500,23,26,.885,81,37,88,.420,26,58,.448,11,30,.367,12,15,.800,97,2015-03-20,NYK,PHI
93,Home,L 81-87 ,240,32,87,.368,26,67,.388,6,20,.300,11,12,.917,81,36,89,.404,29,63,.460,7,26,.269,8,18,.444,87,2015-03-27,PHO,POR
94,Home,L 81-95 ,240,32,79,.405,27,64,.422,5,15,.333,12,12,1.000,81,37,74,.500,29,56,.518,8,18,.444,13,17,.765,95,2015-03-31,MIA,SAS
95,@,L 81-100 ,240,30,82,.366,23,59,.390,7,23,.304,14,20,.700,81,34,77,.442,25,56,.446,9,21,.429,23,27,.852,100,2015-11-13,NOP,TOR
96,@,L 81-105 ,240,34,98,.347,28,63,.444,6,35,.171,7,8,.875,81,37,84,.440,26,60,.433,11,24,.458,20,26,.769,105,2015-11-14,DEN,PHO
97,@,L 81-104 ,240,32,79,.405,26,59,.441,6,20,.300,11,16,.688,81,41,98,.418,25,67,.373,16,31,.516,6,7,.857,104,2015-11-25,MIA,DET
98,@,L 81-92 ,240,30,75,.400,22,50,.440,8,25,.320,13,17,.765,81,33,77,.429,26,51,.510,7,26,.269,19,27,.704,92,2015-11-28,DEN,DAL
99,@,L 81-99 ,240,29,75,.387,23,54,.426,6,21,.286,17,24,.708,81,40,81,.494,29,54,.537,11,27,.407,8,17,.471,99,2015-12-09,MIA,CHO
0,@,L 81-118 ,240,32,79,.405,29,68,.426,3,11,.273,14,17,.824,81,42,75,.560,33,54,.611,9,21,.429,25,27,.926,118,2015-12-14,UTA,SAS
1,@,L 81-107 ,240,33,90,.367,25,57,.439,8,33,.242,7,10,.700,81,43,89,.483,32,60,.533,11,29,.379,10,17,.588,107,2015-12-16,DAL,IND
2,@,L 81-108 ,240,31,84,.369,25,65,.385,6,19,.316,13,17,.765,81,39,85,.459,29,69,.420,10,16,.625,20,25,.800,108,2016-01-01,NYK,CHI
3,@,L 81-98 ,240,30,87,.345,24,65,.369,6,22,.273,15,20,.750,81,41,80,.513,32,61,.525,9,19,.474,7,10,.700,98,2016-01-18,ORL,ATL
4,@,L 81-101 ,240,33,81,.407,29,64,.453,4,17,.235,11,17,.647,81,35,75,.467,22,50,.440,13,25,.520,18,21,.857,101,2016-01-22,MIA,TOR
5,@,L 81-85 ,240,26,70,.371,22,52,.423,4,18,.222,25,33,.758,81,33,74,.446,28,52,.538,5,22,.227,14,20,.700,85,2016-02-03,DEN,UTA
6,@,L 81-84 ,240,30,71,.423,23,57,.404,7,14,.500,14,21,.667,81,30,77,.390,22,50,.440,8,27,.296,16,23,.696,84,2016-02-05,MIL,UTA
7,Home,L 81-87 ,240,30,85,.353,17,39,.436,13,46,.283,8,14,.571,81,34,90,.378,28,66,.424,6,24,.250,13,17,.765,87,2016-02-24,LAC,DEN
8,Home,L 81-98 ,240,32,87,.368,26,72,.361,6,15,.400,11,12,.917,81,40,84,.476,39,76,.513,1,8,.125,17,21,.810,98,2016-02-28,NYK,MIA
9,@,L 81-97 ,240,31,78,.397,25,59,.424,6,19,.316,13,23,.565,81,43,84,.512,40,70,.571,3,14,.214,8,9,.889,97,2016-03-02,DET,SAS
10,@,L 81-130 ,240,30,101,.297,26,84,.310,4,17,.235,17,28,.607,81,46,85,.541,30,52,.577,16,33,.485,22,34,.647,130,2016-03-14,MEM,HOU
11,@,L 81-124 ,240,32,79,.405,29,56,.518,3,23,.130,14,22,.636,81,51,90,.567,43,72,.597,8,18,.444,14,18,.778,124,2016-03-14,DET,WAS
12,@,L 81-103 ,240,26,83,.313,20,63,.317,6,20,.300,23,25,.920,81,40,78,.513,33,58,.569,7,20,.350,16,26,.615,103,2016-04-05,LAL,LAC
13,Home,L 81-91 ,240,32,90,.356,28,71,.394,4,19,.211,13,17,.765,81,37,83,.446,30,58,.517,7,25,.280,10,14,.714,91,2016-04-06,LAL,LAC
14,@,L 81-116 ,240,32,96,.333,21,59,.356,11,37,.297,6,13,.462,81,47,97,.485,37,62,.597,10,35,.286,12,19,.632,116,2016-04-13,SAC,HOU
15,@,L 81-97 ,240,33,77,.429,26,51,.510,7,26,.269,8,10,.800,81,35,77,.455,23,52,.442,12,25,.480,15,26,.577,97,2016-11-02,DAL,UTA
16,@,L 81-104 ,240,29,93,.312,23,74,.311,6,19,.316,17,20,.850,81,40,83,.482,29,58,.500,11,25,.440,13,14,.929,104,2016-11-18,DET,CLE
17,Home,L 81-90 ,240,29,82,.354,25,63,.397,4,19,.211,19,23,.826,81,33,85,.388,21,54,.389,12,31,.387,12,18,.667,90,2016-11-25,MEM,MIA
18,@,L 81-91 ,240,30,77,.390,25,57,.439,5,20,.250,16,18,.889,81,32,77,.416,22,50,.440,10,27,.370,17,20,.850,91,2016-11-27,NOP,DAL
19,@,L 80-96 ,240,36,89,.404,36,74,.486,0,15,.000,8,16,.500,80,35,85,.412,27,62,.435,8,23,.348,18,21,.857,96,2012-01-01,NOH,SAC
20,Home,L 80-103 ,240,29,78,.372,20,52,.385,9,26,.346,13,22,.591,80,39,83,.470,31,55,.564,8,28,.286,17,20,.850,103,2012-01-07,DET,NYK
21,Home,L 80-87 ,240,34,90,.378,30,74,.405,4,16,.250,8,16,.500,80,24,70,.343,18,45,.400,6,25,.240,33,38,.868,87,2012-01-13,NOH,MIN
22,@,L 80-97 ,240,34,83,.410,30,70,.429,4,13,.308,8,9,.889,80,40,81,.494,32,62,.516,8,19,.421,9,12,.750,97,2012-01-17,DET,HOU
23,@,L 80-92 ,240,29,76,.382,23,56,.411,6,20,.300,16,22,.727,80,32,77,.416,20,50,.400,12,27,.444,16,26,.615,92,2012-01-20,LAL,ORL
24,@,L 80-88 ,240,26,74,.351,23,57,.404,3,17,.176,25,33,.758,80,34,81,.420,30,67,.448,4,14,.286,16,19,.842,88,2012-02-03,MIL,DET
25,@,L 80-98 ,240,32,87,.368,29,73,.397,3,14,.214,13,16,.813,80,36,73,.493,29,53,.547,7,20,.350,19,21,.905,98,2012-02-05,MEM,BOS
26,@,L 80-85 ,240,31,79,.392,27,60,.450,4,19,.211,14,19,.737,80,35,94,.372,31,83,.373,4,11,.364,11,15,.733,85,2012-02-08,MIN,MEM
27,@,L 80-86 ,240,30,73,.411,26,59,.441,4,14,.286,16,23,.696,80,32,75,.427,29,64,.453,3,11,.273,19,28,.679,86,2012-02-13,UTA,NOH
28,@,L 80-89 ,240,31,78,.397,28,63,.444,3,15,.200,15,18,.833,80,30,76,.395,20,55,.364,10,21,.476,19,28,.679,89,2012-02-16,BOS,CHI
29,@,L 80-89 ,240,33,79,.418,30,66,.455,3,13,.231,11,15,.733,80,31,77,.403,25,56,.446,6,21,.286,21,31,.677,89,2012-03-17,PHI,CHI
30,Home,L 80-105 ,240,29,75,.387,27,67,.403,2,8,.250,20,28,.714,80,46,86,.535,41,75,.547,5,11,.455,8,9,.889,105,2012-03-19,CHA,PHI
31,@,L 80-93 ,240,31,82,.378,27,64,.422,4,18,.222,14,21,.667,80,37,79,.468,25,44,.568,12,35,.343,7,12,.583,93,2012-03-23,CLE,ORL
32,@,L 80-89 ,240,31,85,.365,25,61,.410,6,24,.250,12,18,.667,80,26,74,.351,19,43,.442,7,31,.226,30,35,.857,89,2012-03-26,MIL,NYK
33,Home,L 80-96 ,240,30,72,.417,21,48,.438,9,24,.375,11,16,.688,80,38,78,.487,25,53,.472,13,25,.520,7,15,.467,96,2012-04-05,ORL,NYK
34,Home,L 80-84 ,240,31,73,.425,28,58,.483,3,15,.200,15,24,.625,80,25,73,.342,20,56,.357,5,17,.294,29,40,.725,84,2012-04-06,TOR,CLE
35,Home,L 80-91 ,240,33,91,.363,26,72,.361,7,19,.368,7,9,.778,80,34,73,.466,31,58,.534,3,15,.200,20,28,.714,91,2012-04-19,DET,MIN
36,Home,L 80-85 ,240,32,79,.405,29,70,.414,3,9,.333,13,18,.722,80,34,75,.453,32,67,.478,2,8,.250,15,21,.714,85,2012-04-20,CHA,MEM
37,@,L 80-92 ,240,32,89,.360,29,73,.397,3,16,.188,13,16,.813,80,32,87,.368,30,70,.429,2,17,.118,26,36,.722,92,2012-11-02,SAC,MIN
38,@,L 80-87 ,240,33,85,.388,30,72,.417,3,13,.231,11,15,.733,80,34,80,.425,28,67,.418,6,13,.462,13,16,.813,87,2012-11-10,MIN,CHI
39,@,L 80-101 ,240,30,89,.337,28,75,.373,2,14,.143,18,22,.818,80,37,75,.493,32,59,.542,5,16,.313,22,30,.733,101,2012-11-17,CHI,LAC
40,Home,L 80-102 ,240,29,69,.420,21,51,.412,8,18,.444,14,21,.667,80,37,83,.446,23,47,.489,14,36,.389,14,19,.737,102,2012-11-20,NOH,NYK
41,@,W 80-76 ,240,29,80,.363,27,70,.386,2,10,.200,20,27,.741,80,28,73,.384,24,61,.393,4,12,.333,16,20,.800,76,2012-12-04,IND,CHI
42,Home,L 80-99 ,240,29,75,.387,21,54,.389,8,21,.381,14,18,.778,80,36,86,.419,27,67,.403,9,19,.474,18,22,.818,99,2012-12-08,POR,SAC
43,Home,L 80-86 ,240,31,81,.383,24,59,.407,7,22,.318,11,11,1.000,80,35,80,.438,29,58,.500,6,22,.273,10,16,.625,86,2012-12-12,ORL,ATL
44,@,L 80-82 ,240,33,73,.452,31,63,.492,2,10,.200,12,12,1.000,80,34,89,.382,29,67,.433,5,22,.227,9,11,.818,82,2012-12-12,MEM,PHO
45,Home,W 80-71 ,240,30,80,.375,24,69,.348,6,11,.545,14,19,.737,80,28,75,.373,26,64,.406,2,11,.182,13,20,.650,71,2012-12-17,MEM,CHI
46,@,L 80-90 ,240,30,85,.353,25,65,.385,5,20,.250,15,19,.789,80,36,88,.409,33,80,.413,3,8,.375,15,19,.789,90,2012-12-19,MIL,MEM
47,@,L 80-99 ,240,31,79,.392,22,54,.407,9,25,.360,9,12,.750,80,44,86,.512,36,67,.537,8,19,.421,3,7,.429,99,2012-12-21,ATL,PHI
48,@,L 80-100 ,240,33,78,.423,26,60,.433,7,18,.389,7,12,.583,80,34,71,.479,26,52,.500,8,19,.421,24,29,.828,100,2012-12-26,TOR,SAS
49,Home,L 80-87 ,240,34,75,.453,30,60,.500,4,15,.267,8,11,.727,80,40,89,.449,39,80,.488,1,9,.111,6,9,.667,87,2013-01-04,PHO,UTA
50,@,L 80-95 ,240,31,82,.378,26,64,.406,5,18,.278,13,18,.722,80,40,92,.435,37,72,.514,3,20,.150,12,20,.600,95,2013-01-05,MIL,IND
51,@,L 80-100 ,240,30,80,.375,24,57,.421,6,23,.261,14,17,.824,80,44,78,.564,42,67,.627,2,11,.182,10,12,.833,100,2013-01-23,IND,POR
52,@,L 80-97 ,240,28,81,.346,24,54,.444,4,27,.148,20,23,.870,80,38,75,.507,32,56,.571,6,19,.316,15,22,.682,97,2013-01-26,NYK,PHI
53,Home,L 80-125 ,240,32,81,.395,27,63,.429,5,18,.278,11,19,.579,80,47,89,.528,31,55,.564,16,34,.471,15,18,.833,125,2013-01-28,UTA,HOU
54,@,L 80-89 ,240,30,79,.380,29,69,.420,1,10,.100,19,25,.760,80,36,76,.474,33,62,.532,3,14,.214,14,19,.737,89,2013-02-01,SAC,PHI
55,Home,L 80-93 ,240,32,77,.416,27,59,.458,5,18,.278,11,16,.688,80,36,83,.434,30,60,.500,6,23,.261,15,22,.682,93,2013-03-09,ATL,BRK
56,@,L 80-87 ,240,30,85,.353,26,73,.356,4,12,.333,16,19,.842,80,35,77,.455,34,65,.523,1,12,.083,16,22,.727,87,2013-03-15,MEM,DEN
57,@,L 80-93 ,240,29,81,.358,17,55,.309,12,26,.462,10,14,.714,80,34,75,.453,26,47,.553,8,28,.286,17,31,.548,93,2013-03-17,NYK,LAC
58,@,L 80-103 ,240,27,84,.321,22,64,.344,5,20,.250,21,29,.724,80,29,63,.460,21,49,.429,8,14,.571,37,41,.902,103,2013-03-27,WAS,OKC
59,Home,L 80-90 ,240,31,79,.392,24,54,.444,7,25,.280,11,14,.786,80,32,81,.395,23,60,.383,9,21,.429,17,18,.944,90,2013-04-09,UTA,OKC
60,@,L 80-90 ,240,28,65,.431,20,37,.541,8,28,.286,16,26,.615,80,35,82,.427,24,51,.471,11,31,.355,9,11,.818,90,2013-04-14,IND,NYK
61,Home,L 80-96 ,240,32,75,.427,30,58,.517,2,17,.118,14,18,.778,80,36,77,.468,33,67,.493,3,10,.300,21,23,.913,96,2013-04-15,MIN,UTA
62,@,L 80-97 ,240,26,73,.356,21,58,.362,5,15,.333,23,27,.852,80,36,86,.419,29,68,.426,7,18,.389,18,21,.857,97,2013-11-06,CHI,IND
63,Home,L 80-86 ,240,32,79,.405,28,64,.438,4,15,.267,12,17,.706,80,32,80,.400,24,60,.400,8,20,.400,14,20,.700,86,2013-11-15,CLE,CHA
64,Home,L 80-96 ,240,29,82,.354,24,61,.393,5,21,.238,17,22,.773,80,36,80,.450,29,64,.453,7,16,.438,17,19,.895,96,2013-11-15,TOR,CHI
65,@,L 80-93 ,240,32,83,.386,29,63,.460,3,20,.150,13,15,.867,80,32,74,.432,26,49,.531,6,25,.240,23,31,.742,93,2013-11-27,NYK,LAC
66,@,L 80-98 ,240,30,77,.390,27,62,.435,3,15,.200,17,19,.895,80,33,73,.452,24,60,.400,9,13,.692,23,29,.793,98,2013-12-02,ORL,WAS
67,@,L 80-83 ,240,31,84,.369,24,70,.343,7,14,.500,11,15,.733,80,34,80,.425,26,59,.441,8,21,.381,7,9,.778,83,2013-12-30,CHA,UTA
68,Home,L 80-92 ,240,32,78,.410,26,52,.500,6,26,.231,10,18,.556,80,37,76,.487,32,63,.508,5,13,.385,13,16,.813,92,2014-01-05,DAL,NYK
69,Home,L 80-101 ,240,31,80,.388,26,65,.400,5,15,.333,13,18,.722,80,39,85,.459,29,53,.547,10,32,.313,13,20,.650,101,2014-01-07,MIL,GSW
70,@,L 80-83 ,240,29,70,.414,23,51,.451,6,19,.316,16,22,.727,80,32,86,.372,23,54,.426,9,32,.281,10,11,.909,83,2014-01-10,HOU,ATL
71,@,L 80-96 ,240,30,75,.400,22,50,.440,8,25,.320,12,18,.667,80,32,79,.405,21,54,.389,11,25,.440,21,28,.750,96,2014-01-11,BRK,TOR
72,@,L 80-124 ,240,31,80,.388,24,59,.407,7,21,.333,11,23,.478,80,42,81,.519,27,51,.529,15,30,.500,25,30,.833,124,2014-01-12,CLE,SAC
73,Home,L 80-103 ,240,24,71,.338,16,46,.348,8,25,.320,24,37,.649,80,37,75,.493,23,37,.622,14,38,.368,15,20,.750,103,2014-01-20,NYK,BRK
74,@,L 80-123 ,240,33,90,.367,31,73,.425,2,17,.118,12,17,.706,80,43,88,.489,31,59,.525,12,29,.414,25,30,.833,123,2014-02-10,PHI,GSW
75,@,L 80-119 ,240,28,89,.315,22,63,.349,6,26,.231,18,26,.692,80,46,80,.575,42,64,.656,4,16,.250,23,26,.885,119,2014-02-10,DEN,IND
76,@,L 80-124 ,240,32,81,.395,28,59,.475,4,22,.182,12,17,.706,80,46,86,.535,33,55,.600,13,31,.419,19,21,.905,124,2014-02-26,BRK,POR
77,@,L 80-96 ,240,30,65,.462,26,52,.500,4,13,.308,16,23,.696,80,34,73,.466,27,48,.563,7,25,.280,21,28,.750,96,2014-03-03,CHI,BRK
78,Home,L 80-87 ,240,29,94,.309,26,73,.356,3,21,.143,19,21,.905,80,34,80,.425,29,54,.537,5,26,.192,14,20,.700,87,2014-03-14,BOS,PHO
79,@,L 80-102 ,240,29,83,.349,21,59,.356,8,24,.333,14,20,.700,80,42,94,.447,34,66,.515,8,28,.286,10,15,.667,102,2014-03-16,CLE,LAC
80,@,L 80-96 ,240,32,81,.395,29,69,.420,3,12,.250,13,16,.813,80,37,78,.474,28,57,.491,9,21,.429,13,20,.650,96,2014-03-29,NOP,SAS
81,@,L 80-94 ,240,31,77,.403,24,52,.462,7,25,.280,11,15,.733,80,38,80,.475,35,64,.547,3,16,.188,15,16,.938,94,2014-03-31,BOS,CHI
82,@,L 80-91 ,240,31,87,.356,28,76,.368,3,11,.273,15,18,.833,80,33,78,.423,27,62,.435,6,16,.375,19,23,.826,91,2014-04-04,ORL,CHA
83,Home,L 80-104 ,240,31,85,.365,28,68,.412,3,17,.176,15,17,.882,80,36,71,.507,29,47,.617,7,24,.292,25,30,.833,104,2014-10-29,NYK,CHI
84,Home,L 80-93 ,240,28,75,.373,26,63,.413,2,12,.167,22,31,.710,80,33,80,.413,23,57,.404,10,23,.435,17,20,.850,93,2014-11-14,LAL,SAS
85,Home,L 80-107 ,240,32,80,.400,22,58,.379,10,22,.455,6,13,.462,80,43,84,.512,33,56,.589,10,28,.357,11,16,.688,107,2014-11-17,CHO,DAL
86,@,L 80-83 ,240,30,81,.370,24,64,.375,6,17,.353,14,21,.667,80,35,76,.461,30,64,.469,5,12,.417,8,12,.667,83,2014-11-29,NOP,WAS
87,@,L 80-105 ,240,29,88,.330,26,74,.351,3,14,.214,19,24,.792,80,37,79,.468,29,57,.509,8,22,.364,23,32,.719,105,2014-12-10,BRK,CHI
88,Home,L 80-103 ,240,31,82,.378,26,53,.491,5,29,.172,13,17,.765,80,41,91,.451,24,60,.400,17,31,.548,4,9,.444,103,2014-12-28,CLE,DET
89,Home,L 80-96 ,240,29,85,.341,21,54,.389,8,31,.258,14,16,.875,80,40,90,.444,29,65,.446,11,25,.440,5,10,.500,96,2014-12-31,CLE,MIL
90,Home,L 80-102 ,240,31,73,.425,27,56,.482,4,17,.235,14,16,.875,80,37,81,.457,33,69,.478,4,12,.333,24,31,.774,102,2015-01-16,WAS,BRK
91,Home,W 80-71 (OT),265,31,101,.307,29,86,.337,2,15,.133,16,25,.640,80,30,84,.357,28,63,.444,2,21,.095,9,13,.692,71,2015-01-17,CHO,IND
92,@,L 80-105 ,240,29,80,.363,23,61,.377,6,19,.316,16,20,.800,80,40,89,.449,28,67,.418,12,22,.545,13,19,.684,105,2015-01-19,MIN,CHO
93,@,L 80-96 ,240,28,77,.364,22,57,.386,6,20,.300,18,21,.857,80,38,83,.458,35,67,.522,3,16,.188,17,21,.810,96,2015-01-21,LAL,NOP
94,@,L 80-92 ,240,27,76,.355,20,60,.333,7,16,.438,19,23,.826,80,37,84,.440,27,62,.435,10,22,.455,8,13,.615,92,2015-02-01,LAL,NYK
95,@,L 80-96 ,240,33,83,.398,29,61,.475,4,22,.182,10,15,.667,80,33,77,.429,26,52,.500,7,25,.280,23,27,.852,96,2015-02-09,ORL,WAS
96,Home,L 80-105 ,240,29,88,.330,21,50,.420,8,38,.211,14,21,.667,80,43,96,.448,30,66,.455,13,30,.433,6,8,.750,105,2015-02-20,ATL,TOR
97,Home,L 80-98 ,240,29,77,.377,25,66,.379,4,11,.364,18,23,.783,80,35,83,.422,22,52,.423,13,31,.419,15,19,.789,98,2015-03-09,PHO,GSW
98,@,W 80-73 ,240,25,62,.403,16,37,.432,9,25,.360,21,31,.677,80,31,77,.403,28,66,.424,3,11,.273,8,17,.471,73,2015-03-19,UTA,LAL
99,Home,L 80-111 ,240,29,82,.354,24,59,.407,5,23,.217,17,19,.895,80,44,78,.564,33,50,.660,11,28,.393,12,18,.667,111,2015-03-25,NYK,LAC
0,@,L 80-111 ,240,30,79,.380,26,62,.419,4,17,.235,16,19,.842,80,43,84,.512,37,67,.552,6,17,.353,19,22,.864,111,2015-03-28,NYK,CHI
1,@,L 80-104 ,240,30,83,.361,22,53,.415,8,30,.267,12,18,.667,80,41,82,.500,31,54,.574,10,28,.357,12,16,.750,104,2015-04-10,CHO,ATL
2,@,L 80-117 ,240,32,82,.390,27,67,.403,5,15,.333,11,17,.647,80,45,89,.506,33,69,.478,12,20,.600,15,23,.652,117,2015-04-10,WAS,BRK
3,@,W 80-79 ,240,31,82,.378,25,62,.403,6,20,.300,12,13,.923,80,30,84,.357,24,62,.387,6,22,.273,13,18,.722,79,2015-04-11,NYK,ORL
4,@,L 80-93 ,240,31,75,.413,24,56,.429,7,19,.368,11,13,.846,80,38,89,.427,31,66,.470,7,23,.304,10,13,.769,93,2015-11-16,POR,SAS
5,Home,L 80-91 ,240,29,74,.392,22,42,.524,7,32,.219,15,20,.750,80,29,78,.372,25,61,.410,4,17,.235,29,31,.935,91,2015-11-22,LAC,TOR
6,@,L 80-84 ,240,31,83,.373,24,56,.429,7,27,.259,11,15,.733,80,31,91,.341,22,62,.355,9,29,.310,13,18,.722,84,2015-11-25,PHI,BOS
7,Home,L 80-91 ,240,31,77,.403,24,57,.421,7,20,.350,11,13,.846,80,36,75,.480,28,53,.528,8,22,.364,11,14,.786,91,2015-11-27,DEN,SAS
8,@,L 80-83 ,240,30,88,.341,20,66,.303,10,22,.455,10,12,.833,80,31,87,.356,24,64,.375,7,23,.304,14,16,.875,83,2015-12-10,LAC,CHI
9,@,L 80-94 ,240,28,80,.350,18,41,.439,10,39,.256,14,20,.700,80,36,77,.468,31,67,.463,5,10,.500,17,27,.630,94,2015-12-30,UTA,MIN
10,Home,L 80-88 ,240,32,91,.352,28,72,.389,4,19,.211,12,15,.800,80,35,88,.398,28,63,.444,7,25,.280,11,14,.786,88,2016-03-20,NYK,SAC
11,Home,L 80-109 ,240,35,88,.398,31,72,.431,4,16,.250,6,12,.500,80,41,75,.547,23,39,.590,18,36,.500,9,10,.900,109,2016-04-05,MIL,CLE
12,@,L 80-116 ,240,27,75,.360,23,51,.451,4,24,.167,22,29,.759,80,43,78,.551,31,58,.534,12,20,.600,18,23,.783,116,2016-11-01,MEM,MIN
13,@,L 80-112 ,240,33,85,.388,24,55,.436,9,30,.300,5,6,.833,80,42,89,.472,39,70,.557,3,19,.158,25,31,.806,112,2016-11-07,ORL,CHI
14,@,L 80-111 ,240,31,88,.352,25,58,.431,6,30,.200,12,14,.857,80,38,87,.437,27,55,.491,11,32,.344,24,33,.727,111,2016-11-09,POR,LAC
15,@,W 80-64 ,240,31,77,.403,22,52,.423,9,25,.360,9,12,.750,80,21,73,.288,16,48,.333,5,25,.200,17,22,.773,64,2016-11-18,MEM,DAL
16,@,L 80-113 ,240,32,93,.344,26,67,.388,6,26,.231,10,17,.588,80,45,83,.542,33,54,.611,12,29,.414,11,13,.846,113,2016-12-02,LAL,TOR
17,@,L 80-114 ,240,25,74,.338,21,52,.404,4,22,.182,26,38,.684,80,43,82,.524,30,60,.500,13,22,.591,15,20,.750,114,2016-12-29,OKC,MEM
18,@,L 80-112 ,240,32,82,.390,29,59,.492,3,23,.130,13,18,.722,80,45,91,.495,28,56,.500,17,35,.486,5,6,.833,112,2017-02-11,ORL,DAL
19,Home,L 80-107 ,240,35,90,.389,31,71,.437,4,19,.211,6,11,.545,80,39,78,.500,31,62,.500,8,16,.500,21,26,.808,107,2017-03-01,UTA,MIN
20,@,L 79-91 ,240,27,75,.360,20,56,.357,7,19,.368,18,21,.857,79,32,87,.368,25,72,.347,7,15,.467,20,25,.800,91,2011-12-26,DET,IND
21,@,L 79-101 ,240,31,82,.378,28,66,.424,3,16,.188,14,22,.636,79,38,85,.447,35,67,.522,3,18,.167,22,28,.786,101,2011-12-27,SAC,POR
22,Home,L 79-100 ,240,30,83,.361,25,68,.368,5,15,.333,14,18,.778,79,37,84,.440,25,56,.446,12,28,.429,14,24,.583,100,2011-12-30,CHA,ORL
23,Home,L 79-107 ,240,34,89,.382,30,72,.417,4,17,.235,7,12,.583,79,39,79,.494,28,59,.475,11,20,.550,18,31,.581,107,2011-12-31,GSW,PHI
24,@,L 79-85 ,240,32,81,.395,29,66,.439,3,15,.200,12,18,.667,79,32,77,.416,26,55,.473,6,22,.273,15,19,.789,85,2012-01-11,PHI,NYK
25,Home,L 79-88 ,240,31,75,.413,25,61,.410,6,14,.429,11,13,.846,79,34,76,.447,30,63,.476,4,13,.308,16,21,.762,88,2012-01-13,BOS,CHI
26,@,L 79-108 ,240,31,85,.365,27,65,.415,4,20,.200,13,21,.619,79,39,82,.476,36,74,.486,3,8,.375,27,31,.871,108,2012-01-17,LAC,UTA
27,@,W 79-71 ,240,31,69,.449,26,50,.520,5,19,.263,12,16,.750,79,30,74,.405,26,64,.406,4,10,.400,7,9,.778,71,2012-01-20,PHO,BOS
28,@,L 79-99 ,240,28,82,.341,24,68,.353,4,14,.286,19,27,.704,79,41,77,.532,34,61,.557,7,16,.438,10,14,.714,99,2012-01-23,DET,OKC
29,@,L 79-87 ,240,31,75,.413,24,59,.407,7,16,.438,10,11,.909,79,36,82,.439,34,73,.466,2,9,.222,13,18,.722,87,2012-01-27,SAS,MIN
30,Home,L 79-99 ,240,32,81,.395,27,69,.391,5,12,.417,10,14,.714,79,40,77,.519,32,64,.500,8,13,.615,11,20,.550,99,2012-02-03,PHI,MIA
31,@,L 79-90 ,240,30,74,.405,21,49,.429,9,25,.360,10,21,.476,79,34,88,.386,26,68,.382,8,20,.400,14,19,.737,90,2012-02-20,ATL,CHI
32,@,L 79-121 ,240,28,75,.373,23,58,.397,5,17,.294,18,23,.783,79,43,80,.538,24,42,.571,19,38,.500,16,26,.615,121,2012-03-14,POR,NYK
33,@,W 79-76 ,240,29,74,.392,23,58,.397,6,16,.375,15,17,.882,79,29,75,.387,24,60,.400,5,15,.333,13,19,.684,76,2012-03-19,BOS,ATL
34,Home,L 79-82 ,240,29,75,.387,21,58,.362,8,17,.471,13,18,.722,79,29,79,.367,27,66,.409,2,13,.154,22,28,.786,82,2012-03-21,PHI,NYK
35,@,L 79-96 ,240,32,85,.376,27,57,.474,5,28,.179,10,18,.556,79,38,83,.458,37,70,.529,1,13,.077,19,26,.731,96,2012-03-23,NYK,TOR
36,@,L 79-101 ,240,28,76,.368,22,57,.386,6,19,.316,17,22,.773,79,38,78,.487,32,58,.552,6,20,.300,19,30,.633,101,2012-03-24,DET,NYK
37,@,W 79-77 ,240,28,76,.368,25,63,.397,3,13,.231,20,27,.741,79,32,78,.410,28,61,.459,4,17,.235,9,14,.643,77,2012-03-26,DET,WAS
38,Home,L 79-100 ,240,26,75,.347,20,51,.392,6,24,.250,21,25,.840,79,44,90,.489,40,78,.513,4,12,.333,8,11,.727,100,2012-03-30,MIN,BOS
39,@,L 79-103 ,240,29,76,.382,27,65,.415,2,11,.182,19,24,.792,79,40,68,.588,33,53,.623,7,15,.467,16,19,.842,103,2012-04-08,PHI,BOS
40,@,L 79-84 ,240,30,80,.375,26,61,.426,4,19,.211,15,19,.789,79,25,72,.347,18,54,.333,7,18,.389,27,31,.871,84,2012-04-13,BOS,TOR
41,@,L 79-108 ,240,28,79,.354,24,66,.364,4,13,.308,19,23,.826,79,40,77,.519,30,55,.545,10,22,.455,18,26,.692,108,2012-11-04,DET,LAL
42,@,L 79-101 ,240,27,79,.342,21,59,.356,6,20,.300,19,22,.864,79,41,87,.471,33,69,.478,8,18,.444,11,13,.846,101,2012-11-05,IND,SAS
43,@,L 79-86 ,240,30,84,.357,25,64,.391,5,20,.250,14,15,.933,79,34,80,.425,25,60,.417,9,20,.450,9,12,.750,86,2012-11-18,CLE,PHI
44,@,W 79-77 ,240,29,79,.367,25,60,.417,4,19,.211,17,27,.630,79,24,76,.316,18,48,.375,6,28,.214,23,43,.535,77,2012-11-27,IND,LAL
45,Home,L 79-100 ,240,30,81,.370,24,57,.421,6,24,.250,13,18,.722,79,40,79,.506,33,63,.524,7,16,.438,13,17,.765,100,2012-12-01,NOH,OKC
46,@,L 79-89 ,240,32,95,.337,29,75,.387,3,20,.150,12,17,.706,79,36,84,.429,32,66,.485,4,18,.222,13,19,.684,89,2012-12-03,CLE,DET
47,@,L 79-92 ,240,31,79,.392,27,62,.435,4,17,.235,13,16,.813,79,40,75,.533,36,61,.590,4,14,.286,8,12,.667,92,2012-12-08,PHI,BOS
48,@,L 79-102 ,240,31,70,.443,27,48,.563,4,22,.182,13,16,.813,79,41,77,.532,33,54,.611,8,23,.348,12,17,.706,102,2013-01-02,POR,TOR
49,@,L 79-87 ,240,33,84,.393,31,72,.431,2,12,.167,11,18,.611,79,37,81,.457,34,67,.507,3,14,.214,10,12,.833,87,2013-01-09,PHO,BOS
50,@,L 79-88 ,240,30,75,.400,21,48,.438,9,27,.333,10,13,.769,79,35,84,.417,30,65,.462,5,19,.263,13,16,.813,88,2013-01-09,HOU,NOH
51,@,L 79-99 ,240,31,79,.392,24,65,.369,7,14,.500,10,16,.625,79,34,75,.453,28,62,.452,6,13,.462,25,32,.781,99,2013-01-11,PHO,BRK
52,@,L 79-92 ,240,25,78,.321,17,47,.362,8,31,.258,21,28,.750,79,30,64,.469,27,50,.540,3,14,.214,29,36,.806,92,2013-01-19,HOU,MIN
53,@,L 79-98 ,240,32,88,.364,29,70,.414,3,18,.167,12,27,.444,79,36,81,.444,29,67,.433,7,14,.500,19,21,.905,98,2013-01-30,DET,IND
54,@,L 79-91 ,240,29,77,.377,22,57,.386,7,20,.350,14,20,.700,79,30,68,.441,26,52,.500,4,16,.250,27,33,.818,91,2013-03-10,BOS,OKC
55,@,L 79-121 ,240,32,83,.386,30,62,.484,2,21,.095,13,15,.867,79,45,83,.542,36,60,.600,9,23,.391,22,26,.846,121,2013-03-13,CHI,SAC
56,Home,L 79-88 ,240,28,83,.337,25,68,.368,3,15,.200,20,22,.909,79,33,68,.485,27,53,.509,6,15,.400,16,25,.640,88,2013-03-20,PHO,WAS
57,Home,L 79-89 ,240,28,88,.318,25,72,.347,3,16,.188,20,22,.909,79,31,69,.449,18,36,.500,13,33,.394,14,17,.824,89,2013-04-05,CHA,MIA
58,@,L 79-94 ,240,30,90,.333,21,64,.328,9,26,.346,10,14,.714,79,40,84,.476,33,63,.524,7,21,.333,7,9,.778,94,2013-11-08,CLE,PHI
59,@,L 79-95 ,240,31,75,.413,27,67,.403,4,8,.500,13,19,.684,79,37,76,.487,31,57,.544,6,19,.316,15,18,.833,95,2013-11-11,MEM,IND
60,@,L 79-92 ,240,33,91,.363,28,76,.368,5,15,.333,8,11,.727,79,39,77,.506,31,55,.564,8,22,.364,6,8,.750,92,2013-11-13,WAS,SAS
61,Home,L 79-92 ,240,30,86,.349,22,64,.344,8,22,.364,11,15,.733,79,34,82,.415,29,65,.446,5,17,.294,19,27,.704,92,2013-11-16,MIL,OKC
62,Home,L 79-99 ,240,34,77,.442,32,65,.492,2,12,.167,9,19,.474,79,42,79,.532,36,62,.581,6,17,.353,9,12,.750,99,2013-11-27,DET,CHI
63,@,L 79-106 ,240,32,84,.381,26,70,.371,6,14,.429,9,13,.692,79,41,83,.494,32,64,.500,9,19,.474,15,22,.682,106,2013-12-22,BOS,IND
64,Home,L 79-85 ,240,30,82,.366,28,73,.384,2,9,.222,17,21,.810,79,29,69,.420,25,55,.455,4,14,.286,23,31,.742,85,2013-12-31,CHI,TOR
65,Home,L 79-94 ,240,29,81,.358,22,57,.386,7,24,.292,14,18,.778,79,40,91,.440,34,68,.500,6,23,.261,8,14,.571,94,2013-12-31,LAL,MIL
66,@,L 79-86 ,240,30,81,.370,25,62,.403,5,19,.263,14,18,.778,79,32,75,.427,31,64,.484,1,11,.091,21,26,.808,86,2014-01-07,TOR,IND
67,Home,L 79-105 ,240,29,76,.382,27,63,.429,2,13,.154,19,27,.704,79,41,84,.488,30,66,.455,11,18,.611,12,17,.706,105,2014-01-24,ATL,SAS
68,Home,L 79-85 ,240,28,75,.373,21,49,.429,7,26,.269,16,19,.842,79,33,84,.393,27,59,.458,6,25,.240,13,18,.722,85,2014-01-26,BOS,BRK
69,@,L 79-88 ,240,27,70,.386,24,54,.444,3,16,.188,22,33,.667,79,38,80,.475,34,71,.479,4,9,.444,8,10,.800,88,2014-02-01,CHI,NOP
70,@,L 79-98 ,240,33,83,.398,26,67,.388,7,16,.438,6,10,.600,79,38,90,.422,30,65,.462,8,25,.320,14,17,.824,98,2014-02-03,ORL,IND
71,Home,L 79-94 ,240,32,78,.410,29,61,.475,3,17,.176,12,13,.923,79,37,84,.440,31,63,.492,6,21,.286,14,16,.875,94,2014-02-03,UTA,TOR
72,@,W 79-76 ,240,37,90,.411,33,78,.423,4,12,.333,1,1,1.000,79,30,70,.429,22,50,.440,8,20,.400,8,15,.533,76,2014-02-08,MEM,ATL
73,Home,L 79-96 ,240,33,85,.388,29,69,.420,4,16,.250,9,13,.692,79,37,85,.435,31,68,.456,6,17,.353,16,25,.640,96,2014-02-11,LAL,UTA
74,@,L 79-93 ,240,29,81,.358,23,60,.383,6,21,.286,15,17,.882,79,37,88,.420,28,65,.431,9,23,.391,10,14,.714,93,2014-02-23,CHI,MIA
75,@,L 79-99 ,240,28,80,.350,14,51,.275,14,29,.483,9,14,.643,79,43,88,.489,39,73,.534,4,15,.267,9,12,.750,99,2014-02-28,UTA,CLE
76,@,L 79-91 ,240,28,77,.364,23,66,.348,5,11,.455,18,24,.750,79,34,79,.430,32,68,.471,2,11,.182,21,25,.840,91,2014-03-21,CHI,IND
77,Home,L 79-99 ,240,32,80,.400,28,66,.424,4,14,.286,11,18,.611,79,36,93,.387,31,68,.456,5,25,.200,22,27,.815,99,2014-03-21,SAC,SAS
78,@,L 79-89 ,240,31,84,.369,25,58,.431,6,26,.231,11,19,.579,79,30,85,.353,24,61,.393,6,24,.250,23,31,.742,89,2014-10-29,DET,DEN
79,Home,L 79-86 ,240,31,88,.352,28,64,.438,3,24,.125,14,20,.700,79,30,72,.417,23,49,.469,7,23,.304,19,31,.613,86,2014-11-30,NYK,MIA
80,@,L 79-95 ,240,30,72,.417,24,47,.511,6,25,.240,13,22,.591,79,38,91,.418,28,61,.459,10,30,.333,9,13,.692,95,2014-12-10,PHI,ATL
81,@,L 79-101 ,240,31,93,.333,24,66,.364,7,27,.259,10,15,.667,79,38,81,.469,22,45,.489,16,36,.444,9,12,.750,101,2014-12-28,NYK,POR
82,@,L 79-115 ,240,30,68,.441,26,51,.510,4,17,.235,15,25,.600,79,41,83,.494,28,52,.538,13,31,.419,20,28,.714,115,2015-01-03,MIA,HOU
83,@,L 79-95 ,240,28,68,.412,20,46,.435,8,22,.364,15,20,.750,79,28,72,.389,20,54,.370,8,18,.444,31,42,.738,95,2015-01-15,NYK,MIL
84,@,L 79-122 ,240,30,87,.345,23,63,.365,7,24,.292,12,19,.632,79,44,81,.543,31,54,.574,13,27,.481,21,27,.778,122,2015-01-19,DEN,GSW
85,Home,L 79-97 ,240,33,87,.379,30,75,.400,3,12,.250,10,15,.667,79,36,78,.462,27,52,.519,9,26,.346,16,28,.571,97,2015-02-27,MEM,LAC
86,@,L 79-110 ,240,31,88,.352,24,60,.400,7,28,.250,10,13,.769,79,43,89,.483,33,61,.541,10,28,.357,14,14,1.000,110,2015-03-03,BOS,CLE
87,@,L 79-89 ,240,30,84,.357,21,59,.356,9,25,.360,10,14,.714,79,31,75,.413,23,55,.418,8,20,.400,19,23,.826,89,2015-03-07,PHO,CLE
88,Home,L 79-80 ,240,30,84,.357,24,62,.387,6,22,.273,13,18,.722,79,31,82,.378,25,62,.403,6,20,.300,12,13,.923,80,2015-04-11,ORL,NYK
89,@,L 79-89 ,240,30,91,.330,24,72,.333,6,19,.316,13,14,.929,79,31,74,.419,19,47,.404,12,27,.444,15,18,.833,89,2015-11-07,MEM,UTA
90,@,L 79-112 ,240,32,81,.395,27,63,.429,5,18,.278,10,18,.556,79,43,76,.566,37,62,.597,6,14,.429,20,33,.606,112,2015-12-30,PHO,SAS
91,@,L 79-104 ,240,29,76,.382,23,51,.451,6,25,.240,15,17,.882,79,34,82,.415,22,45,.489,12,37,.324,24,39,.615,104,2016-01-02,ORL,CLE
92,Home,L 79-106 ,240,33,73,.452,31,61,.508,2,12,.167,11,13,.846,79,44,82,.537,40,69,.580,4,13,.308,14,19,.737,106,2016-01-11,BRK,SAS
93,Home,L 79-91 ,240,27,74,.365,22,52,.423,5,22,.227,20,26,.769,79,36,74,.486,31,62,.500,5,12,.417,14,16,.875,91,2016-01-19,MIA,MIL
94,@,L 79-91 ,240,28,78,.359,24,58,.414,4,20,.200,19,23,.826,79,37,80,.463,29,59,.492,8,21,.381,9,15,.600,91,2016-01-29,BRK,DAL
95,Home,L 79-96 ,240,25,77,.325,18,41,.439,7,36,.194,22,30,.733,79,35,87,.402,24,52,.462,11,35,.314,15,23,.652,96,2016-02-06,HOU,POR
96,@,L 79-87 ,240,31,82,.378,22,46,.478,9,36,.250,8,10,.800,79,32,78,.410,24,57,.421,8,21,.381,15,18,.833,87,2016-03-19,GSW,SAS
97,@,L 79-91 ,240,31,89,.348,25,67,.373,6,22,.273,11,20,.550,79,35,80,.438,27,60,.450,8,20,.400,13,21,.619,91,2016-03-23,TOR,BOS
98,Home,L 79-99 ,240,30,87,.345,22,64,.344,8,23,.348,11,17,.647,79,37,84,.440,28,53,.528,9,31,.290,16,18,.889,99,2016-03-30,MIN,LAC
99,@,L 79-112 ,240,23,81,.284,16,50,.320,7,31,.226,26,30,.867,79,42,96,.438,30,59,.508,12,37,.324,16,27,.593,112,2016-04-11,LAL,OKC
0,@,L 79-98 ,240,32,86,.372,28,64,.438,4,22,.182,11,15,.733,79,35,83,.422,25,59,.424,10,24,.417,18,23,.783,98,2016-10-29,NOP,SAS
1,Home,L 79-97 ,240,32,82,.390,27,63,.429,5,19,.263,10,14,.714,79,38,68,.559,31,51,.608,7,17,.412,14,17,.824,97,2016-12-11,DET,PHI
2,@,L 79-99 ,240,30,76,.395,22,45,.489,8,31,.258,11,17,.647,79,34,77,.442,21,44,.477,13,33,.394,18,22,.818,99,2016-12-18,SAC,DAL
3,Home,L 79-109 ,240,34,83,.410,31,62,.500,3,21,.143,8,9,.889,79,43,87,.494,36,60,.600,7,27,.259,16,21,.762,109,2016-12-18,ORL,TOR
4,@,L 79-88 ,240,28,72,.389,19,49,.388,9,23,.391,14,23,.609,79,34,78,.436,25,54,.463,9,24,.375,11,14,.786,88,2017-01-08,UTA,MEM
5,Home,L 79-107 ,240,30,76,.395,26,58,.448,4,18,.222,15,19,.789,79,42,89,.472,34,58,.586,8,31,.258,15,19,.789,107,2017-02-15,ORL,SAS
6,@,L 78-92 ,240,28,70,.400,24,49,.490,4,21,.190,18,25,.720,78,35,77,.455,29,61,.475,6,16,.375,16,24,.667,92,2011-12-28,NYK,GSW
7,@,L 78-97 ,240,29,78,.372,22,61,.361,7,17,.412,13,18,.722,78,36,79,.456,32,67,.478,4,12,.333,21,25,.840,97,2011-12-28,BOS,NOH
8,@,L 78-94 ,240,29,77,.377,23,60,.383,6,17,.353,14,21,.667,78,36,81,.444,27,60,.450,9,21,.429,13,25,.520,94,2011-12-29,NJN,ORL
9,Home,L 78-93 ,240,26,90,.289,23,76,.303,3,14,.214,23,28,.821,78,33,78,.423,26,55,.473,7,23,.304,20,22,.909,93,2011-12-30,NOH,PHO
10,@,L 78-89 ,240,28,63,.444,20,41,.488,8,22,.364,14,21,.667,78,31,62,.500,29,54,.537,2,8,.250,25,33,.758,89,2012-01-02,ORL,DET
11,@,L 78-98 ,240,29,79,.367,26,55,.473,3,24,.125,17,24,.708,78,38,92,.413,32,69,.464,6,23,.261,16,18,.889,98,2012-01-08,CLE,POR
12,@,L 78-93 ,240,30,76,.395,26,56,.464,4,20,.200,14,17,.824,78,40,82,.488,36,69,.522,4,13,.308,9,17,.529,93,2012-01-10,TOR,WAS
13,Home,W 78-64 ,240,33,90,.367,30,78,.385,3,12,.250,9,16,.563,78,26,84,.310,23,75,.307,3,9,.333,9,12,.750,64,2012-01-11,CHI,WAS
14,Home,L 78-111 ,240,27,82,.329,24,71,.338,3,11,.273,21,22,.955,78,39,78,.500,32,59,.542,7,19,.368,26,33,.788,111,2012-01-24,CHA,NYK
15,@,W 78-77 ,240,33,85,.388,31,66,.470,2,19,.105,10,15,.667,78,29,71,.408,25,56,.446,4,15,.267,15,23,.652,77,2012-02-10,LAC,PHI
16,@,L 78-86 ,240,31,90,.344,24,63,.381,7,27,.259,9,14,.643,78,37,84,.440,29,67,.433,8,17,.471,4,9,.444,86,2012-02-14,ATL,LAL
17,@,L 78-90 ,240,27,74,.365,16,45,.356,11,29,.379,13,25,.520,78,38,80,.475,35,68,.515,3,12,.250,11,14,.786,90,2012-02-19,ORL,MIA
18,@,L 78-83 ,240,31,82,.378,24,50,.480,7,32,.219,9,13,.692,78,31,78,.397,24,61,.393,7,17,.412,14,20,.700,83,2012-02-23,ORL,ATL
19,@,L 78-102 ,240,29,85,.341,26,63,.413,3,22,.136,17,24,.708,78,37,84,.440,32,73,.438,5,11,.455,23,32,.719,102,2012-02-28,GSW,IND
20,@,L 78-81 ,240,32,87,.368,26,71,.366,6,16,.375,8,9,.889,78,28,80,.350,21,59,.356,7,21,.333,18,29,.621,81,2012-03-02,LAC,PHO
21,@,L 78-108 ,240,31,83,.373,23,61,.377,8,22,.364,8,12,.667,78,45,77,.584,35,60,.583,10,17,.588,8,9,.889,108,2012-03-06,NJN,MIA
22,Home,L 78-84 ,240,33,93,.355,28,75,.373,5,18,.278,7,14,.500,78,35,74,.473,31,62,.500,4,12,.333,10,19,.526,84,2012-03-16,PHI,MIA
23,@,L 78-92 ,240,30,91,.330,22,67,.328,8,24,.333,10,15,.667,78,36,74,.486,32,65,.492,4,9,.444,16,17,.941,92,2012-04-01,CHI,OKC
24,Home,L 78-99 ,240,34,79,.430,31,67,.463,3,12,.250,7,8,.875,78,39,77,.506,30,56,.536,9,21,.429,12,12,1.000,99,2012-04-04,PHI,TOR
25,Home,W 78-66 ,240,32,74,.432,28,62,.452,4,12,.333,10,16,.625,78,28,73,.384,22,56,.393,6,17,.353,4,7,.571,66,2012-04-24,BOS,MIA
26,@,L 78-84 ,240,31,76,.408,27,60,.450,4,16,.250,12,15,.800,78,33,71,.465,29,60,.483,4,11,.364,14,18,.778,84,2012-11-26,CLE,MEM
27,Home,L 78-91 ,240,30,84,.357,28,69,.406,2,15,.133,16,22,.727,78,37,79,.468,31,62,.500,6,17,.353,11,18,.611,91,2012-11-27,CLE,PHO
28,@,L 78-101 ,240,28,81,.346,24,63,.381,4,18,.222,18,20,.900,78,34,69,.493,28,59,.475,6,10,.600,27,33,.818,101,2012-11-28,DAL,CHI
29,@,L 78-96 ,240,24,69,.348,21,54,.389,3,15,.200,27,37,.730,78,36,73,.493,30,57,.526,6,16,.375,18,20,.900,96,2012-11-30,POR,BOS
30,@,L 78-90 ,240,29,72,.403,25,56,.446,4,16,.250,16,20,.800,78,34,85,.400,30,73,.411,4,12,.333,18,21,.857,90,2012-11-30,DET,MEM
31,@,L 78-92 ,240,30,78,.385,25,49,.510,5,29,.172,13,29,.448,78,37,82,.451,30,59,.508,7,23,.304,11,21,.524,92,2013-01-01,LAC,DEN
32,@,L 78-99 ,240,28,75,.373,25,63,.397,3,12,.250,19,22,.864,78,39,86,.453,27,59,.458,12,27,.444,9,11,.818,99,2013-01-11,CHA,TOR
33,Home,L 78-90 ,240,34,74,.459,30,56,.536,4,18,.222,6,16,.375,78,31,71,.437,29,54,.537,2,17,.118,26,31,.839,90,2013-01-16,BOS,NOH
34,@,L 78-102 ,240,30,73,.411,26,54,.481,4,19,.211,14,17,.824,78,38,69,.551,29,53,.547,9,16,.563,17,21,.810,102,2013-01-30,CHA,SAS
35,Home,W 78-61 ,240,36,79,.456,33,59,.559,3,20,.150,3,5,.600,78,27,80,.338,26,68,.382,1,12,.083,6,8,.750,61,2013-02-04,PHI,ORL
36,Home,L 78-99 ,240,32,84,.381,28,66,.424,4,18,.222,10,15,.667,78,34,67,.507,21,40,.525,13,27,.481,18,22,.818,99,2013-03-06,CHA,BRK
37,@,L 78-95 ,240,32,90,.356,29,73,.397,3,17,.176,11,17,.647,78,32,81,.395,20,54,.370,12,27,.444,19,33,.576,95,2013-03-08,WAS,BRK
38,@,L 78-92 ,240,26,80,.325,20,58,.345,6,22,.273,20,29,.690,78,33,68,.485,30,58,.517,3,10,.300,23,27,.852,92,2013-03-15,CHA,TOR
39,Home,L 78-108 ,240,28,86,.326,19,51,.373,9,35,.257,13,16,.813,78,44,96,.458,31,70,.443,13,26,.500,7,9,.778,108,2013-03-17,HOU,GSW
40,@,L 78-116 ,240,31,86,.360,27,66,.409,4,20,.200,12,15,.800,78,44,77,.571,34,48,.708,10,29,.345,18,27,.667,116,2013-03-22,CLE,HOU
41,@,L 78-102 ,240,31,101,.307,28,82,.341,3,19,.158,13,22,.591,78,38,79,.481,35,67,.522,3,12,.250,23,30,.767,102,2013-03-22,MIL,IND
42,Home,L 78-103 ,240,32,83,.386,28,69,.406,4,14,.286,10,14,.714,78,40,84,.476,33,69,.478,7,15,.467,16,26,.615,103,2013-03-28,DAL,IND
43,@,L 78-88 ,240,26,80,.325,21,61,.344,5,19,.263,21,29,.724,78,30,66,.455,29,58,.500,1,8,.125,27,36,.750,88,2013-04-03,WAS,TOR
44,Home,L 78-82 ,240,23,74,.311,12,42,.286,11,32,.344,21,28,.750,78,29,83,.349,24,66,.364,5,17,.294,19,28,.679,82,2013-04-12,HOU,MEM
45,@,W 78-74 ,240,30,75,.400,28,64,.438,2,11,.182,16,20,.800,78,31,83,.373,28,68,.412,3,15,.200,9,14,.643,74,2013-12-10,MIL,CHI
46,@,L 78-83 ,240,24,72,.333,18,51,.353,6,21,.286,24,29,.828,78,31,76,.408,26,57,.456,5,19,.263,16,19,.842,83,2013-12-11,CHI,NYK
47,Home,L 78-95 ,240,25,71,.352,20,54,.370,5,17,.294,23,31,.742,78,36,74,.486,31,57,.544,5,17,.294,18,20,.900,95,2013-12-25,BRK,CHI
48,Home,L 78-87 ,240,33,88,.375,28,64,.438,5,24,.208,7,10,.700,78,30,78,.385,24,54,.444,6,24,.250,21,23,.913,87,2014-01-01,WAS,DAL
49,Home,L 78-82 ,240,27,79,.342,21,59,.356,6,20,.300,18,20,.900,78,28,77,.364,20,53,.377,8,24,.333,18,22,.818,82,2014-01-05,CLE,IND
50,@,L 78-103 ,240,34,97,.351,32,78,.410,2,19,.105,8,12,.667,78,40,82,.488,34,62,.548,6,20,.300,17,20,.850,103,2014-01-18,PHI,CHI
51,@,L 78-93 ,240,30,74,.405,23,50,.460,7,24,.292,11,14,.786,78,37,88,.420,33,74,.446,4,14,.286,15,23,.652,93,2014-01-24,MIL,CLE
52,@,L 78-123 ,240,27,100,.270,24,72,.333,3,28,.107,21,25,.840,78,50,89,.562,41,61,.672,9,28,.321,14,17,.824,123,2014-02-09,PHI,LAC
53,@,L 78-102 ,240,29,88,.330,25,61,.410,4,27,.148,16,19,.842,78,35,79,.443,22,50,.440,13,29,.448,19,21,.905,102,2014-03-05,ATL,POR
54,Home,L 78-110 ,240,30,79,.380,27,55,.491,3,24,.125,15,21,.714,78,43,79,.544,35,60,.583,8,19,.421,16,22,.727,110,2014-03-28,DET,MIA
55,@,L 78-91 ,240,28,79,.354,26,66,.394,2,13,.154,20,25,.800,78,34,87,.391,27,64,.422,7,23,.304,16,17,.941,91,2014-03-28,IND,WAS
56,Home,L 78-96 ,240,34,86,.395,31,70,.443,3,16,.188,7,12,.583,78,35,79,.443,26,56,.464,9,23,.391,17,21,.810,96,2014-04-05,WAS,CHI
57,@,L 78-85 ,240,29,87,.333,23,67,.343,6,20,.300,14,19,.737,78,33,81,.407,30,66,.455,3,15,.200,16,24,.667,85,2014-11-11,OKC,MIL
58,@,L 78-91 ,240,27,75,.360,21,48,.438,6,27,.222,18,23,.783,78,41,84,.488,37,74,.500,4,10,.400,5,9,.556,91,2014-11-21,CLE,WAS
59,@,L 78-105 ,240,29,75,.387,27,56,.482,2,19,.105,18,24,.750,78,38,86,.442,28,62,.452,10,24,.417,19,23,.826,105,2014-11-28,NYK,OKC
60,@,L 78-99 ,240,32,84,.381,28,67,.418,4,17,.235,10,15,.667,78,36,82,.439,21,48,.438,15,34,.441,12,20,.600,99,2014-12-31,NYK,LAC
61,@,W 78-75 ,240,33,78,.423,31,62,.500,2,16,.125,10,15,.667,78,29,92,.315,25,69,.362,4,23,.174,13,18,.722,75,2015-01-13,MIA,LAL
62,Home,W 78-76 ,240,27,80,.338,23,61,.377,4,19,.211,20,30,.667,78,29,84,.345,24,66,.364,5,18,.278,13,15,.867,76,2015-01-21,CHO,MIA
63,Home,L 78-101 ,240,29,79,.367,26,58,.448,3,21,.143,17,22,.773,78,41,96,.427,29,62,.468,12,34,.353,7,10,.700,101,2015-02-05,SAC,DAL
64,Home,L 78-106 ,240,29,81,.358,20,57,.351,9,24,.375,11,14,.786,78,37,83,.446,32,64,.500,5,19,.263,27,30,.900,106,2015-02-10,CHO,DET
65,@,L 78-106 ,240,29,75,.387,24,62,.387,5,13,.385,15,25,.600,78,38,87,.437,30,63,.476,8,24,.333,22,29,.759,106,2015-03-09,NYK,DEN
66,@,L 78-102 ,240,31,88,.352,26,66,.394,5,22,.227,11,18,.611,78,38,90,.422,29,68,.426,9,22,.409,17,24,.708,102,2015-04-01,DET,CHO
67,Home,L 78-106 ,240,29,75,.387,22,58,.379,7,17,.412,13,22,.591,78,40,75,.533,25,48,.521,15,27,.556,11,18,.611,106,2015-04-05,LAL,LAC
68,Home,L 78-89 ,240,34,88,.386,29,70,.414,5,18,.278,5,7,.714,78,35,91,.385,29,68,.426,6,23,.261,13,17,.765,89,2015-04-09,MIA,CHI
69,@,L 78-117 ,240,31,79,.392,28,57,.491,3,22,.136,13,19,.684,78,46,84,.548,36,60,.600,10,24,.417,15,22,.682,117,2015-04-12,CLE,BOS
70,Home,L 78-95 ,240,29,95,.305,24,70,.343,5,25,.200,15,20,.750,78,30,71,.423,28,60,.467,2,11,.182,33,41,.805,95,2015-10-30,DEN,MIN
71,@,L 78-95 ,240,28,87,.322,24,63,.381,4,24,.167,18,21,.857,78,31,81,.383,26,62,.419,5,19,.263,28,36,.778,95,2015-11-23,NYK,MIA
72,@,L 78-111 ,240,27,84,.321,22,66,.333,5,18,.278,19,22,.864,78,42,97,.433,30,64,.469,12,33,.364,15,19,.789,111,2015-11-27,WAS,BOS
73,Home,L 78-97 ,240,32,85,.376,29,71,.408,3,14,.214,11,15,.733,78,33,76,.434,26,59,.441,7,17,.412,24,28,.857,97,2015-11-27,NYK,MIA
74,Home,L 78-103 ,240,30,80,.375,25,56,.446,5,24,.208,13,16,.813,78,36,74,.486,26,54,.481,10,20,.500,21,22,.955,103,2015-12-12,ATL,SAS
75,@,L 78-118 ,240,30,86,.349,22,58,.379,8,28,.286,10,17,.588,78,46,84,.548,37,65,.569,9,19,.474,17,25,.680,118,2015-12-19,LAL,OKC
76,Home,L 78-91 ,240,28,72,.389,21,44,.477,7,28,.250,15,24,.625,78,35,91,.385,32,76,.421,3,15,.200,18,26,.692,91,2016-01-04,POR,MEM
77,@,W 78-74 ,240,29,81,.358,21,61,.344,8,20,.400,12,17,.706,78,28,73,.384,25,62,.403,3,11,.273,15,20,.750,74,2016-01-06,DEN,MIN
78,Home,L 78-91 ,240,35,84,.417,31,65,.477,4,19,.211,4,8,.500,78,36,77,.468,31,60,.517,5,17,.294,14,20,.700,91,2016-01-20,BRK,CLE
79,@,L 78-91 ,240,27,74,.365,22,51,.431,5,23,.217,19,24,.792,78,31,78,.397,23,49,.469,8,29,.276,21,23,.913,91,2016-01-31,PHO,DAL
80,Home,L 78-96 ,240,33,77,.429,30,60,.500,3,17,.176,9,12,.750,78,38,79,.481,29,61,.475,9,18,.500,11,12,.917,96,2016-02-25,UTA,SAS
81,Home,L 78-88 ,240,29,71,.408,25,50,.500,4,21,.190,16,18,.889,78,32,83,.386,18,43,.419,14,40,.350,10,17,.588,88,2016-04-03,MIN,DAL
82,@,L 78-113 ,240,29,86,.337,22,56,.393,7,30,.233,13,14,.929,78,40,80,.500,28,55,.509,12,25,.480,21,25,.840,113,2017-01-20,TOR,CHO
83,@,L 77-92 ,240,24,81,.296,17,58,.293,7,23,.304,22,26,.846,77,36,77,.468,26,50,.520,10,27,.370,10,13,.769,92,2012-01-04,CLE,TOR
84,@,L 77-102 ,240,25,77,.325,23,58,.397,2,19,.105,25,35,.714,77,37,79,.468,30,59,.508,7,20,.350,21,25,.840,102,2012-01-06,POR,PHO
85,@,L 77-99 ,240,29,89,.326,24,73,.329,5,16,.313,14,21,.667,77,39,77,.506,37,68,.544,2,9,.222,19,26,.731,99,2012-01-07,CHA,IND
86,Home,W 77-64 ,240,33,82,.402,29,67,.433,4,15,.267,7,12,.583,77,30,86,.349,27,76,.355,3,10,.300,1,7,.143,64,2012-01-14,CHI,TOR
87,Home,L 77-84 ,240,28,68,.412,28,59,.475,0,9,.000,21,28,.750,77,34,72,.472,28,52,.538,6,20,.300,10,15,.667,84,2012-01-16,NOH,POR
88,Home,L 77-100 ,240,27,73,.370,23,53,.434,4,20,.200,19,23,.826,77,41,80,.513,34,62,.548,7,18,.389,11,13,.846,100,2012-01-31,TOR,ATL
89,Home,L 77-96 ,240,33,75,.440,28,60,.467,5,15,.333,6,9,.667,77,41,85,.482,39,78,.500,2,7,.286,12,19,.632,96,2012-02-02,ATL,MEM
90,Home,L 77-78 ,240,29,71,.408,25,56,.446,4,15,.267,15,23,.652,77,33,85,.388,31,66,.470,2,19,.105,10,15,.667,78,2012-02-10,PHI,LAC
91,Home,L 77-98 ,240,29,89,.326,28,78,.359,1,11,.091,18,19,.947,77,37,79,.468,31,64,.484,6,15,.400,18,21,.857,98,2012-02-12,DET,WAS
92,@,L 77-97 ,240,30,73,.411,23,46,.500,7,27,.259,10,13,.769,77,38,81,.469,29,59,.492,9,22,.409,12,16,.750,97,2012-02-18,ATL,POR
93,Home,L 77-79 ,240,32,78,.410,28,61,.459,4,17,.235,9,14,.643,77,28,76,.368,25,63,.397,3,13,.231,20,27,.741,79,2012-03-26,WAS,DET
94,Home,L 77-98 ,240,32,80,.400,27,63,.429,5,17,.294,8,9,.889,77,38,81,.469,29,65,.446,9,16,.563,13,20,.650,98,2012-03-28,ATL,CHI
95,@,L 77-92 ,240,27,72,.375,22,50,.440,5,22,.227,18,29,.621,77,36,81,.444,27,61,.443,9,20,.450,11,16,.688,92,2012-04-16,OKC,LAC
96,@,L 77-116 ,240,27,78,.346,20,57,.351,7,21,.333,16,21,.762,77,45,75,.600,37,57,.649,8,18,.444,18,20,.900,116,2012-04-17,CLE,DET
97,@,L 77-84 ,240,27,68,.397,22,53,.415,5,15,.333,18,30,.600,77,32,91,.352,23,63,.365,9,28,.321,11,14,.786,84,2012-04-26,NOH,HOU
98,@,W 77-62 ,240,35,84,.417,31,62,.500,4,22,.182,3,5,.600,77,23,69,.333,19,50,.380,4,19,.211,12,16,.750,62,2012-11-07,PHI,NOH
99,@,L 77-101 ,240,29,86,.337,22,61,.361,7,25,.280,12,20,.600,77,36,90,.400,28,62,.452,8,28,.286,21,28,.750,101,2012-11-09,GSW,LAL
0,Home,L 77-79 ,240,24,76,.316,18,48,.375,6,28,.214,23,43,.535,77,29,79,.367,25,60,.417,4,19,.211,17,27,.630,79,2012-11-27,LAL,IND
1,@,L 77-117 ,240,28,82,.341,22,61,.361,6,21,.286,15,20,.750,77,40,76,.526,28,60,.467,12,16,.750,25,35,.714,117,2012-11-28,PHO,DET
2,@,L 77-92 ,240,29,85,.341,24,64,.375,5,21,.238,14,18,.778,77,38,93,.409,27,68,.397,11,25,.440,5,8,.625,92,2012-12-01,DET,DAL
3,@,W 77-70 ,240,27,82,.329,22,63,.349,5,19,.263,18,23,.783,77,26,80,.325,22,64,.344,4,16,.250,14,22,.636,70,2012-12-11,WAS,NOH
4,Home,L 77-88 ,240,32,83,.386,29,70,.414,3,13,.231,10,15,.667,77,35,72,.486,28,48,.583,7,24,.292,11,16,.688,88,2012-12-15,DET,IND
5,@,L 77-93 ,240,29,75,.387,27,56,.482,2,19,.105,17,22,.773,77,37,74,.500,33,54,.611,4,20,.200,15,19,.789,93,2012-12-19,NOH,LAC
6,Home,L 77-103 ,240,29,80,.363,26,63,.413,3,17,.176,16,24,.667,77,38,71,.535,27,50,.540,11,21,.524,16,29,.552,103,2012-12-23,PHO,LAC
7,@,L 77-106 ,240,29,72,.403,23,56,.411,6,16,.375,13,15,.867,77,41,85,.482,29,55,.527,12,30,.400,12,24,.500,106,2012-12-27,BOS,LAC
8,@,L 77-87 ,240,31,85,.365,28,75,.373,3,10,.300,12,18,.667,77,34,87,.391,27,71,.380,7,16,.438,12,18,.667,87,2012-12-29,WAS,CHI
9,@,L 77-87 ,240,28,68,.412,20,49,.408,8,19,.421,13,18,.722,77,33,91,.363,24,69,.348,9,22,.409,12,19,.632,87,2013-01-08,MIA,IND
10,Home,L 77-90 ,240,30,84,.357,26,65,.400,4,19,.211,13,20,.650,77,35,77,.455,30,64,.469,5,13,.385,15,23,.652,90,2013-01-17,MIN,LAC
11,@,L 77-101 ,240,29,71,.408,26,54,.481,3,17,.176,16,25,.640,77,47,90,.522,43,81,.531,4,9,.444,3,8,.375,101,2013-01-25,BRK,MEM
12,@,L 77-97 ,240,32,79,.405,26,52,.500,6,27,.222,7,9,.778,77,37,74,.500,24,45,.533,13,29,.448,10,12,.833,97,2013-01-28,ORL,BRK
13,@,L 77-86 ,240,29,79,.367,22,59,.373,7,20,.350,12,16,.750,77,35,81,.432,31,66,.470,4,15,.267,12,17,.706,86,2013-02-01,POR,UTA
14,@,L 77-101 ,240,26,82,.317,21,66,.318,5,16,.313,20,28,.714,77,41,95,.432,35,76,.461,6,19,.316,13,19,.684,101,2013-02-13,CHA,IND
15,Home,L 77-87 ,240,32,74,.432,25,54,.463,7,20,.350,6,10,.600,77,31,75,.413,18,40,.450,13,35,.371,12,15,.800,87,2013-03-06,DET,NYK
16,Home,L 77-100 ,240,32,88,.364,30,70,.429,2,18,.111,11,14,.786,77,42,92,.457,34,71,.479,8,21,.381,8,10,.800,100,2013-03-10,MIN,DAL
17,@,L 77-92 ,240,29,86,.337,23,62,.371,6,24,.250,13,18,.722,77,40,82,.488,35,66,.530,5,16,.313,7,11,.636,92,2013-03-18,MIN,MEM
18,@,L 77-109 ,240,30,89,.337,25,64,.391,5,25,.200,12,18,.667,77,38,76,.500,25,46,.543,13,30,.433,20,23,.870,109,2013-03-24,CHA,MIA
19,@,L 77-91 ,240,31,85,.365,26,69,.377,5,16,.313,10,15,.667,77,38,86,.442,30,65,.462,8,21,.381,7,11,.636,91,2013-04-14,CLE,PHI
20,@,L 77-93 ,240,30,73,.411,23,52,.442,7,21,.333,10,15,.667,77,37,79,.468,30,52,.577,7,27,.259,12,15,.800,93,2013-04-16,POR,LAC
21,@,L 77-87 ,240,31,74,.419,28,58,.483,3,16,.188,12,12,1.000,77,34,76,.447,32,63,.508,2,13,.154,17,29,.586,87,2013-11-03,BOS,DET
22,@,L 77-104 ,240,30,88,.341,22,72,.306,8,16,.500,9,11,.818,77,40,79,.506,35,63,.556,5,16,.313,19,21,.905,104,2013-11-15,MIL,IND
23,Home,L 77-109 ,240,29,84,.345,27,69,.391,2,15,.133,17,23,.739,77,46,88,.523,42,71,.592,4,17,.235,13,17,.765,109,2013-12-11,MIL,SAS
24,Home,L 77-99 ,240,31,86,.360,25,68,.368,6,18,.333,9,12,.750,77,40,83,.482,35,68,.515,5,15,.333,14,18,.778,99,2013-12-14,CHI,TOR
25,Home,L 77-82 ,240,31,82,.378,25,62,.403,6,20,.300,9,12,.750,77,33,82,.402,28,62,.452,5,20,.250,11,18,.611,82,2014-01-15,MIL,MEM
26,@,L 77-88 ,240,29,82,.354,27,61,.443,2,21,.095,17,23,.739,77,33,82,.402,29,62,.468,4,20,.200,18,25,.720,88,2014-01-29,NOP,MIN
27,@,L 77-86 ,240,32,81,.395,30,65,.462,2,16,.125,11,15,.733,77,34,76,.447,30,58,.517,4,18,.222,14,23,.609,86,2014-02-03,MEM,OKC
28,Home,L 77-85 ,240,31,75,.413,29,62,.468,2,13,.154,13,14,.929,77,35,78,.449,30,70,.429,5,8,.625,10,18,.556,85,2014-03-07,CHI,MEM
29,Home,L 77-103 ,240,31,83,.373,25,60,.417,6,23,.261,9,19,.474,77,38,70,.543,34,55,.618,4,15,.267,23,32,.719,103,2014-03-15,PHI,MEM
30,@,L 77-89 ,240,27,73,.370,23,63,.365,4,10,.400,19,21,.905,77,35,84,.417,31,69,.449,4,15,.267,15,16,.938,89,2014-03-24,IND,CHI
31,Home,L 77-103 ,240,26,69,.377,20,55,.364,6,14,.429,19,24,.792,77,37,80,.463,29,63,.460,8,17,.471,21,25,.840,103,2014-03-31,IND,SAS
32,@,L 77-96 ,240,32,73,.438,28,55,.509,4,18,.222,9,9,1.000,77,39,77,.506,30,51,.588,9,26,.346,9,14,.643,96,2014-04-02,MIL,MIA
33,Home,L 77-95 ,240,24,78,.308,21,60,.350,3,18,.167,26,35,.743,77,33,75,.440,27,48,.563,6,27,.222,23,32,.719,95,2014-10-29,SAC,GSW
34,Home,L 77-85 ,240,30,84,.357,27,67,.403,3,17,.176,14,17,.824,77,32,82,.390,27,58,.466,5,24,.208,16,25,.640,85,2014-12-03,MIN,PHI
35,Home,L 77-107 ,240,31,76,.408,27,53,.509,4,23,.174,11,14,.786,77,40,79,.506,32,60,.533,8,19,.421,19,23,.826,107,2014-12-26,ATL,MIL
36,Home,L 77-97 ,240,28,84,.333,22,64,.344,6,20,.300,15,20,.750,77,37,78,.474,32,62,.516,5,16,.313,18,24,.750,97,2015-01-07,CHI,UTA
37,Home,L 77-97 ,240,25,83,.301,23,58,.397,2,25,.080,25,29,.862,77,41,76,.539,33,59,.559,8,17,.471,7,11,.636,97,2015-01-07,PHI,MIL
38,@,L 77-114 ,240,26,77,.338,22,59,.373,4,18,.222,21,31,.677,77,44,87,.506,35,67,.522,9,20,.450,17,23,.739,114,2015-02-07,BRK,WAS
39,@,L 77-97 ,240,33,87,.379,29,69,.420,4,18,.222,7,8,.875,77,35,81,.432,31,68,.456,4,13,.308,23,28,.821,97,2015-02-25,WAS,MIN
40,Home,L 77-107 ,240,31,82,.378,26,68,.382,5,14,.357,10,17,.588,77,43,88,.489,33,62,.532,10,26,.385,11,11,1.000,107,2015-04-03,LAL,POR
41,@,L 77-116 ,240,27,79,.342,23,64,.359,4,15,.267,19,29,.655,77,41,81,.506,25,53,.472,16,28,.571,18,23,.783,116,2015-04-12,CHO,DET
42,@,L 77-111 ,240,31,83,.373,28,62,.452,3,21,.143,12,16,.750,77,45,92,.489,33,57,.579,12,35,.343,9,15,.600,111,2015-11-24,LAL,GSW
43,Home,L 77-89 ,240,28,87,.322,19,55,.345,9,32,.281,12,14,.857,77,36,78,.462,28,55,.509,8,23,.348,9,10,.900,89,2015-12-15,BOS,CLE
44,@,L 77-97 ,240,32,89,.360,26,62,.419,6,27,.222,7,9,.778,77,38,84,.452,30,62,.484,8,22,.364,13,17,.765,97,2016-01-03,PHO,LAL
45,Home,L 77-83 ,240,29,73,.397,22,51,.431,7,22,.318,12,20,.600,77,33,83,.398,20,55,.364,13,28,.464,4,6,.667,83,2016-01-08,BRK,ORL
46,Home,L 77-83 ,240,31,86,.360,29,67,.433,2,19,.105,13,15,.867,77,30,77,.390,22,55,.400,8,22,.364,15,17,.882,83,2016-01-15,CHI,DAL
47,Home,L 77-91 ,240,26,74,.351,20,49,.408,6,25,.240,19,29,.655,77,34,87,.391,26,52,.500,8,35,.229,15,23,.652,91,2016-01-15,HOU,CLE
48,Home,L 77-106 ,240,29,85,.341,24,58,.414,5,27,.185,14,20,.700,77,37,68,.544,24,40,.600,13,28,.464,19,26,.731,106,2016-03-04,LAL,ATL
49,@,L 77-93 ,240,32,84,.381,27,57,.474,5,27,.185,8,11,.727,77,34,78,.436,25,53,.472,9,25,.360,16,18,.889,93,2016-11-14,DAL,NYK
50,Home,L 77-85 ,240,30,78,.385,25,53,.472,5,25,.200,12,14,.857,77,33,90,.367,28,73,.384,5,17,.294,14,16,.875,85,2016-11-17,UTA,CHI
51,@,L 77-87 ,240,34,89,.382,30,62,.484,4,27,.148,5,8,.625,77,30,88,.341,24,67,.358,6,21,.286,21,29,.724,87,2016-12-07,DET,CHO
52,@,L 77-110 ,240,30,76,.395,24,59,.407,6,17,.353,11,16,.688,77,43,80,.538,27,49,.551,16,31,.516,8,13,.615,110,2017-01-13,DET,UTA
53,Home,W 76-74 ,240,26,77,.338,22,60,.367,4,17,.235,20,26,.769,76,28,80,.350,24,65,.369,4,15,.267,14,25,.560,74,2012-01-03,CHI,ATL
54,@,L 76-102 ,240,29,78,.372,24,54,.444,5,24,.208,13,16,.813,76,39,75,.520,29,53,.547,10,22,.455,14,18,.778,102,2012-01-13,MIL,DAL
55,@,L 76-90 ,240,32,74,.432,27,59,.458,5,15,.333,7,8,.875,76,35,84,.417,31,67,.463,4,17,.235,16,19,.842,90,2012-01-20,ATL,PHI
56,@,L 76-103 ,240,32,88,.364,31,80,.388,1,8,.125,11,16,.688,76,38,90,.422,33,75,.440,5,15,.333,22,30,.733,103,2012-01-27,WAS,HOU
57,@,L 76-89 ,240,31,85,.365,23,70,.329,8,15,.533,6,8,.750,76,31,78,.397,25,66,.379,6,12,.500,21,29,.724,89,2012-02-21,PHI,MEM
58,Home,L 76-79 ,240,29,75,.387,24,60,.400,5,15,.333,13,19,.684,76,29,74,.392,23,58,.397,6,16,.375,15,17,.882,79,2012-03-19,ATL,BOS
59,@,L 76-88 ,240,30,87,.345,27,73,.370,3,14,.214,13,19,.684,76,34,70,.486,31,60,.517,3,10,.300,17,18,.944,88,2012-03-25,WAS,BOS
60,@,L 76-93 ,240,35,85,.412,34,76,.447,1,9,.111,5,11,.455,76,37,81,.457,30,53,.566,7,28,.250,12,18,.667,93,2012-03-25,PHI,SAS
61,@,L 76-97 ,240,30,82,.366,27,68,.397,3,14,.214,13,17,.765,76,42,87,.483,35,70,.500,7,17,.412,6,6,1.000,97,2012-03-30,PHI,WAS
62,Home,W 76-73 ,240,26,71,.366,24,56,.429,2,15,.133,22,35,.629,76,29,77,.377,25,64,.391,4,13,.308,11,16,.688,73,2012-04-22,DET,TOR
63,@,L 76-88 ,240,30,73,.411,23,47,.489,7,26,.269,9,15,.600,76,34,72,.472,32,60,.533,2,12,.167,18,22,.818,88,2012-04-26,ORL,MEM
64,@,L 76-89 ,240,30,72,.417,21,47,.447,9,25,.360,7,16,.438,76,38,82,.463,33,67,.493,5,15,.333,8,8,1.000,89,2012-11-11,ATL,LAC
65,@,L 76-92 ,240,25,84,.298,20,53,.377,5,31,.161,21,32,.656,76,31,78,.397,28,65,.431,3,13,.231,27,32,.844,92,2012-11-13,WAS,CHA
66,Home,L 76-94 ,240,25,84,.298,20,68,.294,5,16,.313,21,32,.656,76,35,73,.479,32,66,.485,3,7,.429,21,31,.677,94,2012-11-14,PHI,DET
67,Home,L 76-83 ,240,31,85,.365,26,69,.377,5,16,.313,9,12,.750,76,31,82,.378,29,73,.397,2,9,.222,19,27,.704,83,2012-11-17,WAS,UTA
68,@,L 76-88 ,240,28,71,.394,20,51,.392,8,20,.400,12,18,.667,76,33,90,.367,26,65,.400,7,25,.280,15,19,.789,88,2012-11-18,IND,NYK
69,@,L 76-86 ,240,29,72,.403,25,55,.455,4,17,.235,14,22,.636,76,34,73,.466,29,60,.483,5,13,.385,13,19,.684,86,2012-11-23,LAC,BRK
70,Home,L 76-80 ,240,28,73,.384,24,61,.393,4,12,.333,16,20,.800,76,29,80,.363,27,70,.386,2,10,.200,20,27,.741,80,2012-12-04,CHI,IND
71,Home,L 76-88 ,240,29,71,.408,22,51,.431,7,20,.350,11,19,.579,76,35,78,.449,30,56,.536,5,22,.227,13,17,.765,88,2012-12-17,DET,LAC
72,Home,L 76-93 ,240,26,64,.406,19,44,.432,7,20,.350,17,29,.586,76,38,77,.494,32,67,.478,6,10,.600,11,13,.846,93,2012-12-25,BRK,BOS
73,@,L 76-81 ,240,31,89,.348,27,69,.391,4,20,.200,10,13,.769,76,31,79,.392,26,58,.448,5,21,.238,14,16,.875,81,2013-01-10,NYK,IND
74,Home,L 76-103 ,240,25,72,.347,22,63,.349,3,9,.333,23,30,.767,76,36,87,.414,28,65,.431,8,22,.364,23,28,.821,103,2013-01-15,CHA,IND
75,@,L 76-85 ,240,34,83,.410,29,63,.460,5,20,.250,3,3,1.000,76,35,78,.449,34,71,.479,1,7,.143,14,17,.824,85,2013-02-01,WAS,MEM
76,Home,L 76-93 ,240,31,79,.392,25,60,.417,6,19,.316,8,15,.533,76,38,93,.409,30,73,.411,8,20,.400,9,13,.692,93,2013-02-02,ATL,CHI
77,Home,L 76-86 ,240,30,87,.345,24,67,.358,6,20,.300,10,14,.714,76,33,82,.402,27,64,.422,6,18,.333,14,22,.636,86,2013-02-06,ORL,LAC
78,@,L 76-87 ,240,27,88,.307,25,72,.347,2,16,.125,20,23,.870,76,39,93,.419,37,77,.481,2,16,.125,7,10,.700,87,2013-02-09,CHA,PHI
79,Home,L 76-108 ,240,34,82,.415,31,68,.456,3,14,.214,5,9,.556,76,41,92,.446,31,58,.534,10,34,.294,16,23,.696,108,2013-02-13,ORL,ATL
80,@,W 76-72 ,240,32,71,.451,30,64,.469,2,7,.286,10,12,.833,76,29,77,.377,20,56,.357,9,21,.429,5,13,.385,72,2013-02-24,MEM,BRK
81,@,L 76-99 ,240,29,87,.333,24,65,.369,5,22,.227,13,16,.813,76,42,87,.483,34,67,.507,8,20,.400,7,15,.467,99,2013-03-18,LAL,PHO
82,Home,L 76-94 ,240,33,80,.413,29,51,.569,4,29,.138,6,10,.600,76,34,67,.507,30,55,.545,4,12,.333,22,28,.786,94,2013-04-03,POR,MEM
83,Home,W 76-74 ,240,31,79,.392,26,60,.433,5,19,.263,9,18,.500,76,29,71,.408,21,51,.412,8,20,.400,8,10,.800,74,2013-11-08,SAS,GSW
84,@,L 76-92 ,240,28,84,.333,23,67,.343,5,17,.294,15,20,.750,76,35,79,.443,32,64,.500,3,15,.200,19,31,.613,92,2013-11-29,MIL,CHA
85,@,L 76-91 ,240,29,80,.363,28,68,.412,1,12,.083,17,23,.739,76,34,77,.442,29,52,.558,5,25,.200,18,22,.818,91,2013-12-31,CLE,IND
86,Home,L 76-79 ,240,30,70,.429,22,50,.440,8,20,.400,8,15,.533,76,37,90,.411,33,78,.423,4,12,.333,1,1,1.000,79,2014-02-08,ATL,MEM
87,@,L 76-92 ,240,26,67,.388,21,50,.420,5,17,.294,19,28,.679,76,35,70,.500,31,56,.554,4,14,.286,18,21,.857,92,2014-02-13,BRK,CHI
88,@,L 76-108 ,240,28,85,.329,25,63,.397,3,22,.136,17,19,.895,76,38,81,.469,29,56,.518,9,25,.360,23,32,.719,108,2014-03-01,NOP,LAC
89,@,L 76-90 ,240,29,78,.372,21,56,.375,8,22,.364,10,16,.625,76,34,76,.447,29,62,.468,5,14,.357,17,21,.810,90,2014-03-30,IND,CLE
90,Home,W 76-73 ,240,30,82,.366,28,66,.424,2,16,.125,14,19,.737,76,27,88,.307,20,65,.308,7,23,.304,12,17,.706,73,2014-12-20,DEN,IND
91,@,L 76-111 ,240,28,85,.329,22,61,.361,6,24,.250,14,23,.609,76,45,81,.556,38,68,.559,7,13,.538,14,18,.778,111,2015-01-19,PHI,WAS
92,@,L 76-78 ,240,29,84,.345,24,66,.364,5,18,.278,13,15,.867,76,27,80,.338,23,61,.377,4,19,.211,20,30,.667,78,2015-01-21,MIA,CHO
93,Home,W 76-71 ,240,25,76,.329,23,69,.333,2,7,.286,24,37,.649,76,28,79,.354,22,64,.344,6,15,.400,9,18,.500,71,2015-01-24,CHO,NYK
94,@,L 76-92 ,240,26,72,.361,22,50,.440,4,22,.182,20,22,.909,76,37,83,.446,27,58,.466,10,25,.400,8,17,.471,92,2015-02-20,POR,UTA
95,@,L 76-98 ,240,25,77,.325,21,59,.356,4,18,.222,22,28,.786,76,35,84,.417,29,55,.527,6,29,.207,22,31,.710,98,2015-02-21,TOR,HOU
96,@,L 76-89 ,240,31,83,.373,29,75,.387,2,8,.250,12,21,.571,76,35,79,.443,24,48,.500,11,31,.355,8,15,.533,89,2015-03-09,MIN,LAC
97,@,L 76-107 ,240,27,81,.333,24,70,.343,3,11,.273,19,26,.731,76,39,95,.411,26,62,.419,13,33,.394,16,21,.762,107,2015-03-23,WAS,GSW
98,@,L 76-94 ,240,31,82,.378,27,64,.422,4,18,.222,10,15,.667,76,37,84,.440,28,58,.483,9,26,.346,11,14,.786,94,2015-03-27,DAL,SAS
99,Home,L 76-106 ,240,29,82,.354,27,66,.409,2,16,.125,16,22,.727,76,41,84,.488,28,55,.509,13,29,.448,11,17,.647,106,2015-10-28,MEM,CLE
0,Home,L 76-97 ,240,28,70,.400,24,53,.453,4,17,.235,16,21,.762,76,39,88,.443,33,73,.452,6,15,.400,13,18,.722,97,2015-10-31,IND,UTA
1,@,L 76-96 ,240,28,71,.394,25,52,.481,3,19,.158,17,22,.773,76,35,83,.422,27,63,.429,8,20,.400,18,25,.720,96,2015-11-08,TOR,MIA
2,Home,L 76-111 ,240,28,72,.389,22,50,.440,6,22,.273,14,20,.700,76,41,72,.569,30,51,.588,11,21,.524,18,27,.667,111,2015-12-11,ORL,CLE
3,@,L 76-96 ,240,28,84,.333,18,56,.321,10,28,.357,10,14,.714,76,32,78,.410,25,56,.446,7,22,.318,25,34,.735,96,2015-12-13,PHI,TOR
4,@,L 76-105 ,240,28,77,.364,17,46,.370,11,31,.355,9,15,.600,76,41,89,.461,32,67,.478,9,22,.409,14,19,.737,105,2015-12-26,CLE,POR
5,@,L 76-87 ,240,27,81,.333,20,49,.408,7,32,.219,15,23,.652,76,38,77,.494,30,60,.500,8,17,.471,3,5,.600,87,2016-02-28,CHO,ATL
6,Home,L 75-114 ,240,27,89,.303,20,75,.267,7,14,.500,14,19,.737,75,46,83,.554,40,74,.541,6,9,.667,16,17,.941,114,2012-01-20,CLE,CHI
7,@,L 75-92 ,240,28,78,.359,27,69,.391,1,9,.111,18,25,.720,75,39,83,.470,36,73,.493,3,10,.300,11,16,.688,92,2012-01-25,CHA,WAS
8,Home,L 75-82 ,240,29,86,.337,28,72,.389,1,14,.071,16,19,.842,75,31,81,.383,26,67,.388,5,14,.357,15,18,.833,82,2012-02-17,PHI,DAL
9,@,L 75-83 ,240,29,80,.363,25,61,.410,4,19,.211,13,19,.684,75,29,78,.372,25,68,.368,4,10,.400,21,24,.875,83,2012-03-04,GSW,TOR
10,@,L 75-92 ,240,20,64,.313,15,42,.357,5,22,.227,30,38,.789,75,40,82,.488,36,71,.507,4,11,.364,8,15,.533,92,2012-03-13,POR,IND
11,Home,L 75-87 ,240,30,87,.345,25,70,.357,5,17,.294,10,12,.833,75,35,83,.422,28,68,.412,7,15,.467,10,16,.625,87,2012-03-28,CLE,DET
12,@,L 75-91 ,240,28,72,.389,26,59,.441,2,13,.154,17,27,.630,75,30,76,.395,21,48,.438,9,28,.321,22,32,.688,91,2012-03-31,CLE,NYK
13,@,L 75-92 ,240,32,77,.416,28,68,.412,4,9,.444,7,9,.778,75,35,71,.493,32,56,.571,3,15,.200,19,21,.905,92,2012-04-01,NOH,PHO
14,Home,L 75-94 ,240,30,77,.390,25,54,.463,5,23,.217,10,17,.588,75,39,83,.470,28,51,.549,11,32,.344,5,12,.417,94,2012-04-02,DAL,LAC
15,@,L 75-98 ,240,28,75,.373,25,56,.446,3,19,.158,16,23,.696,75,36,83,.434,29,60,.483,7,23,.304,19,29,.655,98,2012-04-08,DET,MIA
16,@,L 75-91 ,240,29,78,.372,23,62,.371,6,16,.375,11,16,.688,75,30,72,.417,20,49,.408,10,23,.435,21,26,.808,91,2012-04-08,TOR,OKC
17,Home,L 75-93 ,240,29,80,.363,22,62,.355,7,18,.389,10,12,.833,75,41,77,.532,40,67,.597,1,10,.100,10,16,.625,93,2012-04-11,TOR,PHI
18,@,L 75-88 ,240,25,70,.357,20,52,.385,5,18,.278,20,25,.800,75,32,73,.438,29,60,.483,3,13,.231,21,21,1.000,88,2012-04-15,MEM,NOH
19,@,W 75-67 ,240,26,77,.338,25,66,.379,1,11,.091,22,25,.880,75,23,76,.303,22,60,.367,1,16,.063,20,30,.667,67,2012-04-16,NOH,CHA
20,@,L 75-107 ,240,28,87,.322,26,74,.351,2,13,.154,17,26,.654,75,45,85,.529,40,69,.580,5,16,.313,12,17,.706,107,2012-04-26,CLE,CHI
21,@,L 75-84 ,240,33,88,.375,29,70,.414,4,18,.222,5,11,.455,75,30,85,.353,23,60,.383,7,25,.280,17,21,.810,84,2012-10-31,DEN,PHI
22,@,L 75-90 ,240,28,80,.350,25,68,.368,3,12,.250,16,20,.800,75,34,76,.447,27,56,.482,7,20,.350,15,22,.682,90,2012-11-07,ORL,MIN
23,@,L 75-92 ,240,32,76,.421,27,62,.435,5,14,.357,6,8,.750,75,38,77,.494,31,58,.534,7,19,.368,9,10,.900,92,2012-12-22,CHI,ATL
24,Home,L 75-81 ,240,33,82,.402,29,71,.408,4,11,.364,5,7,.714,75,33,77,.429,29,60,.483,4,17,.235,11,18,.611,81,2012-12-22,NOH,IND
25,@,L 75-94 ,240,27,85,.318,23,68,.338,4,17,.235,17,28,.607,75,40,89,.449,36,80,.450,4,9,.444,10,18,.556,94,2013-01-04,IND,BOS
26,Home,L 75-92 ,240,29,80,.363,26,68,.382,3,12,.250,14,18,.778,75,36,90,.400,28,61,.459,8,29,.276,12,18,.667,92,2013-01-16,GSW,MIA
27,Home,L 75-105 ,240,25,75,.333,21,59,.356,4,16,.250,21,35,.600,75,42,83,.506,37,69,.536,5,14,.357,16,20,.800,105,2013-02-22,CHA,CHI
28,@,L 75-114 ,240,28,86,.326,22,67,.328,6,19,.316,13,18,.722,75,45,89,.506,36,69,.522,9,20,.450,15,20,.750,114,2013-03-03,DET,SAS
29,Home,L 75-97 ,240,27,72,.375,25,51,.490,2,21,.095,19,24,.792,75,37,78,.474,33,66,.500,4,12,.333,19,23,.826,97,2013-04-05,IND,OKC
30,@,L 75-94 ,240,30,80,.375,28,66,.424,2,14,.143,13,18,.722,75,39,82,.476,36,69,.522,3,13,.231,13,20,.650,94,2013-04-09,CHA,MEM
31,Home,L 75-92 ,240,30,90,.333,27,72,.375,3,18,.167,12,15,.800,75,34,80,.425,22,61,.361,12,19,.632,12,15,.800,92,2013-12-07,CHI,DET
32,@,W 75-74 ,240,30,73,.411,23,52,.442,7,21,.333,8,14,.571,75,32,89,.360,27,65,.415,5,24,.208,5,9,.556,74,2013-12-09,DEN,WAS
33,Home,L 75-91 ,240,29,93,.312,25,73,.342,4,20,.200,13,16,.813,75,37,78,.474,32,65,.492,5,13,.385,12,19,.632,91,2014-02-04,GSW,CHA
34,Home,L 75-81 ,240,29,68,.426,20,48,.417,9,20,.450,8,18,.444,75,30,80,.375,22,54,.407,8,26,.308,13,15,.867,81,2014-11-12,MIA,IND
35,@,L 75-100 ,240,27,83,.325,23,57,.404,4,26,.154,17,24,.708,75,36,81,.444,26,55,.473,10,26,.385,18,21,.857,100,2014-11-17,PHI,SAS
36,@,L 75-105 ,240,29,88,.330,24,65,.369,5,23,.217,12,16,.750,75,40,75,.533,28,52,.538,12,23,.522,13,16,.813,105,2014-11-29,CHO,ATL
37,Home,L 75-98 ,240,30,80,.375,27,62,.435,3,18,.167,12,19,.632,75,35,81,.432,22,47,.468,13,34,.382,15,24,.625,98,2014-12-05,BRK,ATL
38,Home,L 75-93 ,240,28,80,.350,24,58,.414,4,22,.182,15,18,.833,75,33,71,.465,24,53,.453,9,18,.500,18,21,.857,93,2014-12-14,MIA,CHI
39,@,L 75-98 ,240,25,87,.287,20,63,.317,5,24,.208,20,26,.769,75,36,88,.409,28,61,.459,8,27,.296,18,21,.857,98,2014-12-26,CHO,OKC
40,Home,L 75-78 ,240,29,92,.315,25,69,.362,4,23,.174,13,18,.722,75,33,78,.423,31,62,.500,2,16,.125,10,15,.667,78,2015-01-13,LAL,MIA
41,Home,L 75-98 ,240,31,89,.348,29,74,.392,2,15,.133,11,15,.733,75,39,76,.513,28,49,.571,11,27,.407,9,14,.643,98,2015-01-21,MIN,DAL
42,Home,L 75-83 ,240,30,81,.370,26,62,.419,4,19,.211,11,18,.611,75,32,77,.416,28,56,.500,4,21,.190,15,21,.714,83,2015-02-01,BOS,MIA
43,Home,L 75-82 ,240,25,78,.321,18,51,.353,7,27,.259,18,22,.818,75,33,80,.413,26,64,.406,7,16,.438,9,17,.529,82,2015-02-02,TOR,MIL
44,@,L 75-82 ,240,29,74,.392,24,59,.407,5,15,.333,12,14,.857,75,29,76,.382,23,54,.426,6,22,.273,18,23,.783,82,2015-02-28,MIL,UTA
45,@,L 75-94 ,240,33,88,.375,31,72,.431,2,16,.125,7,8,.875,75,34,82,.415,27,60,.450,7,22,.318,19,21,.905,94,2015-03-05,DAL,POR
46,@,L 75-93 ,240,32,81,.395,29,63,.460,3,18,.167,8,15,.533,75,40,90,.444,34,72,.472,6,18,.333,7,13,.538,93,2015-03-22,MIA,OKC
47,@,L 75-90 ,240,30,85,.353,23,60,.383,7,25,.280,8,10,.800,75,37,84,.440,32,65,.492,5,19,.263,11,19,.579,90,2015-04-10,PHO,NOP
48,@,L 75-102 ,240,31,77,.403,26,61,.426,5,16,.313,8,15,.533,75,40,86,.465,31,64,.484,9,22,.409,13,13,1.000,102,2015-10-30,BRK,SAS
49,Home,L 75-97 ,240,31,91,.341,27,61,.443,4,30,.133,9,13,.692,75,39,86,.453,30,63,.476,9,23,.391,10,12,.833,97,2016-01-03,WAS,MIA
50,@,L 75-104 ,240,33,87,.379,28,63,.444,5,24,.208,4,7,.571,75,40,85,.471,25,55,.455,15,30,.500,9,10,.900,104,2016-03-13,IND,ATL
51,@,L 75-91 ,240,31,80,.388,27,62,.435,4,18,.222,9,14,.643,75,35,81,.432,25,55,.455,10,26,.385,11,13,.846,91,2016-03-21,PHI,IND
52,@,L 75-123 ,240,26,85,.306,19,65,.292,7,20,.350,16,22,.727,75,46,89,.517,29,57,.509,17,32,.531,14,19,.737,123,2016-03-28,LAL,UTA
53,@,L 75-88 ,240,29,73,.397,22,54,.407,7,19,.368,10,13,.769,75,34,83,.410,28,56,.500,6,27,.222,14,20,.700,88,2016-10-30,UTA,LAC
54,@,L 75-86 (OT),265,30,82,.366,24,53,.453,6,29,.207,9,12,.750,75,33,88,.375,24,50,.480,9,38,.237,11,12,.917,86,2016-11-06,MIL,DAL
55,@,L 74-76 ,240,28,80,.350,24,65,.369,4,15,.267,14,25,.560,74,26,77,.338,22,60,.367,4,17,.235,20,26,.769,76,2012-01-03,ATL,CHI
56,Home,L 74-87 ,240,26,66,.394,21,52,.404,5,14,.357,17,24,.708,74,32,80,.400,24,66,.364,8,14,.571,15,18,.833,87,2012-01-06,BOS,IND
57,Home,L 74-84 ,240,27,87,.310,24,64,.375,3,23,.130,17,19,.895,74,32,77,.416,28,60,.467,4,17,.235,16,24,.667,84,2012-01-21,NJN,OKC
58,@,L 74-95 ,240,29,83,.349,26,72,.361,3,11,.273,13,17,.765,74,38,78,.487,29,63,.460,9,15,.600,10,15,.667,95,2012-01-28,DET,PHI
59,Home,W 74-69 ,240,30,80,.375,26,65,.400,4,15,.267,10,19,.526,74,26,78,.333,19,56,.339,7,22,.318,10,22,.455,69,2012-01-30,PHI,ORL
60,@,L 74-86 ,240,29,65,.446,26,55,.473,3,10,.300,13,18,.722,74,33,75,.440,28,56,.500,5,19,.263,15,20,.750,86,2012-02-10,BOS,TOR
61,@,W 74-71 ,240,30,78,.385,28,61,.459,2,17,.118,12,19,.632,74,27,71,.380,21,57,.368,6,14,.429,11,18,.611,71,2012-02-16,LAC,POR
62,@,L 74-86 ,240,29,70,.414,26,61,.426,3,9,.333,13,22,.591,74,31,72,.431,25,50,.500,6,22,.273,18,24,.750,86,2012-03-05,NOH,POR
63,Home,L 74-83 ,240,30,86,.349,28,75,.373,2,11,.182,12,21,.571,74,30,83,.361,26,61,.426,4,22,.182,19,26,.731,83,2012-03-09,CHA,NJN
64,@,L 74-101 ,240,28,75,.373,22,52,.423,6,23,.261,12,17,.706,74,44,78,.564,39,63,.619,5,15,.333,8,11,.727,101,2012-04-22,ORL,DEN
65,@,L 74-87 ,240,29,78,.372,27,69,.391,2,9,.222,14,23,.609,74,35,87,.402,27,63,.429,8,24,.333,9,11,.818,87,2012-04-26,MIL,BOS
66,@,L 74-82 ,240,30,84,.357,29,71,.408,1,13,.077,13,18,.722,74,29,78,.372,22,54,.407,7,24,.292,17,25,.680,82,2012-11-11,ORL,BRK
67,@,W 74-72 ,240,26,72,.361,20,60,.333,6,12,.500,16,19,.842,74,24,75,.320,19,60,.317,5,15,.333,19,25,.760,72,2012-11-13,TOR,IND
68,@,L 74-90 ,240,28,85,.329,25,68,.368,3,17,.176,15,22,.682,74,36,83,.434,31,63,.492,5,20,.250,13,18,.722,90,2012-11-21,DET,ORL
69,@,L 74-92 ,240,26,74,.351,23,53,.434,3,21,.143,19,21,.905,74,36,89,.404,36,69,.522,0,20,.000,20,22,.909,92,2012-12-10,TOR,POR
70,@,L 74-95 ,240,27,69,.391,27,56,.482,0,13,.000,20,23,.870,74,34,84,.405,22,48,.458,12,36,.333,15,22,.682,95,2012-12-14,DAL,TOR
71,@,L 74-89 ,240,25,76,.329,20,58,.345,5,18,.278,19,32,.594,74,36,80,.450,29,64,.453,7,16,.438,10,11,.909,89,2013-02-08,BRK,WAS
72,@,L 74-119 ,240,27,77,.351,21,56,.375,6,21,.286,14,18,.778,74,42,76,.553,34,58,.586,8,18,.444,27,28,.964,119,2013-02-27,NOH,OKC
73,@,L 74-100 ,240,27,66,.409,23,53,.434,4,13,.308,16,25,.640,74,35,77,.455,29,60,.483,6,17,.353,24,30,.800,100,2013-03-12,BOS,CHA
74,@,L 74-89 ,240,29,83,.349,26,68,.382,3,15,.200,13,15,.867,74,32,77,.416,22,49,.449,10,28,.357,15,20,.750,89,2013-11-02,CLE,IND
75,@,L 74-76 ,240,29,71,.408,21,51,.412,8,20,.400,8,10,.800,74,31,79,.392,26,60,.433,5,19,.263,9,18,.500,76,2013-11-08,GSW,SAS
76,Home,L 74-99 ,240,26,83,.313,23,74,.311,3,9,.333,19,28,.679,74,32,84,.381,22,59,.373,10,25,.400,25,32,.781,99,2013-11-27,CHA,IND
77,Home,L 74-75 ,240,32,89,.360,27,65,.415,5,24,.208,5,9,.556,74,30,73,.411,23,52,.442,7,21,.333,8,14,.571,75,2013-12-09,WAS,DEN
78,Home,L 74-78 ,240,31,83,.373,28,68,.412,3,15,.200,9,14,.643,74,30,75,.400,28,64,.438,2,11,.182,16,20,.800,78,2013-12-10,CHI,MIL
79,Home,L 74-91 ,240,33,84,.393,30,67,.448,3,17,.176,5,7,.714,74,35,80,.438,25,58,.431,10,22,.455,11,16,.688,91,2014-03-28,CHI,POR
80,@,L 74-106 ,240,29,80,.363,24,63,.381,5,17,.294,11,15,.733,74,42,81,.519,36,65,.554,6,16,.375,16,22,.727,106,2014-11-24,ORL,CLE
81,@,L 74-99 ,240,28,81,.346,26,66,.394,2,15,.133,16,21,.762,74,39,86,.453,32,70,.457,7,16,.438,14,19,.737,99,2015-01-26,PHI,NOP
82,@,L 74-85 ,240,27,78,.346,21,58,.362,6,20,.300,14,18,.778,74,34,91,.374,31,80,.388,3,11,.273,14,17,.824,85,2015-01-31,OKC,MEM
83,Home,L 74-101 ,240,25,84,.298,20,68,.294,5,16,.313,19,24,.792,74,41,92,.446,37,73,.507,4,19,.211,15,17,.882,101,2015-02-28,PHO,SAS
84,@,L 74-94 ,240,29,84,.345,24,60,.400,5,24,.208,11,17,.647,74,36,88,.409,33,70,.471,3,18,.167,19,25,.760,94,2015-03-01,PHI,IND
85,Home,W 74-72 ,240,29,83,.349,27,61,.443,2,22,.091,14,21,.667,74,31,83,.373,26,65,.400,5,18,.278,5,10,.500,72,2015-03-19,PHO,NOP
86,@,L 74-93 ,240,28,80,.350,24,62,.387,4,18,.222,14,20,.700,74,36,83,.434,28,67,.418,8,16,.500,13,18,.722,93,2015-04-03,CHO,IND
87,Home,L 74-92 ,240,28,81,.346,18,59,.305,10,22,.455,8,11,.727,74,33,77,.429,21,50,.420,12,27,.444,14,19,.737,92,2015-04-08,CHO,TOR
88,@,L 74-110 ,240,28,80,.350,22,59,.373,6,21,.286,12,18,.667,74,45,88,.511,37,71,.521,8,17,.471,12,14,.857,110,2015-04-08,NOP,MEM
89,@,L 74-92 ,240,28,75,.373,22,56,.393,6,19,.316,12,16,.750,74,35,77,.455,29,59,.492,6,18,.333,16,22,.727,92,2015-11-30,DEN,MIL
90,Home,L 74-85 ,240,28,84,.333,21,60,.350,7,24,.292,11,20,.550,74,38,88,.432,37,72,.514,1,16,.063,8,10,.800,85,2015-12-08,DEN,ORL
91,Home,L 74-91 ,240,31,78,.397,26,62,.419,5,16,.313,7,12,.583,74,35,80,.438,31,58,.534,4,22,.182,17,18,.944,91,2016-01-06,BRK,TOR
92,Home,L 74-78 ,240,28,73,.384,25,62,.403,3,11,.273,15,20,.750,74,29,81,.358,21,61,.344,8,20,.400,12,17,.706,78,2016-01-06,MIN,DEN
93,Home,L 74-86 ,240,29,89,.326,26,68,.382,3,21,.143,13,15,.867,74,31,69,.449,26,53,.491,5,16,.313,19,25,.760,86,2016-01-10,LAL,UTA
94,@,L 74-99 ,240,30,72,.417,26,58,.448,4,14,.286,10,11,.909,74,40,88,.455,33,66,.500,7,22,.318,12,12,1.000,99,2016-01-17,MIA,OKC
95,Home,L 74-87 ,240,26,78,.333,18,58,.310,8,20,.400,14,19,.737,74,33,81,.407,26,53,.491,7,28,.250,14,16,.875,87,2016-11-11,ORL,UTA
96,@,L 74-104 ,240,27,76,.355,18,46,.391,9,30,.300,11,20,.550,74,40,90,.444,31,67,.463,9,23,.391,15,17,.882,104,2016-12-20,UTA,GSW
97,@,L 74-89 ,240,30,82,.366,26,63,.413,4,19,.211,10,18,.556,74,32,81,.395,28,62,.452,4,19,.211,21,25,.840,89,2017-02-06,SAS,MEM
98,@,L 73-85 ,240,29,95,.305,27,74,.365,2,21,.095,13,16,.813,73,32,66,.485,29,53,.547,3,13,.231,18,28,.643,85,2012-01-03,MIL,UTA
99,@,L 73-96 ,240,31,86,.360,31,76,.408,0,10,.000,11,14,.786,73,39,85,.459,34,67,.507,5,18,.278,13,16,.813,96,2012-01-06,DET,PHI
0,Home,W 73-70 ,240,29,76,.382,28,66,.424,1,10,.100,14,19,.737,73,28,80,.350,24,54,.444,4,26,.154,10,16,.625,70,2012-01-16,LAL,DAL
1,@,L 73-96 ,240,26,69,.377,22,54,.407,4,15,.267,17,20,.850,73,34,71,.479,28,55,.509,6,16,.375,22,32,.688,96,2012-01-18,TOR,BOS
2,Home,L 73-94 ,240,27,74,.365,20,52,.385,7,22,.318,12,18,.667,73,35,68,.515,32,54,.593,3,14,.214,21,29,.724,94,2012-01-29,NJN,TOR
3,Home,L 73-83 ,240,27,73,.370,24,64,.375,3,9,.333,16,20,.800,73,32,80,.400,22,56,.393,10,24,.417,9,15,.600,83,2012-01-30,MEM,SAS
4,@,L 73-106 ,240,31,89,.348,29,80,.363,2,9,.222,9,13,.692,73,42,76,.553,30,50,.600,12,26,.462,10,11,.909,106,2012-01-31,CHA,LAL
5,@,L 73-108 ,240,28,75,.373,24,58,.414,4,17,.235,13,22,.591,73,39,78,.500,33,62,.532,6,16,.375,24,32,.750,108,2012-02-19,CHA,IND
6,@,L 73-89 ,240,29,74,.392,22,50,.440,7,24,.292,8,11,.727,73,36,89,.404,29,64,.453,7,25,.280,10,14,.714,89,2012-02-20,BOS,DAL
7,@,W 73-71 ,240,34,79,.430,34,67,.507,0,12,.000,5,7,.714,73,30,78,.385,25,66,.379,5,12,.417,6,7,.857,71,2012-03-12,CHA,NOH
8,Home,L 73-88 ,240,29,75,.387,23,60,.383,6,15,.400,9,17,.529,73,34,77,.442,32,61,.525,2,16,.125,18,20,.900,88,2012-03-23,DET,MIA
9,@,L 73-76 ,240,29,77,.377,25,64,.391,4,13,.308,11,16,.688,73,26,71,.366,24,56,.429,2,15,.133,22,35,.629,76,2012-04-22,TOR,DET
10,@,L 73-101 ,240,25,73,.342,21,58,.362,4,15,.267,19,23,.826,73,46,83,.554,44,65,.677,2,18,.111,7,12,.583,101,2012-04-23,CHA,WAS
11,@,L 73-103 ,240,30,80,.375,27,59,.458,3,21,.143,10,17,.588,73,40,77,.519,30,53,.566,10,24,.417,13,16,.813,103,2012-11-07,BRK,MIA
12,@,L 73-91 ,240,30,87,.345,23,63,.365,7,24,.292,6,9,.667,73,30,70,.429,26,51,.510,4,19,.211,27,35,.771,91,2012-12-07,CLE,MIN
13,@,L 73-104 ,240,28,74,.378,24,57,.421,4,17,.235,13,17,.765,73,43,73,.589,37,59,.627,6,14,.429,12,16,.750,104,2012-12-31,BRK,SAS
14,Home,L 73-99 ,240,27,89,.303,21,69,.304,6,20,.300,13,17,.765,73,35,76,.461,30,62,.484,5,14,.357,24,32,.750,99,2013-01-14,MEM,LAC
15,@,L 73-86 ,240,29,71,.408,25,56,.446,4,15,.267,11,12,.917,73,34,79,.430,31,69,.449,3,10,.300,15,19,.789,86,2013-01-26,CHI,WAS
16,@,L 73-98 ,240,25,72,.347,22,53,.415,3,19,.158,20,31,.645,73,38,81,.469,26,55,.473,12,26,.462,10,17,.588,98,2013-02-01,LAC,TOR
17,@,L 73-95 ,240,28,88,.318,25,73,.342,3,15,.200,14,21,.667,73,34,87,.391,28,64,.438,6,23,.261,21,24,.875,95,2013-03-19,ORL,IND
18,@,L 73-97 ,240,25,85,.294,18,65,.277,7,20,.350,16,25,.640,73,38,72,.528,35,64,.547,3,8,.375,18,25,.720,97,2013-11-08,UTA,CHI
19,@,L 73-95 ,240,28,71,.394,24,53,.453,4,18,.222,13,29,.448,73,36,71,.507,31,59,.525,5,12,.417,18,22,.818,95,2013-11-24,UTA,OKC
20,@,L 73-93 ,240,29,73,.397,23,55,.418,6,18,.333,9,13,.692,73,38,85,.447,29,63,.460,9,22,.409,8,10,.800,93,2013-11-29,WAS,IND
21,Home,L 73-114 ,240,25,73,.342,19,57,.333,6,16,.375,17,23,.739,73,39,72,.542,25,47,.532,14,25,.560,22,27,.815,114,2013-12-08,NYK,BOS
22,Home,L 73-81 ,240,27,84,.321,20,60,.333,7,24,.292,12,14,.857,73,30,84,.357,25,65,.385,5,19,.263,16,21,.762,81,2014-02-12,IND,DAL
23,@,L 73-76 ,240,27,88,.307,20,65,.308,7,23,.304,12,17,.706,73,30,82,.366,28,66,.424,2,16,.125,14,19,.737,76,2014-12-20,IND,DEN
24,@,L 73-108 ,240,29,75,.387,24,60,.400,5,15,.333,10,16,.625,73,42,79,.532,29,50,.580,13,29,.448,11,14,.786,108,2015-01-24,BRK,UTA
25,Home,L 73-80 ,240,31,77,.403,28,66,.424,3,11,.273,8,17,.471,73,25,62,.403,16,37,.432,9,25,.360,21,31,.677,80,2015-03-19,LAL,UTA
26,@,L 73-96 ,240,27,83,.325,24,65,.369,3,18,.167,16,22,.727,73,41,83,.494,35,63,.556,6,20,.300,8,12,.667,96,2015-04-12,BRK,MIL
27,@,L 73-102 ,240,25,68,.368,19,43,.442,6,25,.240,17,21,.810,73,40,81,.494,28,50,.560,12,31,.387,10,15,.667,102,2016-01-27,CHO,UTA
28,@,L 73-96 ,240,28,85,.329,21,62,.339,7,23,.304,10,13,.769,73,39,97,.402,32,67,.478,7,30,.233,11,21,.524,96,2016-11-17,MIL,MIA
29,Home,L 73-82 ,240,28,93,.301,26,70,.371,2,23,.087,15,18,.833,73,30,66,.455,22,39,.564,8,27,.296,14,25,.560,82,2016-12-18,MEM,UTA
30,@,L 73-122 ,240,28,73,.384,25,52,.481,3,21,.143,14,17,.824,73,43,87,.494,26,48,.542,17,39,.436,19,19,1.000,122,2017-01-22,LAL,DAL
31,Home,L 72-93 ,240,30,87,.345,27,77,.351,3,10,.300,9,16,.563,72,36,80,.450,26,54,.481,10,26,.385,11,15,.733,93,2012-01-08,WAS,MIN
32,@,L 72-89 ,240,27,70,.386,23,55,.418,4,15,.267,14,21,.667,72,35,78,.449,29,63,.460,6,15,.400,13,16,.813,89,2012-01-27,CHA,PHI
33,Home,L 72-94 ,240,27,73,.370,24,63,.381,3,10,.300,15,19,.789,72,36,81,.444,24,58,.414,12,23,.522,10,17,.588,94,2012-01-29,NOH,ATL
34,@,L 72-102 ,240,31,83,.373,28,67,.418,3,16,.188,7,10,.700,72,39,82,.476,29,62,.468,10,20,.500,14,21,.667,102,2012-03-02,CHA,SAS
35,@,L 72-92 ,240,27,79,.342,24,63,.381,3,16,.188,15,22,.682,72,33,78,.423,24,63,.381,9,15,.600,17,27,.630,92,2012-03-05,IND,CHI
36,@,L 72-91 ,240,31,89,.348,28,73,.384,3,16,.188,7,17,.412,72,33,70,.471,28,57,.491,5,13,.385,20,22,.909,91,2012-04-01,MIA,BOS
37,Home,L 72-86 ,240,26,74,.351,21,52,.404,5,22,.227,15,19,.789,72,32,76,.421,23,58,.397,9,18,.500,13,14,.929,86,2012-04-07,IND,BOS
38,@,L 72-96 ,240,30,72,.417,29,56,.518,1,16,.063,11,15,.733,72,40,76,.526,33,59,.559,7,17,.412,9,15,.600,96,2012-04-18,TOR,MIA
39,@,L 72-83 ,240,25,70,.357,23,54,.426,2,16,.125,20,28,.714,72,32,76,.421,28,63,.444,4,13,.308,15,21,.714,83,2012-04-19,CHI,MIA
40,Home,L 72-74 ,240,24,75,.320,19,60,.317,5,15,.333,19,25,.760,72,26,72,.361,20,60,.333,6,12,.500,16,19,.842,74,2012-11-13,IND,TOR
41,@,L 72-81 ,240,31,82,.378,29,72,.403,2,10,.200,8,14,.571,72,34,89,.382,29,64,.453,5,25,.200,8,13,.615,81,2012-11-19,ORL,ATL
42,@,L 72-102 ,240,27,72,.375,20,52,.385,7,20,.350,11,15,.733,72,40,79,.506,32,52,.615,8,27,.296,14,21,.667,102,2012-12-15,WAS,MIA
43,@,L 72-81 ,240,29,68,.426,26,52,.500,3,16,.188,11,18,.611,72,36,89,.404,31,70,.443,5,19,.263,4,7,.571,81,2012-12-29,DEN,MEM
44,@,L 72-90 ,240,29,74,.392,27,64,.422,2,10,.200,12,19,.632,72,39,80,.488,38,69,.551,1,11,.091,11,13,.846,90,2013-01-09,PHI,TOR
45,Home,L 72-90 ,240,26,77,.338,24,63,.381,2,14,.143,18,24,.750,72,34,75,.453,26,53,.491,8,22,.364,14,19,.737,90,2013-02-23,DET,IND
46,Home,L 72-76 ,240,29,77,.377,20,56,.357,9,21,.429,5,13,.385,72,32,71,.451,30,64,.469,2,7,.286,10,12,.833,76,2013-02-24,BRK,MEM
47,@,L 72-102 ,240,25,86,.291,21,68,.309,4,18,.222,18,24,.750,72,36,79,.456,30,62,.484,6,17,.353,24,27,.889,102,2013-02-24,CHI,OKC
48,Home,L 72-93 ,240,28,83,.337,25,66,.379,3,17,.176,13,13,1.000,72,35,70,.500,25,51,.490,10,19,.526,13,15,.867,93,2013-03-18,NOH,GSW
49,@,L 72-101 ,240,29,79,.367,23,59,.390,6,20,.300,8,10,.800,72,41,78,.526,35,58,.603,6,20,.300,13,19,.684,101,2013-03-20,PHI,LAC
50,Home,L 72-96 ,240,30,85,.353,25,67,.373,5,18,.278,7,9,.778,72,38,77,.494,33,63,.524,5,14,.357,15,27,.556,96,2013-11-23,MIL,CHA
51,Home,L 72-81 ,240,28,88,.318,21,67,.313,7,21,.333,9,12,.750,72,24,62,.387,18,46,.391,6,16,.375,27,39,.692,81,2014-01-10,MIL,CHI
52,@,L 72-98 ,240,21,73,.288,14,48,.292,7,25,.280,23,29,.793,72,36,83,.434,30,66,.455,6,17,.353,20,34,.588,98,2014-01-18,UTA,MIN
53,Home,L 72-93 ,240,29,88,.330,20,59,.339,9,29,.310,5,10,.500,72,34,82,.415,21,53,.396,13,29,.448,12,20,.600,93,2015-01-30,MIA,DAL
54,Home,L 72-107 ,240,32,86,.372,28,69,.406,4,17,.235,4,7,.571,72,43,84,.512,33,62,.532,10,22,.455,11,13,.846,107,2015-02-07,NOP,CHI
55,@,L 72-74 ,240,31,83,.373,26,65,.400,5,18,.278,5,10,.500,72,29,83,.349,27,61,.443,2,22,.091,14,21,.667,74,2015-03-19,NOP,PHO
56,Home,L 72-104 ,240,28,80,.350,23,62,.371,5,18,.278,11,15,.733,72,42,85,.494,37,65,.569,5,20,.250,15,23,.652,104,2016-10-29,PHI,ATL
57,Home,L 72-88 ,240,28,87,.322,24,64,.375,4,23,.174,12,18,.667,72,36,81,.444,27,56,.482,9,25,.360,7,11,.636,88,2017-02-13,UTA,LAC
58,@,L 71-96 ,240,29,90,.322,28,77,.364,1,13,.077,12,17,.706,71,30,71,.423,24,55,.436,6,16,.375,30,37,.811,96,2011-12-27,UTA,LAL
59,@,L 71-93 ,240,27,77,.351,26,58,.448,1,19,.053,16,21,.762,71,34,86,.395,18,53,.340,16,33,.485,9,16,.563,93,2012-01-05,DAL,SAS
60,Home,L 71-79 ,240,30,74,.405,26,64,.406,4,10,.400,7,9,.778,71,31,69,.449,26,50,.520,5,19,.263,12,16,.750,79,2012-01-20,BOS,PHO
61,@,L 71-109 ,240,29,78,.372,25,65,.385,4,13,.308,9,18,.500,71,43,91,.473,36,71,.507,7,20,.350,16,19,.842,109,2012-01-27,PHO,POR
62,Home,L 71-74 ,240,27,71,.380,21,57,.368,6,14,.429,11,18,.611,71,30,78,.385,28,61,.459,2,17,.118,12,19,.632,74,2012-02-16,POR,LAC
63,@,L 71-103 ,240,28,80,.350,28,72,.389,0,8,.000,15,18,.833,71,43,89,.483,37,72,.514,6,17,.353,11,15,.733,103,2012-03-07,BOS,PHI
64,Home,L 71-73 ,240,30,78,.385,25,66,.379,5,12,.417,6,7,.857,71,34,79,.430,34,67,.507,0,12,.000,5,7,.714,73,2012-03-12,NOH,CHA
65,@,L 71-83 ,240,31,84,.369,28,73,.384,3,11,.273,6,7,.857,71,32,75,.427,30,63,.476,2,12,.167,17,21,.810,83,2012-03-30,DET,CHI
66,@,L 71-80 ,240,28,75,.373,26,64,.406,2,11,.182,13,20,.650,71,30,80,.375,24,69,.348,6,11,.545,14,19,.737,80,2012-12-17,CHI,MEM
67,@,L 71-99 ,240,29,81,.358,23,60,.383,6,21,.286,7,14,.500,71,38,82,.463,30,61,.492,8,21,.381,15,16,.938,99,2013-01-06,WAS,MIA
68,Home,W 71-69 ,240,28,76,.368,23,61,.377,5,15,.333,10,12,.833,71,27,74,.365,24,57,.421,3,17,.176,12,17,.706,69,2013-02-13,BOS,CHI
69,Home,L 71-98 ,240,28,74,.378,21,51,.412,7,23,.304,8,15,.533,71,37,77,.481,26,53,.491,11,24,.458,13,15,.867,98,2013-03-06,PHO,TOR
70,@,L 71-82 ,240,27,74,.365,21,59,.356,6,15,.400,11,14,.786,71,33,75,.440,28,62,.452,5,13,.385,11,17,.647,82,2014-03-22,IND,MEM
71,@,W 71-69 ,240,29,80,.363,26,69,.377,3,11,.273,10,13,.769,71,26,72,.361,22,58,.379,4,14,.286,13,18,.722,69,2014-11-01,MEM,CHO
72,@,L 71-88 ,240,24,74,.324,19,48,.396,5,26,.192,18,28,.643,71,30,84,.357,26,61,.426,4,23,.174,24,28,.857,88,2014-12-27,PHI,UTA
73,@,L 71-80 (OT),265,30,84,.357,28,63,.444,2,21,.095,9,13,.692,71,31,101,.307,29,86,.337,2,15,.133,16,25,.640,80,2015-01-17,IND,CHO
74,@,L 71-76 ,240,28,79,.354,22,64,.344,6,15,.400,9,18,.500,71,25,76,.329,23,69,.333,2,7,.286,24,37,.649,76,2015-01-24,NYK,CHO
75,@,L 71-87 ,240,30,89,.337,26,71,.366,4,18,.222,7,13,.538,71,27,76,.355,19,50,.380,8,26,.308,25,32,.781,87,2015-02-23,MIL,CHI
76,Home,L 71-99 ,240,19,63,.302,13,48,.271,6,15,.400,27,37,.730,71,36,88,.409,29,75,.387,7,13,.538,20,25,.800,99,2015-10-30,PHI,UTA
77,@,L 71-93 ,240,25,64,.391,18,42,.429,7,22,.318,14,22,.636,71,29,76,.382,27,58,.466,2,18,.111,33,38,.868,93,2016-11-19,MIN,MEM
78,Home,L 70-106 ,240,22,71,.310,17,47,.362,5,24,.208,21,26,.808,70,38,86,.442,26,63,.413,12,23,.522,18,21,.857,106,2011-12-27,NJN,ATL
79,@,L 70-89 ,240,30,74,.405,26,54,.481,4,20,.200,6,10,.600,70,35,71,.493,29,55,.527,6,16,.375,13,21,.619,89,2012-01-04,NJN,BOS
80,Home,L 70-82 ,240,30,88,.341,29,75,.387,1,13,.077,9,11,.818,70,32,83,.386,26,66,.394,6,17,.353,12,16,.750,82,2012-01-10,CHA,HOU
81,@,L 70-73 ,240,28,80,.350,24,54,.444,4,26,.154,10,16,.625,70,29,76,.382,28,66,.424,1,10,.100,14,19,.737,73,2012-01-16,DAL,LAL
82,@,L 70-86 ,240,28,83,.337,22,63,.349,6,20,.300,8,10,.800,70,34,67,.507,26,38,.684,8,29,.276,10,14,.714,86,2012-03-16,NJN,ORL
83,@,L 70-104 ,240,24,67,.358,20,49,.408,4,18,.222,18,24,.750,70,42,76,.553,37,66,.561,5,10,.500,15,24,.625,104,2012-04-26,MIA,WAS
84,Home,L 70-77 ,240,26,80,.325,22,64,.344,4,16,.250,14,22,.636,70,27,82,.329,22,63,.349,5,19,.263,18,23,.783,77,2012-12-11,NOH,WAS
85,@,L 70-86 ,240,25,78,.321,22,67,.328,3,11,.273,17,26,.654,70,34,84,.405,30,71,.423,4,13,.308,14,20,.700,86,2013-04-17,UTA,MEM
86,@,L 70-99 ,240,22,78,.282,18,58,.310,4,20,.200,22,34,.647,70,36,69,.522,34,61,.557,2,8,.250,25,34,.735,99,2014-02-03,CHI,SAC
87,@,L 70-123 ,240,23,77,.299,16,50,.320,7,27,.259,17,33,.515,70,41,80,.513,30,48,.625,11,32,.344,30,36,.833,123,2014-11-13,PHI,DAL
88,@,L 70-88 ,240,22,69,.319,11,41,.268,11,28,.393,15,20,.750,70,36,81,.444,31,61,.508,5,20,.250,11,17,.647,88,2014-12-12,PHI,BRK
89,@,L 70-95 ,240,26,78,.333,23,64,.359,3,14,.214,15,18,.833,70,37,90,.411,30,69,.435,7,21,.333,14,20,.700,95,2015-12-02,MIL,SAS
90,@,L 70-91 ,240,22,70,.314,18,46,.391,4,24,.167,22,27,.815,70,40,92,.435,35,73,.479,5,19,.263,6,7,.857,91,2016-11-27,LAC,IND
91,@,L 69-74 ,240,26,78,.333,19,56,.339,7,22,.318,10,22,.455,69,30,80,.375,26,65,.400,4,15,.267,10,19,.526,74,2012-01-30,ORL,PHI
92,@,L 69-114 ,240,23,79,.291,17,57,.298,6,22,.273,17,22,.773,69,40,78,.513,27,51,.529,13,27,.481,21,23,.913,114,2012-11-26,CHA,OKC
93,@,L 69-85 ,240,29,85,.341,27,75,.360,2,10,.200,9,15,.600,69,34,78,.436,31,71,.437,3,7,.429,14,20,.700,85,2013-01-18,SAC,MEM
94,Home,L 69-88 ,240,31,89,.348,29,81,.358,2,8,.250,5,7,.714,69,32,81,.395,27,64,.422,5,17,.294,19,25,.760,88,2013-02-06,PHI,IND
95,Home,L 69-97 ,240,30,91,.330,26,77,.338,4,14,.286,5,5,1.000,69,34,76,.447,25,59,.424,9,17,.529,20,27,.741,97,2013-02-10,PHO,OKC
96,@,L 69-71 ,240,27,74,.365,24,57,.421,3,17,.176,12,17,.706,69,28,76,.368,23,61,.377,5,15,.333,10,12,.833,71,2013-02-13,CHI,BOS
97,@,L 69-102 ,240,25,78,.321,24,68,.353,1,10,.100,18,25,.720,69,42,93,.452,32,63,.508,10,30,.333,8,12,.667,102,2014-04-04,SAC,GSW
98,Home,L 69-71 ,240,26,72,.361,22,58,.379,4,14,.286,13,18,.722,69,29,80,.363,26,69,.377,3,11,.273,10,13,.769,71,2014-11-01,CHO,MEM
99,@,W 69-65 ,240,23,80,.288,16,45,.356,7,35,.200,16,30,.533,69,20,68,.294,17,49,.347,3,19,.158,22,28,.786,65,2014-11-16,HOU,OKC
0,@,L 69-89 ,240,28,84,.333,25,74,.338,3,10,.300,10,16,.625,69,31,80,.388,23,63,.365,8,17,.471,19,23,.826,89,2015-01-18,UTA,SAS
1,@,L 69-89 ,240,23,75,.307,21,55,.382,2,20,.100,21,23,.913,69,37,78,.474,30,57,.526,7,21,.333,8,12,.667,89,2015-01-28,DET,PHI
2,@,L 69-99 ,240,29,87,.333,27,61,.443,2,26,.077,9,10,.900,69,39,88,.443,36,72,.500,3,16,.188,18,27,.667,99,2015-01-29,DEN,MEM
3,Home,L 69-95 ,240,25,77,.325,21,55,.382,4,22,.182,15,20,.750,69,44,85,.518,42,71,.592,2,14,.143,5,5,1.000,95,2015-03-09,CHO,WAS
4,@,L 69-96 ,240,26,83,.313,22,63,.349,4,20,.200,13,18,.722,69,41,83,.494,37,58,.638,4,25,.160,10,14,.714,96,2015-04-07,PHO,ATL
5,@,L 69-119 ,240,26,96,.271,23,73,.315,3,23,.130,14,20,.700,69,43,84,.512,32,59,.542,11,25,.440,22,30,.733,119,2015-11-02,MEM,GSW
6,@,L 69-103 ,240,28,82,.341,22,56,.393,6,26,.231,7,14,.500,69,43,88,.489,32,63,.508,11,25,.440,6,9,.667,103,2016-03-17,PHO,UTA
7,@,L 69-88 ,240,27,84,.321,22,59,.373,5,25,.200,10,13,.769,69,35,90,.389,27,65,.415,8,25,.320,10,10,1.000,88,2016-11-14,ORL,IND
8,Home,L 69-95 ,240,28,92,.304,23,71,.324,5,21,.238,8,15,.533,69,38,82,.463,28,57,.491,10,25,.400,9,13,.692,95,2016-12-16,CHI,MIL
9,@,L 68-92 ,240,28,71,.394,27,67,.403,1,4,.250,11,14,.786,68,34,74,.459,31,58,.534,3,16,.188,21,25,.840,92,2012-01-09,DET,CHI
10,@,L 68-112 ,240,26,80,.325,25,71,.352,1,9,.111,15,19,.789,68,44,80,.550,37,66,.561,7,14,.500,17,20,.850,112,2012-02-01,CHA,POR
11,Home,L 68-97 ,240,25,79,.316,23,69,.333,2,10,.200,16,20,.800,68,42,84,.500,37,71,.521,5,13,.385,8,9,.889,97,2012-02-28,DET,PHI
12,Home,L 68-100 ,240,25,84,.298,24,76,.316,1,8,.125,17,23,.739,68,40,83,.482,31,64,.484,9,19,.474,11,19,.579,100,2012-04-18,CHA,CHI
13,Home,L 68-107 ,240,30,70,.429,26,59,.441,4,11,.364,4,8,.500,68,41,82,.500,32,59,.542,9,23,.391,16,25,.640,107,2012-11-09,ORL,BRK
14,@,L 68-100 ,240,28,85,.329,26,73,.356,2,12,.167,10,13,.769,68,38,90,.422,28,66,.424,10,24,.417,14,21,.667,100,2012-12-21,WAS,DET
15,@,L 68-98 ,240,28,81,.346,23,63,.365,5,18,.278,7,12,.583,68,38,78,.487,33,62,.532,5,16,.313,17,23,.739,98,2013-03-01,CHA,UTA
16,Home,L 68-119 ,240,26,75,.347,22,51,.431,4,24,.167,12,21,.571,68,47,76,.618,43,65,.662,4,11,.364,21,25,.840,119,2015-12-07,PHI,SAS
17,@,L 68-95 ,240,26,83,.313,18,58,.310,8,25,.320,8,12,.667,68,35,80,.438,25,46,.543,10,34,.294,15,18,.833,95,2016-11-25,ATL,UTA
18,@,L 67-93 ,240,24,61,.393,18,40,.450,6,21,.286,13,21,.619,67,41,81,.506,36,67,.537,5,14,.357,6,16,.375,93,2012-01-27,ORL,NOH
19,Home,L 67-90 ,240,28,75,.373,27,72,.375,1,3,.333,10,17,.588,67,39,85,.459,35,69,.507,4,16,.250,8,12,.667,90,2012-02-08,NOH,CHI
20,Home,L 67-75 ,240,23,76,.303,22,60,.367,1,16,.063,20,30,.667,67,26,77,.338,25,66,.379,1,11,.091,22,25,.880,75,2012-04-16,CHA,NOH
21,@,L 67-98 ,240,25,83,.301,19,65,.292,6,18,.333,11,16,.688,67,37,88,.420,27,69,.391,10,19,.526,14,18,.778,98,2012-04-26,NJN,TOR
22,Home,L 67-86 ,240,28,75,.373,26,65,.400,2,10,.200,9,11,.818,67,37,73,.507,34,60,.567,3,13,.231,9,14,.643,86,2013-02-21,CHI,MIA
23,Home,L 67-88 ,240,27,79,.342,23,65,.354,4,14,.286,9,14,.643,67,32,74,.432,25,51,.490,7,23,.304,17,21,.810,88,2014-03-29,MIL,MIA
24,@,L 66-78 ,240,28,73,.384,22,56,.393,6,17,.353,4,7,.571,66,32,74,.432,28,62,.452,4,12,.333,10,16,.625,78,2012-04-24,MIA,BOS
25,@,L 66-93 ,240,26,81,.321,21,67,.313,5,14,.357,9,23,.391,66,37,83,.446,31,70,.443,6,13,.462,13,22,.591,93,2014-01-10,WAS,IND
26,@,L 66-94 ,240,23,78,.295,18,59,.305,5,19,.263,15,18,.833,66,33,78,.423,18,54,.333,15,24,.625,13,19,.684,94,2015-03-16,CHO,UTA
27,@,L 65-103 ,240,22,79,.278,18,59,.305,4,20,.200,17,21,.810,65,39,84,.464,25,55,.455,14,29,.483,11,13,.846,103,2012-04-13,WAS,NYK
28,Home,L 65-69 ,240,20,68,.294,17,49,.347,3,19,.158,22,28,.786,65,23,80,.288,16,45,.356,7,35,.200,16,30,.533,69,2014-11-16,OKC,HOU
29,@,L 64-104 ,240,26,84,.310,25,75,.333,1,9,.111,11,14,.786,64,39,84,.464,34,71,.479,5,13,.385,21,29,.724,104,2012-01-01,MEM,CHI
30,@,L 64-78 ,240,26,84,.310,23,75,.307,3,9,.333,9,12,.750,64,33,90,.367,30,78,.385,3,12,.250,9,16,.563,78,2012-01-11,WAS,CHI
31,@,L 64-77 ,240,30,86,.349,27,76,.355,3,10,.300,1,7,.143,64,33,82,.402,29,67,.433,4,15,.267,7,12,.583,77,2012-01-14,TOR,CHI
32,@,L 64-100 ,240,25,73,.342,19,59,.322,6,14,.429,8,18,.444,64,39,75,.520,27,51,.529,12,24,.500,10,12,.833,100,2012-02-01,TOR,BOS
33,Home,L 64-95 ,240,25,76,.329,24,68,.353,1,8,.125,13,19,.684,64,39,90,.433,33,75,.440,6,15,.400,11,20,.550,95,2012-02-10,CHA,CHI
34,Home,L 64-80 ,240,21,73,.288,16,48,.333,5,25,.200,17,22,.773,64,31,77,.403,22,52,.423,9,25,.360,9,12,.750,80,2016-11-18,DAL,MEM
35,@,L 63-99 ,240,24,74,.324,22,57,.386,2,17,.118,13,13,1.000,63,41,87,.471,36,75,.480,5,12,.417,12,18,.667,99,2013-02-13,POR,NOH
36,@,L 63-92 ,240,20,73,.274,15,46,.326,5,27,.185,18,28,.643,63,32,78,.410,21,58,.362,11,20,.550,17,24,.708,92,2013-03-11,NYK,GSW
37,@,L 62-97 ,240,27,85,.318,26,73,.356,1,12,.083,7,12,.583,62,36,83,.434,31,62,.500,5,21,.238,20,27,.741,97,2012-01-07,TOR,PHI
38,Home,L 62-77 ,240,23,69,.333,19,50,.380,4,19,.211,12,16,.750,62,35,84,.417,31,62,.500,4,22,.182,3,5,.600,77,2012-11-07,NOH,PHI
39,@,L 61-78 ,240,27,80,.338,26,68,.382,1,12,.083,6,8,.750,61,36,79,.456,33,59,.559,3,20,.150,3,5,.600,78,2013-02-04,ORL,PHI
40,@,L 60-99 ,240,22,86,.256,20,65,.308,2,21,.095,14,18,.778,60,37,81,.457,30,65,.462,7,16,.438,18,25,.720,99,2012-01-14,SAC,DAL
41,Home,L 59-85 ,240,24,68,.353,20,48,.417,4,20,.200,7,18,.389,59,35,79,.443,28,61,.459,7,18,.389,8,11,.727,85,2012-03-19,ORL,CHI
42,@,L 58-97 ,240,24,82,.293,22,68,.324,2,14,.143,8,10,.800,58,33,79,.418,27,65,.415,6,14,.429,25,33,.758,97,2013-01-14,ATL,CHI
43,@,L 56-87 ,240,16,65,.246,12,49,.245,4,16,.250,20,30,.667,56,33,78,.423,31,65,.477,2,13,.154,19,19,1.000,87,2012-01-23,ORL,BOS
